accuracy,alpha,batch_neg,batch_pos,embed_dim,hidden_dim,learning_rate,train_size,trial
0.504,1e-05,64,40,2,2,0.0001,104,1
0.504,1e-05,109,95,2,2,0.0001,204,1
0.502,1e-05,158,146,2,2,0.0001,304,1
0.502,1e-05,215,189,2,2,0.0001,404,1
0.502,1e-05,258,246,2,2,0.0001,504,1
0.502,1e-05,304,300,2,2,0.0001,604,1
0.502,1e-05,349,355,2,2,0.0001,704,1
0.502,1e-05,404,400,2,2,0.0001,804,1
0.502,1e-05,453,451,2,2,0.0001,904,1
0.502,1e-05,502,502,2,2,0.0001,1004,1
0.502,1e-05,548,556,2,2,0.0001,1104,1
0.502,1e-05,593,611,2,2,0.0001,1204,1
0.502,1e-05,635,669,2,2,0.0001,1304,1
0.504,1e-05,684,720,2,2,0.0001,1404,1
0.504,1e-05,739,765,2,2,0.0001,1504,1
0.504,1e-05,785,819,2,2,0.0001,1604,1
0.504,1e-05,841,863,2,2,0.0001,1704,1
0.504,1e-05,892,912,2,2,0.0001,1804,1
0.504,1e-05,943,961,2,2,0.0001,1904,1
0.504,1e-05,992,1012,2,2,0.0001,2004,1
0.52,1e-05,54,50,2,2,0.0001,104,2
0.52,1e-05,101,103,2,2,0.0001,204,2
0.52,1e-05,154,150,2,2,0.0001,304,2
0.52,1e-05,199,205,2,2,0.0001,404,2
0.52,1e-05,251,253,2,2,0.0001,504,2
0.52,1e-05,291,313,2,2,0.0001,604,2
0.52,1e-05,337,367,2,2,0.0001,704,2
0.518,1e-05,394,410,2,2,0.0001,804,2
0.518,1e-05,436,468,2,2,0.0001,904,2
0.518,1e-05,491,513,2,2,0.0001,1004,2
0.518,1e-05,546,558,2,2,0.0001,1104,2
0.518,1e-05,578,626,2,2,0.0001,1204,2
0.518,1e-05,633,671,2,2,0.0001,1304,2
0.518,1e-05,691,713,2,2,0.0001,1404,2
0.516,1e-05,737,767,2,2,0.0001,1504,2
0.516,1e-05,800,804,2,2,0.0001,1604,2
0.516,1e-05,861,843,2,2,0.0001,1704,2
0.518,1e-05,909,895,2,2,0.0001,1804,2
0.518,1e-05,969,935,2,2,0.0001,1904,2
0.518,1e-05,1014,990,2,2,0.0001,2004,2
0.518,1e-05,54,50,2,2,0.0001,104,3
0.518,1e-05,113,91,2,2,0.0001,204,3
0.518,1e-05,152,152,2,2,0.0001,304,3
0.518,1e-05,204,200,2,2,0.0001,404,3
0.518,1e-05,249,255,2,2,0.0001,504,3
0.518,1e-05,294,310,2,2,0.0001,604,3
0.518,1e-05,349,355,2,2,0.0001,704,3
0.518,1e-05,405,399,2,2,0.0001,804,3
0.518,1e-05,452,452,2,2,0.0001,904,3
0.518,1e-05,499,505,2,2,0.0001,1004,3
0.518,1e-05,556,548,2,2,0.0001,1104,3
0.518,1e-05,613,591,2,2,0.0001,1204,3
0.518,1e-05,660,644,2,2,0.0001,1304,3
0.518,1e-05,703,701,2,2,0.0001,1404,3
0.518,1e-05,752,752,2,2,0.0001,1504,3
0.518,1e-05,801,803,2,2,0.0001,1604,3
0.518,1e-05,855,849,2,2,0.0001,1704,3
0.518,1e-05,905,899,2,2,0.0001,1804,3
0.518,1e-05,962,942,2,2,0.0001,1904,3
0.518,1e-05,1011,993,2,2,0.0001,2004,3
0.534,1e-05,57,47,2,2,0.0001,104,4
0.534,1e-05,100,104,2,2,0.0001,204,4
0.534,1e-05,150,154,2,2,0.0001,304,4
0.534,1e-05,211,193,2,2,0.0001,404,4
0.534,1e-05,255,249,2,2,0.0001,504,4
0.534,1e-05,302,302,2,2,0.0001,604,4
0.534,1e-05,353,351,2,2,0.0001,704,4
0.534,1e-05,403,401,2,2,0.0001,804,4
0.534,1e-05,454,450,2,2,0.0001,904,4
0.534,1e-05,506,498,2,2,0.0001,1004,4
0.534,1e-05,555,549,2,2,0.0001,1104,4
0.534,1e-05,605,599,2,2,0.0001,1204,4
0.534,1e-05,655,649,2,2,0.0001,1304,4
0.534,1e-05,706,698,2,2,0.0001,1404,4
0.534,1e-05,753,751,2,2,0.0001,1504,4
0.534,1e-05,802,802,2,2,0.0001,1604,4
0.534,1e-05,853,851,2,2,0.0001,1704,4
0.534,1e-05,910,894,2,2,0.0001,1804,4
0.534,1e-05,963,941,2,2,0.0001,1904,4
0.534,1e-05,1019,985,2,2,0.0001,2004,4
0.484,1e-05,46,58,2,2,0.0001,104,5
0.484,1e-05,99,105,2,2,0.0001,204,5
0.484,1e-05,145,159,2,2,0.0001,304,5
0.484,1e-05,199,205,2,2,0.0001,404,5
0.484,1e-05,251,253,2,2,0.0001,504,5
0.484,1e-05,294,310,2,2,0.0001,604,5
0.484,1e-05,352,352,2,2,0.0001,704,5
0.484,1e-05,401,403,2,2,0.0001,804,5
0.484,1e-05,454,450,2,2,0.0001,904,5
0.484,1e-05,506,498,2,2,0.0001,1004,5
0.484,1e-05,563,541,2,2,0.0001,1104,5
0.484,1e-05,616,588,2,2,0.0001,1204,5
0.484,1e-05,664,640,2,2,0.0001,1304,5
0.482,1e-05,714,690,2,2,0.0001,1404,5
0.482,1e-05,764,740,2,2,0.0001,1504,5
0.482,1e-05,807,797,2,2,0.0001,1604,5
0.482,1e-05,855,849,2,2,0.0001,1704,5
0.48,1e-05,903,901,2,2,0.0001,1804,5
0.48,1e-05,954,950,2,2,0.0001,1904,5
0.478,1e-05,1014,990,2,2,0.0001,2004,5
0.518,1e-05,55,49,2,2,0.0001,104,6
0.518,1e-05,113,91,2,2,0.0001,204,6
0.518,1e-05,166,138,2,2,0.0001,304,6
0.518,1e-05,214,190,2,2,0.0001,404,6
0.518,1e-05,270,234,2,2,0.0001,504,6
0.518,1e-05,316,288,2,2,0.0001,604,6
0.518,1e-05,370,334,2,2,0.0001,704,6
0.52,1e-05,414,390,2,2,0.0001,804,6
0.52,1e-05,467,437,2,2,0.0001,904,6
0.52,1e-05,512,492,2,2,0.0001,1004,6
0.52,1e-05,556,548,2,2,0.0001,1104,6
0.52,1e-05,601,603,2,2,0.0001,1204,6
0.52,1e-05,650,654,2,2,0.0001,1304,6
0.52,1e-05,699,705,2,2,0.0001,1404,6
0.52,1e-05,748,756,2,2,0.0001,1504,6
0.52,1e-05,798,806,2,2,0.0001,1604,6
0.52,1e-05,858,846,2,2,0.0001,1704,6
0.52,1e-05,909,895,2,2,0.0001,1804,6
0.52,1e-05,958,946,2,2,0.0001,1904,6
0.52,1e-05,1006,998,2,2,0.0001,2004,6
0.492,1e-05,60,44,2,2,0.0001,104,7
0.492,1e-05,106,98,2,2,0.0001,204,7
0.492,1e-05,149,155,2,2,0.0001,304,7
0.492,1e-05,200,204,2,2,0.0001,404,7
0.492,1e-05,240,264,2,2,0.0001,504,7
0.492,1e-05,294,310,2,2,0.0001,604,7
0.492,1e-05,349,355,2,2,0.0001,704,7
0.492,1e-05,394,410,2,2,0.0001,804,7
0.492,1e-05,444,460,2,2,0.0001,904,7
0.492,1e-05,489,515,2,2,0.0001,1004,7
0.492,1e-05,540,564,2,2,0.0001,1104,7
0.492,1e-05,589,615,2,2,0.0001,1204,7
0.492,1e-05,640,664,2,2,0.0001,1304,7
0.492,1e-05,692,712,2,2,0.0001,1404,7
0.492,1e-05,738,766,2,2,0.0001,1504,7
0.492,1e-05,799,805,2,2,0.0001,1604,7
0.492,1e-05,851,853,2,2,0.0001,1704,7
0.492,1e-05,910,894,2,2,0.0001,1804,7
0.492,1e-05,958,946,2,2,0.0001,1904,7
0.492,1e-05,1006,998,2,2,0.0001,2004,7
0.526,1e-05,50,54,2,2,0.0001,104,8
0.526,1e-05,94,110,2,2,0.0001,204,8
0.526,1e-05,151,153,2,2,0.0001,304,8
0.526,1e-05,207,197,2,2,0.0001,404,8
0.526,1e-05,259,245,2,2,0.0001,504,8
0.526,1e-05,309,295,2,2,0.0001,604,8
0.526,1e-05,362,342,2,2,0.0001,704,8
0.526,1e-05,422,382,2,2,0.0001,804,8
0.526,1e-05,470,434,2,2,0.0001,904,8
0.526,1e-05,518,486,2,2,0.0001,1004,8
0.526,1e-05,558,546,2,2,0.0001,1104,8
0.526,1e-05,609,595,2,2,0.0001,1204,8
0.526,1e-05,661,643,2,2,0.0001,1304,8
0.526,1e-05,712,692,2,2,0.0001,1404,8
0.526,1e-05,765,739,2,2,0.0001,1504,8
0.526,1e-05,816,788,2,2,0.0001,1604,8
0.526,1e-05,862,842,2,2,0.0001,1704,8
0.526,1e-05,909,895,2,2,0.0001,1804,8
0.526,1e-05,958,946,2,2,0.0001,1904,8
0.526,1e-05,1015,989,2,2,0.0001,2004,8
0.454,1e-05,57,47,2,2,0.0001,104,9
0.454,1e-05,101,103,2,2,0.0001,204,9
0.454,1e-05,157,147,2,2,0.0001,304,9
0.454,1e-05,204,200,2,2,0.0001,404,9
0.454,1e-05,254,250,2,2,0.0001,504,9
0.454,1e-05,302,302,2,2,0.0001,604,9
0.454,1e-05,359,345,2,2,0.0001,704,9
0.454,1e-05,411,393,2,2,0.0001,804,9
0.454,1e-05,470,434,2,2,0.0001,904,9
0.454,1e-05,519,485,2,2,0.0001,1004,9
0.454,1e-05,566,538,2,2,0.0001,1104,9
0.454,1e-05,616,588,2,2,0.0001,1204,9
0.454,1e-05,665,639,2,2,0.0001,1304,9
0.454,1e-05,704,700,2,2,0.0001,1404,9
0.454,1e-05,760,744,2,2,0.0001,1504,9
0.454,1e-05,812,792,2,2,0.0001,1604,9
0.454,1e-05,859,845,2,2,0.0001,1704,9
0.454,1e-05,920,884,2,2,0.0001,1804,9
0.454,1e-05,974,930,2,2,0.0001,1904,9
0.454,1e-05,1025,979,2,2,0.0001,2004,9
0.51,1e-05,55,49,2,2,0.0001,104,10
0.51,1e-05,107,97,2,2,0.0001,204,10
0.51,1e-05,157,147,2,2,0.0001,304,10
0.51,1e-05,203,201,2,2,0.0001,404,10
0.51,1e-05,251,253,2,2,0.0001,504,10
0.51,1e-05,301,303,2,2,0.0001,604,10
0.51,1e-05,354,350,2,2,0.0001,704,10
0.51,1e-05,409,395,2,2,0.0001,804,10
0.51,1e-05,458,446,2,2,0.0001,904,10
0.51,1e-05,504,500,2,2,0.0001,1004,10
0.51,1e-05,550,554,2,2,0.0001,1104,10
0.51,1e-05,597,607,2,2,0.0001,1204,10
0.51,1e-05,645,659,2,2,0.0001,1304,10
0.51,1e-05,701,703,2,2,0.0001,1404,10
0.51,1e-05,749,755,2,2,0.0001,1504,10
0.51,1e-05,804,800,2,2,0.0001,1604,10
0.51,1e-05,845,859,2,2,0.0001,1704,10
0.51,1e-05,894,910,2,2,0.0001,1804,10
0.51,1e-05,952,952,2,2,0.0001,1904,10
0.51,1e-05,997,1007,2,2,0.0001,2004,10
0.442,1e-05,50,54,2,2,0.0001,104,11
0.442,1e-05,100,104,2,2,0.0001,204,11
0.442,1e-05,155,149,2,2,0.0001,304,11
0.442,1e-05,202,202,2,2,0.0001,404,11
0.442,1e-05,253,251,2,2,0.0001,504,11
0.442,1e-05,303,301,2,2,0.0001,604,11
0.442,1e-05,358,346,2,2,0.0001,704,11
0.442,1e-05,414,390,2,2,0.0001,804,11
0.442,1e-05,461,443,2,2,0.0001,904,11
0.442,1e-05,515,489,2,2,0.0001,1004,11
0.44,1e-05,561,543,2,2,0.0001,1104,11
0.44,1e-05,607,597,2,2,0.0001,1204,11
0.44,1e-05,663,641,2,2,0.0001,1304,11
0.442,1e-05,722,682,2,2,0.0001,1404,11
0.442,1e-05,778,726,2,2,0.0001,1504,11
0.442,1e-05,828,776,2,2,0.0001,1604,11
0.444,1e-05,877,827,2,2,0.0001,1704,11
0.444,1e-05,922,882,2,2,0.0001,1804,11
0.444,1e-05,960,944,2,2,0.0001,1904,11
0.444,1e-05,1003,1001,2,2,0.0001,2004,11
0.498,1e-05,45,59,2,2,0.0001,104,12
0.498,1e-05,93,111,2,2,0.0001,204,12
0.498,1e-05,151,153,2,2,0.0001,304,12
0.498,1e-05,201,203,2,2,0.0001,404,12
0.498,1e-05,263,241,2,2,0.0001,504,12
0.498,1e-05,298,306,2,2,0.0001,604,12
0.498,1e-05,352,352,2,2,0.0001,704,12
0.498,1e-05,402,402,2,2,0.0001,804,12
0.498,1e-05,455,449,2,2,0.0001,904,12
0.498,1e-05,512,492,2,2,0.0001,1004,12
0.498,1e-05,555,549,2,2,0.0001,1104,12
0.498,1e-05,606,598,2,2,0.0001,1204,12
0.498,1e-05,657,647,2,2,0.0001,1304,12
0.498,1e-05,704,700,2,2,0.0001,1404,12
0.498,1e-05,762,742,2,2,0.0001,1504,12
0.498,1e-05,803,801,2,2,0.0001,1604,12
0.498,1e-05,849,855,2,2,0.0001,1704,12
0.498,1e-05,891,913,2,2,0.0001,1804,12
0.498,1e-05,947,957,2,2,0.0001,1904,12
0.498,1e-05,1003,1001,2,2,0.0001,2004,12
0.478,1e-05,44,60,2,2,0.0001,104,13
0.478,1e-05,97,107,2,2,0.0001,204,13
0.478,1e-05,147,157,2,2,0.0001,304,13
0.478,1e-05,194,210,2,2,0.0001,404,13
0.478,1e-05,250,254,2,2,0.0001,504,13
0.478,1e-05,299,305,2,2,0.0001,604,13
0.478,1e-05,352,352,2,2,0.0001,704,13
0.478,1e-05,403,401,2,2,0.0001,804,13
0.478,1e-05,452,452,2,2,0.0001,904,13
0.478,1e-05,493,511,2,2,0.0001,1004,13
0.478,1e-05,547,557,2,2,0.0001,1104,13
0.478,1e-05,608,596,2,2,0.0001,1204,13
0.478,1e-05,651,653,2,2,0.0001,1304,13
0.478,1e-05,703,701,2,2,0.0001,1404,13
0.478,1e-05,753,751,2,2,0.0001,1504,13
0.478,1e-05,809,795,2,2,0.0001,1604,13
0.478,1e-05,859,845,2,2,0.0001,1704,13
0.478,1e-05,901,903,2,2,0.0001,1804,13
0.478,1e-05,962,942,2,2,0.0001,1904,13
0.478,1e-05,1013,991,2,2,0.0001,2004,13
0.466,1e-05,47,57,2,2,0.0001,104,14
0.466,1e-05,93,111,2,2,0.0001,204,14
0.466,1e-05,140,164,2,2,0.0001,304,14
0.466,1e-05,193,211,2,2,0.0001,404,14
0.466,1e-05,245,259,2,2,0.0001,504,14
0.466,1e-05,289,315,2,2,0.0001,604,14
0.466,1e-05,326,378,2,2,0.0001,704,14
0.466,1e-05,370,434,2,2,0.0001,804,14
0.464,1e-05,417,487,2,2,0.0001,904,14
0.464,1e-05,469,535,2,2,0.0001,1004,14
0.464,1e-05,520,584,2,2,0.0001,1104,14
0.464,1e-05,567,637,2,2,0.0001,1204,14
0.464,1e-05,618,686,2,2,0.0001,1304,14
0.464,1e-05,669,735,2,2,0.0001,1404,14
0.462,1e-05,719,785,2,2,0.0001,1504,14
0.462,1e-05,773,831,2,2,0.0001,1604,14
0.462,1e-05,830,874,2,2,0.0001,1704,14
0.462,1e-05,881,923,2,2,0.0001,1804,14
0.462,1e-05,936,968,2,2,0.0001,1904,14
0.46,1e-05,989,1015,2,2,0.0001,2004,14
0.472,1e-05,49,55,2,2,0.0001,104,15
0.472,1e-05,94,110,2,2,0.0001,204,15
0.472,1e-05,147,157,2,2,0.0001,304,15
0.472,1e-05,185,219,2,2,0.0001,404,15
0.472,1e-05,244,260,2,2,0.0001,504,15
0.472,1e-05,304,300,2,2,0.0001,604,15
0.472,1e-05,353,351,2,2,0.0001,704,15
0.472,1e-05,400,404,2,2,0.0001,804,15
0.472,1e-05,446,458,2,2,0.0001,904,15
0.472,1e-05,489,515,2,2,0.0001,1004,15
0.472,1e-05,541,563,2,2,0.0001,1104,15
0.472,1e-05,587,617,2,2,0.0001,1204,15
0.472,1e-05,638,666,2,2,0.0001,1304,15
0.472,1e-05,691,713,2,2,0.0001,1404,15
0.472,1e-05,738,766,2,2,0.0001,1504,15
0.472,1e-05,789,815,2,2,0.0001,1604,15
0.472,1e-05,831,873,2,2,0.0001,1704,15
0.472,1e-05,887,917,2,2,0.0001,1804,15
0.472,1e-05,935,969,2,2,0.0001,1904,15
0.472,1e-05,987,1017,2,2,0.0001,2004,15
0.52,1e-05,49,55,2,2,0.0001,104,16
0.52,1e-05,102,102,2,2,0.0001,204,16
0.518,1e-05,150,154,2,2,0.0001,304,16
0.518,1e-05,201,203,2,2,0.0001,404,16
0.518,1e-05,252,252,2,2,0.0001,504,16
0.518,1e-05,305,299,2,2,0.0001,604,16
0.518,1e-05,353,351,2,2,0.0001,704,16
0.518,1e-05,410,394,2,2,0.0001,804,16
0.518,1e-05,465,439,2,2,0.0001,904,16
0.518,1e-05,516,488,2,2,0.0001,1004,16
0.518,1e-05,558,546,2,2,0.0001,1104,16
0.518,1e-05,611,593,2,2,0.0001,1204,16
0.518,1e-05,655,649,2,2,0.0001,1304,16
0.522,1e-05,712,692,2,2,0.0001,1404,16
0.524,1e-05,762,742,2,2,0.0001,1504,16
0.524,1e-05,813,791,2,2,0.0001,1604,16
0.524,1e-05,867,837,2,2,0.0001,1704,16
0.524,1e-05,917,887,2,2,0.0001,1804,16
0.526,1e-05,970,934,2,2,0.0001,1904,16
0.526,1e-05,1009,995,2,2,0.0001,2004,16
0.486,1e-05,47,57,2,2,0.0001,104,17
0.486,1e-05,99,105,2,2,0.0001,204,17
0.486,1e-05,148,156,2,2,0.0001,304,17
0.486,1e-05,206,198,2,2,0.0001,404,17
0.486,1e-05,262,242,2,2,0.0001,504,17
0.486,1e-05,312,292,2,2,0.0001,604,17
0.486,1e-05,372,332,2,2,0.0001,704,17
0.486,1e-05,436,368,2,2,0.0001,804,17
0.486,1e-05,474,430,2,2,0.0001,904,17
0.486,1e-05,518,486,2,2,0.0001,1004,17
0.486,1e-05,570,534,2,2,0.0001,1104,17
0.486,1e-05,624,580,2,2,0.0001,1204,17
0.486,1e-05,666,638,2,2,0.0001,1304,17
0.486,1e-05,711,693,2,2,0.0001,1404,17
0.486,1e-05,760,744,2,2,0.0001,1504,17
0.486,1e-05,805,799,2,2,0.0001,1604,17
0.486,1e-05,854,850,2,2,0.0001,1704,17
0.486,1e-05,900,904,2,2,0.0001,1804,17
0.486,1e-05,948,956,2,2,0.0001,1904,17
0.486,1e-05,995,1009,2,2,0.0001,2004,17
0.51,1e-05,50,54,2,2,0.0001,104,18
0.51,1e-05,102,102,2,2,0.0001,204,18
0.51,1e-05,147,157,2,2,0.0001,304,18
0.51,1e-05,188,216,2,2,0.0001,404,18
0.51,1e-05,232,272,2,2,0.0001,504,18
0.51,1e-05,292,312,2,2,0.0001,604,18
0.51,1e-05,341,363,2,2,0.0001,704,18
0.51,1e-05,384,420,2,2,0.0001,804,18
0.51,1e-05,435,469,2,2,0.0001,904,18
0.51,1e-05,484,520,2,2,0.0001,1004,18
0.51,1e-05,531,573,2,2,0.0001,1104,18
0.51,1e-05,572,632,2,2,0.0001,1204,18
0.51,1e-05,624,680,2,2,0.0001,1304,18
0.51,1e-05,676,728,2,2,0.0001,1404,18
0.51,1e-05,731,773,2,2,0.0001,1504,18
0.51,1e-05,790,814,2,2,0.0001,1604,18
0.51,1e-05,841,863,2,2,0.0001,1704,18
0.51,1e-05,884,920,2,2,0.0001,1804,18
0.51,1e-05,937,967,2,2,0.0001,1904,18
0.51,1e-05,997,1007,2,2,0.0001,2004,18
0.476,1e-05,51,53,2,2,0.0001,104,19
0.476,1e-05,116,88,2,2,0.0001,204,19
0.476,1e-05,158,146,2,2,0.0001,304,19
0.476,1e-05,209,195,2,2,0.0001,404,19
0.476,1e-05,256,248,2,2,0.0001,504,19
0.476,1e-05,302,302,2,2,0.0001,604,19
0.476,1e-05,353,351,2,2,0.0001,704,19
0.476,1e-05,405,399,2,2,0.0001,804,19
0.476,1e-05,455,449,2,2,0.0001,904,19
0.476,1e-05,504,500,2,2,0.0001,1004,19
0.476,1e-05,559,545,2,2,0.0001,1104,19
0.476,1e-05,611,593,2,2,0.0001,1204,19
0.476,1e-05,665,639,2,2,0.0001,1304,19
0.476,1e-05,707,697,2,2,0.0001,1404,19
0.476,1e-05,757,747,2,2,0.0001,1504,19
0.476,1e-05,808,796,2,2,0.0001,1604,19
0.476,1e-05,859,845,2,2,0.0001,1704,19
0.476,1e-05,919,885,2,2,0.0001,1804,19
0.476,1e-05,959,945,2,2,0.0001,1904,19
0.476,1e-05,1011,993,2,2,0.0001,2004,19
0.45,1e-05,49,55,2,2,0.0001,104,20
0.454,1e-05,101,103,2,2,0.0001,204,20
0.454,1e-05,156,148,2,2,0.0001,304,20
0.454,1e-05,214,190,2,2,0.0001,404,20
0.454,1e-05,263,241,2,2,0.0001,504,20
0.454,1e-05,314,290,2,2,0.0001,604,20
0.454,1e-05,360,344,2,2,0.0001,704,20
0.452,1e-05,411,393,2,2,0.0001,804,20
0.452,1e-05,452,452,2,2,0.0001,904,20
0.452,1e-05,499,505,2,2,0.0001,1004,20
0.452,1e-05,558,546,2,2,0.0001,1104,20
0.452,1e-05,594,610,2,2,0.0001,1204,20
0.45,1e-05,645,659,2,2,0.0001,1304,20
0.45,1e-05,692,712,2,2,0.0001,1404,20
0.452,1e-05,748,756,2,2,0.0001,1504,20
0.456,1e-05,795,809,2,2,0.0001,1604,20
0.458,1e-05,848,856,2,2,0.0001,1704,20
0.458,1e-05,893,911,2,2,0.0001,1804,20
0.46,1e-05,948,956,2,2,0.0001,1904,20
0.458,1e-05,994,1010,2,2,0.0001,2004,20
0.516,1e-05,50,54,2,2,0.001,104,1
0.516,1e-05,101,103,2,2,0.001,204,1
0.516,1e-05,156,148,2,2,0.001,304,1
0.516,1e-05,200,204,2,2,0.001,404,1
0.516,1e-05,246,258,2,2,0.001,504,1
0.516,1e-05,298,306,2,2,0.001,604,1
0.516,1e-05,353,351,2,2,0.001,704,1
0.516,1e-05,405,399,2,2,0.001,804,1
0.516,1e-05,454,450,2,2,0.001,904,1
0.516,1e-05,505,499,2,2,0.001,1004,1
0.516,1e-05,560,544,2,2,0.001,1104,1
0.516,1e-05,610,594,2,2,0.001,1204,1
0.516,1e-05,660,644,2,2,0.001,1304,1
0.516,1e-05,710,694,2,2,0.001,1404,1
0.516,1e-05,758,746,2,2,0.001,1504,1
0.516,1e-05,805,799,2,2,0.001,1604,1
0.516,1e-05,857,847,2,2,0.001,1704,1
0.516,1e-05,902,902,2,2,0.001,1804,1
0.516,1e-05,952,952,2,2,0.001,1904,1
0.516,1e-05,994,1010,2,2,0.001,2004,1
0.478,1e-05,48,56,2,2,0.001,104,2
0.474,1e-05,102,102,2,2,0.001,204,2
0.476,1e-05,149,155,2,2,0.001,304,2
0.48,1e-05,199,205,2,2,0.001,404,2
0.482,1e-05,248,256,2,2,0.001,504,2
0.48,1e-05,301,303,2,2,0.001,604,2
0.474,1e-05,362,342,2,2,0.001,704,2
0.474,1e-05,411,393,2,2,0.001,804,2
0.48,1e-05,462,442,2,2,0.001,904,2
0.486,1e-05,515,489,2,2,0.001,1004,2
0.484,1e-05,563,541,2,2,0.001,1104,2
0.476,1e-05,611,593,2,2,0.001,1204,2
0.488,1e-05,655,649,2,2,0.001,1304,2
0.494,1e-05,704,700,2,2,0.001,1404,2
0.49,1e-05,760,744,2,2,0.001,1504,2
0.498,1e-05,810,794,2,2,0.001,1604,2
0.494,1e-05,864,840,2,2,0.001,1704,2
0.498,1e-05,915,889,2,2,0.001,1804,2
0.5,1e-05,973,931,2,2,0.001,1904,2
0.498,1e-05,1018,986,2,2,0.001,2004,2
0.476,1e-05,58,46,2,2,0.001,104,3
0.476,1e-05,110,94,2,2,0.001,204,3
0.476,1e-05,156,148,2,2,0.001,304,3
0.474,1e-05,208,196,2,2,0.001,404,3
0.474,1e-05,261,243,2,2,0.001,504,3
0.472,1e-05,312,292,2,2,0.001,604,3
0.47,1e-05,365,339,2,2,0.001,704,3
0.468,1e-05,418,386,2,2,0.001,804,3
0.464,1e-05,468,436,2,2,0.001,904,3
0.464,1e-05,518,486,2,2,0.001,1004,3
0.464,1e-05,567,537,2,2,0.001,1104,3
0.462,1e-05,616,588,2,2,0.001,1204,3
0.462,1e-05,663,641,2,2,0.001,1304,3
0.46,1e-05,720,684,2,2,0.001,1404,3
0.46,1e-05,766,738,2,2,0.001,1504,3
0.458,1e-05,819,785,2,2,0.001,1604,3
0.452,1e-05,870,834,2,2,0.001,1704,3
0.448,1e-05,918,886,2,2,0.001,1804,3
0.442,1e-05,965,939,2,2,0.001,1904,3
0.44,1e-05,1007,997,2,2,0.001,2004,3
0.506,1e-05,51,53,2,2,0.001,104,4
0.506,1e-05,104,100,2,2,0.001,204,4
0.506,1e-05,146,158,2,2,0.001,304,4
0.506,1e-05,193,211,2,2,0.001,404,4
0.506,1e-05,242,262,2,2,0.001,504,4
0.506,1e-05,295,309,2,2,0.001,604,4
0.506,1e-05,351,353,2,2,0.001,704,4
0.506,1e-05,408,396,2,2,0.001,804,4
0.506,1e-05,452,452,2,2,0.001,904,4
0.506,1e-05,505,499,2,2,0.001,1004,4
0.506,1e-05,553,551,2,2,0.001,1104,4
0.506,1e-05,598,606,2,2,0.001,1204,4
0.506,1e-05,651,653,2,2,0.001,1304,4
0.506,1e-05,697,707,2,2,0.001,1404,4
0.506,1e-05,752,752,2,2,0.001,1504,4
0.506,1e-05,796,808,2,2,0.001,1604,4
0.506,1e-05,847,857,2,2,0.001,1704,4
0.506,1e-05,900,904,2,2,0.001,1804,4
0.506,1e-05,949,955,2,2,0.001,1904,4
0.506,1e-05,1005,999,2,2,0.001,2004,4
0.454,1e-05,52,52,2,2,0.001,104,5
0.454,1e-05,95,109,2,2,0.001,204,5
0.454,1e-05,142,162,2,2,0.001,304,5
0.454,1e-05,200,204,2,2,0.001,404,5
0.454,1e-05,249,255,2,2,0.001,504,5
0.454,1e-05,301,303,2,2,0.001,604,5
0.454,1e-05,350,354,2,2,0.001,704,5
0.454,1e-05,402,402,2,2,0.001,804,5
0.454,1e-05,450,454,2,2,0.001,904,5
0.454,1e-05,509,495,2,2,0.001,1004,5
0.454,1e-05,561,543,2,2,0.001,1104,5
0.454,1e-05,613,591,2,2,0.001,1204,5
0.454,1e-05,672,632,2,2,0.001,1304,5
0.454,1e-05,713,691,2,2,0.001,1404,5
0.454,1e-05,760,744,2,2,0.001,1504,5
0.454,1e-05,813,791,2,2,0.001,1604,5
0.454,1e-05,872,832,2,2,0.001,1704,5
0.454,1e-05,924,880,2,2,0.001,1804,5
0.454,1e-05,975,929,2,2,0.001,1904,5
0.454,1e-05,1025,979,2,2,0.001,2004,5
0.504,1e-05,41,63,2,2,0.001,104,6
0.504,1e-05,92,112,2,2,0.001,204,6
0.504,1e-05,147,157,2,2,0.001,304,6
0.504,1e-05,191,213,2,2,0.001,404,6
0.504,1e-05,238,266,2,2,0.001,504,6
0.504,1e-05,295,309,2,2,0.001,604,6
0.504,1e-05,353,351,2,2,0.001,704,6
0.504,1e-05,402,402,2,2,0.001,804,6
0.504,1e-05,449,455,2,2,0.001,904,6
0.504,1e-05,510,494,2,2,0.001,1004,6
0.504,1e-05,554,550,2,2,0.001,1104,6
0.504,1e-05,600,604,2,2,0.001,1204,6
0.504,1e-05,644,660,2,2,0.001,1304,6
0.464,1e-05,694,710,2,2,0.001,1404,6
0.464,1e-05,737,767,2,2,0.001,1504,6
0.462,1e-05,797,807,2,2,0.001,1604,6
0.462,1e-05,844,860,2,2,0.001,1704,6
0.458,1e-05,903,901,2,2,0.001,1804,6
0.458,1e-05,952,952,2,2,0.001,1904,6
0.458,1e-05,1000,1004,2,2,0.001,2004,6
0.51,1e-05,55,49,2,2,0.001,104,7
0.51,1e-05,109,95,2,2,0.001,204,7
0.51,1e-05,154,150,2,2,0.001,304,7
0.51,1e-05,204,200,2,2,0.001,404,7
0.51,1e-05,257,247,2,2,0.001,504,7
0.51,1e-05,302,302,2,2,0.001,604,7
0.51,1e-05,356,348,2,2,0.001,704,7
0.51,1e-05,406,398,2,2,0.001,804,7
0.51,1e-05,458,446,2,2,0.001,904,7
0.51,1e-05,514,490,2,2,0.001,1004,7
0.51,1e-05,561,543,2,2,0.001,1104,7
0.51,1e-05,604,600,2,2,0.001,1204,7
0.51,1e-05,644,660,2,2,0.001,1304,7
0.51,1e-05,685,719,2,2,0.001,1404,7
0.51,1e-05,741,763,2,2,0.001,1504,7
0.51,1e-05,798,806,2,2,0.001,1604,7
0.51,1e-05,851,853,2,2,0.001,1704,7
0.51,1e-05,907,897,2,2,0.001,1804,7
0.51,1e-05,951,953,2,2,0.001,1904,7
0.51,1e-05,1007,997,2,2,0.001,2004,7
0.49,1e-05,54,50,2,2,0.001,104,8
0.49,1e-05,103,101,2,2,0.001,204,8
0.49,1e-05,151,153,2,2,0.001,304,8
0.49,1e-05,193,211,2,2,0.001,404,8
0.49,1e-05,243,261,2,2,0.001,504,8
0.49,1e-05,286,318,2,2,0.001,604,8
0.49,1e-05,327,377,2,2,0.001,704,8
0.49,1e-05,382,422,2,2,0.001,804,8
0.49,1e-05,435,469,2,2,0.001,904,8
0.49,1e-05,484,520,2,2,0.001,1004,8
0.49,1e-05,532,572,2,2,0.001,1104,8
0.49,1e-05,586,618,2,2,0.001,1204,8
0.49,1e-05,644,660,2,2,0.001,1304,8
0.49,1e-05,699,705,2,2,0.001,1404,8
0.49,1e-05,755,749,2,2,0.001,1504,8
0.49,1e-05,802,802,2,2,0.001,1604,8
0.49,1e-05,858,846,2,2,0.001,1704,8
0.49,1e-05,910,894,2,2,0.001,1804,8
0.49,1e-05,958,946,2,2,0.001,1904,8
0.49,1e-05,1007,997,2,2,0.001,2004,8
0.518,1e-05,58,46,2,2,0.001,104,9
0.518,1e-05,105,99,2,2,0.001,204,9
0.518,1e-05,158,146,2,2,0.001,304,9
0.518,1e-05,199,205,2,2,0.001,404,9
0.518,1e-05,257,247,2,2,0.001,504,9
0.518,1e-05,310,294,2,2,0.001,604,9
0.518,1e-05,360,344,2,2,0.001,704,9
0.518,1e-05,418,386,2,2,0.001,804,9
0.518,1e-05,468,436,2,2,0.001,904,9
0.52,1e-05,514,490,2,2,0.001,1004,9
0.52,1e-05,558,546,2,2,0.001,1104,9
0.52,1e-05,601,603,2,2,0.001,1204,9
0.52,1e-05,653,651,2,2,0.001,1304,9
0.522,1e-05,702,702,2,2,0.001,1404,9
0.522,1e-05,750,754,2,2,0.001,1504,9
0.528,1e-05,800,804,2,2,0.001,1604,9
0.536,1e-05,843,861,2,2,0.001,1704,9
0.538,1e-05,906,898,2,2,0.001,1804,9
0.54,1e-05,958,946,2,2,0.001,1904,9
0.546,1e-05,1011,993,2,2,0.001,2004,9
0.418,1e-05,53,51,2,2,0.001,104,10
0.42,1e-05,97,107,2,2,0.001,204,10
0.422,1e-05,153,151,2,2,0.001,304,10
0.422,1e-05,211,193,2,2,0.001,404,10
0.422,1e-05,255,249,2,2,0.001,504,10
0.426,1e-05,312,292,2,2,0.001,604,10
0.43,1e-05,358,346,2,2,0.001,704,10
0.438,1e-05,409,395,2,2,0.001,804,10
0.442,1e-05,459,445,2,2,0.001,904,10
0.444,1e-05,509,495,2,2,0.001,1004,10
0.448,1e-05,565,539,2,2,0.001,1104,10
0.452,1e-05,613,591,2,2,0.001,1204,10
0.452,1e-05,655,649,2,2,0.001,1304,10
0.456,1e-05,704,700,2,2,0.001,1404,10
0.472,1e-05,758,746,2,2,0.001,1504,10
0.468,1e-05,814,790,2,2,0.001,1604,10
0.476,1e-05,873,831,2,2,0.001,1704,10
0.474,1e-05,908,896,2,2,0.001,1804,10
0.474,1e-05,956,948,2,2,0.001,1904,10
0.474,1e-05,1006,998,2,2,0.001,2004,10
0.528,1e-05,57,47,2,2,0.001,104,11
0.528,1e-05,106,98,2,2,0.001,204,11
0.528,1e-05,157,147,2,2,0.001,304,11
0.528,1e-05,211,193,2,2,0.001,404,11
0.528,1e-05,261,243,2,2,0.001,504,11
0.528,1e-05,308,296,2,2,0.001,604,11
0.528,1e-05,363,341,2,2,0.001,704,11
0.528,1e-05,415,389,2,2,0.001,804,11
0.528,1e-05,467,437,2,2,0.001,904,11
0.528,1e-05,506,498,2,2,0.001,1004,11
0.528,1e-05,555,549,2,2,0.001,1104,11
0.528,1e-05,607,597,2,2,0.001,1204,11
0.528,1e-05,661,643,2,2,0.001,1304,11
0.528,1e-05,702,702,2,2,0.001,1404,11
0.528,1e-05,762,742,2,2,0.001,1504,11
0.528,1e-05,809,795,2,2,0.001,1604,11
0.528,1e-05,855,849,2,2,0.001,1704,11
0.528,1e-05,915,889,2,2,0.001,1804,11
0.528,1e-05,958,946,2,2,0.001,1904,11
0.528,1e-05,1016,988,2,2,0.001,2004,11
0.512,1e-05,46,58,2,2,0.001,104,12
0.512,1e-05,96,108,2,2,0.001,204,12
0.512,1e-05,147,157,2,2,0.001,304,12
0.512,1e-05,195,209,2,2,0.001,404,12
0.512,1e-05,246,258,2,2,0.001,504,12
0.512,1e-05,289,315,2,2,0.001,604,12
0.512,1e-05,339,365,2,2,0.001,704,12
0.512,1e-05,387,417,2,2,0.001,804,12
0.512,1e-05,435,469,2,2,0.001,904,12
0.512,1e-05,486,518,2,2,0.001,1004,12
0.512,1e-05,538,566,2,2,0.001,1104,12
0.512,1e-05,585,619,2,2,0.001,1204,12
0.512,1e-05,638,666,2,2,0.001,1304,12
0.512,1e-05,693,711,2,2,0.001,1404,12
0.512,1e-05,745,759,2,2,0.001,1504,12
0.512,1e-05,793,811,2,2,0.001,1604,12
0.512,1e-05,854,850,2,2,0.001,1704,12
0.512,1e-05,902,902,2,2,0.001,1804,12
0.512,1e-05,956,948,2,2,0.001,1904,12
0.512,1e-05,1008,996,2,2,0.001,2004,12
0.512,1e-05,53,51,2,2,0.001,104,13
0.512,1e-05,101,103,2,2,0.001,204,13
0.512,1e-05,152,152,2,2,0.001,304,13
0.512,1e-05,209,195,2,2,0.001,404,13
0.512,1e-05,260,244,2,2,0.001,504,13
0.512,1e-05,303,301,2,2,0.001,604,13
0.512,1e-05,352,352,2,2,0.001,704,13
0.512,1e-05,400,404,2,2,0.001,804,13
0.512,1e-05,444,460,2,2,0.001,904,13
0.512,1e-05,494,510,2,2,0.001,1004,13
0.512,1e-05,547,557,2,2,0.001,1104,13
0.512,1e-05,601,603,2,2,0.001,1204,13
0.512,1e-05,649,655,2,2,0.001,1304,13
0.512,1e-05,696,708,2,2,0.001,1404,13
0.512,1e-05,751,753,2,2,0.001,1504,13
0.512,1e-05,797,807,2,2,0.001,1604,13
0.512,1e-05,847,857,2,2,0.001,1704,13
0.512,1e-05,903,901,2,2,0.001,1804,13
0.512,1e-05,957,947,2,2,0.001,1904,13
0.512,1e-05,1008,996,2,2,0.001,2004,13
0.476,1e-05,50,54,2,2,0.001,104,14
0.476,1e-05,101,103,2,2,0.001,204,14
0.476,1e-05,148,156,2,2,0.001,304,14
0.476,1e-05,200,204,2,2,0.001,404,14
0.476,1e-05,253,251,2,2,0.001,504,14
0.476,1e-05,310,294,2,2,0.001,604,14
0.476,1e-05,354,350,2,2,0.001,704,14
0.476,1e-05,409,395,2,2,0.001,804,14
0.476,1e-05,465,439,2,2,0.001,904,14
0.476,1e-05,516,488,2,2,0.001,1004,14
0.476,1e-05,557,547,2,2,0.001,1104,14
0.476,1e-05,600,604,2,2,0.001,1204,14
0.476,1e-05,652,652,2,2,0.001,1304,14
0.476,1e-05,699,705,2,2,0.001,1404,14
0.476,1e-05,753,751,2,2,0.001,1504,14
0.476,1e-05,808,796,2,2,0.001,1604,14
0.476,1e-05,862,842,2,2,0.001,1704,14
0.476,1e-05,913,891,2,2,0.001,1804,14
0.476,1e-05,958,946,2,2,0.001,1904,14
0.476,1e-05,1014,990,2,2,0.001,2004,14
0.492,1e-05,55,49,2,2,0.001,104,15
0.492,1e-05,113,91,2,2,0.001,204,15
0.492,1e-05,156,148,2,2,0.001,304,15
0.486,1e-05,207,197,2,2,0.001,404,15
0.482,1e-05,259,245,2,2,0.001,504,15
0.482,1e-05,315,289,2,2,0.001,604,15
0.482,1e-05,366,338,2,2,0.001,704,15
0.484,1e-05,412,392,2,2,0.001,804,15
0.482,1e-05,466,438,2,2,0.001,904,15
0.482,1e-05,525,479,2,2,0.001,1004,15
0.488,1e-05,580,524,2,2,0.001,1104,15
0.488,1e-05,633,571,2,2,0.001,1204,15
0.488,1e-05,676,628,2,2,0.001,1304,15
0.494,1e-05,723,681,2,2,0.001,1404,15
0.494,1e-05,776,728,2,2,0.001,1504,15
0.494,1e-05,825,779,2,2,0.001,1604,15
0.492,1e-05,868,836,2,2,0.001,1704,15
0.492,1e-05,918,886,2,2,0.001,1804,15
0.492,1e-05,969,935,2,2,0.001,1904,15
0.492,1e-05,1015,989,2,2,0.001,2004,15
0.528,1e-05,51,53,2,2,0.001,104,16
0.528,1e-05,105,99,2,2,0.001,204,16
0.528,1e-05,163,141,2,2,0.001,304,16
0.528,1e-05,217,187,2,2,0.001,404,16
0.528,1e-05,265,239,2,2,0.001,504,16
0.528,1e-05,314,290,2,2,0.001,604,16
0.528,1e-05,362,342,2,2,0.001,704,16
0.528,1e-05,403,401,2,2,0.001,804,16
0.528,1e-05,445,459,2,2,0.001,904,16
0.528,1e-05,505,499,2,2,0.001,1004,16
0.528,1e-05,557,547,2,2,0.001,1104,16
0.528,1e-05,601,603,2,2,0.001,1204,16
0.528,1e-05,651,653,2,2,0.001,1304,16
0.528,1e-05,699,705,2,2,0.001,1404,16
0.528,1e-05,745,759,2,2,0.001,1504,16
0.528,1e-05,796,808,2,2,0.001,1604,16
0.528,1e-05,851,853,2,2,0.001,1704,16
0.528,1e-05,899,905,2,2,0.001,1804,16
0.528,1e-05,954,950,2,2,0.001,1904,16
0.528,1e-05,1016,988,2,2,0.001,2004,16
0.484,1e-05,52,52,2,2,0.001,104,17
0.484,1e-05,108,96,2,2,0.001,204,17
0.484,1e-05,163,141,2,2,0.001,304,17
0.484,1e-05,219,185,2,2,0.001,404,17
0.484,1e-05,261,243,2,2,0.001,504,17
0.484,1e-05,318,286,2,2,0.001,604,17
0.484,1e-05,366,338,2,2,0.001,704,17
0.484,1e-05,424,380,2,2,0.001,804,17
0.484,1e-05,475,429,2,2,0.001,904,17
0.484,1e-05,526,478,2,2,0.001,1004,17
0.484,1e-05,569,535,2,2,0.001,1104,17
0.484,1e-05,618,586,2,2,0.001,1204,17
0.484,1e-05,668,636,2,2,0.001,1304,17
0.484,1e-05,714,690,2,2,0.001,1404,17
0.484,1e-05,765,739,2,2,0.001,1504,17
0.484,1e-05,811,793,2,2,0.001,1604,17
0.484,1e-05,863,841,2,2,0.001,1704,17
0.484,1e-05,918,886,2,2,0.001,1804,17
0.484,1e-05,953,951,2,2,0.001,1904,17
0.484,1e-05,994,1010,2,2,0.001,2004,17
0.488,1e-05,51,53,2,2,0.001,104,18
0.488,1e-05,100,104,2,2,0.001,204,18
0.488,1e-05,154,150,2,2,0.001,304,18
0.488,1e-05,212,192,2,2,0.001,404,18
0.488,1e-05,264,240,2,2,0.001,504,18
0.488,1e-05,310,294,2,2,0.001,604,18
0.488,1e-05,362,342,2,2,0.001,704,18
0.488,1e-05,406,398,2,2,0.001,804,18
0.488,1e-05,462,442,2,2,0.001,904,18
0.488,1e-05,514,490,2,2,0.001,1004,18
0.488,1e-05,557,547,2,2,0.001,1104,18
0.488,1e-05,609,595,2,2,0.001,1204,18
0.488,1e-05,651,653,2,2,0.001,1304,18
0.488,1e-05,701,703,2,2,0.001,1404,18
0.488,1e-05,751,753,2,2,0.001,1504,18
0.488,1e-05,802,802,2,2,0.001,1604,18
0.488,1e-05,854,850,2,2,0.001,1704,18
0.488,1e-05,907,897,2,2,0.001,1804,18
0.488,1e-05,956,948,2,2,0.001,1904,18
0.488,1e-05,1008,996,2,2,0.001,2004,18
0.49,1e-05,49,55,2,2,0.001,104,19
0.492,1e-05,103,101,2,2,0.001,204,19
0.49,1e-05,149,155,2,2,0.001,304,19
0.492,1e-05,197,207,2,2,0.001,404,19
0.484,1e-05,243,261,2,2,0.001,504,19
0.49,1e-05,289,315,2,2,0.001,604,19
0.488,1e-05,339,365,2,2,0.001,704,19
0.486,1e-05,389,415,2,2,0.001,804,19
0.484,1e-05,438,466,2,2,0.001,904,19
0.486,1e-05,487,517,2,2,0.001,1004,19
0.474,1e-05,535,569,2,2,0.001,1104,19
0.494,1e-05,589,615,2,2,0.001,1204,19
0.492,1e-05,636,668,2,2,0.001,1304,19
0.486,1e-05,689,715,2,2,0.001,1404,19
0.494,1e-05,732,772,2,2,0.001,1504,19
0.496,1e-05,783,821,2,2,0.001,1604,19
0.49,1e-05,833,871,2,2,0.001,1704,19
0.482,1e-05,892,912,2,2,0.001,1804,19
0.488,1e-05,945,959,2,2,0.001,1904,19
0.494,1e-05,1009,995,2,2,0.001,2004,19
0.52,1e-05,52,52,2,2,0.001,104,20
0.524,1e-05,96,108,2,2,0.001,204,20
0.528,1e-05,149,155,2,2,0.001,304,20
0.526,1e-05,203,201,2,2,0.001,404,20
0.526,1e-05,252,252,2,2,0.001,504,20
0.528,1e-05,297,307,2,2,0.001,604,20
0.532,1e-05,350,354,2,2,0.001,704,20
0.532,1e-05,399,405,2,2,0.001,804,20
0.532,1e-05,450,454,2,2,0.001,904,20
0.532,1e-05,500,504,2,2,0.001,1004,20
0.536,1e-05,558,546,2,2,0.001,1104,20
0.544,1e-05,604,600,2,2,0.001,1204,20
0.54,1e-05,656,648,2,2,0.001,1304,20
0.546,1e-05,700,704,2,2,0.001,1404,20
0.546,1e-05,751,753,2,2,0.001,1504,20
0.554,1e-05,791,813,2,2,0.001,1604,20
0.558,1e-05,845,859,2,2,0.001,1704,20
0.564,1e-05,898,906,2,2,0.001,1804,20
0.578,1e-05,948,956,2,2,0.001,1904,20
0.576,1e-05,994,1010,2,2,0.001,2004,20
0.524,1e-05,51,53,2,2,0.01,104,1
0.524,1e-05,106,98,2,2,0.01,204,1
0.524,1e-05,157,147,2,2,0.01,304,1
0.524,1e-05,213,191,2,2,0.01,404,1
0.524,1e-05,266,238,2,2,0.01,504,1
0.524,1e-05,314,290,2,2,0.01,604,1
0.524,1e-05,370,334,2,2,0.01,704,1
0.524,1e-05,428,376,2,2,0.01,804,1
0.524,1e-05,482,422,2,2,0.01,904,1
0.524,1e-05,531,473,2,2,0.01,1004,1
0.524,1e-05,579,525,2,2,0.01,1104,1
0.532,1e-05,626,578,2,2,0.01,1204,1
0.56,1e-05,669,635,2,2,0.01,1304,1
0.57,1e-05,719,685,2,2,0.01,1404,1
0.552,1e-05,767,737,2,2,0.01,1504,1
0.57,1e-05,811,793,2,2,0.01,1604,1
0.614,1e-05,864,840,2,2,0.01,1704,1
0.596,1e-05,912,892,2,2,0.01,1804,1
0.584,1e-05,961,943,2,2,0.01,1904,1
0.602,1e-05,1014,990,2,2,0.01,2004,1
0.508,1e-05,58,46,2,2,0.01,104,2
0.508,1e-05,101,103,2,2,0.01,204,2
0.51,1e-05,157,147,2,2,0.01,304,2
0.492,1e-05,211,193,2,2,0.01,404,2
0.514,1e-05,256,248,2,2,0.01,504,2
0.55,1e-05,301,303,2,2,0.01,604,2
0.572,1e-05,340,364,2,2,0.01,704,2
0.594,1e-05,393,411,2,2,0.01,804,2
0.614,1e-05,440,464,2,2,0.01,904,2
0.634,1e-05,493,511,2,2,0.01,1004,2
0.642,1e-05,547,557,2,2,0.01,1104,2
0.658,1e-05,595,609,2,2,0.01,1204,2
0.686,1e-05,646,658,2,2,0.01,1304,2
0.728,1e-05,708,696,2,2,0.01,1404,2
0.726,1e-05,759,745,2,2,0.01,1504,2
0.738,1e-05,811,793,2,2,0.01,1604,2
0.75,1e-05,855,849,2,2,0.01,1704,2
0.752,1e-05,906,898,2,2,0.01,1804,2
0.752,1e-05,956,948,2,2,0.01,1904,2
0.754,1e-05,1006,998,2,2,0.01,2004,2
0.49,1e-05,65,39,2,2,0.01,104,3
0.49,1e-05,118,86,2,2,0.01,204,3
0.49,1e-05,166,138,2,2,0.01,304,3
0.49,1e-05,220,184,2,2,0.01,404,3
0.49,1e-05,276,228,2,2,0.01,504,3
0.49,1e-05,327,277,2,2,0.01,604,3
0.49,1e-05,379,325,2,2,0.01,704,3
0.49,1e-05,425,379,2,2,0.01,804,3
0.49,1e-05,468,436,2,2,0.01,904,3
0.49,1e-05,512,492,2,2,0.01,1004,3
0.49,1e-05,567,537,2,2,0.01,1104,3
0.49,1e-05,609,595,2,2,0.01,1204,3
0.488,1e-05,661,643,2,2,0.01,1304,3
0.494,1e-05,711,693,2,2,0.01,1404,3
0.484,1e-05,759,745,2,2,0.01,1504,3
0.494,1e-05,806,798,2,2,0.01,1604,3
0.512,1e-05,856,848,2,2,0.01,1704,3
0.526,1e-05,905,899,2,2,0.01,1804,3
0.546,1e-05,951,953,2,2,0.01,1904,3
0.548,1e-05,1007,997,2,2,0.01,2004,3
0.482,1e-05,67,37,2,2,0.01,104,4
0.482,1e-05,122,82,2,2,0.01,204,4
0.482,1e-05,173,131,2,2,0.01,304,4
0.482,1e-05,230,174,2,2,0.01,404,4
0.482,1e-05,274,230,2,2,0.01,504,4
0.482,1e-05,318,286,2,2,0.01,604,4
0.482,1e-05,365,339,2,2,0.01,704,4
0.482,1e-05,406,398,2,2,0.01,804,4
0.482,1e-05,453,451,2,2,0.01,904,4
0.482,1e-05,497,507,2,2,0.01,1004,4
0.482,1e-05,556,548,2,2,0.01,1104,4
0.482,1e-05,607,597,2,2,0.01,1204,4
0.482,1e-05,657,647,2,2,0.01,1304,4
0.482,1e-05,711,693,2,2,0.01,1404,4
0.482,1e-05,757,747,2,2,0.01,1504,4
0.482,1e-05,805,799,2,2,0.01,1604,4
0.482,1e-05,853,851,2,2,0.01,1704,4
0.482,1e-05,895,909,2,2,0.01,1804,4
0.482,1e-05,939,965,2,2,0.01,1904,4
0.482,1e-05,993,1011,2,2,0.01,2004,4
0.542,1e-05,55,49,2,2,0.01,104,5
0.542,1e-05,107,97,2,2,0.01,204,5
0.542,1e-05,157,147,2,2,0.01,304,5
0.542,1e-05,207,197,2,2,0.01,404,5
0.542,1e-05,260,244,2,2,0.01,504,5
0.542,1e-05,308,296,2,2,0.01,604,5
0.542,1e-05,358,346,2,2,0.01,704,5
0.542,1e-05,409,395,2,2,0.01,804,5
0.542,1e-05,454,450,2,2,0.01,904,5
0.542,1e-05,502,502,2,2,0.01,1004,5
0.542,1e-05,551,553,2,2,0.01,1104,5
0.528,1e-05,596,608,2,2,0.01,1204,5
0.498,1e-05,639,665,2,2,0.01,1304,5
0.496,1e-05,684,720,2,2,0.01,1404,5
0.532,1e-05,729,775,2,2,0.01,1504,5
0.52,1e-05,787,817,2,2,0.01,1604,5
0.432,1e-05,842,862,2,2,0.01,1704,5
0.41,1e-05,889,915,2,2,0.01,1804,5
0.446,1e-05,941,963,2,2,0.01,1904,5
0.418,1e-05,981,1023,2,2,0.01,2004,5
0.548,1e-05,58,46,2,2,0.01,104,6
0.556,1e-05,104,100,2,2,0.01,204,6
0.556,1e-05,157,147,2,2,0.01,304,6
0.56,1e-05,202,202,2,2,0.01,404,6
0.568,1e-05,254,250,2,2,0.01,504,6
0.578,1e-05,293,311,2,2,0.01,604,6
0.588,1e-05,347,357,2,2,0.01,704,6
0.6,1e-05,402,402,2,2,0.01,804,6
0.612,1e-05,451,453,2,2,0.01,904,6
0.62,1e-05,497,507,2,2,0.01,1004,6
0.646,1e-05,544,560,2,2,0.01,1104,6
0.664,1e-05,591,613,2,2,0.01,1204,6
0.676,1e-05,643,661,2,2,0.01,1304,6
0.678,1e-05,695,709,2,2,0.01,1404,6
0.682,1e-05,751,753,2,2,0.01,1504,6
0.702,1e-05,803,801,2,2,0.01,1604,6
0.716,1e-05,856,848,2,2,0.01,1704,6
0.728,1e-05,912,892,2,2,0.01,1804,6
0.734,1e-05,962,942,2,2,0.01,1904,6
0.736,1e-05,1012,992,2,2,0.01,2004,6
0.404,1e-05,58,46,2,2,0.01,104,7
0.402,1e-05,104,100,2,2,0.01,204,7
0.398,1e-05,146,158,2,2,0.01,304,7
0.372,1e-05,188,216,2,2,0.01,404,7
0.352,1e-05,233,271,2,2,0.01,504,7
0.318,1e-05,287,317,2,2,0.01,604,7
0.38,1e-05,337,367,2,2,0.01,704,7
0.438,1e-05,392,412,2,2,0.01,804,7
0.452,1e-05,440,464,2,2,0.01,904,7
0.522,1e-05,496,508,2,2,0.01,1004,7
0.61,1e-05,545,559,2,2,0.01,1104,7
0.604,1e-05,599,605,2,2,0.01,1204,7
0.618,1e-05,652,652,2,2,0.01,1304,7
0.628,1e-05,703,701,2,2,0.01,1404,7
0.642,1e-05,757,747,2,2,0.01,1504,7
0.704,1e-05,809,795,2,2,0.01,1604,7
0.626,1e-05,866,838,2,2,0.01,1704,7
0.65,1e-05,906,898,2,2,0.01,1804,7
0.718,1e-05,947,957,2,2,0.01,1904,7
0.824,1e-05,994,1010,2,2,0.01,2004,7
0.5,1e-05,54,50,2,2,0.01,104,8
0.496,1e-05,108,96,2,2,0.01,204,8
0.494,1e-05,168,136,2,2,0.01,304,8
0.496,1e-05,215,189,2,2,0.01,404,8
0.504,1e-05,267,237,2,2,0.01,504,8
0.51,1e-05,318,286,2,2,0.01,604,8
0.524,1e-05,362,342,2,2,0.01,704,8
0.528,1e-05,405,399,2,2,0.01,804,8
0.528,1e-05,459,445,2,2,0.01,904,8
0.538,1e-05,512,492,2,2,0.01,1004,8
0.554,1e-05,562,542,2,2,0.01,1104,8
0.58,1e-05,609,595,2,2,0.01,1204,8
0.614,1e-05,658,646,2,2,0.01,1304,8
0.636,1e-05,708,696,2,2,0.01,1404,8
0.698,1e-05,756,748,2,2,0.01,1504,8
0.712,1e-05,806,798,2,2,0.01,1604,8
0.714,1e-05,859,845,2,2,0.01,1704,8
0.716,1e-05,907,897,2,2,0.01,1804,8
0.718,1e-05,964,940,2,2,0.01,1904,8
0.726,1e-05,1010,994,2,2,0.01,2004,8
0.58,1e-05,55,49,2,2,0.01,104,9
0.554,1e-05,110,94,2,2,0.01,204,9
0.536,1e-05,160,144,2,2,0.01,304,9
0.502,1e-05,200,204,2,2,0.01,404,9
0.49,1e-05,248,256,2,2,0.01,504,9
0.478,1e-05,287,317,2,2,0.01,604,9
0.476,1e-05,344,360,2,2,0.01,704,9
0.492,1e-05,398,406,2,2,0.01,804,9
0.52,1e-05,447,457,2,2,0.01,904,9
0.586,1e-05,489,515,2,2,0.01,1004,9
0.582,1e-05,543,561,2,2,0.01,1104,9
0.558,1e-05,598,606,2,2,0.01,1204,9
0.544,1e-05,649,655,2,2,0.01,1304,9
0.562,1e-05,693,711,2,2,0.01,1404,9
0.716,1e-05,755,749,2,2,0.01,1504,9
0.734,1e-05,803,801,2,2,0.01,1604,9
0.554,1e-05,857,847,2,2,0.01,1704,9
0.306,1e-05,905,899,2,2,0.01,1804,9
0.364,1e-05,950,954,2,2,0.01,1904,9
0.336,1e-05,1003,1001,2,2,0.01,2004,9
0.516,1e-05,51,53,2,2,0.01,104,10
0.514,1e-05,103,101,2,2,0.01,204,10
0.516,1e-05,148,156,2,2,0.01,304,10
0.516,1e-05,195,209,2,2,0.01,404,10
0.512,1e-05,247,257,2,2,0.01,504,10
0.512,1e-05,296,308,2,2,0.01,604,10
0.52,1e-05,345,359,2,2,0.01,704,10
0.524,1e-05,390,414,2,2,0.01,804,10
0.534,1e-05,435,469,2,2,0.01,904,10
0.54,1e-05,491,513,2,2,0.01,1004,10
0.54,1e-05,546,558,2,2,0.01,1104,10
0.564,1e-05,594,610,2,2,0.01,1204,10
0.58,1e-05,639,665,2,2,0.01,1304,10
0.598,1e-05,696,708,2,2,0.01,1404,10
0.628,1e-05,752,752,2,2,0.01,1504,10
0.67,1e-05,796,808,2,2,0.01,1604,10
0.684,1e-05,849,855,2,2,0.01,1704,10
0.714,1e-05,902,902,2,2,0.01,1804,10
0.734,1e-05,952,952,2,2,0.01,1904,10
0.734,1e-05,1001,1003,2,2,0.01,2004,10
0.514,1e-05,51,53,2,2,0.01,104,11
0.514,1e-05,100,104,2,2,0.01,204,11
0.514,1e-05,149,155,2,2,0.01,304,11
0.514,1e-05,192,212,2,2,0.01,404,11
0.514,1e-05,246,258,2,2,0.01,504,11
0.514,1e-05,296,308,2,2,0.01,604,11
0.48,1e-05,349,355,2,2,0.01,704,11
0.48,1e-05,404,400,2,2,0.01,804,11
0.476,1e-05,451,453,2,2,0.01,904,11
0.466,1e-05,500,504,2,2,0.01,1004,11
0.46,1e-05,549,555,2,2,0.01,1104,11
0.478,1e-05,601,603,2,2,0.01,1204,11
0.506,1e-05,655,649,2,2,0.01,1304,11
0.514,1e-05,700,704,2,2,0.01,1404,11
0.514,1e-05,755,749,2,2,0.01,1504,11
0.53,1e-05,806,798,2,2,0.01,1604,11
0.53,1e-05,854,850,2,2,0.01,1704,11
0.596,1e-05,907,897,2,2,0.01,1804,11
0.606,1e-05,957,947,2,2,0.01,1904,11
0.616,1e-05,1009,995,2,2,0.01,2004,11
0.48,1e-05,51,53,2,2,0.01,104,12
0.48,1e-05,105,99,2,2,0.01,204,12
0.48,1e-05,154,150,2,2,0.01,304,12
0.494,1e-05,205,199,2,2,0.01,404,12
0.526,1e-05,260,244,2,2,0.01,504,12
0.532,1e-05,310,294,2,2,0.01,604,12
0.514,1e-05,359,345,2,2,0.01,704,12
0.47,1e-05,411,393,2,2,0.01,804,12
0.444,1e-05,460,444,2,2,0.01,904,12
0.468,1e-05,506,498,2,2,0.01,1004,12
0.52,1e-05,551,553,2,2,0.01,1104,12
0.65,1e-05,600,604,2,2,0.01,1204,12
0.69,1e-05,643,661,2,2,0.01,1304,12
0.742,1e-05,703,701,2,2,0.01,1404,12
0.734,1e-05,751,753,2,2,0.01,1504,12
0.774,1e-05,803,801,2,2,0.01,1604,12
0.782,1e-05,857,847,2,2,0.01,1704,12
0.814,1e-05,902,902,2,2,0.01,1804,12
0.762,1e-05,943,961,2,2,0.01,1904,12
0.782,1e-05,992,1012,2,2,0.01,2004,12
0.502,1e-05,59,45,2,2,0.01,104,13
0.502,1e-05,107,97,2,2,0.01,204,13
0.504,1e-05,148,156,2,2,0.01,304,13
0.508,1e-05,195,209,2,2,0.01,404,13
0.516,1e-05,245,259,2,2,0.01,504,13
0.528,1e-05,298,306,2,2,0.01,604,13
0.518,1e-05,346,358,2,2,0.01,704,13
0.506,1e-05,383,421,2,2,0.01,804,13
0.5,1e-05,431,473,2,2,0.01,904,13
0.486,1e-05,483,521,2,2,0.01,1004,13
0.468,1e-05,535,569,2,2,0.01,1104,13
0.464,1e-05,581,623,2,2,0.01,1204,13
0.488,1e-05,644,660,2,2,0.01,1304,13
0.512,1e-05,690,714,2,2,0.01,1404,13
0.538,1e-05,743,761,2,2,0.01,1504,13
0.55,1e-05,795,809,2,2,0.01,1604,13
0.546,1e-05,842,862,2,2,0.01,1704,13
0.564,1e-05,899,905,2,2,0.01,1804,13
0.554,1e-05,946,958,2,2,0.01,1904,13
0.556,1e-05,1001,1003,2,2,0.01,2004,13
0.48,1e-05,49,55,2,2,0.01,104,14
0.498,1e-05,91,113,2,2,0.01,204,14
0.498,1e-05,133,171,2,2,0.01,304,14
0.49,1e-05,187,217,2,2,0.01,404,14
0.494,1e-05,236,268,2,2,0.01,504,14
0.504,1e-05,281,323,2,2,0.01,604,14
0.5,1e-05,327,377,2,2,0.01,704,14
0.506,1e-05,368,436,2,2,0.01,804,14
0.508,1e-05,416,488,2,2,0.01,904,14
0.522,1e-05,473,531,2,2,0.01,1004,14
0.542,1e-05,527,577,2,2,0.01,1104,14
0.54,1e-05,578,626,2,2,0.01,1204,14
0.546,1e-05,631,673,2,2,0.01,1304,14
0.564,1e-05,684,720,2,2,0.01,1404,14
0.576,1e-05,735,769,2,2,0.01,1504,14
0.578,1e-05,798,806,2,2,0.01,1604,14
0.584,1e-05,842,862,2,2,0.01,1704,14
0.594,1e-05,889,915,2,2,0.01,1804,14
0.61,1e-05,936,968,2,2,0.01,1904,14
0.63,1e-05,991,1013,2,2,0.01,2004,14
0.492,1e-05,58,46,2,2,0.01,104,15
0.492,1e-05,102,102,2,2,0.01,204,15
0.492,1e-05,157,147,2,2,0.01,304,15
0.5,1e-05,203,201,2,2,0.01,404,15
0.51,1e-05,242,262,2,2,0.01,504,15
0.516,1e-05,298,306,2,2,0.01,604,15
0.526,1e-05,345,359,2,2,0.01,704,15
0.546,1e-05,398,406,2,2,0.01,804,15
0.542,1e-05,451,453,2,2,0.01,904,15
0.528,1e-05,497,507,2,2,0.01,1004,15
0.526,1e-05,546,558,2,2,0.01,1104,15
0.508,1e-05,600,604,2,2,0.01,1204,15
0.51,1e-05,642,662,2,2,0.01,1304,15
0.502,1e-05,687,717,2,2,0.01,1404,15
0.482,1e-05,740,764,2,2,0.01,1504,15
0.484,1e-05,786,818,2,2,0.01,1604,15
0.522,1e-05,842,862,2,2,0.01,1704,15
0.54,1e-05,889,915,2,2,0.01,1804,15
0.572,1e-05,949,955,2,2,0.01,1904,15
0.598,1e-05,1006,998,2,2,0.01,2004,15
0.49,1e-05,54,50,2,2,0.01,104,16
0.48,1e-05,104,100,2,2,0.01,204,16
0.47,1e-05,161,143,2,2,0.01,304,16
0.49,1e-05,209,195,2,2,0.01,404,16
0.498,1e-05,261,243,2,2,0.01,504,16
0.51,1e-05,300,304,2,2,0.01,604,16
0.51,1e-05,350,354,2,2,0.01,704,16
0.508,1e-05,389,415,2,2,0.01,804,16
0.512,1e-05,433,471,2,2,0.01,904,16
0.512,1e-05,486,518,2,2,0.01,1004,16
0.524,1e-05,539,565,2,2,0.01,1104,16
0.53,1e-05,591,613,2,2,0.01,1204,16
0.526,1e-05,643,661,2,2,0.01,1304,16
0.534,1e-05,696,708,2,2,0.01,1404,16
0.534,1e-05,743,761,2,2,0.01,1504,16
0.538,1e-05,788,816,2,2,0.01,1604,16
0.514,1e-05,830,874,2,2,0.01,1704,16
0.53,1e-05,887,917,2,2,0.01,1804,16
0.524,1e-05,943,961,2,2,0.01,1904,16
0.528,1e-05,991,1013,2,2,0.01,2004,16
0.554,1e-05,51,53,2,2,0.01,104,17
0.56,1e-05,90,114,2,2,0.01,204,17
0.568,1e-05,139,165,2,2,0.01,304,17
0.57,1e-05,187,217,2,2,0.01,404,17
0.572,1e-05,236,268,2,2,0.01,504,17
0.576,1e-05,294,310,2,2,0.01,604,17
0.588,1e-05,342,362,2,2,0.01,704,17
0.586,1e-05,402,402,2,2,0.01,804,17
0.592,1e-05,454,450,2,2,0.01,904,17
0.584,1e-05,511,493,2,2,0.01,1004,17
0.588,1e-05,559,545,2,2,0.01,1104,17
0.592,1e-05,611,593,2,2,0.01,1204,17
0.602,1e-05,655,649,2,2,0.01,1304,17
0.602,1e-05,703,701,2,2,0.01,1404,17
0.614,1e-05,754,750,2,2,0.01,1504,17
0.616,1e-05,804,800,2,2,0.01,1604,17
0.616,1e-05,852,852,2,2,0.01,1704,17
0.62,1e-05,903,901,2,2,0.01,1804,17
0.632,1e-05,953,951,2,2,0.01,1904,17
0.644,1e-05,1011,993,2,2,0.01,2004,17
0.486,1e-05,50,54,2,2,0.01,104,18
0.486,1e-05,96,108,2,2,0.01,204,18
0.486,1e-05,146,158,2,2,0.01,304,18
0.486,1e-05,203,201,2,2,0.01,404,18
0.486,1e-05,254,250,2,2,0.01,504,18
0.486,1e-05,304,300,2,2,0.01,604,18
0.52,1e-05,348,356,2,2,0.01,704,18
0.52,1e-05,399,405,2,2,0.01,804,18
0.498,1e-05,456,448,2,2,0.01,904,18
0.508,1e-05,505,499,2,2,0.01,1004,18
0.514,1e-05,560,544,2,2,0.01,1104,18
0.57,1e-05,608,596,2,2,0.01,1204,18
0.634,1e-05,660,644,2,2,0.01,1304,18
0.712,1e-05,712,692,2,2,0.01,1404,18
0.766,1e-05,759,745,2,2,0.01,1504,18
0.818,1e-05,809,795,2,2,0.01,1604,18
0.84,1e-05,857,847,2,2,0.01,1704,18
0.874,1e-05,906,898,2,2,0.01,1804,18
0.884,1e-05,961,943,2,2,0.01,1904,18
0.914,1e-05,1009,995,2,2,0.01,2004,18
0.51,1e-05,49,55,2,2,0.01,104,19
0.51,1e-05,103,101,2,2,0.01,204,19
0.51,1e-05,147,157,2,2,0.01,304,19
0.51,1e-05,199,205,2,2,0.01,404,19
0.51,1e-05,245,259,2,2,0.01,504,19
0.51,1e-05,300,304,2,2,0.01,604,19
0.51,1e-05,346,358,2,2,0.01,704,19
0.51,1e-05,400,404,2,2,0.01,804,19
0.51,1e-05,450,454,2,2,0.01,904,19
0.51,1e-05,500,504,2,2,0.01,1004,19
0.51,1e-05,547,557,2,2,0.01,1104,19
0.51,1e-05,596,608,2,2,0.01,1204,19
0.51,1e-05,651,653,2,2,0.01,1304,19
0.51,1e-05,701,703,2,2,0.01,1404,19
0.51,1e-05,751,753,2,2,0.01,1504,19
0.51,1e-05,798,806,2,2,0.01,1604,19
0.51,1e-05,847,857,2,2,0.01,1704,19
0.51,1e-05,895,909,2,2,0.01,1804,19
0.51,1e-05,949,955,2,2,0.01,1904,19
0.51,1e-05,1007,997,2,2,0.01,2004,19
0.606,1e-05,44,60,2,2,0.01,104,20
0.618,1e-05,99,105,2,2,0.01,204,20
0.602,1e-05,154,150,2,2,0.01,304,20
0.602,1e-05,203,201,2,2,0.01,404,20
0.586,1e-05,250,254,2,2,0.01,504,20
0.598,1e-05,290,314,2,2,0.01,604,20
0.628,1e-05,333,371,2,2,0.01,704,20
0.652,1e-05,387,417,2,2,0.01,804,20
0.642,1e-05,432,472,2,2,0.01,904,20
0.642,1e-05,488,516,2,2,0.01,1004,20
0.644,1e-05,540,564,2,2,0.01,1104,20
0.648,1e-05,589,615,2,2,0.01,1204,20
0.646,1e-05,648,656,2,2,0.01,1304,20
0.654,1e-05,714,690,2,2,0.01,1404,20
0.66,1e-05,759,745,2,2,0.01,1504,20
0.664,1e-05,806,798,2,2,0.01,1604,20
0.666,1e-05,855,849,2,2,0.01,1704,20
0.68,1e-05,901,903,2,2,0.01,1804,20
0.69,1e-05,947,957,2,2,0.01,1904,20
0.694,1e-05,990,1014,2,2,0.01,2004,20
0.596,0.0001,56,48,2,2,0.0001,104,1
0.596,0.0001,101,103,2,2,0.0001,204,1
0.596,0.0001,154,150,2,2,0.0001,304,1
0.596,0.0001,200,204,2,2,0.0001,404,1
0.596,0.0001,247,257,2,2,0.0001,504,1
0.596,0.0001,290,314,2,2,0.0001,604,1
0.596,0.0001,336,368,2,2,0.0001,704,1
0.596,0.0001,392,412,2,2,0.0001,804,1
0.598,0.0001,441,463,2,2,0.0001,904,1
0.6,0.0001,487,517,2,2,0.0001,1004,1
0.598,0.0001,537,567,2,2,0.0001,1104,1
0.598,0.0001,587,617,2,2,0.0001,1204,1
0.598,0.0001,640,664,2,2,0.0001,1304,1
0.598,0.0001,697,707,2,2,0.0001,1404,1
0.598,0.0001,745,759,2,2,0.0001,1504,1
0.598,0.0001,792,812,2,2,0.0001,1604,1
0.598,0.0001,838,866,2,2,0.0001,1704,1
0.6,0.0001,886,918,2,2,0.0001,1804,1
0.602,0.0001,936,968,2,2,0.0001,1904,1
0.6,0.0001,1000,1004,2,2,0.0001,2004,1
0.474,0.0001,45,59,2,2,0.0001,104,2
0.474,0.0001,95,109,2,2,0.0001,204,2
0.474,0.0001,148,156,2,2,0.0001,304,2
0.474,0.0001,194,210,2,2,0.0001,404,2
0.474,0.0001,241,263,2,2,0.0001,504,2
0.474,0.0001,287,317,2,2,0.0001,604,2
0.474,0.0001,336,368,2,2,0.0001,704,2
0.474,0.0001,390,414,2,2,0.0001,804,2
0.474,0.0001,443,461,2,2,0.0001,904,2
0.474,0.0001,498,506,2,2,0.0001,1004,2
0.474,0.0001,548,556,2,2,0.0001,1104,2
0.474,0.0001,604,600,2,2,0.0001,1204,2
0.474,0.0001,663,641,2,2,0.0001,1304,2
0.474,0.0001,713,691,2,2,0.0001,1404,2
0.474,0.0001,760,744,2,2,0.0001,1504,2
0.474,0.0001,820,784,2,2,0.0001,1604,2
0.474,0.0001,866,838,2,2,0.0001,1704,2
0.474,0.0001,921,883,2,2,0.0001,1804,2
0.474,0.0001,963,941,2,2,0.0001,1904,2
0.474,0.0001,1017,987,2,2,0.0001,2004,2
0.524,0.0001,58,46,2,2,0.0001,104,3
0.524,0.0001,107,97,2,2,0.0001,204,3
0.524,0.0001,154,150,2,2,0.0001,304,3
0.524,0.0001,203,201,2,2,0.0001,404,3
0.524,0.0001,250,254,2,2,0.0001,504,3
0.524,0.0001,301,303,2,2,0.0001,604,3
0.524,0.0001,352,352,2,2,0.0001,704,3
0.524,0.0001,405,399,2,2,0.0001,804,3
0.524,0.0001,462,442,2,2,0.0001,904,3
0.524,0.0001,506,498,2,2,0.0001,1004,3
0.524,0.0001,557,547,2,2,0.0001,1104,3
0.524,0.0001,604,600,2,2,0.0001,1204,3
0.524,0.0001,660,644,2,2,0.0001,1304,3
0.524,0.0001,710,694,2,2,0.0001,1404,3
0.524,0.0001,760,744,2,2,0.0001,1504,3
0.524,0.0001,812,792,2,2,0.0001,1604,3
0.524,0.0001,863,841,2,2,0.0001,1704,3
0.524,0.0001,918,886,2,2,0.0001,1804,3
0.524,0.0001,967,937,2,2,0.0001,1904,3
0.524,0.0001,1014,990,2,2,0.0001,2004,3
0.486,0.0001,52,52,2,2,0.0001,104,4
0.486,0.0001,99,105,2,2,0.0001,204,4
0.486,0.0001,151,153,2,2,0.0001,304,4
0.486,0.0001,196,208,2,2,0.0001,404,4
0.486,0.0001,244,260,2,2,0.0001,504,4
0.486,0.0001,287,317,2,2,0.0001,604,4
0.486,0.0001,336,368,2,2,0.0001,704,4
0.486,0.0001,381,423,2,2,0.0001,804,4
0.486,0.0001,430,474,2,2,0.0001,904,4
0.486,0.0001,488,516,2,2,0.0001,1004,4
0.486,0.0001,539,565,2,2,0.0001,1104,4
0.486,0.0001,594,610,2,2,0.0001,1204,4
0.486,0.0001,644,660,2,2,0.0001,1304,4
0.486,0.0001,691,713,2,2,0.0001,1404,4
0.486,0.0001,750,754,2,2,0.0001,1504,4
0.486,0.0001,804,800,2,2,0.0001,1604,4
0.486,0.0001,855,849,2,2,0.0001,1704,4
0.486,0.0001,913,891,2,2,0.0001,1804,4
0.486,0.0001,961,943,2,2,0.0001,1904,4
0.486,0.0001,1009,995,2,2,0.0001,2004,4
0.644,0.0001,50,54,2,2,0.0001,104,5
0.646,0.0001,110,94,2,2,0.0001,204,5
0.646,0.0001,166,138,2,2,0.0001,304,5
0.646,0.0001,217,187,2,2,0.0001,404,5
0.648,0.0001,267,237,2,2,0.0001,504,5
0.646,0.0001,318,286,2,2,0.0001,604,5
0.646,0.0001,366,338,2,2,0.0001,704,5
0.648,0.0001,415,389,2,2,0.0001,804,5
0.648,0.0001,462,442,2,2,0.0001,904,5
0.648,0.0001,505,499,2,2,0.0001,1004,5
0.648,0.0001,551,553,2,2,0.0001,1104,5
0.648,0.0001,596,608,2,2,0.0001,1204,5
0.648,0.0001,646,658,2,2,0.0001,1304,5
0.648,0.0001,698,706,2,2,0.0001,1404,5
0.648,0.0001,751,753,2,2,0.0001,1504,5
0.652,0.0001,806,798,2,2,0.0001,1604,5
0.654,0.0001,854,850,2,2,0.0001,1704,5
0.654,0.0001,908,896,2,2,0.0001,1804,5
0.654,0.0001,954,950,2,2,0.0001,1904,5
0.658,0.0001,1002,1002,2,2,0.0001,2004,5
0.496,0.0001,45,59,2,2,0.0001,104,6
0.498,0.0001,93,111,2,2,0.0001,204,6
0.498,0.0001,145,159,2,2,0.0001,304,6
0.498,0.0001,199,205,2,2,0.0001,404,6
0.498,0.0001,256,248,2,2,0.0001,504,6
0.498,0.0001,304,300,2,2,0.0001,604,6
0.498,0.0001,348,356,2,2,0.0001,704,6
0.498,0.0001,404,400,2,2,0.0001,804,6
0.498,0.0001,448,456,2,2,0.0001,904,6
0.5,0.0001,498,506,2,2,0.0001,1004,6
0.5,0.0001,544,560,2,2,0.0001,1104,6
0.502,0.0001,590,614,2,2,0.0001,1204,6
0.502,0.0001,636,668,2,2,0.0001,1304,6
0.502,0.0001,688,716,2,2,0.0001,1404,6
0.504,0.0001,743,761,2,2,0.0001,1504,6
0.504,0.0001,801,803,2,2,0.0001,1604,6
0.502,0.0001,854,850,2,2,0.0001,1704,6
0.502,0.0001,893,911,2,2,0.0001,1804,6
0.504,0.0001,948,956,2,2,0.0001,1904,6
0.504,0.0001,999,1005,2,2,0.0001,2004,6
0.486,0.0001,57,47,2,2,0.0001,104,7
0.486,0.0001,114,90,2,2,0.0001,204,7
0.486,0.0001,150,154,2,2,0.0001,304,7
0.486,0.0001,202,202,2,2,0.0001,404,7
0.486,0.0001,253,251,2,2,0.0001,504,7
0.486,0.0001,306,298,2,2,0.0001,604,7
0.486,0.0001,353,351,2,2,0.0001,704,7
0.486,0.0001,405,399,2,2,0.0001,804,7
0.486,0.0001,452,452,2,2,0.0001,904,7
0.486,0.0001,497,507,2,2,0.0001,1004,7
0.486,0.0001,556,548,2,2,0.0001,1104,7
0.486,0.0001,596,608,2,2,0.0001,1204,7
0.486,0.0001,645,659,2,2,0.0001,1304,7
0.486,0.0001,690,714,2,2,0.0001,1404,7
0.486,0.0001,737,767,2,2,0.0001,1504,7
0.486,0.0001,786,818,2,2,0.0001,1604,7
0.486,0.0001,830,874,2,2,0.0001,1704,7
0.486,0.0001,885,919,2,2,0.0001,1804,7
0.486,0.0001,947,957,2,2,0.0001,1904,7
0.486,0.0001,995,1009,2,2,0.0001,2004,7
0.542,0.0001,56,48,2,2,0.0001,104,8
0.542,0.0001,111,93,2,2,0.0001,204,8
0.542,0.0001,172,132,2,2,0.0001,304,8
0.542,0.0001,225,179,2,2,0.0001,404,8
0.542,0.0001,276,228,2,2,0.0001,504,8
0.542,0.0001,316,288,2,2,0.0001,604,8
0.542,0.0001,364,340,2,2,0.0001,704,8
0.542,0.0001,424,380,2,2,0.0001,804,8
0.544,0.0001,468,436,2,2,0.0001,904,8
0.544,0.0001,510,494,2,2,0.0001,1004,8
0.544,0.0001,559,545,2,2,0.0001,1104,8
0.544,0.0001,614,590,2,2,0.0001,1204,8
0.546,0.0001,661,643,2,2,0.0001,1304,8
0.546,0.0001,711,693,2,2,0.0001,1404,8
0.546,0.0001,770,734,2,2,0.0001,1504,8
0.548,0.0001,822,782,2,2,0.0001,1604,8
0.548,0.0001,872,832,2,2,0.0001,1704,8
0.548,0.0001,916,888,2,2,0.0001,1804,8
0.548,0.0001,970,934,2,2,0.0001,1904,8
0.55,0.0001,1008,996,2,2,0.0001,2004,8
0.546,0.0001,56,48,2,2,0.0001,104,9
0.546,0.0001,108,96,2,2,0.0001,204,9
0.546,0.0001,160,144,2,2,0.0001,304,9
0.546,0.0001,209,195,2,2,0.0001,404,9
0.544,0.0001,254,250,2,2,0.0001,504,9
0.544,0.0001,305,299,2,2,0.0001,604,9
0.544,0.0001,348,356,2,2,0.0001,704,9
0.546,0.0001,407,397,2,2,0.0001,804,9
0.546,0.0001,454,450,2,2,0.0001,904,9
0.546,0.0001,496,508,2,2,0.0001,1004,9
0.546,0.0001,558,546,2,2,0.0001,1104,9
0.546,0.0001,603,601,2,2,0.0001,1204,9
0.546,0.0001,657,647,2,2,0.0001,1304,9
0.546,0.0001,710,694,2,2,0.0001,1404,9
0.546,0.0001,758,746,2,2,0.0001,1504,9
0.546,0.0001,812,792,2,2,0.0001,1604,9
0.546,0.0001,861,843,2,2,0.0001,1704,9
0.546,0.0001,909,895,2,2,0.0001,1804,9
0.544,0.0001,947,957,2,2,0.0001,1904,9
0.544,0.0001,993,1011,2,2,0.0001,2004,9
0.506,0.0001,51,53,2,2,0.0001,104,10
0.506,0.0001,97,107,2,2,0.0001,204,10
0.506,0.0001,154,150,2,2,0.0001,304,10
0.506,0.0001,204,200,2,2,0.0001,404,10
0.506,0.0001,258,246,2,2,0.0001,504,10
0.506,0.0001,306,298,2,2,0.0001,604,10
0.506,0.0001,359,345,2,2,0.0001,704,10
0.506,0.0001,410,394,2,2,0.0001,804,10
0.506,0.0001,458,446,2,2,0.0001,904,10
0.506,0.0001,502,502,2,2,0.0001,1004,10
0.506,0.0001,561,543,2,2,0.0001,1104,10
0.506,0.0001,605,599,2,2,0.0001,1204,10
0.506,0.0001,658,646,2,2,0.0001,1304,10
0.506,0.0001,705,699,2,2,0.0001,1404,10
0.506,0.0001,759,745,2,2,0.0001,1504,10
0.506,0.0001,799,805,2,2,0.0001,1604,10
0.506,0.0001,845,859,2,2,0.0001,1704,10
0.506,0.0001,905,899,2,2,0.0001,1804,10
0.506,0.0001,951,953,2,2,0.0001,1904,10
0.506,0.0001,999,1005,2,2,0.0001,2004,10
0.492,0.0001,58,46,2,2,0.0001,104,11
0.492,0.0001,108,96,2,2,0.0001,204,11
0.492,0.0001,153,151,2,2,0.0001,304,11
0.492,0.0001,198,206,2,2,0.0001,404,11
0.492,0.0001,258,246,2,2,0.0001,504,11
0.492,0.0001,299,305,2,2,0.0001,604,11
0.492,0.0001,352,352,2,2,0.0001,704,11
0.492,0.0001,402,402,2,2,0.0001,804,11
0.492,0.0001,454,450,2,2,0.0001,904,11
0.492,0.0001,503,501,2,2,0.0001,1004,11
0.492,0.0001,554,550,2,2,0.0001,1104,11
0.492,0.0001,601,603,2,2,0.0001,1204,11
0.492,0.0001,654,650,2,2,0.0001,1304,11
0.492,0.0001,705,699,2,2,0.0001,1404,11
0.492,0.0001,755,749,2,2,0.0001,1504,11
0.492,0.0001,803,801,2,2,0.0001,1604,11
0.492,0.0001,861,843,2,2,0.0001,1704,11
0.492,0.0001,907,897,2,2,0.0001,1804,11
0.492,0.0001,955,949,2,2,0.0001,1904,11
0.492,0.0001,998,1006,2,2,0.0001,2004,11
0.418,0.0001,52,52,2,2,0.0001,104,12
0.418,0.0001,106,98,2,2,0.0001,204,12
0.418,0.0001,156,148,2,2,0.0001,304,12
0.418,0.0001,208,196,2,2,0.0001,404,12
0.418,0.0001,258,246,2,2,0.0001,504,12
0.418,0.0001,299,305,2,2,0.0001,604,12
0.416,0.0001,348,356,2,2,0.0001,704,12
0.416,0.0001,405,399,2,2,0.0001,804,12
0.414,0.0001,456,448,2,2,0.0001,904,12
0.414,0.0001,502,502,2,2,0.0001,1004,12
0.416,0.0001,545,559,2,2,0.0001,1104,12
0.416,0.0001,603,601,2,2,0.0001,1204,12
0.414,0.0001,657,647,2,2,0.0001,1304,12
0.414,0.0001,706,698,2,2,0.0001,1404,12
0.414,0.0001,748,756,2,2,0.0001,1504,12
0.414,0.0001,799,805,2,2,0.0001,1604,12
0.414,0.0001,855,849,2,2,0.0001,1704,12
0.412,0.0001,899,905,2,2,0.0001,1804,12
0.41,0.0001,938,966,2,2,0.0001,1904,12
0.41,0.0001,989,1015,2,2,0.0001,2004,12
0.48,0.0001,52,52,2,2,0.0001,104,13
0.48,0.0001,105,99,2,2,0.0001,204,13
0.48,0.0001,156,148,2,2,0.0001,304,13
0.48,0.0001,213,191,2,2,0.0001,404,13
0.48,0.0001,267,237,2,2,0.0001,504,13
0.48,0.0001,312,292,2,2,0.0001,604,13
0.48,0.0001,358,346,2,2,0.0001,704,13
0.48,0.0001,409,395,2,2,0.0001,804,13
0.478,0.0001,462,442,2,2,0.0001,904,13
0.478,0.0001,514,490,2,2,0.0001,1004,13
0.48,0.0001,561,543,2,2,0.0001,1104,13
0.48,0.0001,611,593,2,2,0.0001,1204,13
0.48,0.0001,654,650,2,2,0.0001,1304,13
0.48,0.0001,697,707,2,2,0.0001,1404,13
0.48,0.0001,752,752,2,2,0.0001,1504,13
0.48,0.0001,810,794,2,2,0.0001,1604,13
0.48,0.0001,861,843,2,2,0.0001,1704,13
0.48,0.0001,920,884,2,2,0.0001,1804,13
0.48,0.0001,971,933,2,2,0.0001,1904,13
0.48,0.0001,1012,992,2,2,0.0001,2004,13
0.54,0.0001,50,54,2,2,0.0001,104,14
0.54,0.0001,105,99,2,2,0.0001,204,14
0.54,0.0001,149,155,2,2,0.0001,304,14
0.54,0.0001,189,215,2,2,0.0001,404,14
0.54,0.0001,239,265,2,2,0.0001,504,14
0.54,0.0001,292,312,2,2,0.0001,604,14
0.54,0.0001,341,363,2,2,0.0001,704,14
0.54,0.0001,391,413,2,2,0.0001,804,14
0.54,0.0001,437,467,2,2,0.0001,904,14
0.54,0.0001,486,518,2,2,0.0001,1004,14
0.54,0.0001,532,572,2,2,0.0001,1104,14
0.54,0.0001,581,623,2,2,0.0001,1204,14
0.54,0.0001,620,684,2,2,0.0001,1304,14
0.54,0.0001,672,732,2,2,0.0001,1404,14
0.54,0.0001,731,773,2,2,0.0001,1504,14
0.54,0.0001,776,828,2,2,0.0001,1604,14
0.54,0.0001,824,880,2,2,0.0001,1704,14
0.54,0.0001,874,930,2,2,0.0001,1804,14
0.54,0.0001,934,970,2,2,0.0001,1904,14
0.54,0.0001,982,1022,2,2,0.0001,2004,14
0.5,0.0001,47,57,2,2,0.0001,104,15
0.5,0.0001,95,109,2,2,0.0001,204,15
0.5,0.0001,138,166,2,2,0.0001,304,15
0.5,0.0001,199,205,2,2,0.0001,404,15
0.5,0.0001,253,251,2,2,0.0001,504,15
0.5,0.0001,304,300,2,2,0.0001,604,15
0.5,0.0001,343,361,2,2,0.0001,704,15
0.5,0.0001,387,417,2,2,0.0001,804,15
0.5,0.0001,446,458,2,2,0.0001,904,15
0.5,0.0001,493,511,2,2,0.0001,1004,15
0.5,0.0001,543,561,2,2,0.0001,1104,15
0.5,0.0001,592,612,2,2,0.0001,1204,15
0.5,0.0001,643,661,2,2,0.0001,1304,15
0.5,0.0001,696,708,2,2,0.0001,1404,15
0.5,0.0001,750,754,2,2,0.0001,1504,15
0.5,0.0001,805,799,2,2,0.0001,1604,15
0.5,0.0001,859,845,2,2,0.0001,1704,15
0.5,0.0001,906,898,2,2,0.0001,1804,15
0.5,0.0001,960,944,2,2,0.0001,1904,15
0.5,0.0001,1002,1002,2,2,0.0001,2004,15
0.51,0.0001,56,48,2,2,0.0001,104,16
0.51,0.0001,106,98,2,2,0.0001,204,16
0.51,0.0001,151,153,2,2,0.0001,304,16
0.51,0.0001,200,204,2,2,0.0001,404,16
0.51,0.0001,244,260,2,2,0.0001,504,16
0.51,0.0001,297,307,2,2,0.0001,604,16
0.51,0.0001,348,356,2,2,0.0001,704,16
0.51,0.0001,399,405,2,2,0.0001,804,16
0.51,0.0001,451,453,2,2,0.0001,904,16
0.51,0.0001,505,499,2,2,0.0001,1004,16
0.51,0.0001,555,549,2,2,0.0001,1104,16
0.51,0.0001,604,600,2,2,0.0001,1204,16
0.51,0.0001,660,644,2,2,0.0001,1304,16
0.51,0.0001,709,695,2,2,0.0001,1404,16
0.51,0.0001,761,743,2,2,0.0001,1504,16
0.51,0.0001,816,788,2,2,0.0001,1604,16
0.51,0.0001,859,845,2,2,0.0001,1704,16
0.51,0.0001,896,908,2,2,0.0001,1804,16
0.51,0.0001,943,961,2,2,0.0001,1904,16
0.51,0.0001,997,1007,2,2,0.0001,2004,16
0.484,0.0001,52,52,2,2,0.0001,104,17
0.484,0.0001,105,99,2,2,0.0001,204,17
0.484,0.0001,154,150,2,2,0.0001,304,17
0.484,0.0001,205,199,2,2,0.0001,404,17
0.484,0.0001,252,252,2,2,0.0001,504,17
0.484,0.0001,299,305,2,2,0.0001,604,17
0.484,0.0001,347,357,2,2,0.0001,704,17
0.486,0.0001,399,405,2,2,0.0001,804,17
0.486,0.0001,446,458,2,2,0.0001,904,17
0.486,0.0001,493,511,2,2,0.0001,1004,17
0.486,0.0001,542,562,2,2,0.0001,1104,17
0.486,0.0001,590,614,2,2,0.0001,1204,17
0.486,0.0001,641,663,2,2,0.0001,1304,17
0.486,0.0001,695,709,2,2,0.0001,1404,17
0.486,0.0001,747,757,2,2,0.0001,1504,17
0.486,0.0001,795,809,2,2,0.0001,1604,17
0.486,0.0001,845,859,2,2,0.0001,1704,17
0.486,0.0001,893,911,2,2,0.0001,1804,17
0.486,0.0001,947,957,2,2,0.0001,1904,17
0.486,0.0001,994,1010,2,2,0.0001,2004,17
0.494,0.0001,56,48,2,2,0.0001,104,18
0.494,0.0001,103,101,2,2,0.0001,204,18
0.494,0.0001,144,160,2,2,0.0001,304,18
0.494,0.0001,190,214,2,2,0.0001,404,18
0.494,0.0001,241,263,2,2,0.0001,504,18
0.494,0.0001,299,305,2,2,0.0001,604,18
0.494,0.0001,347,357,2,2,0.0001,704,18
0.494,0.0001,402,402,2,2,0.0001,804,18
0.494,0.0001,451,453,2,2,0.0001,904,18
0.494,0.0001,509,495,2,2,0.0001,1004,18
0.494,0.0001,561,543,2,2,0.0001,1104,18
0.494,0.0001,603,601,2,2,0.0001,1204,18
0.494,0.0001,659,645,2,2,0.0001,1304,18
0.494,0.0001,711,693,2,2,0.0001,1404,18
0.494,0.0001,758,746,2,2,0.0001,1504,18
0.494,0.0001,799,805,2,2,0.0001,1604,18
0.494,0.0001,852,852,2,2,0.0001,1704,18
0.494,0.0001,903,901,2,2,0.0001,1804,18
0.494,0.0001,955,949,2,2,0.0001,1904,18
0.494,0.0001,998,1006,2,2,0.0001,2004,18
0.536,0.0001,49,55,2,2,0.0001,104,19
0.538,0.0001,96,108,2,2,0.0001,204,19
0.538,0.0001,146,158,2,2,0.0001,304,19
0.538,0.0001,199,205,2,2,0.0001,404,19
0.538,0.0001,249,255,2,2,0.0001,504,19
0.538,0.0001,293,311,2,2,0.0001,604,19
0.538,0.0001,347,357,2,2,0.0001,704,19
0.538,0.0001,394,410,2,2,0.0001,804,19
0.538,0.0001,457,447,2,2,0.0001,904,19
0.538,0.0001,506,498,2,2,0.0001,1004,19
0.538,0.0001,555,549,2,2,0.0001,1104,19
0.538,0.0001,607,597,2,2,0.0001,1204,19
0.538,0.0001,658,646,2,2,0.0001,1304,19
0.538,0.0001,708,696,2,2,0.0001,1404,19
0.538,0.0001,759,745,2,2,0.0001,1504,19
0.538,0.0001,817,787,2,2,0.0001,1604,19
0.54,0.0001,862,842,2,2,0.0001,1704,19
0.542,0.0001,909,895,2,2,0.0001,1804,19
0.542,0.0001,954,950,2,2,0.0001,1904,19
0.542,0.0001,1004,1000,2,2,0.0001,2004,19
0.522,0.0001,52,52,2,2,0.0001,104,20
0.522,0.0001,97,107,2,2,0.0001,204,20
0.522,0.0001,152,152,2,2,0.0001,304,20
0.522,0.0001,211,193,2,2,0.0001,404,20
0.522,0.0001,262,242,2,2,0.0001,504,20
0.52,0.0001,309,295,2,2,0.0001,604,20
0.52,0.0001,360,344,2,2,0.0001,704,20
0.518,0.0001,402,402,2,2,0.0001,804,20
0.518,0.0001,449,455,2,2,0.0001,904,20
0.518,0.0001,501,503,2,2,0.0001,1004,20
0.516,0.0001,554,550,2,2,0.0001,1104,20
0.516,0.0001,611,593,2,2,0.0001,1204,20
0.514,0.0001,656,648,2,2,0.0001,1304,20
0.516,0.0001,707,697,2,2,0.0001,1404,20
0.516,0.0001,763,741,2,2,0.0001,1504,20
0.516,0.0001,824,780,2,2,0.0001,1604,20
0.516,0.0001,871,833,2,2,0.0001,1704,20
0.516,0.0001,919,885,2,2,0.0001,1804,20
0.516,0.0001,974,930,2,2,0.0001,1904,20
0.516,0.0001,1023,981,2,2,0.0001,2004,20
0.512,0.0001,52,52,2,2,0.001,104,1
0.512,0.0001,102,102,2,2,0.001,204,1
0.514,0.0001,156,148,2,2,0.001,304,1
0.516,0.0001,202,202,2,2,0.001,404,1
0.514,0.0001,244,260,2,2,0.001,504,1
0.516,0.0001,299,305,2,2,0.001,604,1
0.516,0.0001,341,363,2,2,0.001,704,1
0.516,0.0001,389,415,2,2,0.001,804,1
0.52,0.0001,445,459,2,2,0.001,904,1
0.522,0.0001,497,507,2,2,0.001,1004,1
0.526,0.0001,542,562,2,2,0.001,1104,1
0.528,0.0001,588,616,2,2,0.001,1204,1
0.528,0.0001,642,662,2,2,0.001,1304,1
0.538,0.0001,689,715,2,2,0.001,1404,1
0.546,0.0001,741,763,2,2,0.001,1504,1
0.546,0.0001,791,813,2,2,0.001,1604,1
0.55,0.0001,837,867,2,2,0.001,1704,1
0.552,0.0001,885,919,2,2,0.001,1804,1
0.56,0.0001,930,974,2,2,0.001,1904,1
0.562,0.0001,979,1025,2,2,0.001,2004,1
0.48,0.0001,53,51,2,2,0.001,104,2
0.48,0.0001,102,102,2,2,0.001,204,2
0.482,0.0001,155,149,2,2,0.001,304,2
0.482,0.0001,205,199,2,2,0.001,404,2
0.482,0.0001,251,253,2,2,0.001,504,2
0.484,0.0001,296,308,2,2,0.001,604,2
0.486,0.0001,344,360,2,2,0.001,704,2
0.486,0.0001,397,407,2,2,0.001,804,2
0.49,0.0001,436,468,2,2,0.001,904,2
0.488,0.0001,489,515,2,2,0.001,1004,2
0.488,0.0001,537,567,2,2,0.001,1104,2
0.488,0.0001,581,623,2,2,0.001,1204,2
0.49,0.0001,630,674,2,2,0.001,1304,2
0.488,0.0001,680,724,2,2,0.001,1404,2
0.486,0.0001,737,767,2,2,0.001,1504,2
0.49,0.0001,786,818,2,2,0.001,1604,2
0.488,0.0001,842,862,2,2,0.001,1704,2
0.49,0.0001,894,910,2,2,0.001,1804,2
0.486,0.0001,943,961,2,2,0.001,1904,2
0.488,0.0001,993,1011,2,2,0.001,2004,2
0.51,0.0001,50,54,2,2,0.001,104,3
0.51,0.0001,111,93,2,2,0.001,204,3
0.51,0.0001,158,146,2,2,0.001,304,3
0.51,0.0001,210,194,2,2,0.001,404,3
0.51,0.0001,267,237,2,2,0.001,504,3
0.51,0.0001,310,294,2,2,0.001,604,3
0.51,0.0001,357,347,2,2,0.001,704,3
0.51,0.0001,409,395,2,2,0.001,804,3
0.51,0.0001,458,446,2,2,0.001,904,3
0.51,0.0001,500,504,2,2,0.001,1004,3
0.51,0.0001,548,556,2,2,0.001,1104,3
0.51,0.0001,593,611,2,2,0.001,1204,3
0.51,0.0001,638,666,2,2,0.001,1304,3
0.51,0.0001,698,706,2,2,0.001,1404,3
0.51,0.0001,747,757,2,2,0.001,1504,3
0.51,0.0001,792,812,2,2,0.001,1604,3
0.51,0.0001,850,854,2,2,0.001,1704,3
0.51,0.0001,907,897,2,2,0.001,1804,3
0.51,0.0001,952,952,2,2,0.001,1904,3
0.51,0.0001,1007,997,2,2,0.001,2004,3
0.512,0.0001,50,54,2,2,0.001,104,4
0.512,0.0001,98,106,2,2,0.001,204,4
0.512,0.0001,151,153,2,2,0.001,304,4
0.512,0.0001,207,197,2,2,0.001,404,4
0.512,0.0001,267,237,2,2,0.001,504,4
0.512,0.0001,316,288,2,2,0.001,604,4
0.512,0.0001,373,331,2,2,0.001,704,4
0.512,0.0001,423,381,2,2,0.001,804,4
0.512,0.0001,468,436,2,2,0.001,904,4
0.512,0.0001,519,485,2,2,0.001,1004,4
0.512,0.0001,561,543,2,2,0.001,1104,4
0.512,0.0001,617,587,2,2,0.001,1204,4
0.512,0.0001,660,644,2,2,0.001,1304,4
0.512,0.0001,706,698,2,2,0.001,1404,4
0.512,0.0001,757,747,2,2,0.001,1504,4
0.512,0.0001,811,793,2,2,0.001,1604,4
0.512,0.0001,857,847,2,2,0.001,1704,4
0.512,0.0001,917,887,2,2,0.001,1804,4
0.512,0.0001,962,942,2,2,0.001,1904,4
0.512,0.0001,1008,996,2,2,0.001,2004,4
0.526,0.0001,49,55,2,2,0.001,104,5
0.526,0.0001,102,102,2,2,0.001,204,5
0.526,0.0001,155,149,2,2,0.001,304,5
0.526,0.0001,209,195,2,2,0.001,404,5
0.528,0.0001,262,242,2,2,0.001,504,5
0.528,0.0001,310,294,2,2,0.001,604,5
0.528,0.0001,366,338,2,2,0.001,704,5
0.528,0.0001,424,380,2,2,0.001,804,5
0.528,0.0001,476,428,2,2,0.001,904,5
0.53,0.0001,523,481,2,2,0.001,1004,5
0.53,0.0001,575,529,2,2,0.001,1104,5
0.534,0.0001,624,580,2,2,0.001,1204,5
0.534,0.0001,680,624,2,2,0.001,1304,5
0.534,0.0001,728,676,2,2,0.001,1404,5
0.536,0.0001,772,732,2,2,0.001,1504,5
0.538,0.0001,822,782,2,2,0.001,1604,5
0.542,0.0001,871,833,2,2,0.001,1704,5
0.548,0.0001,916,888,2,2,0.001,1804,5
0.548,0.0001,957,947,2,2,0.001,1904,5
0.548,0.0001,1012,992,2,2,0.001,2004,5
0.54,0.0001,50,54,2,2,0.001,104,6
0.54,0.0001,96,108,2,2,0.001,204,6
0.54,0.0001,152,152,2,2,0.001,304,6
0.54,0.0001,210,194,2,2,0.001,404,6
0.54,0.0001,248,256,2,2,0.001,504,6
0.54,0.0001,297,307,2,2,0.001,604,6
0.54,0.0001,345,359,2,2,0.001,704,6
0.54,0.0001,393,411,2,2,0.001,804,6
0.538,0.0001,447,457,2,2,0.001,904,6
0.538,0.0001,497,507,2,2,0.001,1004,6
0.538,0.0001,541,563,2,2,0.001,1104,6
0.538,0.0001,586,618,2,2,0.001,1204,6
0.536,0.0001,640,664,2,2,0.001,1304,6
0.536,0.0001,680,724,2,2,0.001,1404,6
0.532,0.0001,725,779,2,2,0.001,1504,6
0.53,0.0001,781,823,2,2,0.001,1604,6
0.534,0.0001,824,880,2,2,0.001,1704,6
0.528,0.0001,877,927,2,2,0.001,1804,6
0.522,0.0001,936,968,2,2,0.001,1904,6
0.524,0.0001,980,1024,2,2,0.001,2004,6
0.618,0.0001,48,56,2,2,0.001,104,7
0.618,0.0001,111,93,2,2,0.001,204,7
0.618,0.0001,157,147,2,2,0.001,304,7
0.618,0.0001,201,203,2,2,0.001,404,7
0.622,0.0001,264,240,2,2,0.001,504,7
0.622,0.0001,316,288,2,2,0.001,604,7
0.624,0.0001,367,337,2,2,0.001,704,7
0.624,0.0001,411,393,2,2,0.001,804,7
0.628,0.0001,460,444,2,2,0.001,904,7
0.628,0.0001,518,486,2,2,0.001,1004,7
0.626,0.0001,565,539,2,2,0.001,1104,7
0.628,0.0001,611,593,2,2,0.001,1204,7
0.626,0.0001,659,645,2,2,0.001,1304,7
0.628,0.0001,701,703,2,2,0.001,1404,7
0.634,0.0001,750,754,2,2,0.001,1504,7
0.632,0.0001,794,810,2,2,0.001,1604,7
0.634,0.0001,844,860,2,2,0.001,1704,7
0.634,0.0001,898,906,2,2,0.001,1804,7
0.632,0.0001,944,960,2,2,0.001,1904,7
0.632,0.0001,989,1015,2,2,0.001,2004,7
0.486,0.0001,50,54,2,2,0.001,104,8
0.486,0.0001,102,102,2,2,0.001,204,8
0.486,0.0001,146,158,2,2,0.001,304,8
0.486,0.0001,191,213,2,2,0.001,404,8
0.486,0.0001,238,266,2,2,0.001,504,8
0.486,0.0001,300,304,2,2,0.001,604,8
0.486,0.0001,349,355,2,2,0.001,704,8
0.486,0.0001,393,411,2,2,0.001,804,8
0.486,0.0001,441,463,2,2,0.001,904,8
0.484,0.0001,487,517,2,2,0.001,1004,8
0.482,0.0001,535,569,2,2,0.001,1104,8
0.48,0.0001,591,613,2,2,0.001,1204,8
0.48,0.0001,646,658,2,2,0.001,1304,8
0.478,0.0001,698,706,2,2,0.001,1404,8
0.478,0.0001,749,755,2,2,0.001,1504,8
0.476,0.0001,798,806,2,2,0.001,1604,8
0.474,0.0001,840,864,2,2,0.001,1704,8
0.474,0.0001,893,911,2,2,0.001,1804,8
0.48,0.0001,947,957,2,2,0.001,1904,8
0.48,0.0001,989,1015,2,2,0.001,2004,8
0.506,0.0001,60,44,2,2,0.001,104,9
0.506,0.0001,112,92,2,2,0.001,204,9
0.506,0.0001,159,145,2,2,0.001,304,9
0.506,0.0001,212,192,2,2,0.001,404,9
0.506,0.0001,265,239,2,2,0.001,504,9
0.506,0.0001,321,283,2,2,0.001,604,9
0.506,0.0001,364,340,2,2,0.001,704,9
0.506,0.0001,414,390,2,2,0.001,804,9
0.506,0.0001,460,444,2,2,0.001,904,9
0.506,0.0001,509,495,2,2,0.001,1004,9
0.506,0.0001,557,547,2,2,0.001,1104,9
0.506,0.0001,606,598,2,2,0.001,1204,9
0.506,0.0001,652,652,2,2,0.001,1304,9
0.506,0.0001,702,702,2,2,0.001,1404,9
0.506,0.0001,762,742,2,2,0.001,1504,9
0.506,0.0001,813,791,2,2,0.001,1604,9
0.506,0.0001,859,845,2,2,0.001,1704,9
0.506,0.0001,906,898,2,2,0.001,1804,9
0.506,0.0001,958,946,2,2,0.001,1904,9
0.506,0.0001,999,1005,2,2,0.001,2004,9
0.506,0.0001,59,45,2,2,0.001,104,10
0.506,0.0001,122,82,2,2,0.001,204,10
0.506,0.0001,171,133,2,2,0.001,304,10
0.506,0.0001,215,189,2,2,0.001,404,10
0.506,0.0001,260,244,2,2,0.001,504,10
0.506,0.0001,310,294,2,2,0.001,604,10
0.506,0.0001,357,347,2,2,0.001,704,10
0.506,0.0001,405,399,2,2,0.001,804,10
0.506,0.0001,456,448,2,2,0.001,904,10
0.506,0.0001,514,490,2,2,0.001,1004,10
0.506,0.0001,563,541,2,2,0.001,1104,10
0.506,0.0001,618,586,2,2,0.001,1204,10
0.506,0.0001,673,631,2,2,0.001,1304,10
0.506,0.0001,721,683,2,2,0.001,1404,10
0.506,0.0001,758,746,2,2,0.001,1504,10
0.506,0.0001,805,799,2,2,0.001,1604,10
0.506,0.0001,847,857,2,2,0.001,1704,10
0.506,0.0001,899,905,2,2,0.001,1804,10
0.506,0.0001,946,958,2,2,0.001,1904,10
0.506,0.0001,999,1005,2,2,0.001,2004,10
0.5,0.0001,57,47,2,2,0.001,104,11
0.5,0.0001,111,93,2,2,0.001,204,11
0.5,0.0001,161,143,2,2,0.001,304,11
0.5,0.0001,208,196,2,2,0.001,404,11
0.5,0.0001,261,243,2,2,0.001,504,11
0.5,0.0001,310,294,2,2,0.001,604,11
0.5,0.0001,355,349,2,2,0.001,704,11
0.5,0.0001,408,396,2,2,0.001,804,11
0.5,0.0001,471,433,2,2,0.001,904,11
0.5,0.0001,513,491,2,2,0.001,1004,11
0.5,0.0001,567,537,2,2,0.001,1104,11
0.5,0.0001,614,590,2,2,0.001,1204,11
0.5,0.0001,664,640,2,2,0.001,1304,11
0.5,0.0001,710,694,2,2,0.001,1404,11
0.5,0.0001,759,745,2,2,0.001,1504,11
0.5,0.0001,814,790,2,2,0.001,1604,11
0.5,0.0001,861,843,2,2,0.001,1704,11
0.5,0.0001,908,896,2,2,0.001,1804,11
0.5,0.0001,953,951,2,2,0.001,1904,11
0.5,0.0001,1002,1002,2,2,0.001,2004,11
0.528,0.0001,61,43,2,2,0.001,104,12
0.53,0.0001,104,100,2,2,0.001,204,12
0.53,0.0001,156,148,2,2,0.001,304,12
0.53,0.0001,205,199,2,2,0.001,404,12
0.534,0.0001,260,244,2,2,0.001,504,12
0.536,0.0001,313,291,2,2,0.001,604,12
0.536,0.0001,363,341,2,2,0.001,704,12
0.538,0.0001,416,388,2,2,0.001,804,12
0.538,0.0001,463,441,2,2,0.001,904,12
0.542,0.0001,504,500,2,2,0.001,1004,12
0.542,0.0001,555,549,2,2,0.001,1104,12
0.542,0.0001,599,605,2,2,0.001,1204,12
0.544,0.0001,645,659,2,2,0.001,1304,12
0.552,0.0001,707,697,2,2,0.001,1404,12
0.554,0.0001,756,748,2,2,0.001,1504,12
0.554,0.0001,802,802,2,2,0.001,1604,12
0.562,0.0001,845,859,2,2,0.001,1704,12
0.566,0.0001,895,909,2,2,0.001,1804,12
0.57,0.0001,941,963,2,2,0.001,1904,12
0.578,0.0001,997,1007,2,2,0.001,2004,12
0.37,0.0001,51,53,2,2,0.001,104,13
0.37,0.0001,106,98,2,2,0.001,204,13
0.37,0.0001,158,146,2,2,0.001,304,13
0.374,0.0001,210,194,2,2,0.001,404,13
0.376,0.0001,262,242,2,2,0.001,504,13
0.376,0.0001,319,285,2,2,0.001,604,13
0.376,0.0001,376,328,2,2,0.001,704,13
0.376,0.0001,413,391,2,2,0.001,804,13
0.376,0.0001,462,442,2,2,0.001,904,13
0.376,0.0001,512,492,2,2,0.001,1004,13
0.374,0.0001,563,541,2,2,0.001,1104,13
0.37,0.0001,613,591,2,2,0.001,1204,13
0.37,0.0001,665,639,2,2,0.001,1304,13
0.37,0.0001,724,680,2,2,0.001,1404,13
0.37,0.0001,772,732,2,2,0.001,1504,13
0.37,0.0001,820,784,2,2,0.001,1604,13
0.376,0.0001,870,834,2,2,0.001,1704,13
0.378,0.0001,922,882,2,2,0.001,1804,13
0.382,0.0001,972,932,2,2,0.001,1904,13
0.392,0.0001,1021,983,2,2,0.001,2004,13
0.514,0.0001,57,47,2,2,0.001,104,14
0.514,0.0001,111,93,2,2,0.001,204,14
0.514,0.0001,157,147,2,2,0.001,304,14
0.514,0.0001,215,189,2,2,0.001,404,14
0.514,0.0001,266,238,2,2,0.001,504,14
0.514,0.0001,321,283,2,2,0.001,604,14
0.514,0.0001,372,332,2,2,0.001,704,14
0.514,0.0001,426,378,2,2,0.001,804,14
0.514,0.0001,476,428,2,2,0.001,904,14
0.514,0.0001,526,478,2,2,0.001,1004,14
0.514,0.0001,575,529,2,2,0.001,1104,14
0.514,0.0001,629,575,2,2,0.001,1204,14
0.514,0.0001,678,626,2,2,0.001,1304,14
0.514,0.0001,735,669,2,2,0.001,1404,14
0.514,0.0001,784,720,2,2,0.001,1504,14
0.514,0.0001,825,779,2,2,0.001,1604,14
0.514,0.0001,875,829,2,2,0.001,1704,14
0.514,0.0001,920,884,2,2,0.001,1804,14
0.514,0.0001,960,944,2,2,0.001,1904,14
0.514,0.0001,1009,995,2,2,0.001,2004,14
0.49,0.0001,51,53,2,2,0.001,104,15
0.49,0.0001,91,113,2,2,0.001,204,15
0.49,0.0001,136,168,2,2,0.001,304,15
0.49,0.0001,187,217,2,2,0.001,404,15
0.49,0.0001,235,269,2,2,0.001,504,15
0.49,0.0001,293,311,2,2,0.001,604,15
0.49,0.0001,341,363,2,2,0.001,704,15
0.49,0.0001,384,420,2,2,0.001,804,15
0.49,0.0001,433,471,2,2,0.001,904,15
0.49,0.0001,489,515,2,2,0.001,1004,15
0.49,0.0001,543,561,2,2,0.001,1104,15
0.49,0.0001,602,602,2,2,0.001,1204,15
0.49,0.0001,650,654,2,2,0.001,1304,15
0.49,0.0001,703,701,2,2,0.001,1404,15
0.49,0.0001,759,745,2,2,0.001,1504,15
0.49,0.0001,801,803,2,2,0.001,1604,15
0.49,0.0001,853,851,2,2,0.001,1704,15
0.49,0.0001,897,907,2,2,0.001,1804,15
0.49,0.0001,951,953,2,2,0.001,1904,15
0.49,0.0001,997,1007,2,2,0.001,2004,15
0.506,0.0001,61,43,2,2,0.001,104,16
0.506,0.0001,114,90,2,2,0.001,204,16
0.506,0.0001,161,143,2,2,0.001,304,16
0.506,0.0001,210,194,2,2,0.001,404,16
0.506,0.0001,255,249,2,2,0.001,504,16
0.506,0.0001,308,296,2,2,0.001,604,16
0.506,0.0001,358,346,2,2,0.001,704,16
0.506,0.0001,406,398,2,2,0.001,804,16
0.506,0.0001,453,451,2,2,0.001,904,16
0.506,0.0001,495,509,2,2,0.001,1004,16
0.506,0.0001,551,553,2,2,0.001,1104,16
0.506,0.0001,611,593,2,2,0.001,1204,16
0.506,0.0001,659,645,2,2,0.001,1304,16
0.506,0.0001,712,692,2,2,0.001,1404,16
0.506,0.0001,753,751,2,2,0.001,1504,16
0.506,0.0001,792,812,2,2,0.001,1604,16
0.506,0.0001,844,860,2,2,0.001,1704,16
0.506,0.0001,898,906,2,2,0.001,1804,16
0.506,0.0001,946,958,2,2,0.001,1904,16
0.506,0.0001,999,1005,2,2,0.001,2004,16
0.51,0.0001,52,52,2,2,0.001,104,17
0.51,0.0001,101,103,2,2,0.001,204,17
0.51,0.0001,160,144,2,2,0.001,304,17
0.514,0.0001,214,190,2,2,0.001,404,17
0.514,0.0001,257,247,2,2,0.001,504,17
0.516,0.0001,304,300,2,2,0.001,604,17
0.516,0.0001,357,347,2,2,0.001,704,17
0.516,0.0001,420,384,2,2,0.001,804,17
0.514,0.0001,474,430,2,2,0.001,904,17
0.514,0.0001,524,480,2,2,0.001,1004,17
0.514,0.0001,576,528,2,2,0.001,1104,17
0.512,0.0001,630,574,2,2,0.001,1204,17
0.512,0.0001,676,628,2,2,0.001,1304,17
0.516,0.0001,722,682,2,2,0.001,1404,17
0.516,0.0001,772,732,2,2,0.001,1504,17
0.512,0.0001,820,784,2,2,0.001,1604,17
0.508,0.0001,862,842,2,2,0.001,1704,17
0.51,0.0001,911,893,2,2,0.001,1804,17
0.506,0.0001,962,942,2,2,0.001,1904,17
0.506,0.0001,1010,994,2,2,0.001,2004,17
0.486,0.0001,63,41,2,2,0.001,104,18
0.486,0.0001,110,94,2,2,0.001,204,18
0.486,0.0001,161,143,2,2,0.001,304,18
0.486,0.0001,210,194,2,2,0.001,404,18
0.486,0.0001,258,246,2,2,0.001,504,18
0.486,0.0001,303,301,2,2,0.001,604,18
0.486,0.0001,354,350,2,2,0.001,704,18
0.486,0.0001,403,401,2,2,0.001,804,18
0.486,0.0001,450,454,2,2,0.001,904,18
0.486,0.0001,496,508,2,2,0.001,1004,18
0.486,0.0001,539,565,2,2,0.001,1104,18
0.486,0.0001,585,619,2,2,0.001,1204,18
0.486,0.0001,644,660,2,2,0.001,1304,18
0.486,0.0001,687,717,2,2,0.001,1404,18
0.486,0.0001,744,760,2,2,0.001,1504,18
0.484,0.0001,793,811,2,2,0.001,1604,18
0.482,0.0001,858,846,2,2,0.001,1704,18
0.482,0.0001,905,899,2,2,0.001,1804,18
0.482,0.0001,951,953,2,2,0.001,1904,18
0.478,0.0001,995,1009,2,2,0.001,2004,18
0.47,0.0001,47,57,2,2,0.001,104,19
0.47,0.0001,93,111,2,2,0.001,204,19
0.47,0.0001,143,161,2,2,0.001,304,19
0.47,0.0001,192,212,2,2,0.001,404,19
0.472,0.0001,240,264,2,2,0.001,504,19
0.472,0.0001,282,322,2,2,0.001,604,19
0.472,0.0001,340,364,2,2,0.001,704,19
0.468,0.0001,396,408,2,2,0.001,804,19
0.468,0.0001,445,459,2,2,0.001,904,19
0.466,0.0001,509,495,2,2,0.001,1004,19
0.466,0.0001,560,544,2,2,0.001,1104,19
0.466,0.0001,616,588,2,2,0.001,1204,19
0.466,0.0001,672,632,2,2,0.001,1304,19
0.468,0.0001,720,684,2,2,0.001,1404,19
0.468,0.0001,770,734,2,2,0.001,1504,19
0.468,0.0001,818,786,2,2,0.001,1604,19
0.466,0.0001,866,838,2,2,0.001,1704,19
0.466,0.0001,908,896,2,2,0.001,1804,19
0.464,0.0001,953,951,2,2,0.001,1904,19
0.464,0.0001,997,1007,2,2,0.001,2004,19
0.368,0.0001,55,49,2,2,0.001,104,20
0.368,0.0001,106,98,2,2,0.001,204,20
0.368,0.0001,151,153,2,2,0.001,304,20
0.368,0.0001,206,198,2,2,0.001,404,20
0.368,0.0001,257,247,2,2,0.001,504,20
0.368,0.0001,310,294,2,2,0.001,604,20
0.368,0.0001,361,343,2,2,0.001,704,20
0.368,0.0001,423,381,2,2,0.001,804,20
0.368,0.0001,481,423,2,2,0.001,904,20
0.368,0.0001,532,472,2,2,0.001,1004,20
0.368,0.0001,588,516,2,2,0.001,1104,20
0.37,0.0001,642,562,2,2,0.001,1204,20
0.374,0.0001,688,616,2,2,0.001,1304,20
0.376,0.0001,734,670,2,2,0.001,1404,20
0.376,0.0001,789,715,2,2,0.001,1504,20
0.378,0.0001,832,772,2,2,0.001,1604,20
0.382,0.0001,876,828,2,2,0.001,1704,20
0.384,0.0001,920,884,2,2,0.001,1804,20
0.384,0.0001,964,940,2,2,0.001,1904,20
0.384,0.0001,1016,988,2,2,0.001,2004,20
0.532,0.0001,48,56,2,2,0.01,104,1
0.526,0.0001,95,109,2,2,0.01,204,1
0.526,0.0001,144,160,2,2,0.01,304,1
0.54,0.0001,193,211,2,2,0.01,404,1
0.538,0.0001,244,260,2,2,0.01,504,1
0.518,0.0001,293,311,2,2,0.01,604,1
0.538,0.0001,337,367,2,2,0.01,704,1
0.55,0.0001,390,414,2,2,0.01,804,1
0.558,0.0001,436,468,2,2,0.01,904,1
0.556,0.0001,495,509,2,2,0.01,1004,1
0.566,0.0001,545,559,2,2,0.01,1104,1
0.582,0.0001,592,612,2,2,0.01,1204,1
0.588,0.0001,643,661,2,2,0.01,1304,1
0.588,0.0001,692,712,2,2,0.01,1404,1
0.596,0.0001,749,755,2,2,0.01,1504,1
0.592,0.0001,798,806,2,2,0.01,1604,1
0.744,0.0001,854,850,2,2,0.01,1704,1
0.744,0.0001,911,893,2,2,0.01,1804,1
0.746,0.0001,959,945,2,2,0.01,1904,1
0.748,0.0001,1015,989,2,2,0.01,2004,1
0.488,0.0001,53,51,2,2,0.01,104,2
0.488,0.0001,106,98,2,2,0.01,204,2
0.488,0.0001,146,158,2,2,0.01,304,2
0.488,0.0001,194,210,2,2,0.01,404,2
0.492,0.0001,250,254,2,2,0.01,504,2
0.496,0.0001,286,318,2,2,0.01,604,2
0.504,0.0001,341,363,2,2,0.01,704,2
0.524,0.0001,398,406,2,2,0.01,804,2
0.54,0.0001,447,457,2,2,0.01,904,2
0.55,0.0001,509,495,2,2,0.01,1004,2
0.546,0.0001,557,547,2,2,0.01,1104,2
0.544,0.0001,613,591,2,2,0.01,1204,2
0.558,0.0001,674,630,2,2,0.01,1304,2
0.56,0.0001,727,677,2,2,0.01,1404,2
0.56,0.0001,776,728,2,2,0.01,1504,2
0.566,0.0001,817,787,2,2,0.01,1604,2
0.58,0.0001,864,840,2,2,0.01,1704,2
0.58,0.0001,915,889,2,2,0.01,1804,2
0.58,0.0001,958,946,2,2,0.01,1904,2
0.584,0.0001,1008,996,2,2,0.01,2004,2
0.488,0.0001,42,62,2,2,0.01,104,3
0.488,0.0001,91,113,2,2,0.01,204,3
0.49,0.0001,143,161,2,2,0.01,304,3
0.49,0.0001,198,206,2,2,0.01,404,3
0.49,0.0001,252,252,2,2,0.01,504,3
0.492,0.0001,307,297,2,2,0.01,604,3
0.492,0.0001,365,339,2,2,0.01,704,3
0.492,0.0001,410,394,2,2,0.01,804,3
0.492,0.0001,458,446,2,2,0.01,904,3
0.496,0.0001,503,501,2,2,0.01,1004,3
0.502,0.0001,551,553,2,2,0.01,1104,3
0.526,0.0001,603,601,2,2,0.01,1204,3
0.516,0.0001,654,650,2,2,0.01,1304,3
0.484,0.0001,697,707,2,2,0.01,1404,3
0.468,0.0001,744,760,2,2,0.01,1504,3
0.45,0.0001,793,811,2,2,0.01,1604,3
0.472,0.0001,842,862,2,2,0.01,1704,3
0.464,0.0001,900,904,2,2,0.01,1804,3
0.474,0.0001,950,954,2,2,0.01,1904,3
0.466,0.0001,1006,998,2,2,0.01,2004,3
0.492,0.0001,49,55,2,2,0.01,104,4
0.492,0.0001,99,105,2,2,0.01,204,4
0.492,0.0001,145,159,2,2,0.01,304,4
0.492,0.0001,189,215,2,2,0.01,404,4
0.492,0.0001,241,263,2,2,0.01,504,4
0.492,0.0001,289,315,2,2,0.01,604,4
0.492,0.0001,337,367,2,2,0.01,704,4
0.492,0.0001,383,421,2,2,0.01,804,4
0.492,0.0001,436,468,2,2,0.01,904,4
0.492,0.0001,482,522,2,2,0.01,1004,4
0.492,0.0001,535,569,2,2,0.01,1104,4
0.492,0.0001,586,618,2,2,0.01,1204,4
0.492,0.0001,636,668,2,2,0.01,1304,4
0.492,0.0001,692,712,2,2,0.01,1404,4
0.492,0.0001,742,762,2,2,0.01,1504,4
0.492,0.0001,798,806,2,2,0.01,1604,4
0.492,0.0001,841,863,2,2,0.01,1704,4
0.492,0.0001,895,909,2,2,0.01,1804,4
0.492,0.0001,945,959,2,2,0.01,1904,4
0.492,0.0001,1006,998,2,2,0.01,2004,4
0.526,0.0001,49,55,2,2,0.01,104,5
0.526,0.0001,101,103,2,2,0.01,204,5
0.526,0.0001,150,154,2,2,0.01,304,5
0.526,0.0001,200,204,2,2,0.01,404,5
0.522,0.0001,254,250,2,2,0.01,504,5
0.53,0.0001,302,302,2,2,0.01,604,5
0.534,0.0001,346,358,2,2,0.01,704,5
0.548,0.0001,393,411,2,2,0.01,804,5
0.548,0.0001,435,469,2,2,0.01,904,5
0.548,0.0001,483,521,2,2,0.01,1004,5
0.546,0.0001,526,578,2,2,0.01,1104,5
0.544,0.0001,583,621,2,2,0.01,1204,5
0.538,0.0001,636,668,2,2,0.01,1304,5
0.54,0.0001,684,720,2,2,0.01,1404,5
0.536,0.0001,735,769,2,2,0.01,1504,5
0.538,0.0001,782,822,2,2,0.01,1604,5
0.542,0.0001,834,870,2,2,0.01,1704,5
0.544,0.0001,891,913,2,2,0.01,1804,5
0.538,0.0001,938,966,2,2,0.01,1904,5
0.534,0.0001,989,1015,2,2,0.01,2004,5
0.49,0.0001,48,56,2,2,0.01,104,6
0.49,0.0001,98,106,2,2,0.01,204,6
0.49,0.0001,139,165,2,2,0.01,304,6
0.49,0.0001,188,216,2,2,0.01,404,6
0.49,0.0001,237,267,2,2,0.01,504,6
0.49,0.0001,293,311,2,2,0.01,604,6
0.49,0.0001,347,357,2,2,0.01,704,6
0.47,0.0001,402,402,2,2,0.01,804,6
0.48,0.0001,449,455,2,2,0.01,904,6
0.486,0.0001,497,507,2,2,0.01,1004,6
0.49,0.0001,548,556,2,2,0.01,1104,6
0.506,0.0001,598,606,2,2,0.01,1204,6
0.504,0.0001,653,651,2,2,0.01,1304,6
0.502,0.0001,711,693,2,2,0.01,1404,6
0.508,0.0001,757,747,2,2,0.01,1504,6
0.51,0.0001,813,791,2,2,0.01,1604,6
0.51,0.0001,858,846,2,2,0.01,1704,6
0.512,0.0001,902,902,2,2,0.01,1804,6
0.514,0.0001,959,945,2,2,0.01,1904,6
0.51,0.0001,1007,997,2,2,0.01,2004,6
0.52,0.0001,53,51,2,2,0.01,104,7
0.52,0.0001,96,108,2,2,0.01,204,7
0.52,0.0001,142,162,2,2,0.01,304,7
0.52,0.0001,193,211,2,2,0.01,404,7
0.52,0.0001,239,265,2,2,0.01,504,7
0.52,0.0001,293,311,2,2,0.01,604,7
0.52,0.0001,345,359,2,2,0.01,704,7
0.52,0.0001,396,408,2,2,0.01,804,7
0.52,0.0001,443,461,2,2,0.01,904,7
0.52,0.0001,493,511,2,2,0.01,1004,7
0.654,0.0001,542,562,2,2,0.01,1104,7
0.714,0.0001,591,613,2,2,0.01,1204,7
0.702,0.0001,646,658,2,2,0.01,1304,7
0.698,0.0001,695,709,2,2,0.01,1404,7
0.688,0.0001,742,762,2,2,0.01,1504,7
0.684,0.0001,797,807,2,2,0.01,1604,7
0.678,0.0001,851,853,2,2,0.01,1704,7
0.678,0.0001,907,897,2,2,0.01,1804,7
0.68,0.0001,953,951,2,2,0.01,1904,7
0.682,0.0001,992,1012,2,2,0.01,2004,7
0.46,0.0001,51,53,2,2,0.01,104,8
0.46,0.0001,96,108,2,2,0.01,204,8
0.46,0.0001,144,160,2,2,0.01,304,8
0.468,0.0001,207,197,2,2,0.01,404,8
0.47,0.0001,257,247,2,2,0.01,504,8
0.474,0.0001,309,295,2,2,0.01,604,8
0.496,0.0001,361,343,2,2,0.01,704,8
0.524,0.0001,413,391,2,2,0.01,804,8
0.524,0.0001,470,434,2,2,0.01,904,8
0.524,0.0001,518,486,2,2,0.01,1004,8
0.538,0.0001,570,534,2,2,0.01,1104,8
0.546,0.0001,623,581,2,2,0.01,1204,8
0.566,0.0001,677,627,2,2,0.01,1304,8
0.586,0.0001,724,680,2,2,0.01,1404,8
0.594,0.0001,775,729,2,2,0.01,1504,8
0.602,0.0001,828,776,2,2,0.01,1604,8
0.602,0.0001,879,825,2,2,0.01,1704,8
0.614,0.0001,928,876,2,2,0.01,1804,8
0.614,0.0001,975,929,2,2,0.01,1904,8
0.618,0.0001,1022,982,2,2,0.01,2004,8
0.51,0.0001,53,51,2,2,0.01,104,9
0.51,0.0001,107,97,2,2,0.01,204,9
0.51,0.0001,158,146,2,2,0.01,304,9
0.51,0.0001,215,189,2,2,0.01,404,9
0.51,0.0001,275,229,2,2,0.01,504,9
0.51,0.0001,327,277,2,2,0.01,604,9
0.51,0.0001,378,326,2,2,0.01,704,9
0.516,0.0001,423,381,2,2,0.01,804,9
0.536,0.0001,471,433,2,2,0.01,904,9
0.554,0.0001,520,484,2,2,0.01,1004,9
0.54,0.0001,562,542,2,2,0.01,1104,9
0.546,0.0001,609,595,2,2,0.01,1204,9
0.546,0.0001,653,651,2,2,0.01,1304,9
0.54,0.0001,701,703,2,2,0.01,1404,9
0.538,0.0001,752,752,2,2,0.01,1504,9
0.534,0.0001,807,797,2,2,0.01,1604,9
0.536,0.0001,853,851,2,2,0.01,1704,9
0.538,0.0001,904,900,2,2,0.01,1804,9
0.54,0.0001,951,953,2,2,0.01,1904,9
0.546,0.0001,997,1007,2,2,0.01,2004,9
0.512,0.0001,58,46,2,2,0.01,104,10
0.512,0.0001,108,96,2,2,0.01,204,10
0.512,0.0001,156,148,2,2,0.01,304,10
0.512,0.0001,213,191,2,2,0.01,404,10
0.512,0.0001,263,241,2,2,0.01,504,10
0.512,0.0001,319,285,2,2,0.01,604,10
0.5,0.0001,369,335,2,2,0.01,704,10
0.482,0.0001,423,381,2,2,0.01,804,10
0.48,0.0001,466,438,2,2,0.01,904,10
0.502,0.0001,522,482,2,2,0.01,1004,10
0.508,0.0001,569,535,2,2,0.01,1104,10
0.532,0.0001,615,589,2,2,0.01,1204,10
0.542,0.0001,670,634,2,2,0.01,1304,10
0.554,0.0001,713,691,2,2,0.01,1404,10
0.58,0.0001,755,749,2,2,0.01,1504,10
0.646,0.0001,799,805,2,2,0.01,1604,10
0.662,0.0001,855,849,2,2,0.01,1704,10
0.688,0.0001,903,901,2,2,0.01,1804,10
0.698,0.0001,959,945,2,2,0.01,1904,10
0.716,0.0001,1008,996,2,2,0.01,2004,10
0.512,0.0001,49,55,2,2,0.01,104,11
0.512,0.0001,99,105,2,2,0.01,204,11
0.512,0.0001,141,163,2,2,0.01,304,11
0.512,0.0001,199,205,2,2,0.01,404,11
0.512,0.0001,254,250,2,2,0.01,504,11
0.512,0.0001,303,301,2,2,0.01,604,11
0.512,0.0001,355,349,2,2,0.01,704,11
0.512,0.0001,406,398,2,2,0.01,804,11
0.512,0.0001,454,450,2,2,0.01,904,11
0.512,0.0001,511,493,2,2,0.01,1004,11
0.512,0.0001,558,546,2,2,0.01,1104,11
0.512,0.0001,604,600,2,2,0.01,1204,11
0.512,0.0001,667,637,2,2,0.01,1304,11
0.512,0.0001,712,692,2,2,0.01,1404,11
0.512,0.0001,758,746,2,2,0.01,1504,11
0.512,0.0001,808,796,2,2,0.01,1604,11
0.512,0.0001,858,846,2,2,0.01,1704,11
0.612,0.0001,914,890,2,2,0.01,1804,11
0.608,0.0001,964,940,2,2,0.01,1904,11
0.606,0.0001,1008,996,2,2,0.01,2004,11
0.452,0.0001,56,48,2,2,0.01,104,12
0.458,0.0001,100,104,2,2,0.01,204,12
0.462,0.0001,151,153,2,2,0.01,304,12
0.474,0.0001,200,204,2,2,0.01,404,12
0.476,0.0001,251,253,2,2,0.01,504,12
0.478,0.0001,308,296,2,2,0.01,604,12
0.484,0.0001,361,343,2,2,0.01,704,12
0.51,0.0001,412,392,2,2,0.01,804,12
0.518,0.0001,460,444,2,2,0.01,904,12
0.524,0.0001,510,494,2,2,0.01,1004,12
0.534,0.0001,569,535,2,2,0.01,1104,12
0.546,0.0001,613,591,2,2,0.01,1204,12
0.544,0.0001,665,639,2,2,0.01,1304,12
0.54,0.0001,705,699,2,2,0.01,1404,12
0.54,0.0001,763,741,2,2,0.01,1504,12
0.536,0.0001,806,798,2,2,0.01,1604,12
0.554,0.0001,851,853,2,2,0.01,1704,12
0.57,0.0001,902,902,2,2,0.01,1804,12
0.604,0.0001,947,957,2,2,0.01,1904,12
0.626,0.0001,995,1009,2,2,0.01,2004,12
0.454,0.0001,51,53,2,2,0.01,104,13
0.448,0.0001,104,100,2,2,0.01,204,13
0.432,0.0001,159,145,2,2,0.01,304,13
0.492,0.0001,206,198,2,2,0.01,404,13
0.486,0.0001,244,260,2,2,0.01,504,13
0.47,0.0001,293,311,2,2,0.01,604,13
0.464,0.0001,340,364,2,2,0.01,704,13
0.448,0.0001,392,412,2,2,0.01,804,13
0.456,0.0001,435,469,2,2,0.01,904,13
0.462,0.0001,483,521,2,2,0.01,1004,13
0.468,0.0001,540,564,2,2,0.01,1104,13
0.482,0.0001,586,618,2,2,0.01,1204,13
0.484,0.0001,639,665,2,2,0.01,1304,13
0.502,0.0001,687,717,2,2,0.01,1404,13
0.514,0.0001,741,763,2,2,0.01,1504,13
0.532,0.0001,792,812,2,2,0.01,1604,13
0.546,0.0001,843,861,2,2,0.01,1704,13
0.564,0.0001,890,914,2,2,0.01,1804,13
0.606,0.0001,947,957,2,2,0.01,1904,13
0.642,0.0001,991,1013,2,2,0.01,2004,13
0.478,0.0001,57,47,2,2,0.01,104,14
0.478,0.0001,116,88,2,2,0.01,204,14
0.472,0.0001,165,139,2,2,0.01,304,14
0.462,0.0001,220,184,2,2,0.01,404,14
0.46,0.0001,269,235,2,2,0.01,504,14
0.46,0.0001,324,280,2,2,0.01,604,14
0.47,0.0001,373,331,2,2,0.01,704,14
0.472,0.0001,422,382,2,2,0.01,804,14
0.474,0.0001,469,435,2,2,0.01,904,14
0.474,0.0001,517,487,2,2,0.01,1004,14
0.482,0.0001,570,534,2,2,0.01,1104,14
0.504,0.0001,618,586,2,2,0.01,1204,14
0.516,0.0001,671,633,2,2,0.01,1304,14
0.532,0.0001,723,681,2,2,0.01,1404,14
0.562,0.0001,765,739,2,2,0.01,1504,14
0.582,0.0001,805,799,2,2,0.01,1604,14
0.592,0.0001,855,849,2,2,0.01,1704,14
0.64,0.0001,898,906,2,2,0.01,1804,14
0.698,0.0001,946,958,2,2,0.01,1904,14
0.74,0.0001,991,1013,2,2,0.01,2004,14
0.49,0.0001,47,57,2,2,0.01,104,15
0.49,0.0001,97,107,2,2,0.01,204,15
0.49,0.0001,142,162,2,2,0.01,304,15
0.508,0.0001,193,211,2,2,0.01,404,15
0.532,0.0001,242,262,2,2,0.01,504,15
0.566,0.0001,293,311,2,2,0.01,604,15
0.55,0.0001,346,358,2,2,0.01,704,15
0.552,0.0001,403,401,2,2,0.01,804,15
0.546,0.0001,451,453,2,2,0.01,904,15
0.546,0.0001,506,498,2,2,0.01,1004,15
0.542,0.0001,559,545,2,2,0.01,1104,15
0.542,0.0001,601,603,2,2,0.01,1204,15
0.548,0.0001,647,657,2,2,0.01,1304,15
0.548,0.0001,709,695,2,2,0.01,1404,15
0.546,0.0001,757,747,2,2,0.01,1504,15
0.55,0.0001,807,797,2,2,0.01,1604,15
0.548,0.0001,861,843,2,2,0.01,1704,15
0.542,0.0001,908,896,2,2,0.01,1804,15
0.54,0.0001,960,944,2,2,0.01,1904,15
0.56,0.0001,1007,997,2,2,0.01,2004,15
0.486,0.0001,61,43,2,2,0.01,104,16
0.486,0.0001,117,87,2,2,0.01,204,16
0.486,0.0001,165,139,2,2,0.01,304,16
0.486,0.0001,212,192,2,2,0.01,404,16
0.486,0.0001,265,239,2,2,0.01,504,16
0.486,0.0001,306,298,2,2,0.01,604,16
0.486,0.0001,363,341,2,2,0.01,704,16
0.486,0.0001,420,384,2,2,0.01,804,16
0.486,0.0001,473,431,2,2,0.01,904,16
0.486,0.0001,527,477,2,2,0.01,1004,16
0.486,0.0001,576,528,2,2,0.01,1104,16
0.486,0.0001,623,581,2,2,0.01,1204,16
0.486,0.0001,680,624,2,2,0.01,1304,16
0.486,0.0001,721,683,2,2,0.01,1404,16
0.486,0.0001,772,732,2,2,0.01,1504,16
0.486,0.0001,819,785,2,2,0.01,1604,16
0.486,0.0001,867,837,2,2,0.01,1704,16
0.486,0.0001,918,886,2,2,0.01,1804,16
0.486,0.0001,961,943,2,2,0.01,1904,16
0.486,0.0001,1009,995,2,2,0.01,2004,16
0.508,0.0001,53,51,2,2,0.01,104,17
0.508,0.0001,107,97,2,2,0.01,204,17
0.526,0.0001,154,150,2,2,0.01,304,17
0.532,0.0001,213,191,2,2,0.01,404,17
0.54,0.0001,260,244,2,2,0.01,504,17
0.54,0.0001,303,301,2,2,0.01,604,17
0.566,0.0001,352,352,2,2,0.01,704,17
0.602,0.0001,401,403,2,2,0.01,804,17
0.61,0.0001,444,460,2,2,0.01,904,17
0.616,0.0001,502,502,2,2,0.01,1004,17
0.62,0.0001,552,552,2,2,0.01,1104,17
0.614,0.0001,594,610,2,2,0.01,1204,17
0.618,0.0001,651,653,2,2,0.01,1304,17
0.628,0.0001,701,703,2,2,0.01,1404,17
0.646,0.0001,754,750,2,2,0.01,1504,17
0.652,0.0001,807,797,2,2,0.01,1604,17
0.646,0.0001,846,858,2,2,0.01,1704,17
0.65,0.0001,889,915,2,2,0.01,1804,17
0.658,0.0001,946,958,2,2,0.01,1904,17
0.67,0.0001,998,1006,2,2,0.01,2004,17
0.51,0.0001,39,65,2,2,0.01,104,18
0.51,0.0001,89,115,2,2,0.01,204,18
0.51,0.0001,148,156,2,2,0.01,304,18
0.51,0.0001,193,211,2,2,0.01,404,18
0.51,0.0001,240,264,2,2,0.01,504,18
0.51,0.0001,288,316,2,2,0.01,604,18
0.51,0.0001,337,367,2,2,0.01,704,18
0.51,0.0001,391,413,2,2,0.01,804,18
0.51,0.0001,442,462,2,2,0.01,904,18
0.51,0.0001,494,510,2,2,0.01,1004,18
0.51,0.0001,542,562,2,2,0.01,1104,18
0.51,0.0001,594,610,2,2,0.01,1204,18
0.512,0.0001,645,659,2,2,0.01,1304,18
0.532,0.0001,693,711,2,2,0.01,1404,18
0.542,0.0001,745,759,2,2,0.01,1504,18
0.552,0.0001,794,810,2,2,0.01,1604,18
0.572,0.0001,848,856,2,2,0.01,1704,18
0.59,0.0001,900,904,2,2,0.01,1804,18
0.64,0.0001,948,956,2,2,0.01,1904,18
0.638,0.0001,1007,997,2,2,0.01,2004,18
0.532,0.0001,58,46,2,2,0.01,104,19
0.518,0.0001,105,99,2,2,0.01,204,19
0.518,0.0001,161,143,2,2,0.01,304,19
0.52,0.0001,220,184,2,2,0.01,404,19
0.538,0.0001,265,239,2,2,0.01,504,19
0.54,0.0001,315,289,2,2,0.01,604,19
0.542,0.0001,365,339,2,2,0.01,704,19
0.544,0.0001,413,391,2,2,0.01,804,19
0.548,0.0001,468,436,2,2,0.01,904,19
0.548,0.0001,518,486,2,2,0.01,1004,19
0.546,0.0001,566,538,2,2,0.01,1104,19
0.548,0.0001,627,577,2,2,0.01,1204,19
0.554,0.0001,674,630,2,2,0.01,1304,19
0.552,0.0001,721,683,2,2,0.01,1404,19
0.552,0.0001,765,739,2,2,0.01,1504,19
0.556,0.0001,814,790,2,2,0.01,1604,19
0.544,0.0001,863,841,2,2,0.01,1704,19
0.54,0.0001,910,894,2,2,0.01,1804,19
0.554,0.0001,952,952,2,2,0.01,1904,19
0.55,0.0001,998,1006,2,2,0.01,2004,19
0.486,0.0001,53,51,2,2,0.01,104,20
0.484,0.0001,102,102,2,2,0.01,204,20
0.482,0.0001,148,156,2,2,0.01,304,20
0.482,0.0001,199,205,2,2,0.01,404,20
0.476,0.0001,253,251,2,2,0.01,504,20
0.47,0.0001,305,299,2,2,0.01,604,20
0.466,0.0001,353,351,2,2,0.01,704,20
0.474,0.0001,404,400,2,2,0.01,804,20
0.484,0.0001,460,444,2,2,0.01,904,20
0.488,0.0001,511,493,2,2,0.01,1004,20
0.484,0.0001,569,535,2,2,0.01,1104,20
0.484,0.0001,615,589,2,2,0.01,1204,20
0.49,0.0001,666,638,2,2,0.01,1304,20
0.506,0.0001,719,685,2,2,0.01,1404,20
0.512,0.0001,764,740,2,2,0.01,1504,20
0.512,0.0001,816,788,2,2,0.01,1604,20
0.534,0.0001,872,832,2,2,0.01,1704,20
0.538,0.0001,926,878,2,2,0.01,1804,20
0.534,0.0001,974,930,2,2,0.01,1904,20
0.524,0.0001,1025,979,2,2,0.01,2004,20
0.496,0.001,39,65,2,2,0.0001,104,1
0.496,0.001,94,110,2,2,0.0001,204,1
0.496,0.001,151,153,2,2,0.0001,304,1
0.496,0.001,206,198,2,2,0.0001,404,1
0.496,0.001,264,240,2,2,0.0001,504,1
0.496,0.001,308,296,2,2,0.0001,604,1
0.496,0.001,352,352,2,2,0.0001,704,1
0.496,0.001,406,398,2,2,0.0001,804,1
0.496,0.001,458,446,2,2,0.0001,904,1
0.496,0.001,504,500,2,2,0.0001,1004,1
0.496,0.001,559,545,2,2,0.0001,1104,1
0.496,0.001,608,596,2,2,0.0001,1204,1
0.496,0.001,662,642,2,2,0.0001,1304,1
0.496,0.001,711,693,2,2,0.0001,1404,1
0.496,0.001,761,743,2,2,0.0001,1504,1
0.496,0.001,818,786,2,2,0.0001,1604,1
0.496,0.001,863,841,2,2,0.0001,1704,1
0.496,0.001,913,891,2,2,0.0001,1804,1
0.496,0.001,952,952,2,2,0.0001,1904,1
0.496,0.001,1004,1000,2,2,0.0001,2004,1
0.482,0.001,55,49,2,2,0.0001,104,2
0.482,0.001,100,104,2,2,0.0001,204,2
0.482,0.001,150,154,2,2,0.0001,304,2
0.482,0.001,204,200,2,2,0.0001,404,2
0.482,0.001,253,251,2,2,0.0001,504,2
0.482,0.001,300,304,2,2,0.0001,604,2
0.482,0.001,344,360,2,2,0.0001,704,2
0.482,0.001,393,411,2,2,0.0001,804,2
0.482,0.001,439,465,2,2,0.0001,904,2
0.482,0.001,492,512,2,2,0.0001,1004,2
0.482,0.001,542,562,2,2,0.0001,1104,2
0.482,0.001,595,609,2,2,0.0001,1204,2
0.482,0.001,644,660,2,2,0.0001,1304,2
0.482,0.001,691,713,2,2,0.0001,1404,2
0.482,0.001,748,756,2,2,0.0001,1504,2
0.482,0.001,796,808,2,2,0.0001,1604,2
0.482,0.001,845,859,2,2,0.0001,1704,2
0.482,0.001,894,910,2,2,0.0001,1804,2
0.482,0.001,950,954,2,2,0.0001,1904,2
0.482,0.001,1003,1001,2,2,0.0001,2004,2
0.516,0.001,48,56,2,2,0.0001,104,3
0.516,0.001,89,115,2,2,0.0001,204,3
0.516,0.001,144,160,2,2,0.0001,304,3
0.516,0.001,188,216,2,2,0.0001,404,3
0.516,0.001,233,271,2,2,0.0001,504,3
0.516,0.001,286,318,2,2,0.0001,604,3
0.516,0.001,334,370,2,2,0.0001,704,3
0.516,0.001,378,426,2,2,0.0001,804,3
0.516,0.001,422,482,2,2,0.0001,904,3
0.516,0.001,470,534,2,2,0.0001,1004,3
0.516,0.001,524,580,2,2,0.0001,1104,3
0.516,0.001,576,628,2,2,0.0001,1204,3
0.516,0.001,630,674,2,2,0.0001,1304,3
0.516,0.001,679,725,2,2,0.0001,1404,3
0.516,0.001,737,767,2,2,0.0001,1504,3
0.516,0.001,790,814,2,2,0.0001,1604,3
0.516,0.001,850,854,2,2,0.0001,1704,3
0.516,0.001,899,905,2,2,0.0001,1804,3
0.516,0.001,946,958,2,2,0.0001,1904,3
0.516,0.001,994,1010,2,2,0.0001,2004,3
0.41,0.001,55,49,2,2,0.0001,104,4
0.41,0.001,102,102,2,2,0.0001,204,4
0.41,0.001,147,157,2,2,0.0001,304,4
0.414,0.001,194,210,2,2,0.0001,404,4
0.414,0.001,248,256,2,2,0.0001,504,4
0.414,0.001,300,304,2,2,0.0001,604,4
0.414,0.001,351,353,2,2,0.0001,704,4
0.414,0.001,397,407,2,2,0.0001,804,4
0.414,0.001,459,445,2,2,0.0001,904,4
0.414,0.001,508,496,2,2,0.0001,1004,4
0.414,0.001,558,546,2,2,0.0001,1104,4
0.414,0.001,606,598,2,2,0.0001,1204,4
0.414,0.001,657,647,2,2,0.0001,1304,4
0.414,0.001,708,696,2,2,0.0001,1404,4
0.414,0.001,759,745,2,2,0.0001,1504,4
0.414,0.001,811,793,2,2,0.0001,1604,4
0.412,0.001,858,846,2,2,0.0001,1704,4
0.412,0.001,908,896,2,2,0.0001,1804,4
0.412,0.001,956,948,2,2,0.0001,1904,4
0.412,0.001,1010,994,2,2,0.0001,2004,4
0.476,0.001,40,64,2,2,0.0001,104,5
0.476,0.001,88,116,2,2,0.0001,204,5
0.476,0.001,142,162,2,2,0.0001,304,5
0.476,0.001,190,214,2,2,0.0001,404,5
0.476,0.001,238,266,2,2,0.0001,504,5
0.476,0.001,295,309,2,2,0.0001,604,5
0.476,0.001,347,357,2,2,0.0001,704,5
0.476,0.001,400,404,2,2,0.0001,804,5
0.476,0.001,450,454,2,2,0.0001,904,5
0.476,0.001,495,509,2,2,0.0001,1004,5
0.476,0.001,551,553,2,2,0.0001,1104,5
0.476,0.001,602,602,2,2,0.0001,1204,5
0.476,0.001,650,654,2,2,0.0001,1304,5
0.476,0.001,692,712,2,2,0.0001,1404,5
0.476,0.001,750,754,2,2,0.0001,1504,5
0.476,0.001,802,802,2,2,0.0001,1604,5
0.476,0.001,858,846,2,2,0.0001,1704,5
0.476,0.001,903,901,2,2,0.0001,1804,5
0.476,0.001,950,954,2,2,0.0001,1904,5
0.476,0.001,1010,994,2,2,0.0001,2004,5
0.52,0.001,47,57,2,2,0.0001,104,6
0.52,0.001,98,106,2,2,0.0001,204,6
0.52,0.001,158,146,2,2,0.0001,304,6
0.52,0.001,207,197,2,2,0.0001,404,6
0.52,0.001,257,247,2,2,0.0001,504,6
0.52,0.001,308,296,2,2,0.0001,604,6
0.52,0.001,363,341,2,2,0.0001,704,6
0.52,0.001,407,397,2,2,0.0001,804,6
0.52,0.001,448,456,2,2,0.0001,904,6
0.52,0.001,498,506,2,2,0.0001,1004,6
0.52,0.001,548,556,2,2,0.0001,1104,6
0.52,0.001,607,597,2,2,0.0001,1204,6
0.52,0.001,656,648,2,2,0.0001,1304,6
0.52,0.001,712,692,2,2,0.0001,1404,6
0.52,0.001,764,740,2,2,0.0001,1504,6
0.52,0.001,808,796,2,2,0.0001,1604,6
0.52,0.001,855,849,2,2,0.0001,1704,6
0.52,0.001,911,893,2,2,0.0001,1804,6
0.52,0.001,964,940,2,2,0.0001,1904,6
0.52,0.001,1012,992,2,2,0.0001,2004,6
0.498,0.001,52,52,2,2,0.0001,104,7
0.498,0.001,92,112,2,2,0.0001,204,7
0.498,0.001,142,162,2,2,0.0001,304,7
0.498,0.001,187,217,2,2,0.0001,404,7
0.498,0.001,238,266,2,2,0.0001,504,7
0.498,0.001,293,311,2,2,0.0001,604,7
0.498,0.001,342,362,2,2,0.0001,704,7
0.498,0.001,392,412,2,2,0.0001,804,7
0.498,0.001,443,461,2,2,0.0001,904,7
0.498,0.001,492,512,2,2,0.0001,1004,7
0.498,0.001,547,557,2,2,0.0001,1104,7
0.498,0.001,593,611,2,2,0.0001,1204,7
0.498,0.001,643,661,2,2,0.0001,1304,7
0.498,0.001,700,704,2,2,0.0001,1404,7
0.498,0.001,753,751,2,2,0.0001,1504,7
0.498,0.001,805,799,2,2,0.0001,1604,7
0.498,0.001,852,852,2,2,0.0001,1704,7
0.498,0.001,904,900,2,2,0.0001,1804,7
0.498,0.001,955,949,2,2,0.0001,1904,7
0.498,0.001,1003,1001,2,2,0.0001,2004,7
0.506,0.001,53,51,2,2,0.0001,104,8
0.506,0.001,100,104,2,2,0.0001,204,8
0.506,0.001,146,158,2,2,0.0001,304,8
0.506,0.001,194,210,2,2,0.0001,404,8
0.506,0.001,249,255,2,2,0.0001,504,8
0.506,0.001,294,310,2,2,0.0001,604,8
0.506,0.001,347,357,2,2,0.0001,704,8
0.506,0.001,403,401,2,2,0.0001,804,8
0.506,0.001,453,451,2,2,0.0001,904,8
0.506,0.001,506,498,2,2,0.0001,1004,8
0.506,0.001,550,554,2,2,0.0001,1104,8
0.506,0.001,603,601,2,2,0.0001,1204,8
0.506,0.001,653,651,2,2,0.0001,1304,8
0.506,0.001,702,702,2,2,0.0001,1404,8
0.506,0.001,753,751,2,2,0.0001,1504,8
0.506,0.001,798,806,2,2,0.0001,1604,8
0.504,0.001,851,853,2,2,0.0001,1704,8
0.504,0.001,900,904,2,2,0.0001,1804,8
0.504,0.001,953,951,2,2,0.0001,1904,8
0.504,0.001,1007,997,2,2,0.0001,2004,8
0.49,0.001,50,54,2,2,0.0001,104,9
0.49,0.001,90,114,2,2,0.0001,204,9
0.49,0.001,150,154,2,2,0.0001,304,9
0.49,0.001,195,209,2,2,0.0001,404,9
0.49,0.001,246,258,2,2,0.0001,504,9
0.49,0.001,295,309,2,2,0.0001,604,9
0.49,0.001,340,364,2,2,0.0001,704,9
0.49,0.001,391,413,2,2,0.0001,804,9
0.49,0.001,445,459,2,2,0.0001,904,9
0.49,0.001,503,501,2,2,0.0001,1004,9
0.49,0.001,554,550,2,2,0.0001,1104,9
0.49,0.001,602,602,2,2,0.0001,1204,9
0.49,0.001,651,653,2,2,0.0001,1304,9
0.49,0.001,699,705,2,2,0.0001,1404,9
0.49,0.001,750,754,2,2,0.0001,1504,9
0.49,0.001,803,801,2,2,0.0001,1604,9
0.49,0.001,847,857,2,2,0.0001,1704,9
0.49,0.001,900,904,2,2,0.0001,1804,9
0.49,0.001,947,957,2,2,0.0001,1904,9
0.49,0.001,997,1007,2,2,0.0001,2004,9
0.468,0.001,53,51,2,2,0.0001,104,10
0.468,0.001,104,100,2,2,0.0001,204,10
0.468,0.001,162,142,2,2,0.0001,304,10
0.468,0.001,212,192,2,2,0.0001,404,10
0.468,0.001,268,236,2,2,0.0001,504,10
0.468,0.001,312,292,2,2,0.0001,604,10
0.468,0.001,360,344,2,2,0.0001,704,10
0.468,0.001,414,390,2,2,0.0001,804,10
0.468,0.001,466,438,2,2,0.0001,904,10
0.468,0.001,523,481,2,2,0.0001,1004,10
0.468,0.001,570,534,2,2,0.0001,1104,10
0.47,0.001,611,593,2,2,0.0001,1204,10
0.47,0.001,658,646,2,2,0.0001,1304,10
0.47,0.001,707,697,2,2,0.0001,1404,10
0.472,0.001,754,750,2,2,0.0001,1504,10
0.472,0.001,798,806,2,2,0.0001,1604,10
0.472,0.001,851,853,2,2,0.0001,1704,10
0.472,0.001,900,904,2,2,0.0001,1804,10
0.472,0.001,950,954,2,2,0.0001,1904,10
0.472,0.001,989,1015,2,2,0.0001,2004,10
0.492,0.001,65,39,2,2,0.0001,104,11
0.492,0.001,117,87,2,2,0.0001,204,11
0.492,0.001,171,133,2,2,0.0001,304,11
0.492,0.001,226,178,2,2,0.0001,404,11
0.492,0.001,269,235,2,2,0.0001,504,11
0.492,0.001,320,284,2,2,0.0001,604,11
0.492,0.001,358,346,2,2,0.0001,704,11
0.492,0.001,409,395,2,2,0.0001,804,11
0.492,0.001,451,453,2,2,0.0001,904,11
0.492,0.001,498,506,2,2,0.0001,1004,11
0.492,0.001,558,546,2,2,0.0001,1104,11
0.492,0.001,608,596,2,2,0.0001,1204,11
0.492,0.001,656,648,2,2,0.0001,1304,11
0.492,0.001,706,698,2,2,0.0001,1404,11
0.492,0.001,754,750,2,2,0.0001,1504,11
0.492,0.001,797,807,2,2,0.0001,1604,11
0.492,0.001,844,860,2,2,0.0001,1704,11
0.492,0.001,894,910,2,2,0.0001,1804,11
0.492,0.001,952,952,2,2,0.0001,1904,11
0.492,0.001,1006,998,2,2,0.0001,2004,11
0.528,0.001,47,57,2,2,0.0001,104,12
0.53,0.001,99,105,2,2,0.0001,204,12
0.53,0.001,158,146,2,2,0.0001,304,12
0.528,0.001,207,197,2,2,0.0001,404,12
0.528,0.001,264,240,2,2,0.0001,504,12
0.528,0.001,313,291,2,2,0.0001,604,12
0.528,0.001,364,340,2,2,0.0001,704,12
0.528,0.001,425,379,2,2,0.0001,804,12
0.528,0.001,474,430,2,2,0.0001,904,12
0.528,0.001,517,487,2,2,0.0001,1004,12
0.528,0.001,560,544,2,2,0.0001,1104,12
0.528,0.001,609,595,2,2,0.0001,1204,12
0.526,0.001,654,650,2,2,0.0001,1304,12
0.526,0.001,704,700,2,2,0.0001,1404,12
0.526,0.001,756,748,2,2,0.0001,1504,12
0.526,0.001,801,803,2,2,0.0001,1604,12
0.526,0.001,844,860,2,2,0.0001,1704,12
0.524,0.001,889,915,2,2,0.0001,1804,12
0.524,0.001,937,967,2,2,0.0001,1904,12
0.524,0.001,987,1017,2,2,0.0001,2004,12
0.478,0.001,47,57,2,2,0.0001,104,13
0.478,0.001,88,116,2,2,0.0001,204,13
0.478,0.001,130,174,2,2,0.0001,304,13
0.478,0.001,177,227,2,2,0.0001,404,13
0.478,0.001,219,285,2,2,0.0001,504,13
0.478,0.001,269,335,2,2,0.0001,604,13
0.478,0.001,317,387,2,2,0.0001,704,13
0.478,0.001,370,434,2,2,0.0001,804,13
0.478,0.001,417,487,2,2,0.0001,904,13
0.478,0.001,470,534,2,2,0.0001,1004,13
0.478,0.001,527,577,2,2,0.0001,1104,13
0.478,0.001,578,626,2,2,0.0001,1204,13
0.478,0.001,620,684,2,2,0.0001,1304,13
0.478,0.001,674,730,2,2,0.0001,1404,13
0.478,0.001,731,773,2,2,0.0001,1504,13
0.478,0.001,785,819,2,2,0.0001,1604,13
0.478,0.001,837,867,2,2,0.0001,1704,13
0.478,0.001,884,920,2,2,0.0001,1804,13
0.478,0.001,931,973,2,2,0.0001,1904,13
0.478,0.001,991,1013,2,2,0.0001,2004,13
0.494,0.001,50,54,2,2,0.0001,104,14
0.494,0.001,100,104,2,2,0.0001,204,14
0.494,0.001,146,158,2,2,0.0001,304,14
0.494,0.001,198,206,2,2,0.0001,404,14
0.494,0.001,253,251,2,2,0.0001,504,14
0.494,0.001,307,297,2,2,0.0001,604,14
0.494,0.001,347,357,2,2,0.0001,704,14
0.494,0.001,394,410,2,2,0.0001,804,14
0.494,0.001,456,448,2,2,0.0001,904,14
0.494,0.001,507,497,2,2,0.0001,1004,14
0.494,0.001,563,541,2,2,0.0001,1104,14
0.494,0.001,607,597,2,2,0.0001,1204,14
0.494,0.001,653,651,2,2,0.0001,1304,14
0.494,0.001,701,703,2,2,0.0001,1404,14
0.494,0.001,753,751,2,2,0.0001,1504,14
0.494,0.001,800,804,2,2,0.0001,1604,14
0.494,0.001,848,856,2,2,0.0001,1704,14
0.494,0.001,907,897,2,2,0.0001,1804,14
0.494,0.001,948,956,2,2,0.0001,1904,14
0.494,0.001,996,1008,2,2,0.0001,2004,14
0.466,0.001,55,49,2,2,0.0001,104,15
0.466,0.001,110,94,2,2,0.0001,204,15
0.466,0.001,158,146,2,2,0.0001,304,15
0.466,0.001,206,198,2,2,0.0001,404,15
0.466,0.001,259,245,2,2,0.0001,504,15
0.466,0.001,309,295,2,2,0.0001,604,15
0.466,0.001,360,344,2,2,0.0001,704,15
0.466,0.001,418,386,2,2,0.0001,804,15
0.466,0.001,461,443,2,2,0.0001,904,15
0.466,0.001,513,491,2,2,0.0001,1004,15
0.466,0.001,559,545,2,2,0.0001,1104,15
0.466,0.001,602,602,2,2,0.0001,1204,15
0.466,0.001,656,648,2,2,0.0001,1304,15
0.466,0.001,713,691,2,2,0.0001,1404,15
0.466,0.001,755,749,2,2,0.0001,1504,15
0.466,0.001,804,800,2,2,0.0001,1604,15
0.466,0.001,847,857,2,2,0.0001,1704,15
0.466,0.001,896,908,2,2,0.0001,1804,15
0.468,0.001,943,961,2,2,0.0001,1904,15
0.47,0.001,1000,1004,2,2,0.0001,2004,15
0.464,0.001,58,46,2,2,0.0001,104,16
0.464,0.001,117,87,2,2,0.0001,204,16
0.464,0.001,175,129,2,2,0.0001,304,16
0.466,0.001,229,175,2,2,0.0001,404,16
0.468,0.001,284,220,2,2,0.0001,504,16
0.47,0.001,340,264,2,2,0.0001,604,16
0.472,0.001,386,318,2,2,0.0001,704,16
0.472,0.001,439,365,2,2,0.0001,804,16
0.472,0.001,480,424,2,2,0.0001,904,16
0.472,0.001,533,471,2,2,0.0001,1004,16
0.472,0.001,580,524,2,2,0.0001,1104,16
0.472,0.001,630,574,2,2,0.0001,1204,16
0.472,0.001,678,626,2,2,0.0001,1304,16
0.472,0.001,725,679,2,2,0.0001,1404,16
0.472,0.001,772,732,2,2,0.0001,1504,16
0.476,0.001,820,784,2,2,0.0001,1604,16
0.476,0.001,868,836,2,2,0.0001,1704,16
0.476,0.001,911,893,2,2,0.0001,1804,16
0.476,0.001,961,943,2,2,0.0001,1904,16
0.476,0.001,1011,993,2,2,0.0001,2004,16
0.466,0.001,51,53,2,2,0.0001,104,17
0.466,0.001,109,95,2,2,0.0001,204,17
0.466,0.001,163,141,2,2,0.0001,304,17
0.466,0.001,208,196,2,2,0.0001,404,17
0.466,0.001,260,244,2,2,0.0001,504,17
0.466,0.001,309,295,2,2,0.0001,604,17
0.466,0.001,361,343,2,2,0.0001,704,17
0.466,0.001,405,399,2,2,0.0001,804,17
0.466,0.001,464,440,2,2,0.0001,904,17
0.466,0.001,513,491,2,2,0.0001,1004,17
0.466,0.001,563,541,2,2,0.0001,1104,17
0.466,0.001,611,593,2,2,0.0001,1204,17
0.466,0.001,664,640,2,2,0.0001,1304,17
0.466,0.001,713,691,2,2,0.0001,1404,17
0.466,0.001,759,745,2,2,0.0001,1504,17
0.466,0.001,813,791,2,2,0.0001,1604,17
0.466,0.001,857,847,2,2,0.0001,1704,17
0.466,0.001,902,902,2,2,0.0001,1804,17
0.466,0.001,955,949,2,2,0.0001,1904,17
0.466,0.001,1008,996,2,2,0.0001,2004,17
0.524,0.001,52,52,2,2,0.0001,104,18
0.524,0.001,108,96,2,2,0.0001,204,18
0.524,0.001,155,149,2,2,0.0001,304,18
0.524,0.001,208,196,2,2,0.0001,404,18
0.524,0.001,256,248,2,2,0.0001,504,18
0.524,0.001,304,300,2,2,0.0001,604,18
0.524,0.001,353,351,2,2,0.0001,704,18
0.524,0.001,400,404,2,2,0.0001,804,18
0.524,0.001,442,462,2,2,0.0001,904,18
0.524,0.001,500,504,2,2,0.0001,1004,18
0.522,0.001,547,557,2,2,0.0001,1104,18
0.522,0.001,596,608,2,2,0.0001,1204,18
0.524,0.001,646,658,2,2,0.0001,1304,18
0.526,0.001,707,697,2,2,0.0001,1404,18
0.526,0.001,754,750,2,2,0.0001,1504,18
0.526,0.001,806,798,2,2,0.0001,1604,18
0.526,0.001,866,838,2,2,0.0001,1704,18
0.526,0.001,921,883,2,2,0.0001,1804,18
0.526,0.001,970,934,2,2,0.0001,1904,18
0.526,0.001,1021,983,2,2,0.0001,2004,18
0.638,0.001,54,50,2,2,0.0001,104,19
0.638,0.001,112,92,2,2,0.0001,204,19
0.638,0.001,164,140,2,2,0.0001,304,19
0.638,0.001,213,191,2,2,0.0001,404,19
0.638,0.001,271,233,2,2,0.0001,504,19
0.638,0.001,318,286,2,2,0.0001,604,19
0.638,0.001,372,332,2,2,0.0001,704,19
0.638,0.001,412,392,2,2,0.0001,804,19
0.638,0.001,465,439,2,2,0.0001,904,19
0.638,0.001,514,490,2,2,0.0001,1004,19
0.638,0.001,567,537,2,2,0.0001,1104,19
0.638,0.001,617,587,2,2,0.0001,1204,19
0.638,0.001,664,640,2,2,0.0001,1304,19
0.638,0.001,711,693,2,2,0.0001,1404,19
0.638,0.001,757,747,2,2,0.0001,1504,19
0.638,0.001,810,794,2,2,0.0001,1604,19
0.638,0.001,860,844,2,2,0.0001,1704,19
0.638,0.001,907,897,2,2,0.0001,1804,19
0.638,0.001,960,944,2,2,0.0001,1904,19
0.64,0.001,1010,994,2,2,0.0001,2004,19
0.49,0.001,54,50,2,2,0.0001,104,20
0.49,0.001,103,101,2,2,0.0001,204,20
0.49,0.001,155,149,2,2,0.0001,304,20
0.49,0.001,202,202,2,2,0.0001,404,20
0.49,0.001,255,249,2,2,0.0001,504,20
0.49,0.001,306,298,2,2,0.0001,604,20
0.49,0.001,350,354,2,2,0.0001,704,20
0.49,0.001,396,408,2,2,0.0001,804,20
0.49,0.001,445,459,2,2,0.0001,904,20
0.49,0.001,499,505,2,2,0.0001,1004,20
0.49,0.001,551,553,2,2,0.0001,1104,20
0.49,0.001,609,595,2,2,0.0001,1204,20
0.49,0.001,664,640,2,2,0.0001,1304,20
0.49,0.001,717,687,2,2,0.0001,1404,20
0.49,0.001,767,737,2,2,0.0001,1504,20
0.49,0.001,814,790,2,2,0.0001,1604,20
0.49,0.001,867,837,2,2,0.0001,1704,20
0.49,0.001,913,891,2,2,0.0001,1804,20
0.49,0.001,960,944,2,2,0.0001,1904,20
0.49,0.001,1007,997,2,2,0.0001,2004,20
0.504,0.001,44,60,2,2,0.001,104,1
0.504,0.001,96,108,2,2,0.001,204,1
0.504,0.001,152,152,2,2,0.001,304,1
0.504,0.001,213,191,2,2,0.001,404,1
0.504,0.001,267,237,2,2,0.001,504,1
0.504,0.001,314,290,2,2,0.001,604,1
0.504,0.001,356,348,2,2,0.001,704,1
0.504,0.001,408,396,2,2,0.001,804,1
0.504,0.001,465,439,2,2,0.001,904,1
0.504,0.001,515,489,2,2,0.001,1004,1
0.504,0.001,564,540,2,2,0.001,1104,1
0.504,0.001,608,596,2,2,0.001,1204,1
0.504,0.001,665,639,2,2,0.001,1304,1
0.504,0.001,713,691,2,2,0.001,1404,1
0.504,0.001,757,747,2,2,0.001,1504,1
0.504,0.001,802,802,2,2,0.001,1604,1
0.504,0.001,857,847,2,2,0.001,1704,1
0.504,0.001,918,886,2,2,0.001,1804,1
0.504,0.001,963,941,2,2,0.001,1904,1
0.504,0.001,1004,1000,2,2,0.001,2004,1
0.54,0.001,54,50,2,2,0.001,104,2
0.54,0.001,104,100,2,2,0.001,204,2
0.54,0.001,149,155,2,2,0.001,304,2
0.54,0.001,197,207,2,2,0.001,404,2
0.54,0.001,248,256,2,2,0.001,504,2
0.544,0.001,302,302,2,2,0.001,604,2
0.546,0.001,346,358,2,2,0.001,704,2
0.546,0.001,389,415,2,2,0.001,804,2
0.548,0.001,444,460,2,2,0.001,904,2
0.552,0.001,498,506,2,2,0.001,1004,2
0.552,0.001,541,563,2,2,0.001,1104,2
0.562,0.001,591,613,2,2,0.001,1204,2
0.564,0.001,642,662,2,2,0.001,1304,2
0.574,0.001,695,709,2,2,0.001,1404,2
0.574,0.001,742,762,2,2,0.001,1504,2
0.574,0.001,797,807,2,2,0.001,1604,2
0.58,0.001,844,860,2,2,0.001,1704,2
0.584,0.001,904,900,2,2,0.001,1804,2
0.588,0.001,951,953,2,2,0.001,1904,2
0.594,0.001,1000,1004,2,2,0.001,2004,2
0.5,0.001,51,53,2,2,0.001,104,3
0.5,0.001,100,104,2,2,0.001,204,3
0.5,0.001,143,161,2,2,0.001,304,3
0.5,0.001,194,210,2,2,0.001,404,3
0.5,0.001,240,264,2,2,0.001,504,3
0.5,0.001,290,314,2,2,0.001,604,3
0.5,0.001,344,360,2,2,0.001,704,3
0.5,0.001,394,410,2,2,0.001,804,3
0.5,0.001,448,456,2,2,0.001,904,3
0.504,0.001,502,502,2,2,0.001,1004,3
0.504,0.001,555,549,2,2,0.001,1104,3
0.506,0.001,605,599,2,2,0.001,1204,3
0.506,0.001,661,643,2,2,0.001,1304,3
0.508,0.001,713,691,2,2,0.001,1404,3
0.514,0.001,760,744,2,2,0.001,1504,3
0.516,0.001,813,791,2,2,0.001,1604,3
0.516,0.001,876,828,2,2,0.001,1704,3
0.518,0.001,917,887,2,2,0.001,1804,3
0.522,0.001,970,934,2,2,0.001,1904,3
0.52,0.001,1024,980,2,2,0.001,2004,3
0.48,0.001,56,48,2,2,0.001,104,4
0.482,0.001,106,98,2,2,0.001,204,4
0.49,0.001,160,144,2,2,0.001,304,4
0.496,0.001,204,200,2,2,0.001,404,4
0.498,0.001,258,246,2,2,0.001,504,4
0.494,0.001,306,298,2,2,0.001,604,4
0.496,0.001,351,353,2,2,0.001,704,4
0.494,0.001,398,406,2,2,0.001,804,4
0.496,0.001,442,462,2,2,0.001,904,4
0.496,0.001,487,517,2,2,0.001,1004,4
0.492,0.001,539,565,2,2,0.001,1104,4
0.492,0.001,588,616,2,2,0.001,1204,4
0.494,0.001,633,671,2,2,0.001,1304,4
0.496,0.001,682,722,2,2,0.001,1404,4
0.5,0.001,736,768,2,2,0.001,1504,4
0.5,0.001,787,817,2,2,0.001,1604,4
0.512,0.001,837,867,2,2,0.001,1704,4
0.518,0.001,883,921,2,2,0.001,1804,4
0.524,0.001,936,968,2,2,0.001,1904,4
0.522,0.001,986,1018,2,2,0.001,2004,4
0.536,0.001,65,39,2,2,0.001,104,5
0.536,0.001,121,83,2,2,0.001,204,5
0.536,0.001,176,128,2,2,0.001,304,5
0.536,0.001,222,182,2,2,0.001,404,5
0.538,0.001,269,235,2,2,0.001,504,5
0.54,0.001,319,285,2,2,0.001,604,5
0.54,0.001,371,333,2,2,0.001,704,5
0.542,0.001,426,378,2,2,0.001,804,5
0.542,0.001,483,421,2,2,0.001,904,5
0.546,0.001,531,473,2,2,0.001,1004,5
0.55,0.001,570,534,2,2,0.001,1104,5
0.554,0.001,621,583,2,2,0.001,1204,5
0.552,0.001,671,633,2,2,0.001,1304,5
0.556,0.001,719,685,2,2,0.001,1404,5
0.558,0.001,773,731,2,2,0.001,1504,5
0.57,0.001,822,782,2,2,0.001,1604,5
0.588,0.001,876,828,2,2,0.001,1704,5
0.584,0.001,915,889,2,2,0.001,1804,5
0.582,0.001,964,940,2,2,0.001,1904,5
0.59,0.001,1011,993,2,2,0.001,2004,5
0.504,0.001,57,47,2,2,0.001,104,6
0.504,0.001,116,88,2,2,0.001,204,6
0.502,0.001,175,129,2,2,0.001,304,6
0.502,0.001,223,181,2,2,0.001,404,6
0.496,0.001,266,238,2,2,0.001,504,6
0.498,0.001,321,283,2,2,0.001,604,6
0.496,0.001,368,336,2,2,0.001,704,6
0.494,0.001,418,386,2,2,0.001,804,6
0.496,0.001,466,438,2,2,0.001,904,6
0.492,0.001,503,501,2,2,0.001,1004,6
0.488,0.001,550,554,2,2,0.001,1104,6
0.482,0.001,596,608,2,2,0.001,1204,6
0.478,0.001,651,653,2,2,0.001,1304,6
0.476,0.001,692,712,2,2,0.001,1404,6
0.472,0.001,746,758,2,2,0.001,1504,6
0.47,0.001,791,813,2,2,0.001,1604,6
0.468,0.001,842,862,2,2,0.001,1704,6
0.466,0.001,886,918,2,2,0.001,1804,6
0.466,0.001,938,966,2,2,0.001,1904,6
0.47,0.001,998,1006,2,2,0.001,2004,6
0.506,0.001,50,54,2,2,0.001,104,7
0.506,0.001,108,96,2,2,0.001,204,7
0.506,0.001,151,153,2,2,0.001,304,7
0.506,0.001,205,199,2,2,0.001,404,7
0.506,0.001,260,244,2,2,0.001,504,7
0.506,0.001,305,299,2,2,0.001,604,7
0.506,0.001,357,347,2,2,0.001,704,7
0.506,0.001,410,394,2,2,0.001,804,7
0.506,0.001,451,453,2,2,0.001,904,7
0.506,0.001,503,501,2,2,0.001,1004,7
0.506,0.001,550,554,2,2,0.001,1104,7
0.506,0.001,604,600,2,2,0.001,1204,7
0.506,0.001,656,648,2,2,0.001,1304,7
0.506,0.001,715,689,2,2,0.001,1404,7
0.506,0.001,764,740,2,2,0.001,1504,7
0.506,0.001,809,795,2,2,0.001,1604,7
0.506,0.001,854,850,2,2,0.001,1704,7
0.506,0.001,910,894,2,2,0.001,1804,7
0.506,0.001,948,956,2,2,0.001,1904,7
0.506,0.001,999,1005,2,2,0.001,2004,7
0.53,0.001,48,56,2,2,0.001,104,8
0.53,0.001,95,109,2,2,0.001,204,8
0.53,0.001,144,160,2,2,0.001,304,8
0.53,0.001,196,208,2,2,0.001,404,8
0.53,0.001,248,256,2,2,0.001,504,8
0.53,0.001,292,312,2,2,0.001,604,8
0.53,0.001,336,368,2,2,0.001,704,8
0.53,0.001,385,419,2,2,0.001,804,8
0.53,0.001,431,473,2,2,0.001,904,8
0.53,0.001,487,517,2,2,0.001,1004,8
0.53,0.001,541,563,2,2,0.001,1104,8
0.53,0.001,599,605,2,2,0.001,1204,8
0.53,0.001,655,649,2,2,0.001,1304,8
0.53,0.001,706,698,2,2,0.001,1404,8
0.53,0.001,756,748,2,2,0.001,1504,8
0.53,0.001,812,792,2,2,0.001,1604,8
0.53,0.001,863,841,2,2,0.001,1704,8
0.53,0.001,915,889,2,2,0.001,1804,8
0.53,0.001,962,942,2,2,0.001,1904,8
0.53,0.001,1017,987,2,2,0.001,2004,8
0.532,0.001,54,50,2,2,0.001,104,9
0.532,0.001,104,100,2,2,0.001,204,9
0.532,0.001,150,154,2,2,0.001,304,9
0.532,0.001,197,207,2,2,0.001,404,9
0.532,0.001,249,255,2,2,0.001,504,9
0.532,0.001,312,292,2,2,0.001,604,9
0.532,0.001,359,345,2,2,0.001,704,9
0.532,0.001,406,398,2,2,0.001,804,9
0.532,0.001,455,449,2,2,0.001,904,9
0.532,0.001,505,499,2,2,0.001,1004,9
0.532,0.001,553,551,2,2,0.001,1104,9
0.532,0.001,603,601,2,2,0.001,1204,9
0.532,0.001,654,650,2,2,0.001,1304,9
0.532,0.001,709,695,2,2,0.001,1404,9
0.532,0.001,755,749,2,2,0.001,1504,9
0.532,0.001,801,803,2,2,0.001,1604,9
0.532,0.001,846,858,2,2,0.001,1704,9
0.532,0.001,896,908,2,2,0.001,1804,9
0.532,0.001,941,963,2,2,0.001,1904,9
0.532,0.001,986,1018,2,2,0.001,2004,9
0.512,0.001,50,54,2,2,0.001,104,10
0.512,0.001,103,101,2,2,0.001,204,10
0.512,0.001,149,155,2,2,0.001,304,10
0.512,0.001,200,204,2,2,0.001,404,10
0.512,0.001,246,258,2,2,0.001,504,10
0.512,0.001,289,315,2,2,0.001,604,10
0.512,0.001,332,372,2,2,0.001,704,10
0.512,0.001,377,427,2,2,0.001,804,10
0.512,0.001,434,470,2,2,0.001,904,10
0.512,0.001,493,511,2,2,0.001,1004,10
0.512,0.001,551,553,2,2,0.001,1104,10
0.512,0.001,597,607,2,2,0.001,1204,10
0.512,0.001,648,656,2,2,0.001,1304,10
0.512,0.001,705,699,2,2,0.001,1404,10
0.512,0.001,749,755,2,2,0.001,1504,10
0.512,0.001,803,801,2,2,0.001,1604,10
0.512,0.001,851,853,2,2,0.001,1704,10
0.512,0.001,894,910,2,2,0.001,1804,10
0.512,0.001,941,963,2,2,0.001,1904,10
0.512,0.001,996,1008,2,2,0.001,2004,10
0.496,0.001,53,51,2,2,0.001,104,11
0.496,0.001,107,97,2,2,0.001,204,11
0.496,0.001,165,139,2,2,0.001,304,11
0.496,0.001,221,183,2,2,0.001,404,11
0.496,0.001,264,240,2,2,0.001,504,11
0.496,0.001,310,294,2,2,0.001,604,11
0.496,0.001,364,340,2,2,0.001,704,11
0.496,0.001,410,394,2,2,0.001,804,11
0.496,0.001,458,446,2,2,0.001,904,11
0.496,0.001,504,500,2,2,0.001,1004,11
0.496,0.001,553,551,2,2,0.001,1104,11
0.496,0.001,607,597,2,2,0.001,1204,11
0.496,0.001,658,646,2,2,0.001,1304,11
0.496,0.001,701,703,2,2,0.001,1404,11
0.496,0.001,754,750,2,2,0.001,1504,11
0.496,0.001,810,794,2,2,0.001,1604,11
0.496,0.001,867,837,2,2,0.001,1704,11
0.496,0.001,916,888,2,2,0.001,1804,11
0.496,0.001,957,947,2,2,0.001,1904,11
0.496,0.001,1004,1000,2,2,0.001,2004,11
0.516,0.001,60,44,2,2,0.001,104,12
0.516,0.001,114,90,2,2,0.001,204,12
0.516,0.001,174,130,2,2,0.001,304,12
0.516,0.001,225,179,2,2,0.001,404,12
0.516,0.001,274,230,2,2,0.001,504,12
0.516,0.001,322,282,2,2,0.001,604,12
0.516,0.001,372,332,2,2,0.001,704,12
0.516,0.001,421,383,2,2,0.001,804,12
0.516,0.001,471,433,2,2,0.001,904,12
0.516,0.001,511,493,2,2,0.001,1004,12
0.516,0.001,559,545,2,2,0.001,1104,12
0.516,0.001,614,590,2,2,0.001,1204,12
0.516,0.001,656,648,2,2,0.001,1304,12
0.518,0.001,709,695,2,2,0.001,1404,12
0.52,0.001,769,735,2,2,0.001,1504,12
0.52,0.001,818,786,2,2,0.001,1604,12
0.52,0.001,865,839,2,2,0.001,1704,12
0.522,0.001,910,894,2,2,0.001,1804,12
0.522,0.001,965,939,2,2,0.001,1904,12
0.522,0.001,1009,995,2,2,0.001,2004,12
0.494,0.001,47,57,2,2,0.001,104,13
0.494,0.001,93,111,2,2,0.001,204,13
0.494,0.001,143,161,2,2,0.001,304,13
0.494,0.001,197,207,2,2,0.001,404,13
0.492,0.001,239,265,2,2,0.001,504,13
0.492,0.001,286,318,2,2,0.001,604,13
0.49,0.001,323,381,2,2,0.001,704,13
0.492,0.001,377,427,2,2,0.001,804,13
0.494,0.001,417,487,2,2,0.001,904,13
0.494,0.001,476,528,2,2,0.001,1004,13
0.492,0.001,528,576,2,2,0.001,1104,13
0.494,0.001,580,624,2,2,0.001,1204,13
0.486,0.001,633,671,2,2,0.001,1304,13
0.486,0.001,679,725,2,2,0.001,1404,13
0.484,0.001,731,773,2,2,0.001,1504,13
0.48,0.001,787,817,2,2,0.001,1604,13
0.48,0.001,837,867,2,2,0.001,1704,13
0.482,0.001,889,915,2,2,0.001,1804,13
0.484,0.001,931,973,2,2,0.001,1904,13
0.486,0.001,989,1015,2,2,0.001,2004,13
0.53,0.001,55,49,2,2,0.001,104,14
0.53,0.001,103,101,2,2,0.001,204,14
0.53,0.001,152,152,2,2,0.001,304,14
0.53,0.001,207,197,2,2,0.001,404,14
0.53,0.001,261,243,2,2,0.001,504,14
0.532,0.001,299,305,2,2,0.001,604,14
0.532,0.001,346,358,2,2,0.001,704,14
0.53,0.001,393,411,2,2,0.001,804,14
0.528,0.001,445,459,2,2,0.001,904,14
0.526,0.001,503,501,2,2,0.001,1004,14
0.526,0.001,551,553,2,2,0.001,1104,14
0.53,0.001,598,606,2,2,0.001,1204,14
0.53,0.001,643,661,2,2,0.001,1304,14
0.536,0.001,691,713,2,2,0.001,1404,14
0.534,0.001,737,767,2,2,0.001,1504,14
0.54,0.001,786,818,2,2,0.001,1604,14
0.536,0.001,843,861,2,2,0.001,1704,14
0.542,0.001,901,903,2,2,0.001,1804,14
0.546,0.001,947,957,2,2,0.001,1904,14
0.556,0.001,990,1014,2,2,0.001,2004,14
0.524,0.001,55,49,2,2,0.001,104,15
0.524,0.001,99,105,2,2,0.001,204,15
0.524,0.001,150,154,2,2,0.001,304,15
0.524,0.001,191,213,2,2,0.001,404,15
0.524,0.001,251,253,2,2,0.001,504,15
0.524,0.001,295,309,2,2,0.001,604,15
0.524,0.001,357,347,2,2,0.001,704,15
0.524,0.001,411,393,2,2,0.001,804,15
0.524,0.001,458,446,2,2,0.001,904,15
0.524,0.001,510,494,2,2,0.001,1004,15
0.524,0.001,567,537,2,2,0.001,1104,15
0.524,0.001,616,588,2,2,0.001,1204,15
0.524,0.001,654,650,2,2,0.001,1304,15
0.524,0.001,697,707,2,2,0.001,1404,15
0.524,0.001,748,756,2,2,0.001,1504,15
0.524,0.001,803,801,2,2,0.001,1604,15
0.524,0.001,850,854,2,2,0.001,1704,15
0.524,0.001,893,911,2,2,0.001,1804,15
0.524,0.001,944,960,2,2,0.001,1904,15
0.524,0.001,990,1014,2,2,0.001,2004,15
0.498,0.001,53,51,2,2,0.001,104,16
0.496,0.001,111,93,2,2,0.001,204,16
0.498,0.001,172,132,2,2,0.001,304,16
0.496,0.001,220,184,2,2,0.001,404,16
0.496,0.001,267,237,2,2,0.001,504,16
0.494,0.001,313,291,2,2,0.001,604,16
0.494,0.001,361,343,2,2,0.001,704,16
0.49,0.001,411,393,2,2,0.001,804,16
0.49,0.001,469,435,2,2,0.001,904,16
0.49,0.001,524,480,2,2,0.001,1004,16
0.492,0.001,571,533,2,2,0.001,1104,16
0.494,0.001,622,582,2,2,0.001,1204,16
0.494,0.001,672,632,2,2,0.001,1304,16
0.494,0.001,720,684,2,2,0.001,1404,16
0.494,0.001,774,730,2,2,0.001,1504,16
0.494,0.001,821,783,2,2,0.001,1604,16
0.496,0.001,872,832,2,2,0.001,1704,16
0.498,0.001,913,891,2,2,0.001,1804,16
0.498,0.001,965,939,2,2,0.001,1904,16
0.498,0.001,1009,995,2,2,0.001,2004,16
0.48,0.001,52,52,2,2,0.001,104,17
0.48,0.001,96,108,2,2,0.001,204,17
0.48,0.001,155,149,2,2,0.001,304,17
0.48,0.001,199,205,2,2,0.001,404,17
0.48,0.001,251,253,2,2,0.001,504,17
0.48,0.001,310,294,2,2,0.001,604,17
0.48,0.001,356,348,2,2,0.001,704,17
0.48,0.001,409,395,2,2,0.001,804,17
0.48,0.001,458,446,2,2,0.001,904,17
0.48,0.001,503,501,2,2,0.001,1004,17
0.48,0.001,564,540,2,2,0.001,1104,17
0.48,0.001,614,590,2,2,0.001,1204,17
0.48,0.001,662,642,2,2,0.001,1304,17
0.48,0.001,704,700,2,2,0.001,1404,17
0.48,0.001,752,752,2,2,0.001,1504,17
0.48,0.001,801,803,2,2,0.001,1604,17
0.48,0.001,847,857,2,2,0.001,1704,17
0.48,0.001,904,900,2,2,0.001,1804,17
0.48,0.001,955,949,2,2,0.001,1904,17
0.48,0.001,1012,992,2,2,0.001,2004,17
0.524,0.001,49,55,2,2,0.001,104,18
0.524,0.001,94,110,2,2,0.001,204,18
0.524,0.001,145,159,2,2,0.001,304,18
0.524,0.001,197,207,2,2,0.001,404,18
0.524,0.001,256,248,2,2,0.001,504,18
0.524,0.001,307,297,2,2,0.001,604,18
0.524,0.001,356,348,2,2,0.001,704,18
0.524,0.001,407,397,2,2,0.001,804,18
0.524,0.001,469,435,2,2,0.001,904,18
0.524,0.001,518,486,2,2,0.001,1004,18
0.524,0.001,574,530,2,2,0.001,1104,18
0.524,0.001,621,583,2,2,0.001,1204,18
0.524,0.001,666,638,2,2,0.001,1304,18
0.524,0.001,709,695,2,2,0.001,1404,18
0.524,0.001,756,748,2,2,0.001,1504,18
0.524,0.001,809,795,2,2,0.001,1604,18
0.524,0.001,859,845,2,2,0.001,1704,18
0.524,0.001,915,889,2,2,0.001,1804,18
0.524,0.001,960,944,2,2,0.001,1904,18
0.524,0.001,1014,990,2,2,0.001,2004,18
0.54,0.001,49,55,2,2,0.001,104,19
0.54,0.001,105,99,2,2,0.001,204,19
0.54,0.001,152,152,2,2,0.001,304,19
0.536,0.001,209,195,2,2,0.001,404,19
0.54,0.001,261,243,2,2,0.001,504,19
0.536,0.001,311,293,2,2,0.001,604,19
0.534,0.001,370,334,2,2,0.001,704,19
0.536,0.001,424,380,2,2,0.001,804,19
0.528,0.001,474,430,2,2,0.001,904,19
0.534,0.001,516,488,2,2,0.001,1004,19
0.538,0.001,554,550,2,2,0.001,1104,19
0.542,0.001,599,605,2,2,0.001,1204,19
0.542,0.001,649,655,2,2,0.001,1304,19
0.546,0.001,703,701,2,2,0.001,1404,19
0.554,0.001,755,749,2,2,0.001,1504,19
0.552,0.001,806,798,2,2,0.001,1604,19
0.56,0.001,848,856,2,2,0.001,1704,19
0.556,0.001,905,899,2,2,0.001,1804,19
0.564,0.001,948,956,2,2,0.001,1904,19
0.568,0.001,1004,1000,2,2,0.001,2004,19
0.502,0.001,56,48,2,2,0.001,104,20
0.502,0.001,109,95,2,2,0.001,204,20
0.502,0.001,160,144,2,2,0.001,304,20
0.502,0.001,211,193,2,2,0.001,404,20
0.502,0.001,259,245,2,2,0.001,504,20
0.502,0.001,297,307,2,2,0.001,604,20
0.502,0.001,355,349,2,2,0.001,704,20
0.502,0.001,401,403,2,2,0.001,804,20
0.502,0.001,454,450,2,2,0.001,904,20
0.502,0.001,506,498,2,2,0.001,1004,20
0.502,0.001,553,551,2,2,0.001,1104,20
0.502,0.001,610,594,2,2,0.001,1204,20
0.502,0.001,659,645,2,2,0.001,1304,20
0.502,0.001,721,683,2,2,0.001,1404,20
0.5,0.001,761,743,2,2,0.001,1504,20
0.508,0.001,816,788,2,2,0.001,1604,20
0.51,0.001,864,840,2,2,0.001,1704,20
0.51,0.001,915,889,2,2,0.001,1804,20
0.508,0.001,962,942,2,2,0.001,1904,20
0.508,0.001,1011,993,2,2,0.001,2004,20
0.352,0.001,48,56,2,2,0.01,104,1
0.338,0.001,106,98,2,2,0.01,204,1
0.334,0.001,157,147,2,2,0.01,304,1
0.338,0.001,207,197,2,2,0.01,404,1
0.342,0.001,251,253,2,2,0.01,504,1
0.356,0.001,296,308,2,2,0.01,604,1
0.402,0.001,354,350,2,2,0.01,704,1
0.464,0.001,403,401,2,2,0.01,804,1
0.496,0.001,455,449,2,2,0.01,904,1
0.554,0.001,504,500,2,2,0.01,1004,1
0.594,0.001,562,542,2,2,0.01,1104,1
0.618,0.001,608,596,2,2,0.01,1204,1
0.642,0.001,658,646,2,2,0.01,1304,1
0.644,0.001,708,696,2,2,0.01,1404,1
0.642,0.001,766,738,2,2,0.01,1504,1
0.646,0.001,813,791,2,2,0.01,1604,1
0.648,0.001,864,840,2,2,0.01,1704,1
0.68,0.001,909,895,2,2,0.01,1804,1
0.688,0.001,960,944,2,2,0.01,1904,1
0.706,0.001,1007,997,2,2,0.01,2004,1
0.514,0.001,47,57,2,2,0.01,104,2
0.514,0.001,92,112,2,2,0.01,204,2
0.514,0.001,139,165,2,2,0.01,304,2
0.514,0.001,195,209,2,2,0.01,404,2
0.514,0.001,238,266,2,2,0.01,504,2
0.514,0.001,285,319,2,2,0.01,604,2
0.514,0.001,340,364,2,2,0.01,704,2
0.514,0.001,394,410,2,2,0.01,804,2
0.514,0.001,442,462,2,2,0.01,904,2
0.514,0.001,494,510,2,2,0.01,1004,2
0.514,0.001,539,565,2,2,0.01,1104,2
0.51,0.001,595,609,2,2,0.01,1204,2
0.51,0.001,644,660,2,2,0.01,1304,2
0.48,0.001,695,709,2,2,0.01,1404,2
0.472,0.001,739,765,2,2,0.01,1504,2
0.476,0.001,773,831,2,2,0.01,1604,2
0.474,0.001,829,875,2,2,0.01,1704,2
0.47,0.001,882,922,2,2,0.01,1804,2
0.482,0.001,946,958,2,2,0.01,1904,2
0.52,0.001,995,1009,2,2,0.01,2004,2
0.484,0.001,44,60,2,2,0.01,104,3
0.484,0.001,89,115,2,2,0.01,204,3
0.484,0.001,137,167,2,2,0.01,304,3
0.484,0.001,184,220,2,2,0.01,404,3
0.484,0.001,237,267,2,2,0.01,504,3
0.486,0.001,275,329,2,2,0.01,604,3
0.486,0.001,330,374,2,2,0.01,704,3
0.492,0.001,377,427,2,2,0.01,804,3
0.484,0.001,433,471,2,2,0.01,904,3
0.484,0.001,486,518,2,2,0.01,1004,3
0.496,0.001,537,567,2,2,0.01,1104,3
0.53,0.001,585,619,2,2,0.01,1204,3
0.594,0.001,630,674,2,2,0.01,1304,3
0.63,0.001,680,724,2,2,0.01,1404,3
0.616,0.001,730,774,2,2,0.01,1504,3
0.612,0.001,777,827,2,2,0.01,1604,3
0.592,0.001,836,868,2,2,0.01,1704,3
0.596,0.001,882,922,2,2,0.01,1804,3
0.614,0.001,941,963,2,2,0.01,1904,3
0.618,0.001,994,1010,2,2,0.01,2004,3
0.522,0.001,44,60,2,2,0.01,104,4
0.522,0.001,100,104,2,2,0.01,204,4
0.524,0.001,149,155,2,2,0.01,304,4
0.526,0.001,199,205,2,2,0.01,404,4
0.526,0.001,244,260,2,2,0.01,504,4
0.526,0.001,304,300,2,2,0.01,604,4
0.526,0.001,351,353,2,2,0.01,704,4
0.526,0.001,402,402,2,2,0.01,804,4
0.526,0.001,458,446,2,2,0.01,904,4
0.526,0.001,508,496,2,2,0.01,1004,4
0.526,0.001,555,549,2,2,0.01,1104,4
0.526,0.001,601,603,2,2,0.01,1204,4
0.526,0.001,651,653,2,2,0.01,1304,4
0.526,0.001,705,699,2,2,0.01,1404,4
0.526,0.001,746,758,2,2,0.01,1504,4
0.528,0.001,792,812,2,2,0.01,1604,4
0.528,0.001,840,864,2,2,0.01,1704,4
0.528,0.001,891,913,2,2,0.01,1804,4
0.528,0.001,939,965,2,2,0.01,1904,4
0.528,0.001,989,1015,2,2,0.01,2004,4
0.504,0.001,59,45,2,2,0.01,104,5
0.508,0.001,117,87,2,2,0.01,204,5
0.51,0.001,178,126,2,2,0.01,304,5
0.512,0.001,224,180,2,2,0.01,404,5
0.512,0.001,275,229,2,2,0.01,504,5
0.504,0.001,320,284,2,2,0.01,604,5
0.492,0.001,363,341,2,2,0.01,704,5
0.506,0.001,408,396,2,2,0.01,804,5
0.53,0.001,456,448,2,2,0.01,904,5
0.57,0.001,507,497,2,2,0.01,1004,5
0.578,0.001,556,548,2,2,0.01,1104,5
0.586,0.001,597,607,2,2,0.01,1204,5
0.594,0.001,644,660,2,2,0.01,1304,5
0.606,0.001,692,712,2,2,0.01,1404,5
0.584,0.001,743,761,2,2,0.01,1504,5
0.578,0.001,796,808,2,2,0.01,1604,5
0.582,0.001,838,866,2,2,0.01,1704,5
0.584,0.001,891,913,2,2,0.01,1804,5
0.614,0.001,943,961,2,2,0.01,1904,5
0.622,0.001,997,1007,2,2,0.01,2004,5
0.53,0.001,53,51,2,2,0.01,104,6
0.53,0.001,104,100,2,2,0.01,204,6
0.53,0.001,160,144,2,2,0.01,304,6
0.53,0.001,204,200,2,2,0.01,404,6
0.53,0.001,254,250,2,2,0.01,504,6
0.53,0.001,301,303,2,2,0.01,604,6
0.53,0.001,352,352,2,2,0.01,704,6
0.53,0.001,406,398,2,2,0.01,804,6
0.53,0.001,450,454,2,2,0.01,904,6
0.53,0.001,498,506,2,2,0.01,1004,6
0.53,0.001,544,560,2,2,0.01,1104,6
0.538,0.001,589,615,2,2,0.01,1204,6
0.49,0.001,646,658,2,2,0.01,1304,6
0.512,0.001,696,708,2,2,0.01,1404,6
0.51,0.001,759,745,2,2,0.01,1504,6
0.508,0.001,810,794,2,2,0.01,1604,6
0.502,0.001,860,844,2,2,0.01,1704,6
0.508,0.001,907,897,2,2,0.01,1804,6
0.54,0.001,966,938,2,2,0.01,1904,6
0.516,0.001,1017,987,2,2,0.01,2004,6
0.522,0.001,47,57,2,2,0.01,104,7
0.522,0.001,94,110,2,2,0.01,204,7
0.52,0.001,148,156,2,2,0.01,304,7
0.52,0.001,198,206,2,2,0.01,404,7
0.51,0.001,249,255,2,2,0.01,504,7
0.508,0.001,300,304,2,2,0.01,604,7
0.512,0.001,353,351,2,2,0.01,704,7
0.506,0.001,396,408,2,2,0.01,804,7
0.502,0.001,451,453,2,2,0.01,904,7
0.514,0.001,506,498,2,2,0.01,1004,7
0.522,0.001,558,546,2,2,0.01,1104,7
0.542,0.001,608,596,2,2,0.01,1204,7
0.54,0.001,661,643,2,2,0.01,1304,7
0.548,0.001,704,700,2,2,0.01,1404,7
0.568,0.001,750,754,2,2,0.01,1504,7
0.59,0.001,797,807,2,2,0.01,1604,7
0.614,0.001,851,853,2,2,0.01,1704,7
0.64,0.001,913,891,2,2,0.01,1804,7
0.658,0.001,966,938,2,2,0.01,1904,7
0.694,0.001,1011,993,2,2,0.01,2004,7
0.506,0.001,57,47,2,2,0.01,104,8
0.506,0.001,106,98,2,2,0.01,204,8
0.506,0.001,161,143,2,2,0.01,304,8
0.506,0.001,211,193,2,2,0.01,404,8
0.506,0.001,264,240,2,2,0.01,504,8
0.506,0.001,311,293,2,2,0.01,604,8
0.49,0.001,356,348,2,2,0.01,704,8
0.468,0.001,397,407,2,2,0.01,804,8
0.466,0.001,459,445,2,2,0.01,904,8
0.488,0.001,502,502,2,2,0.01,1004,8
0.582,0.001,552,552,2,2,0.01,1104,8
0.58,0.001,604,600,2,2,0.01,1204,8
0.528,0.001,651,653,2,2,0.01,1304,8
0.504,0.001,699,705,2,2,0.01,1404,8
0.556,0.001,745,759,2,2,0.01,1504,8
0.552,0.001,794,810,2,2,0.01,1604,8
0.54,0.001,845,859,2,2,0.01,1704,8
0.542,0.001,897,907,2,2,0.01,1804,8
0.538,0.001,948,956,2,2,0.01,1904,8
0.54,0.001,999,1005,2,2,0.01,2004,8
0.49,0.001,53,51,2,2,0.01,104,9
0.484,0.001,109,95,2,2,0.01,204,9
0.484,0.001,156,148,2,2,0.01,304,9
0.476,0.001,201,203,2,2,0.01,404,9
0.472,0.001,239,265,2,2,0.01,504,9
0.466,0.001,295,309,2,2,0.01,604,9
0.462,0.001,343,361,2,2,0.01,704,9
0.464,0.001,392,412,2,2,0.01,804,9
0.468,0.001,434,470,2,2,0.01,904,9
0.46,0.001,493,511,2,2,0.01,1004,9
0.462,0.001,543,561,2,2,0.01,1104,9
0.464,0.001,602,602,2,2,0.01,1204,9
0.48,0.001,647,657,2,2,0.01,1304,9
0.484,0.001,695,709,2,2,0.01,1404,9
0.496,0.001,749,755,2,2,0.01,1504,9
0.512,0.001,800,804,2,2,0.01,1604,9
0.54,0.001,853,851,2,2,0.01,1704,9
0.572,0.001,905,899,2,2,0.01,1804,9
0.59,0.001,946,958,2,2,0.01,1904,9
0.628,0.001,999,1005,2,2,0.01,2004,9
0.496,0.001,51,53,2,2,0.01,104,10
0.496,0.001,103,101,2,2,0.01,204,10
0.496,0.001,141,163,2,2,0.01,304,10
0.496,0.001,190,214,2,2,0.01,404,10
0.496,0.001,237,267,2,2,0.01,504,10
0.496,0.001,282,322,2,2,0.01,604,10
0.496,0.001,336,368,2,2,0.01,704,10
0.496,0.001,393,411,2,2,0.01,804,10
0.496,0.001,445,459,2,2,0.01,904,10
0.496,0.001,488,516,2,2,0.01,1004,10
0.466,0.001,542,562,2,2,0.01,1104,10
0.41,0.001,596,608,2,2,0.01,1204,10
0.348,0.001,646,658,2,2,0.01,1304,10
0.348,0.001,697,707,2,2,0.01,1404,10
0.43,0.001,749,755,2,2,0.01,1504,10
0.526,0.001,795,809,2,2,0.01,1604,10
0.632,0.001,838,866,2,2,0.01,1704,10
0.686,0.001,890,914,2,2,0.01,1804,10
0.71,0.001,948,956,2,2,0.01,1904,10
0.728,0.001,1004,1000,2,2,0.01,2004,10
0.488,0.001,50,54,2,2,0.01,104,11
0.458,0.001,95,109,2,2,0.01,204,11
0.526,0.001,139,165,2,2,0.01,304,11
0.518,0.001,197,207,2,2,0.01,404,11
0.516,0.001,250,254,2,2,0.01,504,11
0.512,0.001,298,306,2,2,0.01,604,11
0.512,0.001,350,354,2,2,0.01,704,11
0.526,0.001,403,401,2,2,0.01,804,11
0.57,0.001,453,451,2,2,0.01,904,11
0.604,0.001,504,500,2,2,0.01,1004,11
0.598,0.001,550,554,2,2,0.01,1104,11
0.628,0.001,600,604,2,2,0.01,1204,11
0.662,0.001,643,661,2,2,0.01,1304,11
0.736,0.001,701,703,2,2,0.01,1404,11
0.814,0.001,754,750,2,2,0.01,1504,11
0.872,0.001,803,801,2,2,0.01,1604,11
0.932,0.001,850,854,2,2,0.01,1704,11
0.96,0.001,908,896,2,2,0.01,1804,11
0.95,0.001,961,943,2,2,0.01,1904,11
0.95,0.001,1008,996,2,2,0.01,2004,11
0.506,0.001,52,52,2,2,0.01,104,12
0.506,0.001,98,106,2,2,0.01,204,12
0.516,0.001,142,162,2,2,0.01,304,12
0.56,0.001,195,209,2,2,0.01,404,12
0.592,0.001,241,263,2,2,0.01,504,12
0.598,0.001,294,310,2,2,0.01,604,12
0.624,0.001,336,368,2,2,0.01,704,12
0.654,0.001,383,421,2,2,0.01,804,12
0.68,0.001,436,468,2,2,0.01,904,12
0.696,0.001,490,514,2,2,0.01,1004,12
0.704,0.001,540,564,2,2,0.01,1104,12
0.658,0.001,590,614,2,2,0.01,1204,12
0.604,0.001,649,655,2,2,0.01,1304,12
0.708,0.001,698,706,2,2,0.01,1404,12
0.748,0.001,745,759,2,2,0.01,1504,12
0.748,0.001,793,811,2,2,0.01,1604,12
0.744,0.001,839,865,2,2,0.01,1704,12
0.744,0.001,889,915,2,2,0.01,1804,12
0.74,0.001,951,953,2,2,0.01,1904,12
0.742,0.001,1005,999,2,2,0.01,2004,12
0.542,0.001,48,56,2,2,0.01,104,13
0.542,0.001,109,95,2,2,0.01,204,13
0.536,0.001,165,139,2,2,0.01,304,13
0.526,0.001,218,186,2,2,0.01,404,13
0.526,0.001,282,222,2,2,0.01,504,13
0.522,0.001,327,277,2,2,0.01,604,13
0.506,0.001,378,326,2,2,0.01,704,13
0.51,0.001,420,384,2,2,0.01,804,13
0.506,0.001,472,432,2,2,0.01,904,13
0.5,0.001,522,482,2,2,0.01,1004,13
0.496,0.001,565,539,2,2,0.01,1104,13
0.49,0.001,613,591,2,2,0.01,1204,13
0.484,0.001,659,645,2,2,0.01,1304,13
0.508,0.001,710,694,2,2,0.01,1404,13
0.54,0.001,765,739,2,2,0.01,1504,13
0.53,0.001,811,793,2,2,0.01,1604,13
0.634,0.001,857,847,2,2,0.01,1704,13
0.672,0.001,902,902,2,2,0.01,1804,13
0.662,0.001,948,956,2,2,0.01,1904,13
0.608,0.001,993,1011,2,2,0.01,2004,13
0.528,0.001,48,56,2,2,0.01,104,14
0.534,0.001,95,109,2,2,0.01,204,14
0.54,0.001,150,154,2,2,0.01,304,14
0.55,0.001,206,198,2,2,0.01,404,14
0.552,0.001,257,247,2,2,0.01,504,14
0.57,0.001,310,294,2,2,0.01,604,14
0.574,0.001,354,350,2,2,0.01,704,14
0.572,0.001,402,402,2,2,0.01,804,14
0.564,0.001,455,449,2,2,0.01,904,14
0.552,0.001,507,497,2,2,0.01,1004,14
0.534,0.001,559,545,2,2,0.01,1104,14
0.486,0.001,610,594,2,2,0.01,1204,14
0.458,0.001,660,644,2,2,0.01,1304,14
0.452,0.001,710,694,2,2,0.01,1404,14
0.412,0.001,767,737,2,2,0.01,1504,14
0.456,0.001,818,786,2,2,0.01,1604,14
0.544,0.001,860,844,2,2,0.01,1704,14
0.588,0.001,911,893,2,2,0.01,1804,14
0.562,0.001,960,944,2,2,0.01,1904,14
0.602,0.001,1008,996,2,2,0.01,2004,14
0.512,0.001,54,50,2,2,0.01,104,15
0.512,0.001,100,104,2,2,0.01,204,15
0.512,0.001,149,155,2,2,0.01,304,15
0.512,0.001,198,206,2,2,0.01,404,15
0.512,0.001,244,260,2,2,0.01,504,15
0.512,0.001,293,311,2,2,0.01,604,15
0.512,0.001,343,361,2,2,0.01,704,15
0.512,0.001,393,411,2,2,0.01,804,15
0.512,0.001,448,456,2,2,0.01,904,15
0.512,0.001,499,505,2,2,0.01,1004,15
0.512,0.001,545,559,2,2,0.01,1104,15
0.512,0.001,599,605,2,2,0.01,1204,15
0.512,0.001,649,655,2,2,0.01,1304,15
0.512,0.001,696,708,2,2,0.01,1404,15
0.512,0.001,747,757,2,2,0.01,1504,15
0.512,0.001,791,813,2,2,0.01,1604,15
0.512,0.001,852,852,2,2,0.01,1704,15
0.512,0.001,894,910,2,2,0.01,1804,15
0.512,0.001,943,961,2,2,0.01,1904,15
0.512,0.001,996,1008,2,2,0.01,2004,15
0.558,0.001,50,54,2,2,0.01,104,16
0.56,0.001,101,103,2,2,0.01,204,16
0.562,0.001,157,147,2,2,0.01,304,16
0.558,0.001,208,196,2,2,0.01,404,16
0.558,0.001,254,250,2,2,0.01,504,16
0.564,0.001,302,302,2,2,0.01,604,16
0.568,0.001,353,351,2,2,0.01,704,16
0.586,0.001,410,394,2,2,0.01,804,16
0.588,0.001,456,448,2,2,0.01,904,16
0.602,0.001,501,503,2,2,0.01,1004,16
0.61,0.001,555,549,2,2,0.01,1104,16
0.616,0.001,606,598,2,2,0.01,1204,16
0.626,0.001,656,648,2,2,0.01,1304,16
0.63,0.001,704,700,2,2,0.01,1404,16
0.636,0.001,756,748,2,2,0.01,1504,16
0.632,0.001,806,798,2,2,0.01,1604,16
0.626,0.001,847,857,2,2,0.01,1704,16
0.626,0.001,900,904,2,2,0.01,1804,16
0.632,0.001,953,951,2,2,0.01,1904,16
0.636,0.001,1001,1003,2,2,0.01,2004,16
0.388,0.001,60,44,2,2,0.01,104,17
0.382,0.001,115,89,2,2,0.01,204,17
0.39,0.001,170,134,2,2,0.01,304,17
0.412,0.001,218,186,2,2,0.01,404,17
0.422,0.001,269,235,2,2,0.01,504,17
0.412,0.001,314,290,2,2,0.01,604,17
0.424,0.001,368,336,2,2,0.01,704,17
0.422,0.001,413,391,2,2,0.01,804,17
0.426,0.001,457,447,2,2,0.01,904,17
0.336,0.001,508,496,2,2,0.01,1004,17
0.358,0.001,561,543,2,2,0.01,1104,17
0.384,0.001,611,593,2,2,0.01,1204,17
0.452,0.001,667,637,2,2,0.01,1304,17
0.51,0.001,721,683,2,2,0.01,1404,17
0.534,0.001,768,736,2,2,0.01,1504,17
0.552,0.001,820,784,2,2,0.01,1604,17
0.554,0.001,860,844,2,2,0.01,1704,17
0.634,0.001,907,897,2,2,0.01,1804,17
0.674,0.001,952,952,2,2,0.01,1904,17
0.696,0.001,1005,999,2,2,0.01,2004,17
0.512,0.001,56,48,2,2,0.01,104,18
0.512,0.001,115,89,2,2,0.01,204,18
0.512,0.001,160,144,2,2,0.01,304,18
0.512,0.001,211,193,2,2,0.01,404,18
0.512,0.001,260,244,2,2,0.01,504,18
0.512,0.001,310,294,2,2,0.01,604,18
0.512,0.001,361,343,2,2,0.01,704,18
0.512,0.001,422,382,2,2,0.01,804,18
0.512,0.001,467,437,2,2,0.01,904,18
0.512,0.001,515,489,2,2,0.01,1004,18
0.512,0.001,561,543,2,2,0.01,1104,18
0.512,0.001,622,582,2,2,0.01,1204,18
0.512,0.001,670,634,2,2,0.01,1304,18
0.512,0.001,722,682,2,2,0.01,1404,18
0.512,0.001,765,739,2,2,0.01,1504,18
0.512,0.001,810,794,2,2,0.01,1604,18
0.512,0.001,858,846,2,2,0.01,1704,18
0.512,0.001,903,901,2,2,0.01,1804,18
0.766,0.001,950,954,2,2,0.01,1904,18
0.732,0.001,996,1008,2,2,0.01,2004,18
0.454,0.001,62,42,2,2,0.01,104,19
0.452,0.001,115,89,2,2,0.01,204,19
0.454,0.001,164,140,2,2,0.01,304,19
0.458,0.001,217,187,2,2,0.01,404,19
0.462,0.001,268,236,2,2,0.01,504,19
0.46,0.001,317,287,2,2,0.01,604,19
0.472,0.001,364,340,2,2,0.01,704,19
0.478,0.001,416,388,2,2,0.01,804,19
0.486,0.001,459,445,2,2,0.01,904,19
0.504,0.001,514,490,2,2,0.01,1004,19
0.5,0.001,574,530,2,2,0.01,1104,19
0.51,0.001,624,580,2,2,0.01,1204,19
0.526,0.001,673,631,2,2,0.01,1304,19
0.524,0.001,729,675,2,2,0.01,1404,19
0.544,0.001,774,730,2,2,0.01,1504,19
0.548,0.001,817,787,2,2,0.01,1604,19
0.552,0.001,873,831,2,2,0.01,1704,19
0.546,0.001,929,875,2,2,0.01,1804,19
0.554,0.001,979,925,2,2,0.01,1904,19
0.55,0.001,1033,971,2,2,0.01,2004,19
0.512,0.001,54,50,2,2,0.01,104,20
0.512,0.001,99,105,2,2,0.01,204,20
0.512,0.001,150,154,2,2,0.01,304,20
0.512,0.001,200,204,2,2,0.01,404,20
0.512,0.001,252,252,2,2,0.01,504,20
0.512,0.001,304,300,2,2,0.01,604,20
0.512,0.001,351,353,2,2,0.01,704,20
0.512,0.001,399,405,2,2,0.01,804,20
0.512,0.001,458,446,2,2,0.01,904,20
0.502,0.001,507,497,2,2,0.01,1004,20
0.474,0.001,562,542,2,2,0.01,1104,20
0.43,0.001,611,593,2,2,0.01,1204,20
0.42,0.001,654,650,2,2,0.01,1304,20
0.438,0.001,701,703,2,2,0.01,1404,20
0.458,0.001,747,757,2,2,0.01,1504,20
0.482,0.001,803,801,2,2,0.01,1604,20
0.522,0.001,857,847,2,2,0.01,1704,20
0.552,0.001,906,898,2,2,0.01,1804,20
0.554,0.001,961,943,2,2,0.01,1904,20
0.562,0.001,1008,996,2,2,0.01,2004,20
0.41,1e-05,45,59,2,10,0.0001,104,1
0.41,1e-05,105,99,2,10,0.0001,204,1
0.41,1e-05,154,150,2,10,0.0001,304,1
0.41,1e-05,203,201,2,10,0.0001,404,1
0.41,1e-05,237,267,2,10,0.0001,504,1
0.41,1e-05,283,321,2,10,0.0001,604,1
0.41,1e-05,344,360,2,10,0.0001,704,1
0.41,1e-05,393,411,2,10,0.0001,804,1
0.41,1e-05,439,465,2,10,0.0001,904,1
0.41,1e-05,490,514,2,10,0.0001,1004,1
0.41,1e-05,543,561,2,10,0.0001,1104,1
0.414,1e-05,599,605,2,10,0.0001,1204,1
0.418,1e-05,650,654,2,10,0.0001,1304,1
0.418,1e-05,705,699,2,10,0.0001,1404,1
0.418,1e-05,762,742,2,10,0.0001,1504,1
0.418,1e-05,813,791,2,10,0.0001,1604,1
0.418,1e-05,858,846,2,10,0.0001,1704,1
0.418,1e-05,910,894,2,10,0.0001,1804,1
0.418,1e-05,964,940,2,10,0.0001,1904,1
0.418,1e-05,1018,986,2,10,0.0001,2004,1
0.498,1e-05,52,52,2,10,0.0001,104,2
0.498,1e-05,96,108,2,10,0.0001,204,2
0.498,1e-05,148,156,2,10,0.0001,304,2
0.498,1e-05,207,197,2,10,0.0001,404,2
0.498,1e-05,249,255,2,10,0.0001,504,2
0.498,1e-05,294,310,2,10,0.0001,604,2
0.498,1e-05,346,358,2,10,0.0001,704,2
0.498,1e-05,400,404,2,10,0.0001,804,2
0.498,1e-05,447,457,2,10,0.0001,904,2
0.498,1e-05,490,514,2,10,0.0001,1004,2
0.498,1e-05,540,564,2,10,0.0001,1104,2
0.498,1e-05,588,616,2,10,0.0001,1204,2
0.498,1e-05,640,664,2,10,0.0001,1304,2
0.498,1e-05,692,712,2,10,0.0001,1404,2
0.498,1e-05,739,765,2,10,0.0001,1504,2
0.498,1e-05,803,801,2,10,0.0001,1604,2
0.498,1e-05,854,850,2,10,0.0001,1704,2
0.498,1e-05,906,898,2,10,0.0001,1804,2
0.498,1e-05,953,951,2,10,0.0001,1904,2
0.498,1e-05,1001,1003,2,10,0.0001,2004,2
0.476,1e-05,58,46,2,10,0.0001,104,3
0.476,1e-05,102,102,2,10,0.0001,204,3
0.476,1e-05,153,151,2,10,0.0001,304,3
0.476,1e-05,208,196,2,10,0.0001,404,3
0.476,1e-05,243,261,2,10,0.0001,504,3
0.476,1e-05,286,318,2,10,0.0001,604,3
0.476,1e-05,338,366,2,10,0.0001,704,3
0.476,1e-05,389,415,2,10,0.0001,804,3
0.476,1e-05,443,461,2,10,0.0001,904,3
0.476,1e-05,489,515,2,10,0.0001,1004,3
0.476,1e-05,544,560,2,10,0.0001,1104,3
0.476,1e-05,593,611,2,10,0.0001,1204,3
0.476,1e-05,641,663,2,10,0.0001,1304,3
0.476,1e-05,686,718,2,10,0.0001,1404,3
0.476,1e-05,738,766,2,10,0.0001,1504,3
0.476,1e-05,791,813,2,10,0.0001,1604,3
0.476,1e-05,843,861,2,10,0.0001,1704,3
0.476,1e-05,891,913,2,10,0.0001,1804,3
0.476,1e-05,941,963,2,10,0.0001,1904,3
0.476,1e-05,990,1014,2,10,0.0001,2004,3
0.45,1e-05,46,58,2,10,0.0001,104,4
0.448,1e-05,96,108,2,10,0.0001,204,4
0.448,1e-05,149,155,2,10,0.0001,304,4
0.448,1e-05,201,203,2,10,0.0001,404,4
0.448,1e-05,245,259,2,10,0.0001,504,4
0.448,1e-05,290,314,2,10,0.0001,604,4
0.448,1e-05,337,367,2,10,0.0001,704,4
0.446,1e-05,389,415,2,10,0.0001,804,4
0.446,1e-05,442,462,2,10,0.0001,904,4
0.446,1e-05,496,508,2,10,0.0001,1004,4
0.446,1e-05,547,557,2,10,0.0001,1104,4
0.446,1e-05,593,611,2,10,0.0001,1204,4
0.446,1e-05,639,665,2,10,0.0001,1304,4
0.446,1e-05,697,707,2,10,0.0001,1404,4
0.446,1e-05,748,756,2,10,0.0001,1504,4
0.446,1e-05,794,810,2,10,0.0001,1604,4
0.448,1e-05,845,859,2,10,0.0001,1704,4
0.448,1e-05,899,905,2,10,0.0001,1804,4
0.448,1e-05,958,946,2,10,0.0001,1904,4
0.448,1e-05,1015,989,2,10,0.0001,2004,4
0.5,1e-05,59,45,2,10,0.0001,104,5
0.498,1e-05,105,99,2,10,0.0001,204,5
0.498,1e-05,158,146,2,10,0.0001,304,5
0.498,1e-05,201,203,2,10,0.0001,404,5
0.498,1e-05,249,255,2,10,0.0001,504,5
0.498,1e-05,304,300,2,10,0.0001,604,5
0.5,1e-05,354,350,2,10,0.0001,704,5
0.5,1e-05,410,394,2,10,0.0001,804,5
0.5,1e-05,464,440,2,10,0.0001,904,5
0.5,1e-05,512,492,2,10,0.0001,1004,5
0.498,1e-05,558,546,2,10,0.0001,1104,5
0.5,1e-05,612,592,2,10,0.0001,1204,5
0.502,1e-05,659,645,2,10,0.0001,1304,5
0.504,1e-05,710,694,2,10,0.0001,1404,5
0.506,1e-05,757,747,2,10,0.0001,1504,5
0.51,1e-05,813,791,2,10,0.0001,1604,5
0.51,1e-05,872,832,2,10,0.0001,1704,5
0.51,1e-05,916,888,2,10,0.0001,1804,5
0.512,1e-05,958,946,2,10,0.0001,1904,5
0.512,1e-05,1011,993,2,10,0.0001,2004,5
0.512,1e-05,56,48,2,10,0.0001,104,6
0.512,1e-05,101,103,2,10,0.0001,204,6
0.512,1e-05,157,147,2,10,0.0001,304,6
0.512,1e-05,206,198,2,10,0.0001,404,6
0.512,1e-05,259,245,2,10,0.0001,504,6
0.512,1e-05,315,289,2,10,0.0001,604,6
0.512,1e-05,366,338,2,10,0.0001,704,6
0.512,1e-05,424,380,2,10,0.0001,804,6
0.512,1e-05,464,440,2,10,0.0001,904,6
0.512,1e-05,521,483,2,10,0.0001,1004,6
0.512,1e-05,569,535,2,10,0.0001,1104,6
0.512,1e-05,619,585,2,10,0.0001,1204,6
0.512,1e-05,673,631,2,10,0.0001,1304,6
0.512,1e-05,726,678,2,10,0.0001,1404,6
0.512,1e-05,786,718,2,10,0.0001,1504,6
0.512,1e-05,832,772,2,10,0.0001,1604,6
0.512,1e-05,879,825,2,10,0.0001,1704,6
0.512,1e-05,924,880,2,10,0.0001,1804,6
0.512,1e-05,962,942,2,10,0.0001,1904,6
0.512,1e-05,1008,996,2,10,0.0001,2004,6
0.538,1e-05,50,54,2,10,0.0001,104,7
0.538,1e-05,103,101,2,10,0.0001,204,7
0.538,1e-05,151,153,2,10,0.0001,304,7
0.538,1e-05,201,203,2,10,0.0001,404,7
0.538,1e-05,259,245,2,10,0.0001,504,7
0.538,1e-05,301,303,2,10,0.0001,604,7
0.536,1e-05,358,346,2,10,0.0001,704,7
0.536,1e-05,414,390,2,10,0.0001,804,7
0.536,1e-05,459,445,2,10,0.0001,904,7
0.534,1e-05,505,499,2,10,0.0001,1004,7
0.534,1e-05,553,551,2,10,0.0001,1104,7
0.534,1e-05,602,602,2,10,0.0001,1204,7
0.538,1e-05,655,649,2,10,0.0001,1304,7
0.538,1e-05,707,697,2,10,0.0001,1404,7
0.538,1e-05,755,749,2,10,0.0001,1504,7
0.536,1e-05,806,798,2,10,0.0001,1604,7
0.54,1e-05,854,850,2,10,0.0001,1704,7
0.542,1e-05,907,897,2,10,0.0001,1804,7
0.538,1e-05,958,946,2,10,0.0001,1904,7
0.54,1e-05,1002,1002,2,10,0.0001,2004,7
0.446,1e-05,52,52,2,10,0.0001,104,8
0.446,1e-05,103,101,2,10,0.0001,204,8
0.446,1e-05,163,141,2,10,0.0001,304,8
0.448,1e-05,214,190,2,10,0.0001,404,8
0.448,1e-05,256,248,2,10,0.0001,504,8
0.448,1e-05,307,297,2,10,0.0001,604,8
0.446,1e-05,362,342,2,10,0.0001,704,8
0.446,1e-05,407,397,2,10,0.0001,804,8
0.446,1e-05,463,441,2,10,0.0001,904,8
0.446,1e-05,513,491,2,10,0.0001,1004,8
0.448,1e-05,563,541,2,10,0.0001,1104,8
0.45,1e-05,607,597,2,10,0.0001,1204,8
0.45,1e-05,657,647,2,10,0.0001,1304,8
0.45,1e-05,710,694,2,10,0.0001,1404,8
0.45,1e-05,762,742,2,10,0.0001,1504,8
0.45,1e-05,807,797,2,10,0.0001,1604,8
0.45,1e-05,857,847,2,10,0.0001,1704,8
0.448,1e-05,898,906,2,10,0.0001,1804,8
0.448,1e-05,945,959,2,10,0.0001,1904,8
0.448,1e-05,995,1009,2,10,0.0001,2004,8
0.496,1e-05,51,53,2,10,0.0001,104,9
0.494,1e-05,98,106,2,10,0.0001,204,9
0.494,1e-05,147,157,2,10,0.0001,304,9
0.49,1e-05,197,207,2,10,0.0001,404,9
0.49,1e-05,242,262,2,10,0.0001,504,9
0.49,1e-05,284,320,2,10,0.0001,604,9
0.49,1e-05,339,365,2,10,0.0001,704,9
0.49,1e-05,387,417,2,10,0.0001,804,9
0.49,1e-05,438,466,2,10,0.0001,904,9
0.49,1e-05,487,517,2,10,0.0001,1004,9
0.49,1e-05,533,571,2,10,0.0001,1104,9
0.496,1e-05,578,626,2,10,0.0001,1204,9
0.498,1e-05,636,668,2,10,0.0001,1304,9
0.496,1e-05,685,719,2,10,0.0001,1404,9
0.49,1e-05,738,766,2,10,0.0001,1504,9
0.488,1e-05,793,811,2,10,0.0001,1604,9
0.492,1e-05,838,866,2,10,0.0001,1704,9
0.486,1e-05,884,920,2,10,0.0001,1804,9
0.484,1e-05,935,969,2,10,0.0001,1904,9
0.484,1e-05,985,1019,2,10,0.0001,2004,9
0.484,1e-05,43,61,2,10,0.0001,104,10
0.482,1e-05,83,121,2,10,0.0001,204,10
0.482,1e-05,139,165,2,10,0.0001,304,10
0.482,1e-05,185,219,2,10,0.0001,404,10
0.484,1e-05,232,272,2,10,0.0001,504,10
0.484,1e-05,287,317,2,10,0.0001,604,10
0.484,1e-05,330,374,2,10,0.0001,704,10
0.484,1e-05,382,422,2,10,0.0001,804,10
0.484,1e-05,436,468,2,10,0.0001,904,10
0.482,1e-05,481,523,2,10,0.0001,1004,10
0.484,1e-05,539,565,2,10,0.0001,1104,10
0.482,1e-05,588,616,2,10,0.0001,1204,10
0.484,1e-05,644,660,2,10,0.0001,1304,10
0.484,1e-05,690,714,2,10,0.0001,1404,10
0.484,1e-05,748,756,2,10,0.0001,1504,10
0.482,1e-05,797,807,2,10,0.0001,1604,10
0.484,1e-05,846,858,2,10,0.0001,1704,10
0.484,1e-05,893,911,2,10,0.0001,1804,10
0.484,1e-05,941,963,2,10,0.0001,1904,10
0.484,1e-05,994,1010,2,10,0.0001,2004,10
0.514,1e-05,57,47,2,10,0.0001,104,11
0.514,1e-05,102,102,2,10,0.0001,204,11
0.514,1e-05,150,154,2,10,0.0001,304,11
0.514,1e-05,193,211,2,10,0.0001,404,11
0.514,1e-05,249,255,2,10,0.0001,504,11
0.516,1e-05,310,294,2,10,0.0001,604,11
0.516,1e-05,367,337,2,10,0.0001,704,11
0.518,1e-05,416,388,2,10,0.0001,804,11
0.52,1e-05,468,436,2,10,0.0001,904,11
0.52,1e-05,523,481,2,10,0.0001,1004,11
0.524,1e-05,575,529,2,10,0.0001,1104,11
0.524,1e-05,622,582,2,10,0.0001,1204,11
0.524,1e-05,670,634,2,10,0.0001,1304,11
0.524,1e-05,712,692,2,10,0.0001,1404,11
0.522,1e-05,764,740,2,10,0.0001,1504,11
0.522,1e-05,809,795,2,10,0.0001,1604,11
0.522,1e-05,860,844,2,10,0.0001,1704,11
0.516,1e-05,917,887,2,10,0.0001,1804,11
0.516,1e-05,972,932,2,10,0.0001,1904,11
0.516,1e-05,1012,992,2,10,0.0001,2004,11
0.392,1e-05,48,56,2,10,0.0001,104,12
0.392,1e-05,98,106,2,10,0.0001,204,12
0.39,1e-05,154,150,2,10,0.0001,304,12
0.39,1e-05,199,205,2,10,0.0001,404,12
0.388,1e-05,258,246,2,10,0.0001,504,12
0.388,1e-05,309,295,2,10,0.0001,604,12
0.39,1e-05,364,340,2,10,0.0001,704,12
0.392,1e-05,423,381,2,10,0.0001,804,12
0.392,1e-05,477,427,2,10,0.0001,904,12
0.396,1e-05,522,482,2,10,0.0001,1004,12
0.396,1e-05,572,532,2,10,0.0001,1104,12
0.398,1e-05,625,579,2,10,0.0001,1204,12
0.402,1e-05,674,630,2,10,0.0001,1304,12
0.402,1e-05,716,688,2,10,0.0001,1404,12
0.404,1e-05,768,736,2,10,0.0001,1504,12
0.406,1e-05,809,795,2,10,0.0001,1604,12
0.406,1e-05,855,849,2,10,0.0001,1704,12
0.406,1e-05,908,896,2,10,0.0001,1804,12
0.408,1e-05,957,947,2,10,0.0001,1904,12
0.41,1e-05,1003,1001,2,10,0.0001,2004,12
0.48,1e-05,51,53,2,10,0.0001,104,13
0.48,1e-05,99,105,2,10,0.0001,204,13
0.48,1e-05,160,144,2,10,0.0001,304,13
0.48,1e-05,207,197,2,10,0.0001,404,13
0.48,1e-05,252,252,2,10,0.0001,504,13
0.48,1e-05,303,301,2,10,0.0001,604,13
0.48,1e-05,355,349,2,10,0.0001,704,13
0.48,1e-05,411,393,2,10,0.0001,804,13
0.48,1e-05,455,449,2,10,0.0001,904,13
0.48,1e-05,507,497,2,10,0.0001,1004,13
0.48,1e-05,566,538,2,10,0.0001,1104,13
0.48,1e-05,618,586,2,10,0.0001,1204,13
0.48,1e-05,662,642,2,10,0.0001,1304,13
0.48,1e-05,706,698,2,10,0.0001,1404,13
0.48,1e-05,757,747,2,10,0.0001,1504,13
0.48,1e-05,806,798,2,10,0.0001,1604,13
0.48,1e-05,854,850,2,10,0.0001,1704,13
0.48,1e-05,910,894,2,10,0.0001,1804,13
0.48,1e-05,939,965,2,10,0.0001,1904,13
0.48,1e-05,992,1012,2,10,0.0001,2004,13
0.516,1e-05,48,56,2,10,0.0001,104,14
0.516,1e-05,101,103,2,10,0.0001,204,14
0.516,1e-05,160,144,2,10,0.0001,304,14
0.516,1e-05,200,204,2,10,0.0001,404,14
0.516,1e-05,254,250,2,10,0.0001,504,14
0.516,1e-05,300,304,2,10,0.0001,604,14
0.518,1e-05,353,351,2,10,0.0001,704,14
0.52,1e-05,399,405,2,10,0.0001,804,14
0.52,1e-05,460,444,2,10,0.0001,904,14
0.52,1e-05,510,494,2,10,0.0001,1004,14
0.522,1e-05,565,539,2,10,0.0001,1104,14
0.52,1e-05,608,596,2,10,0.0001,1204,14
0.518,1e-05,667,637,2,10,0.0001,1304,14
0.518,1e-05,716,688,2,10,0.0001,1404,14
0.518,1e-05,766,738,2,10,0.0001,1504,14
0.52,1e-05,811,793,2,10,0.0001,1604,14
0.518,1e-05,855,849,2,10,0.0001,1704,14
0.518,1e-05,905,899,2,10,0.0001,1804,14
0.52,1e-05,953,951,2,10,0.0001,1904,14
0.518,1e-05,999,1005,2,10,0.0001,2004,14
0.396,1e-05,54,50,2,10,0.0001,104,15
0.396,1e-05,107,97,2,10,0.0001,204,15
0.396,1e-05,164,140,2,10,0.0001,304,15
0.396,1e-05,215,189,2,10,0.0001,404,15
0.396,1e-05,263,241,2,10,0.0001,504,15
0.396,1e-05,310,294,2,10,0.0001,604,15
0.392,1e-05,363,341,2,10,0.0001,704,15
0.392,1e-05,406,398,2,10,0.0001,804,15
0.392,1e-05,455,449,2,10,0.0001,904,15
0.392,1e-05,505,499,2,10,0.0001,1004,15
0.392,1e-05,554,550,2,10,0.0001,1104,15
0.388,1e-05,600,604,2,10,0.0001,1204,15
0.388,1e-05,648,656,2,10,0.0001,1304,15
0.388,1e-05,703,701,2,10,0.0001,1404,15
0.39,1e-05,750,754,2,10,0.0001,1504,15
0.394,1e-05,799,805,2,10,0.0001,1604,15
0.394,1e-05,851,853,2,10,0.0001,1704,15
0.396,1e-05,898,906,2,10,0.0001,1804,15
0.398,1e-05,946,958,2,10,0.0001,1904,15
0.4,1e-05,1001,1003,2,10,0.0001,2004,15
0.48,1e-05,50,54,2,10,0.0001,104,16
0.48,1e-05,102,102,2,10,0.0001,204,16
0.48,1e-05,153,151,2,10,0.0001,304,16
0.48,1e-05,194,210,2,10,0.0001,404,16
0.482,1e-05,243,261,2,10,0.0001,504,16
0.482,1e-05,288,316,2,10,0.0001,604,16
0.482,1e-05,332,372,2,10,0.0001,704,16
0.48,1e-05,382,422,2,10,0.0001,804,16
0.48,1e-05,435,469,2,10,0.0001,904,16
0.484,1e-05,488,516,2,10,0.0001,1004,16
0.482,1e-05,547,557,2,10,0.0001,1104,16
0.484,1e-05,600,604,2,10,0.0001,1204,16
0.484,1e-05,653,651,2,10,0.0001,1304,16
0.486,1e-05,702,702,2,10,0.0001,1404,16
0.488,1e-05,751,753,2,10,0.0001,1504,16
0.488,1e-05,807,797,2,10,0.0001,1604,16
0.488,1e-05,845,859,2,10,0.0001,1704,16
0.486,1e-05,902,902,2,10,0.0001,1804,16
0.488,1e-05,950,954,2,10,0.0001,1904,16
0.488,1e-05,1007,997,2,10,0.0001,2004,16
0.494,1e-05,46,58,2,10,0.0001,104,17
0.494,1e-05,97,107,2,10,0.0001,204,17
0.494,1e-05,147,157,2,10,0.0001,304,17
0.494,1e-05,196,208,2,10,0.0001,404,17
0.494,1e-05,240,264,2,10,0.0001,504,17
0.494,1e-05,295,309,2,10,0.0001,604,17
0.494,1e-05,341,363,2,10,0.0001,704,17
0.494,1e-05,393,411,2,10,0.0001,804,17
0.492,1e-05,455,449,2,10,0.0001,904,17
0.492,1e-05,500,504,2,10,0.0001,1004,17
0.492,1e-05,548,556,2,10,0.0001,1104,17
0.492,1e-05,601,603,2,10,0.0001,1204,17
0.496,1e-05,655,649,2,10,0.0001,1304,17
0.496,1e-05,704,700,2,10,0.0001,1404,17
0.496,1e-05,752,752,2,10,0.0001,1504,17
0.496,1e-05,801,803,2,10,0.0001,1604,17
0.496,1e-05,851,853,2,10,0.0001,1704,17
0.496,1e-05,907,897,2,10,0.0001,1804,17
0.496,1e-05,951,953,2,10,0.0001,1904,17
0.498,1e-05,999,1005,2,10,0.0001,2004,17
0.454,1e-05,49,55,2,10,0.0001,104,18
0.454,1e-05,89,115,2,10,0.0001,204,18
0.454,1e-05,134,170,2,10,0.0001,304,18
0.454,1e-05,190,214,2,10,0.0001,404,18
0.456,1e-05,239,265,2,10,0.0001,504,18
0.456,1e-05,288,316,2,10,0.0001,604,18
0.456,1e-05,339,365,2,10,0.0001,704,18
0.454,1e-05,394,410,2,10,0.0001,804,18
0.454,1e-05,445,459,2,10,0.0001,904,18
0.454,1e-05,491,513,2,10,0.0001,1004,18
0.454,1e-05,543,561,2,10,0.0001,1104,18
0.454,1e-05,589,615,2,10,0.0001,1204,18
0.452,1e-05,642,662,2,10,0.0001,1304,18
0.448,1e-05,688,716,2,10,0.0001,1404,18
0.448,1e-05,738,766,2,10,0.0001,1504,18
0.448,1e-05,783,821,2,10,0.0001,1604,18
0.45,1e-05,834,870,2,10,0.0001,1704,18
0.45,1e-05,886,918,2,10,0.0001,1804,18
0.448,1e-05,939,965,2,10,0.0001,1904,18
0.45,1e-05,984,1020,2,10,0.0001,2004,18
0.572,1e-05,54,50,2,10,0.0001,104,19
0.572,1e-05,106,98,2,10,0.0001,204,19
0.572,1e-05,161,143,2,10,0.0001,304,19
0.572,1e-05,199,205,2,10,0.0001,404,19
0.572,1e-05,249,255,2,10,0.0001,504,19
0.572,1e-05,310,294,2,10,0.0001,604,19
0.572,1e-05,361,343,2,10,0.0001,704,19
0.572,1e-05,423,381,2,10,0.0001,804,19
0.572,1e-05,477,427,2,10,0.0001,904,19
0.572,1e-05,525,479,2,10,0.0001,1004,19
0.572,1e-05,581,523,2,10,0.0001,1104,19
0.572,1e-05,632,572,2,10,0.0001,1204,19
0.572,1e-05,679,625,2,10,0.0001,1304,19
0.574,1e-05,726,678,2,10,0.0001,1404,19
0.574,1e-05,780,724,2,10,0.0001,1504,19
0.574,1e-05,832,772,2,10,0.0001,1604,19
0.576,1e-05,876,828,2,10,0.0001,1704,19
0.58,1e-05,924,880,2,10,0.0001,1804,19
0.58,1e-05,974,930,2,10,0.0001,1904,19
0.58,1e-05,1023,981,2,10,0.0001,2004,19
0.522,1e-05,56,48,2,10,0.0001,104,20
0.522,1e-05,101,103,2,10,0.0001,204,20
0.522,1e-05,159,145,2,10,0.0001,304,20
0.522,1e-05,211,193,2,10,0.0001,404,20
0.524,1e-05,260,244,2,10,0.0001,504,20
0.524,1e-05,313,291,2,10,0.0001,604,20
0.524,1e-05,361,343,2,10,0.0001,704,20
0.524,1e-05,409,395,2,10,0.0001,804,20
0.524,1e-05,466,438,2,10,0.0001,904,20
0.524,1e-05,517,487,2,10,0.0001,1004,20
0.524,1e-05,564,540,2,10,0.0001,1104,20
0.524,1e-05,619,585,2,10,0.0001,1204,20
0.524,1e-05,662,642,2,10,0.0001,1304,20
0.524,1e-05,715,689,2,10,0.0001,1404,20
0.524,1e-05,764,740,2,10,0.0001,1504,20
0.524,1e-05,821,783,2,10,0.0001,1604,20
0.524,1e-05,868,836,2,10,0.0001,1704,20
0.526,1e-05,917,887,2,10,0.0001,1804,20
0.526,1e-05,963,941,2,10,0.0001,1904,20
0.526,1e-05,1013,991,2,10,0.0001,2004,20
0.478,1e-05,55,49,2,10,0.001,104,1
0.482,1e-05,100,104,2,10,0.001,204,1
0.486,1e-05,152,152,2,10,0.001,304,1
0.484,1e-05,201,203,2,10,0.001,404,1
0.506,1e-05,261,243,2,10,0.001,504,1
0.534,1e-05,311,293,2,10,0.001,604,1
0.556,1e-05,357,347,2,10,0.001,704,1
0.566,1e-05,409,395,2,10,0.001,804,1
0.582,1e-05,462,442,2,10,0.001,904,1
0.594,1e-05,508,496,2,10,0.001,1004,1
0.582,1e-05,554,550,2,10,0.001,1104,1
0.592,1e-05,604,600,2,10,0.001,1204,1
0.608,1e-05,648,656,2,10,0.001,1304,1
0.616,1e-05,705,699,2,10,0.001,1404,1
0.582,1e-05,755,749,2,10,0.001,1504,1
0.566,1e-05,811,793,2,10,0.001,1604,1
0.58,1e-05,865,839,2,10,0.001,1704,1
0.57,1e-05,913,891,2,10,0.001,1804,1
0.552,1e-05,958,946,2,10,0.001,1904,1
0.518,1e-05,1001,1003,2,10,0.001,2004,1
0.43,1e-05,59,45,2,10,0.001,104,2
0.428,1e-05,112,92,2,10,0.001,204,2
0.432,1e-05,156,148,2,10,0.001,304,2
0.43,1e-05,199,205,2,10,0.001,404,2
0.432,1e-05,248,256,2,10,0.001,504,2
0.426,1e-05,294,310,2,10,0.001,604,2
0.438,1e-05,352,352,2,10,0.001,704,2
0.438,1e-05,401,403,2,10,0.001,804,2
0.456,1e-05,443,461,2,10,0.001,904,2
0.48,1e-05,498,506,2,10,0.001,1004,2
0.492,1e-05,556,548,2,10,0.001,1104,2
0.5,1e-05,604,600,2,10,0.001,1204,2
0.514,1e-05,660,644,2,10,0.001,1304,2
0.532,1e-05,709,695,2,10,0.001,1404,2
0.542,1e-05,766,738,2,10,0.001,1504,2
0.54,1e-05,802,802,2,10,0.001,1604,2
0.534,1e-05,849,855,2,10,0.001,1704,2
0.538,1e-05,902,902,2,10,0.001,1804,2
0.552,1e-05,945,959,2,10,0.001,1904,2
0.568,1e-05,992,1012,2,10,0.001,2004,2
0.516,1e-05,45,59,2,10,0.001,104,3
0.518,1e-05,98,106,2,10,0.001,204,3
0.52,1e-05,153,151,2,10,0.001,304,3
0.524,1e-05,207,197,2,10,0.001,404,3
0.522,1e-05,258,246,2,10,0.001,504,3
0.52,1e-05,310,294,2,10,0.001,604,3
0.516,1e-05,357,347,2,10,0.001,704,3
0.518,1e-05,411,393,2,10,0.001,804,3
0.53,1e-05,456,448,2,10,0.001,904,3
0.534,1e-05,508,496,2,10,0.001,1004,3
0.534,1e-05,554,550,2,10,0.001,1104,3
0.54,1e-05,598,606,2,10,0.001,1204,3
0.546,1e-05,641,663,2,10,0.001,1304,3
0.55,1e-05,695,709,2,10,0.001,1404,3
0.558,1e-05,750,754,2,10,0.001,1504,3
0.572,1e-05,796,808,2,10,0.001,1604,3
0.58,1e-05,851,853,2,10,0.001,1704,3
0.594,1e-05,896,908,2,10,0.001,1804,3
0.622,1e-05,948,956,2,10,0.001,1904,3
0.636,1e-05,998,1006,2,10,0.001,2004,3
0.464,1e-05,57,47,2,10,0.001,104,4
0.464,1e-05,103,101,2,10,0.001,204,4
0.466,1e-05,157,147,2,10,0.001,304,4
0.466,1e-05,213,191,2,10,0.001,404,4
0.466,1e-05,259,245,2,10,0.001,504,4
0.466,1e-05,301,303,2,10,0.001,604,4
0.466,1e-05,353,351,2,10,0.001,704,4
0.466,1e-05,402,402,2,10,0.001,804,4
0.468,1e-05,463,441,2,10,0.001,904,4
0.476,1e-05,510,494,2,10,0.001,1004,4
0.48,1e-05,559,545,2,10,0.001,1104,4
0.49,1e-05,602,602,2,10,0.001,1204,4
0.5,1e-05,648,656,2,10,0.001,1304,4
0.514,1e-05,698,706,2,10,0.001,1404,4
0.522,1e-05,742,762,2,10,0.001,1504,4
0.542,1e-05,807,797,2,10,0.001,1604,4
0.576,1e-05,857,847,2,10,0.001,1704,4
0.58,1e-05,915,889,2,10,0.001,1804,4
0.576,1e-05,969,935,2,10,0.001,1904,4
0.584,1e-05,1020,984,2,10,0.001,2004,4
0.494,1e-05,42,62,2,10,0.001,104,5
0.494,1e-05,97,107,2,10,0.001,204,5
0.496,1e-05,141,163,2,10,0.001,304,5
0.496,1e-05,192,212,2,10,0.001,404,5
0.496,1e-05,254,250,2,10,0.001,504,5
0.5,1e-05,299,305,2,10,0.001,604,5
0.494,1e-05,348,356,2,10,0.001,704,5
0.498,1e-05,401,403,2,10,0.001,804,5
0.504,1e-05,447,457,2,10,0.001,904,5
0.51,1e-05,501,503,2,10,0.001,1004,5
0.516,1e-05,550,554,2,10,0.001,1104,5
0.524,1e-05,605,599,2,10,0.001,1204,5
0.528,1e-05,655,649,2,10,0.001,1304,5
0.528,1e-05,708,696,2,10,0.001,1404,5
0.534,1e-05,760,744,2,10,0.001,1504,5
0.524,1e-05,810,794,2,10,0.001,1604,5
0.528,1e-05,864,840,2,10,0.001,1704,5
0.526,1e-05,907,897,2,10,0.001,1804,5
0.538,1e-05,959,945,2,10,0.001,1904,5
0.536,1e-05,1005,999,2,10,0.001,2004,5
0.568,1e-05,49,55,2,10,0.001,104,6
0.568,1e-05,102,102,2,10,0.001,204,6
0.566,1e-05,144,160,2,10,0.001,304,6
0.576,1e-05,182,222,2,10,0.001,404,6
0.576,1e-05,230,274,2,10,0.001,504,6
0.57,1e-05,278,326,2,10,0.001,604,6
0.568,1e-05,330,374,2,10,0.001,704,6
0.572,1e-05,383,421,2,10,0.001,804,6
0.574,1e-05,434,470,2,10,0.001,904,6
0.58,1e-05,478,526,2,10,0.001,1004,6
0.584,1e-05,539,565,2,10,0.001,1104,6
0.592,1e-05,592,612,2,10,0.001,1204,6
0.596,1e-05,635,669,2,10,0.001,1304,6
0.61,1e-05,686,718,2,10,0.001,1404,6
0.616,1e-05,742,762,2,10,0.001,1504,6
0.608,1e-05,787,817,2,10,0.001,1604,6
0.612,1e-05,842,862,2,10,0.001,1704,6
0.626,1e-05,900,904,2,10,0.001,1804,6
0.648,1e-05,947,957,2,10,0.001,1904,6
0.654,1e-05,1010,994,2,10,0.001,2004,6
0.496,1e-05,50,54,2,10,0.001,104,7
0.502,1e-05,97,107,2,10,0.001,204,7
0.502,1e-05,142,162,2,10,0.001,304,7
0.504,1e-05,195,209,2,10,0.001,404,7
0.504,1e-05,236,268,2,10,0.001,504,7
0.506,1e-05,291,313,2,10,0.001,604,7
0.504,1e-05,337,367,2,10,0.001,704,7
0.508,1e-05,381,423,2,10,0.001,804,7
0.506,1e-05,435,469,2,10,0.001,904,7
0.514,1e-05,485,519,2,10,0.001,1004,7
0.516,1e-05,536,568,2,10,0.001,1104,7
0.522,1e-05,593,611,2,10,0.001,1204,7
0.532,1e-05,636,668,2,10,0.001,1304,7
0.528,1e-05,684,720,2,10,0.001,1404,7
0.526,1e-05,745,759,2,10,0.001,1504,7
0.534,1e-05,798,806,2,10,0.001,1604,7
0.54,1e-05,848,856,2,10,0.001,1704,7
0.548,1e-05,888,916,2,10,0.001,1804,7
0.546,1e-05,938,966,2,10,0.001,1904,7
0.554,1e-05,995,1009,2,10,0.001,2004,7
0.342,1e-05,49,55,2,10,0.001,104,8
0.34,1e-05,98,106,2,10,0.001,204,8
0.34,1e-05,153,151,2,10,0.001,304,8
0.34,1e-05,201,203,2,10,0.001,404,8
0.338,1e-05,252,252,2,10,0.001,504,8
0.336,1e-05,309,295,2,10,0.001,604,8
0.334,1e-05,354,350,2,10,0.001,704,8
0.332,1e-05,403,401,2,10,0.001,804,8
0.328,1e-05,455,449,2,10,0.001,904,8
0.324,1e-05,509,495,2,10,0.001,1004,8
0.332,1e-05,556,548,2,10,0.001,1104,8
0.33,1e-05,605,599,2,10,0.001,1204,8
0.336,1e-05,663,641,2,10,0.001,1304,8
0.342,1e-05,714,690,2,10,0.001,1404,8
0.348,1e-05,767,737,2,10,0.001,1504,8
0.37,1e-05,811,793,2,10,0.001,1604,8
0.392,1e-05,862,842,2,10,0.001,1704,8
0.416,1e-05,906,898,2,10,0.001,1804,8
0.444,1e-05,956,948,2,10,0.001,1904,8
0.462,1e-05,996,1008,2,10,0.001,2004,8
0.524,1e-05,56,48,2,10,0.001,104,9
0.524,1e-05,106,98,2,10,0.001,204,9
0.524,1e-05,157,147,2,10,0.001,304,9
0.524,1e-05,204,200,2,10,0.001,404,9
0.524,1e-05,253,251,2,10,0.001,504,9
0.524,1e-05,309,295,2,10,0.001,604,9
0.524,1e-05,356,348,2,10,0.001,704,9
0.524,1e-05,400,404,2,10,0.001,804,9
0.524,1e-05,450,454,2,10,0.001,904,9
0.524,1e-05,489,515,2,10,0.001,1004,9
0.524,1e-05,542,562,2,10,0.001,1104,9
0.524,1e-05,592,612,2,10,0.001,1204,9
0.524,1e-05,644,660,2,10,0.001,1304,9
0.524,1e-05,707,697,2,10,0.001,1404,9
0.524,1e-05,759,745,2,10,0.001,1504,9
0.524,1e-05,806,798,2,10,0.001,1604,9
0.524,1e-05,853,851,2,10,0.001,1704,9
0.522,1e-05,898,906,2,10,0.001,1804,9
0.524,1e-05,941,963,2,10,0.001,1904,9
0.52,1e-05,990,1014,2,10,0.001,2004,9
0.492,1e-05,52,52,2,10,0.001,104,10
0.492,1e-05,93,111,2,10,0.001,204,10
0.492,1e-05,150,154,2,10,0.001,304,10
0.492,1e-05,199,205,2,10,0.001,404,10
0.492,1e-05,254,250,2,10,0.001,504,10
0.492,1e-05,309,295,2,10,0.001,604,10
0.492,1e-05,359,345,2,10,0.001,704,10
0.492,1e-05,403,401,2,10,0.001,804,10
0.492,1e-05,455,449,2,10,0.001,904,10
0.488,1e-05,510,494,2,10,0.001,1004,10
0.488,1e-05,552,552,2,10,0.001,1104,10
0.488,1e-05,605,599,2,10,0.001,1204,10
0.488,1e-05,652,652,2,10,0.001,1304,10
0.486,1e-05,704,700,2,10,0.001,1404,10
0.49,1e-05,749,755,2,10,0.001,1504,10
0.494,1e-05,800,804,2,10,0.001,1604,10
0.494,1e-05,850,854,2,10,0.001,1704,10
0.494,1e-05,897,907,2,10,0.001,1804,10
0.496,1e-05,945,959,2,10,0.001,1904,10
0.494,1e-05,998,1006,2,10,0.001,2004,10
0.54,1e-05,49,55,2,10,0.001,104,11
0.544,1e-05,108,96,2,10,0.001,204,11
0.546,1e-05,166,138,2,10,0.001,304,11
0.534,1e-05,214,190,2,10,0.001,404,11
0.532,1e-05,261,243,2,10,0.001,504,11
0.526,1e-05,320,284,2,10,0.001,604,11
0.528,1e-05,365,339,2,10,0.001,704,11
0.526,1e-05,413,391,2,10,0.001,804,11
0.504,1e-05,471,433,2,10,0.001,904,11
0.504,1e-05,528,476,2,10,0.001,1004,11
0.506,1e-05,574,530,2,10,0.001,1104,11
0.506,1e-05,629,575,2,10,0.001,1204,11
0.514,1e-05,677,627,2,10,0.001,1304,11
0.514,1e-05,724,680,2,10,0.001,1404,11
0.514,1e-05,775,729,2,10,0.001,1504,11
0.522,1e-05,815,789,2,10,0.001,1604,11
0.542,1e-05,862,842,2,10,0.001,1704,11
0.564,1e-05,906,898,2,10,0.001,1804,11
0.566,1e-05,964,940,2,10,0.001,1904,11
0.578,1e-05,1012,992,2,10,0.001,2004,11
0.498,1e-05,48,56,2,10,0.001,104,12
0.5,1e-05,101,103,2,10,0.001,204,12
0.502,1e-05,149,155,2,10,0.001,304,12
0.502,1e-05,191,213,2,10,0.001,404,12
0.504,1e-05,244,260,2,10,0.001,504,12
0.504,1e-05,297,307,2,10,0.001,604,12
0.506,1e-05,344,360,2,10,0.001,704,12
0.506,1e-05,401,403,2,10,0.001,804,12
0.508,1e-05,457,447,2,10,0.001,904,12
0.514,1e-05,510,494,2,10,0.001,1004,12
0.512,1e-05,563,541,2,10,0.001,1104,12
0.53,1e-05,614,590,2,10,0.001,1204,12
0.538,1e-05,662,642,2,10,0.001,1304,12
0.548,1e-05,716,688,2,10,0.001,1404,12
0.564,1e-05,762,742,2,10,0.001,1504,12
0.566,1e-05,812,792,2,10,0.001,1604,12
0.582,1e-05,861,843,2,10,0.001,1704,12
0.592,1e-05,901,903,2,10,0.001,1804,12
0.6,1e-05,950,954,2,10,0.001,1904,12
0.63,1e-05,1005,999,2,10,0.001,2004,12
0.442,1e-05,59,45,2,10,0.001,104,13
0.44,1e-05,108,96,2,10,0.001,204,13
0.44,1e-05,154,150,2,10,0.001,304,13
0.44,1e-05,208,196,2,10,0.001,404,13
0.442,1e-05,262,242,2,10,0.001,504,13
0.442,1e-05,312,292,2,10,0.001,604,13
0.438,1e-05,360,344,2,10,0.001,704,13
0.442,1e-05,410,394,2,10,0.001,804,13
0.452,1e-05,460,444,2,10,0.001,904,13
0.454,1e-05,511,493,2,10,0.001,1004,13
0.444,1e-05,558,546,2,10,0.001,1104,13
0.442,1e-05,602,602,2,10,0.001,1204,13
0.446,1e-05,651,653,2,10,0.001,1304,13
0.446,1e-05,709,695,2,10,0.001,1404,13
0.442,1e-05,757,747,2,10,0.001,1504,13
0.44,1e-05,812,792,2,10,0.001,1604,13
0.44,1e-05,859,845,2,10,0.001,1704,13
0.452,1e-05,910,894,2,10,0.001,1804,13
0.454,1e-05,965,939,2,10,0.001,1904,13
0.46,1e-05,1005,999,2,10,0.001,2004,13
0.57,1e-05,59,45,2,10,0.001,104,14
0.576,1e-05,113,91,2,10,0.001,204,14
0.578,1e-05,165,139,2,10,0.001,304,14
0.578,1e-05,212,192,2,10,0.001,404,14
0.586,1e-05,264,240,2,10,0.001,504,14
0.588,1e-05,311,293,2,10,0.001,604,14
0.592,1e-05,365,339,2,10,0.001,704,14
0.596,1e-05,406,398,2,10,0.001,804,14
0.606,1e-05,453,451,2,10,0.001,904,14
0.612,1e-05,496,508,2,10,0.001,1004,14
0.618,1e-05,549,555,2,10,0.001,1104,14
0.624,1e-05,603,601,2,10,0.001,1204,14
0.626,1e-05,658,646,2,10,0.001,1304,14
0.638,1e-05,704,700,2,10,0.001,1404,14
0.642,1e-05,745,759,2,10,0.001,1504,14
0.648,1e-05,796,808,2,10,0.001,1604,14
0.65,1e-05,846,858,2,10,0.001,1704,14
0.66,1e-05,898,906,2,10,0.001,1804,14
0.676,1e-05,939,965,2,10,0.001,1904,14
0.68,1e-05,990,1014,2,10,0.001,2004,14
0.632,1e-05,55,49,2,10,0.001,104,15
0.632,1e-05,105,99,2,10,0.001,204,15
0.632,1e-05,153,151,2,10,0.001,304,15
0.632,1e-05,209,195,2,10,0.001,404,15
0.634,1e-05,257,247,2,10,0.001,504,15
0.638,1e-05,312,292,2,10,0.001,604,15
0.64,1e-05,369,335,2,10,0.001,704,15
0.644,1e-05,420,384,2,10,0.001,804,15
0.65,1e-05,470,434,2,10,0.001,904,15
0.658,1e-05,519,485,2,10,0.001,1004,15
0.666,1e-05,562,542,2,10,0.001,1104,15
0.668,1e-05,615,589,2,10,0.001,1204,15
0.668,1e-05,659,645,2,10,0.001,1304,15
0.674,1e-05,722,682,2,10,0.001,1404,15
0.686,1e-05,773,731,2,10,0.001,1504,15
0.71,1e-05,823,781,2,10,0.001,1604,15
0.712,1e-05,870,834,2,10,0.001,1704,15
0.726,1e-05,906,898,2,10,0.001,1804,15
0.728,1e-05,965,939,2,10,0.001,1904,15
0.73,1e-05,1019,985,2,10,0.001,2004,15
0.502,1e-05,50,54,2,10,0.001,104,16
0.502,1e-05,101,103,2,10,0.001,204,16
0.502,1e-05,143,161,2,10,0.001,304,16
0.506,1e-05,190,214,2,10,0.001,404,16
0.508,1e-05,243,261,2,10,0.001,504,16
0.51,1e-05,293,311,2,10,0.001,604,16
0.512,1e-05,350,354,2,10,0.001,704,16
0.514,1e-05,401,403,2,10,0.001,804,16
0.516,1e-05,450,454,2,10,0.001,904,16
0.518,1e-05,505,499,2,10,0.001,1004,16
0.522,1e-05,559,545,2,10,0.001,1104,16
0.528,1e-05,616,588,2,10,0.001,1204,16
0.536,1e-05,662,642,2,10,0.001,1304,16
0.542,1e-05,701,703,2,10,0.001,1404,16
0.546,1e-05,745,759,2,10,0.001,1504,16
0.548,1e-05,791,813,2,10,0.001,1604,16
0.558,1e-05,833,871,2,10,0.001,1704,16
0.566,1e-05,891,913,2,10,0.001,1804,16
0.572,1e-05,950,954,2,10,0.001,1904,16
0.578,1e-05,997,1007,2,10,0.001,2004,16
0.446,1e-05,48,56,2,10,0.001,104,17
0.448,1e-05,91,113,2,10,0.001,204,17
0.448,1e-05,129,175,2,10,0.001,304,17
0.448,1e-05,184,220,2,10,0.001,404,17
0.45,1e-05,240,264,2,10,0.001,504,17
0.452,1e-05,299,305,2,10,0.001,604,17
0.454,1e-05,350,354,2,10,0.001,704,17
0.454,1e-05,398,406,2,10,0.001,804,17
0.456,1e-05,454,450,2,10,0.001,904,17
0.464,1e-05,503,501,2,10,0.001,1004,17
0.472,1e-05,551,553,2,10,0.001,1104,17
0.478,1e-05,599,605,2,10,0.001,1204,17
0.48,1e-05,648,656,2,10,0.001,1304,17
0.486,1e-05,696,708,2,10,0.001,1404,17
0.498,1e-05,745,759,2,10,0.001,1504,17
0.518,1e-05,802,802,2,10,0.001,1604,17
0.528,1e-05,850,854,2,10,0.001,1704,17
0.546,1e-05,896,908,2,10,0.001,1804,17
0.552,1e-05,954,950,2,10,0.001,1904,17
0.568,1e-05,1006,998,2,10,0.001,2004,17
0.544,1e-05,42,62,2,10,0.001,104,18
0.544,1e-05,96,108,2,10,0.001,204,18
0.544,1e-05,145,159,2,10,0.001,304,18
0.546,1e-05,201,203,2,10,0.001,404,18
0.548,1e-05,252,252,2,10,0.001,504,18
0.554,1e-05,292,312,2,10,0.001,604,18
0.562,1e-05,349,355,2,10,0.001,704,18
0.556,1e-05,407,397,2,10,0.001,804,18
0.558,1e-05,460,444,2,10,0.001,904,18
0.556,1e-05,517,487,2,10,0.001,1004,18
0.558,1e-05,562,542,2,10,0.001,1104,18
0.556,1e-05,621,583,2,10,0.001,1204,18
0.568,1e-05,663,641,2,10,0.001,1304,18
0.572,1e-05,709,695,2,10,0.001,1404,18
0.574,1e-05,762,742,2,10,0.001,1504,18
0.586,1e-05,808,796,2,10,0.001,1604,18
0.606,1e-05,851,853,2,10,0.001,1704,18
0.614,1e-05,891,913,2,10,0.001,1804,18
0.644,1e-05,940,964,2,10,0.001,1904,18
0.656,1e-05,986,1018,2,10,0.001,2004,18
0.502,1e-05,53,51,2,10,0.001,104,19
0.52,1e-05,98,106,2,10,0.001,204,19
0.542,1e-05,143,161,2,10,0.001,304,19
0.58,1e-05,193,211,2,10,0.001,404,19
0.6,1e-05,245,259,2,10,0.001,504,19
0.62,1e-05,300,304,2,10,0.001,604,19
0.642,1e-05,355,349,2,10,0.001,704,19
0.648,1e-05,417,387,2,10,0.001,804,19
0.662,1e-05,464,440,2,10,0.001,904,19
0.664,1e-05,513,491,2,10,0.001,1004,19
0.676,1e-05,563,541,2,10,0.001,1104,19
0.68,1e-05,611,593,2,10,0.001,1204,19
0.682,1e-05,660,644,2,10,0.001,1304,19
0.688,1e-05,713,691,2,10,0.001,1404,19
0.712,1e-05,760,744,2,10,0.001,1504,19
0.72,1e-05,809,795,2,10,0.001,1604,19
0.74,1e-05,864,840,2,10,0.001,1704,19
0.744,1e-05,910,894,2,10,0.001,1804,19
0.748,1e-05,964,940,2,10,0.001,1904,19
0.752,1e-05,1005,999,2,10,0.001,2004,19
0.418,1e-05,44,60,2,10,0.001,104,20
0.418,1e-05,102,102,2,10,0.001,204,20
0.418,1e-05,152,152,2,10,0.001,304,20
0.42,1e-05,199,205,2,10,0.001,404,20
0.426,1e-05,250,254,2,10,0.001,504,20
0.43,1e-05,305,299,2,10,0.001,604,20
0.434,1e-05,359,345,2,10,0.001,704,20
0.442,1e-05,409,395,2,10,0.001,804,20
0.45,1e-05,458,446,2,10,0.001,904,20
0.456,1e-05,510,494,2,10,0.001,1004,20
0.468,1e-05,559,545,2,10,0.001,1104,20
0.488,1e-05,612,592,2,10,0.001,1204,20
0.502,1e-05,662,642,2,10,0.001,1304,20
0.53,1e-05,715,689,2,10,0.001,1404,20
0.582,1e-05,771,733,2,10,0.001,1504,20
0.626,1e-05,814,790,2,10,0.001,1604,20
0.636,1e-05,856,848,2,10,0.001,1704,20
0.64,1e-05,902,902,2,10,0.001,1804,20
0.652,1e-05,943,961,2,10,0.001,1904,20
0.658,1e-05,992,1012,2,10,0.001,2004,20
0.48,1e-05,50,54,2,10,0.01,104,1
0.48,1e-05,98,106,2,10,0.01,204,1
0.48,1e-05,156,148,2,10,0.01,304,1
0.48,1e-05,204,200,2,10,0.01,404,1
0.48,1e-05,251,253,2,10,0.01,504,1
0.48,1e-05,294,310,2,10,0.01,604,1
0.514,1e-05,341,363,2,10,0.01,704,1
0.568,1e-05,382,422,2,10,0.01,804,1
0.5,1e-05,436,468,2,10,0.01,904,1
0.534,1e-05,491,513,2,10,0.01,1004,1
0.538,1e-05,546,558,2,10,0.01,1104,1
0.566,1e-05,602,602,2,10,0.01,1204,1
0.628,1e-05,655,649,2,10,0.01,1304,1
0.678,1e-05,701,703,2,10,0.01,1404,1
0.706,1e-05,750,754,2,10,0.01,1504,1
0.744,1e-05,802,802,2,10,0.01,1604,1
0.764,1e-05,857,847,2,10,0.01,1704,1
0.796,1e-05,903,901,2,10,0.01,1804,1
0.89,1e-05,951,953,2,10,0.01,1904,1
0.888,1e-05,992,1012,2,10,0.01,2004,1
0.514,1e-05,43,61,2,10,0.01,104,2
0.514,1e-05,97,107,2,10,0.01,204,2
0.508,1e-05,147,157,2,10,0.01,304,2
0.502,1e-05,196,208,2,10,0.01,404,2
0.526,1e-05,258,246,2,10,0.01,504,2
0.52,1e-05,304,300,2,10,0.01,604,2
0.516,1e-05,356,348,2,10,0.01,704,2
0.536,1e-05,407,397,2,10,0.01,804,2
0.538,1e-05,463,441,2,10,0.01,904,2
0.55,1e-05,514,490,2,10,0.01,1004,2
0.572,1e-05,569,535,2,10,0.01,1104,2
0.56,1e-05,620,584,2,10,0.01,1204,2
0.562,1e-05,669,635,2,10,0.01,1304,2
0.602,1e-05,715,689,2,10,0.01,1404,2
0.622,1e-05,765,739,2,10,0.01,1504,2
0.626,1e-05,812,792,2,10,0.01,1604,2
0.608,1e-05,855,849,2,10,0.01,1704,2
0.606,1e-05,904,900,2,10,0.01,1804,2
0.652,1e-05,950,954,2,10,0.01,1904,2
0.644,1e-05,995,1009,2,10,0.01,2004,2
0.516,1e-05,57,47,2,10,0.01,104,3
0.456,1e-05,108,96,2,10,0.01,204,3
0.416,1e-05,153,151,2,10,0.01,304,3
0.422,1e-05,204,200,2,10,0.01,404,3
0.398,1e-05,255,249,2,10,0.01,504,3
0.436,1e-05,305,299,2,10,0.01,604,3
0.498,1e-05,358,346,2,10,0.01,704,3
0.564,1e-05,412,392,2,10,0.01,804,3
0.614,1e-05,466,438,2,10,0.01,904,3
0.674,1e-05,518,486,2,10,0.01,1004,3
0.668,1e-05,558,546,2,10,0.01,1104,3
0.71,1e-05,612,592,2,10,0.01,1204,3
0.756,1e-05,656,648,2,10,0.01,1304,3
0.796,1e-05,703,701,2,10,0.01,1404,3
0.804,1e-05,760,744,2,10,0.01,1504,3
0.846,1e-05,816,788,2,10,0.01,1604,3
0.846,1e-05,864,840,2,10,0.01,1704,3
0.85,1e-05,912,892,2,10,0.01,1804,3
0.862,1e-05,966,938,2,10,0.01,1904,3
0.872,1e-05,1007,997,2,10,0.01,2004,3
0.456,1e-05,59,45,2,10,0.01,104,4
0.46,1e-05,111,93,2,10,0.01,204,4
0.46,1e-05,162,142,2,10,0.01,304,4
0.494,1e-05,208,196,2,10,0.01,404,4
0.538,1e-05,256,248,2,10,0.01,504,4
0.598,1e-05,297,307,2,10,0.01,604,4
0.624,1e-05,341,363,2,10,0.01,704,4
0.65,1e-05,405,399,2,10,0.01,804,4
0.654,1e-05,457,447,2,10,0.01,904,4
0.668,1e-05,507,497,2,10,0.01,1004,4
0.668,1e-05,561,543,2,10,0.01,1104,4
0.68,1e-05,609,595,2,10,0.01,1204,4
0.694,1e-05,668,636,2,10,0.01,1304,4
0.716,1e-05,719,685,2,10,0.01,1404,4
0.74,1e-05,773,731,2,10,0.01,1504,4
0.754,1e-05,830,774,2,10,0.01,1604,4
0.764,1e-05,876,828,2,10,0.01,1704,4
0.792,1e-05,922,882,2,10,0.01,1804,4
0.832,1e-05,976,928,2,10,0.01,1904,4
0.862,1e-05,1024,980,2,10,0.01,2004,4
0.528,1e-05,53,51,2,10,0.01,104,5
0.556,1e-05,102,102,2,10,0.01,204,5
0.576,1e-05,154,150,2,10,0.01,304,5
0.548,1e-05,211,193,2,10,0.01,404,5
0.564,1e-05,246,258,2,10,0.01,504,5
0.6,1e-05,291,313,2,10,0.01,604,5
0.574,1e-05,344,360,2,10,0.01,704,5
0.584,1e-05,385,419,2,10,0.01,804,5
0.59,1e-05,430,474,2,10,0.01,904,5
0.608,1e-05,482,522,2,10,0.01,1004,5
0.64,1e-05,535,569,2,10,0.01,1104,5
0.666,1e-05,584,620,2,10,0.01,1204,5
0.688,1e-05,636,668,2,10,0.01,1304,5
0.716,1e-05,688,716,2,10,0.01,1404,5
0.76,1e-05,742,762,2,10,0.01,1504,5
0.8,1e-05,785,819,2,10,0.01,1604,5
0.826,1e-05,832,872,2,10,0.01,1704,5
0.83,1e-05,882,922,2,10,0.01,1804,5
0.848,1e-05,932,972,2,10,0.01,1904,5
0.856,1e-05,991,1013,2,10,0.01,2004,5
0.512,1e-05,55,49,2,10,0.01,104,6
0.512,1e-05,105,99,2,10,0.01,204,6
0.512,1e-05,157,147,2,10,0.01,304,6
0.512,1e-05,206,198,2,10,0.01,404,6
0.514,1e-05,257,247,2,10,0.01,504,6
0.56,1e-05,309,295,2,10,0.01,604,6
0.572,1e-05,364,340,2,10,0.01,704,6
0.546,1e-05,414,390,2,10,0.01,804,6
0.548,1e-05,463,441,2,10,0.01,904,6
0.562,1e-05,502,502,2,10,0.01,1004,6
0.57,1e-05,545,559,2,10,0.01,1104,6
0.708,1e-05,599,605,2,10,0.01,1204,6
0.77,1e-05,644,660,2,10,0.01,1304,6
0.77,1e-05,692,712,2,10,0.01,1404,6
0.772,1e-05,742,762,2,10,0.01,1504,6
0.794,1e-05,795,809,2,10,0.01,1604,6
0.822,1e-05,848,856,2,10,0.01,1704,6
0.838,1e-05,908,896,2,10,0.01,1804,6
0.842,1e-05,952,952,2,10,0.01,1904,6
0.866,1e-05,1008,996,2,10,0.01,2004,6
0.546,1e-05,43,61,2,10,0.01,104,7
0.548,1e-05,90,114,2,10,0.01,204,7
0.542,1e-05,139,165,2,10,0.01,304,7
0.54,1e-05,186,218,2,10,0.01,404,7
0.544,1e-05,234,270,2,10,0.01,504,7
0.544,1e-05,289,315,2,10,0.01,604,7
0.546,1e-05,346,358,2,10,0.01,704,7
0.626,1e-05,399,405,2,10,0.01,804,7
0.712,1e-05,461,443,2,10,0.01,904,7
0.784,1e-05,512,492,2,10,0.01,1004,7
0.834,1e-05,559,545,2,10,0.01,1104,7
0.868,1e-05,613,591,2,10,0.01,1204,7
0.882,1e-05,658,646,2,10,0.01,1304,7
0.886,1e-05,704,700,2,10,0.01,1404,7
0.886,1e-05,748,756,2,10,0.01,1504,7
0.882,1e-05,804,800,2,10,0.01,1604,7
0.886,1e-05,849,855,2,10,0.01,1704,7
0.892,1e-05,898,906,2,10,0.01,1804,7
0.894,1e-05,947,957,2,10,0.01,1904,7
0.898,1e-05,999,1005,2,10,0.01,2004,7
0.502,1e-05,53,51,2,10,0.01,104,8
0.502,1e-05,106,98,2,10,0.01,204,8
0.502,1e-05,159,145,2,10,0.01,304,8
0.502,1e-05,212,192,2,10,0.01,404,8
0.502,1e-05,256,248,2,10,0.01,504,8
0.506,1e-05,304,300,2,10,0.01,604,8
0.622,1e-05,359,345,2,10,0.01,704,8
0.722,1e-05,409,395,2,10,0.01,804,8
0.716,1e-05,462,442,2,10,0.01,904,8
0.658,1e-05,509,495,2,10,0.01,1004,8
0.732,1e-05,554,550,2,10,0.01,1104,8
0.724,1e-05,609,595,2,10,0.01,1204,8
0.73,1e-05,656,648,2,10,0.01,1304,8
0.728,1e-05,701,703,2,10,0.01,1404,8
0.734,1e-05,758,746,2,10,0.01,1504,8
0.738,1e-05,818,786,2,10,0.01,1604,8
0.73,1e-05,868,836,2,10,0.01,1704,8
0.738,1e-05,915,889,2,10,0.01,1804,8
0.76,1e-05,958,946,2,10,0.01,1904,8
0.778,1e-05,1003,1001,2,10,0.01,2004,8
0.526,1e-05,54,50,2,10,0.01,104,9
0.524,1e-05,112,92,2,10,0.01,204,9
0.518,1e-05,159,145,2,10,0.01,304,9
0.526,1e-05,208,196,2,10,0.01,404,9
0.54,1e-05,247,257,2,10,0.01,504,9
0.598,1e-05,293,311,2,10,0.01,604,9
0.598,1e-05,344,360,2,10,0.01,704,9
0.596,1e-05,393,411,2,10,0.01,804,9
0.602,1e-05,446,458,2,10,0.01,904,9
0.61,1e-05,495,509,2,10,0.01,1004,9
0.666,1e-05,557,547,2,10,0.01,1104,9
0.758,1e-05,599,605,2,10,0.01,1204,9
0.864,1e-05,647,657,2,10,0.01,1304,9
0.892,1e-05,699,705,2,10,0.01,1404,9
0.864,1e-05,745,759,2,10,0.01,1504,9
0.844,1e-05,796,808,2,10,0.01,1604,9
0.826,1e-05,840,864,2,10,0.01,1704,9
0.844,1e-05,890,914,2,10,0.01,1804,9
0.868,1e-05,932,972,2,10,0.01,1904,9
0.882,1e-05,989,1015,2,10,0.01,2004,9
0.524,1e-05,49,55,2,10,0.01,104,10
0.538,1e-05,106,98,2,10,0.01,204,10
0.554,1e-05,158,146,2,10,0.01,304,10
0.548,1e-05,218,186,2,10,0.01,404,10
0.546,1e-05,265,239,2,10,0.01,504,10
0.538,1e-05,312,292,2,10,0.01,604,10
0.55,1e-05,366,338,2,10,0.01,704,10
0.556,1e-05,420,384,2,10,0.01,804,10
0.542,1e-05,468,436,2,10,0.01,904,10
0.594,1e-05,513,491,2,10,0.01,1004,10
0.65,1e-05,558,546,2,10,0.01,1104,10
0.668,1e-05,601,603,2,10,0.01,1204,10
0.658,1e-05,653,651,2,10,0.01,1304,10
0.7,1e-05,702,702,2,10,0.01,1404,10
0.722,1e-05,751,753,2,10,0.01,1504,10
0.756,1e-05,806,798,2,10,0.01,1604,10
0.758,1e-05,855,849,2,10,0.01,1704,10
0.774,1e-05,905,899,2,10,0.01,1804,10
0.78,1e-05,951,953,2,10,0.01,1904,10
0.794,1e-05,1001,1003,2,10,0.01,2004,10
0.534,1e-05,53,51,2,10,0.01,104,11
0.526,1e-05,100,104,2,10,0.01,204,11
0.56,1e-05,151,153,2,10,0.01,304,11
0.598,1e-05,207,197,2,10,0.01,404,11
0.624,1e-05,258,246,2,10,0.01,504,11
0.624,1e-05,303,301,2,10,0.01,604,11
0.636,1e-05,351,353,2,10,0.01,704,11
0.67,1e-05,400,404,2,10,0.01,804,11
0.67,1e-05,449,455,2,10,0.01,904,11
0.678,1e-05,496,508,2,10,0.01,1004,11
0.664,1e-05,547,557,2,10,0.01,1104,11
0.71,1e-05,597,607,2,10,0.01,1204,11
0.77,1e-05,650,654,2,10,0.01,1304,11
0.78,1e-05,702,702,2,10,0.01,1404,11
0.776,1e-05,747,757,2,10,0.01,1504,11
0.808,1e-05,804,800,2,10,0.01,1604,11
0.83,1e-05,853,851,2,10,0.01,1704,11
0.84,1e-05,899,905,2,10,0.01,1804,11
0.856,1e-05,945,959,2,10,0.01,1904,11
0.86,1e-05,1005,999,2,10,0.01,2004,11
0.682,1e-05,56,48,2,10,0.01,104,12
0.796,1e-05,110,94,2,10,0.01,204,12
0.696,1e-05,162,142,2,10,0.01,304,12
0.662,1e-05,212,192,2,10,0.01,404,12
0.594,1e-05,252,252,2,10,0.01,504,12
0.594,1e-05,301,303,2,10,0.01,604,12
0.622,1e-05,351,353,2,10,0.01,704,12
0.636,1e-05,403,401,2,10,0.01,804,12
0.66,1e-05,449,455,2,10,0.01,904,12
0.69,1e-05,497,507,2,10,0.01,1004,12
0.798,1e-05,547,557,2,10,0.01,1104,12
0.94,1e-05,600,604,2,10,0.01,1204,12
0.918,1e-05,650,654,2,10,0.01,1304,12
0.9,1e-05,701,703,2,10,0.01,1404,12
0.886,1e-05,747,757,2,10,0.01,1504,12
0.874,1e-05,791,813,2,10,0.01,1604,12
0.866,1e-05,847,857,2,10,0.01,1704,12
0.868,1e-05,893,911,2,10,0.01,1804,12
0.874,1e-05,945,959,2,10,0.01,1904,12
0.878,1e-05,996,1008,2,10,0.01,2004,12
0.486,1e-05,50,54,2,10,0.01,104,13
0.508,1e-05,100,104,2,10,0.01,204,13
0.516,1e-05,145,159,2,10,0.01,304,13
0.57,1e-05,194,210,2,10,0.01,404,13
0.628,1e-05,252,252,2,10,0.01,504,13
0.69,1e-05,305,299,2,10,0.01,604,13
0.736,1e-05,356,348,2,10,0.01,704,13
0.766,1e-05,405,399,2,10,0.01,804,13
0.794,1e-05,457,447,2,10,0.01,904,13
0.818,1e-05,509,495,2,10,0.01,1004,13
0.84,1e-05,560,544,2,10,0.01,1104,13
0.852,1e-05,605,599,2,10,0.01,1204,13
0.868,1e-05,663,641,2,10,0.01,1304,13
0.878,1e-05,715,689,2,10,0.01,1404,13
0.89,1e-05,762,742,2,10,0.01,1504,13
0.894,1e-05,815,789,2,10,0.01,1604,13
0.902,1e-05,855,849,2,10,0.01,1704,13
0.9,1e-05,903,901,2,10,0.01,1804,13
0.898,1e-05,951,953,2,10,0.01,1904,13
0.906,1e-05,997,1007,2,10,0.01,2004,13
0.518,1e-05,43,61,2,10,0.01,104,14
0.524,1e-05,94,110,2,10,0.01,204,14
0.494,1e-05,142,162,2,10,0.01,304,14
0.468,1e-05,189,215,2,10,0.01,404,14
0.478,1e-05,237,267,2,10,0.01,504,14
0.478,1e-05,283,321,2,10,0.01,604,14
0.484,1e-05,336,368,2,10,0.01,704,14
0.514,1e-05,386,418,2,10,0.01,804,14
0.526,1e-05,448,456,2,10,0.01,904,14
0.54,1e-05,500,504,2,10,0.01,1004,14
0.572,1e-05,552,552,2,10,0.01,1104,14
0.576,1e-05,613,591,2,10,0.01,1204,14
0.612,1e-05,655,649,2,10,0.01,1304,14
0.606,1e-05,709,695,2,10,0.01,1404,14
0.604,1e-05,764,740,2,10,0.01,1504,14
0.632,1e-05,818,786,2,10,0.01,1604,14
0.66,1e-05,867,837,2,10,0.01,1704,14
0.67,1e-05,916,888,2,10,0.01,1804,14
0.672,1e-05,964,940,2,10,0.01,1904,14
0.678,1e-05,1011,993,2,10,0.01,2004,14
0.588,1e-05,52,52,2,10,0.01,104,15
0.578,1e-05,103,101,2,10,0.01,204,15
0.598,1e-05,154,150,2,10,0.01,304,15
0.576,1e-05,208,196,2,10,0.01,404,15
0.568,1e-05,271,233,2,10,0.01,504,15
0.574,1e-05,323,281,2,10,0.01,604,15
0.542,1e-05,380,324,2,10,0.01,704,15
0.564,1e-05,432,372,2,10,0.01,804,15
0.542,1e-05,484,420,2,10,0.01,904,15
0.56,1e-05,532,472,2,10,0.01,1004,15
0.586,1e-05,583,521,2,10,0.01,1104,15
0.632,1e-05,627,577,2,10,0.01,1204,15
0.676,1e-05,674,630,2,10,0.01,1304,15
0.726,1e-05,724,680,2,10,0.01,1404,15
0.752,1e-05,777,727,2,10,0.01,1504,15
0.768,1e-05,819,785,2,10,0.01,1604,15
0.806,1e-05,866,838,2,10,0.01,1704,15
0.82,1e-05,913,891,2,10,0.01,1804,15
0.84,1e-05,964,940,2,10,0.01,1904,15
0.858,1e-05,1013,991,2,10,0.01,2004,15
0.51,1e-05,48,56,2,10,0.01,104,16
0.51,1e-05,93,111,2,10,0.01,204,16
0.51,1e-05,147,157,2,10,0.01,304,16
0.51,1e-05,200,204,2,10,0.01,404,16
0.514,1e-05,232,272,2,10,0.01,504,16
0.566,1e-05,284,320,2,10,0.01,604,16
0.652,1e-05,337,367,2,10,0.01,704,16
0.708,1e-05,385,419,2,10,0.01,804,16
0.742,1e-05,438,466,2,10,0.01,904,16
0.768,1e-05,498,506,2,10,0.01,1004,16
0.796,1e-05,556,548,2,10,0.01,1104,16
0.822,1e-05,603,601,2,10,0.01,1204,16
0.852,1e-05,655,649,2,10,0.01,1304,16
0.848,1e-05,701,703,2,10,0.01,1404,16
0.846,1e-05,755,749,2,10,0.01,1504,16
0.846,1e-05,809,795,2,10,0.01,1604,16
0.854,1e-05,862,842,2,10,0.01,1704,16
0.864,1e-05,911,893,2,10,0.01,1804,16
0.878,1e-05,960,944,2,10,0.01,1904,16
0.89,1e-05,1007,997,2,10,0.01,2004,16
0.46,1e-05,50,54,2,10,0.01,104,17
0.494,1e-05,107,97,2,10,0.01,204,17
0.504,1e-05,163,141,2,10,0.01,304,17
0.526,1e-05,219,185,2,10,0.01,404,17
0.544,1e-05,263,241,2,10,0.01,504,17
0.576,1e-05,315,289,2,10,0.01,604,17
0.614,1e-05,374,330,2,10,0.01,704,17
0.696,1e-05,419,385,2,10,0.01,804,17
0.706,1e-05,461,443,2,10,0.01,904,17
0.728,1e-05,509,495,2,10,0.01,1004,17
0.738,1e-05,564,540,2,10,0.01,1104,17
0.748,1e-05,615,589,2,10,0.01,1204,17
0.764,1e-05,659,645,2,10,0.01,1304,17
0.792,1e-05,713,691,2,10,0.01,1404,17
0.796,1e-05,757,747,2,10,0.01,1504,17
0.822,1e-05,802,802,2,10,0.01,1604,17
0.85,1e-05,851,853,2,10,0.01,1704,17
0.86,1e-05,902,902,2,10,0.01,1804,17
0.858,1e-05,954,950,2,10,0.01,1904,17
0.816,1e-05,995,1009,2,10,0.01,2004,17
0.446,1e-05,56,48,2,10,0.01,104,18
0.482,1e-05,114,90,2,10,0.01,204,18
0.476,1e-05,172,132,2,10,0.01,304,18
0.486,1e-05,228,176,2,10,0.01,404,18
0.468,1e-05,268,236,2,10,0.01,504,18
0.478,1e-05,318,286,2,10,0.01,604,18
0.512,1e-05,370,334,2,10,0.01,704,18
0.52,1e-05,421,383,2,10,0.01,804,18
0.534,1e-05,465,439,2,10,0.01,904,18
0.616,1e-05,513,491,2,10,0.01,1004,18
0.66,1e-05,560,544,2,10,0.01,1104,18
0.7,1e-05,605,599,2,10,0.01,1204,18
0.696,1e-05,657,647,2,10,0.01,1304,18
0.71,1e-05,712,692,2,10,0.01,1404,18
0.726,1e-05,763,741,2,10,0.01,1504,18
0.764,1e-05,821,783,2,10,0.01,1604,18
0.772,1e-05,874,830,2,10,0.01,1704,18
0.798,1e-05,923,881,2,10,0.01,1804,18
0.804,1e-05,972,932,2,10,0.01,1904,18
0.844,1e-05,1026,978,2,10,0.01,2004,18
0.522,1e-05,52,52,2,10,0.01,104,19
0.522,1e-05,100,104,2,10,0.01,204,19
0.524,1e-05,150,154,2,10,0.01,304,19
0.544,1e-05,194,210,2,10,0.01,404,19
0.55,1e-05,247,257,2,10,0.01,504,19
0.638,1e-05,298,306,2,10,0.01,604,19
0.668,1e-05,352,352,2,10,0.01,704,19
0.72,1e-05,397,407,2,10,0.01,804,19
0.764,1e-05,444,460,2,10,0.01,904,19
0.822,1e-05,489,515,2,10,0.01,1004,19
0.834,1e-05,528,576,2,10,0.01,1104,19
0.836,1e-05,580,624,2,10,0.01,1204,19
0.88,1e-05,634,670,2,10,0.01,1304,19
0.884,1e-05,687,717,2,10,0.01,1404,19
0.906,1e-05,737,767,2,10,0.01,1504,19
0.904,1e-05,788,816,2,10,0.01,1604,19
0.91,1e-05,840,864,2,10,0.01,1704,19
0.91,1e-05,890,914,2,10,0.01,1804,19
0.912,1e-05,940,964,2,10,0.01,1904,19
0.918,1e-05,991,1013,2,10,0.01,2004,19
0.602,1e-05,65,39,2,10,0.01,104,20
0.61,1e-05,118,86,2,10,0.01,204,20
0.626,1e-05,169,135,2,10,0.01,304,20
0.646,1e-05,226,178,2,10,0.01,404,20
0.684,1e-05,285,219,2,10,0.01,504,20
0.74,1e-05,326,278,2,10,0.01,604,20
0.77,1e-05,374,330,2,10,0.01,704,20
0.808,1e-05,425,379,2,10,0.01,804,20
0.832,1e-05,482,422,2,10,0.01,904,20
0.844,1e-05,531,473,2,10,0.01,1004,20
0.846,1e-05,589,515,2,10,0.01,1104,20
0.866,1e-05,639,565,2,10,0.01,1204,20
0.878,1e-05,689,615,2,10,0.01,1304,20
0.898,1e-05,741,663,2,10,0.01,1404,20
0.894,1e-05,783,721,2,10,0.01,1504,20
0.904,1e-05,827,777,2,10,0.01,1604,20
0.906,1e-05,871,833,2,10,0.01,1704,20
0.91,1e-05,923,881,2,10,0.01,1804,20
0.914,1e-05,971,933,2,10,0.01,1904,20
0.914,1e-05,1021,983,2,10,0.01,2004,20
0.472,0.0001,53,51,2,10,0.0001,104,1
0.472,0.0001,98,106,2,10,0.0001,204,1
0.472,0.0001,148,156,2,10,0.0001,304,1
0.472,0.0001,198,206,2,10,0.0001,404,1
0.472,0.0001,250,254,2,10,0.0001,504,1
0.472,0.0001,307,297,2,10,0.0001,604,1
0.472,0.0001,358,346,2,10,0.0001,704,1
0.474,0.0001,410,394,2,10,0.0001,804,1
0.474,0.0001,456,448,2,10,0.0001,904,1
0.472,0.0001,504,500,2,10,0.0001,1004,1
0.474,0.0001,551,553,2,10,0.0001,1104,1
0.474,0.0001,604,600,2,10,0.0001,1204,1
0.472,0.0001,657,647,2,10,0.0001,1304,1
0.472,0.0001,709,695,2,10,0.0001,1404,1
0.472,0.0001,760,744,2,10,0.0001,1504,1
0.472,0.0001,803,801,2,10,0.0001,1604,1
0.472,0.0001,849,855,2,10,0.0001,1704,1
0.472,0.0001,901,903,2,10,0.0001,1804,1
0.474,0.0001,958,946,2,10,0.0001,1904,1
0.476,0.0001,1007,997,2,10,0.0001,2004,1
0.49,0.0001,46,58,2,10,0.0001,104,2
0.49,0.0001,94,110,2,10,0.0001,204,2
0.49,0.0001,154,150,2,10,0.0001,304,2
0.49,0.0001,198,206,2,10,0.0001,404,2
0.49,0.0001,249,255,2,10,0.0001,504,2
0.49,0.0001,294,310,2,10,0.0001,604,2
0.49,0.0001,343,361,2,10,0.0001,704,2
0.49,0.0001,390,414,2,10,0.0001,804,2
0.49,0.0001,446,458,2,10,0.0001,904,2
0.49,0.0001,492,512,2,10,0.0001,1004,2
0.49,0.0001,540,564,2,10,0.0001,1104,2
0.49,0.0001,588,616,2,10,0.0001,1204,2
0.49,0.0001,641,663,2,10,0.0001,1304,2
0.49,0.0001,698,706,2,10,0.0001,1404,2
0.49,0.0001,750,754,2,10,0.0001,1504,2
0.49,0.0001,799,805,2,10,0.0001,1604,2
0.49,0.0001,841,863,2,10,0.0001,1704,2
0.49,0.0001,887,917,2,10,0.0001,1804,2
0.49,0.0001,944,960,2,10,0.0001,1904,2
0.49,0.0001,997,1007,2,10,0.0001,2004,2
0.494,0.0001,53,51,2,10,0.0001,104,3
0.496,0.0001,102,102,2,10,0.0001,204,3
0.496,0.0001,159,145,2,10,0.0001,304,3
0.496,0.0001,208,196,2,10,0.0001,404,3
0.496,0.0001,257,247,2,10,0.0001,504,3
0.5,0.0001,305,299,2,10,0.0001,604,3
0.504,0.0001,347,357,2,10,0.0001,704,3
0.504,0.0001,401,403,2,10,0.0001,804,3
0.504,0.0001,445,459,2,10,0.0001,904,3
0.504,0.0001,494,510,2,10,0.0001,1004,3
0.504,0.0001,545,559,2,10,0.0001,1104,3
0.506,0.0001,603,601,2,10,0.0001,1204,3
0.506,0.0001,653,651,2,10,0.0001,1304,3
0.504,0.0001,701,703,2,10,0.0001,1404,3
0.506,0.0001,754,750,2,10,0.0001,1504,3
0.506,0.0001,808,796,2,10,0.0001,1604,3
0.506,0.0001,858,846,2,10,0.0001,1704,3
0.508,0.0001,902,902,2,10,0.0001,1804,3
0.51,0.0001,948,956,2,10,0.0001,1904,3
0.512,0.0001,1002,1002,2,10,0.0001,2004,3
0.462,0.0001,56,48,2,10,0.0001,104,4
0.462,0.0001,108,96,2,10,0.0001,204,4
0.462,0.0001,157,147,2,10,0.0001,304,4
0.462,0.0001,203,201,2,10,0.0001,404,4
0.462,0.0001,252,252,2,10,0.0001,504,4
0.464,0.0001,304,300,2,10,0.0001,604,4
0.464,0.0001,351,353,2,10,0.0001,704,4
0.464,0.0001,395,409,2,10,0.0001,804,4
0.464,0.0001,442,462,2,10,0.0001,904,4
0.464,0.0001,497,507,2,10,0.0001,1004,4
0.464,0.0001,545,559,2,10,0.0001,1104,4
0.464,0.0001,608,596,2,10,0.0001,1204,4
0.464,0.0001,665,639,2,10,0.0001,1304,4
0.464,0.0001,713,691,2,10,0.0001,1404,4
0.464,0.0001,764,740,2,10,0.0001,1504,4
0.464,0.0001,820,784,2,10,0.0001,1604,4
0.464,0.0001,868,836,2,10,0.0001,1704,4
0.462,0.0001,915,889,2,10,0.0001,1804,4
0.458,0.0001,962,942,2,10,0.0001,1904,4
0.458,0.0001,1009,995,2,10,0.0001,2004,4
0.502,0.0001,60,44,2,10,0.0001,104,5
0.502,0.0001,117,87,2,10,0.0001,204,5
0.502,0.0001,166,138,2,10,0.0001,304,5
0.502,0.0001,217,187,2,10,0.0001,404,5
0.502,0.0001,270,234,2,10,0.0001,504,5
0.502,0.0001,313,291,2,10,0.0001,604,5
0.502,0.0001,363,341,2,10,0.0001,704,5
0.502,0.0001,419,385,2,10,0.0001,804,5
0.502,0.0001,466,438,2,10,0.0001,904,5
0.502,0.0001,516,488,2,10,0.0001,1004,5
0.5,0.0001,565,539,2,10,0.0001,1104,5
0.5,0.0001,610,594,2,10,0.0001,1204,5
0.5,0.0001,654,650,2,10,0.0001,1304,5
0.5,0.0001,709,695,2,10,0.0001,1404,5
0.5,0.0001,761,743,2,10,0.0001,1504,5
0.5,0.0001,811,793,2,10,0.0001,1604,5
0.5,0.0001,859,845,2,10,0.0001,1704,5
0.5,0.0001,898,906,2,10,0.0001,1804,5
0.5,0.0001,948,956,2,10,0.0001,1904,5
0.5,0.0001,997,1007,2,10,0.0001,2004,5
0.488,0.0001,49,55,2,10,0.0001,104,6
0.488,0.0001,88,116,2,10,0.0001,204,6
0.488,0.0001,137,167,2,10,0.0001,304,6
0.488,0.0001,185,219,2,10,0.0001,404,6
0.49,0.0001,236,268,2,10,0.0001,504,6
0.488,0.0001,292,312,2,10,0.0001,604,6
0.488,0.0001,340,364,2,10,0.0001,704,6
0.488,0.0001,390,414,2,10,0.0001,804,6
0.488,0.0001,437,467,2,10,0.0001,904,6
0.488,0.0001,488,516,2,10,0.0001,1004,6
0.488,0.0001,538,566,2,10,0.0001,1104,6
0.488,0.0001,592,612,2,10,0.0001,1204,6
0.488,0.0001,653,651,2,10,0.0001,1304,6
0.488,0.0001,713,691,2,10,0.0001,1404,6
0.488,0.0001,763,741,2,10,0.0001,1504,6
0.492,0.0001,802,802,2,10,0.0001,1604,6
0.49,0.0001,854,850,2,10,0.0001,1704,6
0.49,0.0001,901,903,2,10,0.0001,1804,6
0.49,0.0001,951,953,2,10,0.0001,1904,6
0.49,0.0001,996,1008,2,10,0.0001,2004,6
0.52,0.0001,57,47,2,10,0.0001,104,7
0.52,0.0001,107,97,2,10,0.0001,204,7
0.52,0.0001,159,145,2,10,0.0001,304,7
0.524,0.0001,209,195,2,10,0.0001,404,7
0.524,0.0001,270,234,2,10,0.0001,504,7
0.522,0.0001,316,288,2,10,0.0001,604,7
0.522,0.0001,370,334,2,10,0.0001,704,7
0.522,0.0001,421,383,2,10,0.0001,804,7
0.522,0.0001,468,436,2,10,0.0001,904,7
0.52,0.0001,520,484,2,10,0.0001,1004,7
0.518,0.0001,563,541,2,10,0.0001,1104,7
0.518,0.0001,613,591,2,10,0.0001,1204,7
0.522,0.0001,655,649,2,10,0.0001,1304,7
0.526,0.0001,699,705,2,10,0.0001,1404,7
0.524,0.0001,742,762,2,10,0.0001,1504,7
0.532,0.0001,789,815,2,10,0.0001,1604,7
0.536,0.0001,840,864,2,10,0.0001,1704,7
0.54,0.0001,892,912,2,10,0.0001,1804,7
0.548,0.0001,942,962,2,10,0.0001,1904,7
0.55,0.0001,987,1017,2,10,0.0001,2004,7
0.6,0.0001,45,59,2,10,0.0001,104,8
0.6,0.0001,86,118,2,10,0.0001,204,8
0.6,0.0001,140,164,2,10,0.0001,304,8
0.6,0.0001,186,218,2,10,0.0001,404,8
0.6,0.0001,236,268,2,10,0.0001,504,8
0.602,0.0001,284,320,2,10,0.0001,604,8
0.602,0.0001,330,374,2,10,0.0001,704,8
0.602,0.0001,379,425,2,10,0.0001,804,8
0.602,0.0001,429,475,2,10,0.0001,904,8
0.604,0.0001,475,529,2,10,0.0001,1004,8
0.604,0.0001,521,583,2,10,0.0001,1104,8
0.606,0.0001,572,632,2,10,0.0001,1204,8
0.608,0.0001,622,682,2,10,0.0001,1304,8
0.608,0.0001,680,724,2,10,0.0001,1404,8
0.608,0.0001,731,773,2,10,0.0001,1504,8
0.608,0.0001,790,814,2,10,0.0001,1604,8
0.608,0.0001,841,863,2,10,0.0001,1704,8
0.612,0.0001,883,921,2,10,0.0001,1804,8
0.612,0.0001,938,966,2,10,0.0001,1904,8
0.614,0.0001,992,1012,2,10,0.0001,2004,8
0.502,0.0001,52,52,2,10,0.0001,104,9
0.502,0.0001,98,106,2,10,0.0001,204,9
0.502,0.0001,143,161,2,10,0.0001,304,9
0.504,0.0001,197,207,2,10,0.0001,404,9
0.504,0.0001,253,251,2,10,0.0001,504,9
0.504,0.0001,310,294,2,10,0.0001,604,9
0.504,0.0001,353,351,2,10,0.0001,704,9
0.504,0.0001,407,397,2,10,0.0001,804,9
0.508,0.0001,454,450,2,10,0.0001,904,9
0.51,0.0001,497,507,2,10,0.0001,1004,9
0.51,0.0001,544,560,2,10,0.0001,1104,9
0.51,0.0001,598,606,2,10,0.0001,1204,9
0.51,0.0001,648,656,2,10,0.0001,1304,9
0.516,0.0001,690,714,2,10,0.0001,1404,9
0.516,0.0001,738,766,2,10,0.0001,1504,9
0.516,0.0001,795,809,2,10,0.0001,1604,9
0.518,0.0001,855,849,2,10,0.0001,1704,9
0.518,0.0001,903,901,2,10,0.0001,1804,9
0.518,0.0001,942,962,2,10,0.0001,1904,9
0.518,0.0001,989,1015,2,10,0.0001,2004,9
0.488,0.0001,52,52,2,10,0.0001,104,10
0.488,0.0001,109,95,2,10,0.0001,204,10
0.488,0.0001,159,145,2,10,0.0001,304,10
0.488,0.0001,211,193,2,10,0.0001,404,10
0.488,0.0001,255,249,2,10,0.0001,504,10
0.488,0.0001,291,313,2,10,0.0001,604,10
0.488,0.0001,340,364,2,10,0.0001,704,10
0.488,0.0001,383,421,2,10,0.0001,804,10
0.488,0.0001,432,472,2,10,0.0001,904,10
0.488,0.0001,482,522,2,10,0.0001,1004,10
0.488,0.0001,531,573,2,10,0.0001,1104,10
0.488,0.0001,581,623,2,10,0.0001,1204,10
0.488,0.0001,639,665,2,10,0.0001,1304,10
0.49,0.0001,689,715,2,10,0.0001,1404,10
0.49,0.0001,744,760,2,10,0.0001,1504,10
0.49,0.0001,793,811,2,10,0.0001,1604,10
0.49,0.0001,839,865,2,10,0.0001,1704,10
0.49,0.0001,892,912,2,10,0.0001,1804,10
0.49,0.0001,936,968,2,10,0.0001,1904,10
0.49,0.0001,996,1008,2,10,0.0001,2004,10
0.508,0.0001,57,47,2,10,0.0001,104,11
0.506,0.0001,101,103,2,10,0.0001,204,11
0.506,0.0001,156,148,2,10,0.0001,304,11
0.506,0.0001,209,195,2,10,0.0001,404,11
0.508,0.0001,260,244,2,10,0.0001,504,11
0.508,0.0001,313,291,2,10,0.0001,604,11
0.508,0.0001,355,349,2,10,0.0001,704,11
0.508,0.0001,405,399,2,10,0.0001,804,11
0.508,0.0001,455,449,2,10,0.0001,904,11
0.508,0.0001,511,493,2,10,0.0001,1004,11
0.508,0.0001,554,550,2,10,0.0001,1104,11
0.508,0.0001,606,598,2,10,0.0001,1204,11
0.508,0.0001,660,644,2,10,0.0001,1304,11
0.51,0.0001,707,697,2,10,0.0001,1404,11
0.51,0.0001,761,743,2,10,0.0001,1504,11
0.51,0.0001,807,797,2,10,0.0001,1604,11
0.508,0.0001,858,846,2,10,0.0001,1704,11
0.508,0.0001,903,901,2,10,0.0001,1804,11
0.506,0.0001,955,949,2,10,0.0001,1904,11
0.506,0.0001,1005,999,2,10,0.0001,2004,11
0.486,0.0001,57,47,2,10,0.0001,104,12
0.486,0.0001,105,99,2,10,0.0001,204,12
0.486,0.0001,150,154,2,10,0.0001,304,12
0.486,0.0001,196,208,2,10,0.0001,404,12
0.486,0.0001,241,263,2,10,0.0001,504,12
0.488,0.0001,287,317,2,10,0.0001,604,12
0.488,0.0001,333,371,2,10,0.0001,704,12
0.488,0.0001,381,423,2,10,0.0001,804,12
0.488,0.0001,427,477,2,10,0.0001,904,12
0.488,0.0001,480,524,2,10,0.0001,1004,12
0.49,0.0001,537,567,2,10,0.0001,1104,12
0.488,0.0001,589,615,2,10,0.0001,1204,12
0.488,0.0001,641,663,2,10,0.0001,1304,12
0.488,0.0001,690,714,2,10,0.0001,1404,12
0.488,0.0001,744,760,2,10,0.0001,1504,12
0.488,0.0001,791,813,2,10,0.0001,1604,12
0.488,0.0001,837,867,2,10,0.0001,1704,12
0.488,0.0001,880,924,2,10,0.0001,1804,12
0.486,0.0001,926,978,2,10,0.0001,1904,12
0.484,0.0001,978,1026,2,10,0.0001,2004,12
0.482,0.0001,51,53,2,10,0.0001,104,13
0.482,0.0001,95,109,2,10,0.0001,204,13
0.482,0.0001,140,164,2,10,0.0001,304,13
0.482,0.0001,186,218,2,10,0.0001,404,13
0.482,0.0001,234,270,2,10,0.0001,504,13
0.482,0.0001,287,317,2,10,0.0001,604,13
0.482,0.0001,332,372,2,10,0.0001,704,13
0.482,0.0001,378,426,2,10,0.0001,804,13
0.482,0.0001,434,470,2,10,0.0001,904,13
0.484,0.0001,490,514,2,10,0.0001,1004,13
0.486,0.0001,547,557,2,10,0.0001,1104,13
0.484,0.0001,601,603,2,10,0.0001,1204,13
0.484,0.0001,655,649,2,10,0.0001,1304,13
0.484,0.0001,704,700,2,10,0.0001,1404,13
0.484,0.0001,749,755,2,10,0.0001,1504,13
0.484,0.0001,794,810,2,10,0.0001,1604,13
0.484,0.0001,852,852,2,10,0.0001,1704,13
0.484,0.0001,900,904,2,10,0.0001,1804,13
0.486,0.0001,944,960,2,10,0.0001,1904,13
0.488,0.0001,993,1011,2,10,0.0001,2004,13
0.512,0.0001,46,58,2,10,0.0001,104,14
0.512,0.0001,95,109,2,10,0.0001,204,14
0.512,0.0001,142,162,2,10,0.0001,304,14
0.512,0.0001,193,211,2,10,0.0001,404,14
0.512,0.0001,250,254,2,10,0.0001,504,14
0.512,0.0001,294,310,2,10,0.0001,604,14
0.512,0.0001,350,354,2,10,0.0001,704,14
0.512,0.0001,406,398,2,10,0.0001,804,14
0.512,0.0001,453,451,2,10,0.0001,904,14
0.512,0.0001,505,499,2,10,0.0001,1004,14
0.512,0.0001,556,548,2,10,0.0001,1104,14
0.512,0.0001,601,603,2,10,0.0001,1204,14
0.512,0.0001,655,649,2,10,0.0001,1304,14
0.512,0.0001,709,695,2,10,0.0001,1404,14
0.512,0.0001,762,742,2,10,0.0001,1504,14
0.512,0.0001,809,795,2,10,0.0001,1604,14
0.512,0.0001,862,842,2,10,0.0001,1704,14
0.512,0.0001,917,887,2,10,0.0001,1804,14
0.512,0.0001,959,945,2,10,0.0001,1904,14
0.512,0.0001,1008,996,2,10,0.0001,2004,14
0.528,0.0001,51,53,2,10,0.0001,104,15
0.528,0.0001,104,100,2,10,0.0001,204,15
0.528,0.0001,146,158,2,10,0.0001,304,15
0.526,0.0001,204,200,2,10,0.0001,404,15
0.526,0.0001,259,245,2,10,0.0001,504,15
0.526,0.0001,304,300,2,10,0.0001,604,15
0.526,0.0001,355,349,2,10,0.0001,704,15
0.524,0.0001,408,396,2,10,0.0001,804,15
0.524,0.0001,458,446,2,10,0.0001,904,15
0.522,0.0001,509,495,2,10,0.0001,1004,15
0.522,0.0001,562,542,2,10,0.0001,1104,15
0.52,0.0001,616,588,2,10,0.0001,1204,15
0.52,0.0001,661,643,2,10,0.0001,1304,15
0.52,0.0001,710,694,2,10,0.0001,1404,15
0.514,0.0001,759,745,2,10,0.0001,1504,15
0.514,0.0001,802,802,2,10,0.0001,1604,15
0.516,0.0001,845,859,2,10,0.0001,1704,15
0.516,0.0001,897,907,2,10,0.0001,1804,15
0.516,0.0001,944,960,2,10,0.0001,1904,15
0.516,0.0001,1000,1004,2,10,0.0001,2004,15
0.504,0.0001,49,55,2,10,0.0001,104,16
0.504,0.0001,97,107,2,10,0.0001,204,16
0.506,0.0001,152,152,2,10,0.0001,304,16
0.504,0.0001,209,195,2,10,0.0001,404,16
0.502,0.0001,261,243,2,10,0.0001,504,16
0.502,0.0001,305,299,2,10,0.0001,604,16
0.502,0.0001,361,343,2,10,0.0001,704,16
0.504,0.0001,403,401,2,10,0.0001,804,16
0.504,0.0001,457,447,2,10,0.0001,904,16
0.502,0.0001,506,498,2,10,0.0001,1004,16
0.502,0.0001,550,554,2,10,0.0001,1104,16
0.502,0.0001,602,602,2,10,0.0001,1204,16
0.5,0.0001,645,659,2,10,0.0001,1304,16
0.5,0.0001,687,717,2,10,0.0001,1404,16
0.502,0.0001,743,761,2,10,0.0001,1504,16
0.502,0.0001,799,805,2,10,0.0001,1604,16
0.502,0.0001,850,854,2,10,0.0001,1704,16
0.502,0.0001,902,902,2,10,0.0001,1804,16
0.502,0.0001,953,951,2,10,0.0001,1904,16
0.5,0.0001,999,1005,2,10,0.0001,2004,16
0.54,0.0001,54,50,2,10,0.0001,104,17
0.54,0.0001,109,95,2,10,0.0001,204,17
0.54,0.0001,161,143,2,10,0.0001,304,17
0.54,0.0001,215,189,2,10,0.0001,404,17
0.54,0.0001,262,242,2,10,0.0001,504,17
0.54,0.0001,306,298,2,10,0.0001,604,17
0.54,0.0001,363,341,2,10,0.0001,704,17
0.54,0.0001,405,399,2,10,0.0001,804,17
0.54,0.0001,455,449,2,10,0.0001,904,17
0.54,0.0001,498,506,2,10,0.0001,1004,17
0.54,0.0001,540,564,2,10,0.0001,1104,17
0.538,0.0001,594,610,2,10,0.0001,1204,17
0.538,0.0001,644,660,2,10,0.0001,1304,17
0.538,0.0001,693,711,2,10,0.0001,1404,17
0.538,0.0001,750,754,2,10,0.0001,1504,17
0.538,0.0001,799,805,2,10,0.0001,1604,17
0.538,0.0001,859,845,2,10,0.0001,1704,17
0.538,0.0001,902,902,2,10,0.0001,1804,17
0.538,0.0001,959,945,2,10,0.0001,1904,17
0.536,0.0001,1006,998,2,10,0.0001,2004,17
0.498,0.0001,60,44,2,10,0.0001,104,18
0.496,0.0001,107,97,2,10,0.0001,204,18
0.496,0.0001,155,149,2,10,0.0001,304,18
0.496,0.0001,205,199,2,10,0.0001,404,18
0.494,0.0001,263,241,2,10,0.0001,504,18
0.494,0.0001,309,295,2,10,0.0001,604,18
0.494,0.0001,368,336,2,10,0.0001,704,18
0.494,0.0001,428,376,2,10,0.0001,804,18
0.494,0.0001,475,429,2,10,0.0001,904,18
0.494,0.0001,528,476,2,10,0.0001,1004,18
0.494,0.0001,576,528,2,10,0.0001,1104,18
0.498,0.0001,614,590,2,10,0.0001,1204,18
0.496,0.0001,665,639,2,10,0.0001,1304,18
0.496,0.0001,717,687,2,10,0.0001,1404,18
0.5,0.0001,767,737,2,10,0.0001,1504,18
0.5,0.0001,815,789,2,10,0.0001,1604,18
0.502,0.0001,866,838,2,10,0.0001,1704,18
0.502,0.0001,912,892,2,10,0.0001,1804,18
0.504,0.0001,960,944,2,10,0.0001,1904,18
0.506,0.0001,1002,1002,2,10,0.0001,2004,18
0.568,0.0001,48,56,2,10,0.0001,104,19
0.568,0.0001,92,112,2,10,0.0001,204,19
0.568,0.0001,141,163,2,10,0.0001,304,19
0.568,0.0001,196,208,2,10,0.0001,404,19
0.568,0.0001,254,250,2,10,0.0001,504,19
0.568,0.0001,305,299,2,10,0.0001,604,19
0.568,0.0001,349,355,2,10,0.0001,704,19
0.568,0.0001,394,410,2,10,0.0001,804,19
0.568,0.0001,443,461,2,10,0.0001,904,19
0.568,0.0001,494,510,2,10,0.0001,1004,19
0.566,0.0001,538,566,2,10,0.0001,1104,19
0.566,0.0001,588,616,2,10,0.0001,1204,19
0.566,0.0001,639,665,2,10,0.0001,1304,19
0.566,0.0001,689,715,2,10,0.0001,1404,19
0.566,0.0001,743,761,2,10,0.0001,1504,19
0.566,0.0001,793,811,2,10,0.0001,1604,19
0.566,0.0001,837,867,2,10,0.0001,1704,19
0.566,0.0001,882,922,2,10,0.0001,1804,19
0.572,0.0001,941,963,2,10,0.0001,1904,19
0.578,0.0001,980,1024,2,10,0.0001,2004,19
0.458,0.0001,51,53,2,10,0.0001,104,20
0.458,0.0001,92,112,2,10,0.0001,204,20
0.458,0.0001,142,162,2,10,0.0001,304,20
0.458,0.0001,191,213,2,10,0.0001,404,20
0.458,0.0001,244,260,2,10,0.0001,504,20
0.458,0.0001,292,312,2,10,0.0001,604,20
0.458,0.0001,343,361,2,10,0.0001,704,20
0.456,0.0001,396,408,2,10,0.0001,804,20
0.456,0.0001,441,463,2,10,0.0001,904,20
0.456,0.0001,496,508,2,10,0.0001,1004,20
0.454,0.0001,544,560,2,10,0.0001,1104,20
0.45,0.0001,591,613,2,10,0.0001,1204,20
0.448,0.0001,629,675,2,10,0.0001,1304,20
0.448,0.0001,683,721,2,10,0.0001,1404,20
0.448,0.0001,723,781,2,10,0.0001,1504,20
0.448,0.0001,777,827,2,10,0.0001,1604,20
0.448,0.0001,829,875,2,10,0.0001,1704,20
0.446,0.0001,877,927,2,10,0.0001,1804,20
0.446,0.0001,926,978,2,10,0.0001,1904,20
0.446,0.0001,986,1018,2,10,0.0001,2004,20
0.508,0.0001,48,56,2,10,0.001,104,1
0.508,0.0001,100,104,2,10,0.001,204,1
0.508,0.0001,149,155,2,10,0.001,304,1
0.508,0.0001,213,191,2,10,0.001,404,1
0.508,0.0001,270,234,2,10,0.001,504,1
0.508,0.0001,318,286,2,10,0.001,604,1
0.508,0.0001,365,339,2,10,0.001,704,1
0.508,0.0001,419,385,2,10,0.001,804,1
0.508,0.0001,463,441,2,10,0.001,904,1
0.508,0.0001,511,493,2,10,0.001,1004,1
0.51,0.0001,554,550,2,10,0.001,1104,1
0.512,0.0001,605,599,2,10,0.001,1204,1
0.516,0.0001,652,652,2,10,0.001,1304,1
0.52,0.0001,699,705,2,10,0.001,1404,1
0.528,0.0001,746,758,2,10,0.001,1504,1
0.54,0.0001,789,815,2,10,0.001,1604,1
0.556,0.0001,844,860,2,10,0.001,1704,1
0.574,0.0001,896,908,2,10,0.001,1804,1
0.586,0.0001,944,960,2,10,0.001,1904,1
0.61,0.0001,1003,1001,2,10,0.001,2004,1
0.476,0.0001,56,48,2,10,0.001,104,2
0.476,0.0001,101,103,2,10,0.001,204,2
0.476,0.0001,151,153,2,10,0.001,304,2
0.476,0.0001,202,202,2,10,0.001,404,2
0.476,0.0001,249,255,2,10,0.001,504,2
0.476,0.0001,311,293,2,10,0.001,604,2
0.476,0.0001,372,332,2,10,0.001,704,2
0.476,0.0001,424,380,2,10,0.001,804,2
0.476,0.0001,475,429,2,10,0.001,904,2
0.476,0.0001,521,483,2,10,0.001,1004,2
0.476,0.0001,571,533,2,10,0.001,1104,2
0.476,0.0001,619,585,2,10,0.001,1204,2
0.476,0.0001,669,635,2,10,0.001,1304,2
0.476,0.0001,719,685,2,10,0.001,1404,2
0.476,0.0001,765,739,2,10,0.001,1504,2
0.476,0.0001,808,796,2,10,0.001,1604,2
0.476,0.0001,853,851,2,10,0.001,1704,2
0.476,0.0001,906,898,2,10,0.001,1804,2
0.476,0.0001,956,948,2,10,0.001,1904,2
0.476,0.0001,1014,990,2,10,0.001,2004,2
0.52,0.0001,57,47,2,10,0.001,104,3
0.528,0.0001,114,90,2,10,0.001,204,3
0.532,0.0001,160,144,2,10,0.001,304,3
0.546,0.0001,215,189,2,10,0.001,404,3
0.546,0.0001,271,233,2,10,0.001,504,3
0.562,0.0001,324,280,2,10,0.001,604,3
0.57,0.0001,378,326,2,10,0.001,704,3
0.582,0.0001,426,378,2,10,0.001,804,3
0.586,0.0001,477,427,2,10,0.001,904,3
0.59,0.0001,518,486,2,10,0.001,1004,3
0.598,0.0001,568,536,2,10,0.001,1104,3
0.592,0.0001,623,581,2,10,0.001,1204,3
0.6,0.0001,662,642,2,10,0.001,1304,3
0.612,0.0001,710,694,2,10,0.001,1404,3
0.61,0.0001,754,750,2,10,0.001,1504,3
0.614,0.0001,803,801,2,10,0.001,1604,3
0.61,0.0001,854,850,2,10,0.001,1704,3
0.612,0.0001,896,908,2,10,0.001,1804,3
0.624,0.0001,950,954,2,10,0.001,1904,3
0.632,0.0001,1003,1001,2,10,0.001,2004,3
0.488,0.0001,53,51,2,10,0.001,104,4
0.488,0.0001,106,98,2,10,0.001,204,4
0.488,0.0001,152,152,2,10,0.001,304,4
0.488,0.0001,205,199,2,10,0.001,404,4
0.488,0.0001,266,238,2,10,0.001,504,4
0.488,0.0001,317,287,2,10,0.001,604,4
0.488,0.0001,361,343,2,10,0.001,704,4
0.488,0.0001,408,396,2,10,0.001,804,4
0.488,0.0001,452,452,2,10,0.001,904,4
0.488,0.0001,496,508,2,10,0.001,1004,4
0.488,0.0001,552,552,2,10,0.001,1104,4
0.488,0.0001,601,603,2,10,0.001,1204,4
0.488,0.0001,656,648,2,10,0.001,1304,4
0.488,0.0001,706,698,2,10,0.001,1404,4
0.49,0.0001,766,738,2,10,0.001,1504,4
0.482,0.0001,819,785,2,10,0.001,1604,4
0.48,0.0001,866,838,2,10,0.001,1704,4
0.476,0.0001,915,889,2,10,0.001,1804,4
0.46,0.0001,960,944,2,10,0.001,1904,4
0.442,0.0001,1008,996,2,10,0.001,2004,4
0.348,0.0001,54,50,2,10,0.001,104,5
0.346,0.0001,106,98,2,10,0.001,204,5
0.344,0.0001,151,153,2,10,0.001,304,5
0.338,0.0001,203,201,2,10,0.001,404,5
0.336,0.0001,255,249,2,10,0.001,504,5
0.334,0.0001,306,298,2,10,0.001,604,5
0.338,0.0001,357,347,2,10,0.001,704,5
0.362,0.0001,406,398,2,10,0.001,804,5
0.38,0.0001,454,450,2,10,0.001,904,5
0.396,0.0001,503,501,2,10,0.001,1004,5
0.39,0.0001,545,559,2,10,0.001,1104,5
0.402,0.0001,592,612,2,10,0.001,1204,5
0.408,0.0001,646,658,2,10,0.001,1304,5
0.424,0.0001,701,703,2,10,0.001,1404,5
0.418,0.0001,751,753,2,10,0.001,1504,5
0.446,0.0001,799,805,2,10,0.001,1604,5
0.5,0.0001,845,859,2,10,0.001,1704,5
0.544,0.0001,886,918,2,10,0.001,1804,5
0.588,0.0001,935,969,2,10,0.001,1904,5
0.592,0.0001,983,1021,2,10,0.001,2004,5
0.498,0.0001,46,58,2,10,0.001,104,6
0.498,0.0001,104,100,2,10,0.001,204,6
0.498,0.0001,149,155,2,10,0.001,304,6
0.498,0.0001,199,205,2,10,0.001,404,6
0.498,0.0001,247,257,2,10,0.001,504,6
0.498,0.0001,299,305,2,10,0.001,604,6
0.498,0.0001,349,355,2,10,0.001,704,6
0.498,0.0001,400,404,2,10,0.001,804,6
0.498,0.0001,448,456,2,10,0.001,904,6
0.498,0.0001,497,507,2,10,0.001,1004,6
0.498,0.0001,541,563,2,10,0.001,1104,6
0.498,0.0001,595,609,2,10,0.001,1204,6
0.498,0.0001,647,657,2,10,0.001,1304,6
0.498,0.0001,698,706,2,10,0.001,1404,6
0.498,0.0001,749,755,2,10,0.001,1504,6
0.498,0.0001,795,809,2,10,0.001,1604,6
0.498,0.0001,845,859,2,10,0.001,1704,6
0.498,0.0001,895,909,2,10,0.001,1804,6
0.496,0.0001,951,953,2,10,0.001,1904,6
0.49,0.0001,1003,1001,2,10,0.001,2004,6
0.546,0.0001,49,55,2,10,0.001,104,7
0.546,0.0001,105,99,2,10,0.001,204,7
0.544,0.0001,162,142,2,10,0.001,304,7
0.544,0.0001,214,190,2,10,0.001,404,7
0.546,0.0001,261,243,2,10,0.001,504,7
0.544,0.0001,310,294,2,10,0.001,604,7
0.546,0.0001,360,344,2,10,0.001,704,7
0.548,0.0001,410,394,2,10,0.001,804,7
0.548,0.0001,453,451,2,10,0.001,904,7
0.54,0.0001,496,508,2,10,0.001,1004,7
0.536,0.0001,540,564,2,10,0.001,1104,7
0.528,0.0001,590,614,2,10,0.001,1204,7
0.538,0.0001,638,666,2,10,0.001,1304,7
0.534,0.0001,695,709,2,10,0.001,1404,7
0.548,0.0001,736,768,2,10,0.001,1504,7
0.522,0.0001,790,814,2,10,0.001,1604,7
0.522,0.0001,835,869,2,10,0.001,1704,7
0.516,0.0001,892,912,2,10,0.001,1804,7
0.526,0.0001,936,968,2,10,0.001,1904,7
0.538,0.0001,990,1014,2,10,0.001,2004,7
0.472,0.0001,53,51,2,10,0.001,104,8
0.472,0.0001,110,94,2,10,0.001,204,8
0.472,0.0001,160,144,2,10,0.001,304,8
0.472,0.0001,208,196,2,10,0.001,404,8
0.472,0.0001,257,247,2,10,0.001,504,8
0.472,0.0001,307,297,2,10,0.001,604,8
0.472,0.0001,366,338,2,10,0.001,704,8
0.472,0.0001,419,385,2,10,0.001,804,8
0.47,0.0001,475,429,2,10,0.001,904,8
0.468,0.0001,524,480,2,10,0.001,1004,8
0.488,0.0001,571,533,2,10,0.001,1104,8
0.516,0.0001,619,585,2,10,0.001,1204,8
0.544,0.0001,672,632,2,10,0.001,1304,8
0.57,0.0001,713,691,2,10,0.001,1404,8
0.594,0.0001,757,747,2,10,0.001,1504,8
0.616,0.0001,805,799,2,10,0.001,1604,8
0.63,0.0001,861,843,2,10,0.001,1704,8
0.644,0.0001,915,889,2,10,0.001,1804,8
0.646,0.0001,966,938,2,10,0.001,1904,8
0.66,0.0001,1016,988,2,10,0.001,2004,8
0.53,0.0001,55,49,2,10,0.001,104,9
0.532,0.0001,96,108,2,10,0.001,204,9
0.534,0.0001,141,163,2,10,0.001,304,9
0.534,0.0001,204,200,2,10,0.001,404,9
0.538,0.0001,254,250,2,10,0.001,504,9
0.536,0.0001,309,295,2,10,0.001,604,9
0.546,0.0001,368,336,2,10,0.001,704,9
0.55,0.0001,420,384,2,10,0.001,804,9
0.552,0.0001,478,426,2,10,0.001,904,9
0.554,0.0001,523,481,2,10,0.001,1004,9
0.564,0.0001,574,530,2,10,0.001,1104,9
0.57,0.0001,625,579,2,10,0.001,1204,9
0.58,0.0001,680,624,2,10,0.001,1304,9
0.59,0.0001,731,673,2,10,0.001,1404,9
0.604,0.0001,778,726,2,10,0.001,1504,9
0.62,0.0001,830,774,2,10,0.001,1604,9
0.632,0.0001,875,829,2,10,0.001,1704,9
0.634,0.0001,918,886,2,10,0.001,1804,9
0.638,0.0001,967,937,2,10,0.001,1904,9
0.654,0.0001,1016,988,2,10,0.001,2004,9
0.512,0.0001,54,50,2,10,0.001,104,10
0.512,0.0001,101,103,2,10,0.001,204,10
0.512,0.0001,148,156,2,10,0.001,304,10
0.512,0.0001,198,206,2,10,0.001,404,10
0.512,0.0001,245,259,2,10,0.001,504,10
0.512,0.0001,286,318,2,10,0.001,604,10
0.512,0.0001,337,367,2,10,0.001,704,10
0.512,0.0001,392,412,2,10,0.001,804,10
0.512,0.0001,441,463,2,10,0.001,904,10
0.512,0.0001,486,518,2,10,0.001,1004,10
0.512,0.0001,534,570,2,10,0.001,1104,10
0.512,0.0001,586,618,2,10,0.001,1204,10
0.512,0.0001,643,661,2,10,0.001,1304,10
0.514,0.0001,691,713,2,10,0.001,1404,10
0.522,0.0001,734,770,2,10,0.001,1504,10
0.526,0.0001,792,812,2,10,0.001,1604,10
0.542,0.0001,842,862,2,10,0.001,1704,10
0.552,0.0001,894,910,2,10,0.001,1804,10
0.556,0.0001,944,960,2,10,0.001,1904,10
0.554,0.0001,996,1008,2,10,0.001,2004,10
0.532,0.0001,56,48,2,10,0.001,104,11
0.532,0.0001,103,101,2,10,0.001,204,11
0.532,0.0001,149,155,2,10,0.001,304,11
0.534,0.0001,203,201,2,10,0.001,404,11
0.534,0.0001,251,253,2,10,0.001,504,11
0.542,0.0001,301,303,2,10,0.001,604,11
0.544,0.0001,359,345,2,10,0.001,704,11
0.552,0.0001,403,401,2,10,0.001,804,11
0.572,0.0001,456,448,2,10,0.001,904,11
0.576,0.0001,504,500,2,10,0.001,1004,11
0.58,0.0001,552,552,2,10,0.001,1104,11
0.584,0.0001,606,598,2,10,0.001,1204,11
0.588,0.0001,656,648,2,10,0.001,1304,11
0.59,0.0001,705,699,2,10,0.001,1404,11
0.594,0.0001,756,748,2,10,0.001,1504,11
0.6,0.0001,811,793,2,10,0.001,1604,11
0.602,0.0001,859,845,2,10,0.001,1704,11
0.606,0.0001,908,896,2,10,0.001,1804,11
0.61,0.0001,966,938,2,10,0.001,1904,11
0.614,0.0001,1011,993,2,10,0.001,2004,11
0.49,0.0001,57,47,2,10,0.001,104,12
0.49,0.0001,101,103,2,10,0.001,204,12
0.49,0.0001,146,158,2,10,0.001,304,12
0.484,0.0001,194,210,2,10,0.001,404,12
0.48,0.0001,242,262,2,10,0.001,504,12
0.478,0.0001,305,299,2,10,0.001,604,12
0.474,0.0001,358,346,2,10,0.001,704,12
0.47,0.0001,411,393,2,10,0.001,804,12
0.47,0.0001,468,436,2,10,0.001,904,12
0.47,0.0001,520,484,2,10,0.001,1004,12
0.474,0.0001,566,538,2,10,0.001,1104,12
0.476,0.0001,610,594,2,10,0.001,1204,12
0.474,0.0001,661,643,2,10,0.001,1304,12
0.484,0.0001,708,696,2,10,0.001,1404,12
0.492,0.0001,758,746,2,10,0.001,1504,12
0.498,0.0001,814,790,2,10,0.001,1604,12
0.496,0.0001,858,846,2,10,0.001,1704,12
0.506,0.0001,904,900,2,10,0.001,1804,12
0.504,0.0001,955,949,2,10,0.001,1904,12
0.504,0.0001,1002,1002,2,10,0.001,2004,12
0.504,0.0001,49,55,2,10,0.001,104,13
0.504,0.0001,102,102,2,10,0.001,204,13
0.504,0.0001,156,148,2,10,0.001,304,13
0.504,0.0001,211,193,2,10,0.001,404,13
0.504,0.0001,266,238,2,10,0.001,504,13
0.504,0.0001,308,296,2,10,0.001,604,13
0.504,0.0001,351,353,2,10,0.001,704,13
0.504,0.0001,403,401,2,10,0.001,804,13
0.504,0.0001,453,451,2,10,0.001,904,13
0.504,0.0001,492,512,2,10,0.001,1004,13
0.504,0.0001,538,566,2,10,0.001,1104,13
0.504,0.0001,584,620,2,10,0.001,1204,13
0.504,0.0001,636,668,2,10,0.001,1304,13
0.504,0.0001,690,714,2,10,0.001,1404,13
0.504,0.0001,742,762,2,10,0.001,1504,13
0.504,0.0001,792,812,2,10,0.001,1604,13
0.504,0.0001,843,861,2,10,0.001,1704,13
0.504,0.0001,894,910,2,10,0.001,1804,13
0.504,0.0001,945,959,2,10,0.001,1904,13
0.504,0.0001,1004,1000,2,10,0.001,2004,13
0.64,0.0001,50,54,2,10,0.001,104,14
0.64,0.0001,100,104,2,10,0.001,204,14
0.638,0.0001,147,157,2,10,0.001,304,14
0.636,0.0001,188,216,2,10,0.001,404,14
0.63,0.0001,237,267,2,10,0.001,504,14
0.63,0.0001,291,313,2,10,0.001,604,14
0.63,0.0001,337,367,2,10,0.001,704,14
0.632,0.0001,395,409,2,10,0.001,804,14
0.634,0.0001,455,449,2,10,0.001,904,14
0.642,0.0001,509,495,2,10,0.001,1004,14
0.652,0.0001,567,537,2,10,0.001,1104,14
0.664,0.0001,619,585,2,10,0.001,1204,14
0.666,0.0001,664,640,2,10,0.001,1304,14
0.678,0.0001,720,684,2,10,0.001,1404,14
0.688,0.0001,770,734,2,10,0.001,1504,14
0.696,0.0001,823,781,2,10,0.001,1604,14
0.702,0.0001,871,833,2,10,0.001,1704,14
0.708,0.0001,916,888,2,10,0.001,1804,14
0.708,0.0001,960,944,2,10,0.001,1904,14
0.718,0.0001,995,1009,2,10,0.001,2004,14
0.468,0.0001,55,49,2,10,0.001,104,15
0.468,0.0001,101,103,2,10,0.001,204,15
0.468,0.0001,155,149,2,10,0.001,304,15
0.468,0.0001,203,201,2,10,0.001,404,15
0.468,0.0001,245,259,2,10,0.001,504,15
0.468,0.0001,288,316,2,10,0.001,604,15
0.468,0.0001,346,358,2,10,0.001,704,15
0.472,0.0001,402,402,2,10,0.001,804,15
0.474,0.0001,458,446,2,10,0.001,904,15
0.474,0.0001,498,506,2,10,0.001,1004,15
0.476,0.0001,552,552,2,10,0.001,1104,15
0.48,0.0001,607,597,2,10,0.001,1204,15
0.486,0.0001,659,645,2,10,0.001,1304,15
0.49,0.0001,709,695,2,10,0.001,1404,15
0.504,0.0001,759,745,2,10,0.001,1504,15
0.51,0.0001,801,803,2,10,0.001,1604,15
0.516,0.0001,846,858,2,10,0.001,1704,15
0.52,0.0001,891,913,2,10,0.001,1804,15
0.524,0.0001,941,963,2,10,0.001,1904,15
0.53,0.0001,986,1018,2,10,0.001,2004,15
0.506,0.0001,44,60,2,10,0.001,104,16
0.506,0.0001,100,104,2,10,0.001,204,16
0.506,0.0001,158,146,2,10,0.001,304,16
0.506,0.0001,208,196,2,10,0.001,404,16
0.506,0.0001,252,252,2,10,0.001,504,16
0.506,0.0001,291,313,2,10,0.001,604,16
0.506,0.0001,338,366,2,10,0.001,704,16
0.506,0.0001,389,415,2,10,0.001,804,16
0.506,0.0001,448,456,2,10,0.001,904,16
0.506,0.0001,499,505,2,10,0.001,1004,16
0.506,0.0001,553,551,2,10,0.001,1104,16
0.506,0.0001,604,600,2,10,0.001,1204,16
0.506,0.0001,652,652,2,10,0.001,1304,16
0.506,0.0001,702,702,2,10,0.001,1404,16
0.506,0.0001,748,756,2,10,0.001,1504,16
0.506,0.0001,794,810,2,10,0.001,1604,16
0.506,0.0001,848,856,2,10,0.001,1704,16
0.506,0.0001,907,897,2,10,0.001,1804,16
0.508,0.0001,958,946,2,10,0.001,1904,16
0.51,0.0001,1005,999,2,10,0.001,2004,16
0.44,0.0001,62,42,2,10,0.001,104,17
0.442,0.0001,116,88,2,10,0.001,204,17
0.446,0.0001,162,142,2,10,0.001,304,17
0.45,0.0001,218,186,2,10,0.001,404,17
0.45,0.0001,261,243,2,10,0.001,504,17
0.448,0.0001,305,299,2,10,0.001,604,17
0.446,0.0001,367,337,2,10,0.001,704,17
0.438,0.0001,411,393,2,10,0.001,804,17
0.432,0.0001,451,453,2,10,0.001,904,17
0.426,0.0001,497,507,2,10,0.001,1004,17
0.42,0.0001,542,562,2,10,0.001,1104,17
0.414,0.0001,588,616,2,10,0.001,1204,17
0.408,0.0001,630,674,2,10,0.001,1304,17
0.404,0.0001,683,721,2,10,0.001,1404,17
0.402,0.0001,738,766,2,10,0.001,1504,17
0.398,0.0001,797,807,2,10,0.001,1604,17
0.392,0.0001,844,860,2,10,0.001,1704,17
0.388,0.0001,890,914,2,10,0.001,1804,17
0.376,0.0001,953,951,2,10,0.001,1904,17
0.376,0.0001,1005,999,2,10,0.001,2004,17
0.484,0.0001,52,52,2,10,0.001,104,18
0.484,0.0001,104,100,2,10,0.001,204,18
0.484,0.0001,140,164,2,10,0.001,304,18
0.484,0.0001,192,212,2,10,0.001,404,18
0.484,0.0001,246,258,2,10,0.001,504,18
0.484,0.0001,303,301,2,10,0.001,604,18
0.482,0.0001,351,353,2,10,0.001,704,18
0.482,0.0001,397,407,2,10,0.001,804,18
0.488,0.0001,443,461,2,10,0.001,904,18
0.494,0.0001,497,507,2,10,0.001,1004,18
0.498,0.0001,547,557,2,10,0.001,1104,18
0.504,0.0001,597,607,2,10,0.001,1204,18
0.506,0.0001,637,667,2,10,0.001,1304,18
0.508,0.0001,698,706,2,10,0.001,1404,18
0.516,0.0001,752,752,2,10,0.001,1504,18
0.516,0.0001,805,799,2,10,0.001,1604,18
0.524,0.0001,854,850,2,10,0.001,1704,18
0.522,0.0001,905,899,2,10,0.001,1804,18
0.518,0.0001,950,954,2,10,0.001,1904,18
0.516,0.0001,994,1010,2,10,0.001,2004,18
0.508,0.0001,40,64,2,10,0.001,104,19
0.506,0.0001,91,113,2,10,0.001,204,19
0.506,0.0001,151,153,2,10,0.001,304,19
0.506,0.0001,199,205,2,10,0.001,404,19
0.506,0.0001,256,248,2,10,0.001,504,19
0.508,0.0001,303,301,2,10,0.001,604,19
0.51,0.0001,353,351,2,10,0.001,704,19
0.512,0.0001,404,400,2,10,0.001,804,19
0.512,0.0001,452,452,2,10,0.001,904,19
0.512,0.0001,503,501,2,10,0.001,1004,19
0.514,0.0001,544,560,2,10,0.001,1104,19
0.512,0.0001,591,613,2,10,0.001,1204,19
0.504,0.0001,640,664,2,10,0.001,1304,19
0.504,0.0001,698,706,2,10,0.001,1404,19
0.506,0.0001,753,751,2,10,0.001,1504,19
0.508,0.0001,809,795,2,10,0.001,1604,19
0.51,0.0001,860,844,2,10,0.001,1704,19
0.514,0.0001,911,893,2,10,0.001,1804,19
0.518,0.0001,957,947,2,10,0.001,1904,19
0.52,0.0001,998,1006,2,10,0.001,2004,19
0.496,0.0001,52,52,2,10,0.001,104,20
0.496,0.0001,111,93,2,10,0.001,204,20
0.496,0.0001,160,144,2,10,0.001,304,20
0.496,0.0001,201,203,2,10,0.001,404,20
0.496,0.0001,244,260,2,10,0.001,504,20
0.496,0.0001,298,306,2,10,0.001,604,20
0.496,0.0001,361,343,2,10,0.001,704,20
0.496,0.0001,412,392,2,10,0.001,804,20
0.496,0.0001,455,449,2,10,0.001,904,20
0.496,0.0001,496,508,2,10,0.001,1004,20
0.496,0.0001,547,557,2,10,0.001,1104,20
0.496,0.0001,595,609,2,10,0.001,1204,20
0.496,0.0001,647,657,2,10,0.001,1304,20
0.496,0.0001,696,708,2,10,0.001,1404,20
0.496,0.0001,748,756,2,10,0.001,1504,20
0.496,0.0001,805,799,2,10,0.001,1604,20
0.496,0.0001,851,853,2,10,0.001,1704,20
0.496,0.0001,900,904,2,10,0.001,1804,20
0.498,0.0001,958,946,2,10,0.001,1904,20
0.5,0.0001,1004,1000,2,10,0.001,2004,20
0.46,0.0001,58,46,2,10,0.01,104,1
0.474,0.0001,108,96,2,10,0.01,204,1
0.49,0.0001,161,143,2,10,0.01,304,1
0.524,0.0001,208,196,2,10,0.01,404,1
0.57,0.0001,250,254,2,10,0.01,504,1
0.596,0.0001,302,302,2,10,0.01,604,1
0.618,0.0001,355,349,2,10,0.01,704,1
0.638,0.0001,407,397,2,10,0.01,804,1
0.662,0.0001,459,445,2,10,0.01,904,1
0.694,0.0001,507,497,2,10,0.01,1004,1
0.734,0.0001,544,560,2,10,0.01,1104,1
0.754,0.0001,596,608,2,10,0.01,1204,1
0.774,0.0001,650,654,2,10,0.01,1304,1
0.804,0.0001,699,705,2,10,0.01,1404,1
0.802,0.0001,747,757,2,10,0.01,1504,1
0.824,0.0001,791,813,2,10,0.01,1604,1
0.838,0.0001,845,859,2,10,0.01,1704,1
0.842,0.0001,896,908,2,10,0.01,1804,1
0.846,0.0001,945,959,2,10,0.01,1904,1
0.846,0.0001,997,1007,2,10,0.01,2004,1
0.496,0.0001,46,58,2,10,0.01,104,2
0.496,0.0001,102,102,2,10,0.01,204,2
0.496,0.0001,154,150,2,10,0.01,304,2
0.496,0.0001,202,202,2,10,0.01,404,2
0.496,0.0001,251,253,2,10,0.01,504,2
0.496,0.0001,307,297,2,10,0.01,604,2
0.498,0.0001,355,349,2,10,0.01,704,2
0.532,0.0001,390,414,2,10,0.01,804,2
0.588,0.0001,438,466,2,10,0.01,904,2
0.714,0.0001,496,508,2,10,0.01,1004,2
0.784,0.0001,552,552,2,10,0.01,1104,2
0.832,0.0001,610,594,2,10,0.01,1204,2
0.83,0.0001,664,640,2,10,0.01,1304,2
0.882,0.0001,708,696,2,10,0.01,1404,2
0.894,0.0001,760,744,2,10,0.01,1504,2
0.894,0.0001,808,796,2,10,0.01,1604,2
0.896,0.0001,846,858,2,10,0.01,1704,2
0.898,0.0001,907,897,2,10,0.01,1804,2
0.904,0.0001,950,954,2,10,0.01,1904,2
0.912,0.0001,1000,1004,2,10,0.01,2004,2
0.472,0.0001,40,64,2,10,0.01,104,3
0.5,0.0001,90,114,2,10,0.01,204,3
0.534,0.0001,139,165,2,10,0.01,304,3
0.534,0.0001,183,221,2,10,0.01,404,3
0.53,0.0001,238,266,2,10,0.01,504,3
0.594,0.0001,292,312,2,10,0.01,604,3
0.588,0.0001,347,357,2,10,0.01,704,3
0.514,0.0001,397,407,2,10,0.01,804,3
0.516,0.0001,442,462,2,10,0.01,904,3
0.566,0.0001,496,508,2,10,0.01,1004,3
0.626,0.0001,550,554,2,10,0.01,1104,3
0.718,0.0001,607,597,2,10,0.01,1204,3
0.828,0.0001,656,648,2,10,0.01,1304,3
0.856,0.0001,716,688,2,10,0.01,1404,3
0.866,0.0001,759,745,2,10,0.01,1504,3
0.876,0.0001,814,790,2,10,0.01,1604,3
0.888,0.0001,860,844,2,10,0.01,1704,3
0.892,0.0001,905,899,2,10,0.01,1804,3
0.902,0.0001,965,939,2,10,0.01,1904,3
0.91,0.0001,1010,994,2,10,0.01,2004,3
0.418,0.0001,39,65,2,10,0.01,104,4
0.464,0.0001,94,110,2,10,0.01,204,4
0.468,0.0001,147,157,2,10,0.01,304,4
0.478,0.0001,193,211,2,10,0.01,404,4
0.472,0.0001,247,257,2,10,0.01,504,4
0.478,0.0001,297,307,2,10,0.01,604,4
0.536,0.0001,349,355,2,10,0.01,704,4
0.626,0.0001,401,403,2,10,0.01,804,4
0.67,0.0001,446,458,2,10,0.01,904,4
0.762,0.0001,498,506,2,10,0.01,1004,4
0.78,0.0001,550,554,2,10,0.01,1104,4
0.802,0.0001,604,600,2,10,0.01,1204,4
0.798,0.0001,647,657,2,10,0.01,1304,4
0.796,0.0001,685,719,2,10,0.01,1404,4
0.808,0.0001,732,772,2,10,0.01,1504,4
0.83,0.0001,779,825,2,10,0.01,1604,4
0.858,0.0001,826,878,2,10,0.01,1704,4
0.854,0.0001,879,925,2,10,0.01,1804,4
0.868,0.0001,931,973,2,10,0.01,1904,4
0.876,0.0001,990,1014,2,10,0.01,2004,4
0.496,0.0001,54,50,2,10,0.01,104,5
0.496,0.0001,97,107,2,10,0.01,204,5
0.496,0.0001,149,155,2,10,0.01,304,5
0.498,0.0001,194,210,2,10,0.01,404,5
0.506,0.0001,242,262,2,10,0.01,504,5
0.532,0.0001,292,312,2,10,0.01,604,5
0.574,0.0001,348,356,2,10,0.01,704,5
0.554,0.0001,398,406,2,10,0.01,804,5
0.546,0.0001,455,449,2,10,0.01,904,5
0.508,0.0001,514,490,2,10,0.01,1004,5
0.526,0.0001,565,539,2,10,0.01,1104,5
0.488,0.0001,610,594,2,10,0.01,1204,5
0.49,0.0001,657,647,2,10,0.01,1304,5
0.538,0.0001,713,691,2,10,0.01,1404,5
0.56,0.0001,758,746,2,10,0.01,1504,5
0.584,0.0001,803,801,2,10,0.01,1604,5
0.618,0.0001,850,854,2,10,0.01,1704,5
0.628,0.0001,896,908,2,10,0.01,1804,5
0.614,0.0001,947,957,2,10,0.01,1904,5
0.646,0.0001,1000,1004,2,10,0.01,2004,5
0.432,0.0001,50,54,2,10,0.01,104,6
0.442,0.0001,108,96,2,10,0.01,204,6
0.44,0.0001,153,151,2,10,0.01,304,6
0.466,0.0001,209,195,2,10,0.01,404,6
0.5,0.0001,256,248,2,10,0.01,504,6
0.536,0.0001,303,301,2,10,0.01,604,6
0.528,0.0001,349,355,2,10,0.01,704,6
0.558,0.0001,396,408,2,10,0.01,804,6
0.566,0.0001,434,470,2,10,0.01,904,6
0.588,0.0001,488,516,2,10,0.01,1004,6
0.604,0.0001,535,569,2,10,0.01,1104,6
0.622,0.0001,583,621,2,10,0.01,1204,6
0.644,0.0001,638,666,2,10,0.01,1304,6
0.678,0.0001,692,712,2,10,0.01,1404,6
0.706,0.0001,740,764,2,10,0.01,1504,6
0.708,0.0001,789,815,2,10,0.01,1604,6
0.732,0.0001,841,863,2,10,0.01,1704,6
0.758,0.0001,895,909,2,10,0.01,1804,6
0.774,0.0001,939,965,2,10,0.01,1904,6
0.8,0.0001,989,1015,2,10,0.01,2004,6
0.462,0.0001,52,52,2,10,0.01,104,7
0.5,0.0001,104,100,2,10,0.01,204,7
0.564,0.0001,150,154,2,10,0.01,304,7
0.62,0.0001,205,199,2,10,0.01,404,7
0.648,0.0001,259,245,2,10,0.01,504,7
0.66,0.0001,317,287,2,10,0.01,604,7
0.64,0.0001,368,336,2,10,0.01,704,7
0.63,0.0001,427,377,2,10,0.01,804,7
0.664,0.0001,467,437,2,10,0.01,904,7
0.682,0.0001,510,494,2,10,0.01,1004,7
0.718,0.0001,558,546,2,10,0.01,1104,7
0.742,0.0001,612,592,2,10,0.01,1204,7
0.766,0.0001,663,641,2,10,0.01,1304,7
0.778,0.0001,711,693,2,10,0.01,1404,7
0.786,0.0001,766,738,2,10,0.01,1504,7
0.832,0.0001,821,783,2,10,0.01,1604,7
0.836,0.0001,866,838,2,10,0.01,1704,7
0.862,0.0001,916,888,2,10,0.01,1804,7
0.874,0.0001,967,937,2,10,0.01,1904,7
0.878,0.0001,1012,992,2,10,0.01,2004,7
0.428,0.0001,53,51,2,10,0.01,104,8
0.432,0.0001,107,97,2,10,0.01,204,8
0.438,0.0001,168,136,2,10,0.01,304,8
0.444,0.0001,213,191,2,10,0.01,404,8
0.458,0.0001,271,233,2,10,0.01,504,8
0.486,0.0001,322,282,2,10,0.01,604,8
0.492,0.0001,375,329,2,10,0.01,704,8
0.508,0.0001,421,383,2,10,0.01,804,8
0.51,0.0001,472,432,2,10,0.01,904,8
0.598,0.0001,510,494,2,10,0.01,1004,8
0.604,0.0001,553,551,2,10,0.01,1104,8
0.65,0.0001,609,595,2,10,0.01,1204,8
0.68,0.0001,646,658,2,10,0.01,1304,8
0.706,0.0001,693,711,2,10,0.01,1404,8
0.768,0.0001,745,759,2,10,0.01,1504,8
0.804,0.0001,793,811,2,10,0.01,1604,8
0.818,0.0001,845,859,2,10,0.01,1704,8
0.836,0.0001,901,903,2,10,0.01,1804,8
0.852,0.0001,953,951,2,10,0.01,1904,8
0.864,0.0001,1007,997,2,10,0.01,2004,8
0.528,0.0001,54,50,2,10,0.01,104,9
0.532,0.0001,107,97,2,10,0.01,204,9
0.542,0.0001,151,153,2,10,0.01,304,9
0.546,0.0001,198,206,2,10,0.01,404,9
0.538,0.0001,245,259,2,10,0.01,504,9
0.518,0.0001,293,311,2,10,0.01,604,9
0.536,0.0001,342,362,2,10,0.01,704,9
0.554,0.0001,395,409,2,10,0.01,804,9
0.572,0.0001,445,459,2,10,0.01,904,9
0.586,0.0001,490,514,2,10,0.01,1004,9
0.622,0.0001,540,564,2,10,0.01,1104,9
0.658,0.0001,593,611,2,10,0.01,1204,9
0.688,0.0001,642,662,2,10,0.01,1304,9
0.718,0.0001,686,718,2,10,0.01,1404,9
0.76,0.0001,738,766,2,10,0.01,1504,9
0.782,0.0001,779,825,2,10,0.01,1604,9
0.782,0.0001,834,870,2,10,0.01,1704,9
0.842,0.0001,884,920,2,10,0.01,1804,9
0.87,0.0001,931,973,2,10,0.01,1904,9
0.888,0.0001,984,1020,2,10,0.01,2004,9
0.55,0.0001,56,48,2,10,0.01,104,10
0.58,0.0001,103,101,2,10,0.01,204,10
0.588,0.0001,152,152,2,10,0.01,304,10
0.608,0.0001,198,206,2,10,0.01,404,10
0.632,0.0001,249,255,2,10,0.01,504,10
0.632,0.0001,301,303,2,10,0.01,604,10
0.62,0.0001,355,349,2,10,0.01,704,10
0.64,0.0001,402,402,2,10,0.01,804,10
0.692,0.0001,462,442,2,10,0.01,904,10
0.662,0.0001,508,496,2,10,0.01,1004,10
0.67,0.0001,558,546,2,10,0.01,1104,10
0.68,0.0001,599,605,2,10,0.01,1204,10
0.71,0.0001,642,662,2,10,0.01,1304,10
0.764,0.0001,699,705,2,10,0.01,1404,10
0.81,0.0001,758,746,2,10,0.01,1504,10
0.85,0.0001,801,803,2,10,0.01,1604,10
0.888,0.0001,844,860,2,10,0.01,1704,10
0.908,0.0001,898,906,2,10,0.01,1804,10
0.91,0.0001,944,960,2,10,0.01,1904,10
0.912,0.0001,993,1011,2,10,0.01,2004,10
0.546,0.0001,43,61,2,10,0.01,104,11
0.598,0.0001,96,108,2,10,0.01,204,11
0.62,0.0001,140,164,2,10,0.01,304,11
0.634,0.0001,183,221,2,10,0.01,404,11
0.638,0.0001,239,265,2,10,0.01,504,11
0.644,0.0001,295,309,2,10,0.01,604,11
0.676,0.0001,350,354,2,10,0.01,704,11
0.696,0.0001,402,402,2,10,0.01,804,11
0.702,0.0001,452,452,2,10,0.01,904,11
0.712,0.0001,504,500,2,10,0.01,1004,11
0.728,0.0001,562,542,2,10,0.01,1104,11
0.75,0.0001,611,593,2,10,0.01,1204,11
0.774,0.0001,656,648,2,10,0.01,1304,11
0.786,0.0001,707,697,2,10,0.01,1404,11
0.792,0.0001,761,743,2,10,0.01,1504,11
0.796,0.0001,811,793,2,10,0.01,1604,11
0.804,0.0001,859,845,2,10,0.01,1704,11
0.82,0.0001,907,897,2,10,0.01,1804,11
0.826,0.0001,957,947,2,10,0.01,1904,11
0.83,0.0001,1007,997,2,10,0.01,2004,11
0.392,0.0001,52,52,2,10,0.01,104,12
0.478,0.0001,103,101,2,10,0.01,204,12
0.506,0.0001,154,150,2,10,0.01,304,12
0.544,0.0001,208,196,2,10,0.01,404,12
0.612,0.0001,259,245,2,10,0.01,504,12
0.648,0.0001,314,290,2,10,0.01,604,12
0.67,0.0001,360,344,2,10,0.01,704,12
0.718,0.0001,403,401,2,10,0.01,804,12
0.74,0.0001,454,450,2,10,0.01,904,12
0.752,0.0001,498,506,2,10,0.01,1004,12
0.766,0.0001,543,561,2,10,0.01,1104,12
0.786,0.0001,598,606,2,10,0.01,1204,12
0.806,0.0001,652,652,2,10,0.01,1304,12
0.82,0.0001,698,706,2,10,0.01,1404,12
0.826,0.0001,757,747,2,10,0.01,1504,12
0.864,0.0001,810,794,2,10,0.01,1604,12
0.894,0.0001,850,854,2,10,0.01,1704,12
0.906,0.0001,904,900,2,10,0.01,1804,12
0.916,0.0001,951,953,2,10,0.01,1904,12
0.912,0.0001,999,1005,2,10,0.01,2004,12
0.498,0.0001,55,49,2,10,0.01,104,13
0.528,0.0001,103,101,2,10,0.01,204,13
0.532,0.0001,148,156,2,10,0.01,304,13
0.538,0.0001,197,207,2,10,0.01,404,13
0.542,0.0001,245,259,2,10,0.01,504,13
0.544,0.0001,293,311,2,10,0.01,604,13
0.568,0.0001,343,361,2,10,0.01,704,13
0.648,0.0001,389,415,2,10,0.01,804,13
0.726,0.0001,429,475,2,10,0.01,904,13
0.756,0.0001,479,525,2,10,0.01,1004,13
0.806,0.0001,527,577,2,10,0.01,1104,13
0.856,0.0001,586,618,2,10,0.01,1204,13
0.89,0.0001,634,670,2,10,0.01,1304,13
0.886,0.0001,686,718,2,10,0.01,1404,13
0.884,0.0001,734,770,2,10,0.01,1504,13
0.894,0.0001,785,819,2,10,0.01,1604,13
0.904,0.0001,835,869,2,10,0.01,1704,13
0.906,0.0001,890,914,2,10,0.01,1804,13
0.918,0.0001,945,959,2,10,0.01,1904,13
0.918,0.0001,996,1008,2,10,0.01,2004,13
0.53,0.0001,51,53,2,10,0.01,104,14
0.576,0.0001,98,106,2,10,0.01,204,14
0.604,0.0001,153,151,2,10,0.01,304,14
0.62,0.0001,199,205,2,10,0.01,404,14
0.614,0.0001,249,255,2,10,0.01,504,14
0.698,0.0001,294,310,2,10,0.01,604,14
0.7,0.0001,348,356,2,10,0.01,704,14
0.712,0.0001,405,399,2,10,0.01,804,14
0.712,0.0001,449,455,2,10,0.01,904,14
0.738,0.0001,502,502,2,10,0.01,1004,14
0.758,0.0001,562,542,2,10,0.01,1104,14
0.79,0.0001,614,590,2,10,0.01,1204,14
0.81,0.0001,661,643,2,10,0.01,1304,14
0.826,0.0001,704,700,2,10,0.01,1404,14
0.826,0.0001,750,754,2,10,0.01,1504,14
0.836,0.0001,795,809,2,10,0.01,1604,14
0.838,0.0001,846,858,2,10,0.01,1704,14
0.844,0.0001,901,903,2,10,0.01,1804,14
0.85,0.0001,953,951,2,10,0.01,1904,14
0.854,0.0001,1007,997,2,10,0.01,2004,14
0.432,0.0001,50,54,2,10,0.01,104,15
0.422,0.0001,101,103,2,10,0.01,204,15
0.426,0.0001,160,144,2,10,0.01,304,15
0.508,0.0001,209,195,2,10,0.01,404,15
0.49,0.0001,256,248,2,10,0.01,504,15
0.486,0.0001,305,299,2,10,0.01,604,15
0.532,0.0001,348,356,2,10,0.01,704,15
0.61,0.0001,398,406,2,10,0.01,804,15
0.662,0.0001,446,458,2,10,0.01,904,15
0.65,0.0001,500,504,2,10,0.01,1004,15
0.666,0.0001,550,554,2,10,0.01,1104,15
0.678,0.0001,597,607,2,10,0.01,1204,15
0.694,0.0001,643,661,2,10,0.01,1304,15
0.702,0.0001,685,719,2,10,0.01,1404,15
0.71,0.0001,735,769,2,10,0.01,1504,15
0.722,0.0001,776,828,2,10,0.01,1604,15
0.742,0.0001,831,873,2,10,0.01,1704,15
0.764,0.0001,882,922,2,10,0.01,1804,15
0.782,0.0001,936,968,2,10,0.01,1904,15
0.812,0.0001,991,1013,2,10,0.01,2004,15
0.448,0.0001,51,53,2,10,0.01,104,16
0.448,0.0001,104,100,2,10,0.01,204,16
0.454,0.0001,152,152,2,10,0.01,304,16
0.452,0.0001,200,204,2,10,0.01,404,16
0.456,0.0001,246,258,2,10,0.01,504,16
0.484,0.0001,293,311,2,10,0.01,604,16
0.512,0.0001,336,368,2,10,0.01,704,16
0.542,0.0001,387,417,2,10,0.01,804,16
0.476,0.0001,436,468,2,10,0.01,904,16
0.368,0.0001,490,514,2,10,0.01,1004,16
0.394,0.0001,535,569,2,10,0.01,1104,16
0.518,0.0001,585,619,2,10,0.01,1204,16
0.59,0.0001,632,672,2,10,0.01,1304,16
0.636,0.0001,681,723,2,10,0.01,1404,16
0.64,0.0001,732,772,2,10,0.01,1504,16
0.666,0.0001,784,820,2,10,0.01,1604,16
0.732,0.0001,833,871,2,10,0.01,1704,16
0.776,0.0001,883,921,2,10,0.01,1804,16
0.728,0.0001,937,967,2,10,0.01,1904,16
0.772,0.0001,991,1013,2,10,0.01,2004,16
0.476,0.0001,48,56,2,10,0.01,104,17
0.476,0.0001,99,105,2,10,0.01,204,17
0.492,0.0001,145,159,2,10,0.01,304,17
0.522,0.0001,186,218,2,10,0.01,404,17
0.56,0.0001,241,263,2,10,0.01,504,17
0.588,0.0001,286,318,2,10,0.01,604,17
0.582,0.0001,335,369,2,10,0.01,704,17
0.576,0.0001,380,424,2,10,0.01,804,17
0.582,0.0001,430,474,2,10,0.01,904,17
0.596,0.0001,482,522,2,10,0.01,1004,17
0.61,0.0001,536,568,2,10,0.01,1104,17
0.76,0.0001,591,613,2,10,0.01,1204,17
0.882,0.0001,646,658,2,10,0.01,1304,17
0.908,0.0001,703,701,2,10,0.01,1404,17
0.91,0.0001,755,749,2,10,0.01,1504,17
0.908,0.0001,812,792,2,10,0.01,1604,17
0.906,0.0001,853,851,2,10,0.01,1704,17
0.908,0.0001,910,894,2,10,0.01,1804,17
0.91,0.0001,959,945,2,10,0.01,1904,17
0.922,0.0001,1014,990,2,10,0.01,2004,17
0.494,0.0001,51,53,2,10,0.01,104,18
0.494,0.0001,100,104,2,10,0.01,204,18
0.494,0.0001,145,159,2,10,0.01,304,18
0.494,0.0001,194,210,2,10,0.01,404,18
0.494,0.0001,248,256,2,10,0.01,504,18
0.532,0.0001,298,306,2,10,0.01,604,18
0.598,0.0001,350,354,2,10,0.01,704,18
0.6,0.0001,396,408,2,10,0.01,804,18
0.6,0.0001,450,454,2,10,0.01,904,18
0.602,0.0001,498,506,2,10,0.01,1004,18
0.608,0.0001,542,562,2,10,0.01,1104,18
0.618,0.0001,589,615,2,10,0.01,1204,18
0.652,0.0001,637,667,2,10,0.01,1304,18
0.656,0.0001,686,718,2,10,0.01,1404,18
0.65,0.0001,734,770,2,10,0.01,1504,18
0.654,0.0001,786,818,2,10,0.01,1604,18
0.654,0.0001,849,855,2,10,0.01,1704,18
0.708,0.0001,898,906,2,10,0.01,1804,18
0.764,0.0001,948,956,2,10,0.01,1904,18
0.792,0.0001,999,1005,2,10,0.01,2004,18
0.472,0.0001,52,52,2,10,0.01,104,19
0.506,0.0001,111,93,2,10,0.01,204,19
0.542,0.0001,164,140,2,10,0.01,304,19
0.582,0.0001,217,187,2,10,0.01,404,19
0.666,0.0001,264,240,2,10,0.01,504,19
0.702,0.0001,312,292,2,10,0.01,604,19
0.716,0.0001,362,342,2,10,0.01,704,19
0.734,0.0001,415,389,2,10,0.01,804,19
0.746,0.0001,459,445,2,10,0.01,904,19
0.754,0.0001,510,494,2,10,0.01,1004,19
0.764,0.0001,558,546,2,10,0.01,1104,19
0.782,0.0001,605,599,2,10,0.01,1204,19
0.798,0.0001,663,641,2,10,0.01,1304,19
0.808,0.0001,712,692,2,10,0.01,1404,19
0.814,0.0001,752,752,2,10,0.01,1504,19
0.822,0.0001,805,799,2,10,0.01,1604,19
0.826,0.0001,852,852,2,10,0.01,1704,19
0.842,0.0001,915,889,2,10,0.01,1804,19
0.866,0.0001,969,935,2,10,0.01,1904,19
0.88,0.0001,1016,988,2,10,0.01,2004,19
0.506,0.0001,45,59,2,10,0.01,104,20
0.506,0.0001,91,113,2,10,0.01,204,20
0.506,0.0001,143,161,2,10,0.01,304,20
0.506,0.0001,198,206,2,10,0.01,404,20
0.506,0.0001,251,253,2,10,0.01,504,20
0.506,0.0001,308,296,2,10,0.01,604,20
0.552,0.0001,352,352,2,10,0.01,704,20
0.578,0.0001,405,399,2,10,0.01,804,20
0.604,0.0001,462,442,2,10,0.01,904,20
0.632,0.0001,515,489,2,10,0.01,1004,20
0.636,0.0001,567,537,2,10,0.01,1104,20
0.738,0.0001,618,586,2,10,0.01,1204,20
0.794,0.0001,664,640,2,10,0.01,1304,20
0.852,0.0001,720,684,2,10,0.01,1404,20
0.862,0.0001,763,741,2,10,0.01,1504,20
0.878,0.0001,818,786,2,10,0.01,1604,20
0.87,0.0001,861,843,2,10,0.01,1704,20
0.868,0.0001,906,898,2,10,0.01,1804,20
0.866,0.0001,960,944,2,10,0.01,1904,20
0.87,0.0001,999,1005,2,10,0.01,2004,20
0.538,0.001,48,56,2,10,0.0001,104,1
0.538,0.001,100,104,2,10,0.0001,204,1
0.538,0.001,155,149,2,10,0.0001,304,1
0.538,0.001,205,199,2,10,0.0001,404,1
0.54,0.001,253,251,2,10,0.0001,504,1
0.54,0.001,306,298,2,10,0.0001,604,1
0.54,0.001,358,346,2,10,0.0001,704,1
0.54,0.001,413,391,2,10,0.0001,804,1
0.542,0.001,457,447,2,10,0.0001,904,1
0.544,0.001,509,495,2,10,0.0001,1004,1
0.544,0.001,566,538,2,10,0.0001,1104,1
0.546,0.001,608,596,2,10,0.0001,1204,1
0.548,0.001,665,639,2,10,0.0001,1304,1
0.55,0.001,707,697,2,10,0.0001,1404,1
0.55,0.001,749,755,2,10,0.0001,1504,1
0.55,0.001,803,801,2,10,0.0001,1604,1
0.55,0.001,856,848,2,10,0.0001,1704,1
0.55,0.001,904,900,2,10,0.0001,1804,1
0.552,0.001,953,951,2,10,0.0001,1904,1
0.552,0.001,999,1005,2,10,0.0001,2004,1
0.498,0.001,45,59,2,10,0.0001,104,2
0.498,0.001,96,108,2,10,0.0001,204,2
0.498,0.001,148,156,2,10,0.0001,304,2
0.498,0.001,200,204,2,10,0.0001,404,2
0.498,0.001,249,255,2,10,0.0001,504,2
0.498,0.001,308,296,2,10,0.0001,604,2
0.498,0.001,359,345,2,10,0.0001,704,2
0.498,0.001,410,394,2,10,0.0001,804,2
0.498,0.001,460,444,2,10,0.0001,904,2
0.5,0.001,504,500,2,10,0.0001,1004,2
0.5,0.001,545,559,2,10,0.0001,1104,2
0.5,0.001,585,619,2,10,0.0001,1204,2
0.5,0.001,628,676,2,10,0.0001,1304,2
0.5,0.001,678,726,2,10,0.0001,1404,2
0.5,0.001,727,777,2,10,0.0001,1504,2
0.5,0.001,780,824,2,10,0.0001,1604,2
0.5,0.001,835,869,2,10,0.0001,1704,2
0.5,0.001,889,915,2,10,0.0001,1804,2
0.502,0.001,935,969,2,10,0.0001,1904,2
0.502,0.001,994,1010,2,10,0.0001,2004,2
0.59,0.001,60,44,2,10,0.0001,104,3
0.586,0.001,111,93,2,10,0.0001,204,3
0.584,0.001,164,140,2,10,0.0001,304,3
0.588,0.001,218,186,2,10,0.0001,404,3
0.586,0.001,269,235,2,10,0.0001,504,3
0.586,0.001,319,285,2,10,0.0001,604,3
0.584,0.001,366,338,2,10,0.0001,704,3
0.582,0.001,419,385,2,10,0.0001,804,3
0.582,0.001,472,432,2,10,0.0001,904,3
0.584,0.001,525,479,2,10,0.0001,1004,3
0.58,0.001,570,534,2,10,0.0001,1104,3
0.578,0.001,621,583,2,10,0.0001,1204,3
0.578,0.001,669,635,2,10,0.0001,1304,3
0.576,0.001,720,684,2,10,0.0001,1404,3
0.578,0.001,765,739,2,10,0.0001,1504,3
0.584,0.001,815,789,2,10,0.0001,1604,3
0.582,0.001,863,841,2,10,0.0001,1704,3
0.582,0.001,918,886,2,10,0.0001,1804,3
0.582,0.001,962,942,2,10,0.0001,1904,3
0.582,0.001,1012,992,2,10,0.0001,2004,3
0.47,0.001,51,53,2,10,0.0001,104,4
0.47,0.001,104,100,2,10,0.0001,204,4
0.47,0.001,155,149,2,10,0.0001,304,4
0.47,0.001,200,204,2,10,0.0001,404,4
0.47,0.001,249,255,2,10,0.0001,504,4
0.47,0.001,308,296,2,10,0.0001,604,4
0.47,0.001,361,343,2,10,0.0001,704,4
0.47,0.001,414,390,2,10,0.0001,804,4
0.47,0.001,466,438,2,10,0.0001,904,4
0.472,0.001,517,487,2,10,0.0001,1004,4
0.474,0.001,564,540,2,10,0.0001,1104,4
0.474,0.001,609,595,2,10,0.0001,1204,4
0.474,0.001,652,652,2,10,0.0001,1304,4
0.474,0.001,694,710,2,10,0.0001,1404,4
0.476,0.001,746,758,2,10,0.0001,1504,4
0.476,0.001,792,812,2,10,0.0001,1604,4
0.478,0.001,835,869,2,10,0.0001,1704,4
0.478,0.001,884,920,2,10,0.0001,1804,4
0.478,0.001,937,967,2,10,0.0001,1904,4
0.48,0.001,982,1022,2,10,0.0001,2004,4
0.504,0.001,48,56,2,10,0.0001,104,5
0.504,0.001,101,103,2,10,0.0001,204,5
0.504,0.001,154,150,2,10,0.0001,304,5
0.504,0.001,210,194,2,10,0.0001,404,5
0.504,0.001,260,244,2,10,0.0001,504,5
0.504,0.001,305,299,2,10,0.0001,604,5
0.504,0.001,353,351,2,10,0.0001,704,5
0.504,0.001,405,399,2,10,0.0001,804,5
0.504,0.001,459,445,2,10,0.0001,904,5
0.504,0.001,503,501,2,10,0.0001,1004,5
0.504,0.001,554,550,2,10,0.0001,1104,5
0.504,0.001,594,610,2,10,0.0001,1204,5
0.504,0.001,642,662,2,10,0.0001,1304,5
0.504,0.001,688,716,2,10,0.0001,1404,5
0.504,0.001,745,759,2,10,0.0001,1504,5
0.504,0.001,798,806,2,10,0.0001,1604,5
0.504,0.001,853,851,2,10,0.0001,1704,5
0.504,0.001,909,895,2,10,0.0001,1804,5
0.504,0.001,952,952,2,10,0.0001,1904,5
0.504,0.001,1004,1000,2,10,0.0001,2004,5
0.488,0.001,55,49,2,10,0.0001,104,6
0.488,0.001,100,104,2,10,0.0001,204,6
0.488,0.001,147,157,2,10,0.0001,304,6
0.488,0.001,196,208,2,10,0.0001,404,6
0.488,0.001,242,262,2,10,0.0001,504,6
0.488,0.001,296,308,2,10,0.0001,604,6
0.488,0.001,347,357,2,10,0.0001,704,6
0.488,0.001,394,410,2,10,0.0001,804,6
0.488,0.001,434,470,2,10,0.0001,904,6
0.488,0.001,495,509,2,10,0.0001,1004,6
0.488,0.001,540,564,2,10,0.0001,1104,6
0.488,0.001,598,606,2,10,0.0001,1204,6
0.488,0.001,653,651,2,10,0.0001,1304,6
0.488,0.001,700,704,2,10,0.0001,1404,6
0.488,0.001,748,756,2,10,0.0001,1504,6
0.488,0.001,799,805,2,10,0.0001,1604,6
0.488,0.001,847,857,2,10,0.0001,1704,6
0.488,0.001,897,907,2,10,0.0001,1804,6
0.488,0.001,945,959,2,10,0.0001,1904,6
0.488,0.001,996,1008,2,10,0.0001,2004,6
0.574,0.001,58,46,2,10,0.0001,104,7
0.574,0.001,114,90,2,10,0.0001,204,7
0.574,0.001,170,134,2,10,0.0001,304,7
0.574,0.001,217,187,2,10,0.0001,404,7
0.574,0.001,269,235,2,10,0.0001,504,7
0.574,0.001,318,286,2,10,0.0001,604,7
0.574,0.001,373,331,2,10,0.0001,704,7
0.574,0.001,425,379,2,10,0.0001,804,7
0.574,0.001,475,429,2,10,0.0001,904,7
0.574,0.001,523,481,2,10,0.0001,1004,7
0.574,0.001,565,539,2,10,0.0001,1104,7
0.574,0.001,609,595,2,10,0.0001,1204,7
0.574,0.001,661,643,2,10,0.0001,1304,7
0.574,0.001,716,688,2,10,0.0001,1404,7
0.574,0.001,769,735,2,10,0.0001,1504,7
0.574,0.001,816,788,2,10,0.0001,1604,7
0.57,0.001,862,842,2,10,0.0001,1704,7
0.57,0.001,909,895,2,10,0.0001,1804,7
0.57,0.001,965,939,2,10,0.0001,1904,7
0.57,0.001,1021,983,2,10,0.0001,2004,7
0.418,0.001,50,54,2,10,0.0001,104,8
0.418,0.001,97,107,2,10,0.0001,204,8
0.418,0.001,149,155,2,10,0.0001,304,8
0.418,0.001,200,204,2,10,0.0001,404,8
0.418,0.001,249,255,2,10,0.0001,504,8
0.418,0.001,296,308,2,10,0.0001,604,8
0.418,0.001,348,356,2,10,0.0001,704,8
0.418,0.001,400,404,2,10,0.0001,804,8
0.418,0.001,452,452,2,10,0.0001,904,8
0.418,0.001,504,500,2,10,0.0001,1004,8
0.418,0.001,553,551,2,10,0.0001,1104,8
0.418,0.001,613,591,2,10,0.0001,1204,8
0.418,0.001,662,642,2,10,0.0001,1304,8
0.416,0.001,704,700,2,10,0.0001,1404,8
0.416,0.001,753,751,2,10,0.0001,1504,8
0.416,0.001,816,788,2,10,0.0001,1604,8
0.416,0.001,865,839,2,10,0.0001,1704,8
0.416,0.001,923,881,2,10,0.0001,1804,8
0.414,0.001,974,930,2,10,0.0001,1904,8
0.414,0.001,1021,983,2,10,0.0001,2004,8
0.492,0.001,54,50,2,10,0.0001,104,9
0.492,0.001,104,100,2,10,0.0001,204,9
0.492,0.001,155,149,2,10,0.0001,304,9
0.492,0.001,204,200,2,10,0.0001,404,9
0.492,0.001,253,251,2,10,0.0001,504,9
0.492,0.001,296,308,2,10,0.0001,604,9
0.492,0.001,361,343,2,10,0.0001,704,9
0.492,0.001,409,395,2,10,0.0001,804,9
0.492,0.001,455,449,2,10,0.0001,904,9
0.492,0.001,503,501,2,10,0.0001,1004,9
0.492,0.001,554,550,2,10,0.0001,1104,9
0.492,0.001,606,598,2,10,0.0001,1204,9
0.492,0.001,655,649,2,10,0.0001,1304,9
0.492,0.001,704,700,2,10,0.0001,1404,9
0.492,0.001,753,751,2,10,0.0001,1504,9
0.492,0.001,804,800,2,10,0.0001,1604,9
0.492,0.001,852,852,2,10,0.0001,1704,9
0.492,0.001,904,900,2,10,0.0001,1804,9
0.492,0.001,946,958,2,10,0.0001,1904,9
0.492,0.001,998,1006,2,10,0.0001,2004,9
0.406,0.001,59,45,2,10,0.0001,104,10
0.408,0.001,99,105,2,10,0.0001,204,10
0.408,0.001,148,156,2,10,0.0001,304,10
0.41,0.001,199,205,2,10,0.0001,404,10
0.41,0.001,252,252,2,10,0.0001,504,10
0.41,0.001,295,309,2,10,0.0001,604,10
0.41,0.001,346,358,2,10,0.0001,704,10
0.41,0.001,401,403,2,10,0.0001,804,10
0.412,0.001,455,449,2,10,0.0001,904,10
0.412,0.001,508,496,2,10,0.0001,1004,10
0.412,0.001,554,550,2,10,0.0001,1104,10
0.412,0.001,597,607,2,10,0.0001,1204,10
0.416,0.001,643,661,2,10,0.0001,1304,10
0.416,0.001,699,705,2,10,0.0001,1404,10
0.418,0.001,745,759,2,10,0.0001,1504,10
0.42,0.001,809,795,2,10,0.0001,1604,10
0.42,0.001,860,844,2,10,0.0001,1704,10
0.42,0.001,913,891,2,10,0.0001,1804,10
0.42,0.001,962,942,2,10,0.0001,1904,10
0.42,0.001,1007,997,2,10,0.0001,2004,10
0.604,0.001,61,43,2,10,0.0001,104,11
0.604,0.001,102,102,2,10,0.0001,204,11
0.604,0.001,155,149,2,10,0.0001,304,11
0.604,0.001,207,197,2,10,0.0001,404,11
0.604,0.001,258,246,2,10,0.0001,504,11
0.604,0.001,301,303,2,10,0.0001,604,11
0.604,0.001,351,353,2,10,0.0001,704,11
0.604,0.001,405,399,2,10,0.0001,804,11
0.604,0.001,457,447,2,10,0.0001,904,11
0.604,0.001,511,493,2,10,0.0001,1004,11
0.606,0.001,558,546,2,10,0.0001,1104,11
0.606,0.001,617,587,2,10,0.0001,1204,11
0.606,0.001,665,639,2,10,0.0001,1304,11
0.606,0.001,715,689,2,10,0.0001,1404,11
0.606,0.001,764,740,2,10,0.0001,1504,11
0.608,0.001,816,788,2,10,0.0001,1604,11
0.608,0.001,869,835,2,10,0.0001,1704,11
0.608,0.001,913,891,2,10,0.0001,1804,11
0.608,0.001,967,937,2,10,0.0001,1904,11
0.608,0.001,1015,989,2,10,0.0001,2004,11
0.47,0.001,58,46,2,10,0.0001,104,12
0.47,0.001,103,101,2,10,0.0001,204,12
0.47,0.001,153,151,2,10,0.0001,304,12
0.47,0.001,203,201,2,10,0.0001,404,12
0.47,0.001,264,240,2,10,0.0001,504,12
0.47,0.001,310,294,2,10,0.0001,604,12
0.47,0.001,356,348,2,10,0.0001,704,12
0.47,0.001,411,393,2,10,0.0001,804,12
0.472,0.001,460,444,2,10,0.0001,904,12
0.472,0.001,512,492,2,10,0.0001,1004,12
0.472,0.001,565,539,2,10,0.0001,1104,12
0.474,0.001,611,593,2,10,0.0001,1204,12
0.474,0.001,659,645,2,10,0.0001,1304,12
0.474,0.001,712,692,2,10,0.0001,1404,12
0.474,0.001,770,734,2,10,0.0001,1504,12
0.474,0.001,819,785,2,10,0.0001,1604,12
0.474,0.001,864,840,2,10,0.0001,1704,12
0.474,0.001,912,892,2,10,0.0001,1804,12
0.476,0.001,969,935,2,10,0.0001,1904,12
0.474,0.001,1017,987,2,10,0.0001,2004,12
0.398,0.001,44,60,2,10,0.0001,104,13
0.398,0.001,102,102,2,10,0.0001,204,13
0.398,0.001,153,151,2,10,0.0001,304,13
0.398,0.001,204,200,2,10,0.0001,404,13
0.4,0.001,254,250,2,10,0.0001,504,13
0.398,0.001,299,305,2,10,0.0001,604,13
0.398,0.001,350,354,2,10,0.0001,704,13
0.398,0.001,396,408,2,10,0.0001,804,13
0.398,0.001,436,468,2,10,0.0001,904,13
0.4,0.001,484,520,2,10,0.0001,1004,13
0.402,0.001,539,565,2,10,0.0001,1104,13
0.402,0.001,590,614,2,10,0.0001,1204,13
0.402,0.001,641,663,2,10,0.0001,1304,13
0.402,0.001,694,710,2,10,0.0001,1404,13
0.402,0.001,742,762,2,10,0.0001,1504,13
0.402,0.001,794,810,2,10,0.0001,1604,13
0.402,0.001,853,851,2,10,0.0001,1704,13
0.402,0.001,912,892,2,10,0.0001,1804,13
0.402,0.001,955,949,2,10,0.0001,1904,13
0.402,0.001,1009,995,2,10,0.0001,2004,13
0.516,0.001,62,42,2,10,0.0001,104,14
0.516,0.001,103,101,2,10,0.0001,204,14
0.516,0.001,159,145,2,10,0.0001,304,14
0.516,0.001,208,196,2,10,0.0001,404,14
0.516,0.001,258,246,2,10,0.0001,504,14
0.516,0.001,302,302,2,10,0.0001,604,14
0.516,0.001,347,357,2,10,0.0001,704,14
0.516,0.001,398,406,2,10,0.0001,804,14
0.516,0.001,445,459,2,10,0.0001,904,14
0.516,0.001,491,513,2,10,0.0001,1004,14
0.516,0.001,546,558,2,10,0.0001,1104,14
0.516,0.001,595,609,2,10,0.0001,1204,14
0.516,0.001,645,659,2,10,0.0001,1304,14
0.518,0.001,704,700,2,10,0.0001,1404,14
0.518,0.001,753,751,2,10,0.0001,1504,14
0.518,0.001,795,809,2,10,0.0001,1604,14
0.518,0.001,843,861,2,10,0.0001,1704,14
0.518,0.001,893,911,2,10,0.0001,1804,14
0.518,0.001,947,957,2,10,0.0001,1904,14
0.518,0.001,1001,1003,2,10,0.0001,2004,14
0.454,0.001,53,51,2,10,0.0001,104,15
0.454,0.001,114,90,2,10,0.0001,204,15
0.454,0.001,168,136,2,10,0.0001,304,15
0.454,0.001,213,191,2,10,0.0001,404,15
0.454,0.001,262,242,2,10,0.0001,504,15
0.452,0.001,312,292,2,10,0.0001,604,15
0.452,0.001,365,339,2,10,0.0001,704,15
0.452,0.001,411,393,2,10,0.0001,804,15
0.452,0.001,454,450,2,10,0.0001,904,15
0.452,0.001,499,505,2,10,0.0001,1004,15
0.45,0.001,550,554,2,10,0.0001,1104,15
0.45,0.001,591,613,2,10,0.0001,1204,15
0.45,0.001,649,655,2,10,0.0001,1304,15
0.45,0.001,708,696,2,10,0.0001,1404,15
0.45,0.001,762,742,2,10,0.0001,1504,15
0.45,0.001,811,793,2,10,0.0001,1604,15
0.45,0.001,868,836,2,10,0.0001,1704,15
0.45,0.001,917,887,2,10,0.0001,1804,15
0.45,0.001,960,944,2,10,0.0001,1904,15
0.45,0.001,1004,1000,2,10,0.0001,2004,15
0.494,0.001,51,53,2,10,0.0001,104,16
0.494,0.001,94,110,2,10,0.0001,204,16
0.494,0.001,139,165,2,10,0.0001,304,16
0.494,0.001,187,217,2,10,0.0001,404,16
0.494,0.001,231,273,2,10,0.0001,504,16
0.494,0.001,289,315,2,10,0.0001,604,16
0.494,0.001,339,365,2,10,0.0001,704,16
0.494,0.001,393,411,2,10,0.0001,804,16
0.494,0.001,446,458,2,10,0.0001,904,16
0.494,0.001,499,505,2,10,0.0001,1004,16
0.494,0.001,560,544,2,10,0.0001,1104,16
0.494,0.001,612,592,2,10,0.0001,1204,16
0.494,0.001,658,646,2,10,0.0001,1304,16
0.494,0.001,712,692,2,10,0.0001,1404,16
0.494,0.001,757,747,2,10,0.0001,1504,16
0.494,0.001,802,802,2,10,0.0001,1604,16
0.494,0.001,849,855,2,10,0.0001,1704,16
0.494,0.001,894,910,2,10,0.0001,1804,16
0.494,0.001,955,949,2,10,0.0001,1904,16
0.494,0.001,1005,999,2,10,0.0001,2004,16
0.466,0.001,55,49,2,10,0.0001,104,17
0.466,0.001,104,100,2,10,0.0001,204,17
0.466,0.001,155,149,2,10,0.0001,304,17
0.466,0.001,212,192,2,10,0.0001,404,17
0.466,0.001,266,238,2,10,0.0001,504,17
0.466,0.001,319,285,2,10,0.0001,604,17
0.466,0.001,373,331,2,10,0.0001,704,17
0.466,0.001,419,385,2,10,0.0001,804,17
0.466,0.001,465,439,2,10,0.0001,904,17
0.466,0.001,516,488,2,10,0.0001,1004,17
0.466,0.001,558,546,2,10,0.0001,1104,17
0.468,0.001,601,603,2,10,0.0001,1204,17
0.47,0.001,646,658,2,10,0.0001,1304,17
0.47,0.001,699,705,2,10,0.0001,1404,17
0.47,0.001,745,759,2,10,0.0001,1504,17
0.47,0.001,794,810,2,10,0.0001,1604,17
0.468,0.001,855,849,2,10,0.0001,1704,17
0.468,0.001,900,904,2,10,0.0001,1804,17
0.468,0.001,952,952,2,10,0.0001,1904,17
0.472,0.001,1000,1004,2,10,0.0001,2004,17
0.48,0.001,57,47,2,10,0.0001,104,18
0.48,0.001,103,101,2,10,0.0001,204,18
0.48,0.001,152,152,2,10,0.0001,304,18
0.48,0.001,205,199,2,10,0.0001,404,18
0.48,0.001,244,260,2,10,0.0001,504,18
0.48,0.001,295,309,2,10,0.0001,604,18
0.48,0.001,348,356,2,10,0.0001,704,18
0.48,0.001,400,404,2,10,0.0001,804,18
0.48,0.001,455,449,2,10,0.0001,904,18
0.48,0.001,506,498,2,10,0.0001,1004,18
0.48,0.001,558,546,2,10,0.0001,1104,18
0.48,0.001,604,600,2,10,0.0001,1204,18
0.48,0.001,656,648,2,10,0.0001,1304,18
0.48,0.001,714,690,2,10,0.0001,1404,18
0.48,0.001,758,746,2,10,0.0001,1504,18
0.48,0.001,806,798,2,10,0.0001,1604,18
0.48,0.001,857,847,2,10,0.0001,1704,18
0.48,0.001,907,897,2,10,0.0001,1804,18
0.48,0.001,955,949,2,10,0.0001,1904,18
0.48,0.001,992,1012,2,10,0.0001,2004,18
0.494,0.001,52,52,2,10,0.0001,104,19
0.494,0.001,96,108,2,10,0.0001,204,19
0.494,0.001,142,162,2,10,0.0001,304,19
0.494,0.001,192,212,2,10,0.0001,404,19
0.494,0.001,242,262,2,10,0.0001,504,19
0.494,0.001,299,305,2,10,0.0001,604,19
0.494,0.001,350,354,2,10,0.0001,704,19
0.494,0.001,402,402,2,10,0.0001,804,19
0.496,0.001,455,449,2,10,0.0001,904,19
0.496,0.001,502,502,2,10,0.0001,1004,19
0.498,0.001,551,553,2,10,0.0001,1104,19
0.5,0.001,601,603,2,10,0.0001,1204,19
0.5,0.001,652,652,2,10,0.0001,1304,19
0.5,0.001,697,707,2,10,0.0001,1404,19
0.5,0.001,751,753,2,10,0.0001,1504,19
0.5,0.001,796,808,2,10,0.0001,1604,19
0.5,0.001,852,852,2,10,0.0001,1704,19
0.502,0.001,899,905,2,10,0.0001,1804,19
0.504,0.001,945,959,2,10,0.0001,1904,19
0.506,0.001,999,1005,2,10,0.0001,2004,19
0.468,0.001,48,56,2,10,0.0001,104,20
0.468,0.001,90,114,2,10,0.0001,204,20
0.468,0.001,146,158,2,10,0.0001,304,20
0.468,0.001,201,203,2,10,0.0001,404,20
0.468,0.001,254,250,2,10,0.0001,504,20
0.468,0.001,303,301,2,10,0.0001,604,20
0.468,0.001,357,347,2,10,0.0001,704,20
0.468,0.001,402,402,2,10,0.0001,804,20
0.468,0.001,452,452,2,10,0.0001,904,20
0.47,0.001,495,509,2,10,0.0001,1004,20
0.47,0.001,541,563,2,10,0.0001,1104,20
0.47,0.001,589,615,2,10,0.0001,1204,20
0.47,0.001,640,664,2,10,0.0001,1304,20
0.47,0.001,699,705,2,10,0.0001,1404,20
0.47,0.001,760,744,2,10,0.0001,1504,20
0.47,0.001,809,795,2,10,0.0001,1604,20
0.47,0.001,859,845,2,10,0.0001,1704,20
0.47,0.001,908,896,2,10,0.0001,1804,20
0.47,0.001,958,946,2,10,0.0001,1904,20
0.47,0.001,1009,995,2,10,0.0001,2004,20
0.352,0.001,51,53,2,10,0.001,104,1
0.35,0.001,102,102,2,10,0.001,204,1
0.356,0.001,158,146,2,10,0.001,304,1
0.358,0.001,206,198,2,10,0.001,404,1
0.352,0.001,251,253,2,10,0.001,504,1
0.352,0.001,300,304,2,10,0.001,604,1
0.35,0.001,351,353,2,10,0.001,704,1
0.356,0.001,403,401,2,10,0.001,804,1
0.364,0.001,453,451,2,10,0.001,904,1
0.37,0.001,509,495,2,10,0.001,1004,1
0.39,0.001,552,552,2,10,0.001,1104,1
0.406,0.001,599,605,2,10,0.001,1204,1
0.42,0.001,647,657,2,10,0.001,1304,1
0.432,0.001,695,709,2,10,0.001,1404,1
0.436,0.001,742,762,2,10,0.001,1504,1
0.436,0.001,793,811,2,10,0.001,1604,1
0.46,0.001,846,858,2,10,0.001,1704,1
0.464,0.001,891,913,2,10,0.001,1804,1
0.48,0.001,936,968,2,10,0.001,1904,1
0.48,0.001,992,1012,2,10,0.001,2004,1
0.478,0.001,40,64,2,10,0.001,104,2
0.478,0.001,90,114,2,10,0.001,204,2
0.478,0.001,143,161,2,10,0.001,304,2
0.478,0.001,199,205,2,10,0.001,404,2
0.478,0.001,260,244,2,10,0.001,504,2
0.478,0.001,319,285,2,10,0.001,604,2
0.478,0.001,369,335,2,10,0.001,704,2
0.484,0.001,415,389,2,10,0.001,804,2
0.488,0.001,466,438,2,10,0.001,904,2
0.5,0.001,505,499,2,10,0.001,1004,2
0.512,0.001,559,545,2,10,0.001,1104,2
0.522,0.001,613,591,2,10,0.001,1204,2
0.538,0.001,654,650,2,10,0.001,1304,2
0.564,0.001,709,695,2,10,0.001,1404,2
0.578,0.001,765,739,2,10,0.001,1504,2
0.572,0.001,818,786,2,10,0.001,1604,2
0.584,0.001,869,835,2,10,0.001,1704,2
0.592,0.001,925,879,2,10,0.001,1804,2
0.59,0.001,975,929,2,10,0.001,1904,2
0.598,0.001,1013,991,2,10,0.001,2004,2
0.482,0.001,56,48,2,10,0.001,104,3
0.486,0.001,102,102,2,10,0.001,204,3
0.484,0.001,143,161,2,10,0.001,304,3
0.484,0.001,190,214,2,10,0.001,404,3
0.486,0.001,242,262,2,10,0.001,504,3
0.492,0.001,289,315,2,10,0.001,604,3
0.492,0.001,328,376,2,10,0.001,704,3
0.492,0.001,386,418,2,10,0.001,804,3
0.5,0.001,436,468,2,10,0.001,904,3
0.506,0.001,490,514,2,10,0.001,1004,3
0.516,0.001,538,566,2,10,0.001,1104,3
0.518,0.001,599,605,2,10,0.001,1204,3
0.52,0.001,651,653,2,10,0.001,1304,3
0.528,0.001,701,703,2,10,0.001,1404,3
0.534,0.001,751,753,2,10,0.001,1504,3
0.546,0.001,798,806,2,10,0.001,1604,3
0.552,0.001,853,851,2,10,0.001,1704,3
0.568,0.001,904,900,2,10,0.001,1804,3
0.574,0.001,960,944,2,10,0.001,1904,3
0.6,0.001,1007,997,2,10,0.001,2004,3
0.514,0.001,48,56,2,10,0.001,104,4
0.516,0.001,95,109,2,10,0.001,204,4
0.514,0.001,140,164,2,10,0.001,304,4
0.512,0.001,185,219,2,10,0.001,404,4
0.512,0.001,243,261,2,10,0.001,504,4
0.516,0.001,292,312,2,10,0.001,604,4
0.514,0.001,340,364,2,10,0.001,704,4
0.518,0.001,391,413,2,10,0.001,804,4
0.522,0.001,441,463,2,10,0.001,904,4
0.53,0.001,487,517,2,10,0.001,1004,4
0.54,0.001,542,562,2,10,0.001,1104,4
0.546,0.001,585,619,2,10,0.001,1204,4
0.544,0.001,630,674,2,10,0.001,1304,4
0.552,0.001,681,723,2,10,0.001,1404,4
0.562,0.001,737,767,2,10,0.001,1504,4
0.564,0.001,796,808,2,10,0.001,1604,4
0.564,0.001,840,864,2,10,0.001,1704,4
0.57,0.001,900,904,2,10,0.001,1804,4
0.578,0.001,950,954,2,10,0.001,1904,4
0.586,0.001,989,1015,2,10,0.001,2004,4
0.484,0.001,56,48,2,10,0.001,104,5
0.484,0.001,105,99,2,10,0.001,204,5
0.486,0.001,157,147,2,10,0.001,304,5
0.49,0.001,202,202,2,10,0.001,404,5
0.502,0.001,251,253,2,10,0.001,504,5
0.508,0.001,301,303,2,10,0.001,604,5
0.51,0.001,349,355,2,10,0.001,704,5
0.514,0.001,399,405,2,10,0.001,804,5
0.512,0.001,451,453,2,10,0.001,904,5
0.514,0.001,495,509,2,10,0.001,1004,5
0.51,0.001,549,555,2,10,0.001,1104,5
0.512,0.001,599,605,2,10,0.001,1204,5
0.514,0.001,657,647,2,10,0.001,1304,5
0.52,0.001,705,699,2,10,0.001,1404,5
0.528,0.001,751,753,2,10,0.001,1504,5
0.536,0.001,802,802,2,10,0.001,1604,5
0.538,0.001,846,858,2,10,0.001,1704,5
0.54,0.001,905,899,2,10,0.001,1804,5
0.53,0.001,957,947,2,10,0.001,1904,5
0.524,0.001,1008,996,2,10,0.001,2004,5
0.574,0.001,56,48,2,10,0.001,104,6
0.58,0.001,108,96,2,10,0.001,204,6
0.578,0.001,157,147,2,10,0.001,304,6
0.578,0.001,201,203,2,10,0.001,404,6
0.584,0.001,247,257,2,10,0.001,504,6
0.588,0.001,300,304,2,10,0.001,604,6
0.586,0.001,341,363,2,10,0.001,704,6
0.592,0.001,390,414,2,10,0.001,804,6
0.6,0.001,441,463,2,10,0.001,904,6
0.6,0.001,491,513,2,10,0.001,1004,6
0.604,0.001,537,567,2,10,0.001,1104,6
0.606,0.001,589,615,2,10,0.001,1204,6
0.602,0.001,637,667,2,10,0.001,1304,6
0.606,0.001,685,719,2,10,0.001,1404,6
0.608,0.001,735,769,2,10,0.001,1504,6
0.608,0.001,782,822,2,10,0.001,1604,6
0.62,0.001,833,871,2,10,0.001,1704,6
0.622,0.001,889,915,2,10,0.001,1804,6
0.626,0.001,946,958,2,10,0.001,1904,6
0.63,0.001,992,1012,2,10,0.001,2004,6
0.548,0.001,52,52,2,10,0.001,104,7
0.55,0.001,104,100,2,10,0.001,204,7
0.552,0.001,156,148,2,10,0.001,304,7
0.556,0.001,203,201,2,10,0.001,404,7
0.566,0.001,258,246,2,10,0.001,504,7
0.574,0.001,312,292,2,10,0.001,604,7
0.58,0.001,357,347,2,10,0.001,704,7
0.59,0.001,412,392,2,10,0.001,804,7
0.594,0.001,452,452,2,10,0.001,904,7
0.604,0.001,501,503,2,10,0.001,1004,7
0.61,0.001,548,556,2,10,0.001,1104,7
0.616,0.001,599,605,2,10,0.001,1204,7
0.632,0.001,653,651,2,10,0.001,1304,7
0.646,0.001,701,703,2,10,0.001,1404,7
0.656,0.001,756,748,2,10,0.001,1504,7
0.666,0.001,808,796,2,10,0.001,1604,7
0.692,0.001,851,853,2,10,0.001,1704,7
0.708,0.001,904,900,2,10,0.001,1804,7
0.714,0.001,953,951,2,10,0.001,1904,7
0.722,0.001,1006,998,2,10,0.001,2004,7
0.43,0.001,52,52,2,10,0.001,104,8
0.43,0.001,99,105,2,10,0.001,204,8
0.432,0.001,154,150,2,10,0.001,304,8
0.432,0.001,201,203,2,10,0.001,404,8
0.434,0.001,254,250,2,10,0.001,504,8
0.426,0.001,302,302,2,10,0.001,604,8
0.428,0.001,346,358,2,10,0.001,704,8
0.432,0.001,401,403,2,10,0.001,804,8
0.436,0.001,447,457,2,10,0.001,904,8
0.436,0.001,490,514,2,10,0.001,1004,8
0.436,0.001,543,561,2,10,0.001,1104,8
0.438,0.001,593,611,2,10,0.001,1204,8
0.448,0.001,644,660,2,10,0.001,1304,8
0.46,0.001,691,713,2,10,0.001,1404,8
0.468,0.001,742,762,2,10,0.001,1504,8
0.496,0.001,789,815,2,10,0.001,1604,8
0.516,0.001,840,864,2,10,0.001,1704,8
0.526,0.001,890,914,2,10,0.001,1804,8
0.536,0.001,938,966,2,10,0.001,1904,8
0.532,0.001,989,1015,2,10,0.001,2004,8
0.432,0.001,51,53,2,10,0.001,104,9
0.446,0.001,98,106,2,10,0.001,204,9
0.45,0.001,155,149,2,10,0.001,304,9
0.46,0.001,211,193,2,10,0.001,404,9
0.476,0.001,252,252,2,10,0.001,504,9
0.492,0.001,302,302,2,10,0.001,604,9
0.494,0.001,353,351,2,10,0.001,704,9
0.502,0.001,403,401,2,10,0.001,804,9
0.508,0.001,451,453,2,10,0.001,904,9
0.508,0.001,505,499,2,10,0.001,1004,9
0.518,0.001,563,541,2,10,0.001,1104,9
0.526,0.001,606,598,2,10,0.001,1204,9
0.532,0.001,659,645,2,10,0.001,1304,9
0.54,0.001,709,695,2,10,0.001,1404,9
0.54,0.001,754,750,2,10,0.001,1504,9
0.546,0.001,809,795,2,10,0.001,1604,9
0.548,0.001,847,857,2,10,0.001,1704,9
0.558,0.001,889,915,2,10,0.001,1804,9
0.584,0.001,946,958,2,10,0.001,1904,9
0.592,0.001,998,1006,2,10,0.001,2004,9
0.458,0.001,62,42,2,10,0.001,104,10
0.456,0.001,111,93,2,10,0.001,204,10
0.46,0.001,162,142,2,10,0.001,304,10
0.46,0.001,209,195,2,10,0.001,404,10
0.462,0.001,259,245,2,10,0.001,504,10
0.474,0.001,298,306,2,10,0.001,604,10
0.48,0.001,343,361,2,10,0.001,704,10
0.48,0.001,395,409,2,10,0.001,804,10
0.482,0.001,443,461,2,10,0.001,904,10
0.482,0.001,495,509,2,10,0.001,1004,10
0.492,0.001,543,561,2,10,0.001,1104,10
0.5,0.001,590,614,2,10,0.001,1204,10
0.502,0.001,640,664,2,10,0.001,1304,10
0.508,0.001,694,710,2,10,0.001,1404,10
0.514,0.001,747,757,2,10,0.001,1504,10
0.524,0.001,803,801,2,10,0.001,1604,10
0.534,0.001,850,854,2,10,0.001,1704,10
0.542,0.001,897,907,2,10,0.001,1804,10
0.546,0.001,945,959,2,10,0.001,1904,10
0.57,0.001,998,1006,2,10,0.001,2004,10
0.55,0.001,56,48,2,10,0.001,104,11
0.552,0.001,112,92,2,10,0.001,204,11
0.552,0.001,162,142,2,10,0.001,304,11
0.548,0.001,209,195,2,10,0.001,404,11
0.55,0.001,263,241,2,10,0.001,504,11
0.564,0.001,311,293,2,10,0.001,604,11
0.566,0.001,360,344,2,10,0.001,704,11
0.574,0.001,408,396,2,10,0.001,804,11
0.58,0.001,454,450,2,10,0.001,904,11
0.58,0.001,503,501,2,10,0.001,1004,11
0.586,0.001,551,553,2,10,0.001,1104,11
0.592,0.001,609,595,2,10,0.001,1204,11
0.596,0.001,653,651,2,10,0.001,1304,11
0.612,0.001,705,699,2,10,0.001,1404,11
0.62,0.001,753,751,2,10,0.001,1504,11
0.622,0.001,804,800,2,10,0.001,1604,11
0.626,0.001,853,851,2,10,0.001,1704,11
0.63,0.001,895,909,2,10,0.001,1804,11
0.646,0.001,938,966,2,10,0.001,1904,11
0.648,0.001,987,1017,2,10,0.001,2004,11
0.436,0.001,52,52,2,10,0.001,104,12
0.452,0.001,99,105,2,10,0.001,204,12
0.442,0.001,150,154,2,10,0.001,304,12
0.432,0.001,198,206,2,10,0.001,404,12
0.422,0.001,252,252,2,10,0.001,504,12
0.414,0.001,301,303,2,10,0.001,604,12
0.414,0.001,358,346,2,10,0.001,704,12
0.404,0.001,409,395,2,10,0.001,804,12
0.404,0.001,459,445,2,10,0.001,904,12
0.416,0.001,509,495,2,10,0.001,1004,12
0.426,0.001,563,541,2,10,0.001,1104,12
0.43,0.001,609,595,2,10,0.001,1204,12
0.434,0.001,647,657,2,10,0.001,1304,12
0.442,0.001,693,711,2,10,0.001,1404,12
0.468,0.001,749,755,2,10,0.001,1504,12
0.488,0.001,796,808,2,10,0.001,1604,12
0.49,0.001,839,865,2,10,0.001,1704,12
0.49,0.001,882,922,2,10,0.001,1804,12
0.488,0.001,921,983,2,10,0.001,1904,12
0.494,0.001,975,1029,2,10,0.001,2004,12
0.53,0.001,50,54,2,10,0.001,104,13
0.532,0.001,104,100,2,10,0.001,204,13
0.534,0.001,147,157,2,10,0.001,304,13
0.534,0.001,194,210,2,10,0.001,404,13
0.542,0.001,244,260,2,10,0.001,504,13
0.54,0.001,294,310,2,10,0.001,604,13
0.546,0.001,344,360,2,10,0.001,704,13
0.536,0.001,392,412,2,10,0.001,804,13
0.542,0.001,432,472,2,10,0.001,904,13
0.556,0.001,492,512,2,10,0.001,1004,13
0.572,0.001,542,562,2,10,0.001,1104,13
0.58,0.001,593,611,2,10,0.001,1204,13
0.592,0.001,638,666,2,10,0.001,1304,13
0.598,0.001,684,720,2,10,0.001,1404,13
0.612,0.001,736,768,2,10,0.001,1504,13
0.624,0.001,778,826,2,10,0.001,1604,13
0.636,0.001,830,874,2,10,0.001,1704,13
0.644,0.001,885,919,2,10,0.001,1804,13
0.658,0.001,940,964,2,10,0.001,1904,13
0.658,0.001,986,1018,2,10,0.001,2004,13
0.54,0.001,52,52,2,10,0.001,104,14
0.542,0.001,97,107,2,10,0.001,204,14
0.546,0.001,146,158,2,10,0.001,304,14
0.544,0.001,191,213,2,10,0.001,404,14
0.538,0.001,241,263,2,10,0.001,504,14
0.542,0.001,289,315,2,10,0.001,604,14
0.544,0.001,341,363,2,10,0.001,704,14
0.544,0.001,390,414,2,10,0.001,804,14
0.54,0.001,436,468,2,10,0.001,904,14
0.542,0.001,488,516,2,10,0.001,1004,14
0.53,0.001,540,564,2,10,0.001,1104,14
0.532,0.001,590,614,2,10,0.001,1204,14
0.534,0.001,646,658,2,10,0.001,1304,14
0.536,0.001,694,710,2,10,0.001,1404,14
0.536,0.001,746,758,2,10,0.001,1504,14
0.536,0.001,804,800,2,10,0.001,1604,14
0.53,0.001,843,861,2,10,0.001,1704,14
0.524,0.001,891,913,2,10,0.001,1804,14
0.516,0.001,947,957,2,10,0.001,1904,14
0.516,0.001,997,1007,2,10,0.001,2004,14
0.556,0.001,57,47,2,10,0.001,104,15
0.556,0.001,106,98,2,10,0.001,204,15
0.556,0.001,169,135,2,10,0.001,304,15
0.556,0.001,223,181,2,10,0.001,404,15
0.556,0.001,275,229,2,10,0.001,504,15
0.556,0.001,323,281,2,10,0.001,604,15
0.556,0.001,380,324,2,10,0.001,704,15
0.556,0.001,425,379,2,10,0.001,804,15
0.556,0.001,474,430,2,10,0.001,904,15
0.564,0.001,519,485,2,10,0.001,1004,15
0.566,0.001,568,536,2,10,0.001,1104,15
0.564,0.001,622,582,2,10,0.001,1204,15
0.558,0.001,667,637,2,10,0.001,1304,15
0.562,0.001,716,688,2,10,0.001,1404,15
0.564,0.001,762,742,2,10,0.001,1504,15
0.566,0.001,822,782,2,10,0.001,1604,15
0.572,0.001,866,838,2,10,0.001,1704,15
0.576,0.001,922,882,2,10,0.001,1804,15
0.58,0.001,973,931,2,10,0.001,1904,15
0.586,0.001,1022,982,2,10,0.001,2004,15
0.492,0.001,48,56,2,10,0.001,104,16
0.492,0.001,101,103,2,10,0.001,204,16
0.492,0.001,142,162,2,10,0.001,304,16
0.49,0.001,200,204,2,10,0.001,404,16
0.486,0.001,246,258,2,10,0.001,504,16
0.486,0.001,294,310,2,10,0.001,604,16
0.488,0.001,345,359,2,10,0.001,704,16
0.494,0.001,403,401,2,10,0.001,804,16
0.5,0.001,446,458,2,10,0.001,904,16
0.498,0.001,500,504,2,10,0.001,1004,16
0.5,0.001,547,557,2,10,0.001,1104,16
0.504,0.001,597,607,2,10,0.001,1204,16
0.494,0.001,650,654,2,10,0.001,1304,16
0.502,0.001,702,702,2,10,0.001,1404,16
0.512,0.001,751,753,2,10,0.001,1504,16
0.526,0.001,805,799,2,10,0.001,1604,16
0.536,0.001,861,843,2,10,0.001,1704,16
0.548,0.001,909,895,2,10,0.001,1804,16
0.554,0.001,960,944,2,10,0.001,1904,16
0.554,0.001,1005,999,2,10,0.001,2004,16
0.546,0.001,53,51,2,10,0.001,104,17
0.546,0.001,105,99,2,10,0.001,204,17
0.546,0.001,156,148,2,10,0.001,304,17
0.546,0.001,203,201,2,10,0.001,404,17
0.546,0.001,253,251,2,10,0.001,504,17
0.546,0.001,307,297,2,10,0.001,604,17
0.544,0.001,352,352,2,10,0.001,704,17
0.542,0.001,400,404,2,10,0.001,804,17
0.546,0.001,454,450,2,10,0.001,904,17
0.546,0.001,499,505,2,10,0.001,1004,17
0.542,0.001,554,550,2,10,0.001,1104,17
0.536,0.001,601,603,2,10,0.001,1204,17
0.54,0.001,656,648,2,10,0.001,1304,17
0.548,0.001,706,698,2,10,0.001,1404,17
0.554,0.001,761,743,2,10,0.001,1504,17
0.56,0.001,814,790,2,10,0.001,1604,17
0.57,0.001,861,843,2,10,0.001,1704,17
0.564,0.001,916,888,2,10,0.001,1804,17
0.572,0.001,970,934,2,10,0.001,1904,17
0.586,0.001,1013,991,2,10,0.001,2004,17
0.428,0.001,51,53,2,10,0.001,104,18
0.428,0.001,103,101,2,10,0.001,204,18
0.426,0.001,152,152,2,10,0.001,304,18
0.424,0.001,212,192,2,10,0.001,404,18
0.42,0.001,266,238,2,10,0.001,504,18
0.416,0.001,316,288,2,10,0.001,604,18
0.416,0.001,371,333,2,10,0.001,704,18
0.414,0.001,421,383,2,10,0.001,804,18
0.414,0.001,466,438,2,10,0.001,904,18
0.424,0.001,512,492,2,10,0.001,1004,18
0.42,0.001,551,553,2,10,0.001,1104,18
0.428,0.001,596,608,2,10,0.001,1204,18
0.442,0.001,651,653,2,10,0.001,1304,18
0.46,0.001,699,705,2,10,0.001,1404,18
0.482,0.001,744,760,2,10,0.001,1504,18
0.498,0.001,796,808,2,10,0.001,1604,18
0.496,0.001,848,856,2,10,0.001,1704,18
0.504,0.001,900,904,2,10,0.001,1804,18
0.528,0.001,947,957,2,10,0.001,1904,18
0.528,0.001,995,1009,2,10,0.001,2004,18
0.5,0.001,52,52,2,10,0.001,104,19
0.5,0.001,97,107,2,10,0.001,204,19
0.5,0.001,149,155,2,10,0.001,304,19
0.5,0.001,193,211,2,10,0.001,404,19
0.502,0.001,239,265,2,10,0.001,504,19
0.504,0.001,294,310,2,10,0.001,604,19
0.504,0.001,343,361,2,10,0.001,704,19
0.508,0.001,397,407,2,10,0.001,804,19
0.51,0.001,452,452,2,10,0.001,904,19
0.51,0.001,502,502,2,10,0.001,1004,19
0.51,0.001,558,546,2,10,0.001,1104,19
0.514,0.001,610,594,2,10,0.001,1204,19
0.512,0.001,658,646,2,10,0.001,1304,19
0.518,0.001,713,691,2,10,0.001,1404,19
0.52,0.001,756,748,2,10,0.001,1504,19
0.524,0.001,810,794,2,10,0.001,1604,19
0.532,0.001,865,839,2,10,0.001,1704,19
0.54,0.001,914,890,2,10,0.001,1804,19
0.552,0.001,967,937,2,10,0.001,1904,19
0.564,0.001,1018,986,2,10,0.001,2004,19
0.51,0.001,54,50,2,10,0.001,104,20
0.51,0.001,109,95,2,10,0.001,204,20
0.51,0.001,162,142,2,10,0.001,304,20
0.51,0.001,214,190,2,10,0.001,404,20
0.51,0.001,269,235,2,10,0.001,504,20
0.51,0.001,315,289,2,10,0.001,604,20
0.51,0.001,357,347,2,10,0.001,704,20
0.51,0.001,411,393,2,10,0.001,804,20
0.51,0.001,469,435,2,10,0.001,904,20
0.51,0.001,522,482,2,10,0.001,1004,20
0.51,0.001,578,526,2,10,0.001,1104,20
0.51,0.001,619,585,2,10,0.001,1204,20
0.51,0.001,669,635,2,10,0.001,1304,20
0.51,0.001,717,687,2,10,0.001,1404,20
0.51,0.001,762,742,2,10,0.001,1504,20
0.51,0.001,800,804,2,10,0.001,1604,20
0.51,0.001,845,859,2,10,0.001,1704,20
0.51,0.001,892,912,2,10,0.001,1804,20
0.51,0.001,945,959,2,10,0.001,1904,20
0.51,0.001,997,1007,2,10,0.001,2004,20
0.494,0.001,56,48,2,10,0.01,104,1
0.492,0.001,107,97,2,10,0.01,204,1
0.5,0.001,156,148,2,10,0.01,304,1
0.496,0.001,209,195,2,10,0.01,404,1
0.496,0.001,257,247,2,10,0.01,504,1
0.494,0.001,311,293,2,10,0.01,604,1
0.49,0.001,363,341,2,10,0.01,704,1
0.504,0.001,410,394,2,10,0.01,804,1
0.506,0.001,469,435,2,10,0.01,904,1
0.52,0.001,526,478,2,10,0.01,1004,1
0.524,0.001,574,530,2,10,0.01,1104,1
0.532,0.001,620,584,2,10,0.01,1204,1
0.538,0.001,671,633,2,10,0.01,1304,1
0.53,0.001,720,684,2,10,0.01,1404,1
0.568,0.001,771,733,2,10,0.01,1504,1
0.576,0.001,829,775,2,10,0.01,1604,1
0.592,0.001,876,828,2,10,0.01,1704,1
0.572,0.001,917,887,2,10,0.01,1804,1
0.58,0.001,960,944,2,10,0.01,1904,1
0.584,0.001,1014,990,2,10,0.01,2004,1
0.52,0.001,53,51,2,10,0.01,104,2
0.53,0.001,101,103,2,10,0.01,204,2
0.526,0.001,158,146,2,10,0.01,304,2
0.53,0.001,209,195,2,10,0.01,404,2
0.532,0.001,258,246,2,10,0.01,504,2
0.54,0.001,306,298,2,10,0.01,604,2
0.542,0.001,356,348,2,10,0.01,704,2
0.57,0.001,408,396,2,10,0.01,804,2
0.59,0.001,453,451,2,10,0.01,904,2
0.658,0.001,504,500,2,10,0.01,1004,2
0.72,0.001,556,548,2,10,0.01,1104,2
0.754,0.001,604,600,2,10,0.01,1204,2
0.776,0.001,655,649,2,10,0.01,1304,2
0.81,0.001,703,701,2,10,0.01,1404,2
0.88,0.001,750,754,2,10,0.01,1504,2
0.91,0.001,802,802,2,10,0.01,1604,2
0.918,0.001,857,847,2,10,0.01,1704,2
0.942,0.001,908,896,2,10,0.01,1804,2
0.95,0.001,955,949,2,10,0.01,1904,2
0.952,0.001,1003,1001,2,10,0.01,2004,2
0.576,0.001,53,51,2,10,0.01,104,3
0.586,0.001,104,100,2,10,0.01,204,3
0.598,0.001,159,145,2,10,0.01,304,3
0.606,0.001,216,188,2,10,0.01,404,3
0.624,0.001,265,239,2,10,0.01,504,3
0.652,0.001,309,295,2,10,0.01,604,3
0.656,0.001,348,356,2,10,0.01,704,3
0.668,0.001,393,411,2,10,0.01,804,3
0.686,0.001,448,456,2,10,0.01,904,3
0.72,0.001,498,506,2,10,0.01,1004,3
0.712,0.001,547,557,2,10,0.01,1104,3
0.73,0.001,605,599,2,10,0.01,1204,3
0.73,0.001,647,657,2,10,0.01,1304,3
0.784,0.001,700,704,2,10,0.01,1404,3
0.882,0.001,746,758,2,10,0.01,1504,3
0.896,0.001,805,799,2,10,0.01,1604,3
0.908,0.001,862,842,2,10,0.01,1704,3
0.918,0.001,913,891,2,10,0.01,1804,3
0.92,0.001,964,940,2,10,0.01,1904,3
0.916,0.001,1007,997,2,10,0.01,2004,3
0.398,0.001,47,57,2,10,0.01,104,4
0.432,0.001,91,113,2,10,0.01,204,4
0.434,0.001,144,160,2,10,0.01,304,4
0.456,0.001,191,213,2,10,0.01,404,4
0.502,0.001,242,262,2,10,0.01,504,4
0.532,0.001,297,307,2,10,0.01,604,4
0.578,0.001,342,362,2,10,0.01,704,4
0.61,0.001,385,419,2,10,0.01,804,4
0.642,0.001,438,466,2,10,0.01,904,4
0.664,0.001,487,517,2,10,0.01,1004,4
0.688,0.001,542,562,2,10,0.01,1104,4
0.76,0.001,593,611,2,10,0.01,1204,4
0.786,0.001,642,662,2,10,0.01,1304,4
0.788,0.001,694,710,2,10,0.01,1404,4
0.826,0.001,744,760,2,10,0.01,1504,4
0.842,0.001,789,815,2,10,0.01,1604,4
0.842,0.001,841,863,2,10,0.01,1704,4
0.856,0.001,889,915,2,10,0.01,1804,4
0.882,0.001,936,968,2,10,0.01,1904,4
0.89,0.001,992,1012,2,10,0.01,2004,4
0.44,0.001,43,61,2,10,0.01,104,5
0.442,0.001,86,118,2,10,0.01,204,5
0.456,0.001,146,158,2,10,0.01,304,5
0.476,0.001,194,210,2,10,0.01,404,5
0.492,0.001,239,265,2,10,0.01,504,5
0.496,0.001,289,315,2,10,0.01,604,5
0.548,0.001,339,365,2,10,0.01,704,5
0.626,0.001,392,412,2,10,0.01,804,5
0.708,0.001,444,460,2,10,0.01,904,5
0.776,0.001,495,509,2,10,0.01,1004,5
0.794,0.001,539,565,2,10,0.01,1104,5
0.8,0.001,594,610,2,10,0.01,1204,5
0.798,0.001,653,651,2,10,0.01,1304,5
0.806,0.001,704,700,2,10,0.01,1404,5
0.82,0.001,747,757,2,10,0.01,1504,5
0.84,0.001,783,821,2,10,0.01,1604,5
0.848,0.001,836,868,2,10,0.01,1704,5
0.852,0.001,890,914,2,10,0.01,1804,5
0.854,0.001,938,966,2,10,0.01,1904,5
0.856,0.001,991,1013,2,10,0.01,2004,5
0.45,0.001,41,63,2,10,0.01,104,6
0.484,0.001,92,112,2,10,0.01,204,6
0.522,0.001,141,163,2,10,0.01,304,6
0.54,0.001,194,210,2,10,0.01,404,6
0.544,0.001,252,252,2,10,0.01,504,6
0.556,0.001,299,305,2,10,0.01,604,6
0.574,0.001,349,355,2,10,0.01,704,6
0.594,0.001,403,401,2,10,0.01,804,6
0.574,0.001,445,459,2,10,0.01,904,6
0.586,0.001,493,511,2,10,0.01,1004,6
0.612,0.001,541,563,2,10,0.01,1104,6
0.608,0.001,594,610,2,10,0.01,1204,6
0.6,0.001,644,660,2,10,0.01,1304,6
0.592,0.001,701,703,2,10,0.01,1404,6
0.614,0.001,745,759,2,10,0.01,1504,6
0.662,0.001,801,803,2,10,0.01,1604,6
0.676,0.001,846,858,2,10,0.01,1704,6
0.702,0.001,904,900,2,10,0.01,1804,6
0.71,0.001,955,949,2,10,0.01,1904,6
0.718,0.001,1005,999,2,10,0.01,2004,6
0.508,0.001,49,55,2,10,0.01,104,7
0.51,0.001,103,101,2,10,0.01,204,7
0.536,0.001,144,160,2,10,0.01,304,7
0.552,0.001,199,205,2,10,0.01,404,7
0.576,0.001,253,251,2,10,0.01,504,7
0.578,0.001,297,307,2,10,0.01,604,7
0.586,0.001,347,357,2,10,0.01,704,7
0.606,0.001,396,408,2,10,0.01,804,7
0.616,0.001,451,453,2,10,0.01,904,7
0.634,0.001,505,499,2,10,0.01,1004,7
0.636,0.001,557,547,2,10,0.01,1104,7
0.67,0.001,608,596,2,10,0.01,1204,7
0.694,0.001,656,648,2,10,0.01,1304,7
0.732,0.001,708,696,2,10,0.01,1404,7
0.808,0.001,762,742,2,10,0.01,1504,7
0.834,0.001,805,799,2,10,0.01,1604,7
0.866,0.001,850,854,2,10,0.01,1704,7
0.87,0.001,897,907,2,10,0.01,1804,7
0.844,0.001,942,962,2,10,0.01,1904,7
0.844,0.001,989,1015,2,10,0.01,2004,7
0.52,0.001,49,55,2,10,0.01,104,8
0.558,0.001,90,114,2,10,0.01,204,8
0.572,0.001,140,164,2,10,0.01,304,8
0.564,0.001,193,211,2,10,0.01,404,8
0.538,0.001,245,259,2,10,0.01,504,8
0.688,0.001,292,312,2,10,0.01,604,8
0.744,0.001,345,359,2,10,0.01,704,8
0.76,0.001,389,415,2,10,0.01,804,8
0.806,0.001,444,460,2,10,0.01,904,8
0.842,0.001,497,507,2,10,0.01,1004,8
0.86,0.001,535,569,2,10,0.01,1104,8
0.864,0.001,574,630,2,10,0.01,1204,8
0.866,0.001,632,672,2,10,0.01,1304,8
0.87,0.001,682,722,2,10,0.01,1404,8
0.872,0.001,732,772,2,10,0.01,1504,8
0.876,0.001,780,824,2,10,0.01,1604,8
0.888,0.001,834,870,2,10,0.01,1704,8
0.888,0.001,885,919,2,10,0.01,1804,8
0.89,0.001,936,968,2,10,0.01,1904,8
0.898,0.001,981,1023,2,10,0.01,2004,8
0.38,0.001,55,49,2,10,0.01,104,9
0.5,0.001,100,104,2,10,0.01,204,9
0.52,0.001,150,154,2,10,0.01,304,9
0.534,0.001,202,202,2,10,0.01,404,9
0.554,0.001,260,244,2,10,0.01,504,9
0.602,0.001,299,305,2,10,0.01,604,9
0.618,0.001,355,349,2,10,0.01,704,9
0.63,0.001,400,404,2,10,0.01,804,9
0.654,0.001,449,455,2,10,0.01,904,9
0.696,0.001,508,496,2,10,0.01,1004,9
0.72,0.001,558,546,2,10,0.01,1104,9
0.76,0.001,605,599,2,10,0.01,1204,9
0.802,0.001,657,647,2,10,0.01,1304,9
0.816,0.001,704,700,2,10,0.01,1404,9
0.818,0.001,743,761,2,10,0.01,1504,9
0.83,0.001,789,815,2,10,0.01,1604,9
0.844,0.001,837,867,2,10,0.01,1704,9
0.844,0.001,890,914,2,10,0.01,1804,9
0.848,0.001,934,970,2,10,0.01,1904,9
0.842,0.001,986,1018,2,10,0.01,2004,9
0.572,0.001,55,49,2,10,0.01,104,10
0.568,0.001,108,96,2,10,0.01,204,10
0.568,0.001,164,140,2,10,0.01,304,10
0.572,0.001,210,194,2,10,0.01,404,10
0.594,0.001,258,246,2,10,0.01,504,10
0.604,0.001,316,288,2,10,0.01,604,10
0.604,0.001,362,342,2,10,0.01,704,10
0.63,0.001,406,398,2,10,0.01,804,10
0.66,0.001,457,447,2,10,0.01,904,10
0.72,0.001,510,494,2,10,0.01,1004,10
0.776,0.001,560,544,2,10,0.01,1104,10
0.836,0.001,609,595,2,10,0.01,1204,10
0.858,0.001,663,641,2,10,0.01,1304,10
0.846,0.001,714,690,2,10,0.01,1404,10
0.842,0.001,755,749,2,10,0.01,1504,10
0.844,0.001,800,804,2,10,0.01,1604,10
0.864,0.001,850,854,2,10,0.01,1704,10
0.868,0.001,913,891,2,10,0.01,1804,10
0.87,0.001,957,947,2,10,0.01,1904,10
0.876,0.001,1004,1000,2,10,0.01,2004,10
0.442,0.001,59,45,2,10,0.01,104,11
0.46,0.001,118,86,2,10,0.01,204,11
0.474,0.001,170,134,2,10,0.01,304,11
0.472,0.001,219,185,2,10,0.01,404,11
0.508,0.001,266,238,2,10,0.01,504,11
0.522,0.001,306,298,2,10,0.01,604,11
0.552,0.001,353,351,2,10,0.01,704,11
0.608,0.001,404,400,2,10,0.01,804,11
0.654,0.001,454,450,2,10,0.01,904,11
0.696,0.001,507,497,2,10,0.01,1004,11
0.726,0.001,559,545,2,10,0.01,1104,11
0.75,0.001,611,593,2,10,0.01,1204,11
0.758,0.001,655,649,2,10,0.01,1304,11
0.766,0.001,703,701,2,10,0.01,1404,11
0.802,0.001,753,751,2,10,0.01,1504,11
0.866,0.001,805,799,2,10,0.01,1604,11
0.884,0.001,853,851,2,10,0.01,1704,11
0.888,0.001,899,905,2,10,0.01,1804,11
0.898,0.001,949,955,2,10,0.01,1904,11
0.894,0.001,997,1007,2,10,0.01,2004,11
0.57,0.001,52,52,2,10,0.01,104,12
0.568,0.001,106,98,2,10,0.01,204,12
0.578,0.001,162,142,2,10,0.01,304,12
0.582,0.001,201,203,2,10,0.01,404,12
0.586,0.001,253,251,2,10,0.01,504,12
0.6,0.001,304,300,2,10,0.01,604,12
0.612,0.001,361,343,2,10,0.01,704,12
0.654,0.001,411,393,2,10,0.01,804,12
0.682,0.001,465,439,2,10,0.01,904,12
0.728,0.001,516,488,2,10,0.01,1004,12
0.776,0.001,556,548,2,10,0.01,1104,12
0.824,0.001,596,608,2,10,0.01,1204,12
0.83,0.001,644,660,2,10,0.01,1304,12
0.842,0.001,703,701,2,10,0.01,1404,12
0.85,0.001,754,750,2,10,0.01,1504,12
0.87,0.001,811,793,2,10,0.01,1604,12
0.88,0.001,859,845,2,10,0.01,1704,12
0.896,0.001,908,896,2,10,0.01,1804,12
0.916,0.001,954,950,2,10,0.01,1904,12
0.918,0.001,1004,1000,2,10,0.01,2004,12
0.528,0.001,64,40,2,10,0.01,104,13
0.536,0.001,112,92,2,10,0.01,204,13
0.562,0.001,158,146,2,10,0.01,304,13
0.602,0.001,201,203,2,10,0.01,404,13
0.612,0.001,246,258,2,10,0.01,504,13
0.61,0.001,303,301,2,10,0.01,604,13
0.648,0.001,353,351,2,10,0.01,704,13
0.728,0.001,409,395,2,10,0.01,804,13
0.788,0.001,460,444,2,10,0.01,904,13
0.876,0.001,516,488,2,10,0.01,1004,13
0.922,0.001,563,541,2,10,0.01,1104,13
0.926,0.001,606,598,2,10,0.01,1204,13
0.93,0.001,654,650,2,10,0.01,1304,13
0.92,0.001,704,700,2,10,0.01,1404,13
0.91,0.001,754,750,2,10,0.01,1504,13
0.908,0.001,806,798,2,10,0.01,1604,13
0.9,0.001,853,851,2,10,0.01,1704,13
0.908,0.001,908,896,2,10,0.01,1804,13
0.914,0.001,950,954,2,10,0.01,1904,13
0.916,0.001,1002,1002,2,10,0.01,2004,13
0.494,0.001,56,48,2,10,0.01,104,14
0.51,0.001,99,105,2,10,0.01,204,14
0.554,0.001,151,153,2,10,0.01,304,14
0.556,0.001,215,189,2,10,0.01,404,14
0.558,0.001,269,235,2,10,0.01,504,14
0.58,0.001,314,290,2,10,0.01,604,14
0.592,0.001,358,346,2,10,0.01,704,14
0.63,0.001,401,403,2,10,0.01,804,14
0.646,0.001,447,457,2,10,0.01,904,14
0.672,0.001,497,507,2,10,0.01,1004,14
0.678,0.001,542,562,2,10,0.01,1104,14
0.684,0.001,604,600,2,10,0.01,1204,14
0.694,0.001,651,653,2,10,0.01,1304,14
0.714,0.001,703,701,2,10,0.01,1404,14
0.722,0.001,755,749,2,10,0.01,1504,14
0.744,0.001,801,803,2,10,0.01,1604,14
0.758,0.001,853,851,2,10,0.01,1704,14
0.76,0.001,905,899,2,10,0.01,1804,14
0.786,0.001,944,960,2,10,0.01,1904,14
0.802,0.001,995,1009,2,10,0.01,2004,14
0.516,0.001,56,48,2,10,0.01,104,15
0.518,0.001,106,98,2,10,0.01,204,15
0.518,0.001,157,147,2,10,0.01,304,15
0.52,0.001,212,192,2,10,0.01,404,15
0.544,0.001,260,244,2,10,0.01,504,15
0.594,0.001,318,286,2,10,0.01,604,15
0.624,0.001,368,336,2,10,0.01,704,15
0.6,0.001,422,382,2,10,0.01,804,15
0.592,0.001,473,431,2,10,0.01,904,15
0.598,0.001,517,487,2,10,0.01,1004,15
0.578,0.001,562,542,2,10,0.01,1104,15
0.646,0.001,617,587,2,10,0.01,1204,15
0.706,0.001,669,635,2,10,0.01,1304,15
0.704,0.001,711,693,2,10,0.01,1404,15
0.718,0.001,765,739,2,10,0.01,1504,15
0.742,0.001,811,793,2,10,0.01,1604,15
0.784,0.001,862,842,2,10,0.01,1704,15
0.816,0.001,917,887,2,10,0.01,1804,15
0.822,0.001,965,939,2,10,0.01,1904,15
0.836,0.001,1010,994,2,10,0.01,2004,15
0.488,0.001,57,47,2,10,0.01,104,16
0.488,0.001,106,98,2,10,0.01,204,16
0.488,0.001,154,150,2,10,0.01,304,16
0.488,0.001,208,196,2,10,0.01,404,16
0.492,0.001,261,243,2,10,0.01,504,16
0.516,0.001,315,289,2,10,0.01,604,16
0.558,0.001,362,342,2,10,0.01,704,16
0.624,0.001,412,392,2,10,0.01,804,16
0.628,0.001,457,447,2,10,0.01,904,16
0.672,0.001,517,487,2,10,0.01,1004,16
0.694,0.001,561,543,2,10,0.01,1104,16
0.728,0.001,611,593,2,10,0.01,1204,16
0.754,0.001,664,640,2,10,0.01,1304,16
0.776,0.001,714,690,2,10,0.01,1404,16
0.79,0.001,755,749,2,10,0.01,1504,16
0.798,0.001,804,800,2,10,0.01,1604,16
0.808,0.001,848,856,2,10,0.01,1704,16
0.824,0.001,896,908,2,10,0.01,1804,16
0.84,0.001,946,958,2,10,0.01,1904,16
0.838,0.001,996,1008,2,10,0.01,2004,16
0.474,0.001,46,58,2,10,0.01,104,17
0.474,0.001,84,120,2,10,0.01,204,17
0.474,0.001,133,171,2,10,0.01,304,17
0.504,0.001,194,210,2,10,0.01,404,17
0.61,0.001,249,255,2,10,0.01,504,17
0.624,0.001,315,289,2,10,0.01,604,17
0.61,0.001,362,342,2,10,0.01,704,17
0.596,0.001,413,391,2,10,0.01,804,17
0.644,0.001,456,448,2,10,0.01,904,17
0.75,0.001,502,502,2,10,0.01,1004,17
0.758,0.001,550,554,2,10,0.01,1104,17
0.776,0.001,607,597,2,10,0.01,1204,17
0.828,0.001,651,653,2,10,0.01,1304,17
0.842,0.001,704,700,2,10,0.01,1404,17
0.852,0.001,752,752,2,10,0.01,1504,17
0.87,0.001,808,796,2,10,0.01,1604,17
0.888,0.001,864,840,2,10,0.01,1704,17
0.894,0.001,917,887,2,10,0.01,1804,17
0.89,0.001,965,939,2,10,0.01,1904,17
0.894,0.001,1015,989,2,10,0.01,2004,17
0.444,0.001,47,57,2,10,0.01,104,18
0.428,0.001,98,106,2,10,0.01,204,18
0.44,0.001,143,161,2,10,0.01,304,18
0.498,0.001,192,212,2,10,0.01,404,18
0.504,0.001,238,266,2,10,0.01,504,18
0.588,0.001,296,308,2,10,0.01,604,18
0.6,0.001,344,360,2,10,0.01,704,18
0.596,0.001,391,413,2,10,0.01,804,18
0.596,0.001,442,462,2,10,0.01,904,18
0.61,0.001,494,510,2,10,0.01,1004,18
0.606,0.001,539,565,2,10,0.01,1104,18
0.62,0.001,583,621,2,10,0.01,1204,18
0.638,0.001,636,668,2,10,0.01,1304,18
0.652,0.001,692,712,2,10,0.01,1404,18
0.674,0.001,743,761,2,10,0.01,1504,18
0.682,0.001,796,808,2,10,0.01,1604,18
0.702,0.001,840,864,2,10,0.01,1704,18
0.712,0.001,888,916,2,10,0.01,1804,18
0.738,0.001,947,957,2,10,0.01,1904,18
0.756,0.001,997,1007,2,10,0.01,2004,18
0.49,0.001,56,48,2,10,0.01,104,19
0.498,0.001,118,86,2,10,0.01,204,19
0.498,0.001,166,138,2,10,0.01,304,19
0.502,0.001,219,185,2,10,0.01,404,19
0.468,0.001,256,248,2,10,0.01,504,19
0.494,0.001,304,300,2,10,0.01,604,19
0.568,0.001,358,346,2,10,0.01,704,19
0.608,0.001,400,404,2,10,0.01,804,19
0.61,0.001,453,451,2,10,0.01,904,19
0.616,0.001,501,503,2,10,0.01,1004,19
0.606,0.001,561,543,2,10,0.01,1104,19
0.59,0.001,607,597,2,10,0.01,1204,19
0.574,0.001,660,644,2,10,0.01,1304,19
0.652,0.001,724,680,2,10,0.01,1404,19
0.738,0.001,773,731,2,10,0.01,1504,19
0.782,0.001,826,778,2,10,0.01,1604,19
0.804,0.001,871,833,2,10,0.01,1704,19
0.828,0.001,925,879,2,10,0.01,1804,19
0.846,0.001,979,925,2,10,0.01,1904,19
0.854,0.001,1026,978,2,10,0.01,2004,19
0.486,0.001,52,52,2,10,0.01,104,20
0.502,0.001,99,105,2,10,0.01,204,20
0.53,0.001,142,162,2,10,0.01,304,20
0.532,0.001,194,210,2,10,0.01,404,20
0.552,0.001,243,261,2,10,0.01,504,20
0.564,0.001,299,305,2,10,0.01,604,20
0.552,0.001,354,350,2,10,0.01,704,20
0.538,0.001,398,406,2,10,0.01,804,20
0.54,0.001,453,451,2,10,0.01,904,20
0.548,0.001,503,501,2,10,0.01,1004,20
0.69,0.001,554,550,2,10,0.01,1104,20
0.838,0.001,603,601,2,10,0.01,1204,20
0.858,0.001,655,649,2,10,0.01,1304,20
0.854,0.001,704,700,2,10,0.01,1404,20
0.836,0.001,751,753,2,10,0.01,1504,20
0.854,0.001,800,804,2,10,0.01,1604,20
0.884,0.001,850,854,2,10,0.01,1704,20
0.896,0.001,908,896,2,10,0.01,1804,20
0.914,0.001,955,949,2,10,0.01,1904,20
0.916,0.001,1006,998,2,10,0.01,2004,20
0.492,1e-05,53,51,2,25,0.0001,104,1
0.492,1e-05,109,95,2,25,0.0001,204,1
0.492,1e-05,168,136,2,25,0.0001,304,1
0.492,1e-05,217,187,2,25,0.0001,404,1
0.492,1e-05,264,240,2,25,0.0001,504,1
0.492,1e-05,307,297,2,25,0.0001,604,1
0.492,1e-05,357,347,2,25,0.0001,704,1
0.492,1e-05,411,393,2,25,0.0001,804,1
0.492,1e-05,456,448,2,25,0.0001,904,1
0.492,1e-05,499,505,2,25,0.0001,1004,1
0.492,1e-05,550,554,2,25,0.0001,1104,1
0.492,1e-05,597,607,2,25,0.0001,1204,1
0.492,1e-05,647,657,2,25,0.0001,1304,1
0.492,1e-05,698,706,2,25,0.0001,1404,1
0.492,1e-05,753,751,2,25,0.0001,1504,1
0.492,1e-05,806,798,2,25,0.0001,1604,1
0.492,1e-05,857,847,2,25,0.0001,1704,1
0.492,1e-05,903,901,2,25,0.0001,1804,1
0.492,1e-05,957,947,2,25,0.0001,1904,1
0.492,1e-05,1006,998,2,25,0.0001,2004,1
0.474,1e-05,47,57,2,25,0.0001,104,2
0.474,1e-05,90,114,2,25,0.0001,204,2
0.474,1e-05,139,165,2,25,0.0001,304,2
0.474,1e-05,189,215,2,25,0.0001,404,2
0.474,1e-05,238,266,2,25,0.0001,504,2
0.474,1e-05,282,322,2,25,0.0001,604,2
0.474,1e-05,331,373,2,25,0.0001,704,2
0.474,1e-05,381,423,2,25,0.0001,804,2
0.474,1e-05,436,468,2,25,0.0001,904,2
0.474,1e-05,479,525,2,25,0.0001,1004,2
0.474,1e-05,521,583,2,25,0.0001,1104,2
0.474,1e-05,575,629,2,25,0.0001,1204,2
0.474,1e-05,631,673,2,25,0.0001,1304,2
0.474,1e-05,687,717,2,25,0.0001,1404,2
0.474,1e-05,740,764,2,25,0.0001,1504,2
0.474,1e-05,795,809,2,25,0.0001,1604,2
0.474,1e-05,848,856,2,25,0.0001,1704,2
0.474,1e-05,897,907,2,25,0.0001,1804,2
0.474,1e-05,943,961,2,25,0.0001,1904,2
0.474,1e-05,989,1015,2,25,0.0001,2004,2
0.432,1e-05,58,46,2,25,0.0001,104,3
0.432,1e-05,103,101,2,25,0.0001,204,3
0.432,1e-05,151,153,2,25,0.0001,304,3
0.432,1e-05,205,199,2,25,0.0001,404,3
0.432,1e-05,261,243,2,25,0.0001,504,3
0.432,1e-05,310,294,2,25,0.0001,604,3
0.432,1e-05,366,338,2,25,0.0001,704,3
0.432,1e-05,427,377,2,25,0.0001,804,3
0.434,1e-05,466,438,2,25,0.0001,904,3
0.436,1e-05,510,494,2,25,0.0001,1004,3
0.436,1e-05,569,535,2,25,0.0001,1104,3
0.438,1e-05,617,587,2,25,0.0001,1204,3
0.438,1e-05,667,637,2,25,0.0001,1304,3
0.434,1e-05,712,692,2,25,0.0001,1404,3
0.436,1e-05,769,735,2,25,0.0001,1504,3
0.436,1e-05,816,788,2,25,0.0001,1604,3
0.434,1e-05,861,843,2,25,0.0001,1704,3
0.436,1e-05,911,893,2,25,0.0001,1804,3
0.436,1e-05,956,948,2,25,0.0001,1904,3
0.44,1e-05,1010,994,2,25,0.0001,2004,3
0.468,1e-05,48,56,2,25,0.0001,104,4
0.468,1e-05,91,113,2,25,0.0001,204,4
0.468,1e-05,136,168,2,25,0.0001,304,4
0.468,1e-05,181,223,2,25,0.0001,404,4
0.468,1e-05,225,279,2,25,0.0001,504,4
0.468,1e-05,283,321,2,25,0.0001,604,4
0.468,1e-05,333,371,2,25,0.0001,704,4
0.466,1e-05,387,417,2,25,0.0001,804,4
0.466,1e-05,435,469,2,25,0.0001,904,4
0.466,1e-05,492,512,2,25,0.0001,1004,4
0.468,1e-05,545,559,2,25,0.0001,1104,4
0.468,1e-05,594,610,2,25,0.0001,1204,4
0.47,1e-05,642,662,2,25,0.0001,1304,4
0.47,1e-05,702,702,2,25,0.0001,1404,4
0.472,1e-05,759,745,2,25,0.0001,1504,4
0.478,1e-05,813,791,2,25,0.0001,1604,4
0.478,1e-05,859,845,2,25,0.0001,1704,4
0.478,1e-05,900,904,2,25,0.0001,1804,4
0.478,1e-05,952,952,2,25,0.0001,1904,4
0.48,1e-05,1004,1000,2,25,0.0001,2004,4
0.538,1e-05,54,50,2,25,0.0001,104,5
0.538,1e-05,110,94,2,25,0.0001,204,5
0.538,1e-05,147,157,2,25,0.0001,304,5
0.538,1e-05,197,207,2,25,0.0001,404,5
0.538,1e-05,246,258,2,25,0.0001,504,5
0.54,1e-05,301,303,2,25,0.0001,604,5
0.54,1e-05,354,350,2,25,0.0001,704,5
0.54,1e-05,398,406,2,25,0.0001,804,5
0.54,1e-05,452,452,2,25,0.0001,904,5
0.54,1e-05,500,504,2,25,0.0001,1004,5
0.54,1e-05,554,550,2,25,0.0001,1104,5
0.54,1e-05,602,602,2,25,0.0001,1204,5
0.54,1e-05,650,654,2,25,0.0001,1304,5
0.54,1e-05,705,699,2,25,0.0001,1404,5
0.542,1e-05,756,748,2,25,0.0001,1504,5
0.544,1e-05,808,796,2,25,0.0001,1604,5
0.548,1e-05,860,844,2,25,0.0001,1704,5
0.552,1e-05,911,893,2,25,0.0001,1804,5
0.552,1e-05,960,944,2,25,0.0001,1904,5
0.554,1e-05,1011,993,2,25,0.0001,2004,5
0.574,1e-05,53,51,2,25,0.0001,104,6
0.574,1e-05,100,104,2,25,0.0001,204,6
0.574,1e-05,147,157,2,25,0.0001,304,6
0.576,1e-05,192,212,2,25,0.0001,404,6
0.576,1e-05,236,268,2,25,0.0001,504,6
0.576,1e-05,298,306,2,25,0.0001,604,6
0.576,1e-05,351,353,2,25,0.0001,704,6
0.58,1e-05,403,401,2,25,0.0001,804,6
0.58,1e-05,450,454,2,25,0.0001,904,6
0.58,1e-05,503,501,2,25,0.0001,1004,6
0.58,1e-05,550,554,2,25,0.0001,1104,6
0.58,1e-05,604,600,2,25,0.0001,1204,6
0.58,1e-05,651,653,2,25,0.0001,1304,6
0.582,1e-05,706,698,2,25,0.0001,1404,6
0.582,1e-05,762,742,2,25,0.0001,1504,6
0.584,1e-05,816,788,2,25,0.0001,1604,6
0.584,1e-05,871,833,2,25,0.0001,1704,6
0.586,1e-05,916,888,2,25,0.0001,1804,6
0.59,1e-05,962,942,2,25,0.0001,1904,6
0.592,1e-05,1011,993,2,25,0.0001,2004,6
0.492,1e-05,53,51,2,25,0.0001,104,7
0.494,1e-05,106,98,2,25,0.0001,204,7
0.494,1e-05,155,149,2,25,0.0001,304,7
0.494,1e-05,205,199,2,25,0.0001,404,7
0.494,1e-05,257,247,2,25,0.0001,504,7
0.494,1e-05,299,305,2,25,0.0001,604,7
0.492,1e-05,352,352,2,25,0.0001,704,7
0.492,1e-05,405,399,2,25,0.0001,804,7
0.49,1e-05,465,439,2,25,0.0001,904,7
0.49,1e-05,513,491,2,25,0.0001,1004,7
0.49,1e-05,564,540,2,25,0.0001,1104,7
0.49,1e-05,608,596,2,25,0.0001,1204,7
0.49,1e-05,653,651,2,25,0.0001,1304,7
0.49,1e-05,709,695,2,25,0.0001,1404,7
0.49,1e-05,761,743,2,25,0.0001,1504,7
0.49,1e-05,812,792,2,25,0.0001,1604,7
0.49,1e-05,862,842,2,25,0.0001,1704,7
0.49,1e-05,913,891,2,25,0.0001,1804,7
0.49,1e-05,963,941,2,25,0.0001,1904,7
0.49,1e-05,1010,994,2,25,0.0001,2004,7
0.614,1e-05,46,58,2,25,0.0001,104,8
0.614,1e-05,101,103,2,25,0.0001,204,8
0.614,1e-05,158,146,2,25,0.0001,304,8
0.614,1e-05,207,197,2,25,0.0001,404,8
0.614,1e-05,257,247,2,25,0.0001,504,8
0.614,1e-05,309,295,2,25,0.0001,604,8
0.614,1e-05,362,342,2,25,0.0001,704,8
0.614,1e-05,408,396,2,25,0.0001,804,8
0.614,1e-05,461,443,2,25,0.0001,904,8
0.614,1e-05,515,489,2,25,0.0001,1004,8
0.616,1e-05,567,537,2,25,0.0001,1104,8
0.616,1e-05,621,583,2,25,0.0001,1204,8
0.616,1e-05,668,636,2,25,0.0001,1304,8
0.616,1e-05,724,680,2,25,0.0001,1404,8
0.62,1e-05,771,733,2,25,0.0001,1504,8
0.62,1e-05,815,789,2,25,0.0001,1604,8
0.62,1e-05,860,844,2,25,0.0001,1704,8
0.62,1e-05,910,894,2,25,0.0001,1804,8
0.622,1e-05,961,943,2,25,0.0001,1904,8
0.622,1e-05,1014,990,2,25,0.0001,2004,8
0.518,1e-05,49,55,2,25,0.0001,104,9
0.52,1e-05,100,104,2,25,0.0001,204,9
0.52,1e-05,159,145,2,25,0.0001,304,9
0.52,1e-05,211,193,2,25,0.0001,404,9
0.52,1e-05,252,252,2,25,0.0001,504,9
0.52,1e-05,300,304,2,25,0.0001,604,9
0.52,1e-05,339,365,2,25,0.0001,704,9
0.52,1e-05,393,411,2,25,0.0001,804,9
0.52,1e-05,442,462,2,25,0.0001,904,9
0.522,1e-05,496,508,2,25,0.0001,1004,9
0.524,1e-05,547,557,2,25,0.0001,1104,9
0.524,1e-05,592,612,2,25,0.0001,1204,9
0.524,1e-05,644,660,2,25,0.0001,1304,9
0.526,1e-05,696,708,2,25,0.0001,1404,9
0.526,1e-05,751,753,2,25,0.0001,1504,9
0.526,1e-05,808,796,2,25,0.0001,1604,9
0.526,1e-05,851,853,2,25,0.0001,1704,9
0.526,1e-05,903,901,2,25,0.0001,1804,9
0.526,1e-05,948,956,2,25,0.0001,1904,9
0.528,1e-05,1002,1002,2,25,0.0001,2004,9
0.562,1e-05,56,48,2,25,0.0001,104,10
0.562,1e-05,105,99,2,25,0.0001,204,10
0.56,1e-05,155,149,2,25,0.0001,304,10
0.562,1e-05,212,192,2,25,0.0001,404,10
0.562,1e-05,263,241,2,25,0.0001,504,10
0.562,1e-05,319,285,2,25,0.0001,604,10
0.562,1e-05,371,333,2,25,0.0001,704,10
0.566,1e-05,425,379,2,25,0.0001,804,10
0.566,1e-05,473,431,2,25,0.0001,904,10
0.568,1e-05,522,482,2,25,0.0001,1004,10
0.57,1e-05,570,534,2,25,0.0001,1104,10
0.57,1e-05,615,589,2,25,0.0001,1204,10
0.57,1e-05,671,633,2,25,0.0001,1304,10
0.57,1e-05,723,681,2,25,0.0001,1404,10
0.572,1e-05,776,728,2,25,0.0001,1504,10
0.574,1e-05,822,782,2,25,0.0001,1604,10
0.578,1e-05,875,829,2,25,0.0001,1704,10
0.578,1e-05,924,880,2,25,0.0001,1804,10
0.58,1e-05,972,932,2,25,0.0001,1904,10
0.58,1e-05,1017,987,2,25,0.0001,2004,10
0.5,1e-05,51,53,2,25,0.0001,104,11
0.5,1e-05,102,102,2,25,0.0001,204,11
0.5,1e-05,159,145,2,25,0.0001,304,11
0.5,1e-05,211,193,2,25,0.0001,404,11
0.5,1e-05,264,240,2,25,0.0001,504,11
0.5,1e-05,312,292,2,25,0.0001,604,11
0.5,1e-05,370,334,2,25,0.0001,704,11
0.5,1e-05,416,388,2,25,0.0001,804,11
0.5,1e-05,474,430,2,25,0.0001,904,11
0.5,1e-05,528,476,2,25,0.0001,1004,11
0.5,1e-05,579,525,2,25,0.0001,1104,11
0.5,1e-05,624,580,2,25,0.0001,1204,11
0.5,1e-05,673,631,2,25,0.0001,1304,11
0.5,1e-05,715,689,2,25,0.0001,1404,11
0.5,1e-05,762,742,2,25,0.0001,1504,11
0.5,1e-05,808,796,2,25,0.0001,1604,11
0.5,1e-05,856,848,2,25,0.0001,1704,11
0.5,1e-05,905,899,2,25,0.0001,1804,11
0.5,1e-05,950,954,2,25,0.0001,1904,11
0.5,1e-05,1002,1002,2,25,0.0001,2004,11
0.502,1e-05,46,58,2,25,0.0001,104,12
0.502,1e-05,90,114,2,25,0.0001,204,12
0.502,1e-05,138,166,2,25,0.0001,304,12
0.502,1e-05,194,210,2,25,0.0001,404,12
0.502,1e-05,257,247,2,25,0.0001,504,12
0.502,1e-05,310,294,2,25,0.0001,604,12
0.502,1e-05,350,354,2,25,0.0001,704,12
0.502,1e-05,402,402,2,25,0.0001,804,12
0.502,1e-05,454,450,2,25,0.0001,904,12
0.502,1e-05,503,501,2,25,0.0001,1004,12
0.502,1e-05,559,545,2,25,0.0001,1104,12
0.502,1e-05,614,590,2,25,0.0001,1204,12
0.502,1e-05,661,643,2,25,0.0001,1304,12
0.502,1e-05,714,690,2,25,0.0001,1404,12
0.502,1e-05,763,741,2,25,0.0001,1504,12
0.502,1e-05,813,791,2,25,0.0001,1604,12
0.502,1e-05,858,846,2,25,0.0001,1704,12
0.502,1e-05,904,900,2,25,0.0001,1804,12
0.502,1e-05,951,953,2,25,0.0001,1904,12
0.502,1e-05,1001,1003,2,25,0.0001,2004,12
0.59,1e-05,54,50,2,25,0.0001,104,13
0.59,1e-05,103,101,2,25,0.0001,204,13
0.59,1e-05,147,157,2,25,0.0001,304,13
0.59,1e-05,202,202,2,25,0.0001,404,13
0.59,1e-05,251,253,2,25,0.0001,504,13
0.59,1e-05,298,306,2,25,0.0001,604,13
0.59,1e-05,355,349,2,25,0.0001,704,13
0.59,1e-05,417,387,2,25,0.0001,804,13
0.59,1e-05,464,440,2,25,0.0001,904,13
0.59,1e-05,509,495,2,25,0.0001,1004,13
0.59,1e-05,565,539,2,25,0.0001,1104,13
0.592,1e-05,605,599,2,25,0.0001,1204,13
0.592,1e-05,656,648,2,25,0.0001,1304,13
0.59,1e-05,705,699,2,25,0.0001,1404,13
0.59,1e-05,753,751,2,25,0.0001,1504,13
0.592,1e-05,804,800,2,25,0.0001,1604,13
0.592,1e-05,855,849,2,25,0.0001,1704,13
0.592,1e-05,906,898,2,25,0.0001,1804,13
0.592,1e-05,948,956,2,25,0.0001,1904,13
0.592,1e-05,1001,1003,2,25,0.0001,2004,13
0.512,1e-05,51,53,2,25,0.0001,104,14
0.512,1e-05,97,107,2,25,0.0001,204,14
0.512,1e-05,149,155,2,25,0.0001,304,14
0.512,1e-05,190,214,2,25,0.0001,404,14
0.51,1e-05,235,269,2,25,0.0001,504,14
0.51,1e-05,294,310,2,25,0.0001,604,14
0.51,1e-05,347,357,2,25,0.0001,704,14
0.51,1e-05,394,410,2,25,0.0001,804,14
0.51,1e-05,441,463,2,25,0.0001,904,14
0.51,1e-05,491,513,2,25,0.0001,1004,14
0.514,1e-05,537,567,2,25,0.0001,1104,14
0.516,1e-05,581,623,2,25,0.0001,1204,14
0.52,1e-05,633,671,2,25,0.0001,1304,14
0.52,1e-05,677,727,2,25,0.0001,1404,14
0.52,1e-05,723,781,2,25,0.0001,1504,14
0.52,1e-05,774,830,2,25,0.0001,1604,14
0.52,1e-05,821,883,2,25,0.0001,1704,14
0.52,1e-05,871,933,2,25,0.0001,1804,14
0.526,1e-05,925,979,2,25,0.0001,1904,14
0.526,1e-05,977,1027,2,25,0.0001,2004,14
0.508,1e-05,50,54,2,25,0.0001,104,15
0.508,1e-05,101,103,2,25,0.0001,204,15
0.506,1e-05,155,149,2,25,0.0001,304,15
0.506,1e-05,202,202,2,25,0.0001,404,15
0.508,1e-05,250,254,2,25,0.0001,504,15
0.508,1e-05,291,313,2,25,0.0001,604,15
0.508,1e-05,343,361,2,25,0.0001,704,15
0.51,1e-05,399,405,2,25,0.0001,804,15
0.51,1e-05,451,453,2,25,0.0001,904,15
0.51,1e-05,494,510,2,25,0.0001,1004,15
0.512,1e-05,544,560,2,25,0.0001,1104,15
0.512,1e-05,588,616,2,25,0.0001,1204,15
0.512,1e-05,640,664,2,25,0.0001,1304,15
0.514,1e-05,693,711,2,25,0.0001,1404,15
0.514,1e-05,740,764,2,25,0.0001,1504,15
0.514,1e-05,799,805,2,25,0.0001,1604,15
0.514,1e-05,849,855,2,25,0.0001,1704,15
0.514,1e-05,892,912,2,25,0.0001,1804,15
0.514,1e-05,948,956,2,25,0.0001,1904,15
0.514,1e-05,1001,1003,2,25,0.0001,2004,15
0.408,1e-05,48,56,2,25,0.0001,104,16
0.408,1e-05,93,111,2,25,0.0001,204,16
0.408,1e-05,137,167,2,25,0.0001,304,16
0.41,1e-05,185,219,2,25,0.0001,404,16
0.41,1e-05,238,266,2,25,0.0001,504,16
0.41,1e-05,289,315,2,25,0.0001,604,16
0.41,1e-05,340,364,2,25,0.0001,704,16
0.41,1e-05,389,415,2,25,0.0001,804,16
0.41,1e-05,443,461,2,25,0.0001,904,16
0.41,1e-05,490,514,2,25,0.0001,1004,16
0.412,1e-05,541,563,2,25,0.0001,1104,16
0.414,1e-05,588,616,2,25,0.0001,1204,16
0.414,1e-05,641,663,2,25,0.0001,1304,16
0.414,1e-05,688,716,2,25,0.0001,1404,16
0.414,1e-05,740,764,2,25,0.0001,1504,16
0.412,1e-05,792,812,2,25,0.0001,1604,16
0.414,1e-05,844,860,2,25,0.0001,1704,16
0.418,1e-05,892,912,2,25,0.0001,1804,16
0.42,1e-05,940,964,2,25,0.0001,1904,16
0.422,1e-05,988,1016,2,25,0.0001,2004,16
0.494,1e-05,47,57,2,25,0.0001,104,17
0.498,1e-05,96,108,2,25,0.0001,204,17
0.502,1e-05,146,158,2,25,0.0001,304,17
0.506,1e-05,187,217,2,25,0.0001,404,17
0.506,1e-05,239,265,2,25,0.0001,504,17
0.508,1e-05,288,316,2,25,0.0001,604,17
0.508,1e-05,335,369,2,25,0.0001,704,17
0.512,1e-05,386,418,2,25,0.0001,804,17
0.514,1e-05,437,467,2,25,0.0001,904,17
0.52,1e-05,490,514,2,25,0.0001,1004,17
0.522,1e-05,535,569,2,25,0.0001,1104,17
0.522,1e-05,589,615,2,25,0.0001,1204,17
0.524,1e-05,635,669,2,25,0.0001,1304,17
0.524,1e-05,688,716,2,25,0.0001,1404,17
0.522,1e-05,746,758,2,25,0.0001,1504,17
0.522,1e-05,802,802,2,25,0.0001,1604,17
0.522,1e-05,845,859,2,25,0.0001,1704,17
0.524,1e-05,898,906,2,25,0.0001,1804,17
0.524,1e-05,953,951,2,25,0.0001,1904,17
0.526,1e-05,1004,1000,2,25,0.0001,2004,17
0.514,1e-05,55,49,2,25,0.0001,104,18
0.514,1e-05,111,93,2,25,0.0001,204,18
0.514,1e-05,159,145,2,25,0.0001,304,18
0.514,1e-05,203,201,2,25,0.0001,404,18
0.514,1e-05,243,261,2,25,0.0001,504,18
0.514,1e-05,294,310,2,25,0.0001,604,18
0.514,1e-05,339,365,2,25,0.0001,704,18
0.514,1e-05,384,420,2,25,0.0001,804,18
0.514,1e-05,435,469,2,25,0.0001,904,18
0.514,1e-05,489,515,2,25,0.0001,1004,18
0.514,1e-05,538,566,2,25,0.0001,1104,18
0.514,1e-05,597,607,2,25,0.0001,1204,18
0.514,1e-05,643,661,2,25,0.0001,1304,18
0.514,1e-05,692,712,2,25,0.0001,1404,18
0.514,1e-05,744,760,2,25,0.0001,1504,18
0.514,1e-05,794,810,2,25,0.0001,1604,18
0.514,1e-05,843,861,2,25,0.0001,1704,18
0.514,1e-05,893,911,2,25,0.0001,1804,18
0.514,1e-05,945,959,2,25,0.0001,1904,18
0.514,1e-05,1009,995,2,25,0.0001,2004,18
0.418,1e-05,52,52,2,25,0.0001,104,19
0.418,1e-05,99,105,2,25,0.0001,204,19
0.418,1e-05,139,165,2,25,0.0001,304,19
0.414,1e-05,185,219,2,25,0.0001,404,19
0.418,1e-05,237,267,2,25,0.0001,504,19
0.422,1e-05,290,314,2,25,0.0001,604,19
0.422,1e-05,344,360,2,25,0.0001,704,19
0.426,1e-05,386,418,2,25,0.0001,804,19
0.426,1e-05,435,469,2,25,0.0001,904,19
0.43,1e-05,491,513,2,25,0.0001,1004,19
0.43,1e-05,543,561,2,25,0.0001,1104,19
0.43,1e-05,602,602,2,25,0.0001,1204,19
0.43,1e-05,644,660,2,25,0.0001,1304,19
0.434,1e-05,701,703,2,25,0.0001,1404,19
0.434,1e-05,757,747,2,25,0.0001,1504,19
0.434,1e-05,803,801,2,25,0.0001,1604,19
0.434,1e-05,845,859,2,25,0.0001,1704,19
0.434,1e-05,897,907,2,25,0.0001,1804,19
0.442,1e-05,953,951,2,25,0.0001,1904,19
0.448,1e-05,1005,999,2,25,0.0001,2004,19
0.56,1e-05,44,60,2,25,0.0001,104,20
0.56,1e-05,102,102,2,25,0.0001,204,20
0.562,1e-05,162,142,2,25,0.0001,304,20
0.562,1e-05,207,197,2,25,0.0001,404,20
0.562,1e-05,257,247,2,25,0.0001,504,20
0.562,1e-05,311,293,2,25,0.0001,604,20
0.562,1e-05,363,341,2,25,0.0001,704,20
0.562,1e-05,415,389,2,25,0.0001,804,20
0.564,1e-05,460,444,2,25,0.0001,904,20
0.564,1e-05,501,503,2,25,0.0001,1004,20
0.568,1e-05,546,558,2,25,0.0001,1104,20
0.568,1e-05,597,607,2,25,0.0001,1204,20
0.568,1e-05,641,663,2,25,0.0001,1304,20
0.57,1e-05,683,721,2,25,0.0001,1404,20
0.574,1e-05,739,765,2,25,0.0001,1504,20
0.58,1e-05,791,813,2,25,0.0001,1604,20
0.586,1e-05,827,877,2,25,0.0001,1704,20
0.586,1e-05,885,919,2,25,0.0001,1804,20
0.59,1e-05,930,974,2,25,0.0001,1904,20
0.594,1e-05,992,1012,2,25,0.0001,2004,20
0.472,1e-05,57,47,2,25,0.001,104,1
0.474,1e-05,98,106,2,25,0.001,204,1
0.476,1e-05,148,156,2,25,0.001,304,1
0.478,1e-05,198,206,2,25,0.001,404,1
0.478,1e-05,250,254,2,25,0.001,504,1
0.476,1e-05,305,299,2,25,0.001,604,1
0.474,1e-05,351,353,2,25,0.001,704,1
0.482,1e-05,401,403,2,25,0.001,804,1
0.496,1e-05,443,461,2,25,0.001,904,1
0.516,1e-05,498,506,2,25,0.001,1004,1
0.526,1e-05,546,558,2,25,0.001,1104,1
0.536,1e-05,601,603,2,25,0.001,1204,1
0.55,1e-05,651,653,2,25,0.001,1304,1
0.562,1e-05,691,713,2,25,0.001,1404,1
0.596,1e-05,740,764,2,25,0.001,1504,1
0.62,1e-05,796,808,2,25,0.001,1604,1
0.648,1e-05,856,848,2,25,0.001,1704,1
0.684,1e-05,910,894,2,25,0.001,1804,1
0.716,1e-05,954,950,2,25,0.001,1904,1
0.744,1e-05,1007,997,2,25,0.001,2004,1
0.558,1e-05,45,59,2,25,0.001,104,2
0.554,1e-05,101,103,2,25,0.001,204,2
0.552,1e-05,156,148,2,25,0.001,304,2
0.55,1e-05,207,197,2,25,0.001,404,2
0.558,1e-05,253,251,2,25,0.001,504,2
0.554,1e-05,301,303,2,25,0.001,604,2
0.554,1e-05,353,351,2,25,0.001,704,2
0.558,1e-05,404,400,2,25,0.001,804,2
0.552,1e-05,458,446,2,25,0.001,904,2
0.56,1e-05,492,512,2,25,0.001,1004,2
0.592,1e-05,547,557,2,25,0.001,1104,2
0.628,1e-05,603,601,2,25,0.001,1204,2
0.648,1e-05,650,654,2,25,0.001,1304,2
0.698,1e-05,697,707,2,25,0.001,1404,2
0.734,1e-05,747,757,2,25,0.001,1504,2
0.732,1e-05,793,811,2,25,0.001,1604,2
0.75,1e-05,850,854,2,25,0.001,1704,2
0.752,1e-05,904,900,2,25,0.001,1804,2
0.748,1e-05,950,954,2,25,0.001,1904,2
0.754,1e-05,999,1005,2,25,0.001,2004,2
0.53,1e-05,56,48,2,25,0.001,104,3
0.53,1e-05,108,96,2,25,0.001,204,3
0.53,1e-05,155,149,2,25,0.001,304,3
0.53,1e-05,211,193,2,25,0.001,404,3
0.53,1e-05,259,245,2,25,0.001,504,3
0.53,1e-05,305,299,2,25,0.001,604,3
0.53,1e-05,361,343,2,25,0.001,704,3
0.53,1e-05,409,395,2,25,0.001,804,3
0.53,1e-05,457,447,2,25,0.001,904,3
0.53,1e-05,513,491,2,25,0.001,1004,3
0.53,1e-05,569,535,2,25,0.001,1104,3
0.53,1e-05,611,593,2,25,0.001,1204,3
0.53,1e-05,653,651,2,25,0.001,1304,3
0.534,1e-05,702,702,2,25,0.001,1404,3
0.546,1e-05,747,757,2,25,0.001,1504,3
0.558,1e-05,793,811,2,25,0.001,1604,3
0.56,1e-05,838,866,2,25,0.001,1704,3
0.622,1e-05,884,920,2,25,0.001,1804,3
0.684,1e-05,935,969,2,25,0.001,1904,3
0.758,1e-05,987,1017,2,25,0.001,2004,3
0.498,1e-05,58,46,2,25,0.001,104,4
0.498,1e-05,117,87,2,25,0.001,204,4
0.502,1e-05,165,139,2,25,0.001,304,4
0.51,1e-05,223,181,2,25,0.001,404,4
0.512,1e-05,267,237,2,25,0.001,504,4
0.516,1e-05,317,287,2,25,0.001,604,4
0.518,1e-05,360,344,2,25,0.001,704,4
0.518,1e-05,417,387,2,25,0.001,804,4
0.52,1e-05,460,444,2,25,0.001,904,4
0.518,1e-05,508,496,2,25,0.001,1004,4
0.53,1e-05,552,552,2,25,0.001,1104,4
0.548,1e-05,597,607,2,25,0.001,1204,4
0.572,1e-05,641,663,2,25,0.001,1304,4
0.592,1e-05,690,714,2,25,0.001,1404,4
0.604,1e-05,744,760,2,25,0.001,1504,4
0.636,1e-05,795,809,2,25,0.001,1604,4
0.664,1e-05,840,864,2,25,0.001,1704,4
0.688,1e-05,884,920,2,25,0.001,1804,4
0.704,1e-05,935,969,2,25,0.001,1904,4
0.714,1e-05,988,1016,2,25,0.001,2004,4
0.448,1e-05,57,47,2,25,0.001,104,5
0.446,1e-05,114,90,2,25,0.001,204,5
0.448,1e-05,164,140,2,25,0.001,304,5
0.446,1e-05,212,192,2,25,0.001,404,5
0.448,1e-05,268,236,2,25,0.001,504,5
0.452,1e-05,314,290,2,25,0.001,604,5
0.456,1e-05,369,335,2,25,0.001,704,5
0.462,1e-05,418,386,2,25,0.001,804,5
0.476,1e-05,464,440,2,25,0.001,904,5
0.482,1e-05,514,490,2,25,0.001,1004,5
0.484,1e-05,559,545,2,25,0.001,1104,5
0.492,1e-05,612,592,2,25,0.001,1204,5
0.494,1e-05,662,642,2,25,0.001,1304,5
0.506,1e-05,715,689,2,25,0.001,1404,5
0.514,1e-05,765,739,2,25,0.001,1504,5
0.53,1e-05,810,794,2,25,0.001,1604,5
0.54,1e-05,850,854,2,25,0.001,1704,5
0.548,1e-05,897,907,2,25,0.001,1804,5
0.552,1e-05,944,960,2,25,0.001,1904,5
0.56,1e-05,1005,999,2,25,0.001,2004,5
0.502,1e-05,52,52,2,25,0.001,104,6
0.506,1e-05,101,103,2,25,0.001,204,6
0.506,1e-05,152,152,2,25,0.001,304,6
0.504,1e-05,201,203,2,25,0.001,404,6
0.502,1e-05,249,255,2,25,0.001,504,6
0.502,1e-05,295,309,2,25,0.001,604,6
0.506,1e-05,346,358,2,25,0.001,704,6
0.512,1e-05,399,405,2,25,0.001,804,6
0.508,1e-05,447,457,2,25,0.001,904,6
0.502,1e-05,506,498,2,25,0.001,1004,6
0.51,1e-05,558,546,2,25,0.001,1104,6
0.504,1e-05,610,594,2,25,0.001,1204,6
0.504,1e-05,659,645,2,25,0.001,1304,6
0.506,1e-05,711,693,2,25,0.001,1404,6
0.506,1e-05,754,750,2,25,0.001,1504,6
0.504,1e-05,796,808,2,25,0.001,1604,6
0.496,1e-05,846,858,2,25,0.001,1704,6
0.522,1e-05,896,908,2,25,0.001,1804,6
0.518,1e-05,946,958,2,25,0.001,1904,6
0.526,1e-05,999,1005,2,25,0.001,2004,6
0.52,1e-05,49,55,2,25,0.001,104,7
0.524,1e-05,89,115,2,25,0.001,204,7
0.528,1e-05,138,166,2,25,0.001,304,7
0.532,1e-05,185,219,2,25,0.001,404,7
0.536,1e-05,238,266,2,25,0.001,504,7
0.542,1e-05,288,316,2,25,0.001,604,7
0.54,1e-05,339,365,2,25,0.001,704,7
0.544,1e-05,385,419,2,25,0.001,804,7
0.548,1e-05,440,464,2,25,0.001,904,7
0.552,1e-05,492,512,2,25,0.001,1004,7
0.558,1e-05,534,570,2,25,0.001,1104,7
0.568,1e-05,583,621,2,25,0.001,1204,7
0.578,1e-05,628,676,2,25,0.001,1304,7
0.59,1e-05,676,728,2,25,0.001,1404,7
0.614,1e-05,724,780,2,25,0.001,1504,7
0.62,1e-05,774,830,2,25,0.001,1604,7
0.626,1e-05,829,875,2,25,0.001,1704,7
0.628,1e-05,880,924,2,25,0.001,1804,7
0.634,1e-05,943,961,2,25,0.001,1904,7
0.642,1e-05,990,1014,2,25,0.001,2004,7
0.492,1e-05,49,55,2,25,0.001,104,8
0.492,1e-05,111,93,2,25,0.001,204,8
0.492,1e-05,164,140,2,25,0.001,304,8
0.492,1e-05,217,187,2,25,0.001,404,8
0.492,1e-05,266,238,2,25,0.001,504,8
0.492,1e-05,314,290,2,25,0.001,604,8
0.492,1e-05,366,338,2,25,0.001,704,8
0.496,1e-05,416,388,2,25,0.001,804,8
0.514,1e-05,456,448,2,25,0.001,904,8
0.536,1e-05,507,497,2,25,0.001,1004,8
0.536,1e-05,563,541,2,25,0.001,1104,8
0.556,1e-05,607,597,2,25,0.001,1204,8
0.55,1e-05,657,647,2,25,0.001,1304,8
0.562,1e-05,714,690,2,25,0.001,1404,8
0.57,1e-05,758,746,2,25,0.001,1504,8
0.584,1e-05,804,800,2,25,0.001,1604,8
0.596,1e-05,860,844,2,25,0.001,1704,8
0.614,1e-05,905,899,2,25,0.001,1804,8
0.646,1e-05,955,949,2,25,0.001,1904,8
0.676,1e-05,1006,998,2,25,0.001,2004,8
0.482,1e-05,58,46,2,25,0.001,104,9
0.482,1e-05,104,100,2,25,0.001,204,9
0.482,1e-05,159,145,2,25,0.001,304,9
0.482,1e-05,207,197,2,25,0.001,404,9
0.482,1e-05,257,247,2,25,0.001,504,9
0.482,1e-05,310,294,2,25,0.001,604,9
0.482,1e-05,359,345,2,25,0.001,704,9
0.482,1e-05,418,386,2,25,0.001,804,9
0.482,1e-05,463,441,2,25,0.001,904,9
0.488,1e-05,514,490,2,25,0.001,1004,9
0.506,1e-05,568,536,2,25,0.001,1104,9
0.516,1e-05,620,584,2,25,0.001,1204,9
0.51,1e-05,674,630,2,25,0.001,1304,9
0.522,1e-05,725,679,2,25,0.001,1404,9
0.53,1e-05,774,730,2,25,0.001,1504,9
0.538,1e-05,822,782,2,25,0.001,1604,9
0.556,1e-05,869,835,2,25,0.001,1704,9
0.57,1e-05,917,887,2,25,0.001,1804,9
0.588,1e-05,964,940,2,25,0.001,1904,9
0.588,1e-05,1011,993,2,25,0.001,2004,9
0.482,1e-05,47,57,2,25,0.001,104,10
0.484,1e-05,103,101,2,25,0.001,204,10
0.484,1e-05,156,148,2,25,0.001,304,10
0.488,1e-05,204,200,2,25,0.001,404,10
0.484,1e-05,259,245,2,25,0.001,504,10
0.484,1e-05,310,294,2,25,0.001,604,10
0.478,1e-05,356,348,2,25,0.001,704,10
0.484,1e-05,402,402,2,25,0.001,804,10
0.488,1e-05,455,449,2,25,0.001,904,10
0.498,1e-05,500,504,2,25,0.001,1004,10
0.502,1e-05,548,556,2,25,0.001,1104,10
0.512,1e-05,591,613,2,25,0.001,1204,10
0.518,1e-05,641,663,2,25,0.001,1304,10
0.5,1e-05,693,711,2,25,0.001,1404,10
0.51,1e-05,737,767,2,25,0.001,1504,10
0.512,1e-05,789,815,2,25,0.001,1604,10
0.536,1e-05,847,857,2,25,0.001,1704,10
0.558,1e-05,895,909,2,25,0.001,1804,10
0.598,1e-05,954,950,2,25,0.001,1904,10
0.612,1e-05,1000,1004,2,25,0.001,2004,10
0.522,1e-05,50,54,2,25,0.001,104,11
0.522,1e-05,102,102,2,25,0.001,204,11
0.522,1e-05,151,153,2,25,0.001,304,11
0.522,1e-05,197,207,2,25,0.001,404,11
0.522,1e-05,251,253,2,25,0.001,504,11
0.522,1e-05,302,302,2,25,0.001,604,11
0.522,1e-05,354,350,2,25,0.001,704,11
0.522,1e-05,406,398,2,25,0.001,804,11
0.522,1e-05,456,448,2,25,0.001,904,11
0.522,1e-05,507,497,2,25,0.001,1004,11
0.522,1e-05,566,538,2,25,0.001,1104,11
0.522,1e-05,617,587,2,25,0.001,1204,11
0.522,1e-05,663,641,2,25,0.001,1304,11
0.528,1e-05,714,690,2,25,0.001,1404,11
0.536,1e-05,765,739,2,25,0.001,1504,11
0.552,1e-05,820,784,2,25,0.001,1604,11
0.562,1e-05,867,837,2,25,0.001,1704,11
0.612,1e-05,910,894,2,25,0.001,1804,11
0.66,1e-05,962,942,2,25,0.001,1904,11
0.712,1e-05,1013,991,2,25,0.001,2004,11
0.406,1e-05,47,57,2,25,0.001,104,12
0.402,1e-05,95,109,2,25,0.001,204,12
0.394,1e-05,140,164,2,25,0.001,304,12
0.384,1e-05,192,212,2,25,0.001,404,12
0.382,1e-05,241,263,2,25,0.001,504,12
0.396,1e-05,292,312,2,25,0.001,604,12
0.422,1e-05,348,356,2,25,0.001,704,12
0.448,1e-05,396,408,2,25,0.001,804,12
0.442,1e-05,455,449,2,25,0.001,904,12
0.444,1e-05,507,497,2,25,0.001,1004,12
0.446,1e-05,557,547,2,25,0.001,1104,12
0.446,1e-05,607,597,2,25,0.001,1204,12
0.45,1e-05,656,648,2,25,0.001,1304,12
0.464,1e-05,704,700,2,25,0.001,1404,12
0.466,1e-05,764,740,2,25,0.001,1504,12
0.48,1e-05,822,782,2,25,0.001,1604,12
0.494,1e-05,866,838,2,25,0.001,1704,12
0.492,1e-05,914,890,2,25,0.001,1804,12
0.522,1e-05,961,943,2,25,0.001,1904,12
0.548,1e-05,1010,994,2,25,0.001,2004,12
0.486,1e-05,54,50,2,25,0.001,104,13
0.486,1e-05,99,105,2,25,0.001,204,13
0.486,1e-05,157,147,2,25,0.001,304,13
0.486,1e-05,208,196,2,25,0.001,404,13
0.486,1e-05,258,246,2,25,0.001,504,13
0.486,1e-05,302,302,2,25,0.001,604,13
0.486,1e-05,352,352,2,25,0.001,704,13
0.486,1e-05,404,400,2,25,0.001,804,13
0.486,1e-05,462,442,2,25,0.001,904,13
0.486,1e-05,503,501,2,25,0.001,1004,13
0.49,1e-05,556,548,2,25,0.001,1104,13
0.498,1e-05,607,597,2,25,0.001,1204,13
0.522,1e-05,656,648,2,25,0.001,1304,13
0.546,1e-05,712,692,2,25,0.001,1404,13
0.584,1e-05,754,750,2,25,0.001,1504,13
0.61,1e-05,801,803,2,25,0.001,1604,13
0.65,1e-05,844,860,2,25,0.001,1704,13
0.676,1e-05,894,910,2,25,0.001,1804,13
0.704,1e-05,942,962,2,25,0.001,1904,13
0.708,1e-05,995,1009,2,25,0.001,2004,13
0.484,1e-05,48,56,2,25,0.001,104,14
0.482,1e-05,91,113,2,25,0.001,204,14
0.488,1e-05,137,167,2,25,0.001,304,14
0.5,1e-05,186,218,2,25,0.001,404,14
0.5,1e-05,235,269,2,25,0.001,504,14
0.502,1e-05,292,312,2,25,0.001,604,14
0.51,1e-05,346,358,2,25,0.001,704,14
0.508,1e-05,399,405,2,25,0.001,804,14
0.514,1e-05,449,455,2,25,0.001,904,14
0.534,1e-05,503,501,2,25,0.001,1004,14
0.546,1e-05,546,558,2,25,0.001,1104,14
0.58,1e-05,596,608,2,25,0.001,1204,14
0.638,1e-05,655,649,2,25,0.001,1304,14
0.672,1e-05,696,708,2,25,0.001,1404,14
0.694,1e-05,743,761,2,25,0.001,1504,14
0.706,1e-05,791,813,2,25,0.001,1604,14
0.732,1e-05,834,870,2,25,0.001,1704,14
0.764,1e-05,892,912,2,25,0.001,1804,14
0.774,1e-05,951,953,2,25,0.001,1904,14
0.784,1e-05,1003,1001,2,25,0.001,2004,14
0.488,1e-05,51,53,2,25,0.001,104,15
0.488,1e-05,94,110,2,25,0.001,204,15
0.496,1e-05,143,161,2,25,0.001,304,15
0.52,1e-05,202,202,2,25,0.001,404,15
0.524,1e-05,258,246,2,25,0.001,504,15
0.526,1e-05,311,293,2,25,0.001,604,15
0.524,1e-05,359,345,2,25,0.001,704,15
0.524,1e-05,410,394,2,25,0.001,804,15
0.528,1e-05,460,444,2,25,0.001,904,15
0.538,1e-05,508,496,2,25,0.001,1004,15
0.538,1e-05,560,544,2,25,0.001,1104,15
0.54,1e-05,617,587,2,25,0.001,1204,15
0.546,1e-05,661,643,2,25,0.001,1304,15
0.562,1e-05,716,688,2,25,0.001,1404,15
0.562,1e-05,762,742,2,25,0.001,1504,15
0.556,1e-05,816,788,2,25,0.001,1604,15
0.568,1e-05,863,841,2,25,0.001,1704,15
0.588,1e-05,911,893,2,25,0.001,1804,15
0.596,1e-05,960,944,2,25,0.001,1904,15
0.616,1e-05,1008,996,2,25,0.001,2004,15
0.466,1e-05,56,48,2,25,0.001,104,16
0.466,1e-05,106,98,2,25,0.001,204,16
0.466,1e-05,158,146,2,25,0.001,304,16
0.466,1e-05,200,204,2,25,0.001,404,16
0.466,1e-05,253,251,2,25,0.001,504,16
0.466,1e-05,303,301,2,25,0.001,604,16
0.466,1e-05,352,352,2,25,0.001,704,16
0.466,1e-05,403,401,2,25,0.001,804,16
0.466,1e-05,450,454,2,25,0.001,904,16
0.466,1e-05,504,500,2,25,0.001,1004,16
0.466,1e-05,563,541,2,25,0.001,1104,16
0.464,1e-05,617,587,2,25,0.001,1204,16
0.466,1e-05,662,642,2,25,0.001,1304,16
0.478,1e-05,716,688,2,25,0.001,1404,16
0.496,1e-05,763,741,2,25,0.001,1504,16
0.51,1e-05,804,800,2,25,0.001,1604,16
0.532,1e-05,855,849,2,25,0.001,1704,16
0.53,1e-05,908,896,2,25,0.001,1804,16
0.548,1e-05,965,939,2,25,0.001,1904,16
0.56,1e-05,1019,985,2,25,0.001,2004,16
0.546,1e-05,55,49,2,25,0.001,104,17
0.56,1e-05,108,96,2,25,0.001,204,17
0.562,1e-05,146,158,2,25,0.001,304,17
0.566,1e-05,201,203,2,25,0.001,404,17
0.57,1e-05,250,254,2,25,0.001,504,17
0.572,1e-05,299,305,2,25,0.001,604,17
0.576,1e-05,342,362,2,25,0.001,704,17
0.582,1e-05,390,414,2,25,0.001,804,17
0.584,1e-05,444,460,2,25,0.001,904,17
0.588,1e-05,491,513,2,25,0.001,1004,17
0.592,1e-05,537,567,2,25,0.001,1104,17
0.61,1e-05,594,610,2,25,0.001,1204,17
0.624,1e-05,642,662,2,25,0.001,1304,17
0.636,1e-05,684,720,2,25,0.001,1404,17
0.666,1e-05,737,767,2,25,0.001,1504,17
0.682,1e-05,790,814,2,25,0.001,1604,17
0.706,1e-05,829,875,2,25,0.001,1704,17
0.714,1e-05,880,924,2,25,0.001,1804,17
0.716,1e-05,929,975,2,25,0.001,1904,17
0.718,1e-05,982,1022,2,25,0.001,2004,17
0.482,1e-05,53,51,2,25,0.001,104,18
0.484,1e-05,96,108,2,25,0.001,204,18
0.482,1e-05,149,155,2,25,0.001,304,18
0.482,1e-05,199,205,2,25,0.001,404,18
0.486,1e-05,247,257,2,25,0.001,504,18
0.492,1e-05,288,316,2,25,0.001,604,18
0.492,1e-05,340,364,2,25,0.001,704,18
0.494,1e-05,390,414,2,25,0.001,804,18
0.498,1e-05,438,466,2,25,0.001,904,18
0.51,1e-05,492,512,2,25,0.001,1004,18
0.524,1e-05,535,569,2,25,0.001,1104,18
0.54,1e-05,587,617,2,25,0.001,1204,18
0.55,1e-05,636,668,2,25,0.001,1304,18
0.552,1e-05,682,722,2,25,0.001,1404,18
0.554,1e-05,725,779,2,25,0.001,1504,18
0.56,1e-05,777,827,2,25,0.001,1604,18
0.534,1e-05,830,874,2,25,0.001,1704,18
0.542,1e-05,875,929,2,25,0.001,1804,18
0.546,1e-05,924,980,2,25,0.001,1904,18
0.552,1e-05,981,1023,2,25,0.001,2004,18
0.482,1e-05,45,59,2,25,0.001,104,19
0.496,1e-05,97,107,2,25,0.001,204,19
0.504,1e-05,150,154,2,25,0.001,304,19
0.532,1e-05,196,208,2,25,0.001,404,19
0.536,1e-05,251,253,2,25,0.001,504,19
0.55,1e-05,305,299,2,25,0.001,604,19
0.542,1e-05,353,351,2,25,0.001,704,19
0.544,1e-05,394,410,2,25,0.001,804,19
0.546,1e-05,446,458,2,25,0.001,904,19
0.554,1e-05,496,508,2,25,0.001,1004,19
0.55,1e-05,539,565,2,25,0.001,1104,19
0.574,1e-05,594,610,2,25,0.001,1204,19
0.546,1e-05,645,659,2,25,0.001,1304,19
0.552,1e-05,693,711,2,25,0.001,1404,19
0.554,1e-05,747,757,2,25,0.001,1504,19
0.56,1e-05,805,799,2,25,0.001,1604,19
0.564,1e-05,864,840,2,25,0.001,1704,19
0.566,1e-05,920,884,2,25,0.001,1804,19
0.57,1e-05,968,936,2,25,0.001,1904,19
0.578,1e-05,1012,992,2,25,0.001,2004,19
0.508,1e-05,44,60,2,25,0.001,104,20
0.512,1e-05,96,108,2,25,0.001,204,20
0.516,1e-05,146,158,2,25,0.001,304,20
0.518,1e-05,197,207,2,25,0.001,404,20
0.522,1e-05,249,255,2,25,0.001,504,20
0.522,1e-05,307,297,2,25,0.001,604,20
0.528,1e-05,352,352,2,25,0.001,704,20
0.534,1e-05,401,403,2,25,0.001,804,20
0.538,1e-05,454,450,2,25,0.001,904,20
0.546,1e-05,505,499,2,25,0.001,1004,20
0.544,1e-05,563,541,2,25,0.001,1104,20
0.55,1e-05,621,583,2,25,0.001,1204,20
0.556,1e-05,669,635,2,25,0.001,1304,20
0.558,1e-05,720,684,2,25,0.001,1404,20
0.562,1e-05,767,737,2,25,0.001,1504,20
0.572,1e-05,827,777,2,25,0.001,1604,20
0.578,1e-05,869,835,2,25,0.001,1704,20
0.604,1e-05,918,886,2,25,0.001,1804,20
0.62,1e-05,972,932,2,25,0.001,1904,20
0.63,1e-05,1023,981,2,25,0.001,2004,20
0.486,1e-05,55,49,2,25,0.01,104,1
0.484,1e-05,111,93,2,25,0.01,204,1
0.478,1e-05,160,144,2,25,0.01,304,1
0.482,1e-05,209,195,2,25,0.01,404,1
0.488,1e-05,262,242,2,25,0.01,504,1
0.516,1e-05,318,286,2,25,0.01,604,1
0.572,1e-05,371,333,2,25,0.01,704,1
0.628,1e-05,420,384,2,25,0.01,804,1
0.744,1e-05,473,431,2,25,0.01,904,1
0.846,1e-05,517,487,2,25,0.01,1004,1
0.866,1e-05,572,532,2,25,0.01,1104,1
0.888,1e-05,623,581,2,25,0.01,1204,1
0.898,1e-05,674,630,2,25,0.01,1304,1
0.902,1e-05,731,673,2,25,0.01,1404,1
0.906,1e-05,781,723,2,25,0.01,1504,1
0.916,1e-05,825,779,2,25,0.01,1604,1
0.926,1e-05,876,828,2,25,0.01,1704,1
0.932,1e-05,929,875,2,25,0.01,1804,1
0.93,1e-05,972,932,2,25,0.01,1904,1
0.938,1e-05,1014,990,2,25,0.01,2004,1
0.396,1e-05,59,45,2,25,0.01,104,2
0.494,1e-05,98,106,2,25,0.01,204,2
0.558,1e-05,150,154,2,25,0.01,304,2
0.592,1e-05,203,201,2,25,0.01,404,2
0.616,1e-05,253,251,2,25,0.01,504,2
0.618,1e-05,304,300,2,25,0.01,604,2
0.626,1e-05,353,351,2,25,0.01,704,2
0.636,1e-05,405,399,2,25,0.01,804,2
0.676,1e-05,455,449,2,25,0.01,904,2
0.788,1e-05,509,495,2,25,0.01,1004,2
0.83,1e-05,554,550,2,25,0.01,1104,2
0.894,1e-05,596,608,2,25,0.01,1204,2
0.918,1e-05,638,666,2,25,0.01,1304,2
0.908,1e-05,688,716,2,25,0.01,1404,2
0.902,1e-05,739,765,2,25,0.01,1504,2
0.91,1e-05,793,811,2,25,0.01,1604,2
0.916,1e-05,837,867,2,25,0.01,1704,2
0.922,1e-05,895,909,2,25,0.01,1804,2
0.916,1e-05,942,962,2,25,0.01,1904,2
0.922,1e-05,996,1008,2,25,0.01,2004,2
0.53,1e-05,52,52,2,25,0.01,104,3
0.528,1e-05,104,100,2,25,0.01,204,3
0.578,1e-05,152,152,2,25,0.01,304,3
0.602,1e-05,204,200,2,25,0.01,404,3
0.644,1e-05,255,249,2,25,0.01,504,3
0.656,1e-05,312,292,2,25,0.01,604,3
0.716,1e-05,354,350,2,25,0.01,704,3
0.74,1e-05,402,402,2,25,0.01,804,3
0.748,1e-05,458,446,2,25,0.01,904,3
0.842,1e-05,503,501,2,25,0.01,1004,3
0.89,1e-05,551,553,2,25,0.01,1104,3
0.894,1e-05,598,606,2,25,0.01,1204,3
0.91,1e-05,641,663,2,25,0.01,1304,3
0.914,1e-05,690,714,2,25,0.01,1404,3
0.916,1e-05,739,765,2,25,0.01,1504,3
0.924,1e-05,790,814,2,25,0.01,1604,3
0.932,1e-05,843,861,2,25,0.01,1704,3
0.936,1e-05,889,915,2,25,0.01,1804,3
0.944,1e-05,936,968,2,25,0.01,1904,3
0.944,1e-05,987,1017,2,25,0.01,2004,3
0.534,1e-05,52,52,2,25,0.01,104,4
0.556,1e-05,97,107,2,25,0.01,204,4
0.644,1e-05,151,153,2,25,0.01,304,4
0.692,1e-05,204,200,2,25,0.01,404,4
0.738,1e-05,248,256,2,25,0.01,504,4
0.792,1e-05,302,302,2,25,0.01,604,4
0.77,1e-05,356,348,2,25,0.01,704,4
0.786,1e-05,410,394,2,25,0.01,804,4
0.794,1e-05,456,448,2,25,0.01,904,4
0.818,1e-05,493,511,2,25,0.01,1004,4
0.83,1e-05,541,563,2,25,0.01,1104,4
0.836,1e-05,584,620,2,25,0.01,1204,4
0.854,1e-05,633,671,2,25,0.01,1304,4
0.854,1e-05,685,719,2,25,0.01,1404,4
0.868,1e-05,748,756,2,25,0.01,1504,4
0.872,1e-05,799,805,2,25,0.01,1604,4
0.874,1e-05,842,862,2,25,0.01,1704,4
0.882,1e-05,894,910,2,25,0.01,1804,4
0.884,1e-05,947,957,2,25,0.01,1904,4
0.892,1e-05,1001,1003,2,25,0.01,2004,4
0.508,1e-05,54,50,2,25,0.01,104,5
0.55,1e-05,112,92,2,25,0.01,204,5
0.548,1e-05,159,145,2,25,0.01,304,5
0.554,1e-05,220,184,2,25,0.01,404,5
0.564,1e-05,267,237,2,25,0.01,504,5
0.576,1e-05,320,284,2,25,0.01,604,5
0.574,1e-05,368,336,2,25,0.01,704,5
0.612,1e-05,423,381,2,25,0.01,804,5
0.616,1e-05,462,442,2,25,0.01,904,5
0.64,1e-05,505,499,2,25,0.01,1004,5
0.688,1e-05,562,542,2,25,0.01,1104,5
0.702,1e-05,612,592,2,25,0.01,1204,5
0.714,1e-05,661,643,2,25,0.01,1304,5
0.734,1e-05,708,696,2,25,0.01,1404,5
0.782,1e-05,756,748,2,25,0.01,1504,5
0.802,1e-05,810,794,2,25,0.01,1604,5
0.832,1e-05,859,845,2,25,0.01,1704,5
0.85,1e-05,904,900,2,25,0.01,1804,5
0.862,1e-05,952,952,2,25,0.01,1904,5
0.894,1e-05,1004,1000,2,25,0.01,2004,5
0.532,1e-05,53,51,2,25,0.01,104,6
0.594,1e-05,104,100,2,25,0.01,204,6
0.494,1e-05,155,149,2,25,0.01,304,6
0.532,1e-05,208,196,2,25,0.01,404,6
0.582,1e-05,256,248,2,25,0.01,504,6
0.59,1e-05,313,291,2,25,0.01,604,6
0.59,1e-05,355,349,2,25,0.01,704,6
0.592,1e-05,407,397,2,25,0.01,804,6
0.824,1e-05,464,440,2,25,0.01,904,6
0.866,1e-05,517,487,2,25,0.01,1004,6
0.876,1e-05,572,532,2,25,0.01,1104,6
0.908,1e-05,619,585,2,25,0.01,1204,6
0.87,1e-05,667,637,2,25,0.01,1304,6
0.872,1e-05,715,689,2,25,0.01,1404,6
0.898,1e-05,769,735,2,25,0.01,1504,6
0.88,1e-05,819,785,2,25,0.01,1604,6
0.884,1e-05,871,833,2,25,0.01,1704,6
0.898,1e-05,915,889,2,25,0.01,1804,6
0.906,1e-05,964,940,2,25,0.01,1904,6
0.906,1e-05,1015,989,2,25,0.01,2004,6
0.512,1e-05,53,51,2,25,0.01,104,7
0.512,1e-05,104,100,2,25,0.01,204,7
0.526,1e-05,154,150,2,25,0.01,304,7
0.564,1e-05,204,200,2,25,0.01,404,7
0.584,1e-05,254,250,2,25,0.01,504,7
0.63,1e-05,313,291,2,25,0.01,604,7
0.666,1e-05,361,343,2,25,0.01,704,7
0.732,1e-05,407,397,2,25,0.01,804,7
0.672,1e-05,453,451,2,25,0.01,904,7
0.72,1e-05,508,496,2,25,0.01,1004,7
0.758,1e-05,571,533,2,25,0.01,1104,7
0.894,1e-05,605,599,2,25,0.01,1204,7
0.896,1e-05,652,652,2,25,0.01,1304,7
0.904,1e-05,698,706,2,25,0.01,1404,7
0.93,1e-05,749,755,2,25,0.01,1504,7
0.902,1e-05,801,803,2,25,0.01,1604,7
0.878,1e-05,850,854,2,25,0.01,1704,7
0.89,1e-05,907,897,2,25,0.01,1804,7
0.904,1e-05,949,955,2,25,0.01,1904,7
0.924,1e-05,996,1008,2,25,0.01,2004,7
0.544,1e-05,55,49,2,25,0.01,104,8
0.562,1e-05,110,94,2,25,0.01,204,8
0.568,1e-05,156,148,2,25,0.01,304,8
0.578,1e-05,199,205,2,25,0.01,404,8
0.714,1e-05,243,261,2,25,0.01,504,8
0.638,1e-05,285,319,2,25,0.01,604,8
0.826,1e-05,333,371,2,25,0.01,704,8
0.782,1e-05,383,421,2,25,0.01,804,8
0.772,1e-05,434,470,2,25,0.01,904,8
0.806,1e-05,477,527,2,25,0.01,1004,8
0.83,1e-05,534,570,2,25,0.01,1104,8
0.852,1e-05,584,620,2,25,0.01,1204,8
0.85,1e-05,642,662,2,25,0.01,1304,8
0.856,1e-05,692,712,2,25,0.01,1404,8
0.864,1e-05,735,769,2,25,0.01,1504,8
0.87,1e-05,784,820,2,25,0.01,1604,8
0.882,1e-05,836,868,2,25,0.01,1704,8
0.89,1e-05,880,924,2,25,0.01,1804,8
0.892,1e-05,929,975,2,25,0.01,1904,8
0.898,1e-05,972,1032,2,25,0.01,2004,8
0.522,1e-05,54,50,2,25,0.01,104,9
0.544,1e-05,102,102,2,25,0.01,204,9
0.64,1e-05,143,161,2,25,0.01,304,9
0.684,1e-05,197,207,2,25,0.01,404,9
0.718,1e-05,246,258,2,25,0.01,504,9
0.736,1e-05,292,312,2,25,0.01,604,9
0.764,1e-05,342,362,2,25,0.01,704,9
0.788,1e-05,395,409,2,25,0.01,804,9
0.81,1e-05,448,456,2,25,0.01,904,9
0.838,1e-05,497,507,2,25,0.01,1004,9
0.866,1e-05,539,565,2,25,0.01,1104,9
0.888,1e-05,597,607,2,25,0.01,1204,9
0.886,1e-05,647,657,2,25,0.01,1304,9
0.902,1e-05,706,698,2,25,0.01,1404,9
0.908,1e-05,760,744,2,25,0.01,1504,9
0.906,1e-05,806,798,2,25,0.01,1604,9
0.902,1e-05,856,848,2,25,0.01,1704,9
0.914,1e-05,911,893,2,25,0.01,1804,9
0.914,1e-05,963,941,2,25,0.01,1904,9
0.914,1e-05,1012,992,2,25,0.01,2004,9
0.504,1e-05,57,47,2,25,0.01,104,10
0.516,1e-05,113,91,2,25,0.01,204,10
0.522,1e-05,166,138,2,25,0.01,304,10
0.546,1e-05,206,198,2,25,0.01,404,10
0.588,1e-05,255,249,2,25,0.01,504,10
0.652,1e-05,305,299,2,25,0.01,604,10
0.676,1e-05,347,357,2,25,0.01,704,10
0.686,1e-05,391,413,2,25,0.01,804,10
0.694,1e-05,445,459,2,25,0.01,904,10
0.704,1e-05,496,508,2,25,0.01,1004,10
0.698,1e-05,546,558,2,25,0.01,1104,10
0.714,1e-05,597,607,2,25,0.01,1204,10
0.742,1e-05,642,662,2,25,0.01,1304,10
0.766,1e-05,689,715,2,25,0.01,1404,10
0.784,1e-05,747,757,2,25,0.01,1504,10
0.814,1e-05,793,811,2,25,0.01,1604,10
0.838,1e-05,841,863,2,25,0.01,1704,10
0.84,1e-05,894,910,2,25,0.01,1804,10
0.86,1e-05,940,964,2,25,0.01,1904,10
0.866,1e-05,993,1011,2,25,0.01,2004,10
0.51,1e-05,64,40,2,25,0.01,104,11
0.486,1e-05,118,86,2,25,0.01,204,11
0.49,1e-05,168,136,2,25,0.01,304,11
0.49,1e-05,219,185,2,25,0.01,404,11
0.542,1e-05,271,233,2,25,0.01,504,11
0.658,1e-05,319,285,2,25,0.01,604,11
0.704,1e-05,369,335,2,25,0.01,704,11
0.808,1e-05,420,384,2,25,0.01,804,11
0.838,1e-05,466,438,2,25,0.01,904,11
0.884,1e-05,512,492,2,25,0.01,1004,11
0.9,1e-05,559,545,2,25,0.01,1104,11
0.888,1e-05,612,592,2,25,0.01,1204,11
0.884,1e-05,664,640,2,25,0.01,1304,11
0.888,1e-05,722,682,2,25,0.01,1404,11
0.888,1e-05,774,730,2,25,0.01,1504,11
0.896,1e-05,821,783,2,25,0.01,1604,11
0.904,1e-05,869,835,2,25,0.01,1704,11
0.9,1e-05,917,887,2,25,0.01,1804,11
0.9,1e-05,962,942,2,25,0.01,1904,11
0.906,1e-05,1007,997,2,25,0.01,2004,11
0.542,1e-05,58,46,2,25,0.01,104,12
0.552,1e-05,111,93,2,25,0.01,204,12
0.544,1e-05,163,141,2,25,0.01,304,12
0.574,1e-05,217,187,2,25,0.01,404,12
0.634,1e-05,264,240,2,25,0.01,504,12
0.668,1e-05,321,283,2,25,0.01,604,12
0.698,1e-05,371,333,2,25,0.01,704,12
0.686,1e-05,420,384,2,25,0.01,804,12
0.706,1e-05,463,441,2,25,0.01,904,12
0.74,1e-05,517,487,2,25,0.01,1004,12
0.756,1e-05,565,539,2,25,0.01,1104,12
0.798,1e-05,610,594,2,25,0.01,1204,12
0.832,1e-05,652,652,2,25,0.01,1304,12
0.86,1e-05,702,702,2,25,0.01,1404,12
0.886,1e-05,749,755,2,25,0.01,1504,12
0.898,1e-05,790,814,2,25,0.01,1604,12
0.9,1e-05,843,861,2,25,0.01,1704,12
0.904,1e-05,891,913,2,25,0.01,1804,12
0.904,1e-05,940,964,2,25,0.01,1904,12
0.914,1e-05,990,1014,2,25,0.01,2004,12
0.514,1e-05,53,51,2,25,0.01,104,13
0.54,1e-05,95,109,2,25,0.01,204,13
0.576,1e-05,154,150,2,25,0.01,304,13
0.582,1e-05,205,199,2,25,0.01,404,13
0.578,1e-05,253,251,2,25,0.01,504,13
0.63,1e-05,301,303,2,25,0.01,604,13
0.68,1e-05,355,349,2,25,0.01,704,13
0.72,1e-05,394,410,2,25,0.01,804,13
0.74,1e-05,440,464,2,25,0.01,904,13
0.766,1e-05,499,505,2,25,0.01,1004,13
0.758,1e-05,544,560,2,25,0.01,1104,13
0.764,1e-05,603,601,2,25,0.01,1204,13
0.788,1e-05,651,653,2,25,0.01,1304,13
0.81,1e-05,699,705,2,25,0.01,1404,13
0.814,1e-05,750,754,2,25,0.01,1504,13
0.824,1e-05,795,809,2,25,0.01,1604,13
0.824,1e-05,838,866,2,25,0.01,1704,13
0.85,1e-05,890,914,2,25,0.01,1804,13
0.908,1e-05,935,969,2,25,0.01,1904,13
0.866,1e-05,983,1021,2,25,0.01,2004,13
0.666,1e-05,47,57,2,25,0.01,104,14
0.664,1e-05,91,113,2,25,0.01,204,14
0.668,1e-05,145,159,2,25,0.01,304,14
0.684,1e-05,195,209,2,25,0.01,404,14
0.722,1e-05,249,255,2,25,0.01,504,14
0.752,1e-05,292,312,2,25,0.01,604,14
0.76,1e-05,339,365,2,25,0.01,704,14
0.774,1e-05,389,415,2,25,0.01,804,14
0.78,1e-05,438,466,2,25,0.01,904,14
0.822,1e-05,502,502,2,25,0.01,1004,14
0.858,1e-05,552,552,2,25,0.01,1104,14
0.874,1e-05,598,606,2,25,0.01,1204,14
0.872,1e-05,645,659,2,25,0.01,1304,14
0.882,1e-05,701,703,2,25,0.01,1404,14
0.912,1e-05,752,752,2,25,0.01,1504,14
0.902,1e-05,810,794,2,25,0.01,1604,14
0.902,1e-05,868,836,2,25,0.01,1704,14
0.904,1e-05,928,876,2,25,0.01,1804,14
0.908,1e-05,968,936,2,25,0.01,1904,14
0.92,1e-05,1018,986,2,25,0.01,2004,14
0.464,1e-05,48,56,2,25,0.01,104,15
0.612,1e-05,97,107,2,25,0.01,204,15
0.59,1e-05,149,155,2,25,0.01,304,15
0.574,1e-05,191,213,2,25,0.01,404,15
0.582,1e-05,241,263,2,25,0.01,504,15
0.594,1e-05,292,312,2,25,0.01,604,15
0.634,1e-05,334,370,2,25,0.01,704,15
0.682,1e-05,379,425,2,25,0.01,804,15
0.692,1e-05,432,472,2,25,0.01,904,15
0.702,1e-05,486,518,2,25,0.01,1004,15
0.74,1e-05,539,565,2,25,0.01,1104,15
0.798,1e-05,581,623,2,25,0.01,1204,15
0.756,1e-05,639,665,2,25,0.01,1304,15
0.798,1e-05,694,710,2,25,0.01,1404,15
0.84,1e-05,739,765,2,25,0.01,1504,15
0.848,1e-05,795,809,2,25,0.01,1604,15
0.858,1e-05,845,859,2,25,0.01,1704,15
0.87,1e-05,890,914,2,25,0.01,1804,15
0.89,1e-05,942,962,2,25,0.01,1904,15
0.894,1e-05,986,1018,2,25,0.01,2004,15
0.51,1e-05,55,49,2,25,0.01,104,16
0.534,1e-05,100,104,2,25,0.01,204,16
0.544,1e-05,143,161,2,25,0.01,304,16
0.538,1e-05,197,207,2,25,0.01,404,16
0.514,1e-05,249,255,2,25,0.01,504,16
0.522,1e-05,306,298,2,25,0.01,604,16
0.548,1e-05,356,348,2,25,0.01,704,16
0.668,1e-05,404,400,2,25,0.01,804,16
0.766,1e-05,450,454,2,25,0.01,904,16
0.832,1e-05,495,509,2,25,0.01,1004,16
0.904,1e-05,549,555,2,25,0.01,1104,16
0.902,1e-05,602,602,2,25,0.01,1204,16
0.904,1e-05,654,650,2,25,0.01,1304,16
0.91,1e-05,709,695,2,25,0.01,1404,16
0.924,1e-05,758,746,2,25,0.01,1504,16
0.928,1e-05,803,801,2,25,0.01,1604,16
0.936,1e-05,848,856,2,25,0.01,1704,16
0.914,1e-05,902,902,2,25,0.01,1804,16
0.91,1e-05,949,955,2,25,0.01,1904,16
0.922,1e-05,998,1006,2,25,0.01,2004,16
0.492,1e-05,46,58,2,25,0.01,104,17
0.536,1e-05,96,108,2,25,0.01,204,17
0.56,1e-05,136,168,2,25,0.01,304,17
0.6,1e-05,186,218,2,25,0.01,404,17
0.634,1e-05,233,271,2,25,0.01,504,17
0.668,1e-05,272,332,2,25,0.01,604,17
0.694,1e-05,321,383,2,25,0.01,704,17
0.716,1e-05,375,429,2,25,0.01,804,17
0.746,1e-05,429,475,2,25,0.01,904,17
0.776,1e-05,483,521,2,25,0.01,1004,17
0.802,1e-05,533,571,2,25,0.01,1104,17
0.838,1e-05,586,618,2,25,0.01,1204,17
0.852,1e-05,642,662,2,25,0.01,1304,17
0.866,1e-05,690,714,2,25,0.01,1404,17
0.882,1e-05,737,767,2,25,0.01,1504,17
0.888,1e-05,782,822,2,25,0.01,1604,17
0.888,1e-05,833,871,2,25,0.01,1704,17
0.894,1e-05,882,922,2,25,0.01,1804,17
0.912,1e-05,939,965,2,25,0.01,1904,17
0.922,1e-05,993,1011,2,25,0.01,2004,17
0.508,1e-05,61,43,2,25,0.01,104,18
0.518,1e-05,118,86,2,25,0.01,204,18
0.488,1e-05,162,142,2,25,0.01,304,18
0.472,1e-05,213,191,2,25,0.01,404,18
0.502,1e-05,264,240,2,25,0.01,504,18
0.536,1e-05,315,289,2,25,0.01,604,18
0.516,1e-05,367,337,2,25,0.01,704,18
0.526,1e-05,425,379,2,25,0.01,804,18
0.584,1e-05,473,431,2,25,0.01,904,18
0.684,1e-05,513,491,2,25,0.01,1004,18
0.742,1e-05,561,543,2,25,0.01,1104,18
0.842,1e-05,616,588,2,25,0.01,1204,18
0.9,1e-05,667,637,2,25,0.01,1304,18
0.912,1e-05,715,689,2,25,0.01,1404,18
0.928,1e-05,761,743,2,25,0.01,1504,18
0.934,1e-05,809,795,2,25,0.01,1604,18
0.94,1e-05,862,842,2,25,0.01,1704,18
0.946,1e-05,907,897,2,25,0.01,1804,18
0.948,1e-05,959,945,2,25,0.01,1904,18
0.952,1e-05,1020,984,2,25,0.01,2004,18
0.482,1e-05,53,51,2,25,0.01,104,19
0.594,1e-05,101,103,2,25,0.01,204,19
0.576,1e-05,154,150,2,25,0.01,304,19
0.592,1e-05,216,188,2,25,0.01,404,19
0.654,1e-05,259,245,2,25,0.01,504,19
0.72,1e-05,315,289,2,25,0.01,604,19
0.744,1e-05,366,338,2,25,0.01,704,19
0.766,1e-05,421,383,2,25,0.01,804,19
0.714,1e-05,464,440,2,25,0.01,904,19
0.772,1e-05,514,490,2,25,0.01,1004,19
0.828,1e-05,560,544,2,25,0.01,1104,19
0.82,1e-05,600,604,2,25,0.01,1204,19
0.832,1e-05,648,656,2,25,0.01,1304,19
0.84,1e-05,698,706,2,25,0.01,1404,19
0.846,1e-05,744,760,2,25,0.01,1504,19
0.852,1e-05,793,811,2,25,0.01,1604,19
0.856,1e-05,842,862,2,25,0.01,1704,19
0.874,1e-05,890,914,2,25,0.01,1804,19
0.878,1e-05,937,967,2,25,0.01,1904,19
0.884,1e-05,988,1016,2,25,0.01,2004,19
0.442,1e-05,54,50,2,25,0.01,104,20
0.458,1e-05,104,100,2,25,0.01,204,20
0.458,1e-05,160,144,2,25,0.01,304,20
0.518,1e-05,213,191,2,25,0.01,404,20
0.522,1e-05,254,250,2,25,0.01,504,20
0.52,1e-05,313,291,2,25,0.01,604,20
0.532,1e-05,362,342,2,25,0.01,704,20
0.578,1e-05,416,388,2,25,0.01,804,20
0.682,1e-05,455,449,2,25,0.01,904,20
0.72,1e-05,498,506,2,25,0.01,1004,20
0.726,1e-05,550,554,2,25,0.01,1104,20
0.82,1e-05,598,606,2,25,0.01,1204,20
0.858,1e-05,653,651,2,25,0.01,1304,20
0.872,1e-05,703,701,2,25,0.01,1404,20
0.874,1e-05,751,753,2,25,0.01,1504,20
0.918,1e-05,806,798,2,25,0.01,1604,20
0.928,1e-05,859,845,2,25,0.01,1704,20
0.938,1e-05,916,888,2,25,0.01,1804,20
0.936,1e-05,961,943,2,25,0.01,1904,20
0.938,1e-05,1009,995,2,25,0.01,2004,20
0.374,0.0001,54,50,2,25,0.0001,104,1
0.374,0.0001,101,103,2,25,0.0001,204,1
0.374,0.0001,150,154,2,25,0.0001,304,1
0.374,0.0001,195,209,2,25,0.0001,404,1
0.376,0.0001,247,257,2,25,0.0001,504,1
0.376,0.0001,298,306,2,25,0.0001,604,1
0.376,0.0001,350,354,2,25,0.0001,704,1
0.376,0.0001,401,403,2,25,0.0001,804,1
0.38,0.0001,447,457,2,25,0.0001,904,1
0.38,0.0001,512,492,2,25,0.0001,1004,1
0.384,0.0001,564,540,2,25,0.0001,1104,1
0.386,0.0001,606,598,2,25,0.0001,1204,1
0.386,0.0001,651,653,2,25,0.0001,1304,1
0.384,0.0001,706,698,2,25,0.0001,1404,1
0.384,0.0001,761,743,2,25,0.0001,1504,1
0.386,0.0001,815,789,2,25,0.0001,1604,1
0.382,0.0001,871,833,2,25,0.0001,1704,1
0.38,0.0001,920,884,2,25,0.0001,1804,1
0.378,0.0001,967,937,2,25,0.0001,1904,1
0.384,0.0001,1018,986,2,25,0.0001,2004,1
0.504,0.0001,42,62,2,25,0.0001,104,2
0.504,0.0001,98,106,2,25,0.0001,204,2
0.504,0.0001,140,164,2,25,0.0001,304,2
0.504,0.0001,194,210,2,25,0.0001,404,2
0.504,0.0001,242,262,2,25,0.0001,504,2
0.504,0.0001,286,318,2,25,0.0001,604,2
0.504,0.0001,338,366,2,25,0.0001,704,2
0.504,0.0001,393,411,2,25,0.0001,804,2
0.504,0.0001,455,449,2,25,0.0001,904,2
0.504,0.0001,505,499,2,25,0.0001,1004,2
0.504,0.0001,555,549,2,25,0.0001,1104,2
0.504,0.0001,603,601,2,25,0.0001,1204,2
0.504,0.0001,651,653,2,25,0.0001,1304,2
0.504,0.0001,700,704,2,25,0.0001,1404,2
0.504,0.0001,747,757,2,25,0.0001,1504,2
0.504,0.0001,797,807,2,25,0.0001,1604,2
0.504,0.0001,849,855,2,25,0.0001,1704,2
0.504,0.0001,906,898,2,25,0.0001,1804,2
0.504,0.0001,953,951,2,25,0.0001,1904,2
0.506,0.0001,1004,1000,2,25,0.0001,2004,2
0.398,0.0001,52,52,2,25,0.0001,104,3
0.398,0.0001,106,98,2,25,0.0001,204,3
0.398,0.0001,157,147,2,25,0.0001,304,3
0.398,0.0001,202,202,2,25,0.0001,404,3
0.398,0.0001,250,254,2,25,0.0001,504,3
0.398,0.0001,301,303,2,25,0.0001,604,3
0.398,0.0001,350,354,2,25,0.0001,704,3
0.402,0.0001,402,402,2,25,0.0001,804,3
0.404,0.0001,460,444,2,25,0.0001,904,3
0.406,0.0001,503,501,2,25,0.0001,1004,3
0.41,0.0001,552,552,2,25,0.0001,1104,3
0.41,0.0001,592,612,2,25,0.0001,1204,3
0.41,0.0001,646,658,2,25,0.0001,1304,3
0.406,0.0001,694,710,2,25,0.0001,1404,3
0.406,0.0001,750,754,2,25,0.0001,1504,3
0.41,0.0001,799,805,2,25,0.0001,1604,3
0.41,0.0001,846,858,2,25,0.0001,1704,3
0.408,0.0001,902,902,2,25,0.0001,1804,3
0.41,0.0001,960,944,2,25,0.0001,1904,3
0.41,0.0001,1010,994,2,25,0.0001,2004,3
0.462,0.0001,51,53,2,25,0.0001,104,4
0.462,0.0001,104,100,2,25,0.0001,204,4
0.462,0.0001,154,150,2,25,0.0001,304,4
0.462,0.0001,213,191,2,25,0.0001,404,4
0.462,0.0001,266,238,2,25,0.0001,504,4
0.46,0.0001,316,288,2,25,0.0001,604,4
0.462,0.0001,364,340,2,25,0.0001,704,4
0.462,0.0001,413,391,2,25,0.0001,804,4
0.462,0.0001,466,438,2,25,0.0001,904,4
0.462,0.0001,524,480,2,25,0.0001,1004,4
0.462,0.0001,563,541,2,25,0.0001,1104,4
0.462,0.0001,618,586,2,25,0.0001,1204,4
0.468,0.0001,664,640,2,25,0.0001,1304,4
0.468,0.0001,711,693,2,25,0.0001,1404,4
0.468,0.0001,761,743,2,25,0.0001,1504,4
0.472,0.0001,812,792,2,25,0.0001,1604,4
0.472,0.0001,860,844,2,25,0.0001,1704,4
0.474,0.0001,907,897,2,25,0.0001,1804,4
0.472,0.0001,958,946,2,25,0.0001,1904,4
0.48,0.0001,1012,992,2,25,0.0001,2004,4
0.47,0.0001,55,49,2,25,0.0001,104,5
0.47,0.0001,105,99,2,25,0.0001,204,5
0.468,0.0001,153,151,2,25,0.0001,304,5
0.468,0.0001,203,201,2,25,0.0001,404,5
0.468,0.0001,254,250,2,25,0.0001,504,5
0.468,0.0001,303,301,2,25,0.0001,604,5
0.468,0.0001,356,348,2,25,0.0001,704,5
0.47,0.0001,404,400,2,25,0.0001,804,5
0.472,0.0001,456,448,2,25,0.0001,904,5
0.476,0.0001,506,498,2,25,0.0001,1004,5
0.48,0.0001,557,547,2,25,0.0001,1104,5
0.48,0.0001,608,596,2,25,0.0001,1204,5
0.482,0.0001,660,644,2,25,0.0001,1304,5
0.482,0.0001,710,694,2,25,0.0001,1404,5
0.484,0.0001,757,747,2,25,0.0001,1504,5
0.484,0.0001,807,797,2,25,0.0001,1604,5
0.486,0.0001,857,847,2,25,0.0001,1704,5
0.486,0.0001,911,893,2,25,0.0001,1804,5
0.488,0.0001,958,946,2,25,0.0001,1904,5
0.488,0.0001,1006,998,2,25,0.0001,2004,5
0.47,0.0001,54,50,2,25,0.0001,104,6
0.47,0.0001,94,110,2,25,0.0001,204,6
0.47,0.0001,147,157,2,25,0.0001,304,6
0.47,0.0001,198,206,2,25,0.0001,404,6
0.47,0.0001,245,259,2,25,0.0001,504,6
0.47,0.0001,292,312,2,25,0.0001,604,6
0.47,0.0001,344,360,2,25,0.0001,704,6
0.47,0.0001,387,417,2,25,0.0001,804,6
0.47,0.0001,439,465,2,25,0.0001,904,6
0.47,0.0001,490,514,2,25,0.0001,1004,6
0.47,0.0001,541,563,2,25,0.0001,1104,6
0.47,0.0001,596,608,2,25,0.0001,1204,6
0.47,0.0001,645,659,2,25,0.0001,1304,6
0.47,0.0001,699,705,2,25,0.0001,1404,6
0.47,0.0001,750,754,2,25,0.0001,1504,6
0.47,0.0001,796,808,2,25,0.0001,1604,6
0.47,0.0001,850,854,2,25,0.0001,1704,6
0.47,0.0001,895,909,2,25,0.0001,1804,6
0.47,0.0001,940,964,2,25,0.0001,1904,6
0.47,0.0001,987,1017,2,25,0.0001,2004,6
0.512,0.0001,55,49,2,25,0.0001,104,7
0.51,0.0001,104,100,2,25,0.0001,204,7
0.508,0.0001,158,146,2,25,0.0001,304,7
0.512,0.0001,197,207,2,25,0.0001,404,7
0.516,0.0001,246,258,2,25,0.0001,504,7
0.514,0.0001,295,309,2,25,0.0001,604,7
0.514,0.0001,348,356,2,25,0.0001,704,7
0.518,0.0001,397,407,2,25,0.0001,804,7
0.522,0.0001,449,455,2,25,0.0001,904,7
0.522,0.0001,499,505,2,25,0.0001,1004,7
0.524,0.0001,555,549,2,25,0.0001,1104,7
0.524,0.0001,604,600,2,25,0.0001,1204,7
0.528,0.0001,650,654,2,25,0.0001,1304,7
0.528,0.0001,697,707,2,25,0.0001,1404,7
0.536,0.0001,749,755,2,25,0.0001,1504,7
0.542,0.0001,802,802,2,25,0.0001,1604,7
0.546,0.0001,854,850,2,25,0.0001,1704,7
0.55,0.0001,902,902,2,25,0.0001,1804,7
0.55,0.0001,952,952,2,25,0.0001,1904,7
0.55,0.0001,1000,1004,2,25,0.0001,2004,7
0.568,0.0001,48,56,2,25,0.0001,104,8
0.568,0.0001,98,106,2,25,0.0001,204,8
0.568,0.0001,152,152,2,25,0.0001,304,8
0.568,0.0001,211,193,2,25,0.0001,404,8
0.566,0.0001,261,243,2,25,0.0001,504,8
0.566,0.0001,314,290,2,25,0.0001,604,8
0.566,0.0001,369,335,2,25,0.0001,704,8
0.566,0.0001,419,385,2,25,0.0001,804,8
0.566,0.0001,468,436,2,25,0.0001,904,8
0.566,0.0001,519,485,2,25,0.0001,1004,8
0.57,0.0001,569,535,2,25,0.0001,1104,8
0.57,0.0001,613,591,2,25,0.0001,1204,8
0.57,0.0001,660,644,2,25,0.0001,1304,8
0.57,0.0001,713,691,2,25,0.0001,1404,8
0.57,0.0001,763,741,2,25,0.0001,1504,8
0.57,0.0001,822,782,2,25,0.0001,1604,8
0.57,0.0001,866,838,2,25,0.0001,1704,8
0.57,0.0001,911,893,2,25,0.0001,1804,8
0.57,0.0001,958,946,2,25,0.0001,1904,8
0.57,0.0001,1013,991,2,25,0.0001,2004,8
0.506,0.0001,55,49,2,25,0.0001,104,9
0.506,0.0001,113,91,2,25,0.0001,204,9
0.504,0.0001,162,142,2,25,0.0001,304,9
0.504,0.0001,205,199,2,25,0.0001,404,9
0.504,0.0001,256,248,2,25,0.0001,504,9
0.506,0.0001,304,300,2,25,0.0001,604,9
0.506,0.0001,353,351,2,25,0.0001,704,9
0.506,0.0001,398,406,2,25,0.0001,804,9
0.504,0.0001,445,459,2,25,0.0001,904,9
0.506,0.0001,496,508,2,25,0.0001,1004,9
0.506,0.0001,550,554,2,25,0.0001,1104,9
0.508,0.0001,598,606,2,25,0.0001,1204,9
0.506,0.0001,650,654,2,25,0.0001,1304,9
0.51,0.0001,699,705,2,25,0.0001,1404,9
0.514,0.0001,741,763,2,25,0.0001,1504,9
0.516,0.0001,789,815,2,25,0.0001,1604,9
0.518,0.0001,840,864,2,25,0.0001,1704,9
0.518,0.0001,896,908,2,25,0.0001,1804,9
0.518,0.0001,946,958,2,25,0.0001,1904,9
0.522,0.0001,988,1016,2,25,0.0001,2004,9
0.476,0.0001,56,48,2,25,0.0001,104,10
0.478,0.0001,109,95,2,25,0.0001,204,10
0.476,0.0001,161,143,2,25,0.0001,304,10
0.478,0.0001,210,194,2,25,0.0001,404,10
0.48,0.0001,257,247,2,25,0.0001,504,10
0.48,0.0001,312,292,2,25,0.0001,604,10
0.48,0.0001,370,334,2,25,0.0001,704,10
0.478,0.0001,428,376,2,25,0.0001,804,10
0.478,0.0001,474,430,2,25,0.0001,904,10
0.48,0.0001,520,484,2,25,0.0001,1004,10
0.482,0.0001,577,527,2,25,0.0001,1104,10
0.478,0.0001,624,580,2,25,0.0001,1204,10
0.482,0.0001,684,620,2,25,0.0001,1304,10
0.478,0.0001,738,666,2,25,0.0001,1404,10
0.476,0.0001,777,727,2,25,0.0001,1504,10
0.476,0.0001,826,778,2,25,0.0001,1604,10
0.478,0.0001,875,829,2,25,0.0001,1704,10
0.474,0.0001,922,882,2,25,0.0001,1804,10
0.474,0.0001,967,937,2,25,0.0001,1904,10
0.476,0.0001,1019,985,2,25,0.0001,2004,10
0.642,0.0001,54,50,2,25,0.0001,104,11
0.64,0.0001,105,99,2,25,0.0001,204,11
0.642,0.0001,148,156,2,25,0.0001,304,11
0.642,0.0001,201,203,2,25,0.0001,404,11
0.64,0.0001,251,253,2,25,0.0001,504,11
0.64,0.0001,300,304,2,25,0.0001,604,11
0.64,0.0001,357,347,2,25,0.0001,704,11
0.642,0.0001,404,400,2,25,0.0001,804,11
0.642,0.0001,454,450,2,25,0.0001,904,11
0.642,0.0001,504,500,2,25,0.0001,1004,11
0.644,0.0001,549,555,2,25,0.0001,1104,11
0.642,0.0001,602,602,2,25,0.0001,1204,11
0.644,0.0001,654,650,2,25,0.0001,1304,11
0.646,0.0001,708,696,2,25,0.0001,1404,11
0.644,0.0001,758,746,2,25,0.0001,1504,11
0.644,0.0001,813,791,2,25,0.0001,1604,11
0.646,0.0001,861,843,2,25,0.0001,1704,11
0.646,0.0001,912,892,2,25,0.0001,1804,11
0.648,0.0001,951,953,2,25,0.0001,1904,11
0.65,0.0001,1000,1004,2,25,0.0001,2004,11
0.552,0.0001,54,50,2,25,0.0001,104,12
0.552,0.0001,103,101,2,25,0.0001,204,12
0.552,0.0001,147,157,2,25,0.0001,304,12
0.552,0.0001,191,213,2,25,0.0001,404,12
0.552,0.0001,242,262,2,25,0.0001,504,12
0.552,0.0001,286,318,2,25,0.0001,604,12
0.552,0.0001,338,366,2,25,0.0001,704,12
0.552,0.0001,384,420,2,25,0.0001,804,12
0.552,0.0001,434,470,2,25,0.0001,904,12
0.552,0.0001,485,519,2,25,0.0001,1004,12
0.552,0.0001,532,572,2,25,0.0001,1104,12
0.552,0.0001,580,624,2,25,0.0001,1204,12
0.552,0.0001,623,681,2,25,0.0001,1304,12
0.554,0.0001,678,726,2,25,0.0001,1404,12
0.554,0.0001,729,775,2,25,0.0001,1504,12
0.554,0.0001,782,822,2,25,0.0001,1604,12
0.556,0.0001,832,872,2,25,0.0001,1704,12
0.556,0.0001,889,915,2,25,0.0001,1804,12
0.556,0.0001,939,965,2,25,0.0001,1904,12
0.556,0.0001,993,1011,2,25,0.0001,2004,12
0.556,0.0001,58,46,2,25,0.0001,104,13
0.556,0.0001,105,99,2,25,0.0001,204,13
0.556,0.0001,151,153,2,25,0.0001,304,13
0.556,0.0001,212,192,2,25,0.0001,404,13
0.556,0.0001,252,252,2,25,0.0001,504,13
0.556,0.0001,302,302,2,25,0.0001,604,13
0.556,0.0001,354,350,2,25,0.0001,704,13
0.556,0.0001,403,401,2,25,0.0001,804,13
0.556,0.0001,448,456,2,25,0.0001,904,13
0.552,0.0001,496,508,2,25,0.0001,1004,13
0.552,0.0001,548,556,2,25,0.0001,1104,13
0.552,0.0001,593,611,2,25,0.0001,1204,13
0.552,0.0001,634,670,2,25,0.0001,1304,13
0.552,0.0001,690,714,2,25,0.0001,1404,13
0.552,0.0001,749,755,2,25,0.0001,1504,13
0.552,0.0001,806,798,2,25,0.0001,1604,13
0.552,0.0001,851,853,2,25,0.0001,1704,13
0.556,0.0001,907,897,2,25,0.0001,1804,13
0.556,0.0001,954,950,2,25,0.0001,1904,13
0.556,0.0001,1008,996,2,25,0.0001,2004,13
0.508,0.0001,45,59,2,25,0.0001,104,14
0.508,0.0001,95,109,2,25,0.0001,204,14
0.508,0.0001,142,162,2,25,0.0001,304,14
0.506,0.0001,201,203,2,25,0.0001,404,14
0.506,0.0001,250,254,2,25,0.0001,504,14
0.504,0.0001,300,304,2,25,0.0001,604,14
0.506,0.0001,354,350,2,25,0.0001,704,14
0.506,0.0001,403,401,2,25,0.0001,804,14
0.506,0.0001,448,456,2,25,0.0001,904,14
0.51,0.0001,492,512,2,25,0.0001,1004,14
0.514,0.0001,552,552,2,25,0.0001,1104,14
0.518,0.0001,600,604,2,25,0.0001,1204,14
0.522,0.0001,651,653,2,25,0.0001,1304,14
0.52,0.0001,708,696,2,25,0.0001,1404,14
0.522,0.0001,753,751,2,25,0.0001,1504,14
0.522,0.0001,802,802,2,25,0.0001,1604,14
0.52,0.0001,857,847,2,25,0.0001,1704,14
0.526,0.0001,905,899,2,25,0.0001,1804,14
0.522,0.0001,947,957,2,25,0.0001,1904,14
0.524,0.0001,996,1008,2,25,0.0001,2004,14
0.514,0.0001,50,54,2,25,0.0001,104,15
0.514,0.0001,98,106,2,25,0.0001,204,15
0.514,0.0001,142,162,2,25,0.0001,304,15
0.514,0.0001,197,207,2,25,0.0001,404,15
0.514,0.0001,236,268,2,25,0.0001,504,15
0.514,0.0001,286,318,2,25,0.0001,604,15
0.514,0.0001,338,366,2,25,0.0001,704,15
0.514,0.0001,386,418,2,25,0.0001,804,15
0.514,0.0001,439,465,2,25,0.0001,904,15
0.514,0.0001,489,515,2,25,0.0001,1004,15
0.514,0.0001,544,560,2,25,0.0001,1104,15
0.514,0.0001,595,609,2,25,0.0001,1204,15
0.514,0.0001,651,653,2,25,0.0001,1304,15
0.514,0.0001,697,707,2,25,0.0001,1404,15
0.514,0.0001,750,754,2,25,0.0001,1504,15
0.512,0.0001,796,808,2,25,0.0001,1604,15
0.51,0.0001,848,856,2,25,0.0001,1704,15
0.51,0.0001,901,903,2,25,0.0001,1804,15
0.51,0.0001,955,949,2,25,0.0001,1904,15
0.51,0.0001,1009,995,2,25,0.0001,2004,15
0.54,0.0001,50,54,2,25,0.0001,104,16
0.542,0.0001,108,96,2,25,0.0001,204,16
0.542,0.0001,156,148,2,25,0.0001,304,16
0.542,0.0001,205,199,2,25,0.0001,404,16
0.542,0.0001,262,242,2,25,0.0001,504,16
0.542,0.0001,307,297,2,25,0.0001,604,16
0.544,0.0001,355,349,2,25,0.0001,704,16
0.544,0.0001,398,406,2,25,0.0001,804,16
0.544,0.0001,447,457,2,25,0.0001,904,16
0.544,0.0001,503,501,2,25,0.0001,1004,16
0.546,0.0001,555,549,2,25,0.0001,1104,16
0.548,0.0001,608,596,2,25,0.0001,1204,16
0.552,0.0001,660,644,2,25,0.0001,1304,16
0.552,0.0001,713,691,2,25,0.0001,1404,16
0.552,0.0001,766,738,2,25,0.0001,1504,16
0.554,0.0001,828,776,2,25,0.0001,1604,16
0.554,0.0001,877,827,2,25,0.0001,1704,16
0.55,0.0001,915,889,2,25,0.0001,1804,16
0.546,0.0001,957,947,2,25,0.0001,1904,16
0.544,0.0001,1003,1001,2,25,0.0001,2004,16
0.504,0.0001,60,44,2,25,0.0001,104,17
0.504,0.0001,109,95,2,25,0.0001,204,17
0.504,0.0001,160,144,2,25,0.0001,304,17
0.504,0.0001,207,197,2,25,0.0001,404,17
0.504,0.0001,250,254,2,25,0.0001,504,17
0.504,0.0001,295,309,2,25,0.0001,604,17
0.504,0.0001,353,351,2,25,0.0001,704,17
0.504,0.0001,403,401,2,25,0.0001,804,17
0.504,0.0001,448,456,2,25,0.0001,904,17
0.504,0.0001,504,500,2,25,0.0001,1004,17
0.504,0.0001,556,548,2,25,0.0001,1104,17
0.504,0.0001,601,603,2,25,0.0001,1204,17
0.504,0.0001,651,653,2,25,0.0001,1304,17
0.504,0.0001,702,702,2,25,0.0001,1404,17
0.504,0.0001,756,748,2,25,0.0001,1504,17
0.504,0.0001,802,802,2,25,0.0001,1604,17
0.504,0.0001,854,850,2,25,0.0001,1704,17
0.504,0.0001,904,900,2,25,0.0001,1804,17
0.504,0.0001,950,954,2,25,0.0001,1904,17
0.504,0.0001,1000,1004,2,25,0.0001,2004,17
0.52,0.0001,57,47,2,25,0.0001,104,18
0.52,0.0001,97,107,2,25,0.0001,204,18
0.52,0.0001,150,154,2,25,0.0001,304,18
0.52,0.0001,197,207,2,25,0.0001,404,18
0.52,0.0001,251,253,2,25,0.0001,504,18
0.52,0.0001,302,302,2,25,0.0001,604,18
0.52,0.0001,358,346,2,25,0.0001,704,18
0.52,0.0001,398,406,2,25,0.0001,804,18
0.52,0.0001,458,446,2,25,0.0001,904,18
0.52,0.0001,511,493,2,25,0.0001,1004,18
0.52,0.0001,567,537,2,25,0.0001,1104,18
0.52,0.0001,619,585,2,25,0.0001,1204,18
0.52,0.0001,672,632,2,25,0.0001,1304,18
0.52,0.0001,721,683,2,25,0.0001,1404,18
0.52,0.0001,774,730,2,25,0.0001,1504,18
0.52,0.0001,823,781,2,25,0.0001,1604,18
0.52,0.0001,866,838,2,25,0.0001,1704,18
0.52,0.0001,912,892,2,25,0.0001,1804,18
0.52,0.0001,961,943,2,25,0.0001,1904,18
0.52,0.0001,1012,992,2,25,0.0001,2004,18
0.508,0.0001,56,48,2,25,0.0001,104,19
0.508,0.0001,100,104,2,25,0.0001,204,19
0.506,0.0001,150,154,2,25,0.0001,304,19
0.506,0.0001,209,195,2,25,0.0001,404,19
0.504,0.0001,264,240,2,25,0.0001,504,19
0.506,0.0001,315,289,2,25,0.0001,604,19
0.508,0.0001,370,334,2,25,0.0001,704,19
0.51,0.0001,426,378,2,25,0.0001,804,19
0.512,0.0001,471,433,2,25,0.0001,904,19
0.52,0.0001,519,485,2,25,0.0001,1004,19
0.524,0.0001,564,540,2,25,0.0001,1104,19
0.522,0.0001,622,582,2,25,0.0001,1204,19
0.522,0.0001,667,637,2,25,0.0001,1304,19
0.524,0.0001,714,690,2,25,0.0001,1404,19
0.524,0.0001,757,747,2,25,0.0001,1504,19
0.522,0.0001,808,796,2,25,0.0001,1604,19
0.522,0.0001,861,843,2,25,0.0001,1704,19
0.524,0.0001,901,903,2,25,0.0001,1804,19
0.526,0.0001,954,950,2,25,0.0001,1904,19
0.526,0.0001,1002,1002,2,25,0.0001,2004,19
0.478,0.0001,48,56,2,25,0.0001,104,20
0.478,0.0001,98,106,2,25,0.0001,204,20
0.476,0.0001,147,157,2,25,0.0001,304,20
0.476,0.0001,201,203,2,25,0.0001,404,20
0.476,0.0001,247,257,2,25,0.0001,504,20
0.476,0.0001,298,306,2,25,0.0001,604,20
0.476,0.0001,352,352,2,25,0.0001,704,20
0.474,0.0001,399,405,2,25,0.0001,804,20
0.474,0.0001,457,447,2,25,0.0001,904,20
0.476,0.0001,513,491,2,25,0.0001,1004,20
0.476,0.0001,558,546,2,25,0.0001,1104,20
0.474,0.0001,605,599,2,25,0.0001,1204,20
0.474,0.0001,658,646,2,25,0.0001,1304,20
0.476,0.0001,701,703,2,25,0.0001,1404,20
0.476,0.0001,746,758,2,25,0.0001,1504,20
0.476,0.0001,800,804,2,25,0.0001,1604,20
0.476,0.0001,853,851,2,25,0.0001,1704,20
0.478,0.0001,899,905,2,25,0.0001,1804,20
0.482,0.0001,947,957,2,25,0.0001,1904,20
0.49,0.0001,994,1010,2,25,0.0001,2004,20
0.482,0.0001,50,54,2,25,0.001,104,1
0.482,0.0001,99,105,2,25,0.001,204,1
0.482,0.0001,155,149,2,25,0.001,304,1
0.482,0.0001,213,191,2,25,0.001,404,1
0.482,0.0001,268,236,2,25,0.001,504,1
0.482,0.0001,313,291,2,25,0.001,604,1
0.482,0.0001,355,349,2,25,0.001,704,1
0.482,0.0001,412,392,2,25,0.001,804,1
0.482,0.0001,458,446,2,25,0.001,904,1
0.482,0.0001,511,493,2,25,0.001,1004,1
0.486,0.0001,557,547,2,25,0.001,1104,1
0.506,0.0001,614,590,2,25,0.001,1204,1
0.518,0.0001,659,645,2,25,0.001,1304,1
0.54,0.0001,702,702,2,25,0.001,1404,1
0.564,0.0001,756,748,2,25,0.001,1504,1
0.572,0.0001,810,794,2,25,0.001,1604,1
0.594,0.0001,859,845,2,25,0.001,1704,1
0.614,0.0001,907,897,2,25,0.001,1804,1
0.622,0.0001,955,949,2,25,0.001,1904,1
0.634,0.0001,1011,993,2,25,0.001,2004,1
0.47,0.0001,52,52,2,25,0.001,104,2
0.47,0.0001,103,101,2,25,0.001,204,2
0.468,0.0001,151,153,2,25,0.001,304,2
0.468,0.0001,208,196,2,25,0.001,404,2
0.476,0.0001,254,250,2,25,0.001,504,2
0.478,0.0001,310,294,2,25,0.001,604,2
0.484,0.0001,357,347,2,25,0.001,704,2
0.482,0.0001,404,400,2,25,0.001,804,2
0.476,0.0001,453,451,2,25,0.001,904,2
0.474,0.0001,499,505,2,25,0.001,1004,2
0.478,0.0001,551,553,2,25,0.001,1104,2
0.478,0.0001,596,608,2,25,0.001,1204,2
0.492,0.0001,646,658,2,25,0.001,1304,2
0.5,0.0001,695,709,2,25,0.001,1404,2
0.5,0.0001,748,756,2,25,0.001,1504,2
0.502,0.0001,792,812,2,25,0.001,1604,2
0.506,0.0001,841,863,2,25,0.001,1704,2
0.508,0.0001,896,908,2,25,0.001,1804,2
0.508,0.0001,948,956,2,25,0.001,1904,2
0.524,0.0001,991,1013,2,25,0.001,2004,2
0.46,0.0001,55,49,2,25,0.001,104,3
0.464,0.0001,104,100,2,25,0.001,204,3
0.48,0.0001,155,149,2,25,0.001,304,3
0.492,0.0001,195,209,2,25,0.001,404,3
0.502,0.0001,239,265,2,25,0.001,504,3
0.514,0.0001,296,308,2,25,0.001,604,3
0.528,0.0001,349,355,2,25,0.001,704,3
0.544,0.0001,410,394,2,25,0.001,804,3
0.552,0.0001,459,445,2,25,0.001,904,3
0.562,0.0001,505,499,2,25,0.001,1004,3
0.582,0.0001,561,543,2,25,0.001,1104,3
0.608,0.0001,608,596,2,25,0.001,1204,3
0.63,0.0001,659,645,2,25,0.001,1304,3
0.65,0.0001,713,691,2,25,0.001,1404,3
0.68,0.0001,759,745,2,25,0.001,1504,3
0.712,0.0001,809,795,2,25,0.001,1604,3
0.74,0.0001,870,834,2,25,0.001,1704,3
0.788,0.0001,917,887,2,25,0.001,1804,3
0.814,0.0001,959,945,2,25,0.001,1904,3
0.828,0.0001,999,1005,2,25,0.001,2004,3
0.508,0.0001,42,62,2,25,0.001,104,4
0.508,0.0001,106,98,2,25,0.001,204,4
0.508,0.0001,162,142,2,25,0.001,304,4
0.508,0.0001,210,194,2,25,0.001,404,4
0.516,0.0001,249,255,2,25,0.001,504,4
0.54,0.0001,295,309,2,25,0.001,604,4
0.574,0.0001,350,354,2,25,0.001,704,4
0.566,0.0001,407,397,2,25,0.001,804,4
0.58,0.0001,452,452,2,25,0.001,904,4
0.586,0.0001,498,506,2,25,0.001,1004,4
0.594,0.0001,549,555,2,25,0.001,1104,4
0.592,0.0001,597,607,2,25,0.001,1204,4
0.606,0.0001,640,664,2,25,0.001,1304,4
0.628,0.0001,690,714,2,25,0.001,1404,4
0.68,0.0001,740,764,2,25,0.001,1504,4
0.692,0.0001,793,811,2,25,0.001,1604,4
0.702,0.0001,844,860,2,25,0.001,1704,4
0.732,0.0001,901,903,2,25,0.001,1804,4
0.738,0.0001,948,956,2,25,0.001,1904,4
0.758,0.0001,998,1006,2,25,0.001,2004,4
0.448,0.0001,58,46,2,25,0.001,104,5
0.448,0.0001,108,96,2,25,0.001,204,5
0.44,0.0001,162,142,2,25,0.001,304,5
0.438,0.0001,205,199,2,25,0.001,404,5
0.438,0.0001,254,250,2,25,0.001,504,5
0.442,0.0001,303,301,2,25,0.001,604,5
0.444,0.0001,363,341,2,25,0.001,704,5
0.446,0.0001,410,394,2,25,0.001,804,5
0.446,0.0001,455,449,2,25,0.001,904,5
0.45,0.0001,496,508,2,25,0.001,1004,5
0.448,0.0001,540,564,2,25,0.001,1104,5
0.446,0.0001,583,621,2,25,0.001,1204,5
0.454,0.0001,637,667,2,25,0.001,1304,5
0.464,0.0001,692,712,2,25,0.001,1404,5
0.49,0.0001,737,767,2,25,0.001,1504,5
0.538,0.0001,776,828,2,25,0.001,1604,5
0.56,0.0001,833,871,2,25,0.001,1704,5
0.596,0.0001,884,920,2,25,0.001,1804,5
0.61,0.0001,944,960,2,25,0.001,1904,5
0.618,0.0001,1006,998,2,25,0.001,2004,5
0.498,0.0001,52,52,2,25,0.001,104,6
0.498,0.0001,108,96,2,25,0.001,204,6
0.494,0.0001,155,149,2,25,0.001,304,6
0.494,0.0001,212,192,2,25,0.001,404,6
0.49,0.0001,262,242,2,25,0.001,504,6
0.494,0.0001,317,287,2,25,0.001,604,6
0.494,0.0001,363,341,2,25,0.001,704,6
0.506,0.0001,405,399,2,25,0.001,804,6
0.518,0.0001,451,453,2,25,0.001,904,6
0.516,0.0001,500,504,2,25,0.001,1004,6
0.52,0.0001,548,556,2,25,0.001,1104,6
0.526,0.0001,600,604,2,25,0.001,1204,6
0.53,0.0001,646,658,2,25,0.001,1304,6
0.536,0.0001,699,705,2,25,0.001,1404,6
0.55,0.0001,748,756,2,25,0.001,1504,6
0.594,0.0001,799,805,2,25,0.001,1604,6
0.604,0.0001,850,854,2,25,0.001,1704,6
0.614,0.0001,906,898,2,25,0.001,1804,6
0.614,0.0001,961,943,2,25,0.001,1904,6
0.61,0.0001,1014,990,2,25,0.001,2004,6
0.442,0.0001,42,62,2,25,0.001,104,7
0.458,0.0001,88,116,2,25,0.001,204,7
0.472,0.0001,141,163,2,25,0.001,304,7
0.506,0.0001,188,216,2,25,0.001,404,7
0.52,0.0001,236,268,2,25,0.001,504,7
0.542,0.0001,287,317,2,25,0.001,604,7
0.54,0.0001,333,371,2,25,0.001,704,7
0.542,0.0001,378,426,2,25,0.001,804,7
0.548,0.0001,424,480,2,25,0.001,904,7
0.554,0.0001,470,534,2,25,0.001,1004,7
0.562,0.0001,525,579,2,25,0.001,1104,7
0.57,0.0001,574,630,2,25,0.001,1204,7
0.582,0.0001,632,672,2,25,0.001,1304,7
0.588,0.0001,681,723,2,25,0.001,1404,7
0.586,0.0001,727,777,2,25,0.001,1504,7
0.6,0.0001,780,824,2,25,0.001,1604,7
0.614,0.0001,837,867,2,25,0.001,1704,7
0.622,0.0001,894,910,2,25,0.001,1804,7
0.626,0.0001,942,962,2,25,0.001,1904,7
0.63,0.0001,995,1009,2,25,0.001,2004,7
0.468,0.0001,47,57,2,25,0.001,104,8
0.468,0.0001,100,104,2,25,0.001,204,8
0.472,0.0001,141,163,2,25,0.001,304,8
0.478,0.0001,196,208,2,25,0.001,404,8
0.48,0.0001,241,263,2,25,0.001,504,8
0.484,0.0001,297,307,2,25,0.001,604,8
0.486,0.0001,347,357,2,25,0.001,704,8
0.494,0.0001,392,412,2,25,0.001,804,8
0.49,0.0001,445,459,2,25,0.001,904,8
0.49,0.0001,492,512,2,25,0.001,1004,8
0.492,0.0001,542,562,2,25,0.001,1104,8
0.492,0.0001,586,618,2,25,0.001,1204,8
0.49,0.0001,635,669,2,25,0.001,1304,8
0.498,0.0001,675,729,2,25,0.001,1404,8
0.51,0.0001,729,775,2,25,0.001,1504,8
0.534,0.0001,787,817,2,25,0.001,1604,8
0.568,0.0001,841,863,2,25,0.001,1704,8
0.57,0.0001,895,909,2,25,0.001,1804,8
0.612,0.0001,949,955,2,25,0.001,1904,8
0.63,0.0001,997,1007,2,25,0.001,2004,8
0.51,0.0001,54,50,2,25,0.001,104,9
0.51,0.0001,102,102,2,25,0.001,204,9
0.51,0.0001,148,156,2,25,0.001,304,9
0.51,0.0001,204,200,2,25,0.001,404,9
0.512,0.0001,261,243,2,25,0.001,504,9
0.512,0.0001,320,284,2,25,0.001,604,9
0.512,0.0001,373,331,2,25,0.001,704,9
0.52,0.0001,421,383,2,25,0.001,804,9
0.526,0.0001,471,433,2,25,0.001,904,9
0.544,0.0001,513,491,2,25,0.001,1004,9
0.568,0.0001,559,545,2,25,0.001,1104,9
0.584,0.0001,612,592,2,25,0.001,1204,9
0.608,0.0001,663,641,2,25,0.001,1304,9
0.62,0.0001,713,691,2,25,0.001,1404,9
0.624,0.0001,763,741,2,25,0.001,1504,9
0.638,0.0001,809,795,2,25,0.001,1604,9
0.644,0.0001,862,842,2,25,0.001,1704,9
0.654,0.0001,910,894,2,25,0.001,1804,9
0.676,0.0001,954,950,2,25,0.001,1904,9
0.694,0.0001,1007,997,2,25,0.001,2004,9
0.492,0.0001,44,60,2,25,0.001,104,10
0.492,0.0001,93,111,2,25,0.001,204,10
0.492,0.0001,138,166,2,25,0.001,304,10
0.492,0.0001,181,223,2,25,0.001,404,10
0.492,0.0001,242,262,2,25,0.001,504,10
0.492,0.0001,296,308,2,25,0.001,604,10
0.492,0.0001,345,359,2,25,0.001,704,10
0.492,0.0001,401,403,2,25,0.001,804,10
0.492,0.0001,463,441,2,25,0.001,904,10
0.492,0.0001,510,494,2,25,0.001,1004,10
0.492,0.0001,556,548,2,25,0.001,1104,10
0.492,0.0001,603,601,2,25,0.001,1204,10
0.492,0.0001,658,646,2,25,0.001,1304,10
0.492,0.0001,703,701,2,25,0.001,1404,10
0.492,0.0001,752,752,2,25,0.001,1504,10
0.492,0.0001,808,796,2,25,0.001,1604,10
0.492,0.0001,855,849,2,25,0.001,1704,10
0.492,0.0001,903,901,2,25,0.001,1804,10
0.492,0.0001,956,948,2,25,0.001,1904,10
0.494,0.0001,998,1006,2,25,0.001,2004,10
0.442,0.0001,62,42,2,25,0.001,104,11
0.444,0.0001,119,85,2,25,0.001,204,11
0.442,0.0001,171,133,2,25,0.001,304,11
0.444,0.0001,221,183,2,25,0.001,404,11
0.448,0.0001,272,232,2,25,0.001,504,11
0.452,0.0001,326,278,2,25,0.001,604,11
0.454,0.0001,372,332,2,25,0.001,704,11
0.452,0.0001,415,389,2,25,0.001,804,11
0.458,0.0001,471,433,2,25,0.001,904,11
0.466,0.0001,525,479,2,25,0.001,1004,11
0.47,0.0001,578,526,2,25,0.001,1104,11
0.48,0.0001,633,571,2,25,0.001,1204,11
0.482,0.0001,686,618,2,25,0.001,1304,11
0.488,0.0001,724,680,2,25,0.001,1404,11
0.504,0.0001,772,732,2,25,0.001,1504,11
0.514,0.0001,824,780,2,25,0.001,1604,11
0.544,0.0001,863,841,2,25,0.001,1704,11
0.572,0.0001,906,898,2,25,0.001,1804,11
0.58,0.0001,948,956,2,25,0.001,1904,11
0.602,0.0001,997,1007,2,25,0.001,2004,11
0.486,0.0001,53,51,2,25,0.001,104,12
0.486,0.0001,109,95,2,25,0.001,204,12
0.486,0.0001,155,149,2,25,0.001,304,12
0.486,0.0001,202,202,2,25,0.001,404,12
0.486,0.0001,245,259,2,25,0.001,504,12
0.486,0.0001,293,311,2,25,0.001,604,12
0.49,0.0001,343,361,2,25,0.001,704,12
0.504,0.0001,391,413,2,25,0.001,804,12
0.518,0.0001,435,469,2,25,0.001,904,12
0.536,0.0001,485,519,2,25,0.001,1004,12
0.55,0.0001,531,573,2,25,0.001,1104,12
0.554,0.0001,581,623,2,25,0.001,1204,12
0.594,0.0001,634,670,2,25,0.001,1304,12
0.634,0.0001,678,726,2,25,0.001,1404,12
0.666,0.0001,731,773,2,25,0.001,1504,12
0.674,0.0001,783,821,2,25,0.001,1604,12
0.684,0.0001,841,863,2,25,0.001,1704,12
0.694,0.0001,896,908,2,25,0.001,1804,12
0.69,0.0001,945,959,2,25,0.001,1904,12
0.704,0.0001,995,1009,2,25,0.001,2004,12
0.468,0.0001,54,50,2,25,0.001,104,13
0.468,0.0001,108,96,2,25,0.001,204,13
0.468,0.0001,162,142,2,25,0.001,304,13
0.468,0.0001,206,198,2,25,0.001,404,13
0.468,0.0001,262,242,2,25,0.001,504,13
0.47,0.0001,312,292,2,25,0.001,604,13
0.472,0.0001,354,350,2,25,0.001,704,13
0.47,0.0001,406,398,2,25,0.001,804,13
0.478,0.0001,457,447,2,25,0.001,904,13
0.49,0.0001,507,497,2,25,0.001,1004,13
0.5,0.0001,553,551,2,25,0.001,1104,13
0.514,0.0001,601,603,2,25,0.001,1204,13
0.546,0.0001,644,660,2,25,0.001,1304,13
0.568,0.0001,691,713,2,25,0.001,1404,13
0.608,0.0001,745,759,2,25,0.001,1504,13
0.65,0.0001,795,809,2,25,0.001,1604,13
0.676,0.0001,836,868,2,25,0.001,1704,13
0.7,0.0001,881,923,2,25,0.001,1804,13
0.72,0.0001,930,974,2,25,0.001,1904,13
0.734,0.0001,986,1018,2,25,0.001,2004,13
0.508,0.0001,51,53,2,25,0.001,104,14
0.506,0.0001,99,105,2,25,0.001,204,14
0.51,0.0001,147,157,2,25,0.001,304,14
0.506,0.0001,197,207,2,25,0.001,404,14
0.504,0.0001,255,249,2,25,0.001,504,14
0.504,0.0001,307,297,2,25,0.001,604,14
0.504,0.0001,350,354,2,25,0.001,704,14
0.51,0.0001,405,399,2,25,0.001,804,14
0.508,0.0001,454,450,2,25,0.001,904,14
0.506,0.0001,506,498,2,25,0.001,1004,14
0.508,0.0001,551,553,2,25,0.001,1104,14
0.512,0.0001,601,603,2,25,0.001,1204,14
0.524,0.0001,644,660,2,25,0.001,1304,14
0.532,0.0001,699,705,2,25,0.001,1404,14
0.536,0.0001,746,758,2,25,0.001,1504,14
0.544,0.0001,793,811,2,25,0.001,1604,14
0.548,0.0001,846,858,2,25,0.001,1704,14
0.56,0.0001,899,905,2,25,0.001,1804,14
0.578,0.0001,962,942,2,25,0.001,1904,14
0.592,0.0001,1013,991,2,25,0.001,2004,14
0.534,0.0001,37,67,2,25,0.001,104,15
0.562,0.0001,81,123,2,25,0.001,204,15
0.566,0.0001,137,167,2,25,0.001,304,15
0.568,0.0001,190,214,2,25,0.001,404,15
0.574,0.0001,248,256,2,25,0.001,504,15
0.582,0.0001,304,300,2,25,0.001,604,15
0.588,0.0001,363,341,2,25,0.001,704,15
0.594,0.0001,418,386,2,25,0.001,804,15
0.592,0.0001,470,434,2,25,0.001,904,15
0.588,0.0001,518,486,2,25,0.001,1004,15
0.592,0.0001,563,541,2,25,0.001,1104,15
0.604,0.0001,606,598,2,25,0.001,1204,15
0.626,0.0001,649,655,2,25,0.001,1304,15
0.632,0.0001,704,700,2,25,0.001,1404,15
0.644,0.0001,759,745,2,25,0.001,1504,15
0.678,0.0001,805,799,2,25,0.001,1604,15
0.704,0.0001,853,851,2,25,0.001,1704,15
0.746,0.0001,898,906,2,25,0.001,1804,15
0.76,0.0001,950,954,2,25,0.001,1904,15
0.774,0.0001,998,1006,2,25,0.001,2004,15
0.514,0.0001,51,53,2,25,0.001,104,16
0.508,0.0001,107,97,2,25,0.001,204,16
0.5,0.0001,155,149,2,25,0.001,304,16
0.502,0.0001,200,204,2,25,0.001,404,16
0.49,0.0001,248,256,2,25,0.001,504,16
0.482,0.0001,287,317,2,25,0.001,604,16
0.482,0.0001,329,375,2,25,0.001,704,16
0.486,0.0001,382,422,2,25,0.001,804,16
0.492,0.0001,432,472,2,25,0.001,904,16
0.492,0.0001,475,529,2,25,0.001,1004,16
0.492,0.0001,524,580,2,25,0.001,1104,16
0.5,0.0001,578,626,2,25,0.001,1204,16
0.5,0.0001,626,678,2,25,0.001,1304,16
0.512,0.0001,677,727,2,25,0.001,1404,16
0.538,0.0001,731,773,2,25,0.001,1504,16
0.55,0.0001,780,824,2,25,0.001,1604,16
0.548,0.0001,826,878,2,25,0.001,1704,16
0.566,0.0001,875,929,2,25,0.001,1804,16
0.568,0.0001,929,975,2,25,0.001,1904,16
0.576,0.0001,984,1020,2,25,0.001,2004,16
0.56,0.0001,54,50,2,25,0.001,104,17
0.558,0.0001,103,101,2,25,0.001,204,17
0.56,0.0001,148,156,2,25,0.001,304,17
0.558,0.0001,194,210,2,25,0.001,404,17
0.556,0.0001,243,261,2,25,0.001,504,17
0.558,0.0001,288,316,2,25,0.001,604,17
0.556,0.0001,330,374,2,25,0.001,704,17
0.552,0.0001,374,430,2,25,0.001,804,17
0.56,0.0001,426,478,2,25,0.001,904,17
0.568,0.0001,477,527,2,25,0.001,1004,17
0.566,0.0001,527,577,2,25,0.001,1104,17
0.552,0.0001,580,624,2,25,0.001,1204,17
0.548,0.0001,633,671,2,25,0.001,1304,17
0.54,0.0001,680,724,2,25,0.001,1404,17
0.546,0.0001,732,772,2,25,0.001,1504,17
0.564,0.0001,782,822,2,25,0.001,1604,17
0.566,0.0001,842,862,2,25,0.001,1704,17
0.574,0.0001,897,907,2,25,0.001,1804,17
0.584,0.0001,941,963,2,25,0.001,1904,17
0.594,0.0001,992,1012,2,25,0.001,2004,17
0.508,0.0001,44,60,2,25,0.001,104,18
0.508,0.0001,101,103,2,25,0.001,204,18
0.51,0.0001,160,144,2,25,0.001,304,18
0.512,0.0001,208,196,2,25,0.001,404,18
0.514,0.0001,257,247,2,25,0.001,504,18
0.52,0.0001,307,297,2,25,0.001,604,18
0.52,0.0001,364,340,2,25,0.001,704,18
0.532,0.0001,421,383,2,25,0.001,804,18
0.536,0.0001,471,433,2,25,0.001,904,18
0.532,0.0001,512,492,2,25,0.001,1004,18
0.532,0.0001,568,536,2,25,0.001,1104,18
0.536,0.0001,622,582,2,25,0.001,1204,18
0.568,0.0001,675,629,2,25,0.001,1304,18
0.584,0.0001,718,686,2,25,0.001,1404,18
0.602,0.0001,765,739,2,25,0.001,1504,18
0.608,0.0001,812,792,2,25,0.001,1604,18
0.622,0.0001,855,849,2,25,0.001,1704,18
0.628,0.0001,896,908,2,25,0.001,1804,18
0.642,0.0001,950,954,2,25,0.001,1904,18
0.664,0.0001,1006,998,2,25,0.001,2004,18
0.486,0.0001,53,51,2,25,0.001,104,19
0.486,0.0001,101,103,2,25,0.001,204,19
0.492,0.0001,151,153,2,25,0.001,304,19
0.494,0.0001,197,207,2,25,0.001,404,19
0.494,0.0001,249,255,2,25,0.001,504,19
0.498,0.0001,290,314,2,25,0.001,604,19
0.516,0.0001,342,362,2,25,0.001,704,19
0.524,0.0001,397,407,2,25,0.001,804,19
0.528,0.0001,445,459,2,25,0.001,904,19
0.554,0.0001,503,501,2,25,0.001,1004,19
0.57,0.0001,554,550,2,25,0.001,1104,19
0.608,0.0001,603,601,2,25,0.001,1204,19
0.646,0.0001,650,654,2,25,0.001,1304,19
0.654,0.0001,704,700,2,25,0.001,1404,19
0.674,0.0001,757,747,2,25,0.001,1504,19
0.678,0.0001,811,793,2,25,0.001,1604,19
0.694,0.0001,867,837,2,25,0.001,1704,19
0.708,0.0001,916,888,2,25,0.001,1804,19
0.714,0.0001,969,935,2,25,0.001,1904,19
0.722,0.0001,1018,986,2,25,0.001,2004,19
0.35,0.0001,56,48,2,25,0.001,104,20
0.344,0.0001,104,100,2,25,0.001,204,20
0.336,0.0001,159,145,2,25,0.001,304,20
0.354,0.0001,207,197,2,25,0.001,404,20
0.37,0.0001,259,245,2,25,0.001,504,20
0.4,0.0001,312,292,2,25,0.001,604,20
0.432,0.0001,370,334,2,25,0.001,704,20
0.458,0.0001,415,389,2,25,0.001,804,20
0.45,0.0001,467,437,2,25,0.001,904,20
0.46,0.0001,526,478,2,25,0.001,1004,20
0.474,0.0001,581,523,2,25,0.001,1104,20
0.486,0.0001,624,580,2,25,0.001,1204,20
0.48,0.0001,680,624,2,25,0.001,1304,20
0.502,0.0001,727,677,2,25,0.001,1404,20
0.514,0.0001,779,725,2,25,0.001,1504,20
0.538,0.0001,821,783,2,25,0.001,1604,20
0.548,0.0001,879,825,2,25,0.001,1704,20
0.576,0.0001,933,871,2,25,0.001,1804,20
0.586,0.0001,974,930,2,25,0.001,1904,20
0.638,0.0001,1023,981,2,25,0.001,2004,20
0.484,0.0001,47,57,2,25,0.01,104,1
0.62,0.0001,104,100,2,25,0.01,204,1
0.618,0.0001,147,157,2,25,0.01,304,1
0.612,0.0001,187,217,2,25,0.01,404,1
0.624,0.0001,249,255,2,25,0.01,504,1
0.684,0.0001,294,310,2,25,0.01,604,1
0.732,0.0001,354,350,2,25,0.01,704,1
0.74,0.0001,410,394,2,25,0.01,804,1
0.752,0.0001,459,445,2,25,0.01,904,1
0.768,0.0001,518,486,2,25,0.01,1004,1
0.798,0.0001,567,537,2,25,0.01,1104,1
0.802,0.0001,612,592,2,25,0.01,1204,1
0.834,0.0001,662,642,2,25,0.01,1304,1
0.866,0.0001,717,687,2,25,0.01,1404,1
0.87,0.0001,766,738,2,25,0.01,1504,1
0.876,0.0001,814,790,2,25,0.01,1604,1
0.88,0.0001,865,839,2,25,0.01,1704,1
0.878,0.0001,916,888,2,25,0.01,1804,1
0.89,0.0001,967,937,2,25,0.01,1904,1
0.888,0.0001,1015,989,2,25,0.01,2004,1
0.49,0.0001,49,55,2,25,0.01,104,2
0.576,0.0001,103,101,2,25,0.01,204,2
0.532,0.0001,159,145,2,25,0.01,304,2
0.522,0.0001,202,202,2,25,0.01,404,2
0.676,0.0001,255,249,2,25,0.01,504,2
0.714,0.0001,302,302,2,25,0.01,604,2
0.762,0.0001,355,349,2,25,0.01,704,2
0.764,0.0001,403,401,2,25,0.01,804,2
0.8,0.0001,453,451,2,25,0.01,904,2
0.828,0.0001,499,505,2,25,0.01,1004,2
0.786,0.0001,555,549,2,25,0.01,1104,2
0.822,0.0001,609,595,2,25,0.01,1204,2
0.864,0.0001,655,649,2,25,0.01,1304,2
0.838,0.0001,704,700,2,25,0.01,1404,2
0.86,0.0001,758,746,2,25,0.01,1504,2
0.862,0.0001,800,804,2,25,0.01,1604,2
0.886,0.0001,854,850,2,25,0.01,1704,2
0.892,0.0001,907,897,2,25,0.01,1804,2
0.898,0.0001,948,956,2,25,0.01,1904,2
0.908,0.0001,997,1007,2,25,0.01,2004,2
0.524,0.0001,56,48,2,25,0.01,104,3
0.536,0.0001,102,102,2,25,0.01,204,3
0.486,0.0001,161,143,2,25,0.01,304,3
0.546,0.0001,210,194,2,25,0.01,404,3
0.564,0.0001,262,242,2,25,0.01,504,3
0.6,0.0001,316,288,2,25,0.01,604,3
0.608,0.0001,366,338,2,25,0.01,704,3
0.696,0.0001,413,391,2,25,0.01,804,3
0.716,0.0001,465,439,2,25,0.01,904,3
0.768,0.0001,505,499,2,25,0.01,1004,3
0.786,0.0001,557,547,2,25,0.01,1104,3
0.816,0.0001,608,596,2,25,0.01,1204,3
0.828,0.0001,656,648,2,25,0.01,1304,3
0.85,0.0001,708,696,2,25,0.01,1404,3
0.876,0.0001,753,751,2,25,0.01,1504,3
0.88,0.0001,804,800,2,25,0.01,1604,3
0.894,0.0001,851,853,2,25,0.01,1704,3
0.862,0.0001,902,902,2,25,0.01,1804,3
0.878,0.0001,956,948,2,25,0.01,1904,3
0.876,0.0001,1002,1002,2,25,0.01,2004,3
0.578,0.0001,44,60,2,25,0.01,104,4
0.566,0.0001,92,112,2,25,0.01,204,4
0.526,0.0001,129,175,2,25,0.01,304,4
0.462,0.0001,183,221,2,25,0.01,404,4
0.48,0.0001,232,272,2,25,0.01,504,4
0.502,0.0001,279,325,2,25,0.01,604,4
0.502,0.0001,331,373,2,25,0.01,704,4
0.53,0.0001,379,425,2,25,0.01,804,4
0.566,0.0001,432,472,2,25,0.01,904,4
0.682,0.0001,488,516,2,25,0.01,1004,4
0.714,0.0001,536,568,2,25,0.01,1104,4
0.748,0.0001,587,617,2,25,0.01,1204,4
0.78,0.0001,647,657,2,25,0.01,1304,4
0.872,0.0001,694,710,2,25,0.01,1404,4
0.908,0.0001,742,762,2,25,0.01,1504,4
0.906,0.0001,792,812,2,25,0.01,1604,4
0.882,0.0001,842,862,2,25,0.01,1704,4
0.914,0.0001,892,912,2,25,0.01,1804,4
0.926,0.0001,949,955,2,25,0.01,1904,4
0.932,0.0001,998,1006,2,25,0.01,2004,4
0.484,0.0001,56,48,2,25,0.01,104,5
0.534,0.0001,106,98,2,25,0.01,204,5
0.554,0.0001,155,149,2,25,0.01,304,5
0.594,0.0001,217,187,2,25,0.01,404,5
0.646,0.0001,263,241,2,25,0.01,504,5
0.698,0.0001,305,299,2,25,0.01,604,5
0.712,0.0001,362,342,2,25,0.01,704,5
0.724,0.0001,410,394,2,25,0.01,804,5
0.74,0.0001,461,443,2,25,0.01,904,5
0.766,0.0001,506,498,2,25,0.01,1004,5
0.784,0.0001,549,555,2,25,0.01,1104,5
0.826,0.0001,600,604,2,25,0.01,1204,5
0.864,0.0001,652,652,2,25,0.01,1304,5
0.888,0.0001,705,699,2,25,0.01,1404,5
0.906,0.0001,755,749,2,25,0.01,1504,5
0.912,0.0001,804,800,2,25,0.01,1604,5
0.922,0.0001,847,857,2,25,0.01,1704,5
0.928,0.0001,891,913,2,25,0.01,1804,5
0.93,0.0001,949,955,2,25,0.01,1904,5
0.938,0.0001,991,1013,2,25,0.01,2004,5
0.638,0.0001,55,49,2,25,0.01,104,6
0.57,0.0001,102,102,2,25,0.01,204,6
0.526,0.0001,146,158,2,25,0.01,304,6
0.504,0.0001,190,214,2,25,0.01,404,6
0.522,0.0001,234,270,2,25,0.01,504,6
0.554,0.0001,277,327,2,25,0.01,604,6
0.588,0.0001,331,373,2,25,0.01,704,6
0.628,0.0001,375,429,2,25,0.01,804,6
0.662,0.0001,426,478,2,25,0.01,904,6
0.722,0.0001,477,527,2,25,0.01,1004,6
0.748,0.0001,538,566,2,25,0.01,1104,6
0.772,0.0001,590,614,2,25,0.01,1204,6
0.8,0.0001,641,663,2,25,0.01,1304,6
0.824,0.0001,696,708,2,25,0.01,1404,6
0.852,0.0001,745,759,2,25,0.01,1504,6
0.87,0.0001,804,800,2,25,0.01,1604,6
0.846,0.0001,856,848,2,25,0.01,1704,6
0.874,0.0001,900,904,2,25,0.01,1804,6
0.894,0.0001,950,954,2,25,0.01,1904,6
0.914,0.0001,998,1006,2,25,0.01,2004,6
0.452,0.0001,48,56,2,25,0.01,104,7
0.46,0.0001,98,106,2,25,0.01,204,7
0.5,0.0001,147,157,2,25,0.01,304,7
0.6,0.0001,194,210,2,25,0.01,404,7
0.644,0.0001,246,258,2,25,0.01,504,7
0.672,0.0001,296,308,2,25,0.01,604,7
0.666,0.0001,351,353,2,25,0.01,704,7
0.698,0.0001,401,403,2,25,0.01,804,7
0.714,0.0001,449,455,2,25,0.01,904,7
0.764,0.0001,497,507,2,25,0.01,1004,7
0.784,0.0001,550,554,2,25,0.01,1104,7
0.796,0.0001,611,593,2,25,0.01,1204,7
0.822,0.0001,661,643,2,25,0.01,1304,7
0.86,0.0001,709,695,2,25,0.01,1404,7
0.88,0.0001,756,748,2,25,0.01,1504,7
0.868,0.0001,804,800,2,25,0.01,1604,7
0.858,0.0001,846,858,2,25,0.01,1704,7
0.876,0.0001,886,918,2,25,0.01,1804,7
0.894,0.0001,939,965,2,25,0.01,1904,7
0.9,0.0001,986,1018,2,25,0.01,2004,7
0.57,0.0001,52,52,2,25,0.01,104,8
0.624,0.0001,102,102,2,25,0.01,204,8
0.668,0.0001,157,147,2,25,0.01,304,8
0.728,0.0001,211,193,2,25,0.01,404,8
0.726,0.0001,264,240,2,25,0.01,504,8
0.726,0.0001,313,291,2,25,0.01,604,8
0.744,0.0001,362,342,2,25,0.01,704,8
0.768,0.0001,410,394,2,25,0.01,804,8
0.772,0.0001,454,450,2,25,0.01,904,8
0.786,0.0001,502,502,2,25,0.01,1004,8
0.81,0.0001,556,548,2,25,0.01,1104,8
0.82,0.0001,607,597,2,25,0.01,1204,8
0.848,0.0001,656,648,2,25,0.01,1304,8
0.864,0.0001,712,692,2,25,0.01,1404,8
0.888,0.0001,760,744,2,25,0.01,1504,8
0.884,0.0001,799,805,2,25,0.01,1604,8
0.888,0.0001,850,854,2,25,0.01,1704,8
0.9,0.0001,904,900,2,25,0.01,1804,8
0.908,0.0001,956,948,2,25,0.01,1904,8
0.918,0.0001,1001,1003,2,25,0.01,2004,8
0.498,0.0001,51,53,2,25,0.01,104,9
0.532,0.0001,99,105,2,25,0.01,204,9
0.56,0.0001,145,159,2,25,0.01,304,9
0.632,0.0001,196,208,2,25,0.01,404,9
0.644,0.0001,244,260,2,25,0.01,504,9
0.666,0.0001,300,304,2,25,0.01,604,9
0.672,0.0001,356,348,2,25,0.01,704,9
0.696,0.0001,403,401,2,25,0.01,804,9
0.71,0.0001,455,449,2,25,0.01,904,9
0.708,0.0001,512,492,2,25,0.01,1004,9
0.774,0.0001,561,543,2,25,0.01,1104,9
0.804,0.0001,614,590,2,25,0.01,1204,9
0.78,0.0001,663,641,2,25,0.01,1304,9
0.856,0.0001,717,687,2,25,0.01,1404,9
0.89,0.0001,760,744,2,25,0.01,1504,9
0.9,0.0001,815,789,2,25,0.01,1604,9
0.91,0.0001,870,834,2,25,0.01,1704,9
0.904,0.0001,920,884,2,25,0.01,1804,9
0.904,0.0001,970,934,2,25,0.01,1904,9
0.908,0.0001,1016,988,2,25,0.01,2004,9
0.364,0.0001,51,53,2,25,0.01,104,10
0.316,0.0001,102,102,2,25,0.01,204,10
0.558,0.0001,154,150,2,25,0.01,304,10
0.53,0.0001,201,203,2,25,0.01,404,10
0.516,0.0001,253,251,2,25,0.01,504,10
0.52,0.0001,299,305,2,25,0.01,604,10
0.522,0.0001,351,353,2,25,0.01,704,10
0.5,0.0001,398,406,2,25,0.01,804,10
0.674,0.0001,445,459,2,25,0.01,904,10
0.768,0.0001,498,506,2,25,0.01,1004,10
0.766,0.0001,551,553,2,25,0.01,1104,10
0.792,0.0001,599,605,2,25,0.01,1204,10
0.814,0.0001,648,656,2,25,0.01,1304,10
0.836,0.0001,699,705,2,25,0.01,1404,10
0.826,0.0001,752,752,2,25,0.01,1504,10
0.874,0.0001,801,803,2,25,0.01,1604,10
0.922,0.0001,847,857,2,25,0.01,1704,10
0.906,0.0001,895,909,2,25,0.01,1804,10
0.9,0.0001,950,954,2,25,0.01,1904,10
0.892,0.0001,996,1008,2,25,0.01,2004,10
0.49,0.0001,49,55,2,25,0.01,104,11
0.494,0.0001,95,109,2,25,0.01,204,11
0.53,0.0001,143,161,2,25,0.01,304,11
0.576,0.0001,191,213,2,25,0.01,404,11
0.592,0.0001,233,271,2,25,0.01,504,11
0.656,0.0001,275,329,2,25,0.01,604,11
0.7,0.0001,331,373,2,25,0.01,704,11
0.684,0.0001,386,418,2,25,0.01,804,11
0.728,0.0001,434,470,2,25,0.01,904,11
0.768,0.0001,486,518,2,25,0.01,1004,11
0.788,0.0001,536,568,2,25,0.01,1104,11
0.802,0.0001,588,616,2,25,0.01,1204,11
0.808,0.0001,649,655,2,25,0.01,1304,11
0.842,0.0001,696,708,2,25,0.01,1404,11
0.872,0.0001,757,747,2,25,0.01,1504,11
0.876,0.0001,810,794,2,25,0.01,1604,11
0.876,0.0001,851,853,2,25,0.01,1704,11
0.906,0.0001,903,901,2,25,0.01,1804,11
0.908,0.0001,959,945,2,25,0.01,1904,11
0.92,0.0001,1003,1001,2,25,0.01,2004,11
0.486,0.0001,44,60,2,25,0.01,104,12
0.506,0.0001,83,121,2,25,0.01,204,12
0.554,0.0001,135,169,2,25,0.01,304,12
0.592,0.0001,179,225,2,25,0.01,404,12
0.618,0.0001,230,274,2,25,0.01,504,12
0.644,0.0001,280,324,2,25,0.01,604,12
0.624,0.0001,337,367,2,25,0.01,704,12
0.704,0.0001,392,412,2,25,0.01,804,12
0.742,0.0001,439,465,2,25,0.01,904,12
0.788,0.0001,487,517,2,25,0.01,1004,12
0.796,0.0001,534,570,2,25,0.01,1104,12
0.826,0.0001,588,616,2,25,0.01,1204,12
0.878,0.0001,644,660,2,25,0.01,1304,12
0.874,0.0001,696,708,2,25,0.01,1404,12
0.876,0.0001,751,753,2,25,0.01,1504,12
0.87,0.0001,793,811,2,25,0.01,1604,12
0.866,0.0001,844,860,2,25,0.01,1704,12
0.874,0.0001,890,914,2,25,0.01,1804,12
0.882,0.0001,943,961,2,25,0.01,1904,12
0.886,0.0001,993,1011,2,25,0.01,2004,12
0.542,0.0001,55,49,2,25,0.01,104,13
0.59,0.0001,113,91,2,25,0.01,204,13
0.606,0.0001,152,152,2,25,0.01,304,13
0.534,0.0001,207,197,2,25,0.01,404,13
0.53,0.0001,251,253,2,25,0.01,504,13
0.546,0.0001,297,307,2,25,0.01,604,13
0.602,0.0001,344,360,2,25,0.01,704,13
0.626,0.0001,391,413,2,25,0.01,804,13
0.706,0.0001,444,460,2,25,0.01,904,13
0.718,0.0001,496,508,2,25,0.01,1004,13
0.75,0.0001,545,559,2,25,0.01,1104,13
0.77,0.0001,599,605,2,25,0.01,1204,13
0.782,0.0001,651,653,2,25,0.01,1304,13
0.792,0.0001,703,701,2,25,0.01,1404,13
0.812,0.0001,746,758,2,25,0.01,1504,13
0.818,0.0001,798,806,2,25,0.01,1604,13
0.832,0.0001,854,850,2,25,0.01,1704,13
0.836,0.0001,905,899,2,25,0.01,1804,13
0.836,0.0001,950,954,2,25,0.01,1904,13
0.85,0.0001,992,1012,2,25,0.01,2004,13
0.542,0.0001,48,56,2,25,0.01,104,14
0.548,0.0001,103,101,2,25,0.01,204,14
0.538,0.0001,160,144,2,25,0.01,304,14
0.564,0.0001,214,190,2,25,0.01,404,14
0.644,0.0001,258,246,2,25,0.01,504,14
0.572,0.0001,299,305,2,25,0.01,604,14
0.536,0.0001,352,352,2,25,0.01,704,14
0.63,0.0001,400,404,2,25,0.01,804,14
0.682,0.0001,452,452,2,25,0.01,904,14
0.726,0.0001,501,503,2,25,0.01,1004,14
0.766,0.0001,542,562,2,25,0.01,1104,14
0.802,0.0001,585,619,2,25,0.01,1204,14
0.838,0.0001,630,674,2,25,0.01,1304,14
0.872,0.0001,682,722,2,25,0.01,1404,14
0.864,0.0001,737,767,2,25,0.01,1504,14
0.872,0.0001,783,821,2,25,0.01,1604,14
0.88,0.0001,833,871,2,25,0.01,1704,14
0.892,0.0001,892,912,2,25,0.01,1804,14
0.894,0.0001,935,969,2,25,0.01,1904,14
0.906,0.0001,990,1014,2,25,0.01,2004,14
0.524,0.0001,49,55,2,25,0.01,104,15
0.554,0.0001,104,100,2,25,0.01,204,15
0.568,0.0001,152,152,2,25,0.01,304,15
0.564,0.0001,200,204,2,25,0.01,404,15
0.576,0.0001,247,257,2,25,0.01,504,15
0.578,0.0001,298,306,2,25,0.01,604,15
0.598,0.0001,348,356,2,25,0.01,704,15
0.654,0.0001,395,409,2,25,0.01,804,15
0.686,0.0001,446,458,2,25,0.01,904,15
0.74,0.0001,489,515,2,25,0.01,1004,15
0.774,0.0001,544,560,2,25,0.01,1104,15
0.79,0.0001,597,607,2,25,0.01,1204,15
0.81,0.0001,637,667,2,25,0.01,1304,15
0.816,0.0001,691,713,2,25,0.01,1404,15
0.824,0.0001,745,759,2,25,0.01,1504,15
0.87,0.0001,795,809,2,25,0.01,1604,15
0.878,0.0001,849,855,2,25,0.01,1704,15
0.9,0.0001,893,911,2,25,0.01,1804,15
0.912,0.0001,952,952,2,25,0.01,1904,15
0.932,0.0001,996,1008,2,25,0.01,2004,15
0.504,0.0001,48,56,2,25,0.01,104,16
0.504,0.0001,94,110,2,25,0.01,204,16
0.508,0.0001,143,161,2,25,0.01,304,16
0.542,0.0001,198,206,2,25,0.01,404,16
0.548,0.0001,250,254,2,25,0.01,504,16
0.556,0.0001,310,294,2,25,0.01,604,16
0.59,0.0001,350,354,2,25,0.01,704,16
0.612,0.0001,398,406,2,25,0.01,804,16
0.588,0.0001,452,452,2,25,0.01,904,16
0.606,0.0001,493,511,2,25,0.01,1004,16
0.628,0.0001,539,565,2,25,0.01,1104,16
0.658,0.0001,592,612,2,25,0.01,1204,16
0.672,0.0001,648,656,2,25,0.01,1304,16
0.714,0.0001,692,712,2,25,0.01,1404,16
0.74,0.0001,739,765,2,25,0.01,1504,16
0.77,0.0001,799,805,2,25,0.01,1604,16
0.812,0.0001,851,853,2,25,0.01,1704,16
0.844,0.0001,903,901,2,25,0.01,1804,16
0.854,0.0001,945,959,2,25,0.01,1904,16
0.884,0.0001,1004,1000,2,25,0.01,2004,16
0.516,0.0001,40,64,2,25,0.01,104,17
0.534,0.0001,93,111,2,25,0.01,204,17
0.534,0.0001,152,152,2,25,0.01,304,17
0.562,0.0001,196,208,2,25,0.01,404,17
0.618,0.0001,247,257,2,25,0.01,504,17
0.65,0.0001,295,309,2,25,0.01,604,17
0.702,0.0001,346,358,2,25,0.01,704,17
0.74,0.0001,402,402,2,25,0.01,804,17
0.762,0.0001,456,448,2,25,0.01,904,17
0.782,0.0001,517,487,2,25,0.01,1004,17
0.8,0.0001,566,538,2,25,0.01,1104,17
0.824,0.0001,612,592,2,25,0.01,1204,17
0.832,0.0001,661,643,2,25,0.01,1304,17
0.846,0.0001,704,700,2,25,0.01,1404,17
0.882,0.0001,749,755,2,25,0.01,1504,17
0.892,0.0001,799,805,2,25,0.01,1604,17
0.894,0.0001,844,860,2,25,0.01,1704,17
0.892,0.0001,897,907,2,25,0.01,1804,17
0.894,0.0001,956,948,2,25,0.01,1904,17
0.898,0.0001,996,1008,2,25,0.01,2004,17
0.52,0.0001,52,52,2,25,0.01,104,18
0.532,0.0001,104,100,2,25,0.01,204,18
0.672,0.0001,155,149,2,25,0.01,304,18
0.736,0.0001,197,207,2,25,0.01,404,18
0.754,0.0001,244,260,2,25,0.01,504,18
0.774,0.0001,285,319,2,25,0.01,604,18
0.782,0.0001,332,372,2,25,0.01,704,18
0.78,0.0001,377,427,2,25,0.01,804,18
0.79,0.0001,432,472,2,25,0.01,904,18
0.802,0.0001,482,522,2,25,0.01,1004,18
0.804,0.0001,533,571,2,25,0.01,1104,18
0.826,0.0001,589,615,2,25,0.01,1204,18
0.84,0.0001,641,663,2,25,0.01,1304,18
0.87,0.0001,699,705,2,25,0.01,1404,18
0.9,0.0001,747,757,2,25,0.01,1504,18
0.892,0.0001,802,802,2,25,0.01,1604,18
0.886,0.0001,845,859,2,25,0.01,1704,18
0.898,0.0001,894,910,2,25,0.01,1804,18
0.918,0.0001,951,953,2,25,0.01,1904,18
0.922,0.0001,1005,999,2,25,0.01,2004,18
0.54,0.0001,44,60,2,25,0.01,104,19
0.568,0.0001,90,114,2,25,0.01,204,19
0.55,0.0001,132,172,2,25,0.01,304,19
0.568,0.0001,177,227,2,25,0.01,404,19
0.59,0.0001,230,274,2,25,0.01,504,19
0.598,0.0001,280,324,2,25,0.01,604,19
0.62,0.0001,328,376,2,25,0.01,704,19
0.652,0.0001,372,432,2,25,0.01,804,19
0.706,0.0001,423,481,2,25,0.01,904,19
0.768,0.0001,471,533,2,25,0.01,1004,19
0.826,0.0001,530,574,2,25,0.01,1104,19
0.856,0.0001,568,636,2,25,0.01,1204,19
0.866,0.0001,616,688,2,25,0.01,1304,19
0.876,0.0001,661,743,2,25,0.01,1404,19
0.876,0.0001,712,792,2,25,0.01,1504,19
0.882,0.0001,771,833,2,25,0.01,1604,19
0.886,0.0001,820,884,2,25,0.01,1704,19
0.91,0.0001,875,929,2,25,0.01,1804,19
0.916,0.0001,924,980,2,25,0.01,1904,19
0.908,0.0001,974,1030,2,25,0.01,2004,19
0.642,0.0001,56,48,2,25,0.01,104,20
0.638,0.0001,117,87,2,25,0.01,204,20
0.644,0.0001,159,145,2,25,0.01,304,20
0.684,0.0001,200,204,2,25,0.01,404,20
0.674,0.0001,250,254,2,25,0.01,504,20
0.792,0.0001,286,318,2,25,0.01,604,20
0.73,0.0001,332,372,2,25,0.01,704,20
0.716,0.0001,385,419,2,25,0.01,804,20
0.746,0.0001,434,470,2,25,0.01,904,20
0.8,0.0001,481,523,2,25,0.01,1004,20
0.848,0.0001,536,568,2,25,0.01,1104,20
0.868,0.0001,586,618,2,25,0.01,1204,20
0.88,0.0001,641,663,2,25,0.01,1304,20
0.876,0.0001,689,715,2,25,0.01,1404,20
0.868,0.0001,735,769,2,25,0.01,1504,20
0.878,0.0001,790,814,2,25,0.01,1604,20
0.89,0.0001,839,865,2,25,0.01,1704,20
0.9,0.0001,887,917,2,25,0.01,1804,20
0.918,0.0001,940,964,2,25,0.01,1904,20
0.92,0.0001,999,1005,2,25,0.01,2004,20
0.416,0.001,58,46,2,25,0.0001,104,1
0.416,0.001,104,100,2,25,0.0001,204,1
0.416,0.001,153,151,2,25,0.0001,304,1
0.414,0.001,206,198,2,25,0.0001,404,1
0.41,0.001,254,250,2,25,0.0001,504,1
0.408,0.001,307,297,2,25,0.0001,604,1
0.408,0.001,350,354,2,25,0.0001,704,1
0.408,0.001,394,410,2,25,0.0001,804,1
0.41,0.001,443,461,2,25,0.0001,904,1
0.41,0.001,493,511,2,25,0.0001,1004,1
0.41,0.001,542,562,2,25,0.0001,1104,1
0.408,0.001,596,608,2,25,0.0001,1204,1
0.41,0.001,648,656,2,25,0.0001,1304,1
0.41,0.001,691,713,2,25,0.0001,1404,1
0.41,0.001,741,763,2,25,0.0001,1504,1
0.41,0.001,794,810,2,25,0.0001,1604,1
0.412,0.001,845,859,2,25,0.0001,1704,1
0.41,0.001,907,897,2,25,0.0001,1804,1
0.408,0.001,953,951,2,25,0.0001,1904,1
0.408,0.001,1006,998,2,25,0.0001,2004,1
0.568,0.001,47,57,2,25,0.0001,104,2
0.568,0.001,98,106,2,25,0.0001,204,2
0.57,0.001,138,166,2,25,0.0001,304,2
0.57,0.001,183,221,2,25,0.0001,404,2
0.57,0.001,227,277,2,25,0.0001,504,2
0.57,0.001,281,323,2,25,0.0001,604,2
0.57,0.001,330,374,2,25,0.0001,704,2
0.572,0.001,376,428,2,25,0.0001,804,2
0.572,0.001,421,483,2,25,0.0001,904,2
0.572,0.001,470,534,2,25,0.0001,1004,2
0.572,0.001,529,575,2,25,0.0001,1104,2
0.568,0.001,580,624,2,25,0.0001,1204,2
0.57,0.001,630,674,2,25,0.0001,1304,2
0.57,0.001,679,725,2,25,0.0001,1404,2
0.57,0.001,727,777,2,25,0.0001,1504,2
0.572,0.001,783,821,2,25,0.0001,1604,2
0.574,0.001,835,869,2,25,0.0001,1704,2
0.578,0.001,889,915,2,25,0.0001,1804,2
0.578,0.001,938,966,2,25,0.0001,1904,2
0.58,0.001,990,1014,2,25,0.0001,2004,2
0.436,0.001,49,55,2,25,0.0001,104,3
0.436,0.001,98,106,2,25,0.0001,204,3
0.436,0.001,155,149,2,25,0.0001,304,3
0.434,0.001,211,193,2,25,0.0001,404,3
0.434,0.001,261,243,2,25,0.0001,504,3
0.434,0.001,312,292,2,25,0.0001,604,3
0.434,0.001,359,345,2,25,0.0001,704,3
0.434,0.001,410,394,2,25,0.0001,804,3
0.436,0.001,450,454,2,25,0.0001,904,3
0.436,0.001,500,504,2,25,0.0001,1004,3
0.436,0.001,547,557,2,25,0.0001,1104,3
0.436,0.001,607,597,2,25,0.0001,1204,3
0.438,0.001,662,642,2,25,0.0001,1304,3
0.432,0.001,713,691,2,25,0.0001,1404,3
0.43,0.001,758,746,2,25,0.0001,1504,3
0.428,0.001,806,798,2,25,0.0001,1604,3
0.428,0.001,853,851,2,25,0.0001,1704,3
0.424,0.001,908,896,2,25,0.0001,1804,3
0.422,0.001,964,940,2,25,0.0001,1904,3
0.418,0.001,1009,995,2,25,0.0001,2004,3
0.52,0.001,56,48,2,25,0.0001,104,4
0.52,0.001,106,98,2,25,0.0001,204,4
0.52,0.001,145,159,2,25,0.0001,304,4
0.52,0.001,193,211,2,25,0.0001,404,4
0.52,0.001,242,262,2,25,0.0001,504,4
0.52,0.001,290,314,2,25,0.0001,604,4
0.52,0.001,346,358,2,25,0.0001,704,4
0.52,0.001,402,402,2,25,0.0001,804,4
0.52,0.001,452,452,2,25,0.0001,904,4
0.52,0.001,504,500,2,25,0.0001,1004,4
0.52,0.001,545,559,2,25,0.0001,1104,4
0.52,0.001,601,603,2,25,0.0001,1204,4
0.52,0.001,649,655,2,25,0.0001,1304,4
0.52,0.001,704,700,2,25,0.0001,1404,4
0.52,0.001,751,753,2,25,0.0001,1504,4
0.52,0.001,801,803,2,25,0.0001,1604,4
0.52,0.001,847,857,2,25,0.0001,1704,4
0.52,0.001,900,904,2,25,0.0001,1804,4
0.52,0.001,945,959,2,25,0.0001,1904,4
0.52,0.001,992,1012,2,25,0.0001,2004,4
0.468,0.001,69,35,2,25,0.0001,104,5
0.468,0.001,123,81,2,25,0.0001,204,5
0.468,0.001,172,132,2,25,0.0001,304,5
0.468,0.001,225,179,2,25,0.0001,404,5
0.466,0.001,272,232,2,25,0.0001,504,5
0.466,0.001,325,279,2,25,0.0001,604,5
0.464,0.001,368,336,2,25,0.0001,704,5
0.464,0.001,417,387,2,25,0.0001,804,5
0.464,0.001,466,438,2,25,0.0001,904,5
0.468,0.001,518,486,2,25,0.0001,1004,5
0.468,0.001,565,539,2,25,0.0001,1104,5
0.47,0.001,610,594,2,25,0.0001,1204,5
0.472,0.001,665,639,2,25,0.0001,1304,5
0.472,0.001,713,691,2,25,0.0001,1404,5
0.474,0.001,752,752,2,25,0.0001,1504,5
0.476,0.001,801,803,2,25,0.0001,1604,5
0.478,0.001,852,852,2,25,0.0001,1704,5
0.48,0.001,899,905,2,25,0.0001,1804,5
0.482,0.001,954,950,2,25,0.0001,1904,5
0.482,0.001,1000,1004,2,25,0.0001,2004,5
0.502,0.001,54,50,2,25,0.0001,104,6
0.502,0.001,96,108,2,25,0.0001,204,6
0.502,0.001,143,161,2,25,0.0001,304,6
0.502,0.001,186,218,2,25,0.0001,404,6
0.502,0.001,232,272,2,25,0.0001,504,6
0.502,0.001,284,320,2,25,0.0001,604,6
0.502,0.001,327,377,2,25,0.0001,704,6
0.502,0.001,376,428,2,25,0.0001,804,6
0.502,0.001,422,482,2,25,0.0001,904,6
0.502,0.001,470,534,2,25,0.0001,1004,6
0.502,0.001,519,585,2,25,0.0001,1104,6
0.502,0.001,581,623,2,25,0.0001,1204,6
0.502,0.001,639,665,2,25,0.0001,1304,6
0.502,0.001,685,719,2,25,0.0001,1404,6
0.502,0.001,743,761,2,25,0.0001,1504,6
0.502,0.001,796,808,2,25,0.0001,1604,6
0.5,0.001,848,856,2,25,0.0001,1704,6
0.5,0.001,900,904,2,25,0.0001,1804,6
0.5,0.001,955,949,2,25,0.0001,1904,6
0.5,0.001,998,1006,2,25,0.0001,2004,6
0.476,0.001,52,52,2,25,0.0001,104,7
0.476,0.001,107,97,2,25,0.0001,204,7
0.472,0.001,157,147,2,25,0.0001,304,7
0.472,0.001,206,198,2,25,0.0001,404,7
0.474,0.001,244,260,2,25,0.0001,504,7
0.474,0.001,293,311,2,25,0.0001,604,7
0.474,0.001,341,363,2,25,0.0001,704,7
0.472,0.001,397,407,2,25,0.0001,804,7
0.474,0.001,441,463,2,25,0.0001,904,7
0.478,0.001,495,509,2,25,0.0001,1004,7
0.476,0.001,549,555,2,25,0.0001,1104,7
0.474,0.001,598,606,2,25,0.0001,1204,7
0.472,0.001,644,660,2,25,0.0001,1304,7
0.468,0.001,699,705,2,25,0.0001,1404,7
0.464,0.001,742,762,2,25,0.0001,1504,7
0.462,0.001,788,816,2,25,0.0001,1604,7
0.466,0.001,832,872,2,25,0.0001,1704,7
0.468,0.001,882,922,2,25,0.0001,1804,7
0.468,0.001,934,970,2,25,0.0001,1904,7
0.472,0.001,991,1013,2,25,0.0001,2004,7
0.518,0.001,43,61,2,25,0.0001,104,8
0.518,0.001,94,110,2,25,0.0001,204,8
0.518,0.001,134,170,2,25,0.0001,304,8
0.518,0.001,196,208,2,25,0.0001,404,8
0.518,0.001,245,259,2,25,0.0001,504,8
0.518,0.001,302,302,2,25,0.0001,604,8
0.518,0.001,344,360,2,25,0.0001,704,8
0.518,0.001,409,395,2,25,0.0001,804,8
0.518,0.001,462,442,2,25,0.0001,904,8
0.518,0.001,512,492,2,25,0.0001,1004,8
0.518,0.001,559,545,2,25,0.0001,1104,8
0.518,0.001,601,603,2,25,0.0001,1204,8
0.518,0.001,656,648,2,25,0.0001,1304,8
0.518,0.001,698,706,2,25,0.0001,1404,8
0.518,0.001,745,759,2,25,0.0001,1504,8
0.518,0.001,786,818,2,25,0.0001,1604,8
0.518,0.001,834,870,2,25,0.0001,1704,8
0.518,0.001,885,919,2,25,0.0001,1804,8
0.518,0.001,938,966,2,25,0.0001,1904,8
0.518,0.001,993,1011,2,25,0.0001,2004,8
0.408,0.001,51,53,2,25,0.0001,104,9
0.408,0.001,102,102,2,25,0.0001,204,9
0.408,0.001,154,150,2,25,0.0001,304,9
0.408,0.001,207,197,2,25,0.0001,404,9
0.408,0.001,262,242,2,25,0.0001,504,9
0.408,0.001,313,291,2,25,0.0001,604,9
0.408,0.001,357,347,2,25,0.0001,704,9
0.408,0.001,399,405,2,25,0.0001,804,9
0.408,0.001,453,451,2,25,0.0001,904,9
0.408,0.001,500,504,2,25,0.0001,1004,9
0.408,0.001,550,554,2,25,0.0001,1104,9
0.408,0.001,605,599,2,25,0.0001,1204,9
0.408,0.001,648,656,2,25,0.0001,1304,9
0.406,0.001,700,704,2,25,0.0001,1404,9
0.406,0.001,742,762,2,25,0.0001,1504,9
0.404,0.001,798,806,2,25,0.0001,1604,9
0.404,0.001,851,853,2,25,0.0001,1704,9
0.404,0.001,898,906,2,25,0.0001,1804,9
0.406,0.001,951,953,2,25,0.0001,1904,9
0.41,0.001,998,1006,2,25,0.0001,2004,9
0.456,0.001,50,54,2,25,0.0001,104,10
0.458,0.001,96,108,2,25,0.0001,204,10
0.458,0.001,146,158,2,25,0.0001,304,10
0.458,0.001,192,212,2,25,0.0001,404,10
0.46,0.001,244,260,2,25,0.0001,504,10
0.46,0.001,300,304,2,25,0.0001,604,10
0.458,0.001,345,359,2,25,0.0001,704,10
0.46,0.001,399,405,2,25,0.0001,804,10
0.458,0.001,448,456,2,25,0.0001,904,10
0.458,0.001,497,507,2,25,0.0001,1004,10
0.46,0.001,550,554,2,25,0.0001,1104,10
0.46,0.001,597,607,2,25,0.0001,1204,10
0.46,0.001,647,657,2,25,0.0001,1304,10
0.46,0.001,697,707,2,25,0.0001,1404,10
0.456,0.001,752,752,2,25,0.0001,1504,10
0.456,0.001,805,799,2,25,0.0001,1604,10
0.454,0.001,851,853,2,25,0.0001,1704,10
0.456,0.001,894,910,2,25,0.0001,1804,10
0.454,0.001,947,957,2,25,0.0001,1904,10
0.456,0.001,995,1009,2,25,0.0001,2004,10
0.516,0.001,56,48,2,25,0.0001,104,11
0.516,0.001,101,103,2,25,0.0001,204,11
0.516,0.001,149,155,2,25,0.0001,304,11
0.516,0.001,200,204,2,25,0.0001,404,11
0.516,0.001,254,250,2,25,0.0001,504,11
0.516,0.001,305,299,2,25,0.0001,604,11
0.516,0.001,350,354,2,25,0.0001,704,11
0.516,0.001,403,401,2,25,0.0001,804,11
0.516,0.001,450,454,2,25,0.0001,904,11
0.516,0.001,503,501,2,25,0.0001,1004,11
0.516,0.001,552,552,2,25,0.0001,1104,11
0.516,0.001,601,603,2,25,0.0001,1204,11
0.516,0.001,646,658,2,25,0.0001,1304,11
0.516,0.001,692,712,2,25,0.0001,1404,11
0.516,0.001,744,760,2,25,0.0001,1504,11
0.516,0.001,793,811,2,25,0.0001,1604,11
0.516,0.001,840,864,2,25,0.0001,1704,11
0.516,0.001,893,911,2,25,0.0001,1804,11
0.516,0.001,953,951,2,25,0.0001,1904,11
0.516,0.001,1010,994,2,25,0.0001,2004,11
0.59,0.001,45,59,2,25,0.0001,104,12
0.59,0.001,98,106,2,25,0.0001,204,12
0.59,0.001,147,157,2,25,0.0001,304,12
0.59,0.001,188,216,2,25,0.0001,404,12
0.59,0.001,243,261,2,25,0.0001,504,12
0.59,0.001,295,309,2,25,0.0001,604,12
0.592,0.001,350,354,2,25,0.0001,704,12
0.594,0.001,396,408,2,25,0.0001,804,12
0.594,0.001,443,461,2,25,0.0001,904,12
0.594,0.001,491,513,2,25,0.0001,1004,12
0.596,0.001,547,557,2,25,0.0001,1104,12
0.598,0.001,597,607,2,25,0.0001,1204,12
0.598,0.001,639,665,2,25,0.0001,1304,12
0.598,0.001,688,716,2,25,0.0001,1404,12
0.598,0.001,741,763,2,25,0.0001,1504,12
0.598,0.001,793,811,2,25,0.0001,1604,12
0.6,0.001,846,858,2,25,0.0001,1704,12
0.602,0.001,896,908,2,25,0.0001,1804,12
0.602,0.001,950,954,2,25,0.0001,1904,12
0.606,0.001,997,1007,2,25,0.0001,2004,12
0.478,0.001,43,61,2,25,0.0001,104,13
0.478,0.001,91,113,2,25,0.0001,204,13
0.478,0.001,139,165,2,25,0.0001,304,13
0.478,0.001,193,211,2,25,0.0001,404,13
0.478,0.001,249,255,2,25,0.0001,504,13
0.478,0.001,291,313,2,25,0.0001,604,13
0.478,0.001,339,365,2,25,0.0001,704,13
0.478,0.001,380,424,2,25,0.0001,804,13
0.478,0.001,431,473,2,25,0.0001,904,13
0.478,0.001,475,529,2,25,0.0001,1004,13
0.478,0.001,521,583,2,25,0.0001,1104,13
0.478,0.001,570,634,2,25,0.0001,1204,13
0.478,0.001,622,682,2,25,0.0001,1304,13
0.478,0.001,671,733,2,25,0.0001,1404,13
0.478,0.001,727,777,2,25,0.0001,1504,13
0.478,0.001,772,832,2,25,0.0001,1604,13
0.478,0.001,823,881,2,25,0.0001,1704,13
0.478,0.001,873,931,2,25,0.0001,1804,13
0.478,0.001,930,974,2,25,0.0001,1904,13
0.478,0.001,991,1013,2,25,0.0001,2004,13
0.49,0.001,52,52,2,25,0.0001,104,14
0.49,0.001,97,107,2,25,0.0001,204,14
0.49,0.001,143,161,2,25,0.0001,304,14
0.49,0.001,197,207,2,25,0.0001,404,14
0.49,0.001,244,260,2,25,0.0001,504,14
0.49,0.001,294,310,2,25,0.0001,604,14
0.49,0.001,342,362,2,25,0.0001,704,14
0.49,0.001,387,417,2,25,0.0001,804,14
0.49,0.001,440,464,2,25,0.0001,904,14
0.49,0.001,481,523,2,25,0.0001,1004,14
0.49,0.001,532,572,2,25,0.0001,1104,14
0.49,0.001,590,614,2,25,0.0001,1204,14
0.49,0.001,641,663,2,25,0.0001,1304,14
0.49,0.001,697,707,2,25,0.0001,1404,14
0.49,0.001,746,758,2,25,0.0001,1504,14
0.49,0.001,804,800,2,25,0.0001,1604,14
0.49,0.001,862,842,2,25,0.0001,1704,14
0.49,0.001,913,891,2,25,0.0001,1804,14
0.49,0.001,964,940,2,25,0.0001,1904,14
0.49,0.001,1007,997,2,25,0.0001,2004,14
0.47,0.001,50,54,2,25,0.0001,104,15
0.47,0.001,92,112,2,25,0.0001,204,15
0.47,0.001,152,152,2,25,0.0001,304,15
0.47,0.001,199,205,2,25,0.0001,404,15
0.47,0.001,252,252,2,25,0.0001,504,15
0.47,0.001,304,300,2,25,0.0001,604,15
0.47,0.001,350,354,2,25,0.0001,704,15
0.47,0.001,402,402,2,25,0.0001,804,15
0.47,0.001,454,450,2,25,0.0001,904,15
0.47,0.001,512,492,2,25,0.0001,1004,15
0.47,0.001,553,551,2,25,0.0001,1104,15
0.472,0.001,605,599,2,25,0.0001,1204,15
0.476,0.001,656,648,2,25,0.0001,1304,15
0.476,0.001,708,696,2,25,0.0001,1404,15
0.478,0.001,761,743,2,25,0.0001,1504,15
0.478,0.001,809,795,2,25,0.0001,1604,15
0.478,0.001,857,847,2,25,0.0001,1704,15
0.48,0.001,900,904,2,25,0.0001,1804,15
0.48,0.001,950,954,2,25,0.0001,1904,15
0.484,0.001,1010,994,2,25,0.0001,2004,15
0.486,0.001,59,45,2,25,0.0001,104,16
0.486,0.001,103,101,2,25,0.0001,204,16
0.486,0.001,153,151,2,25,0.0001,304,16
0.486,0.001,208,196,2,25,0.0001,404,16
0.486,0.001,263,241,2,25,0.0001,504,16
0.486,0.001,313,291,2,25,0.0001,604,16
0.486,0.001,366,338,2,25,0.0001,704,16
0.486,0.001,416,388,2,25,0.0001,804,16
0.486,0.001,467,437,2,25,0.0001,904,16
0.486,0.001,513,491,2,25,0.0001,1004,16
0.486,0.001,566,538,2,25,0.0001,1104,16
0.486,0.001,616,588,2,25,0.0001,1204,16
0.486,0.001,660,644,2,25,0.0001,1304,16
0.486,0.001,711,693,2,25,0.0001,1404,16
0.486,0.001,761,743,2,25,0.0001,1504,16
0.486,0.001,809,795,2,25,0.0001,1604,16
0.486,0.001,856,848,2,25,0.0001,1704,16
0.488,0.001,897,907,2,25,0.0001,1804,16
0.488,0.001,951,953,2,25,0.0001,1904,16
0.488,0.001,995,1009,2,25,0.0001,2004,16
0.518,0.001,49,55,2,25,0.0001,104,17
0.52,0.001,104,100,2,25,0.0001,204,17
0.52,0.001,152,152,2,25,0.0001,304,17
0.52,0.001,200,204,2,25,0.0001,404,17
0.52,0.001,254,250,2,25,0.0001,504,17
0.52,0.001,299,305,2,25,0.0001,604,17
0.522,0.001,349,355,2,25,0.0001,704,17
0.524,0.001,399,405,2,25,0.0001,804,17
0.526,0.001,445,459,2,25,0.0001,904,17
0.528,0.001,494,510,2,25,0.0001,1004,17
0.528,0.001,551,553,2,25,0.0001,1104,17
0.53,0.001,603,601,2,25,0.0001,1204,17
0.534,0.001,651,653,2,25,0.0001,1304,17
0.534,0.001,702,702,2,25,0.0001,1404,17
0.538,0.001,753,751,2,25,0.0001,1504,17
0.542,0.001,805,799,2,25,0.0001,1604,17
0.544,0.001,857,847,2,25,0.0001,1704,17
0.546,0.001,903,901,2,25,0.0001,1804,17
0.552,0.001,954,950,2,25,0.0001,1904,17
0.548,0.001,1010,994,2,25,0.0001,2004,17
0.442,0.001,52,52,2,25,0.0001,104,18
0.442,0.001,100,104,2,25,0.0001,204,18
0.442,0.001,155,149,2,25,0.0001,304,18
0.442,0.001,208,196,2,25,0.0001,404,18
0.442,0.001,249,255,2,25,0.0001,504,18
0.442,0.001,290,314,2,25,0.0001,604,18
0.442,0.001,342,362,2,25,0.0001,704,18
0.442,0.001,387,417,2,25,0.0001,804,18
0.442,0.001,433,471,2,25,0.0001,904,18
0.442,0.001,486,518,2,25,0.0001,1004,18
0.442,0.001,537,567,2,25,0.0001,1104,18
0.442,0.001,583,621,2,25,0.0001,1204,18
0.444,0.001,633,671,2,25,0.0001,1304,18
0.444,0.001,681,723,2,25,0.0001,1404,18
0.444,0.001,726,778,2,25,0.0001,1504,18
0.444,0.001,775,829,2,25,0.0001,1604,18
0.444,0.001,823,881,2,25,0.0001,1704,18
0.444,0.001,868,936,2,25,0.0001,1804,18
0.444,0.001,921,983,2,25,0.0001,1904,18
0.444,0.001,973,1031,2,25,0.0001,2004,18
0.538,0.001,62,42,2,25,0.0001,104,19
0.538,0.001,107,97,2,25,0.0001,204,19
0.538,0.001,160,144,2,25,0.0001,304,19
0.538,0.001,216,188,2,25,0.0001,404,19
0.538,0.001,267,237,2,25,0.0001,504,19
0.538,0.001,320,284,2,25,0.0001,604,19
0.538,0.001,372,332,2,25,0.0001,704,19
0.538,0.001,422,382,2,25,0.0001,804,19
0.538,0.001,473,431,2,25,0.0001,904,19
0.538,0.001,517,487,2,25,0.0001,1004,19
0.538,0.001,565,539,2,25,0.0001,1104,19
0.538,0.001,616,588,2,25,0.0001,1204,19
0.538,0.001,661,643,2,25,0.0001,1304,19
0.54,0.001,707,697,2,25,0.0001,1404,19
0.54,0.001,754,750,2,25,0.0001,1504,19
0.542,0.001,805,799,2,25,0.0001,1604,19
0.542,0.001,856,848,2,25,0.0001,1704,19
0.542,0.001,915,889,2,25,0.0001,1804,19
0.542,0.001,963,941,2,25,0.0001,1904,19
0.542,0.001,1012,992,2,25,0.0001,2004,19
0.56,0.001,62,42,2,25,0.0001,104,20
0.558,0.001,116,88,2,25,0.0001,204,20
0.56,0.001,155,149,2,25,0.0001,304,20
0.56,0.001,197,207,2,25,0.0001,404,20
0.56,0.001,255,249,2,25,0.0001,504,20
0.56,0.001,304,300,2,25,0.0001,604,20
0.56,0.001,358,346,2,25,0.0001,704,20
0.558,0.001,405,399,2,25,0.0001,804,20
0.56,0.001,457,447,2,25,0.0001,904,20
0.56,0.001,500,504,2,25,0.0001,1004,20
0.566,0.001,545,559,2,25,0.0001,1104,20
0.57,0.001,593,611,2,25,0.0001,1204,20
0.574,0.001,643,661,2,25,0.0001,1304,20
0.576,0.001,685,719,2,25,0.0001,1404,20
0.58,0.001,736,768,2,25,0.0001,1504,20
0.582,0.001,795,809,2,25,0.0001,1604,20
0.582,0.001,849,855,2,25,0.0001,1704,20
0.584,0.001,895,909,2,25,0.0001,1804,20
0.586,0.001,946,958,2,25,0.0001,1904,20
0.584,0.001,989,1015,2,25,0.0001,2004,20
0.498,0.001,55,49,2,25,0.001,104,1
0.498,0.001,109,95,2,25,0.001,204,1
0.494,0.001,166,138,2,25,0.001,304,1
0.488,0.001,222,182,2,25,0.001,404,1
0.488,0.001,268,236,2,25,0.001,504,1
0.498,0.001,324,280,2,25,0.001,604,1
0.502,0.001,377,327,2,25,0.001,704,1
0.526,0.001,422,382,2,25,0.001,804,1
0.55,0.001,473,431,2,25,0.001,904,1
0.578,0.001,520,484,2,25,0.001,1004,1
0.6,0.001,570,534,2,25,0.001,1104,1
0.64,0.001,616,588,2,25,0.001,1204,1
0.688,0.001,666,638,2,25,0.001,1304,1
0.72,0.001,714,690,2,25,0.001,1404,1
0.736,0.001,755,749,2,25,0.001,1504,1
0.754,0.001,811,793,2,25,0.001,1604,1
0.752,0.001,865,839,2,25,0.001,1704,1
0.764,0.001,925,879,2,25,0.001,1804,1
0.76,0.001,974,930,2,25,0.001,1904,1
0.76,0.001,1018,986,2,25,0.001,2004,1
0.492,0.001,55,49,2,25,0.001,104,2
0.492,0.001,103,101,2,25,0.001,204,2
0.492,0.001,159,145,2,25,0.001,304,2
0.492,0.001,207,197,2,25,0.001,404,2
0.492,0.001,254,250,2,25,0.001,504,2
0.496,0.001,299,305,2,25,0.001,604,2
0.498,0.001,345,359,2,25,0.001,704,2
0.502,0.001,392,412,2,25,0.001,804,2
0.506,0.001,445,459,2,25,0.001,904,2
0.514,0.001,488,516,2,25,0.001,1004,2
0.518,0.001,541,563,2,25,0.001,1104,2
0.52,0.001,589,615,2,25,0.001,1204,2
0.528,0.001,632,672,2,25,0.001,1304,2
0.536,0.001,684,720,2,25,0.001,1404,2
0.536,0.001,738,766,2,25,0.001,1504,2
0.548,0.001,791,813,2,25,0.001,1604,2
0.554,0.001,838,866,2,25,0.001,1704,2
0.582,0.001,880,924,2,25,0.001,1804,2
0.592,0.001,944,960,2,25,0.001,1904,2
0.622,0.001,988,1016,2,25,0.001,2004,2
0.488,0.001,51,53,2,25,0.001,104,3
0.488,0.001,97,107,2,25,0.001,204,3
0.488,0.001,146,158,2,25,0.001,304,3
0.488,0.001,201,203,2,25,0.001,404,3
0.488,0.001,254,250,2,25,0.001,504,3
0.492,0.001,302,302,2,25,0.001,604,3
0.506,0.001,350,354,2,25,0.001,704,3
0.528,0.001,402,402,2,25,0.001,804,3
0.544,0.001,454,450,2,25,0.001,904,3
0.562,0.001,500,504,2,25,0.001,1004,3
0.574,0.001,549,555,2,25,0.001,1104,3
0.586,0.001,598,606,2,25,0.001,1204,3
0.598,0.001,642,662,2,25,0.001,1304,3
0.606,0.001,693,711,2,25,0.001,1404,3
0.618,0.001,746,758,2,25,0.001,1504,3
0.628,0.001,801,803,2,25,0.001,1604,3
0.64,0.001,849,855,2,25,0.001,1704,3
0.664,0.001,898,906,2,25,0.001,1804,3
0.682,0.001,944,960,2,25,0.001,1904,3
0.732,0.001,996,1008,2,25,0.001,2004,3
0.51,0.001,52,52,2,25,0.001,104,4
0.51,0.001,113,91,2,25,0.001,204,4
0.51,0.001,166,138,2,25,0.001,304,4
0.51,0.001,222,182,2,25,0.001,404,4
0.51,0.001,278,226,2,25,0.001,504,4
0.51,0.001,334,270,2,25,0.001,604,4
0.51,0.001,381,323,2,25,0.001,704,4
0.51,0.001,434,370,2,25,0.001,804,4
0.51,0.001,480,424,2,25,0.001,904,4
0.51,0.001,531,473,2,25,0.001,1004,4
0.504,0.001,579,525,2,25,0.001,1104,4
0.5,0.001,631,573,2,25,0.001,1204,4
0.496,0.001,675,629,2,25,0.001,1304,4
0.492,0.001,723,681,2,25,0.001,1404,4
0.494,0.001,769,735,2,25,0.001,1504,4
0.492,0.001,822,782,2,25,0.001,1604,4
0.498,0.001,866,838,2,25,0.001,1704,4
0.5,0.001,904,900,2,25,0.001,1804,4
0.502,0.001,960,944,2,25,0.001,1904,4
0.504,0.001,1007,997,2,25,0.001,2004,4
0.59,0.001,44,60,2,25,0.001,104,5
0.614,0.001,99,105,2,25,0.001,204,5
0.614,0.001,152,152,2,25,0.001,304,5
0.624,0.001,202,202,2,25,0.001,404,5
0.646,0.001,245,259,2,25,0.001,504,5
0.652,0.001,293,311,2,25,0.001,604,5
0.65,0.001,342,362,2,25,0.001,704,5
0.652,0.001,395,409,2,25,0.001,804,5
0.644,0.001,443,461,2,25,0.001,904,5
0.64,0.001,483,521,2,25,0.001,1004,5
0.64,0.001,526,578,2,25,0.001,1104,5
0.642,0.001,583,621,2,25,0.001,1204,5
0.64,0.001,627,677,2,25,0.001,1304,5
0.642,0.001,680,724,2,25,0.001,1404,5
0.668,0.001,725,779,2,25,0.001,1504,5
0.688,0.001,778,826,2,25,0.001,1604,5
0.706,0.001,829,875,2,25,0.001,1704,5
0.718,0.001,877,927,2,25,0.001,1804,5
0.754,0.001,926,978,2,25,0.001,1904,5
0.764,0.001,985,1019,2,25,0.001,2004,5
0.538,0.001,59,45,2,25,0.001,104,6
0.538,0.001,114,90,2,25,0.001,204,6
0.538,0.001,171,133,2,25,0.001,304,6
0.538,0.001,227,177,2,25,0.001,404,6
0.538,0.001,274,230,2,25,0.001,504,6
0.54,0.001,324,280,2,25,0.001,604,6
0.544,0.001,364,340,2,25,0.001,704,6
0.54,0.001,416,388,2,25,0.001,804,6
0.544,0.001,467,437,2,25,0.001,904,6
0.538,0.001,525,479,2,25,0.001,1004,6
0.54,0.001,580,524,2,25,0.001,1104,6
0.54,0.001,633,571,2,25,0.001,1204,6
0.528,0.001,682,622,2,25,0.001,1304,6
0.558,0.001,726,678,2,25,0.001,1404,6
0.598,0.001,777,727,2,25,0.001,1504,6
0.604,0.001,831,773,2,25,0.001,1604,6
0.614,0.001,876,828,2,25,0.001,1704,6
0.632,0.001,926,878,2,25,0.001,1804,6
0.656,0.001,973,931,2,25,0.001,1904,6
0.674,0.001,1017,987,2,25,0.001,2004,6
0.402,0.001,44,60,2,25,0.001,104,7
0.4,0.001,95,109,2,25,0.001,204,7
0.4,0.001,145,159,2,25,0.001,304,7
0.404,0.001,197,207,2,25,0.001,404,7
0.406,0.001,257,247,2,25,0.001,504,7
0.428,0.001,301,303,2,25,0.001,604,7
0.428,0.001,344,360,2,25,0.001,704,7
0.432,0.001,387,417,2,25,0.001,804,7
0.442,0.001,447,457,2,25,0.001,904,7
0.452,0.001,496,508,2,25,0.001,1004,7
0.46,0.001,545,559,2,25,0.001,1104,7
0.456,0.001,589,615,2,25,0.001,1204,7
0.458,0.001,646,658,2,25,0.001,1304,7
0.456,0.001,702,702,2,25,0.001,1404,7
0.454,0.001,750,754,2,25,0.001,1504,7
0.46,0.001,807,797,2,25,0.001,1604,7
0.468,0.001,851,853,2,25,0.001,1704,7
0.474,0.001,900,904,2,25,0.001,1804,7
0.48,0.001,945,959,2,25,0.001,1904,7
0.532,0.001,996,1008,2,25,0.001,2004,7
0.524,0.001,52,52,2,25,0.001,104,8
0.526,0.001,99,105,2,25,0.001,204,8
0.528,0.001,145,159,2,25,0.001,304,8
0.532,0.001,192,212,2,25,0.001,404,8
0.534,0.001,243,261,2,25,0.001,504,8
0.536,0.001,290,314,2,25,0.001,604,8
0.538,0.001,333,371,2,25,0.001,704,8
0.548,0.001,376,428,2,25,0.001,804,8
0.568,0.001,425,479,2,25,0.001,904,8
0.612,0.001,467,537,2,25,0.001,1004,8
0.622,0.001,528,576,2,25,0.001,1104,8
0.658,0.001,587,617,2,25,0.001,1204,8
0.68,0.001,642,662,2,25,0.001,1304,8
0.692,0.001,694,710,2,25,0.001,1404,8
0.714,0.001,745,759,2,25,0.001,1504,8
0.73,0.001,796,808,2,25,0.001,1604,8
0.736,0.001,853,851,2,25,0.001,1704,8
0.76,0.001,909,895,2,25,0.001,1804,8
0.766,0.001,956,948,2,25,0.001,1904,8
0.786,0.001,1005,999,2,25,0.001,2004,8
0.474,0.001,57,47,2,25,0.001,104,9
0.474,0.001,108,96,2,25,0.001,204,9
0.474,0.001,157,147,2,25,0.001,304,9
0.474,0.001,202,202,2,25,0.001,404,9
0.474,0.001,251,253,2,25,0.001,504,9
0.474,0.001,298,306,2,25,0.001,604,9
0.474,0.001,346,358,2,25,0.001,704,9
0.474,0.001,398,406,2,25,0.001,804,9
0.474,0.001,443,461,2,25,0.001,904,9
0.474,0.001,488,516,2,25,0.001,1004,9
0.474,0.001,541,563,2,25,0.001,1104,9
0.47,0.001,590,614,2,25,0.001,1204,9
0.478,0.001,638,666,2,25,0.001,1304,9
0.468,0.001,686,718,2,25,0.001,1404,9
0.474,0.001,734,770,2,25,0.001,1504,9
0.484,0.001,786,818,2,25,0.001,1604,9
0.492,0.001,835,869,2,25,0.001,1704,9
0.494,0.001,881,923,2,25,0.001,1804,9
0.518,0.001,940,964,2,25,0.001,1904,9
0.53,0.001,989,1015,2,25,0.001,2004,9
0.506,0.001,45,59,2,25,0.001,104,10
0.502,0.001,97,107,2,25,0.001,204,10
0.504,0.001,154,150,2,25,0.001,304,10
0.502,0.001,204,200,2,25,0.001,404,10
0.498,0.001,258,246,2,25,0.001,504,10
0.492,0.001,296,308,2,25,0.001,604,10
0.508,0.001,344,360,2,25,0.001,704,10
0.526,0.001,392,412,2,25,0.001,804,10
0.522,0.001,449,455,2,25,0.001,904,10
0.528,0.001,493,511,2,25,0.001,1004,10
0.536,0.001,543,561,2,25,0.001,1104,10
0.558,0.001,590,614,2,25,0.001,1204,10
0.566,0.001,635,669,2,25,0.001,1304,10
0.572,0.001,686,718,2,25,0.001,1404,10
0.602,0.001,739,765,2,25,0.001,1504,10
0.618,0.001,798,806,2,25,0.001,1604,10
0.646,0.001,851,853,2,25,0.001,1704,10
0.656,0.001,900,904,2,25,0.001,1804,10
0.668,0.001,955,949,2,25,0.001,1904,10
0.692,0.001,1004,1000,2,25,0.001,2004,10
0.538,0.001,56,48,2,25,0.001,104,11
0.546,0.001,113,91,2,25,0.001,204,11
0.554,0.001,163,141,2,25,0.001,304,11
0.564,0.001,217,187,2,25,0.001,404,11
0.566,0.001,255,249,2,25,0.001,504,11
0.584,0.001,302,302,2,25,0.001,604,11
0.592,0.001,351,353,2,25,0.001,704,11
0.6,0.001,405,399,2,25,0.001,804,11
0.622,0.001,453,451,2,25,0.001,904,11
0.65,0.001,500,504,2,25,0.001,1004,11
0.672,0.001,552,552,2,25,0.001,1104,11
0.7,0.001,601,603,2,25,0.001,1204,11
0.718,0.001,641,663,2,25,0.001,1304,11
0.744,0.001,691,713,2,25,0.001,1404,11
0.766,0.001,743,761,2,25,0.001,1504,11
0.788,0.001,801,803,2,25,0.001,1604,11
0.79,0.001,856,848,2,25,0.001,1704,11
0.808,0.001,902,902,2,25,0.001,1804,11
0.802,0.001,948,956,2,25,0.001,1904,11
0.812,0.001,1013,991,2,25,0.001,2004,11
0.482,0.001,53,51,2,25,0.001,104,12
0.482,0.001,101,103,2,25,0.001,204,12
0.482,0.001,146,158,2,25,0.001,304,12
0.48,0.001,197,207,2,25,0.001,404,12
0.476,0.001,242,262,2,25,0.001,504,12
0.472,0.001,286,318,2,25,0.001,604,12
0.468,0.001,339,365,2,25,0.001,704,12
0.456,0.001,377,427,2,25,0.001,804,12
0.436,0.001,422,482,2,25,0.001,904,12
0.4,0.001,476,528,2,25,0.001,1004,12
0.476,0.001,525,579,2,25,0.001,1104,12
0.554,0.001,575,629,2,25,0.001,1204,12
0.568,0.001,614,690,2,25,0.001,1304,12
0.614,0.001,667,737,2,25,0.001,1404,12
0.628,0.001,717,787,2,25,0.001,1504,12
0.678,0.001,769,835,2,25,0.001,1604,12
0.692,0.001,826,878,2,25,0.001,1704,12
0.726,0.001,873,931,2,25,0.001,1804,12
0.714,0.001,929,975,2,25,0.001,1904,12
0.712,0.001,985,1019,2,25,0.001,2004,12
0.54,0.001,53,51,2,25,0.001,104,13
0.542,0.001,107,97,2,25,0.001,204,13
0.544,0.001,154,150,2,25,0.001,304,13
0.544,0.001,200,204,2,25,0.001,404,13
0.544,0.001,249,255,2,25,0.001,504,13
0.554,0.001,301,303,2,25,0.001,604,13
0.558,0.001,358,346,2,25,0.001,704,13
0.562,0.001,409,395,2,25,0.001,804,13
0.568,0.001,458,446,2,25,0.001,904,13
0.572,0.001,514,490,2,25,0.001,1004,13
0.57,0.001,563,541,2,25,0.001,1104,13
0.572,0.001,614,590,2,25,0.001,1204,13
0.562,0.001,669,635,2,25,0.001,1304,13
0.578,0.001,720,684,2,25,0.001,1404,13
0.576,0.001,761,743,2,25,0.001,1504,13
0.582,0.001,806,798,2,25,0.001,1604,13
0.584,0.001,856,848,2,25,0.001,1704,13
0.602,0.001,904,900,2,25,0.001,1804,13
0.63,0.001,955,949,2,25,0.001,1904,13
0.668,0.001,1012,992,2,25,0.001,2004,13
0.408,0.001,55,49,2,25,0.001,104,14
0.406,0.001,104,100,2,25,0.001,204,14
0.408,0.001,157,147,2,25,0.001,304,14
0.406,0.001,202,202,2,25,0.001,404,14
0.402,0.001,252,252,2,25,0.001,504,14
0.404,0.001,297,307,2,25,0.001,604,14
0.404,0.001,356,348,2,25,0.001,704,14
0.41,0.001,405,399,2,25,0.001,804,14
0.402,0.001,446,458,2,25,0.001,904,14
0.402,0.001,496,508,2,25,0.001,1004,14
0.404,0.001,550,554,2,25,0.001,1104,14
0.412,0.001,602,602,2,25,0.001,1204,14
0.412,0.001,648,656,2,25,0.001,1304,14
0.414,0.001,705,699,2,25,0.001,1404,14
0.414,0.001,760,744,2,25,0.001,1504,14
0.416,0.001,806,798,2,25,0.001,1604,14
0.424,0.001,852,852,2,25,0.001,1704,14
0.43,0.001,897,907,2,25,0.001,1804,14
0.466,0.001,944,960,2,25,0.001,1904,14
0.496,0.001,995,1009,2,25,0.001,2004,14
0.434,0.001,57,47,2,25,0.001,104,15
0.442,0.001,113,91,2,25,0.001,204,15
0.45,0.001,168,136,2,25,0.001,304,15
0.458,0.001,220,184,2,25,0.001,404,15
0.47,0.001,272,232,2,25,0.001,504,15
0.478,0.001,310,294,2,25,0.001,604,15
0.478,0.001,364,340,2,25,0.001,704,15
0.478,0.001,418,386,2,25,0.001,804,15
0.488,0.001,465,439,2,25,0.001,904,15
0.506,0.001,510,494,2,25,0.001,1004,15
0.53,0.001,562,542,2,25,0.001,1104,15
0.552,0.001,616,588,2,25,0.001,1204,15
0.536,0.001,674,630,2,25,0.001,1304,15
0.532,0.001,722,682,2,25,0.001,1404,15
0.53,0.001,763,741,2,25,0.001,1504,15
0.536,0.001,808,796,2,25,0.001,1604,15
0.574,0.001,857,847,2,25,0.001,1704,15
0.59,0.001,903,901,2,25,0.001,1804,15
0.596,0.001,945,959,2,25,0.001,1904,15
0.61,0.001,992,1012,2,25,0.001,2004,15
0.528,0.001,57,47,2,25,0.001,104,16
0.528,0.001,117,87,2,25,0.001,204,16
0.528,0.001,158,146,2,25,0.001,304,16
0.528,0.001,206,198,2,25,0.001,404,16
0.53,0.001,250,254,2,25,0.001,504,16
0.532,0.001,302,302,2,25,0.001,604,16
0.532,0.001,359,345,2,25,0.001,704,16
0.534,0.001,405,399,2,25,0.001,804,16
0.536,0.001,463,441,2,25,0.001,904,16
0.544,0.001,503,501,2,25,0.001,1004,16
0.556,0.001,551,553,2,25,0.001,1104,16
0.568,0.001,607,597,2,25,0.001,1204,16
0.586,0.001,661,643,2,25,0.001,1304,16
0.63,0.001,704,700,2,25,0.001,1404,16
0.656,0.001,752,752,2,25,0.001,1504,16
0.694,0.001,803,801,2,25,0.001,1604,16
0.692,0.001,857,847,2,25,0.001,1704,16
0.712,0.001,913,891,2,25,0.001,1804,16
0.746,0.001,969,935,2,25,0.001,1904,16
0.776,0.001,1016,988,2,25,0.001,2004,16
0.526,0.001,47,57,2,25,0.001,104,17
0.53,0.001,95,109,2,25,0.001,204,17
0.53,0.001,150,154,2,25,0.001,304,17
0.534,0.001,195,209,2,25,0.001,404,17
0.54,0.001,257,247,2,25,0.001,504,17
0.574,0.001,307,297,2,25,0.001,604,17
0.63,0.001,359,345,2,25,0.001,704,17
0.654,0.001,415,389,2,25,0.001,804,17
0.662,0.001,468,436,2,25,0.001,904,17
0.67,0.001,510,494,2,25,0.001,1004,17
0.686,0.001,556,548,2,25,0.001,1104,17
0.694,0.001,601,603,2,25,0.001,1204,17
0.696,0.001,644,660,2,25,0.001,1304,17
0.72,0.001,694,710,2,25,0.001,1404,17
0.716,0.001,744,760,2,25,0.001,1504,17
0.72,0.001,796,808,2,25,0.001,1604,17
0.73,0.001,839,865,2,25,0.001,1704,17
0.748,0.001,890,914,2,25,0.001,1804,17
0.756,0.001,946,958,2,25,0.001,1904,17
0.77,0.001,1000,1004,2,25,0.001,2004,17
0.496,0.001,53,51,2,25,0.001,104,18
0.496,0.001,105,99,2,25,0.001,204,18
0.496,0.001,163,141,2,25,0.001,304,18
0.49,0.001,214,190,2,25,0.001,404,18
0.492,0.001,270,234,2,25,0.001,504,18
0.496,0.001,313,291,2,25,0.001,604,18
0.496,0.001,366,338,2,25,0.001,704,18
0.502,0.001,415,389,2,25,0.001,804,18
0.502,0.001,464,440,2,25,0.001,904,18
0.514,0.001,512,492,2,25,0.001,1004,18
0.526,0.001,562,542,2,25,0.001,1104,18
0.57,0.001,618,586,2,25,0.001,1204,18
0.592,0.001,666,638,2,25,0.001,1304,18
0.63,0.001,714,690,2,25,0.001,1404,18
0.658,0.001,755,749,2,25,0.001,1504,18
0.678,0.001,815,789,2,25,0.001,1604,18
0.674,0.001,871,833,2,25,0.001,1704,18
0.686,0.001,923,881,2,25,0.001,1804,18
0.686,0.001,973,931,2,25,0.001,1904,18
0.704,0.001,1019,985,2,25,0.001,2004,18
0.528,0.001,54,50,2,25,0.001,104,19
0.53,0.001,99,105,2,25,0.001,204,19
0.534,0.001,152,152,2,25,0.001,304,19
0.542,0.001,202,202,2,25,0.001,404,19
0.544,0.001,250,254,2,25,0.001,504,19
0.554,0.001,300,304,2,25,0.001,604,19
0.558,0.001,353,351,2,25,0.001,704,19
0.564,0.001,409,395,2,25,0.001,804,19
0.57,0.001,458,446,2,25,0.001,904,19
0.566,0.001,503,501,2,25,0.001,1004,19
0.558,0.001,550,554,2,25,0.001,1104,19
0.56,0.001,604,600,2,25,0.001,1204,19
0.572,0.001,657,647,2,25,0.001,1304,19
0.576,0.001,699,705,2,25,0.001,1404,19
0.58,0.001,741,763,2,25,0.001,1504,19
0.59,0.001,796,808,2,25,0.001,1604,19
0.61,0.001,841,863,2,25,0.001,1704,19
0.63,0.001,896,908,2,25,0.001,1804,19
0.652,0.001,957,947,2,25,0.001,1904,19
0.668,0.001,1004,1000,2,25,0.001,2004,19
0.52,0.001,56,48,2,25,0.001,104,20
0.52,0.001,115,89,2,25,0.001,204,20
0.518,0.001,178,126,2,25,0.001,304,20
0.518,0.001,227,177,2,25,0.001,404,20
0.518,0.001,281,223,2,25,0.001,504,20
0.52,0.001,325,279,2,25,0.001,604,20
0.524,0.001,382,322,2,25,0.001,704,20
0.524,0.001,438,366,2,25,0.001,804,20
0.53,0.001,486,418,2,25,0.001,904,20
0.53,0.001,535,469,2,25,0.001,1004,20
0.532,0.001,580,524,2,25,0.001,1104,20
0.534,0.001,627,577,2,25,0.001,1204,20
0.538,0.001,677,627,2,25,0.001,1304,20
0.552,0.001,727,677,2,25,0.001,1404,20
0.57,0.001,775,729,2,25,0.001,1504,20
0.584,0.001,822,782,2,25,0.001,1604,20
0.618,0.001,865,839,2,25,0.001,1704,20
0.63,0.001,913,891,2,25,0.001,1804,20
0.638,0.001,955,949,2,25,0.001,1904,20
0.644,0.001,1008,996,2,25,0.001,2004,20
0.484,0.001,57,47,2,25,0.01,104,1
0.474,0.001,105,99,2,25,0.01,204,1
0.548,0.001,154,150,2,25,0.01,304,1
0.578,0.001,200,204,2,25,0.01,404,1
0.57,0.001,246,258,2,25,0.01,504,1
0.608,0.001,293,311,2,25,0.01,604,1
0.624,0.001,346,358,2,25,0.01,704,1
0.73,0.001,392,412,2,25,0.01,804,1
0.782,0.001,436,468,2,25,0.01,904,1
0.792,0.001,487,517,2,25,0.01,1004,1
0.804,0.001,545,559,2,25,0.01,1104,1
0.826,0.001,600,604,2,25,0.01,1204,1
0.83,0.001,649,655,2,25,0.01,1304,1
0.85,0.001,694,710,2,25,0.01,1404,1
0.868,0.001,743,761,2,25,0.01,1504,1
0.872,0.001,790,814,2,25,0.01,1604,1
0.892,0.001,845,859,2,25,0.01,1704,1
0.894,0.001,890,914,2,25,0.01,1804,1
0.894,0.001,945,959,2,25,0.01,1904,1
0.9,0.001,995,1009,2,25,0.01,2004,1
0.486,0.001,41,63,2,25,0.01,104,2
0.492,0.001,94,110,2,25,0.01,204,2
0.55,0.001,135,169,2,25,0.01,304,2
0.604,0.001,192,212,2,25,0.01,404,2
0.54,0.001,243,261,2,25,0.01,504,2
0.544,0.001,294,310,2,25,0.01,604,2
0.598,0.001,355,349,2,25,0.01,704,2
0.668,0.001,396,408,2,25,0.01,804,2
0.748,0.001,444,460,2,25,0.01,904,2
0.746,0.001,490,514,2,25,0.01,1004,2
0.752,0.001,540,564,2,25,0.01,1104,2
0.782,0.001,597,607,2,25,0.01,1204,2
0.838,0.001,649,655,2,25,0.01,1304,2
0.91,0.001,698,706,2,25,0.01,1404,2
0.916,0.001,745,759,2,25,0.01,1504,2
0.912,0.001,799,805,2,25,0.01,1604,2
0.914,0.001,853,851,2,25,0.01,1704,2
0.93,0.001,907,897,2,25,0.01,1804,2
0.934,0.001,959,945,2,25,0.01,1904,2
0.932,0.001,1009,995,2,25,0.01,2004,2
0.552,0.001,54,50,2,25,0.01,104,3
0.58,0.001,101,103,2,25,0.01,204,3
0.592,0.001,148,156,2,25,0.01,304,3
0.624,0.001,201,203,2,25,0.01,404,3
0.638,0.001,261,243,2,25,0.01,504,3
0.678,0.001,304,300,2,25,0.01,604,3
0.752,0.001,353,351,2,25,0.01,704,3
0.772,0.001,402,402,2,25,0.01,804,3
0.768,0.001,452,452,2,25,0.01,904,3
0.768,0.001,500,504,2,25,0.01,1004,3
0.776,0.001,544,560,2,25,0.01,1104,3
0.812,0.001,594,610,2,25,0.01,1204,3
0.87,0.001,644,660,2,25,0.01,1304,3
0.872,0.001,699,705,2,25,0.01,1404,3
0.848,0.001,757,747,2,25,0.01,1504,3
0.86,0.001,812,792,2,25,0.01,1604,3
0.876,0.001,863,841,2,25,0.01,1704,3
0.87,0.001,912,892,2,25,0.01,1804,3
0.88,0.001,961,943,2,25,0.01,1904,3
0.904,0.001,1012,992,2,25,0.01,2004,3
0.462,0.001,53,51,2,25,0.01,104,4
0.466,0.001,102,102,2,25,0.01,204,4
0.518,0.001,151,153,2,25,0.01,304,4
0.63,0.001,206,198,2,25,0.01,404,4
0.61,0.001,252,252,2,25,0.01,504,4
0.61,0.001,298,306,2,25,0.01,604,4
0.716,0.001,350,354,2,25,0.01,704,4
0.798,0.001,408,396,2,25,0.01,804,4
0.8,0.001,454,450,2,25,0.01,904,4
0.816,0.001,503,501,2,25,0.01,1004,4
0.856,0.001,552,552,2,25,0.01,1104,4
0.864,0.001,593,611,2,25,0.01,1204,4
0.89,0.001,649,655,2,25,0.01,1304,4
0.88,0.001,698,706,2,25,0.01,1404,4
0.884,0.001,748,756,2,25,0.01,1504,4
0.886,0.001,798,806,2,25,0.01,1604,4
0.902,0.001,849,855,2,25,0.01,1704,4
0.898,0.001,899,905,2,25,0.01,1804,4
0.902,0.001,946,958,2,25,0.01,1904,4
0.906,0.001,1001,1003,2,25,0.01,2004,4
0.658,0.001,52,52,2,25,0.01,104,5
0.704,0.001,94,110,2,25,0.01,204,5
0.648,0.001,151,153,2,25,0.01,304,5
0.636,0.001,196,208,2,25,0.01,404,5
0.602,0.001,241,263,2,25,0.01,504,5
0.658,0.001,282,322,2,25,0.01,604,5
0.738,0.001,325,379,2,25,0.01,704,5
0.766,0.001,376,428,2,25,0.01,804,5
0.792,0.001,428,476,2,25,0.01,904,5
0.814,0.001,474,530,2,25,0.01,1004,5
0.814,0.001,526,578,2,25,0.01,1104,5
0.84,0.001,578,626,2,25,0.01,1204,5
0.862,0.001,639,665,2,25,0.01,1304,5
0.864,0.001,692,712,2,25,0.01,1404,5
0.856,0.001,744,760,2,25,0.01,1504,5
0.852,0.001,798,806,2,25,0.01,1604,5
0.87,0.001,846,858,2,25,0.01,1704,5
0.896,0.001,904,900,2,25,0.01,1804,5
0.92,0.001,949,955,2,25,0.01,1904,5
0.904,0.001,997,1007,2,25,0.01,2004,5
0.518,0.001,43,61,2,25,0.01,104,6
0.538,0.001,91,113,2,25,0.01,204,6
0.542,0.001,144,160,2,25,0.01,304,6
0.5,0.001,189,215,2,25,0.01,404,6
0.506,0.001,247,257,2,25,0.01,504,6
0.52,0.001,292,312,2,25,0.01,604,6
0.536,0.001,334,370,2,25,0.01,704,6
0.572,0.001,387,417,2,25,0.01,804,6
0.618,0.001,434,470,2,25,0.01,904,6
0.678,0.001,485,519,2,25,0.01,1004,6
0.732,0.001,538,566,2,25,0.01,1104,6
0.754,0.001,585,619,2,25,0.01,1204,6
0.762,0.001,638,666,2,25,0.01,1304,6
0.792,0.001,690,714,2,25,0.01,1404,6
0.814,0.001,742,762,2,25,0.01,1504,6
0.836,0.001,793,811,2,25,0.01,1604,6
0.846,0.001,849,855,2,25,0.01,1704,6
0.856,0.001,899,905,2,25,0.01,1804,6
0.868,0.001,950,954,2,25,0.01,1904,6
0.872,0.001,993,1011,2,25,0.01,2004,6
0.61,0.001,57,47,2,25,0.01,104,7
0.6,0.001,97,107,2,25,0.01,204,7
0.604,0.001,151,153,2,25,0.01,304,7
0.616,0.001,210,194,2,25,0.01,404,7
0.616,0.001,259,245,2,25,0.01,504,7
0.632,0.001,304,300,2,25,0.01,604,7
0.67,0.001,354,350,2,25,0.01,704,7
0.762,0.001,402,402,2,25,0.01,804,7
0.794,0.001,449,455,2,25,0.01,904,7
0.798,0.001,497,507,2,25,0.01,1004,7
0.798,0.001,547,557,2,25,0.01,1104,7
0.832,0.001,599,605,2,25,0.01,1204,7
0.85,0.001,648,656,2,25,0.01,1304,7
0.866,0.001,693,711,2,25,0.01,1404,7
0.87,0.001,745,759,2,25,0.01,1504,7
0.874,0.001,796,808,2,25,0.01,1604,7
0.896,0.001,852,852,2,25,0.01,1704,7
0.9,0.001,909,895,2,25,0.01,1804,7
0.904,0.001,956,948,2,25,0.01,1904,7
0.91,0.001,1002,1002,2,25,0.01,2004,7
0.534,0.001,49,55,2,25,0.01,104,8
0.58,0.001,106,98,2,25,0.01,204,8
0.596,0.001,149,155,2,25,0.01,304,8
0.59,0.001,197,207,2,25,0.01,404,8
0.62,0.001,249,255,2,25,0.01,504,8
0.692,0.001,295,309,2,25,0.01,604,8
0.546,0.001,348,356,2,25,0.01,704,8
0.584,0.001,401,403,2,25,0.01,804,8
0.768,0.001,458,446,2,25,0.01,904,8
0.772,0.001,507,497,2,25,0.01,1004,8
0.774,0.001,562,542,2,25,0.01,1104,8
0.82,0.001,620,584,2,25,0.01,1204,8
0.808,0.001,667,637,2,25,0.01,1304,8
0.878,0.001,710,694,2,25,0.01,1404,8
0.924,0.001,754,750,2,25,0.01,1504,8
0.93,0.001,807,797,2,25,0.01,1604,8
0.91,0.001,861,843,2,25,0.01,1704,8
0.924,0.001,906,898,2,25,0.01,1804,8
0.942,0.001,956,948,2,25,0.01,1904,8
0.932,0.001,1001,1003,2,25,0.01,2004,8
0.594,0.001,55,49,2,25,0.01,104,9
0.508,0.001,110,94,2,25,0.01,204,9
0.502,0.001,156,148,2,25,0.01,304,9
0.504,0.001,205,199,2,25,0.01,404,9
0.518,0.001,257,247,2,25,0.01,504,9
0.528,0.001,305,299,2,25,0.01,604,9
0.548,0.001,348,356,2,25,0.01,704,9
0.626,0.001,398,406,2,25,0.01,804,9
0.704,0.001,456,448,2,25,0.01,904,9
0.742,0.001,504,500,2,25,0.01,1004,9
0.764,0.001,549,555,2,25,0.01,1104,9
0.796,0.001,600,604,2,25,0.01,1204,9
0.818,0.001,656,648,2,25,0.01,1304,9
0.848,0.001,711,693,2,25,0.01,1404,9
0.862,0.001,762,742,2,25,0.01,1504,9
0.886,0.001,818,786,2,25,0.01,1604,9
0.894,0.001,863,841,2,25,0.01,1704,9
0.9,0.001,916,888,2,25,0.01,1804,9
0.91,0.001,969,935,2,25,0.01,1904,9
0.92,0.001,1018,986,2,25,0.01,2004,9
0.554,0.001,45,59,2,25,0.01,104,10
0.534,0.001,88,116,2,25,0.01,204,10
0.52,0.001,141,163,2,25,0.01,304,10
0.496,0.001,190,214,2,25,0.01,404,10
0.512,0.001,244,260,2,25,0.01,504,10
0.536,0.001,302,302,2,25,0.01,604,10
0.576,0.001,347,357,2,25,0.01,704,10
0.63,0.001,397,407,2,25,0.01,804,10
0.636,0.001,442,462,2,25,0.01,904,10
0.688,0.001,486,518,2,25,0.01,1004,10
0.78,0.001,540,564,2,25,0.01,1104,10
0.818,0.001,589,615,2,25,0.01,1204,10
0.852,0.001,639,665,2,25,0.01,1304,10
0.896,0.001,685,719,2,25,0.01,1404,10
0.896,0.001,732,772,2,25,0.01,1504,10
0.9,0.001,787,817,2,25,0.01,1604,10
0.9,0.001,843,861,2,25,0.01,1704,10
0.906,0.001,893,911,2,25,0.01,1804,10
0.91,0.001,944,960,2,25,0.01,1904,10
0.92,0.001,998,1006,2,25,0.01,2004,10
0.492,0.001,53,51,2,25,0.01,104,11
0.492,0.001,113,91,2,25,0.01,204,11
0.492,0.001,159,145,2,25,0.01,304,11
0.492,0.001,205,199,2,25,0.01,404,11
0.496,0.001,251,253,2,25,0.01,504,11
0.564,0.001,311,293,2,25,0.01,604,11
0.584,0.001,354,350,2,25,0.01,704,11
0.62,0.001,406,398,2,25,0.01,804,11
0.744,0.001,463,441,2,25,0.01,904,11
0.754,0.001,509,495,2,25,0.01,1004,11
0.77,0.001,567,537,2,25,0.01,1104,11
0.788,0.001,612,592,2,25,0.01,1204,11
0.808,0.001,657,647,2,25,0.01,1304,11
0.864,0.001,705,699,2,25,0.01,1404,11
0.916,0.001,749,755,2,25,0.01,1504,11
0.922,0.001,804,800,2,25,0.01,1604,11
0.916,0.001,848,856,2,25,0.01,1704,11
0.932,0.001,899,905,2,25,0.01,1804,11
0.944,0.001,953,951,2,25,0.01,1904,11
0.938,0.001,1006,998,2,25,0.01,2004,11
0.514,0.001,58,46,2,25,0.01,104,12
0.512,0.001,105,99,2,25,0.01,204,12
0.55,0.001,145,159,2,25,0.01,304,12
0.674,0.001,193,211,2,25,0.01,404,12
0.694,0.001,241,263,2,25,0.01,504,12
0.742,0.001,285,319,2,25,0.01,604,12
0.782,0.001,339,365,2,25,0.01,704,12
0.82,0.001,391,413,2,25,0.01,804,12
0.854,0.001,444,460,2,25,0.01,904,12
0.896,0.001,495,509,2,25,0.01,1004,12
0.936,0.001,554,550,2,25,0.01,1104,12
0.912,0.001,601,603,2,25,0.01,1204,12
0.88,0.001,655,649,2,25,0.01,1304,12
0.892,0.001,702,702,2,25,0.01,1404,12
0.918,0.001,748,756,2,25,0.01,1504,12
0.932,0.001,803,801,2,25,0.01,1604,12
0.93,0.001,858,846,2,25,0.01,1704,12
0.922,0.001,900,904,2,25,0.01,1804,12
0.918,0.001,953,951,2,25,0.01,1904,12
0.938,0.001,995,1009,2,25,0.01,2004,12
0.49,0.001,52,52,2,25,0.01,104,13
0.53,0.001,103,101,2,25,0.01,204,13
0.582,0.001,156,148,2,25,0.01,304,13
0.606,0.001,213,191,2,25,0.01,404,13
0.63,0.001,262,242,2,25,0.01,504,13
0.672,0.001,306,298,2,25,0.01,604,13
0.74,0.001,352,352,2,25,0.01,704,13
0.818,0.001,396,408,2,25,0.01,804,13
0.816,0.001,446,458,2,25,0.01,904,13
0.83,0.001,499,505,2,25,0.01,1004,13
0.864,0.001,550,554,2,25,0.01,1104,13
0.888,0.001,606,598,2,25,0.01,1204,13
0.892,0.001,654,650,2,25,0.01,1304,13
0.926,0.001,705,699,2,25,0.01,1404,13
0.894,0.001,757,747,2,25,0.01,1504,13
0.896,0.001,810,794,2,25,0.01,1604,13
0.904,0.001,859,845,2,25,0.01,1704,13
0.92,0.001,905,899,2,25,0.01,1804,13
0.924,0.001,964,940,2,25,0.01,1904,13
0.928,0.001,1017,987,2,25,0.01,2004,13
0.55,0.001,42,62,2,25,0.01,104,14
0.576,0.001,92,112,2,25,0.01,204,14
0.604,0.001,143,161,2,25,0.01,304,14
0.548,0.001,193,211,2,25,0.01,404,14
0.54,0.001,245,259,2,25,0.01,504,14
0.594,0.001,293,311,2,25,0.01,604,14
0.618,0.001,344,360,2,25,0.01,704,14
0.624,0.001,400,404,2,25,0.01,804,14
0.662,0.001,447,457,2,25,0.01,904,14
0.778,0.001,497,507,2,25,0.01,1004,14
0.804,0.001,546,558,2,25,0.01,1104,14
0.806,0.001,590,614,2,25,0.01,1204,14
0.804,0.001,638,666,2,25,0.01,1304,14
0.822,0.001,694,710,2,25,0.01,1404,14
0.85,0.001,741,763,2,25,0.01,1504,14
0.834,0.001,791,813,2,25,0.01,1604,14
0.832,0.001,843,861,2,25,0.01,1704,14
0.852,0.001,886,918,2,25,0.01,1804,14
0.868,0.001,938,966,2,25,0.01,1904,14
0.88,0.001,985,1019,2,25,0.01,2004,14
0.612,0.001,56,48,2,25,0.01,104,15
0.592,0.001,109,95,2,25,0.01,204,15
0.506,0.001,165,139,2,25,0.01,304,15
0.508,0.001,220,184,2,25,0.01,404,15
0.512,0.001,266,238,2,25,0.01,504,15
0.514,0.001,321,283,2,25,0.01,604,15
0.548,0.001,379,325,2,25,0.01,704,15
0.652,0.001,424,380,2,25,0.01,804,15
0.68,0.001,465,439,2,25,0.01,904,15
0.792,0.001,517,487,2,25,0.01,1004,15
0.81,0.001,573,531,2,25,0.01,1104,15
0.818,0.001,620,584,2,25,0.01,1204,15
0.836,0.001,661,643,2,25,0.01,1304,15
0.848,0.001,713,691,2,25,0.01,1404,15
0.864,0.001,765,739,2,25,0.01,1504,15
0.88,0.001,804,800,2,25,0.01,1604,15
0.888,0.001,859,845,2,25,0.01,1704,15
0.892,0.001,908,896,2,25,0.01,1804,15
0.894,0.001,955,949,2,25,0.01,1904,15
0.9,0.001,1008,996,2,25,0.01,2004,15
0.526,0.001,52,52,2,25,0.01,104,16
0.572,0.001,94,110,2,25,0.01,204,16
0.608,0.001,147,157,2,25,0.01,304,16
0.604,0.001,201,203,2,25,0.01,404,16
0.63,0.001,260,244,2,25,0.01,504,16
0.664,0.001,316,288,2,25,0.01,604,16
0.628,0.001,366,338,2,25,0.01,704,16
0.654,0.001,415,389,2,25,0.01,804,16
0.706,0.001,461,443,2,25,0.01,904,16
0.852,0.001,510,494,2,25,0.01,1004,16
0.854,0.001,560,544,2,25,0.01,1104,16
0.86,0.001,611,593,2,25,0.01,1204,16
0.898,0.001,657,647,2,25,0.01,1304,16
0.908,0.001,700,704,2,25,0.01,1404,16
0.91,0.001,745,759,2,25,0.01,1504,16
0.9,0.001,795,809,2,25,0.01,1604,16
0.898,0.001,842,862,2,25,0.01,1704,16
0.92,0.001,888,916,2,25,0.01,1804,16
0.924,0.001,937,967,2,25,0.01,1904,16
0.916,0.001,984,1020,2,25,0.01,2004,16
0.53,0.001,50,54,2,25,0.01,104,17
0.584,0.001,93,111,2,25,0.01,204,17
0.622,0.001,142,162,2,25,0.01,304,17
0.566,0.001,189,215,2,25,0.01,404,17
0.592,0.001,238,266,2,25,0.01,504,17
0.6,0.001,288,316,2,25,0.01,604,17
0.69,0.001,346,358,2,25,0.01,704,17
0.76,0.001,398,406,2,25,0.01,804,17
0.782,0.001,448,456,2,25,0.01,904,17
0.814,0.001,501,503,2,25,0.01,1004,17
0.828,0.001,538,566,2,25,0.01,1104,17
0.832,0.001,590,614,2,25,0.01,1204,17
0.848,0.001,639,665,2,25,0.01,1304,17
0.856,0.001,684,720,2,25,0.01,1404,17
0.872,0.001,742,762,2,25,0.01,1504,17
0.862,0.001,798,806,2,25,0.01,1604,17
0.876,0.001,856,848,2,25,0.01,1704,17
0.882,0.001,906,898,2,25,0.01,1804,17
0.89,0.001,959,945,2,25,0.01,1904,17
0.894,0.001,1013,991,2,25,0.01,2004,17
0.616,0.001,45,59,2,25,0.01,104,18
0.622,0.001,92,112,2,25,0.01,204,18
0.626,0.001,149,155,2,25,0.01,304,18
0.622,0.001,190,214,2,25,0.01,404,18
0.514,0.001,242,262,2,25,0.01,504,18
0.456,0.001,296,308,2,25,0.01,604,18
0.522,0.001,347,357,2,25,0.01,704,18
0.586,0.001,401,403,2,25,0.01,804,18
0.642,0.001,454,450,2,25,0.01,904,18
0.746,0.001,500,504,2,25,0.01,1004,18
0.776,0.001,554,550,2,25,0.01,1104,18
0.808,0.001,607,597,2,25,0.01,1204,18
0.806,0.001,657,647,2,25,0.01,1304,18
0.82,0.001,709,695,2,25,0.01,1404,18
0.828,0.001,756,748,2,25,0.01,1504,18
0.852,0.001,810,794,2,25,0.01,1604,18
0.898,0.001,859,845,2,25,0.01,1704,18
0.88,0.001,906,898,2,25,0.01,1804,18
0.892,0.001,957,947,2,25,0.01,1904,18
0.894,0.001,1012,992,2,25,0.01,2004,18
0.48,0.001,53,51,2,25,0.01,104,19
0.478,0.001,101,103,2,25,0.01,204,19
0.47,0.001,146,158,2,25,0.01,304,19
0.424,0.001,195,209,2,25,0.01,404,19
0.448,0.001,252,252,2,25,0.01,504,19
0.57,0.001,303,301,2,25,0.01,604,19
0.7,0.001,360,344,2,25,0.01,704,19
0.764,0.001,413,391,2,25,0.01,804,19
0.814,0.001,461,443,2,25,0.01,904,19
0.816,0.001,506,498,2,25,0.01,1004,19
0.834,0.001,556,548,2,25,0.01,1104,19
0.852,0.001,611,593,2,25,0.01,1204,19
0.856,0.001,672,632,2,25,0.01,1304,19
0.854,0.001,723,681,2,25,0.01,1404,19
0.866,0.001,774,730,2,25,0.01,1504,19
0.884,0.001,817,787,2,25,0.01,1604,19
0.89,0.001,861,843,2,25,0.01,1704,19
0.894,0.001,912,892,2,25,0.01,1804,19
0.908,0.001,966,938,2,25,0.01,1904,19
0.914,0.001,1012,992,2,25,0.01,2004,19
0.524,0.001,54,50,2,25,0.01,104,20
0.572,0.001,100,104,2,25,0.01,204,20
0.65,0.001,150,154,2,25,0.01,304,20
0.668,0.001,208,196,2,25,0.01,404,20
0.688,0.001,259,245,2,25,0.01,504,20
0.73,0.001,307,297,2,25,0.01,604,20
0.732,0.001,359,345,2,25,0.01,704,20
0.768,0.001,407,397,2,25,0.01,804,20
0.79,0.001,450,454,2,25,0.01,904,20
0.86,0.001,495,509,2,25,0.01,1004,20
0.904,0.001,546,558,2,25,0.01,1104,20
0.902,0.001,597,607,2,25,0.01,1204,20
0.898,0.001,642,662,2,25,0.01,1304,20
0.886,0.001,693,711,2,25,0.01,1404,20
0.888,0.001,746,758,2,25,0.01,1504,20
0.906,0.001,806,798,2,25,0.01,1604,20
0.91,0.001,854,850,2,25,0.01,1704,20
0.914,0.001,904,900,2,25,0.01,1804,20
0.916,0.001,951,953,2,25,0.01,1904,20
0.914,0.001,997,1007,2,25,0.01,2004,20
0.482,1e-05,47,57,2,50,0.0001,104,1
0.482,1e-05,96,108,2,50,0.0001,204,1
0.482,1e-05,141,163,2,50,0.0001,304,1
0.482,1e-05,190,214,2,50,0.0001,404,1
0.482,1e-05,242,262,2,50,0.0001,504,1
0.484,1e-05,294,310,2,50,0.0001,604,1
0.482,1e-05,347,357,2,50,0.0001,704,1
0.48,1e-05,399,405,2,50,0.0001,804,1
0.478,1e-05,452,452,2,50,0.0001,904,1
0.478,1e-05,508,496,2,50,0.0001,1004,1
0.478,1e-05,565,539,2,50,0.0001,1104,1
0.478,1e-05,611,593,2,50,0.0001,1204,1
0.478,1e-05,660,644,2,50,0.0001,1304,1
0.478,1e-05,719,685,2,50,0.0001,1404,1
0.478,1e-05,766,738,2,50,0.0001,1504,1
0.478,1e-05,816,788,2,50,0.0001,1604,1
0.478,1e-05,870,834,2,50,0.0001,1704,1
0.478,1e-05,923,881,2,50,0.0001,1804,1
0.478,1e-05,970,934,2,50,0.0001,1904,1
0.478,1e-05,1025,979,2,50,0.0001,2004,1
0.462,1e-05,45,59,2,50,0.0001,104,2
0.462,1e-05,89,115,2,50,0.0001,204,2
0.462,1e-05,146,158,2,50,0.0001,304,2
0.462,1e-05,194,210,2,50,0.0001,404,2
0.462,1e-05,249,255,2,50,0.0001,504,2
0.462,1e-05,305,299,2,50,0.0001,604,2
0.462,1e-05,366,338,2,50,0.0001,704,2
0.462,1e-05,413,391,2,50,0.0001,804,2
0.462,1e-05,465,439,2,50,0.0001,904,2
0.462,1e-05,517,487,2,50,0.0001,1004,2
0.462,1e-05,570,534,2,50,0.0001,1104,2
0.462,1e-05,610,594,2,50,0.0001,1204,2
0.462,1e-05,658,646,2,50,0.0001,1304,2
0.462,1e-05,705,699,2,50,0.0001,1404,2
0.462,1e-05,758,746,2,50,0.0001,1504,2
0.462,1e-05,813,791,2,50,0.0001,1604,2
0.462,1e-05,867,837,2,50,0.0001,1704,2
0.462,1e-05,917,887,2,50,0.0001,1804,2
0.462,1e-05,973,931,2,50,0.0001,1904,2
0.462,1e-05,1021,983,2,50,0.0001,2004,2
0.404,1e-05,50,54,2,50,0.0001,104,3
0.406,1e-05,96,108,2,50,0.0001,204,3
0.406,1e-05,157,147,2,50,0.0001,304,3
0.406,1e-05,208,196,2,50,0.0001,404,3
0.404,1e-05,256,248,2,50,0.0001,504,3
0.406,1e-05,302,302,2,50,0.0001,604,3
0.406,1e-05,354,350,2,50,0.0001,704,3
0.404,1e-05,405,399,2,50,0.0001,804,3
0.404,1e-05,451,453,2,50,0.0001,904,3
0.404,1e-05,500,504,2,50,0.0001,1004,3
0.402,1e-05,554,550,2,50,0.0001,1104,3
0.404,1e-05,603,601,2,50,0.0001,1204,3
0.41,1e-05,658,646,2,50,0.0001,1304,3
0.414,1e-05,705,699,2,50,0.0001,1404,3
0.416,1e-05,753,751,2,50,0.0001,1504,3
0.416,1e-05,804,800,2,50,0.0001,1604,3
0.414,1e-05,852,852,2,50,0.0001,1704,3
0.414,1e-05,910,894,2,50,0.0001,1804,3
0.418,1e-05,957,947,2,50,0.0001,1904,3
0.42,1e-05,1009,995,2,50,0.0001,2004,3
0.554,1e-05,61,43,2,50,0.0001,104,4
0.552,1e-05,101,103,2,50,0.0001,204,4
0.554,1e-05,157,147,2,50,0.0001,304,4
0.556,1e-05,201,203,2,50,0.0001,404,4
0.556,1e-05,248,256,2,50,0.0001,504,4
0.556,1e-05,294,310,2,50,0.0001,604,4
0.556,1e-05,343,361,2,50,0.0001,704,4
0.556,1e-05,392,412,2,50,0.0001,804,4
0.558,1e-05,452,452,2,50,0.0001,904,4
0.558,1e-05,504,500,2,50,0.0001,1004,4
0.558,1e-05,554,550,2,50,0.0001,1104,4
0.558,1e-05,599,605,2,50,0.0001,1204,4
0.56,1e-05,646,658,2,50,0.0001,1304,4
0.562,1e-05,696,708,2,50,0.0001,1404,4
0.564,1e-05,748,756,2,50,0.0001,1504,4
0.564,1e-05,800,804,2,50,0.0001,1604,4
0.566,1e-05,858,846,2,50,0.0001,1704,4
0.57,1e-05,905,899,2,50,0.0001,1804,4
0.568,1e-05,953,951,2,50,0.0001,1904,4
0.57,1e-05,1008,996,2,50,0.0001,2004,4
0.494,1e-05,55,49,2,50,0.0001,104,5
0.494,1e-05,107,97,2,50,0.0001,204,5
0.496,1e-05,164,140,2,50,0.0001,304,5
0.502,1e-05,215,189,2,50,0.0001,404,5
0.496,1e-05,266,238,2,50,0.0001,504,5
0.498,1e-05,314,290,2,50,0.0001,604,5
0.5,1e-05,367,337,2,50,0.0001,704,5
0.504,1e-05,418,386,2,50,0.0001,804,5
0.508,1e-05,462,442,2,50,0.0001,904,5
0.512,1e-05,513,491,2,50,0.0001,1004,5
0.512,1e-05,568,536,2,50,0.0001,1104,5
0.512,1e-05,608,596,2,50,0.0001,1204,5
0.514,1e-05,662,642,2,50,0.0001,1304,5
0.514,1e-05,714,690,2,50,0.0001,1404,5
0.516,1e-05,762,742,2,50,0.0001,1504,5
0.518,1e-05,809,795,2,50,0.0001,1604,5
0.522,1e-05,857,847,2,50,0.0001,1704,5
0.522,1e-05,915,889,2,50,0.0001,1804,5
0.524,1e-05,962,942,2,50,0.0001,1904,5
0.526,1e-05,1012,992,2,50,0.0001,2004,5
0.504,1e-05,49,55,2,50,0.0001,104,6
0.504,1e-05,103,101,2,50,0.0001,204,6
0.506,1e-05,163,141,2,50,0.0001,304,6
0.508,1e-05,209,195,2,50,0.0001,404,6
0.504,1e-05,266,238,2,50,0.0001,504,6
0.506,1e-05,319,285,2,50,0.0001,604,6
0.508,1e-05,369,335,2,50,0.0001,704,6
0.508,1e-05,419,385,2,50,0.0001,804,6
0.512,1e-05,464,440,2,50,0.0001,904,6
0.52,1e-05,506,498,2,50,0.0001,1004,6
0.524,1e-05,563,541,2,50,0.0001,1104,6
0.528,1e-05,616,588,2,50,0.0001,1204,6
0.53,1e-05,659,645,2,50,0.0001,1304,6
0.532,1e-05,709,695,2,50,0.0001,1404,6
0.536,1e-05,762,742,2,50,0.0001,1504,6
0.538,1e-05,811,793,2,50,0.0001,1604,6
0.542,1e-05,857,847,2,50,0.0001,1704,6
0.546,1e-05,907,897,2,50,0.0001,1804,6
0.55,1e-05,961,943,2,50,0.0001,1904,6
0.55,1e-05,1007,997,2,50,0.0001,2004,6
0.512,1e-05,56,48,2,50,0.0001,104,7
0.51,1e-05,104,100,2,50,0.0001,204,7
0.51,1e-05,155,149,2,50,0.0001,304,7
0.51,1e-05,212,192,2,50,0.0001,404,7
0.512,1e-05,265,239,2,50,0.0001,504,7
0.514,1e-05,314,290,2,50,0.0001,604,7
0.514,1e-05,361,343,2,50,0.0001,704,7
0.516,1e-05,415,389,2,50,0.0001,804,7
0.516,1e-05,461,443,2,50,0.0001,904,7
0.518,1e-05,498,506,2,50,0.0001,1004,7
0.52,1e-05,541,563,2,50,0.0001,1104,7
0.524,1e-05,591,613,2,50,0.0001,1204,7
0.526,1e-05,645,659,2,50,0.0001,1304,7
0.522,1e-05,699,705,2,50,0.0001,1404,7
0.522,1e-05,751,753,2,50,0.0001,1504,7
0.524,1e-05,812,792,2,50,0.0001,1604,7
0.522,1e-05,864,840,2,50,0.0001,1704,7
0.522,1e-05,919,885,2,50,0.0001,1804,7
0.524,1e-05,968,936,2,50,0.0001,1904,7
0.528,1e-05,1015,989,2,50,0.0001,2004,7
0.544,1e-05,55,49,2,50,0.0001,104,8
0.546,1e-05,107,97,2,50,0.0001,204,8
0.546,1e-05,149,155,2,50,0.0001,304,8
0.548,1e-05,199,205,2,50,0.0001,404,8
0.552,1e-05,250,254,2,50,0.0001,504,8
0.554,1e-05,299,305,2,50,0.0001,604,8
0.554,1e-05,354,350,2,50,0.0001,704,8
0.554,1e-05,408,396,2,50,0.0001,804,8
0.554,1e-05,456,448,2,50,0.0001,904,8
0.554,1e-05,502,502,2,50,0.0001,1004,8
0.554,1e-05,548,556,2,50,0.0001,1104,8
0.554,1e-05,607,597,2,50,0.0001,1204,8
0.556,1e-05,657,647,2,50,0.0001,1304,8
0.556,1e-05,704,700,2,50,0.0001,1404,8
0.558,1e-05,755,749,2,50,0.0001,1504,8
0.558,1e-05,814,790,2,50,0.0001,1604,8
0.56,1e-05,860,844,2,50,0.0001,1704,8
0.57,1e-05,905,899,2,50,0.0001,1804,8
0.572,1e-05,967,937,2,50,0.0001,1904,8
0.574,1e-05,1018,986,2,50,0.0001,2004,8
0.524,1e-05,52,52,2,50,0.0001,104,9
0.522,1e-05,93,111,2,50,0.0001,204,9
0.522,1e-05,138,166,2,50,0.0001,304,9
0.522,1e-05,188,216,2,50,0.0001,404,9
0.522,1e-05,237,267,2,50,0.0001,504,9
0.526,1e-05,288,316,2,50,0.0001,604,9
0.532,1e-05,346,358,2,50,0.0001,704,9
0.532,1e-05,403,401,2,50,0.0001,804,9
0.53,1e-05,449,455,2,50,0.0001,904,9
0.53,1e-05,502,502,2,50,0.0001,1004,9
0.532,1e-05,549,555,2,50,0.0001,1104,9
0.532,1e-05,590,614,2,50,0.0001,1204,9
0.532,1e-05,643,661,2,50,0.0001,1304,9
0.536,1e-05,696,708,2,50,0.0001,1404,9
0.538,1e-05,747,757,2,50,0.0001,1504,9
0.538,1e-05,803,801,2,50,0.0001,1604,9
0.536,1e-05,847,857,2,50,0.0001,1704,9
0.534,1e-05,898,906,2,50,0.0001,1804,9
0.534,1e-05,943,961,2,50,0.0001,1904,9
0.534,1e-05,997,1007,2,50,0.0001,2004,9
0.502,1e-05,46,58,2,50,0.0001,104,10
0.502,1e-05,95,109,2,50,0.0001,204,10
0.502,1e-05,156,148,2,50,0.0001,304,10
0.502,1e-05,211,193,2,50,0.0001,404,10
0.502,1e-05,250,254,2,50,0.0001,504,10
0.502,1e-05,299,305,2,50,0.0001,604,10
0.504,1e-05,357,347,2,50,0.0001,704,10
0.506,1e-05,411,393,2,50,0.0001,804,10
0.506,1e-05,457,447,2,50,0.0001,904,10
0.506,1e-05,512,492,2,50,0.0001,1004,10
0.506,1e-05,560,544,2,50,0.0001,1104,10
0.506,1e-05,602,602,2,50,0.0001,1204,10
0.506,1e-05,658,646,2,50,0.0001,1304,10
0.506,1e-05,705,699,2,50,0.0001,1404,10
0.506,1e-05,749,755,2,50,0.0001,1504,10
0.506,1e-05,802,802,2,50,0.0001,1604,10
0.506,1e-05,854,850,2,50,0.0001,1704,10
0.506,1e-05,901,903,2,50,0.0001,1804,10
0.506,1e-05,946,958,2,50,0.0001,1904,10
0.508,1e-05,1003,1001,2,50,0.0001,2004,10
0.446,1e-05,45,59,2,50,0.0001,104,11
0.446,1e-05,95,109,2,50,0.0001,204,11
0.446,1e-05,149,155,2,50,0.0001,304,11
0.444,1e-05,207,197,2,50,0.0001,404,11
0.444,1e-05,262,242,2,50,0.0001,504,11
0.442,1e-05,299,305,2,50,0.0001,604,11
0.442,1e-05,346,358,2,50,0.0001,704,11
0.44,1e-05,398,406,2,50,0.0001,804,11
0.44,1e-05,449,455,2,50,0.0001,904,11
0.44,1e-05,508,496,2,50,0.0001,1004,11
0.438,1e-05,553,551,2,50,0.0001,1104,11
0.436,1e-05,597,607,2,50,0.0001,1204,11
0.436,1e-05,648,656,2,50,0.0001,1304,11
0.436,1e-05,696,708,2,50,0.0001,1404,11
0.436,1e-05,751,753,2,50,0.0001,1504,11
0.434,1e-05,809,795,2,50,0.0001,1604,11
0.432,1e-05,864,840,2,50,0.0001,1704,11
0.432,1e-05,908,896,2,50,0.0001,1804,11
0.432,1e-05,957,947,2,50,0.0001,1904,11
0.432,1e-05,1012,992,2,50,0.0001,2004,11
0.576,1e-05,56,48,2,50,0.0001,104,12
0.576,1e-05,107,97,2,50,0.0001,204,12
0.574,1e-05,151,153,2,50,0.0001,304,12
0.576,1e-05,196,208,2,50,0.0001,404,12
0.576,1e-05,248,256,2,50,0.0001,504,12
0.576,1e-05,301,303,2,50,0.0001,604,12
0.572,1e-05,352,352,2,50,0.0001,704,12
0.572,1e-05,397,407,2,50,0.0001,804,12
0.574,1e-05,457,447,2,50,0.0001,904,12
0.576,1e-05,513,491,2,50,0.0001,1004,12
0.574,1e-05,566,538,2,50,0.0001,1104,12
0.576,1e-05,616,588,2,50,0.0001,1204,12
0.578,1e-05,658,646,2,50,0.0001,1304,12
0.578,1e-05,709,695,2,50,0.0001,1404,12
0.58,1e-05,757,747,2,50,0.0001,1504,12
0.582,1e-05,809,795,2,50,0.0001,1604,12
0.588,1e-05,859,845,2,50,0.0001,1704,12
0.59,1e-05,912,892,2,50,0.0001,1804,12
0.598,1e-05,957,947,2,50,0.0001,1904,12
0.598,1e-05,1007,997,2,50,0.0001,2004,12
0.408,1e-05,46,58,2,50,0.0001,104,13
0.408,1e-05,96,108,2,50,0.0001,204,13
0.408,1e-05,148,156,2,50,0.0001,304,13
0.406,1e-05,205,199,2,50,0.0001,404,13
0.406,1e-05,256,248,2,50,0.0001,504,13
0.406,1e-05,308,296,2,50,0.0001,604,13
0.41,1e-05,369,335,2,50,0.0001,704,13
0.412,1e-05,421,383,2,50,0.0001,804,13
0.408,1e-05,467,437,2,50,0.0001,904,13
0.408,1e-05,520,484,2,50,0.0001,1004,13
0.406,1e-05,561,543,2,50,0.0001,1104,13
0.406,1e-05,608,596,2,50,0.0001,1204,13
0.402,1e-05,658,646,2,50,0.0001,1304,13
0.412,1e-05,710,694,2,50,0.0001,1404,13
0.414,1e-05,764,740,2,50,0.0001,1504,13
0.416,1e-05,810,794,2,50,0.0001,1604,13
0.418,1e-05,862,842,2,50,0.0001,1704,13
0.416,1e-05,911,893,2,50,0.0001,1804,13
0.414,1e-05,967,937,2,50,0.0001,1904,13
0.418,1e-05,1022,982,2,50,0.0001,2004,13
0.378,1e-05,53,51,2,50,0.0001,104,14
0.378,1e-05,105,99,2,50,0.0001,204,14
0.378,1e-05,160,144,2,50,0.0001,304,14
0.38,1e-05,209,195,2,50,0.0001,404,14
0.38,1e-05,254,250,2,50,0.0001,504,14
0.382,1e-05,312,292,2,50,0.0001,604,14
0.384,1e-05,359,345,2,50,0.0001,704,14
0.384,1e-05,402,402,2,50,0.0001,804,14
0.384,1e-05,458,446,2,50,0.0001,904,14
0.386,1e-05,512,492,2,50,0.0001,1004,14
0.386,1e-05,556,548,2,50,0.0001,1104,14
0.39,1e-05,602,602,2,50,0.0001,1204,14
0.392,1e-05,645,659,2,50,0.0001,1304,14
0.39,1e-05,693,711,2,50,0.0001,1404,14
0.39,1e-05,745,759,2,50,0.0001,1504,14
0.398,1e-05,798,806,2,50,0.0001,1604,14
0.402,1e-05,844,860,2,50,0.0001,1704,14
0.406,1e-05,891,913,2,50,0.0001,1804,14
0.408,1e-05,938,966,2,50,0.0001,1904,14
0.414,1e-05,990,1014,2,50,0.0001,2004,14
0.564,1e-05,46,58,2,50,0.0001,104,15
0.562,1e-05,94,110,2,50,0.0001,204,15
0.562,1e-05,144,160,2,50,0.0001,304,15
0.562,1e-05,193,211,2,50,0.0001,404,15
0.562,1e-05,244,260,2,50,0.0001,504,15
0.56,1e-05,300,304,2,50,0.0001,604,15
0.56,1e-05,347,357,2,50,0.0001,704,15
0.562,1e-05,393,411,2,50,0.0001,804,15
0.562,1e-05,448,456,2,50,0.0001,904,15
0.562,1e-05,502,502,2,50,0.0001,1004,15
0.564,1e-05,561,543,2,50,0.0001,1104,15
0.568,1e-05,609,595,2,50,0.0001,1204,15
0.562,1e-05,656,648,2,50,0.0001,1304,15
0.562,1e-05,709,695,2,50,0.0001,1404,15
0.564,1e-05,759,745,2,50,0.0001,1504,15
0.566,1e-05,816,788,2,50,0.0001,1604,15
0.568,1e-05,863,841,2,50,0.0001,1704,15
0.57,1e-05,916,888,2,50,0.0001,1804,15
0.574,1e-05,954,950,2,50,0.0001,1904,15
0.574,1e-05,997,1007,2,50,0.0001,2004,15
0.574,1e-05,47,57,2,50,0.0001,104,16
0.574,1e-05,88,116,2,50,0.0001,204,16
0.578,1e-05,141,163,2,50,0.0001,304,16
0.582,1e-05,192,212,2,50,0.0001,404,16
0.578,1e-05,241,263,2,50,0.0001,504,16
0.578,1e-05,282,322,2,50,0.0001,604,16
0.58,1e-05,324,380,2,50,0.0001,704,16
0.58,1e-05,373,431,2,50,0.0001,804,16
0.586,1e-05,428,476,2,50,0.0001,904,16
0.588,1e-05,483,521,2,50,0.0001,1004,16
0.586,1e-05,539,565,2,50,0.0001,1104,16
0.586,1e-05,596,608,2,50,0.0001,1204,16
0.592,1e-05,644,660,2,50,0.0001,1304,16
0.59,1e-05,699,705,2,50,0.0001,1404,16
0.592,1e-05,745,759,2,50,0.0001,1504,16
0.596,1e-05,793,811,2,50,0.0001,1604,16
0.6,1e-05,845,859,2,50,0.0001,1704,16
0.598,1e-05,900,904,2,50,0.0001,1804,16
0.6,1e-05,951,953,2,50,0.0001,1904,16
0.602,1e-05,1008,996,2,50,0.0001,2004,16
0.466,1e-05,49,55,2,50,0.0001,104,17
0.466,1e-05,98,106,2,50,0.0001,204,17
0.466,1e-05,149,155,2,50,0.0001,304,17
0.466,1e-05,201,203,2,50,0.0001,404,17
0.466,1e-05,247,257,2,50,0.0001,504,17
0.466,1e-05,297,307,2,50,0.0001,604,17
0.466,1e-05,350,354,2,50,0.0001,704,17
0.466,1e-05,400,404,2,50,0.0001,804,17
0.466,1e-05,449,455,2,50,0.0001,904,17
0.466,1e-05,514,490,2,50,0.0001,1004,17
0.466,1e-05,562,542,2,50,0.0001,1104,17
0.466,1e-05,607,597,2,50,0.0001,1204,17
0.466,1e-05,659,645,2,50,0.0001,1304,17
0.466,1e-05,702,702,2,50,0.0001,1404,17
0.466,1e-05,750,754,2,50,0.0001,1504,17
0.466,1e-05,794,810,2,50,0.0001,1604,17
0.466,1e-05,837,867,2,50,0.0001,1704,17
0.466,1e-05,886,918,2,50,0.0001,1804,17
0.466,1e-05,932,972,2,50,0.0001,1904,17
0.466,1e-05,985,1019,2,50,0.0001,2004,17
0.49,1e-05,56,48,2,50,0.0001,104,18
0.496,1e-05,106,98,2,50,0.0001,204,18
0.504,1e-05,155,149,2,50,0.0001,304,18
0.52,1e-05,200,204,2,50,0.0001,404,18
0.522,1e-05,244,260,2,50,0.0001,504,18
0.538,1e-05,294,310,2,50,0.0001,604,18
0.548,1e-05,343,361,2,50,0.0001,704,18
0.566,1e-05,393,411,2,50,0.0001,804,18
0.576,1e-05,441,463,2,50,0.0001,904,18
0.594,1e-05,487,517,2,50,0.0001,1004,18
0.592,1e-05,538,566,2,50,0.0001,1104,18
0.6,1e-05,594,610,2,50,0.0001,1204,18
0.602,1e-05,643,661,2,50,0.0001,1304,18
0.602,1e-05,687,717,2,50,0.0001,1404,18
0.61,1e-05,738,766,2,50,0.0001,1504,18
0.618,1e-05,789,815,2,50,0.0001,1604,18
0.614,1e-05,844,860,2,50,0.0001,1704,18
0.63,1e-05,893,911,2,50,0.0001,1804,18
0.626,1e-05,939,965,2,50,0.0001,1904,18
0.628,1e-05,990,1014,2,50,0.0001,2004,18
0.458,1e-05,54,50,2,50,0.0001,104,19
0.458,1e-05,110,94,2,50,0.0001,204,19
0.458,1e-05,155,149,2,50,0.0001,304,19
0.458,1e-05,199,205,2,50,0.0001,404,19
0.456,1e-05,246,258,2,50,0.0001,504,19
0.456,1e-05,294,310,2,50,0.0001,604,19
0.456,1e-05,344,360,2,50,0.0001,704,19
0.456,1e-05,394,410,2,50,0.0001,804,19
0.456,1e-05,438,466,2,50,0.0001,904,19
0.456,1e-05,484,520,2,50,0.0001,1004,19
0.454,1e-05,533,571,2,50,0.0001,1104,19
0.456,1e-05,586,618,2,50,0.0001,1204,19
0.454,1e-05,645,659,2,50,0.0001,1304,19
0.454,1e-05,693,711,2,50,0.0001,1404,19
0.452,1e-05,741,763,2,50,0.0001,1504,19
0.452,1e-05,790,814,2,50,0.0001,1604,19
0.446,1e-05,841,863,2,50,0.0001,1704,19
0.448,1e-05,899,905,2,50,0.0001,1804,19
0.446,1e-05,949,955,2,50,0.0001,1904,19
0.45,1e-05,990,1014,2,50,0.0001,2004,19
0.522,1e-05,49,55,2,50,0.0001,104,20
0.522,1e-05,108,96,2,50,0.0001,204,20
0.522,1e-05,156,148,2,50,0.0001,304,20
0.522,1e-05,206,198,2,50,0.0001,404,20
0.522,1e-05,256,248,2,50,0.0001,504,20
0.522,1e-05,310,294,2,50,0.0001,604,20
0.522,1e-05,358,346,2,50,0.0001,704,20
0.522,1e-05,405,399,2,50,0.0001,804,20
0.522,1e-05,450,454,2,50,0.0001,904,20
0.522,1e-05,505,499,2,50,0.0001,1004,20
0.522,1e-05,566,538,2,50,0.0001,1104,20
0.522,1e-05,620,584,2,50,0.0001,1204,20
0.522,1e-05,669,635,2,50,0.0001,1304,20
0.522,1e-05,719,685,2,50,0.0001,1404,20
0.522,1e-05,772,732,2,50,0.0001,1504,20
0.522,1e-05,828,776,2,50,0.0001,1604,20
0.522,1e-05,878,826,2,50,0.0001,1704,20
0.522,1e-05,922,882,2,50,0.0001,1804,20
0.522,1e-05,965,939,2,50,0.0001,1904,20
0.522,1e-05,1013,991,2,50,0.0001,2004,20
0.486,1e-05,54,50,2,50,0.001,104,1
0.486,1e-05,105,99,2,50,0.001,204,1
0.486,1e-05,162,142,2,50,0.001,304,1
0.486,1e-05,207,197,2,50,0.001,404,1
0.486,1e-05,250,254,2,50,0.001,504,1
0.486,1e-05,297,307,2,50,0.001,604,1
0.486,1e-05,347,357,2,50,0.001,704,1
0.486,1e-05,398,406,2,50,0.001,804,1
0.486,1e-05,448,456,2,50,0.001,904,1
0.486,1e-05,497,507,2,50,0.001,1004,1
0.486,1e-05,540,564,2,50,0.001,1104,1
0.486,1e-05,592,612,2,50,0.001,1204,1
0.486,1e-05,643,661,2,50,0.001,1304,1
0.486,1e-05,690,714,2,50,0.001,1404,1
0.486,1e-05,747,757,2,50,0.001,1504,1
0.5,1e-05,804,800,2,50,0.001,1604,1
0.502,1e-05,850,854,2,50,0.001,1704,1
0.518,1e-05,898,906,2,50,0.001,1804,1
0.61,1e-05,956,948,2,50,0.001,1904,1
0.628,1e-05,1009,995,2,50,0.001,2004,1
0.502,1e-05,56,48,2,50,0.001,104,2
0.502,1e-05,105,99,2,50,0.001,204,2
0.502,1e-05,157,147,2,50,0.001,304,2
0.5,1e-05,210,194,2,50,0.001,404,2
0.5,1e-05,254,250,2,50,0.001,504,2
0.496,1e-05,301,303,2,50,0.001,604,2
0.484,1e-05,353,351,2,50,0.001,704,2
0.48,1e-05,394,410,2,50,0.001,804,2
0.474,1e-05,448,456,2,50,0.001,904,2
0.47,1e-05,495,509,2,50,0.001,1004,2
0.474,1e-05,541,563,2,50,0.001,1104,2
0.484,1e-05,591,613,2,50,0.001,1204,2
0.504,1e-05,641,663,2,50,0.001,1304,2
0.518,1e-05,692,712,2,50,0.001,1404,2
0.548,1e-05,744,760,2,50,0.001,1504,2
0.558,1e-05,794,810,2,50,0.001,1604,2
0.594,1e-05,844,860,2,50,0.001,1704,2
0.626,1e-05,900,904,2,50,0.001,1804,2
0.64,1e-05,946,958,2,50,0.001,1904,2
0.664,1e-05,1003,1001,2,50,0.001,2004,2
0.474,1e-05,54,50,2,50,0.001,104,3
0.474,1e-05,94,110,2,50,0.001,204,3
0.474,1e-05,150,154,2,50,0.001,304,3
0.474,1e-05,198,206,2,50,0.001,404,3
0.474,1e-05,244,260,2,50,0.001,504,3
0.474,1e-05,285,319,2,50,0.001,604,3
0.474,1e-05,340,364,2,50,0.001,704,3
0.474,1e-05,389,415,2,50,0.001,804,3
0.474,1e-05,445,459,2,50,0.001,904,3
0.474,1e-05,498,506,2,50,0.001,1004,3
0.474,1e-05,548,556,2,50,0.001,1104,3
0.474,1e-05,603,601,2,50,0.001,1204,3
0.488,1e-05,658,646,2,50,0.001,1304,3
0.52,1e-05,715,689,2,50,0.001,1404,3
0.53,1e-05,763,741,2,50,0.001,1504,3
0.548,1e-05,813,791,2,50,0.001,1604,3
0.57,1e-05,859,845,2,50,0.001,1704,3
0.624,1e-05,907,897,2,50,0.001,1804,3
0.706,1e-05,956,948,2,50,0.001,1904,3
0.76,1e-05,1015,989,2,50,0.001,2004,3
0.452,1e-05,48,56,2,50,0.001,104,4
0.456,1e-05,102,102,2,50,0.001,204,4
0.468,1e-05,149,155,2,50,0.001,304,4
0.478,1e-05,191,213,2,50,0.001,404,4
0.486,1e-05,237,267,2,50,0.001,504,4
0.498,1e-05,291,313,2,50,0.001,604,4
0.504,1e-05,328,376,2,50,0.001,704,4
0.51,1e-05,378,426,2,50,0.001,804,4
0.516,1e-05,439,465,2,50,0.001,904,4
0.582,1e-05,502,502,2,50,0.001,1004,4
0.612,1e-05,560,544,2,50,0.001,1104,4
0.654,1e-05,605,599,2,50,0.001,1204,4
0.672,1e-05,654,650,2,50,0.001,1304,4
0.694,1e-05,700,704,2,50,0.001,1404,4
0.69,1e-05,742,762,2,50,0.001,1504,4
0.736,1e-05,796,808,2,50,0.001,1604,4
0.77,1e-05,841,863,2,50,0.001,1704,4
0.792,1e-05,894,910,2,50,0.001,1804,4
0.814,1e-05,948,956,2,50,0.001,1904,4
0.83,1e-05,1000,1004,2,50,0.001,2004,4
0.51,1e-05,49,55,2,50,0.001,104,5
0.51,1e-05,106,98,2,50,0.001,204,5
0.51,1e-05,153,151,2,50,0.001,304,5
0.51,1e-05,202,202,2,50,0.001,404,5
0.51,1e-05,255,249,2,50,0.001,504,5
0.51,1e-05,295,309,2,50,0.001,604,5
0.51,1e-05,343,361,2,50,0.001,704,5
0.51,1e-05,391,413,2,50,0.001,804,5
0.51,1e-05,442,462,2,50,0.001,904,5
0.51,1e-05,492,512,2,50,0.001,1004,5
0.51,1e-05,544,560,2,50,0.001,1104,5
0.498,1e-05,594,610,2,50,0.001,1204,5
0.49,1e-05,642,662,2,50,0.001,1304,5
0.468,1e-05,691,713,2,50,0.001,1404,5
0.444,1e-05,743,761,2,50,0.001,1504,5
0.482,1e-05,791,813,2,50,0.001,1604,5
0.538,1e-05,847,857,2,50,0.001,1704,5
0.574,1e-05,892,912,2,50,0.001,1804,5
0.62,1e-05,943,961,2,50,0.001,1904,5
0.66,1e-05,997,1007,2,50,0.001,2004,5
0.514,1e-05,50,54,2,50,0.001,104,6
0.508,1e-05,93,111,2,50,0.001,204,6
0.506,1e-05,137,167,2,50,0.001,304,6
0.504,1e-05,188,216,2,50,0.001,404,6
0.512,1e-05,232,272,2,50,0.001,504,6
0.526,1e-05,282,322,2,50,0.001,604,6
0.528,1e-05,334,370,2,50,0.001,704,6
0.542,1e-05,379,425,2,50,0.001,804,6
0.552,1e-05,431,473,2,50,0.001,904,6
0.566,1e-05,480,524,2,50,0.001,1004,6
0.578,1e-05,532,572,2,50,0.001,1104,6
0.6,1e-05,584,620,2,50,0.001,1204,6
0.626,1e-05,639,665,2,50,0.001,1304,6
0.67,1e-05,680,724,2,50,0.001,1404,6
0.71,1e-05,734,770,2,50,0.001,1504,6
0.742,1e-05,785,819,2,50,0.001,1604,6
0.75,1e-05,836,868,2,50,0.001,1704,6
0.758,1e-05,894,910,2,50,0.001,1804,6
0.762,1e-05,950,954,2,50,0.001,1904,6
0.764,1e-05,997,1007,2,50,0.001,2004,6
0.488,1e-05,49,55,2,50,0.001,104,7
0.492,1e-05,111,93,2,50,0.001,204,7
0.5,1e-05,155,149,2,50,0.001,304,7
0.502,1e-05,199,205,2,50,0.001,404,7
0.522,1e-05,244,260,2,50,0.001,504,7
0.554,1e-05,300,304,2,50,0.001,604,7
0.576,1e-05,353,351,2,50,0.001,704,7
0.59,1e-05,407,397,2,50,0.001,804,7
0.61,1e-05,459,445,2,50,0.001,904,7
0.61,1e-05,513,491,2,50,0.001,1004,7
0.62,1e-05,561,543,2,50,0.001,1104,7
0.614,1e-05,618,586,2,50,0.001,1204,7
0.608,1e-05,671,633,2,50,0.001,1304,7
0.582,1e-05,715,689,2,50,0.001,1404,7
0.594,1e-05,760,744,2,50,0.001,1504,7
0.6,1e-05,807,797,2,50,0.001,1604,7
0.622,1e-05,855,849,2,50,0.001,1704,7
0.666,1e-05,906,898,2,50,0.001,1804,7
0.714,1e-05,950,954,2,50,0.001,1904,7
0.748,1e-05,1000,1004,2,50,0.001,2004,7
0.462,1e-05,53,51,2,50,0.001,104,8
0.45,1e-05,98,106,2,50,0.001,204,8
0.452,1e-05,146,158,2,50,0.001,304,8
0.44,1e-05,195,209,2,50,0.001,404,8
0.428,1e-05,236,268,2,50,0.001,504,8
0.446,1e-05,284,320,2,50,0.001,604,8
0.464,1e-05,344,360,2,50,0.001,704,8
0.5,1e-05,393,411,2,50,0.001,804,8
0.536,1e-05,440,464,2,50,0.001,904,8
0.57,1e-05,497,507,2,50,0.001,1004,8
0.616,1e-05,547,557,2,50,0.001,1104,8
0.652,1e-05,601,603,2,50,0.001,1204,8
0.664,1e-05,642,662,2,50,0.001,1304,8
0.682,1e-05,698,706,2,50,0.001,1404,8
0.714,1e-05,742,762,2,50,0.001,1504,8
0.732,1e-05,793,811,2,50,0.001,1604,8
0.73,1e-05,845,859,2,50,0.001,1704,8
0.752,1e-05,892,912,2,50,0.001,1804,8
0.758,1e-05,951,953,2,50,0.001,1904,8
0.772,1e-05,999,1005,2,50,0.001,2004,8
0.518,1e-05,56,48,2,50,0.001,104,9
0.518,1e-05,115,89,2,50,0.001,204,9
0.522,1e-05,163,141,2,50,0.001,304,9
0.526,1e-05,210,194,2,50,0.001,404,9
0.534,1e-05,262,242,2,50,0.001,504,9
0.536,1e-05,310,294,2,50,0.001,604,9
0.556,1e-05,361,343,2,50,0.001,704,9
0.572,1e-05,405,399,2,50,0.001,804,9
0.578,1e-05,456,448,2,50,0.001,904,9
0.576,1e-05,504,500,2,50,0.001,1004,9
0.582,1e-05,556,548,2,50,0.001,1104,9
0.59,1e-05,608,596,2,50,0.001,1204,9
0.594,1e-05,648,656,2,50,0.001,1304,9
0.6,1e-05,700,704,2,50,0.001,1404,9
0.612,1e-05,753,751,2,50,0.001,1504,9
0.628,1e-05,801,803,2,50,0.001,1604,9
0.66,1e-05,858,846,2,50,0.001,1704,9
0.686,1e-05,908,896,2,50,0.001,1804,9
0.724,1e-05,953,951,2,50,0.001,1904,9
0.742,1e-05,1003,1001,2,50,0.001,2004,9
0.546,1e-05,39,65,2,50,0.001,104,10
0.55,1e-05,83,121,2,50,0.001,204,10
0.544,1e-05,138,166,2,50,0.001,304,10
0.542,1e-05,192,212,2,50,0.001,404,10
0.546,1e-05,247,257,2,50,0.001,504,10
0.552,1e-05,299,305,2,50,0.001,604,10
0.562,1e-05,351,353,2,50,0.001,704,10
0.578,1e-05,406,398,2,50,0.001,804,10
0.592,1e-05,456,448,2,50,0.001,904,10
0.622,1e-05,510,494,2,50,0.001,1004,10
0.634,1e-05,559,545,2,50,0.001,1104,10
0.66,1e-05,620,584,2,50,0.001,1204,10
0.692,1e-05,666,638,2,50,0.001,1304,10
0.72,1e-05,723,681,2,50,0.001,1404,10
0.728,1e-05,769,735,2,50,0.001,1504,10
0.742,1e-05,820,784,2,50,0.001,1604,10
0.758,1e-05,871,833,2,50,0.001,1704,10
0.76,1e-05,914,890,2,50,0.001,1804,10
0.782,1e-05,967,937,2,50,0.001,1904,10
0.798,1e-05,1017,987,2,50,0.001,2004,10
0.522,1e-05,47,57,2,50,0.001,104,11
0.516,1e-05,104,100,2,50,0.001,204,11
0.52,1e-05,156,148,2,50,0.001,304,11
0.53,1e-05,201,203,2,50,0.001,404,11
0.544,1e-05,254,250,2,50,0.001,504,11
0.554,1e-05,298,306,2,50,0.001,604,11
0.586,1e-05,344,360,2,50,0.001,704,11
0.598,1e-05,388,416,2,50,0.001,804,11
0.61,1e-05,445,459,2,50,0.001,904,11
0.618,1e-05,495,509,2,50,0.001,1004,11
0.636,1e-05,545,559,2,50,0.001,1104,11
0.64,1e-05,599,605,2,50,0.001,1204,11
0.648,1e-05,655,649,2,50,0.001,1304,11
0.676,1e-05,702,702,2,50,0.001,1404,11
0.718,1e-05,750,754,2,50,0.001,1504,11
0.772,1e-05,806,798,2,50,0.001,1604,11
0.778,1e-05,857,847,2,50,0.001,1704,11
0.794,1e-05,905,899,2,50,0.001,1804,11
0.786,1e-05,956,948,2,50,0.001,1904,11
0.788,1e-05,1000,1004,2,50,0.001,2004,11
0.638,1e-05,53,51,2,50,0.001,104,12
0.638,1e-05,102,102,2,50,0.001,204,12
0.64,1e-05,156,148,2,50,0.001,304,12
0.646,1e-05,205,199,2,50,0.001,404,12
0.668,1e-05,260,244,2,50,0.001,504,12
0.664,1e-05,314,290,2,50,0.001,604,12
0.668,1e-05,371,333,2,50,0.001,704,12
0.672,1e-05,418,386,2,50,0.001,804,12
0.672,1e-05,472,432,2,50,0.001,904,12
0.678,1e-05,533,471,2,50,0.001,1004,12
0.686,1e-05,584,520,2,50,0.001,1104,12
0.692,1e-05,631,573,2,50,0.001,1204,12
0.69,1e-05,689,615,2,50,0.001,1304,12
0.688,1e-05,735,669,2,50,0.001,1404,12
0.698,1e-05,776,728,2,50,0.001,1504,12
0.712,1e-05,824,780,2,50,0.001,1604,12
0.722,1e-05,874,830,2,50,0.001,1704,12
0.742,1e-05,927,877,2,50,0.001,1804,12
0.754,1e-05,965,939,2,50,0.001,1904,12
0.762,1e-05,1014,990,2,50,0.001,2004,12
0.454,1e-05,52,52,2,50,0.001,104,13
0.472,1e-05,97,107,2,50,0.001,204,13
0.488,1e-05,152,152,2,50,0.001,304,13
0.504,1e-05,215,189,2,50,0.001,404,13
0.504,1e-05,271,233,2,50,0.001,504,13
0.546,1e-05,320,284,2,50,0.001,604,13
0.564,1e-05,368,336,2,50,0.001,704,13
0.596,1e-05,411,393,2,50,0.001,804,13
0.6,1e-05,452,452,2,50,0.001,904,13
0.6,1e-05,500,504,2,50,0.001,1004,13
0.576,1e-05,544,560,2,50,0.001,1104,13
0.632,1e-05,592,612,2,50,0.001,1204,13
0.664,1e-05,647,657,2,50,0.001,1304,13
0.742,1e-05,696,708,2,50,0.001,1404,13
0.764,1e-05,748,756,2,50,0.001,1504,13
0.798,1e-05,803,801,2,50,0.001,1604,13
0.786,1e-05,862,842,2,50,0.001,1704,13
0.776,1e-05,906,898,2,50,0.001,1804,13
0.784,1e-05,955,949,2,50,0.001,1904,13
0.788,1e-05,1002,1002,2,50,0.001,2004,13
0.518,1e-05,55,49,2,50,0.001,104,14
0.518,1e-05,102,102,2,50,0.001,204,14
0.518,1e-05,151,153,2,50,0.001,304,14
0.518,1e-05,204,200,2,50,0.001,404,14
0.518,1e-05,256,248,2,50,0.001,504,14
0.518,1e-05,303,301,2,50,0.001,604,14
0.518,1e-05,366,338,2,50,0.001,704,14
0.52,1e-05,417,387,2,50,0.001,804,14
0.522,1e-05,463,441,2,50,0.001,904,14
0.524,1e-05,506,498,2,50,0.001,1004,14
0.534,1e-05,559,545,2,50,0.001,1104,14
0.548,1e-05,595,609,2,50,0.001,1204,14
0.56,1e-05,646,658,2,50,0.001,1304,14
0.584,1e-05,702,702,2,50,0.001,1404,14
0.62,1e-05,756,748,2,50,0.001,1504,14
0.64,1e-05,807,797,2,50,0.001,1604,14
0.638,1e-05,857,847,2,50,0.001,1704,14
0.646,1e-05,907,897,2,50,0.001,1804,14
0.722,1e-05,955,949,2,50,0.001,1904,14
0.748,1e-05,1011,993,2,50,0.001,2004,14
0.512,1e-05,50,54,2,50,0.001,104,15
0.512,1e-05,101,103,2,50,0.001,204,15
0.512,1e-05,156,148,2,50,0.001,304,15
0.514,1e-05,207,197,2,50,0.001,404,15
0.516,1e-05,250,254,2,50,0.001,504,15
0.518,1e-05,302,302,2,50,0.001,604,15
0.52,1e-05,350,354,2,50,0.001,704,15
0.524,1e-05,400,404,2,50,0.001,804,15
0.53,1e-05,448,456,2,50,0.001,904,15
0.566,1e-05,510,494,2,50,0.001,1004,15
0.596,1e-05,563,541,2,50,0.001,1104,15
0.638,1e-05,613,591,2,50,0.001,1204,15
0.668,1e-05,661,643,2,50,0.001,1304,15
0.694,1e-05,719,685,2,50,0.001,1404,15
0.7,1e-05,759,745,2,50,0.001,1504,15
0.702,1e-05,809,795,2,50,0.001,1604,15
0.696,1e-05,851,853,2,50,0.001,1704,15
0.704,1e-05,901,903,2,50,0.001,1804,15
0.716,1e-05,959,945,2,50,0.001,1904,15
0.718,1e-05,1012,992,2,50,0.001,2004,15
0.466,1e-05,52,52,2,50,0.001,104,16
0.466,1e-05,111,93,2,50,0.001,204,16
0.466,1e-05,164,140,2,50,0.001,304,16
0.466,1e-05,212,192,2,50,0.001,404,16
0.466,1e-05,248,256,2,50,0.001,504,16
0.462,1e-05,296,308,2,50,0.001,604,16
0.458,1e-05,344,360,2,50,0.001,704,16
0.458,1e-05,384,420,2,50,0.001,804,16
0.462,1e-05,427,477,2,50,0.001,904,16
0.466,1e-05,475,529,2,50,0.001,1004,16
0.488,1e-05,530,574,2,50,0.001,1104,16
0.524,1e-05,576,628,2,50,0.001,1204,16
0.584,1e-05,632,672,2,50,0.001,1304,16
0.626,1e-05,680,724,2,50,0.001,1404,16
0.652,1e-05,731,773,2,50,0.001,1504,16
0.68,1e-05,793,811,2,50,0.001,1604,16
0.698,1e-05,833,871,2,50,0.001,1704,16
0.698,1e-05,880,924,2,50,0.001,1804,16
0.674,1e-05,933,971,2,50,0.001,1904,16
0.684,1e-05,985,1019,2,50,0.001,2004,16
0.576,1e-05,52,52,2,50,0.001,104,17
0.582,1e-05,100,104,2,50,0.001,204,17
0.584,1e-05,151,153,2,50,0.001,304,17
0.59,1e-05,203,201,2,50,0.001,404,17
0.598,1e-05,253,251,2,50,0.001,504,17
0.608,1e-05,302,302,2,50,0.001,604,17
0.616,1e-05,352,352,2,50,0.001,704,17
0.632,1e-05,400,404,2,50,0.001,804,17
0.628,1e-05,452,452,2,50,0.001,904,17
0.636,1e-05,499,505,2,50,0.001,1004,17
0.652,1e-05,542,562,2,50,0.001,1104,17
0.668,1e-05,594,610,2,50,0.001,1204,17
0.672,1e-05,651,653,2,50,0.001,1304,17
0.674,1e-05,699,705,2,50,0.001,1404,17
0.692,1e-05,755,749,2,50,0.001,1504,17
0.704,1e-05,805,799,2,50,0.001,1604,17
0.72,1e-05,851,853,2,50,0.001,1704,17
0.73,1e-05,897,907,2,50,0.001,1804,17
0.758,1e-05,948,956,2,50,0.001,1904,17
0.764,1e-05,1005,999,2,50,0.001,2004,17
0.484,1e-05,61,43,2,50,0.001,104,18
0.474,1e-05,110,94,2,50,0.001,204,18
0.466,1e-05,154,150,2,50,0.001,304,18
0.456,1e-05,200,204,2,50,0.001,404,18
0.466,1e-05,257,247,2,50,0.001,504,18
0.472,1e-05,312,292,2,50,0.001,604,18
0.484,1e-05,372,332,2,50,0.001,704,18
0.492,1e-05,417,387,2,50,0.001,804,18
0.508,1e-05,473,431,2,50,0.001,904,18
0.514,1e-05,517,487,2,50,0.001,1004,18
0.534,1e-05,567,537,2,50,0.001,1104,18
0.556,1e-05,615,589,2,50,0.001,1204,18
0.592,1e-05,667,637,2,50,0.001,1304,18
0.634,1e-05,717,687,2,50,0.001,1404,18
0.648,1e-05,770,734,2,50,0.001,1504,18
0.628,1e-05,821,783,2,50,0.001,1604,18
0.628,1e-05,869,835,2,50,0.001,1704,18
0.64,1e-05,914,890,2,50,0.001,1804,18
0.656,1e-05,962,942,2,50,0.001,1904,18
0.658,1e-05,1013,991,2,50,0.001,2004,18
0.56,1e-05,53,51,2,50,0.001,104,19
0.55,1e-05,107,97,2,50,0.001,204,19
0.534,1e-05,151,153,2,50,0.001,304,19
0.522,1e-05,207,197,2,50,0.001,404,19
0.53,1e-05,245,259,2,50,0.001,504,19
0.536,1e-05,295,309,2,50,0.001,604,19
0.54,1e-05,347,357,2,50,0.001,704,19
0.552,1e-05,397,407,2,50,0.001,804,19
0.564,1e-05,451,453,2,50,0.001,904,19
0.586,1e-05,506,498,2,50,0.001,1004,19
0.6,1e-05,551,553,2,50,0.001,1104,19
0.626,1e-05,599,605,2,50,0.001,1204,19
0.644,1e-05,654,650,2,50,0.001,1304,19
0.656,1e-05,706,698,2,50,0.001,1404,19
0.66,1e-05,756,748,2,50,0.001,1504,19
0.666,1e-05,804,800,2,50,0.001,1604,19
0.674,1e-05,846,858,2,50,0.001,1704,19
0.692,1e-05,903,901,2,50,0.001,1804,19
0.72,1e-05,954,950,2,50,0.001,1904,19
0.728,1e-05,1008,996,2,50,0.001,2004,19
0.502,1e-05,52,52,2,50,0.001,104,20
0.504,1e-05,108,96,2,50,0.001,204,20
0.502,1e-05,153,151,2,50,0.001,304,20
0.508,1e-05,204,200,2,50,0.001,404,20
0.512,1e-05,250,254,2,50,0.001,504,20
0.556,1e-05,301,303,2,50,0.001,604,20
0.604,1e-05,351,353,2,50,0.001,704,20
0.638,1e-05,400,404,2,50,0.001,804,20
0.668,1e-05,453,451,2,50,0.001,904,20
0.71,1e-05,499,505,2,50,0.001,1004,20
0.758,1e-05,545,559,2,50,0.001,1104,20
0.808,1e-05,604,600,2,50,0.001,1204,20
0.78,1e-05,648,656,2,50,0.001,1304,20
0.836,1e-05,693,711,2,50,0.001,1404,20
0.828,1e-05,743,761,2,50,0.001,1504,20
0.816,1e-05,795,809,2,50,0.001,1604,20
0.792,1e-05,834,870,2,50,0.001,1704,20
0.788,1e-05,886,918,2,50,0.001,1804,20
0.798,1e-05,946,958,2,50,0.001,1904,20
0.802,1e-05,1005,999,2,50,0.001,2004,20
0.498,1e-05,62,42,2,50,0.01,104,1
0.548,1e-05,114,90,2,50,0.01,204,1
0.586,1e-05,163,141,2,50,0.01,304,1
0.594,1e-05,213,191,2,50,0.01,404,1
0.594,1e-05,267,237,2,50,0.01,504,1
0.592,1e-05,318,286,2,50,0.01,604,1
0.608,1e-05,363,341,2,50,0.01,704,1
0.664,1e-05,417,387,2,50,0.01,804,1
0.806,1e-05,469,435,2,50,0.01,904,1
0.854,1e-05,511,493,2,50,0.01,1004,1
0.846,1e-05,568,536,2,50,0.01,1104,1
0.866,1e-05,610,594,2,50,0.01,1204,1
0.878,1e-05,654,650,2,50,0.01,1304,1
0.88,1e-05,695,709,2,50,0.01,1404,1
0.884,1e-05,743,761,2,50,0.01,1504,1
0.892,1e-05,793,811,2,50,0.01,1604,1
0.884,1e-05,839,865,2,50,0.01,1704,1
0.908,1e-05,888,916,2,50,0.01,1804,1
0.918,1e-05,949,955,2,50,0.01,1904,1
0.922,1e-05,1006,998,2,50,0.01,2004,1
0.506,1e-05,53,51,2,50,0.01,104,2
0.594,1e-05,107,97,2,50,0.01,204,2
0.604,1e-05,154,150,2,50,0.01,304,2
0.608,1e-05,205,199,2,50,0.01,404,2
0.588,1e-05,255,249,2,50,0.01,504,2
0.62,1e-05,304,300,2,50,0.01,604,2
0.706,1e-05,352,352,2,50,0.01,704,2
0.826,1e-05,398,406,2,50,0.01,804,2
0.87,1e-05,452,452,2,50,0.01,904,2
0.866,1e-05,498,506,2,50,0.01,1004,2
0.84,1e-05,539,565,2,50,0.01,1104,2
0.856,1e-05,594,610,2,50,0.01,1204,2
0.876,1e-05,639,665,2,50,0.01,1304,2
0.898,1e-05,690,714,2,50,0.01,1404,2
0.902,1e-05,752,752,2,50,0.01,1504,2
0.9,1e-05,793,811,2,50,0.01,1604,2
0.908,1e-05,838,866,2,50,0.01,1704,2
0.918,1e-05,887,917,2,50,0.01,1804,2
0.92,1e-05,943,961,2,50,0.01,1904,2
0.928,1e-05,995,1009,2,50,0.01,2004,2
0.51,1e-05,47,57,2,50,0.01,104,3
0.582,1e-05,105,99,2,50,0.01,204,3
0.632,1e-05,161,143,2,50,0.01,304,3
0.61,1e-05,209,195,2,50,0.01,404,3
0.558,1e-05,264,240,2,50,0.01,504,3
0.64,1e-05,323,281,2,50,0.01,604,3
0.676,1e-05,376,328,2,50,0.01,704,3
0.758,1e-05,428,376,2,50,0.01,804,3
0.8,1e-05,479,425,2,50,0.01,904,3
0.814,1e-05,529,475,2,50,0.01,1004,3
0.828,1e-05,576,528,2,50,0.01,1104,3
0.84,1e-05,615,589,2,50,0.01,1204,3
0.85,1e-05,669,635,2,50,0.01,1304,3
0.886,1e-05,713,691,2,50,0.01,1404,3
0.89,1e-05,759,745,2,50,0.01,1504,3
0.894,1e-05,811,793,2,50,0.01,1604,3
0.91,1e-05,855,849,2,50,0.01,1704,3
0.902,1e-05,901,903,2,50,0.01,1804,3
0.912,1e-05,954,950,2,50,0.01,1904,3
0.904,1e-05,1008,996,2,50,0.01,2004,3
0.596,1e-05,55,49,2,50,0.01,104,4
0.542,1e-05,106,98,2,50,0.01,204,4
0.608,1e-05,161,143,2,50,0.01,304,4
0.612,1e-05,212,192,2,50,0.01,404,4
0.62,1e-05,261,243,2,50,0.01,504,4
0.62,1e-05,308,296,2,50,0.01,604,4
0.706,1e-05,362,342,2,50,0.01,704,4
0.746,1e-05,411,393,2,50,0.01,804,4
0.766,1e-05,464,440,2,50,0.01,904,4
0.786,1e-05,510,494,2,50,0.01,1004,4
0.832,1e-05,556,548,2,50,0.01,1104,4
0.87,1e-05,613,591,2,50,0.01,1204,4
0.898,1e-05,672,632,2,50,0.01,1304,4
0.91,1e-05,717,687,2,50,0.01,1404,4
0.92,1e-05,763,741,2,50,0.01,1504,4
0.926,1e-05,812,792,2,50,0.01,1604,4
0.928,1e-05,856,848,2,50,0.01,1704,4
0.942,1e-05,900,904,2,50,0.01,1804,4
0.942,1e-05,944,960,2,50,0.01,1904,4
0.934,1e-05,1002,1002,2,50,0.01,2004,4
0.442,1e-05,58,46,2,50,0.01,104,5
0.58,1e-05,107,97,2,50,0.01,204,5
0.602,1e-05,159,145,2,50,0.01,304,5
0.618,1e-05,205,199,2,50,0.01,404,5
0.626,1e-05,256,248,2,50,0.01,504,5
0.726,1e-05,305,299,2,50,0.01,604,5
0.808,1e-05,355,349,2,50,0.01,704,5
0.818,1e-05,399,405,2,50,0.01,804,5
0.824,1e-05,452,452,2,50,0.01,904,5
0.808,1e-05,507,497,2,50,0.01,1004,5
0.836,1e-05,549,555,2,50,0.01,1104,5
0.916,1e-05,594,610,2,50,0.01,1204,5
0.896,1e-05,640,664,2,50,0.01,1304,5
0.922,1e-05,686,718,2,50,0.01,1404,5
0.934,1e-05,737,767,2,50,0.01,1504,5
0.926,1e-05,791,813,2,50,0.01,1604,5
0.926,1e-05,845,859,2,50,0.01,1704,5
0.938,1e-05,898,906,2,50,0.01,1804,5
0.948,1e-05,948,956,2,50,0.01,1904,5
0.95,1e-05,1002,1002,2,50,0.01,2004,5
0.566,1e-05,53,51,2,50,0.01,104,6
0.506,1e-05,102,102,2,50,0.01,204,6
0.48,1e-05,149,155,2,50,0.01,304,6
0.554,1e-05,204,200,2,50,0.01,404,6
0.632,1e-05,249,255,2,50,0.01,504,6
0.694,1e-05,311,293,2,50,0.01,604,6
0.746,1e-05,368,336,2,50,0.01,704,6
0.756,1e-05,411,393,2,50,0.01,804,6
0.758,1e-05,459,445,2,50,0.01,904,6
0.81,1e-05,519,485,2,50,0.01,1004,6
0.82,1e-05,557,547,2,50,0.01,1104,6
0.846,1e-05,601,603,2,50,0.01,1204,6
0.874,1e-05,654,650,2,50,0.01,1304,6
0.896,1e-05,698,706,2,50,0.01,1404,6
0.924,1e-05,745,759,2,50,0.01,1504,6
0.904,1e-05,799,805,2,50,0.01,1604,6
0.906,1e-05,847,857,2,50,0.01,1704,6
0.912,1e-05,898,906,2,50,0.01,1804,6
0.916,1e-05,947,957,2,50,0.01,1904,6
0.922,1e-05,999,1005,2,50,0.01,2004,6
0.456,1e-05,59,45,2,50,0.01,104,7
0.49,1e-05,106,98,2,50,0.01,204,7
0.534,1e-05,156,148,2,50,0.01,304,7
0.666,1e-05,197,207,2,50,0.01,404,7
0.746,1e-05,246,258,2,50,0.01,504,7
0.848,1e-05,288,316,2,50,0.01,604,7
0.746,1e-05,348,356,2,50,0.01,704,7
0.81,1e-05,393,411,2,50,0.01,804,7
0.846,1e-05,443,461,2,50,0.01,904,7
0.882,1e-05,493,511,2,50,0.01,1004,7
0.852,1e-05,546,558,2,50,0.01,1104,7
0.88,1e-05,598,606,2,50,0.01,1204,7
0.904,1e-05,648,656,2,50,0.01,1304,7
0.906,1e-05,692,712,2,50,0.01,1404,7
0.892,1e-05,748,756,2,50,0.01,1504,7
0.926,1e-05,797,807,2,50,0.01,1604,7
0.94,1e-05,842,862,2,50,0.01,1704,7
0.95,1e-05,893,911,2,50,0.01,1804,7
0.95,1e-05,942,962,2,50,0.01,1904,7
0.958,1e-05,990,1014,2,50,0.01,2004,7
0.544,1e-05,53,51,2,50,0.01,104,8
0.638,1e-05,107,97,2,50,0.01,204,8
0.662,1e-05,154,150,2,50,0.01,304,8
0.698,1e-05,197,207,2,50,0.01,404,8
0.704,1e-05,248,256,2,50,0.01,504,8
0.714,1e-05,300,304,2,50,0.01,604,8
0.726,1e-05,349,355,2,50,0.01,704,8
0.756,1e-05,395,409,2,50,0.01,804,8
0.796,1e-05,444,460,2,50,0.01,904,8
0.828,1e-05,491,513,2,50,0.01,1004,8
0.822,1e-05,547,557,2,50,0.01,1104,8
0.856,1e-05,593,611,2,50,0.01,1204,8
0.88,1e-05,640,664,2,50,0.01,1304,8
0.88,1e-05,686,718,2,50,0.01,1404,8
0.87,1e-05,739,765,2,50,0.01,1504,8
0.874,1e-05,793,811,2,50,0.01,1604,8
0.882,1e-05,844,860,2,50,0.01,1704,8
0.89,1e-05,894,910,2,50,0.01,1804,8
0.902,1e-05,946,958,2,50,0.01,1904,8
0.91,1e-05,988,1016,2,50,0.01,2004,8
0.542,1e-05,53,51,2,50,0.01,104,9
0.514,1e-05,104,100,2,50,0.01,204,9
0.504,1e-05,161,143,2,50,0.01,304,9
0.526,1e-05,212,192,2,50,0.01,404,9
0.564,1e-05,258,246,2,50,0.01,504,9
0.602,1e-05,308,296,2,50,0.01,604,9
0.606,1e-05,360,344,2,50,0.01,704,9
0.624,1e-05,406,398,2,50,0.01,804,9
0.616,1e-05,459,445,2,50,0.01,904,9
0.732,1e-05,505,499,2,50,0.01,1004,9
0.876,1e-05,560,544,2,50,0.01,1104,9
0.89,1e-05,605,599,2,50,0.01,1204,9
0.922,1e-05,655,649,2,50,0.01,1304,9
0.928,1e-05,700,704,2,50,0.01,1404,9
0.928,1e-05,751,753,2,50,0.01,1504,9
0.914,1e-05,798,806,2,50,0.01,1604,9
0.916,1e-05,851,853,2,50,0.01,1704,9
0.926,1e-05,903,901,2,50,0.01,1804,9
0.934,1e-05,952,952,2,50,0.01,1904,9
0.942,1e-05,1003,1001,2,50,0.01,2004,9
0.488,1e-05,57,47,2,50,0.01,104,10
0.526,1e-05,102,102,2,50,0.01,204,10
0.504,1e-05,154,150,2,50,0.01,304,10
0.572,1e-05,215,189,2,50,0.01,404,10
0.534,1e-05,258,246,2,50,0.01,504,10
0.546,1e-05,316,288,2,50,0.01,604,10
0.562,1e-05,376,328,2,50,0.01,704,10
0.622,1e-05,432,372,2,50,0.01,804,10
0.724,1e-05,480,424,2,50,0.01,904,10
0.784,1e-05,530,474,2,50,0.01,1004,10
0.818,1e-05,581,523,2,50,0.01,1104,10
0.838,1e-05,626,578,2,50,0.01,1204,10
0.862,1e-05,677,627,2,50,0.01,1304,10
0.874,1e-05,730,674,2,50,0.01,1404,10
0.866,1e-05,783,721,2,50,0.01,1504,10
0.898,1e-05,830,774,2,50,0.01,1604,10
0.896,1e-05,878,826,2,50,0.01,1704,10
0.912,1e-05,917,887,2,50,0.01,1804,10
0.914,1e-05,962,942,2,50,0.01,1904,10
0.916,1e-05,1007,997,2,50,0.01,2004,10
0.48,1e-05,52,52,2,50,0.01,104,11
0.568,1e-05,91,113,2,50,0.01,204,11
0.526,1e-05,139,165,2,50,0.01,304,11
0.528,1e-05,198,206,2,50,0.01,404,11
0.566,1e-05,235,269,2,50,0.01,504,11
0.592,1e-05,281,323,2,50,0.01,604,11
0.66,1e-05,328,376,2,50,0.01,704,11
0.762,1e-05,385,419,2,50,0.01,804,11
0.756,1e-05,442,462,2,50,0.01,904,11
0.834,1e-05,498,506,2,50,0.01,1004,11
0.858,1e-05,545,559,2,50,0.01,1104,11
0.856,1e-05,606,598,2,50,0.01,1204,11
0.866,1e-05,666,638,2,50,0.01,1304,11
0.878,1e-05,715,689,2,50,0.01,1404,11
0.906,1e-05,752,752,2,50,0.01,1504,11
0.894,1e-05,800,804,2,50,0.01,1604,11
0.902,1e-05,849,855,2,50,0.01,1704,11
0.924,1e-05,900,904,2,50,0.01,1804,11
0.924,1e-05,957,947,2,50,0.01,1904,11
0.938,1e-05,1011,993,2,50,0.01,2004,11
0.524,1e-05,47,57,2,50,0.01,104,12
0.554,1e-05,101,103,2,50,0.01,204,12
0.61,1e-05,147,157,2,50,0.01,304,12
0.628,1e-05,191,213,2,50,0.01,404,12
0.618,1e-05,237,267,2,50,0.01,504,12
0.628,1e-05,285,319,2,50,0.01,604,12
0.626,1e-05,340,364,2,50,0.01,704,12
0.67,1e-05,390,414,2,50,0.01,804,12
0.748,1e-05,440,464,2,50,0.01,904,12
0.734,1e-05,496,508,2,50,0.01,1004,12
0.746,1e-05,551,553,2,50,0.01,1104,12
0.76,1e-05,608,596,2,50,0.01,1204,12
0.776,1e-05,656,648,2,50,0.01,1304,12
0.79,1e-05,710,694,2,50,0.01,1404,12
0.822,1e-05,758,746,2,50,0.01,1504,12
0.832,1e-05,805,799,2,50,0.01,1604,12
0.848,1e-05,857,847,2,50,0.01,1704,12
0.86,1e-05,913,891,2,50,0.01,1804,12
0.886,1e-05,965,939,2,50,0.01,1904,12
0.88,1e-05,1009,995,2,50,0.01,2004,12
0.484,1e-05,56,48,2,50,0.01,104,13
0.54,1e-05,110,94,2,50,0.01,204,13
0.654,1e-05,155,149,2,50,0.01,304,13
0.596,1e-05,201,203,2,50,0.01,404,13
0.67,1e-05,246,258,2,50,0.01,504,13
0.742,1e-05,295,309,2,50,0.01,604,13
0.746,1e-05,346,358,2,50,0.01,704,13
0.79,1e-05,398,406,2,50,0.01,804,13
0.8,1e-05,446,458,2,50,0.01,904,13
0.804,1e-05,494,510,2,50,0.01,1004,13
0.83,1e-05,542,562,2,50,0.01,1104,13
0.818,1e-05,589,615,2,50,0.01,1204,13
0.824,1e-05,642,662,2,50,0.01,1304,13
0.846,1e-05,691,713,2,50,0.01,1404,13
0.862,1e-05,741,763,2,50,0.01,1504,13
0.864,1e-05,787,817,2,50,0.01,1604,13
0.866,1e-05,838,866,2,50,0.01,1704,13
0.898,1e-05,900,904,2,50,0.01,1804,13
0.908,1e-05,950,954,2,50,0.01,1904,13
0.912,1e-05,994,1010,2,50,0.01,2004,13
0.482,1e-05,48,56,2,50,0.01,104,14
0.586,1e-05,105,99,2,50,0.01,204,14
0.586,1e-05,162,142,2,50,0.01,304,14
0.594,1e-05,212,192,2,50,0.01,404,14
0.6,1e-05,258,246,2,50,0.01,504,14
0.69,1e-05,312,292,2,50,0.01,604,14
0.788,1e-05,363,341,2,50,0.01,704,14
0.76,1e-05,406,398,2,50,0.01,804,14
0.748,1e-05,460,444,2,50,0.01,904,14
0.858,1e-05,516,488,2,50,0.01,1004,14
0.884,1e-05,577,527,2,50,0.01,1104,14
0.886,1e-05,631,573,2,50,0.01,1204,14
0.9,1e-05,671,633,2,50,0.01,1304,14
0.888,1e-05,714,690,2,50,0.01,1404,14
0.886,1e-05,767,737,2,50,0.01,1504,14
0.888,1e-05,806,798,2,50,0.01,1604,14
0.898,1e-05,856,848,2,50,0.01,1704,14
0.894,1e-05,910,894,2,50,0.01,1804,14
0.896,1e-05,964,940,2,50,0.01,1904,14
0.898,1e-05,1019,985,2,50,0.01,2004,14
0.596,1e-05,52,52,2,50,0.01,104,15
0.566,1e-05,117,87,2,50,0.01,204,15
0.524,1e-05,174,130,2,50,0.01,304,15
0.5,1e-05,220,184,2,50,0.01,404,15
0.498,1e-05,270,234,2,50,0.01,504,15
0.556,1e-05,324,280,2,50,0.01,604,15
0.62,1e-05,374,330,2,50,0.01,704,15
0.72,1e-05,421,383,2,50,0.01,804,15
0.808,1e-05,471,433,2,50,0.01,904,15
0.824,1e-05,524,480,2,50,0.01,1004,15
0.874,1e-05,578,526,2,50,0.01,1104,15
0.862,1e-05,621,583,2,50,0.01,1204,15
0.878,1e-05,671,633,2,50,0.01,1304,15
0.888,1e-05,720,684,2,50,0.01,1404,15
0.892,1e-05,774,730,2,50,0.01,1504,15
0.902,1e-05,822,782,2,50,0.01,1604,15
0.918,1e-05,867,837,2,50,0.01,1704,15
0.934,1e-05,913,891,2,50,0.01,1804,15
0.944,1e-05,963,941,2,50,0.01,1904,15
0.934,1e-05,1009,995,2,50,0.01,2004,15
0.608,1e-05,49,55,2,50,0.01,104,16
0.628,1e-05,105,99,2,50,0.01,204,16
0.626,1e-05,155,149,2,50,0.01,304,16
0.658,1e-05,210,194,2,50,0.01,404,16
0.576,1e-05,263,241,2,50,0.01,504,16
0.56,1e-05,314,290,2,50,0.01,604,16
0.594,1e-05,368,336,2,50,0.01,704,16
0.672,1e-05,416,388,2,50,0.01,804,16
0.732,1e-05,467,437,2,50,0.01,904,16
0.772,1e-05,513,491,2,50,0.01,1004,16
0.796,1e-05,561,543,2,50,0.01,1104,16
0.812,1e-05,613,591,2,50,0.01,1204,16
0.838,1e-05,660,644,2,50,0.01,1304,16
0.888,1e-05,705,699,2,50,0.01,1404,16
0.896,1e-05,762,742,2,50,0.01,1504,16
0.92,1e-05,817,787,2,50,0.01,1604,16
0.936,1e-05,871,833,2,50,0.01,1704,16
0.942,1e-05,920,884,2,50,0.01,1804,16
0.946,1e-05,963,941,2,50,0.01,1904,16
0.948,1e-05,1011,993,2,50,0.01,2004,16
0.438,1e-05,41,63,2,50,0.01,104,17
0.542,1e-05,101,103,2,50,0.01,204,17
0.59,1e-05,155,149,2,50,0.01,304,17
0.68,1e-05,197,207,2,50,0.01,404,17
0.686,1e-05,244,260,2,50,0.01,504,17
0.654,1e-05,299,305,2,50,0.01,604,17
0.654,1e-05,355,349,2,50,0.01,704,17
0.66,1e-05,409,395,2,50,0.01,804,17
0.684,1e-05,465,439,2,50,0.01,904,17
0.716,1e-05,515,489,2,50,0.01,1004,17
0.698,1e-05,560,544,2,50,0.01,1104,17
0.738,1e-05,600,604,2,50,0.01,1204,17
0.762,1e-05,643,661,2,50,0.01,1304,17
0.782,1e-05,689,715,2,50,0.01,1404,17
0.818,1e-05,753,751,2,50,0.01,1504,17
0.836,1e-05,802,802,2,50,0.01,1604,17
0.846,1e-05,841,863,2,50,0.01,1704,17
0.844,1e-05,896,908,2,50,0.01,1804,17
0.85,1e-05,944,960,2,50,0.01,1904,17
0.872,1e-05,988,1016,2,50,0.01,2004,17
0.506,1e-05,53,51,2,50,0.01,104,18
0.568,1e-05,93,111,2,50,0.01,204,18
0.612,1e-05,148,156,2,50,0.01,304,18
0.67,1e-05,194,210,2,50,0.01,404,18
0.694,1e-05,240,264,2,50,0.01,504,18
0.714,1e-05,294,310,2,50,0.01,604,18
0.77,1e-05,339,365,2,50,0.01,704,18
0.8,1e-05,390,414,2,50,0.01,804,18
0.822,1e-05,441,463,2,50,0.01,904,18
0.858,1e-05,489,515,2,50,0.01,1004,18
0.838,1e-05,530,574,2,50,0.01,1104,18
0.846,1e-05,581,623,2,50,0.01,1204,18
0.86,1e-05,626,678,2,50,0.01,1304,18
0.878,1e-05,678,726,2,50,0.01,1404,18
0.888,1e-05,733,771,2,50,0.01,1504,18
0.89,1e-05,785,819,2,50,0.01,1604,18
0.892,1e-05,836,868,2,50,0.01,1704,18
0.908,1e-05,886,918,2,50,0.01,1804,18
0.91,1e-05,938,966,2,50,0.01,1904,18
0.91,1e-05,991,1013,2,50,0.01,2004,18
0.542,1e-05,55,49,2,50,0.01,104,19
0.566,1e-05,106,98,2,50,0.01,204,19
0.6,1e-05,162,142,2,50,0.01,304,19
0.628,1e-05,209,195,2,50,0.01,404,19
0.648,1e-05,264,240,2,50,0.01,504,19
0.688,1e-05,301,303,2,50,0.01,604,19
0.738,1e-05,350,354,2,50,0.01,704,19
0.794,1e-05,408,396,2,50,0.01,804,19
0.86,1e-05,453,451,2,50,0.01,904,19
0.89,1e-05,504,500,2,50,0.01,1004,19
0.904,1e-05,555,549,2,50,0.01,1104,19
0.922,1e-05,605,599,2,50,0.01,1204,19
0.926,1e-05,652,652,2,50,0.01,1304,19
0.928,1e-05,701,703,2,50,0.01,1404,19
0.918,1e-05,749,755,2,50,0.01,1504,19
0.92,1e-05,797,807,2,50,0.01,1604,19
0.928,1e-05,851,853,2,50,0.01,1704,19
0.934,1e-05,896,908,2,50,0.01,1804,19
0.934,1e-05,947,957,2,50,0.01,1904,19
0.936,1e-05,1003,1001,2,50,0.01,2004,19
0.426,1e-05,54,50,2,50,0.01,104,20
0.584,1e-05,101,103,2,50,0.01,204,20
0.676,1e-05,152,152,2,50,0.01,304,20
0.766,1e-05,202,202,2,50,0.01,404,20
0.782,1e-05,247,257,2,50,0.01,504,20
0.808,1e-05,296,308,2,50,0.01,604,20
0.828,1e-05,343,361,2,50,0.01,704,20
0.836,1e-05,401,403,2,50,0.01,804,20
0.852,1e-05,446,458,2,50,0.01,904,20
0.866,1e-05,492,512,2,50,0.01,1004,20
0.884,1e-05,538,566,2,50,0.01,1104,20
0.888,1e-05,590,614,2,50,0.01,1204,20
0.892,1e-05,639,665,2,50,0.01,1304,20
0.904,1e-05,692,712,2,50,0.01,1404,20
0.926,1e-05,742,762,2,50,0.01,1504,20
0.914,1e-05,795,809,2,50,0.01,1604,20
0.92,1e-05,855,849,2,50,0.01,1704,20
0.94,1e-05,905,899,2,50,0.01,1804,20
0.944,1e-05,954,950,2,50,0.01,1904,20
0.952,1e-05,1002,1002,2,50,0.01,2004,20
0.622,0.0001,48,56,2,50,0.0001,104,1
0.622,0.0001,98,106,2,50,0.0001,204,1
0.622,0.0001,149,155,2,50,0.0001,304,1
0.622,0.0001,205,199,2,50,0.0001,404,1
0.622,0.0001,253,251,2,50,0.0001,504,1
0.622,0.0001,296,308,2,50,0.0001,604,1
0.622,0.0001,348,356,2,50,0.0001,704,1
0.622,0.0001,402,402,2,50,0.0001,804,1
0.62,0.0001,447,457,2,50,0.0001,904,1
0.62,0.0001,506,498,2,50,0.0001,1004,1
0.62,0.0001,557,547,2,50,0.0001,1104,1
0.62,0.0001,607,597,2,50,0.0001,1204,1
0.624,0.0001,658,646,2,50,0.0001,1304,1
0.624,0.0001,710,694,2,50,0.0001,1404,1
0.622,0.0001,767,737,2,50,0.0001,1504,1
0.624,0.0001,821,783,2,50,0.0001,1604,1
0.626,0.0001,873,831,2,50,0.0001,1704,1
0.628,0.0001,919,885,2,50,0.0001,1804,1
0.63,0.0001,962,942,2,50,0.0001,1904,1
0.634,0.0001,1009,995,2,50,0.0001,2004,1
0.502,0.0001,61,43,2,50,0.0001,104,2
0.502,0.0001,107,97,2,50,0.0001,204,2
0.502,0.0001,162,142,2,50,0.0001,304,2
0.502,0.0001,198,206,2,50,0.0001,404,2
0.502,0.0001,239,265,2,50,0.0001,504,2
0.502,0.0001,294,310,2,50,0.0001,604,2
0.502,0.0001,347,357,2,50,0.0001,704,2
0.502,0.0001,402,402,2,50,0.0001,804,2
0.502,0.0001,455,449,2,50,0.0001,904,2
0.502,0.0001,505,499,2,50,0.0001,1004,2
0.502,0.0001,544,560,2,50,0.0001,1104,2
0.502,0.0001,598,606,2,50,0.0001,1204,2
0.502,0.0001,643,661,2,50,0.0001,1304,2
0.502,0.0001,684,720,2,50,0.0001,1404,2
0.502,0.0001,745,759,2,50,0.0001,1504,2
0.502,0.0001,795,809,2,50,0.0001,1604,2
0.502,0.0001,841,863,2,50,0.0001,1704,2
0.504,0.0001,892,912,2,50,0.0001,1804,2
0.504,0.0001,946,958,2,50,0.0001,1904,2
0.504,0.0001,998,1006,2,50,0.0001,2004,2
0.538,0.0001,55,49,2,50,0.0001,104,3
0.538,0.0001,107,97,2,50,0.0001,204,3
0.54,0.0001,154,150,2,50,0.0001,304,3
0.538,0.0001,202,202,2,50,0.0001,404,3
0.54,0.0001,253,251,2,50,0.0001,504,3
0.54,0.0001,298,306,2,50,0.0001,604,3
0.542,0.0001,351,353,2,50,0.0001,704,3
0.542,0.0001,398,406,2,50,0.0001,804,3
0.542,0.0001,450,454,2,50,0.0001,904,3
0.54,0.0001,500,504,2,50,0.0001,1004,3
0.538,0.0001,541,563,2,50,0.0001,1104,3
0.54,0.0001,595,609,2,50,0.0001,1204,3
0.542,0.0001,645,659,2,50,0.0001,1304,3
0.544,0.0001,702,702,2,50,0.0001,1404,3
0.544,0.0001,756,748,2,50,0.0001,1504,3
0.548,0.0001,806,798,2,50,0.0001,1604,3
0.55,0.0001,849,855,2,50,0.0001,1704,3
0.548,0.0001,899,905,2,50,0.0001,1804,3
0.566,0.0001,946,958,2,50,0.0001,1904,3
0.578,0.0001,1001,1003,2,50,0.0001,2004,3
0.518,0.0001,53,51,2,50,0.0001,104,4
0.518,0.0001,107,97,2,50,0.0001,204,4
0.522,0.0001,155,149,2,50,0.0001,304,4
0.522,0.0001,214,190,2,50,0.0001,404,4
0.524,0.0001,264,240,2,50,0.0001,504,4
0.526,0.0001,306,298,2,50,0.0001,604,4
0.532,0.0001,358,346,2,50,0.0001,704,4
0.536,0.0001,417,387,2,50,0.0001,804,4
0.54,0.0001,477,427,2,50,0.0001,904,4
0.542,0.0001,519,485,2,50,0.0001,1004,4
0.548,0.0001,565,539,2,50,0.0001,1104,4
0.548,0.0001,614,590,2,50,0.0001,1204,4
0.55,0.0001,664,640,2,50,0.0001,1304,4
0.552,0.0001,710,694,2,50,0.0001,1404,4
0.556,0.0001,761,743,2,50,0.0001,1504,4
0.558,0.0001,807,797,2,50,0.0001,1604,4
0.564,0.0001,856,848,2,50,0.0001,1704,4
0.57,0.0001,906,898,2,50,0.0001,1804,4
0.574,0.0001,958,946,2,50,0.0001,1904,4
0.586,0.0001,1006,998,2,50,0.0001,2004,4
0.506,0.0001,49,55,2,50,0.0001,104,5
0.508,0.0001,97,107,2,50,0.0001,204,5
0.51,0.0001,152,152,2,50,0.0001,304,5
0.51,0.0001,198,206,2,50,0.0001,404,5
0.51,0.0001,248,256,2,50,0.0001,504,5
0.51,0.0001,296,308,2,50,0.0001,604,5
0.51,0.0001,346,358,2,50,0.0001,704,5
0.51,0.0001,397,407,2,50,0.0001,804,5
0.51,0.0001,447,457,2,50,0.0001,904,5
0.51,0.0001,496,508,2,50,0.0001,1004,5
0.51,0.0001,555,549,2,50,0.0001,1104,5
0.51,0.0001,598,606,2,50,0.0001,1204,5
0.51,0.0001,649,655,2,50,0.0001,1304,5
0.512,0.0001,699,705,2,50,0.0001,1404,5
0.512,0.0001,753,751,2,50,0.0001,1504,5
0.512,0.0001,806,798,2,50,0.0001,1604,5
0.512,0.0001,850,854,2,50,0.0001,1704,5
0.514,0.0001,909,895,2,50,0.0001,1804,5
0.514,0.0001,959,945,2,50,0.0001,1904,5
0.514,0.0001,1008,996,2,50,0.0001,2004,5
0.514,0.0001,52,52,2,50,0.0001,104,6
0.514,0.0001,98,106,2,50,0.0001,204,6
0.514,0.0001,154,150,2,50,0.0001,304,6
0.514,0.0001,202,202,2,50,0.0001,404,6
0.514,0.0001,253,251,2,50,0.0001,504,6
0.514,0.0001,311,293,2,50,0.0001,604,6
0.514,0.0001,366,338,2,50,0.0001,704,6
0.514,0.0001,410,394,2,50,0.0001,804,6
0.514,0.0001,448,456,2,50,0.0001,904,6
0.514,0.0001,495,509,2,50,0.0001,1004,6
0.514,0.0001,542,562,2,50,0.0001,1104,6
0.514,0.0001,586,618,2,50,0.0001,1204,6
0.514,0.0001,636,668,2,50,0.0001,1304,6
0.514,0.0001,682,722,2,50,0.0001,1404,6
0.514,0.0001,735,769,2,50,0.0001,1504,6
0.514,0.0001,785,819,2,50,0.0001,1604,6
0.514,0.0001,836,868,2,50,0.0001,1704,6
0.514,0.0001,894,910,2,50,0.0001,1804,6
0.514,0.0001,943,961,2,50,0.0001,1904,6
0.514,0.0001,995,1009,2,50,0.0001,2004,6
0.438,0.0001,44,60,2,50,0.0001,104,7
0.438,0.0001,97,107,2,50,0.0001,204,7
0.438,0.0001,143,161,2,50,0.0001,304,7
0.438,0.0001,184,220,2,50,0.0001,404,7
0.438,0.0001,233,271,2,50,0.0001,504,7
0.438,0.0001,282,322,2,50,0.0001,604,7
0.438,0.0001,330,374,2,50,0.0001,704,7
0.438,0.0001,390,414,2,50,0.0001,804,7
0.438,0.0001,441,463,2,50,0.0001,904,7
0.44,0.0001,484,520,2,50,0.0001,1004,7
0.44,0.0001,539,565,2,50,0.0001,1104,7
0.44,0.0001,588,616,2,50,0.0001,1204,7
0.44,0.0001,640,664,2,50,0.0001,1304,7
0.442,0.0001,685,719,2,50,0.0001,1404,7
0.444,0.0001,740,764,2,50,0.0001,1504,7
0.444,0.0001,799,805,2,50,0.0001,1604,7
0.446,0.0001,845,859,2,50,0.0001,1704,7
0.448,0.0001,887,917,2,50,0.0001,1804,7
0.45,0.0001,931,973,2,50,0.0001,1904,7
0.454,0.0001,985,1019,2,50,0.0001,2004,7
0.488,0.0001,50,54,2,50,0.0001,104,8
0.488,0.0001,99,105,2,50,0.0001,204,8
0.488,0.0001,156,148,2,50,0.0001,304,8
0.488,0.0001,200,204,2,50,0.0001,404,8
0.488,0.0001,256,248,2,50,0.0001,504,8
0.488,0.0001,305,299,2,50,0.0001,604,8
0.488,0.0001,354,350,2,50,0.0001,704,8
0.488,0.0001,408,396,2,50,0.0001,804,8
0.488,0.0001,452,452,2,50,0.0001,904,8
0.488,0.0001,500,504,2,50,0.0001,1004,8
0.488,0.0001,551,553,2,50,0.0001,1104,8
0.488,0.0001,600,604,2,50,0.0001,1204,8
0.486,0.0001,652,652,2,50,0.0001,1304,8
0.486,0.0001,710,694,2,50,0.0001,1404,8
0.492,0.0001,759,745,2,50,0.0001,1504,8
0.492,0.0001,808,796,2,50,0.0001,1604,8
0.49,0.0001,857,847,2,50,0.0001,1704,8
0.496,0.0001,904,900,2,50,0.0001,1804,8
0.496,0.0001,953,951,2,50,0.0001,1904,8
0.5,0.0001,1008,996,2,50,0.0001,2004,8
0.496,0.0001,44,60,2,50,0.0001,104,9
0.496,0.0001,93,111,2,50,0.0001,204,9
0.496,0.0001,145,159,2,50,0.0001,304,9
0.494,0.0001,193,211,2,50,0.0001,404,9
0.494,0.0001,242,262,2,50,0.0001,504,9
0.494,0.0001,282,322,2,50,0.0001,604,9
0.492,0.0001,336,368,2,50,0.0001,704,9
0.492,0.0001,388,416,2,50,0.0001,804,9
0.492,0.0001,432,472,2,50,0.0001,904,9
0.492,0.0001,475,529,2,50,0.0001,1004,9
0.492,0.0001,527,577,2,50,0.0001,1104,9
0.492,0.0001,573,631,2,50,0.0001,1204,9
0.492,0.0001,621,683,2,50,0.0001,1304,9
0.49,0.0001,681,723,2,50,0.0001,1404,9
0.49,0.0001,737,767,2,50,0.0001,1504,9
0.49,0.0001,780,824,2,50,0.0001,1604,9
0.486,0.0001,827,877,2,50,0.0001,1704,9
0.486,0.0001,887,917,2,50,0.0001,1804,9
0.484,0.0001,945,959,2,50,0.0001,1904,9
0.486,0.0001,998,1006,2,50,0.0001,2004,9
0.488,0.0001,59,45,2,50,0.0001,104,10
0.488,0.0001,112,92,2,50,0.0001,204,10
0.482,0.0001,162,142,2,50,0.0001,304,10
0.482,0.0001,210,194,2,50,0.0001,404,10
0.482,0.0001,257,247,2,50,0.0001,504,10
0.48,0.0001,304,300,2,50,0.0001,604,10
0.48,0.0001,354,350,2,50,0.0001,704,10
0.48,0.0001,405,399,2,50,0.0001,804,10
0.482,0.0001,460,444,2,50,0.0001,904,10
0.482,0.0001,507,497,2,50,0.0001,1004,10
0.486,0.0001,556,548,2,50,0.0001,1104,10
0.488,0.0001,603,601,2,50,0.0001,1204,10
0.488,0.0001,657,647,2,50,0.0001,1304,10
0.488,0.0001,713,691,2,50,0.0001,1404,10
0.49,0.0001,761,743,2,50,0.0001,1504,10
0.494,0.0001,815,789,2,50,0.0001,1604,10
0.496,0.0001,858,846,2,50,0.0001,1704,10
0.504,0.0001,912,892,2,50,0.0001,1804,10
0.506,0.0001,959,945,2,50,0.0001,1904,10
0.506,0.0001,1009,995,2,50,0.0001,2004,10
0.43,0.0001,56,48,2,50,0.0001,104,11
0.43,0.0001,108,96,2,50,0.0001,204,11
0.43,0.0001,161,143,2,50,0.0001,304,11
0.428,0.0001,215,189,2,50,0.0001,404,11
0.428,0.0001,268,236,2,50,0.0001,504,11
0.434,0.0001,314,290,2,50,0.0001,604,11
0.436,0.0001,362,342,2,50,0.0001,704,11
0.436,0.0001,408,396,2,50,0.0001,804,11
0.436,0.0001,465,439,2,50,0.0001,904,11
0.438,0.0001,520,484,2,50,0.0001,1004,11
0.438,0.0001,571,533,2,50,0.0001,1104,11
0.438,0.0001,619,585,2,50,0.0001,1204,11
0.436,0.0001,672,632,2,50,0.0001,1304,11
0.43,0.0001,721,683,2,50,0.0001,1404,11
0.43,0.0001,768,736,2,50,0.0001,1504,11
0.426,0.0001,817,787,2,50,0.0001,1604,11
0.422,0.0001,873,831,2,50,0.0001,1704,11
0.42,0.0001,909,895,2,50,0.0001,1804,11
0.42,0.0001,950,954,2,50,0.0001,1904,11
0.418,0.0001,1000,1004,2,50,0.0001,2004,11
0.526,0.0001,41,63,2,50,0.0001,104,12
0.526,0.0001,83,121,2,50,0.0001,204,12
0.526,0.0001,135,169,2,50,0.0001,304,12
0.526,0.0001,187,217,2,50,0.0001,404,12
0.526,0.0001,243,261,2,50,0.0001,504,12
0.526,0.0001,298,306,2,50,0.0001,604,12
0.526,0.0001,349,355,2,50,0.0001,704,12
0.526,0.0001,400,404,2,50,0.0001,804,12
0.526,0.0001,449,455,2,50,0.0001,904,12
0.526,0.0001,505,499,2,50,0.0001,1004,12
0.526,0.0001,558,546,2,50,0.0001,1104,12
0.526,0.0001,603,601,2,50,0.0001,1204,12
0.526,0.0001,653,651,2,50,0.0001,1304,12
0.526,0.0001,702,702,2,50,0.0001,1404,12
0.526,0.0001,756,748,2,50,0.0001,1504,12
0.526,0.0001,813,791,2,50,0.0001,1604,12
0.526,0.0001,867,837,2,50,0.0001,1704,12
0.526,0.0001,910,894,2,50,0.0001,1804,12
0.526,0.0001,967,937,2,50,0.0001,1904,12
0.526,0.0001,1015,989,2,50,0.0001,2004,12
0.494,0.0001,47,57,2,50,0.0001,104,13
0.494,0.0001,90,114,2,50,0.0001,204,13
0.494,0.0001,145,159,2,50,0.0001,304,13
0.494,0.0001,200,204,2,50,0.0001,404,13
0.494,0.0001,247,257,2,50,0.0001,504,13
0.494,0.0001,297,307,2,50,0.0001,604,13
0.494,0.0001,353,351,2,50,0.0001,704,13
0.494,0.0001,407,397,2,50,0.0001,804,13
0.494,0.0001,462,442,2,50,0.0001,904,13
0.494,0.0001,519,485,2,50,0.0001,1004,13
0.494,0.0001,572,532,2,50,0.0001,1104,13
0.496,0.0001,622,582,2,50,0.0001,1204,13
0.496,0.0001,668,636,2,50,0.0001,1304,13
0.496,0.0001,721,683,2,50,0.0001,1404,13
0.496,0.0001,762,742,2,50,0.0001,1504,13
0.5,0.0001,804,800,2,50,0.0001,1604,13
0.5,0.0001,851,853,2,50,0.0001,1704,13
0.504,0.0001,903,901,2,50,0.0001,1804,13
0.514,0.0001,946,958,2,50,0.0001,1904,13
0.516,0.0001,999,1005,2,50,0.0001,2004,13
0.56,0.0001,52,52,2,50,0.0001,104,14
0.56,0.0001,106,98,2,50,0.0001,204,14
0.56,0.0001,163,141,2,50,0.0001,304,14
0.562,0.0001,217,187,2,50,0.0001,404,14
0.562,0.0001,266,238,2,50,0.0001,504,14
0.562,0.0001,320,284,2,50,0.0001,604,14
0.562,0.0001,370,334,2,50,0.0001,704,14
0.562,0.0001,412,392,2,50,0.0001,804,14
0.564,0.0001,461,443,2,50,0.0001,904,14
0.564,0.0001,514,490,2,50,0.0001,1004,14
0.566,0.0001,568,536,2,50,0.0001,1104,14
0.572,0.0001,618,586,2,50,0.0001,1204,14
0.576,0.0001,671,633,2,50,0.0001,1304,14
0.578,0.0001,717,687,2,50,0.0001,1404,14
0.582,0.0001,760,744,2,50,0.0001,1504,14
0.592,0.0001,810,794,2,50,0.0001,1604,14
0.6,0.0001,863,841,2,50,0.0001,1704,14
0.608,0.0001,916,888,2,50,0.0001,1804,14
0.618,0.0001,965,939,2,50,0.0001,1904,14
0.626,0.0001,1009,995,2,50,0.0001,2004,14
0.474,0.0001,54,50,2,50,0.0001,104,15
0.474,0.0001,103,101,2,50,0.0001,204,15
0.474,0.0001,143,161,2,50,0.0001,304,15
0.482,0.0001,191,213,2,50,0.0001,404,15
0.48,0.0001,242,262,2,50,0.0001,504,15
0.484,0.0001,292,312,2,50,0.0001,604,15
0.484,0.0001,345,359,2,50,0.0001,704,15
0.486,0.0001,397,407,2,50,0.0001,804,15
0.486,0.0001,445,459,2,50,0.0001,904,15
0.486,0.0001,499,505,2,50,0.0001,1004,15
0.484,0.0001,545,559,2,50,0.0001,1104,15
0.482,0.0001,586,618,2,50,0.0001,1204,15
0.484,0.0001,640,664,2,50,0.0001,1304,15
0.488,0.0001,689,715,2,50,0.0001,1404,15
0.492,0.0001,731,773,2,50,0.0001,1504,15
0.492,0.0001,782,822,2,50,0.0001,1604,15
0.494,0.0001,837,867,2,50,0.0001,1704,15
0.498,0.0001,888,916,2,50,0.0001,1804,15
0.508,0.0001,946,958,2,50,0.0001,1904,15
0.508,0.0001,992,1012,2,50,0.0001,2004,15
0.552,0.0001,47,57,2,50,0.0001,104,16
0.552,0.0001,89,115,2,50,0.0001,204,16
0.552,0.0001,145,159,2,50,0.0001,304,16
0.552,0.0001,195,209,2,50,0.0001,404,16
0.552,0.0001,254,250,2,50,0.0001,504,16
0.552,0.0001,303,301,2,50,0.0001,604,16
0.552,0.0001,353,351,2,50,0.0001,704,16
0.556,0.0001,401,403,2,50,0.0001,804,16
0.556,0.0001,450,454,2,50,0.0001,904,16
0.556,0.0001,499,505,2,50,0.0001,1004,16
0.556,0.0001,547,557,2,50,0.0001,1104,16
0.556,0.0001,597,607,2,50,0.0001,1204,16
0.554,0.0001,650,654,2,50,0.0001,1304,16
0.556,0.0001,702,702,2,50,0.0001,1404,16
0.558,0.0001,744,760,2,50,0.0001,1504,16
0.556,0.0001,802,802,2,50,0.0001,1604,16
0.562,0.0001,852,852,2,50,0.0001,1704,16
0.568,0.0001,901,903,2,50,0.0001,1804,16
0.56,0.0001,961,943,2,50,0.0001,1904,16
0.564,0.0001,1004,1000,2,50,0.0001,2004,16
0.522,0.0001,48,56,2,50,0.0001,104,17
0.526,0.0001,96,108,2,50,0.0001,204,17
0.526,0.0001,140,164,2,50,0.0001,304,17
0.53,0.0001,192,212,2,50,0.0001,404,17
0.53,0.0001,238,266,2,50,0.0001,504,17
0.528,0.0001,292,312,2,50,0.0001,604,17
0.528,0.0001,348,356,2,50,0.0001,704,17
0.534,0.0001,397,407,2,50,0.0001,804,17
0.542,0.0001,450,454,2,50,0.0001,904,17
0.55,0.0001,506,498,2,50,0.0001,1004,17
0.552,0.0001,555,549,2,50,0.0001,1104,17
0.558,0.0001,615,589,2,50,0.0001,1204,17
0.566,0.0001,665,639,2,50,0.0001,1304,17
0.568,0.0001,718,686,2,50,0.0001,1404,17
0.57,0.0001,761,743,2,50,0.0001,1504,17
0.566,0.0001,812,792,2,50,0.0001,1604,17
0.572,0.0001,862,842,2,50,0.0001,1704,17
0.574,0.0001,913,891,2,50,0.0001,1804,17
0.582,0.0001,961,943,2,50,0.0001,1904,17
0.582,0.0001,1010,994,2,50,0.0001,2004,17
0.51,0.0001,46,58,2,50,0.0001,104,18
0.51,0.0001,96,108,2,50,0.0001,204,18
0.51,0.0001,139,165,2,50,0.0001,304,18
0.51,0.0001,187,217,2,50,0.0001,404,18
0.51,0.0001,244,260,2,50,0.0001,504,18
0.51,0.0001,295,309,2,50,0.0001,604,18
0.51,0.0001,351,353,2,50,0.0001,704,18
0.51,0.0001,404,400,2,50,0.0001,804,18
0.51,0.0001,451,453,2,50,0.0001,904,18
0.51,0.0001,503,501,2,50,0.0001,1004,18
0.51,0.0001,554,550,2,50,0.0001,1104,18
0.51,0.0001,601,603,2,50,0.0001,1204,18
0.51,0.0001,647,657,2,50,0.0001,1304,18
0.51,0.0001,699,705,2,50,0.0001,1404,18
0.51,0.0001,747,757,2,50,0.0001,1504,18
0.51,0.0001,799,805,2,50,0.0001,1604,18
0.51,0.0001,856,848,2,50,0.0001,1704,18
0.51,0.0001,907,897,2,50,0.0001,1804,18
0.51,0.0001,960,944,2,50,0.0001,1904,18
0.51,0.0001,1007,997,2,50,0.0001,2004,18
0.406,0.0001,51,53,2,50,0.0001,104,19
0.406,0.0001,99,105,2,50,0.0001,204,19
0.406,0.0001,143,161,2,50,0.0001,304,19
0.41,0.0001,195,209,2,50,0.0001,404,19
0.408,0.0001,248,256,2,50,0.0001,504,19
0.406,0.0001,299,305,2,50,0.0001,604,19
0.402,0.0001,345,359,2,50,0.0001,704,19
0.398,0.0001,394,410,2,50,0.0001,804,19
0.392,0.0001,441,463,2,50,0.0001,904,19
0.392,0.0001,495,509,2,50,0.0001,1004,19
0.392,0.0001,548,556,2,50,0.0001,1104,19
0.396,0.0001,610,594,2,50,0.0001,1204,19
0.396,0.0001,659,645,2,50,0.0001,1304,19
0.402,0.0001,712,692,2,50,0.0001,1404,19
0.404,0.0001,759,745,2,50,0.0001,1504,19
0.408,0.0001,809,795,2,50,0.0001,1604,19
0.416,0.0001,860,844,2,50,0.0001,1704,19
0.422,0.0001,911,893,2,50,0.0001,1804,19
0.422,0.0001,959,945,2,50,0.0001,1904,19
0.438,0.0001,1012,992,2,50,0.0001,2004,19
0.546,0.0001,51,53,2,50,0.0001,104,20
0.546,0.0001,100,104,2,50,0.0001,204,20
0.544,0.0001,142,162,2,50,0.0001,304,20
0.544,0.0001,191,213,2,50,0.0001,404,20
0.546,0.0001,235,269,2,50,0.0001,504,20
0.55,0.0001,285,319,2,50,0.0001,604,20
0.554,0.0001,338,366,2,50,0.0001,704,20
0.554,0.0001,381,423,2,50,0.0001,804,20
0.554,0.0001,429,475,2,50,0.0001,904,20
0.554,0.0001,476,528,2,50,0.0001,1004,20
0.56,0.0001,539,565,2,50,0.0001,1104,20
0.56,0.0001,595,609,2,50,0.0001,1204,20
0.56,0.0001,636,668,2,50,0.0001,1304,20
0.562,0.0001,688,716,2,50,0.0001,1404,20
0.568,0.0001,734,770,2,50,0.0001,1504,20
0.57,0.0001,795,809,2,50,0.0001,1604,20
0.57,0.0001,842,862,2,50,0.0001,1704,20
0.57,0.0001,882,922,2,50,0.0001,1804,20
0.576,0.0001,934,970,2,50,0.0001,1904,20
0.582,0.0001,983,1021,2,50,0.0001,2004,20
0.482,0.0001,54,50,2,50,0.001,104,1
0.482,0.0001,105,99,2,50,0.001,204,1
0.48,0.0001,155,149,2,50,0.001,304,1
0.478,0.0001,201,203,2,50,0.001,404,1
0.482,0.0001,255,249,2,50,0.001,504,1
0.488,0.0001,302,302,2,50,0.001,604,1
0.49,0.0001,355,349,2,50,0.001,704,1
0.492,0.0001,401,403,2,50,0.001,804,1
0.498,0.0001,455,449,2,50,0.001,904,1
0.5,0.0001,501,503,2,50,0.001,1004,1
0.522,0.0001,553,551,2,50,0.001,1104,1
0.548,0.0001,601,603,2,50,0.001,1204,1
0.568,0.0001,648,656,2,50,0.001,1304,1
0.576,0.0001,697,707,2,50,0.001,1404,1
0.604,0.0001,756,748,2,50,0.001,1504,1
0.63,0.0001,805,799,2,50,0.001,1604,1
0.66,0.0001,859,845,2,50,0.001,1704,1
0.686,0.0001,909,895,2,50,0.001,1804,1
0.736,0.0001,955,949,2,50,0.001,1904,1
0.764,0.0001,1005,999,2,50,0.001,2004,1
0.632,0.0001,56,48,2,50,0.001,104,2
0.63,0.0001,102,102,2,50,0.001,204,2
0.626,0.0001,157,147,2,50,0.001,304,2
0.63,0.0001,204,200,2,50,0.001,404,2
0.63,0.0001,249,255,2,50,0.001,504,2
0.644,0.0001,296,308,2,50,0.001,604,2
0.658,0.0001,348,356,2,50,0.001,704,2
0.658,0.0001,400,404,2,50,0.001,804,2
0.662,0.0001,466,438,2,50,0.001,904,2
0.668,0.0001,510,494,2,50,0.001,1004,2
0.676,0.0001,553,551,2,50,0.001,1104,2
0.686,0.0001,609,595,2,50,0.001,1204,2
0.688,0.0001,661,643,2,50,0.001,1304,2
0.698,0.0001,705,699,2,50,0.001,1404,2
0.704,0.0001,750,754,2,50,0.001,1504,2
0.712,0.0001,796,808,2,50,0.001,1604,2
0.714,0.0001,842,862,2,50,0.001,1704,2
0.718,0.0001,891,913,2,50,0.001,1804,2
0.724,0.0001,938,966,2,50,0.001,1904,2
0.732,0.0001,998,1006,2,50,0.001,2004,2
0.564,0.0001,52,52,2,50,0.001,104,3
0.57,0.0001,100,104,2,50,0.001,204,3
0.57,0.0001,149,155,2,50,0.001,304,3
0.572,0.0001,203,201,2,50,0.001,404,3
0.572,0.0001,250,254,2,50,0.001,504,3
0.572,0.0001,302,302,2,50,0.001,604,3
0.574,0.0001,355,349,2,50,0.001,704,3
0.562,0.0001,411,393,2,50,0.001,804,3
0.554,0.0001,468,436,2,50,0.001,904,3
0.552,0.0001,510,494,2,50,0.001,1004,3
0.556,0.0001,560,544,2,50,0.001,1104,3
0.55,0.0001,610,594,2,50,0.001,1204,3
0.546,0.0001,660,644,2,50,0.001,1304,3
0.546,0.0001,702,702,2,50,0.001,1404,3
0.544,0.0001,744,760,2,50,0.001,1504,3
0.548,0.0001,797,807,2,50,0.001,1604,3
0.548,0.0001,843,861,2,50,0.001,1704,3
0.584,0.0001,899,905,2,50,0.001,1804,3
0.6,0.0001,953,951,2,50,0.001,1904,3
0.624,0.0001,1002,1002,2,50,0.001,2004,3
0.55,0.0001,53,51,2,50,0.001,104,4
0.55,0.0001,111,93,2,50,0.001,204,4
0.55,0.0001,161,143,2,50,0.001,304,4
0.55,0.0001,204,200,2,50,0.001,404,4
0.55,0.0001,253,251,2,50,0.001,504,4
0.55,0.0001,305,299,2,50,0.001,604,4
0.55,0.0001,352,352,2,50,0.001,704,4
0.55,0.0001,391,413,2,50,0.001,804,4
0.548,0.0001,432,472,2,50,0.001,904,4
0.548,0.0001,480,524,2,50,0.001,1004,4
0.542,0.0001,525,579,2,50,0.001,1104,4
0.51,0.0001,570,634,2,50,0.001,1204,4
0.47,0.0001,633,671,2,50,0.001,1304,4
0.496,0.0001,683,721,2,50,0.001,1404,4
0.594,0.0001,735,769,2,50,0.001,1504,4
0.656,0.0001,775,829,2,50,0.001,1604,4
0.714,0.0001,829,875,2,50,0.001,1704,4
0.74,0.0001,879,925,2,50,0.001,1804,4
0.732,0.0001,925,979,2,50,0.001,1904,4
0.752,0.0001,977,1027,2,50,0.001,2004,4
0.448,0.0001,51,53,2,50,0.001,104,5
0.452,0.0001,100,104,2,50,0.001,204,5
0.45,0.0001,147,157,2,50,0.001,304,5
0.452,0.0001,198,206,2,50,0.001,404,5
0.464,0.0001,244,260,2,50,0.001,504,5
0.478,0.0001,290,314,2,50,0.001,604,5
0.504,0.0001,339,365,2,50,0.001,704,5
0.51,0.0001,400,404,2,50,0.001,804,5
0.516,0.0001,448,456,2,50,0.001,904,5
0.546,0.0001,498,506,2,50,0.001,1004,5
0.576,0.0001,549,555,2,50,0.001,1104,5
0.622,0.0001,600,604,2,50,0.001,1204,5
0.634,0.0001,653,651,2,50,0.001,1304,5
0.668,0.0001,701,703,2,50,0.001,1404,5
0.676,0.0001,748,756,2,50,0.001,1504,5
0.72,0.0001,804,800,2,50,0.001,1604,5
0.758,0.0001,851,853,2,50,0.001,1704,5
0.792,0.0001,904,900,2,50,0.001,1804,5
0.796,0.0001,950,954,2,50,0.001,1904,5
0.8,0.0001,1000,1004,2,50,0.001,2004,5
0.51,0.0001,49,55,2,50,0.001,104,6
0.522,0.0001,91,113,2,50,0.001,204,6
0.53,0.0001,148,156,2,50,0.001,304,6
0.532,0.0001,197,207,2,50,0.001,404,6
0.534,0.0001,261,243,2,50,0.001,504,6
0.534,0.0001,317,287,2,50,0.001,604,6
0.536,0.0001,360,344,2,50,0.001,704,6
0.536,0.0001,408,396,2,50,0.001,804,6
0.54,0.0001,456,448,2,50,0.001,904,6
0.546,0.0001,506,498,2,50,0.001,1004,6
0.552,0.0001,550,554,2,50,0.001,1104,6
0.538,0.0001,596,608,2,50,0.001,1204,6
0.552,0.0001,646,658,2,50,0.001,1304,6
0.61,0.0001,699,705,2,50,0.001,1404,6
0.688,0.0001,755,749,2,50,0.001,1504,6
0.692,0.0001,807,797,2,50,0.001,1604,6
0.698,0.0001,853,851,2,50,0.001,1704,6
0.704,0.0001,899,905,2,50,0.001,1804,6
0.694,0.0001,947,957,2,50,0.001,1904,6
0.698,0.0001,1002,1002,2,50,0.001,2004,6
0.554,0.0001,48,56,2,50,0.001,104,7
0.56,0.0001,92,112,2,50,0.001,204,7
0.562,0.0001,153,151,2,50,0.001,304,7
0.568,0.0001,194,210,2,50,0.001,404,7
0.576,0.0001,243,261,2,50,0.001,504,7
0.566,0.0001,298,306,2,50,0.001,604,7
0.572,0.0001,351,353,2,50,0.001,704,7
0.574,0.0001,397,407,2,50,0.001,804,7
0.568,0.0001,446,458,2,50,0.001,904,7
0.59,0.0001,494,510,2,50,0.001,1004,7
0.606,0.0001,548,556,2,50,0.001,1104,7
0.642,0.0001,604,600,2,50,0.001,1204,7
0.648,0.0001,655,649,2,50,0.001,1304,7
0.644,0.0001,704,700,2,50,0.001,1404,7
0.652,0.0001,753,751,2,50,0.001,1504,7
0.656,0.0001,801,803,2,50,0.001,1604,7
0.672,0.0001,851,853,2,50,0.001,1704,7
0.702,0.0001,909,895,2,50,0.001,1804,7
0.736,0.0001,961,943,2,50,0.001,1904,7
0.744,0.0001,1003,1001,2,50,0.001,2004,7
0.564,0.0001,51,53,2,50,0.001,104,8
0.564,0.0001,98,106,2,50,0.001,204,8
0.564,0.0001,144,160,2,50,0.001,304,8
0.564,0.0001,195,209,2,50,0.001,404,8
0.564,0.0001,241,263,2,50,0.001,504,8
0.564,0.0001,300,304,2,50,0.001,604,8
0.564,0.0001,356,348,2,50,0.001,704,8
0.564,0.0001,410,394,2,50,0.001,804,8
0.564,0.0001,462,442,2,50,0.001,904,8
0.564,0.0001,501,503,2,50,0.001,1004,8
0.564,0.0001,542,562,2,50,0.001,1104,8
0.564,0.0001,595,609,2,50,0.001,1204,8
0.564,0.0001,642,662,2,50,0.001,1304,8
0.588,0.0001,692,712,2,50,0.001,1404,8
0.626,0.0001,740,764,2,50,0.001,1504,8
0.696,0.0001,786,818,2,50,0.001,1604,8
0.756,0.0001,836,868,2,50,0.001,1704,8
0.77,0.0001,878,926,2,50,0.001,1804,8
0.776,0.0001,927,977,2,50,0.001,1904,8
0.776,0.0001,970,1034,2,50,0.001,2004,8
0.482,0.0001,49,55,2,50,0.001,104,9
0.482,0.0001,101,103,2,50,0.001,204,9
0.484,0.0001,143,161,2,50,0.001,304,9
0.486,0.0001,194,210,2,50,0.001,404,9
0.488,0.0001,252,252,2,50,0.001,504,9
0.5,0.0001,298,306,2,50,0.001,604,9
0.512,0.0001,340,364,2,50,0.001,704,9
0.528,0.0001,391,413,2,50,0.001,804,9
0.544,0.0001,446,458,2,50,0.001,904,9
0.576,0.0001,497,507,2,50,0.001,1004,9
0.598,0.0001,547,557,2,50,0.001,1104,9
0.648,0.0001,593,611,2,50,0.001,1204,9
0.722,0.0001,645,659,2,50,0.001,1304,9
0.76,0.0001,701,703,2,50,0.001,1404,9
0.768,0.0001,744,760,2,50,0.001,1504,9
0.8,0.0001,792,812,2,50,0.001,1604,9
0.838,0.0001,843,861,2,50,0.001,1704,9
0.852,0.0001,890,914,2,50,0.001,1804,9
0.846,0.0001,942,962,2,50,0.001,1904,9
0.848,0.0001,993,1011,2,50,0.001,2004,9
0.402,0.0001,53,51,2,50,0.001,104,10
0.41,0.0001,113,91,2,50,0.001,204,10
0.426,0.0001,155,149,2,50,0.001,304,10
0.452,0.0001,204,200,2,50,0.001,404,10
0.466,0.0001,254,250,2,50,0.001,504,10
0.494,0.0001,297,307,2,50,0.001,604,10
0.522,0.0001,350,354,2,50,0.001,704,10
0.542,0.0001,397,407,2,50,0.001,804,10
0.55,0.0001,439,465,2,50,0.001,904,10
0.562,0.0001,492,512,2,50,0.001,1004,10
0.56,0.0001,542,562,2,50,0.001,1104,10
0.564,0.0001,588,616,2,50,0.001,1204,10
0.568,0.0001,639,665,2,50,0.001,1304,10
0.582,0.0001,696,708,2,50,0.001,1404,10
0.588,0.0001,753,751,2,50,0.001,1504,10
0.608,0.0001,795,809,2,50,0.001,1604,10
0.682,0.0001,845,859,2,50,0.001,1704,10
0.708,0.0001,898,906,2,50,0.001,1804,10
0.718,0.0001,939,965,2,50,0.001,1904,10
0.75,0.0001,999,1005,2,50,0.001,2004,10
0.508,0.0001,51,53,2,50,0.001,104,11
0.512,0.0001,105,99,2,50,0.001,204,11
0.516,0.0001,159,145,2,50,0.001,304,11
0.524,0.0001,215,189,2,50,0.001,404,11
0.536,0.0001,265,239,2,50,0.001,504,11
0.556,0.0001,320,284,2,50,0.001,604,11
0.584,0.0001,372,332,2,50,0.001,704,11
0.592,0.0001,425,379,2,50,0.001,804,11
0.616,0.0001,481,423,2,50,0.001,904,11
0.64,0.0001,533,471,2,50,0.001,1004,11
0.67,0.0001,582,522,2,50,0.001,1104,11
0.696,0.0001,628,576,2,50,0.001,1204,11
0.704,0.0001,681,623,2,50,0.001,1304,11
0.732,0.0001,733,671,2,50,0.001,1404,11
0.752,0.0001,783,721,2,50,0.001,1504,11
0.776,0.0001,824,780,2,50,0.001,1604,11
0.798,0.0001,873,831,2,50,0.001,1704,11
0.798,0.0001,920,884,2,50,0.001,1804,11
0.832,0.0001,963,941,2,50,0.001,1904,11
0.832,0.0001,1013,991,2,50,0.001,2004,11
0.518,0.0001,47,57,2,50,0.001,104,12
0.518,0.0001,93,111,2,50,0.001,204,12
0.518,0.0001,150,154,2,50,0.001,304,12
0.518,0.0001,202,202,2,50,0.001,404,12
0.518,0.0001,256,248,2,50,0.001,504,12
0.518,0.0001,304,300,2,50,0.001,604,12
0.518,0.0001,356,348,2,50,0.001,704,12
0.518,0.0001,412,392,2,50,0.001,804,12
0.518,0.0001,466,438,2,50,0.001,904,12
0.538,0.0001,514,490,2,50,0.001,1004,12
0.62,0.0001,572,532,2,50,0.001,1104,12
0.704,0.0001,623,581,2,50,0.001,1204,12
0.724,0.0001,677,627,2,50,0.001,1304,12
0.752,0.0001,719,685,2,50,0.001,1404,12
0.758,0.0001,774,730,2,50,0.001,1504,12
0.74,0.0001,820,784,2,50,0.001,1604,12
0.748,0.0001,857,847,2,50,0.001,1704,12
0.748,0.0001,916,888,2,50,0.001,1804,12
0.744,0.0001,963,941,2,50,0.001,1904,12
0.744,0.0001,1011,993,2,50,0.001,2004,12
0.472,0.0001,56,48,2,50,0.001,104,13
0.478,0.0001,102,102,2,50,0.001,204,13
0.484,0.0001,152,152,2,50,0.001,304,13
0.488,0.0001,205,199,2,50,0.001,404,13
0.486,0.0001,251,253,2,50,0.001,504,13
0.494,0.0001,297,307,2,50,0.001,604,13
0.502,0.0001,351,353,2,50,0.001,704,13
0.516,0.0001,403,401,2,50,0.001,804,13
0.526,0.0001,447,457,2,50,0.001,904,13
0.54,0.0001,497,507,2,50,0.001,1004,13
0.556,0.0001,548,556,2,50,0.001,1104,13
0.58,0.0001,594,610,2,50,0.001,1204,13
0.596,0.0001,637,667,2,50,0.001,1304,13
0.636,0.0001,682,722,2,50,0.001,1404,13
0.682,0.0001,735,769,2,50,0.001,1504,13
0.724,0.0001,792,812,2,50,0.001,1604,13
0.736,0.0001,851,853,2,50,0.001,1704,13
0.752,0.0001,898,906,2,50,0.001,1804,13
0.768,0.0001,951,953,2,50,0.001,1904,13
0.78,0.0001,1002,1002,2,50,0.001,2004,13
0.512,0.0001,55,49,2,50,0.001,104,14
0.512,0.0001,98,106,2,50,0.001,204,14
0.512,0.0001,151,153,2,50,0.001,304,14
0.512,0.0001,205,199,2,50,0.001,404,14
0.512,0.0001,251,253,2,50,0.001,504,14
0.512,0.0001,300,304,2,50,0.001,604,14
0.512,0.0001,352,352,2,50,0.001,704,14
0.518,0.0001,405,399,2,50,0.001,804,14
0.534,0.0001,454,450,2,50,0.001,904,14
0.566,0.0001,510,494,2,50,0.001,1004,14
0.586,0.0001,558,546,2,50,0.001,1104,14
0.596,0.0001,603,601,2,50,0.001,1204,14
0.614,0.0001,653,651,2,50,0.001,1304,14
0.644,0.0001,701,703,2,50,0.001,1404,14
0.66,0.0001,743,761,2,50,0.001,1504,14
0.66,0.0001,782,822,2,50,0.001,1604,14
0.702,0.0001,836,868,2,50,0.001,1704,14
0.71,0.0001,889,915,2,50,0.001,1804,14
0.722,0.0001,941,963,2,50,0.001,1904,14
0.746,0.0001,992,1012,2,50,0.001,2004,14
0.442,0.0001,59,45,2,50,0.001,104,15
0.438,0.0001,109,95,2,50,0.001,204,15
0.46,0.0001,162,142,2,50,0.001,304,15
0.478,0.0001,214,190,2,50,0.001,404,15
0.488,0.0001,256,248,2,50,0.001,504,15
0.514,0.0001,309,295,2,50,0.001,604,15
0.52,0.0001,369,335,2,50,0.001,704,15
0.526,0.0001,413,391,2,50,0.001,804,15
0.55,0.0001,464,440,2,50,0.001,904,15
0.552,0.0001,516,488,2,50,0.001,1004,15
0.578,0.0001,564,540,2,50,0.001,1104,15
0.59,0.0001,617,587,2,50,0.001,1204,15
0.602,0.0001,658,646,2,50,0.001,1304,15
0.63,0.0001,701,703,2,50,0.001,1404,15
0.634,0.0001,759,745,2,50,0.001,1504,15
0.65,0.0001,814,790,2,50,0.001,1604,15
0.652,0.0001,861,843,2,50,0.001,1704,15
0.67,0.0001,901,903,2,50,0.001,1804,15
0.682,0.0001,952,952,2,50,0.001,1904,15
0.716,0.0001,997,1007,2,50,0.001,2004,15
0.502,0.0001,54,50,2,50,0.001,104,16
0.506,0.0001,106,98,2,50,0.001,204,16
0.512,0.0001,157,147,2,50,0.001,304,16
0.514,0.0001,212,192,2,50,0.001,404,16
0.52,0.0001,254,250,2,50,0.001,504,16
0.522,0.0001,310,294,2,50,0.001,604,16
0.524,0.0001,354,350,2,50,0.001,704,16
0.53,0.0001,397,407,2,50,0.001,804,16
0.548,0.0001,444,460,2,50,0.001,904,16
0.566,0.0001,494,510,2,50,0.001,1004,16
0.564,0.0001,552,552,2,50,0.001,1104,16
0.582,0.0001,607,597,2,50,0.001,1204,16
0.592,0.0001,653,651,2,50,0.001,1304,16
0.648,0.0001,703,701,2,50,0.001,1404,16
0.676,0.0001,744,760,2,50,0.001,1504,16
0.712,0.0001,800,804,2,50,0.001,1604,16
0.778,0.0001,849,855,2,50,0.001,1704,16
0.796,0.0001,899,905,2,50,0.001,1804,16
0.81,0.0001,946,958,2,50,0.001,1904,16
0.828,0.0001,993,1011,2,50,0.001,2004,16
0.52,0.0001,57,47,2,50,0.001,104,17
0.522,0.0001,102,102,2,50,0.001,204,17
0.524,0.0001,154,150,2,50,0.001,304,17
0.54,0.0001,206,198,2,50,0.001,404,17
0.55,0.0001,245,259,2,50,0.001,504,17
0.572,0.0001,298,306,2,50,0.001,604,17
0.578,0.0001,348,356,2,50,0.001,704,17
0.592,0.0001,396,408,2,50,0.001,804,17
0.6,0.0001,455,449,2,50,0.001,904,17
0.612,0.0001,503,501,2,50,0.001,1004,17
0.63,0.0001,548,556,2,50,0.001,1104,17
0.658,0.0001,599,605,2,50,0.001,1204,17
0.668,0.0001,648,656,2,50,0.001,1304,17
0.684,0.0001,704,700,2,50,0.001,1404,17
0.694,0.0001,761,743,2,50,0.001,1504,17
0.712,0.0001,813,791,2,50,0.001,1604,17
0.728,0.0001,869,835,2,50,0.001,1704,17
0.748,0.0001,919,885,2,50,0.001,1804,17
0.768,0.0001,961,943,2,50,0.001,1904,17
0.766,0.0001,1012,992,2,50,0.001,2004,17
0.514,0.0001,49,55,2,50,0.001,104,18
0.514,0.0001,92,112,2,50,0.001,204,18
0.514,0.0001,145,159,2,50,0.001,304,18
0.514,0.0001,198,206,2,50,0.001,404,18
0.514,0.0001,252,252,2,50,0.001,504,18
0.514,0.0001,299,305,2,50,0.001,604,18
0.514,0.0001,342,362,2,50,0.001,704,18
0.514,0.0001,398,406,2,50,0.001,804,18
0.514,0.0001,440,464,2,50,0.001,904,18
0.514,0.0001,484,520,2,50,0.001,1004,18
0.536,0.0001,541,563,2,50,0.001,1104,18
0.582,0.0001,590,614,2,50,0.001,1204,18
0.636,0.0001,641,663,2,50,0.001,1304,18
0.674,0.0001,692,712,2,50,0.001,1404,18
0.73,0.0001,742,762,2,50,0.001,1504,18
0.764,0.0001,802,802,2,50,0.001,1604,18
0.794,0.0001,847,857,2,50,0.001,1704,18
0.804,0.0001,900,904,2,50,0.001,1804,18
0.812,0.0001,959,945,2,50,0.001,1904,18
0.808,0.0001,1009,995,2,50,0.001,2004,18
0.56,0.0001,54,50,2,50,0.001,104,19
0.56,0.0001,98,106,2,50,0.001,204,19
0.544,0.0001,151,153,2,50,0.001,304,19
0.544,0.0001,196,208,2,50,0.001,404,19
0.54,0.0001,243,261,2,50,0.001,504,19
0.534,0.0001,296,308,2,50,0.001,604,19
0.534,0.0001,347,357,2,50,0.001,704,19
0.54,0.0001,410,394,2,50,0.001,804,19
0.572,0.0001,461,443,2,50,0.001,904,19
0.63,0.0001,507,497,2,50,0.001,1004,19
0.646,0.0001,553,551,2,50,0.001,1104,19
0.676,0.0001,605,599,2,50,0.001,1204,19
0.7,0.0001,662,642,2,50,0.001,1304,19
0.708,0.0001,722,682,2,50,0.001,1404,19
0.722,0.0001,776,728,2,50,0.001,1504,19
0.73,0.0001,820,784,2,50,0.001,1604,19
0.734,0.0001,873,831,2,50,0.001,1704,19
0.738,0.0001,913,891,2,50,0.001,1804,19
0.738,0.0001,950,954,2,50,0.001,1904,19
0.746,0.0001,1000,1004,2,50,0.001,2004,19
0.528,0.0001,42,62,2,50,0.001,104,20
0.528,0.0001,96,108,2,50,0.001,204,20
0.528,0.0001,143,161,2,50,0.001,304,20
0.528,0.0001,198,206,2,50,0.001,404,20
0.528,0.0001,257,247,2,50,0.001,504,20
0.528,0.0001,309,295,2,50,0.001,604,20
0.528,0.0001,357,347,2,50,0.001,704,20
0.528,0.0001,408,396,2,50,0.001,804,20
0.528,0.0001,464,440,2,50,0.001,904,20
0.534,0.0001,501,503,2,50,0.001,1004,20
0.54,0.0001,545,559,2,50,0.001,1104,20
0.554,0.0001,594,610,2,50,0.001,1204,20
0.574,0.0001,635,669,2,50,0.001,1304,20
0.64,0.0001,683,721,2,50,0.001,1404,20
0.674,0.0001,737,767,2,50,0.001,1504,20
0.742,0.0001,784,820,2,50,0.001,1604,20
0.756,0.0001,831,873,2,50,0.001,1704,20
0.78,0.0001,875,929,2,50,0.001,1804,20
0.792,0.0001,935,969,2,50,0.001,1904,20
0.794,0.0001,988,1016,2,50,0.001,2004,20
0.512,0.0001,52,52,2,50,0.01,104,1
0.532,0.0001,108,96,2,50,0.01,204,1
0.548,0.0001,157,147,2,50,0.01,304,1
0.592,0.0001,199,205,2,50,0.01,404,1
0.642,0.0001,252,252,2,50,0.01,504,1
0.712,0.0001,302,302,2,50,0.01,604,1
0.822,0.0001,355,349,2,50,0.01,704,1
0.824,0.0001,407,397,2,50,0.01,804,1
0.814,0.0001,455,449,2,50,0.01,904,1
0.846,0.0001,508,496,2,50,0.01,1004,1
0.886,0.0001,561,543,2,50,0.01,1104,1
0.896,0.0001,603,601,2,50,0.01,1204,1
0.904,0.0001,651,653,2,50,0.01,1304,1
0.91,0.0001,701,703,2,50,0.01,1404,1
0.908,0.0001,753,751,2,50,0.01,1504,1
0.914,0.0001,800,804,2,50,0.01,1604,1
0.922,0.0001,859,845,2,50,0.01,1704,1
0.926,0.0001,910,894,2,50,0.01,1804,1
0.926,0.0001,956,948,2,50,0.01,1904,1
0.93,0.0001,1008,996,2,50,0.01,2004,1
0.508,0.0001,57,47,2,50,0.01,104,2
0.528,0.0001,105,99,2,50,0.01,204,2
0.646,0.0001,162,142,2,50,0.01,304,2
0.688,0.0001,215,189,2,50,0.01,404,2
0.736,0.0001,273,231,2,50,0.01,504,2
0.76,0.0001,326,278,2,50,0.01,604,2
0.75,0.0001,376,328,2,50,0.01,704,2
0.784,0.0001,430,374,2,50,0.01,804,2
0.816,0.0001,481,423,2,50,0.01,904,2
0.83,0.0001,529,475,2,50,0.01,1004,2
0.846,0.0001,579,525,2,50,0.01,1104,2
0.842,0.0001,631,573,2,50,0.01,1204,2
0.852,0.0001,686,618,2,50,0.01,1304,2
0.856,0.0001,727,677,2,50,0.01,1404,2
0.872,0.0001,774,730,2,50,0.01,1504,2
0.89,0.0001,830,774,2,50,0.01,1604,2
0.904,0.0001,877,827,2,50,0.01,1704,2
0.898,0.0001,921,883,2,50,0.01,1804,2
0.896,0.0001,960,944,2,50,0.01,1904,2
0.904,0.0001,997,1007,2,50,0.01,2004,2
0.54,0.0001,51,53,2,50,0.01,104,3
0.63,0.0001,103,101,2,50,0.01,204,3
0.63,0.0001,155,149,2,50,0.01,304,3
0.632,0.0001,200,204,2,50,0.01,404,3
0.63,0.0001,248,256,2,50,0.01,504,3
0.642,0.0001,306,298,2,50,0.01,604,3
0.718,0.0001,353,351,2,50,0.01,704,3
0.836,0.0001,400,404,2,50,0.01,804,3
0.84,0.0001,456,448,2,50,0.01,904,3
0.84,0.0001,511,493,2,50,0.01,1004,3
0.854,0.0001,563,541,2,50,0.01,1104,3
0.896,0.0001,615,589,2,50,0.01,1204,3
0.924,0.0001,668,636,2,50,0.01,1304,3
0.91,0.0001,717,687,2,50,0.01,1404,3
0.906,0.0001,768,736,2,50,0.01,1504,3
0.924,0.0001,815,789,2,50,0.01,1604,3
0.942,0.0001,864,840,2,50,0.01,1704,3
0.934,0.0001,918,886,2,50,0.01,1804,3
0.93,0.0001,965,939,2,50,0.01,1904,3
0.944,0.0001,1006,998,2,50,0.01,2004,3
0.492,0.0001,50,54,2,50,0.01,104,4
0.534,0.0001,99,105,2,50,0.01,204,4
0.56,0.0001,153,151,2,50,0.01,304,4
0.58,0.0001,216,188,2,50,0.01,404,4
0.54,0.0001,264,240,2,50,0.01,504,4
0.574,0.0001,312,292,2,50,0.01,604,4
0.582,0.0001,369,335,2,50,0.01,704,4
0.602,0.0001,430,374,2,50,0.01,804,4
0.726,0.0001,485,419,2,50,0.01,904,4
0.864,0.0001,532,472,2,50,0.01,1004,4
0.878,0.0001,582,522,2,50,0.01,1104,4
0.894,0.0001,631,573,2,50,0.01,1204,4
0.908,0.0001,680,624,2,50,0.01,1304,4
0.926,0.0001,732,672,2,50,0.01,1404,4
0.936,0.0001,782,722,2,50,0.01,1504,4
0.946,0.0001,830,774,2,50,0.01,1604,4
0.942,0.0001,869,835,2,50,0.01,1704,4
0.942,0.0001,913,891,2,50,0.01,1804,4
0.94,0.0001,964,940,2,50,0.01,1904,4
0.946,0.0001,1022,982,2,50,0.01,2004,4
0.502,0.0001,53,51,2,50,0.01,104,5
0.52,0.0001,109,95,2,50,0.01,204,5
0.512,0.0001,156,148,2,50,0.01,304,5
0.556,0.0001,216,188,2,50,0.01,404,5
0.54,0.0001,267,237,2,50,0.01,504,5
0.572,0.0001,322,282,2,50,0.01,604,5
0.558,0.0001,373,331,2,50,0.01,704,5
0.564,0.0001,419,385,2,50,0.01,804,5
0.598,0.0001,468,436,2,50,0.01,904,5
0.626,0.0001,525,479,2,50,0.01,1004,5
0.638,0.0001,574,530,2,50,0.01,1104,5
0.672,0.0001,618,586,2,50,0.01,1204,5
0.684,0.0001,658,646,2,50,0.01,1304,5
0.712,0.0001,703,701,2,50,0.01,1404,5
0.77,0.0001,748,756,2,50,0.01,1504,5
0.852,0.0001,798,806,2,50,0.01,1604,5
0.888,0.0001,842,862,2,50,0.01,1704,5
0.902,0.0001,888,916,2,50,0.01,1804,5
0.906,0.0001,939,965,2,50,0.01,1904,5
0.922,0.0001,1002,1002,2,50,0.01,2004,5
0.588,0.0001,45,59,2,50,0.01,104,6
0.592,0.0001,97,107,2,50,0.01,204,6
0.594,0.0001,143,161,2,50,0.01,304,6
0.616,0.0001,193,211,2,50,0.01,404,6
0.66,0.0001,238,266,2,50,0.01,504,6
0.714,0.0001,293,311,2,50,0.01,604,6
0.756,0.0001,344,360,2,50,0.01,704,6
0.818,0.0001,407,397,2,50,0.01,804,6
0.824,0.0001,458,446,2,50,0.01,904,6
0.888,0.0001,508,496,2,50,0.01,1004,6
0.908,0.0001,564,540,2,50,0.01,1104,6
0.918,0.0001,618,586,2,50,0.01,1204,6
0.91,0.0001,662,642,2,50,0.01,1304,6
0.938,0.0001,713,691,2,50,0.01,1404,6
0.932,0.0001,754,750,2,50,0.01,1504,6
0.942,0.0001,798,806,2,50,0.01,1604,6
0.942,0.0001,847,857,2,50,0.01,1704,6
0.948,0.0001,899,905,2,50,0.01,1804,6
0.948,0.0001,948,956,2,50,0.01,1904,6
0.95,0.0001,1003,1001,2,50,0.01,2004,6
0.48,0.0001,53,51,2,50,0.01,104,7
0.598,0.0001,93,111,2,50,0.01,204,7
0.596,0.0001,150,154,2,50,0.01,304,7
0.634,0.0001,196,208,2,50,0.01,404,7
0.618,0.0001,241,263,2,50,0.01,504,7
0.614,0.0001,286,318,2,50,0.01,604,7
0.66,0.0001,342,362,2,50,0.01,704,7
0.708,0.0001,395,409,2,50,0.01,804,7
0.72,0.0001,446,458,2,50,0.01,904,7
0.74,0.0001,500,504,2,50,0.01,1004,7
0.76,0.0001,553,551,2,50,0.01,1104,7
0.778,0.0001,598,606,2,50,0.01,1204,7
0.804,0.0001,658,646,2,50,0.01,1304,7
0.838,0.0001,701,703,2,50,0.01,1404,7
0.838,0.0001,754,750,2,50,0.01,1504,7
0.854,0.0001,803,801,2,50,0.01,1604,7
0.872,0.0001,850,854,2,50,0.01,1704,7
0.892,0.0001,899,905,2,50,0.01,1804,7
0.898,0.0001,953,951,2,50,0.01,1904,7
0.89,0.0001,1002,1002,2,50,0.01,2004,7
0.556,0.0001,56,48,2,50,0.01,104,8
0.59,0.0001,108,96,2,50,0.01,204,8
0.468,0.0001,155,149,2,50,0.01,304,8
0.52,0.0001,204,200,2,50,0.01,404,8
0.536,0.0001,257,247,2,50,0.01,504,8
0.654,0.0001,301,303,2,50,0.01,604,8
0.744,0.0001,353,351,2,50,0.01,704,8
0.778,0.0001,401,403,2,50,0.01,804,8
0.758,0.0001,446,458,2,50,0.01,904,8
0.812,0.0001,496,508,2,50,0.01,1004,8
0.868,0.0001,549,555,2,50,0.01,1104,8
0.892,0.0001,601,603,2,50,0.01,1204,8
0.922,0.0001,650,654,2,50,0.01,1304,8
0.908,0.0001,711,693,2,50,0.01,1404,8
0.896,0.0001,755,749,2,50,0.01,1504,8
0.902,0.0001,804,800,2,50,0.01,1604,8
0.908,0.0001,849,855,2,50,0.01,1704,8
0.912,0.0001,901,903,2,50,0.01,1804,8
0.916,0.0001,954,950,2,50,0.01,1904,8
0.926,0.0001,1002,1002,2,50,0.01,2004,8
0.464,0.0001,57,47,2,50,0.01,104,9
0.494,0.0001,107,97,2,50,0.01,204,9
0.546,0.0001,154,150,2,50,0.01,304,9
0.668,0.0001,201,203,2,50,0.01,404,9
0.672,0.0001,244,260,2,50,0.01,504,9
0.724,0.0001,300,304,2,50,0.01,604,9
0.782,0.0001,364,340,2,50,0.01,704,9
0.838,0.0001,412,392,2,50,0.01,804,9
0.874,0.0001,465,439,2,50,0.01,904,9
0.886,0.0001,501,503,2,50,0.01,1004,9
0.896,0.0001,556,548,2,50,0.01,1104,9
0.914,0.0001,609,595,2,50,0.01,1204,9
0.934,0.0001,658,646,2,50,0.01,1304,9
0.93,0.0001,712,692,2,50,0.01,1404,9
0.91,0.0001,766,738,2,50,0.01,1504,9
0.914,0.0001,815,789,2,50,0.01,1604,9
0.922,0.0001,853,851,2,50,0.01,1704,9
0.93,0.0001,914,890,2,50,0.01,1804,9
0.932,0.0001,958,946,2,50,0.01,1904,9
0.94,0.0001,1008,996,2,50,0.01,2004,9
0.468,0.0001,48,56,2,50,0.01,104,10
0.574,0.0001,98,106,2,50,0.01,204,10
0.618,0.0001,143,161,2,50,0.01,304,10
0.676,0.0001,197,207,2,50,0.01,404,10
0.716,0.0001,255,249,2,50,0.01,504,10
0.706,0.0001,307,297,2,50,0.01,604,10
0.712,0.0001,362,342,2,50,0.01,704,10
0.74,0.0001,406,398,2,50,0.01,804,10
0.758,0.0001,453,451,2,50,0.01,904,10
0.77,0.0001,499,505,2,50,0.01,1004,10
0.802,0.0001,557,547,2,50,0.01,1104,10
0.834,0.0001,610,594,2,50,0.01,1204,10
0.852,0.0001,661,643,2,50,0.01,1304,10
0.87,0.0001,708,696,2,50,0.01,1404,10
0.888,0.0001,752,752,2,50,0.01,1504,10
0.884,0.0001,798,806,2,50,0.01,1604,10
0.888,0.0001,850,854,2,50,0.01,1704,10
0.898,0.0001,893,911,2,50,0.01,1804,10
0.894,0.0001,934,970,2,50,0.01,1904,10
0.902,0.0001,981,1023,2,50,0.01,2004,10
0.492,0.0001,58,46,2,50,0.01,104,11
0.492,0.0001,105,99,2,50,0.01,204,11
0.476,0.0001,159,145,2,50,0.01,304,11
0.544,0.0001,203,201,2,50,0.01,404,11
0.64,0.0001,249,255,2,50,0.01,504,11
0.736,0.0001,307,297,2,50,0.01,604,11
0.794,0.0001,355,349,2,50,0.01,704,11
0.81,0.0001,405,399,2,50,0.01,804,11
0.824,0.0001,456,448,2,50,0.01,904,11
0.856,0.0001,508,496,2,50,0.01,1004,11
0.888,0.0001,567,537,2,50,0.01,1104,11
0.884,0.0001,612,592,2,50,0.01,1204,11
0.894,0.0001,666,638,2,50,0.01,1304,11
0.894,0.0001,723,681,2,50,0.01,1404,11
0.894,0.0001,772,732,2,50,0.01,1504,11
0.906,0.0001,829,775,2,50,0.01,1604,11
0.912,0.0001,870,834,2,50,0.01,1704,11
0.91,0.0001,917,887,2,50,0.01,1804,11
0.912,0.0001,961,943,2,50,0.01,1904,11
0.922,0.0001,1014,990,2,50,0.01,2004,11
0.552,0.0001,55,49,2,50,0.01,104,12
0.616,0.0001,104,100,2,50,0.01,204,12
0.63,0.0001,160,144,2,50,0.01,304,12
0.64,0.0001,207,197,2,50,0.01,404,12
0.62,0.0001,250,254,2,50,0.01,504,12
0.612,0.0001,300,304,2,50,0.01,604,12
0.638,0.0001,346,358,2,50,0.01,704,12
0.672,0.0001,397,407,2,50,0.01,804,12
0.714,0.0001,447,457,2,50,0.01,904,12
0.808,0.0001,496,508,2,50,0.01,1004,12
0.858,0.0001,548,556,2,50,0.01,1104,12
0.878,0.0001,596,608,2,50,0.01,1204,12
0.9,0.0001,642,662,2,50,0.01,1304,12
0.89,0.0001,697,707,2,50,0.01,1404,12
0.884,0.0001,735,769,2,50,0.01,1504,12
0.906,0.0001,783,821,2,50,0.01,1604,12
0.924,0.0001,835,869,2,50,0.01,1704,12
0.926,0.0001,884,920,2,50,0.01,1804,12
0.928,0.0001,932,972,2,50,0.01,1904,12
0.938,0.0001,985,1019,2,50,0.01,2004,12
0.534,0.0001,60,44,2,50,0.01,104,13
0.58,0.0001,113,91,2,50,0.01,204,13
0.602,0.0001,159,145,2,50,0.01,304,13
0.646,0.0001,206,198,2,50,0.01,404,13
0.662,0.0001,263,241,2,50,0.01,504,13
0.782,0.0001,311,293,2,50,0.01,604,13
0.774,0.0001,349,355,2,50,0.01,704,13
0.798,0.0001,391,413,2,50,0.01,804,13
0.812,0.0001,425,479,2,50,0.01,904,13
0.83,0.0001,480,524,2,50,0.01,1004,13
0.834,0.0001,532,572,2,50,0.01,1104,13
0.852,0.0001,579,625,2,50,0.01,1204,13
0.858,0.0001,633,671,2,50,0.01,1304,13
0.86,0.0001,689,715,2,50,0.01,1404,13
0.856,0.0001,741,763,2,50,0.01,1504,13
0.864,0.0001,798,806,2,50,0.01,1604,13
0.866,0.0001,840,864,2,50,0.01,1704,13
0.88,0.0001,894,910,2,50,0.01,1804,13
0.882,0.0001,942,962,2,50,0.01,1904,13
0.886,0.0001,991,1013,2,50,0.01,2004,13
0.558,0.0001,53,51,2,50,0.01,104,14
0.642,0.0001,104,100,2,50,0.01,204,14
0.596,0.0001,151,153,2,50,0.01,304,14
0.582,0.0001,199,205,2,50,0.01,404,14
0.628,0.0001,252,252,2,50,0.01,504,14
0.806,0.0001,301,303,2,50,0.01,604,14
0.866,0.0001,345,359,2,50,0.01,704,14
0.862,0.0001,395,409,2,50,0.01,804,14
0.86,0.0001,440,464,2,50,0.01,904,14
0.864,0.0001,482,522,2,50,0.01,1004,14
0.858,0.0001,531,573,2,50,0.01,1104,14
0.862,0.0001,589,615,2,50,0.01,1204,14
0.882,0.0001,639,665,2,50,0.01,1304,14
0.902,0.0001,688,716,2,50,0.01,1404,14
0.91,0.0001,729,775,2,50,0.01,1504,14
0.914,0.0001,792,812,2,50,0.01,1604,14
0.912,0.0001,843,861,2,50,0.01,1704,14
0.918,0.0001,899,905,2,50,0.01,1804,14
0.92,0.0001,951,953,2,50,0.01,1904,14
0.92,0.0001,1007,997,2,50,0.01,2004,14
0.472,0.0001,46,58,2,50,0.01,104,15
0.476,0.0001,106,98,2,50,0.01,204,15
0.584,0.0001,156,148,2,50,0.01,304,15
0.616,0.0001,206,198,2,50,0.01,404,15
0.644,0.0001,247,257,2,50,0.01,504,15
0.684,0.0001,295,309,2,50,0.01,604,15
0.69,0.0001,346,358,2,50,0.01,704,15
0.722,0.0001,397,407,2,50,0.01,804,15
0.768,0.0001,447,457,2,50,0.01,904,15
0.78,0.0001,489,515,2,50,0.01,1004,15
0.766,0.0001,541,563,2,50,0.01,1104,15
0.792,0.0001,588,616,2,50,0.01,1204,15
0.84,0.0001,635,669,2,50,0.01,1304,15
0.876,0.0001,688,716,2,50,0.01,1404,15
0.896,0.0001,743,761,2,50,0.01,1504,15
0.896,0.0001,791,813,2,50,0.01,1604,15
0.89,0.0001,839,865,2,50,0.01,1704,15
0.91,0.0001,889,915,2,50,0.01,1804,15
0.912,0.0001,936,968,2,50,0.01,1904,15
0.926,0.0001,987,1017,2,50,0.01,2004,15
0.63,0.0001,56,48,2,50,0.01,104,16
0.654,0.0001,110,94,2,50,0.01,204,16
0.536,0.0001,159,145,2,50,0.01,304,16
0.638,0.0001,208,196,2,50,0.01,404,16
0.634,0.0001,259,245,2,50,0.01,504,16
0.642,0.0001,309,295,2,50,0.01,604,16
0.644,0.0001,361,343,2,50,0.01,704,16
0.784,0.0001,408,396,2,50,0.01,804,16
0.808,0.0001,463,441,2,50,0.01,904,16
0.806,0.0001,511,493,2,50,0.01,1004,16
0.818,0.0001,559,545,2,50,0.01,1104,16
0.854,0.0001,610,594,2,50,0.01,1204,16
0.85,0.0001,658,646,2,50,0.01,1304,16
0.882,0.0001,713,691,2,50,0.01,1404,16
0.898,0.0001,758,746,2,50,0.01,1504,16
0.91,0.0001,805,799,2,50,0.01,1604,16
0.904,0.0001,861,843,2,50,0.01,1704,16
0.908,0.0001,907,897,2,50,0.01,1804,16
0.92,0.0001,947,957,2,50,0.01,1904,16
0.932,0.0001,999,1005,2,50,0.01,2004,16
0.49,0.0001,51,53,2,50,0.01,104,17
0.49,0.0001,96,108,2,50,0.01,204,17
0.55,0.0001,147,157,2,50,0.01,304,17
0.524,0.0001,199,205,2,50,0.01,404,17
0.51,0.0001,244,260,2,50,0.01,504,17
0.512,0.0001,284,320,2,50,0.01,604,17
0.558,0.0001,337,367,2,50,0.01,704,17
0.738,0.0001,382,422,2,50,0.01,804,17
0.77,0.0001,440,464,2,50,0.01,904,17
0.836,0.0001,492,512,2,50,0.01,1004,17
0.85,0.0001,550,554,2,50,0.01,1104,17
0.894,0.0001,601,603,2,50,0.01,1204,17
0.912,0.0001,647,657,2,50,0.01,1304,17
0.92,0.0001,694,710,2,50,0.01,1404,17
0.92,0.0001,750,754,2,50,0.01,1504,17
0.934,0.0001,800,804,2,50,0.01,1604,17
0.94,0.0001,845,859,2,50,0.01,1704,17
0.93,0.0001,900,904,2,50,0.01,1804,17
0.93,0.0001,957,947,2,50,0.01,1904,17
0.948,0.0001,1007,997,2,50,0.01,2004,17
0.612,0.0001,47,57,2,50,0.01,104,18
0.644,0.0001,87,117,2,50,0.01,204,18
0.684,0.0001,146,158,2,50,0.01,304,18
0.708,0.0001,195,209,2,50,0.01,404,18
0.704,0.0001,246,258,2,50,0.01,504,18
0.718,0.0001,295,309,2,50,0.01,604,18
0.738,0.0001,336,368,2,50,0.01,704,18
0.768,0.0001,386,418,2,50,0.01,804,18
0.79,0.0001,428,476,2,50,0.01,904,18
0.854,0.0001,485,519,2,50,0.01,1004,18
0.874,0.0001,532,572,2,50,0.01,1104,18
0.892,0.0001,589,615,2,50,0.01,1204,18
0.9,0.0001,637,667,2,50,0.01,1304,18
0.902,0.0001,681,723,2,50,0.01,1404,18
0.902,0.0001,730,774,2,50,0.01,1504,18
0.918,0.0001,784,820,2,50,0.01,1604,18
0.93,0.0001,843,861,2,50,0.01,1704,18
0.91,0.0001,885,919,2,50,0.01,1804,18
0.926,0.0001,943,961,2,50,0.01,1904,18
0.94,0.0001,992,1012,2,50,0.01,2004,18
0.508,0.0001,50,54,2,50,0.01,104,19
0.508,0.0001,98,106,2,50,0.01,204,19
0.508,0.0001,149,155,2,50,0.01,304,19
0.52,0.0001,197,207,2,50,0.01,404,19
0.63,0.0001,249,255,2,50,0.01,504,19
0.536,0.0001,299,305,2,50,0.01,604,19
0.546,0.0001,346,358,2,50,0.01,704,19
0.612,0.0001,400,404,2,50,0.01,804,19
0.624,0.0001,448,456,2,50,0.01,904,19
0.68,0.0001,495,509,2,50,0.01,1004,19
0.752,0.0001,544,560,2,50,0.01,1104,19
0.806,0.0001,596,608,2,50,0.01,1204,19
0.854,0.0001,649,655,2,50,0.01,1304,19
0.874,0.0001,702,702,2,50,0.01,1404,19
0.872,0.0001,754,750,2,50,0.01,1504,19
0.886,0.0001,798,806,2,50,0.01,1604,19
0.902,0.0001,856,848,2,50,0.01,1704,19
0.904,0.0001,908,896,2,50,0.01,1804,19
0.918,0.0001,962,942,2,50,0.01,1904,19
0.922,0.0001,1006,998,2,50,0.01,2004,19
0.56,0.0001,55,49,2,50,0.01,104,20
0.572,0.0001,106,98,2,50,0.01,204,20
0.572,0.0001,154,150,2,50,0.01,304,20
0.596,0.0001,208,196,2,50,0.01,404,20
0.696,0.0001,252,252,2,50,0.01,504,20
0.726,0.0001,301,303,2,50,0.01,604,20
0.736,0.0001,354,350,2,50,0.01,704,20
0.76,0.0001,400,404,2,50,0.01,804,20
0.754,0.0001,449,455,2,50,0.01,904,20
0.762,0.0001,496,508,2,50,0.01,1004,20
0.794,0.0001,546,558,2,50,0.01,1104,20
0.796,0.0001,590,614,2,50,0.01,1204,20
0.808,0.0001,639,665,2,50,0.01,1304,20
0.818,0.0001,693,711,2,50,0.01,1404,20
0.832,0.0001,744,760,2,50,0.01,1504,20
0.87,0.0001,798,806,2,50,0.01,1604,20
0.88,0.0001,852,852,2,50,0.01,1704,20
0.886,0.0001,901,903,2,50,0.01,1804,20
0.876,0.0001,955,949,2,50,0.01,1904,20
0.884,0.0001,1002,1002,2,50,0.01,2004,20
0.542,0.001,41,63,2,50,0.0001,104,1
0.542,0.001,94,110,2,50,0.0001,204,1
0.542,0.001,148,156,2,50,0.0001,304,1
0.542,0.001,201,203,2,50,0.0001,404,1
0.54,0.001,251,253,2,50,0.0001,504,1
0.54,0.001,311,293,2,50,0.0001,604,1
0.536,0.001,352,352,2,50,0.0001,704,1
0.538,0.001,398,406,2,50,0.0001,804,1
0.538,0.001,452,452,2,50,0.0001,904,1
0.54,0.001,501,503,2,50,0.0001,1004,1
0.542,0.001,553,551,2,50,0.0001,1104,1
0.54,0.001,604,600,2,50,0.0001,1204,1
0.544,0.001,652,652,2,50,0.0001,1304,1
0.544,0.001,701,703,2,50,0.0001,1404,1
0.544,0.001,753,751,2,50,0.0001,1504,1
0.546,0.001,800,804,2,50,0.0001,1604,1
0.544,0.001,856,848,2,50,0.0001,1704,1
0.544,0.001,902,902,2,50,0.0001,1804,1
0.544,0.001,956,948,2,50,0.0001,1904,1
0.546,0.001,1001,1003,2,50,0.0001,2004,1
0.486,0.001,59,45,2,50,0.0001,104,2
0.486,0.001,111,93,2,50,0.0001,204,2
0.486,0.001,153,151,2,50,0.0001,304,2
0.486,0.001,201,203,2,50,0.0001,404,2
0.486,0.001,264,240,2,50,0.0001,504,2
0.486,0.001,313,291,2,50,0.0001,604,2
0.486,0.001,364,340,2,50,0.0001,704,2
0.486,0.001,413,391,2,50,0.0001,804,2
0.486,0.001,464,440,2,50,0.0001,904,2
0.486,0.001,517,487,2,50,0.0001,1004,2
0.486,0.001,558,546,2,50,0.0001,1104,2
0.486,0.001,610,594,2,50,0.0001,1204,2
0.486,0.001,658,646,2,50,0.0001,1304,2
0.486,0.001,700,704,2,50,0.0001,1404,2
0.486,0.001,756,748,2,50,0.0001,1504,2
0.486,0.001,798,806,2,50,0.0001,1604,2
0.486,0.001,851,853,2,50,0.0001,1704,2
0.486,0.001,898,906,2,50,0.0001,1804,2
0.486,0.001,954,950,2,50,0.0001,1904,2
0.486,0.001,1009,995,2,50,0.0001,2004,2
0.526,0.001,43,61,2,50,0.0001,104,3
0.524,0.001,89,115,2,50,0.0001,204,3
0.524,0.001,143,161,2,50,0.0001,304,3
0.524,0.001,198,206,2,50,0.0001,404,3
0.524,0.001,257,247,2,50,0.0001,504,3
0.524,0.001,305,299,2,50,0.0001,604,3
0.524,0.001,360,344,2,50,0.0001,704,3
0.526,0.001,408,396,2,50,0.0001,804,3
0.528,0.001,458,446,2,50,0.0001,904,3
0.53,0.001,509,495,2,50,0.0001,1004,3
0.532,0.001,562,542,2,50,0.0001,1104,3
0.534,0.001,612,592,2,50,0.0001,1204,3
0.536,0.001,654,650,2,50,0.0001,1304,3
0.534,0.001,709,695,2,50,0.0001,1404,3
0.532,0.001,752,752,2,50,0.0001,1504,3
0.53,0.001,795,809,2,50,0.0001,1604,3
0.53,0.001,848,856,2,50,0.0001,1704,3
0.53,0.001,899,905,2,50,0.0001,1804,3
0.53,0.001,948,956,2,50,0.0001,1904,3
0.53,0.001,1001,1003,2,50,0.0001,2004,3
0.566,0.001,50,54,2,50,0.0001,104,4
0.566,0.001,105,99,2,50,0.0001,204,4
0.566,0.001,155,149,2,50,0.0001,304,4
0.566,0.001,199,205,2,50,0.0001,404,4
0.566,0.001,244,260,2,50,0.0001,504,4
0.566,0.001,300,304,2,50,0.0001,604,4
0.566,0.001,350,354,2,50,0.0001,704,4
0.566,0.001,394,410,2,50,0.0001,804,4
0.566,0.001,437,467,2,50,0.0001,904,4
0.568,0.001,483,521,2,50,0.0001,1004,4
0.568,0.001,532,572,2,50,0.0001,1104,4
0.568,0.001,583,621,2,50,0.0001,1204,4
0.57,0.001,643,661,2,50,0.0001,1304,4
0.57,0.001,692,712,2,50,0.0001,1404,4
0.57,0.001,741,763,2,50,0.0001,1504,4
0.572,0.001,791,813,2,50,0.0001,1604,4
0.574,0.001,840,864,2,50,0.0001,1704,4
0.574,0.001,886,918,2,50,0.0001,1804,4
0.574,0.001,938,966,2,50,0.0001,1904,4
0.574,0.001,986,1018,2,50,0.0001,2004,4
0.5,0.001,54,50,2,50,0.0001,104,5
0.5,0.001,111,93,2,50,0.0001,204,5
0.5,0.001,161,143,2,50,0.0001,304,5
0.5,0.001,207,197,2,50,0.0001,404,5
0.5,0.001,255,249,2,50,0.0001,504,5
0.5,0.001,306,298,2,50,0.0001,604,5
0.5,0.001,349,355,2,50,0.0001,704,5
0.5,0.001,392,412,2,50,0.0001,804,5
0.5,0.001,446,458,2,50,0.0001,904,5
0.5,0.001,493,511,2,50,0.0001,1004,5
0.5,0.001,543,561,2,50,0.0001,1104,5
0.5,0.001,593,611,2,50,0.0001,1204,5
0.5,0.001,644,660,2,50,0.0001,1304,5
0.5,0.001,691,713,2,50,0.0001,1404,5
0.5,0.001,740,764,2,50,0.0001,1504,5
0.504,0.001,790,814,2,50,0.0001,1604,5
0.508,0.001,841,863,2,50,0.0001,1704,5
0.514,0.001,899,905,2,50,0.0001,1804,5
0.514,0.001,950,954,2,50,0.0001,1904,5
0.51,0.001,1002,1002,2,50,0.0001,2004,5
0.484,0.001,51,53,2,50,0.0001,104,6
0.484,0.001,101,103,2,50,0.0001,204,6
0.484,0.001,149,155,2,50,0.0001,304,6
0.484,0.001,197,207,2,50,0.0001,404,6
0.484,0.001,243,261,2,50,0.0001,504,6
0.484,0.001,290,314,2,50,0.0001,604,6
0.484,0.001,336,368,2,50,0.0001,704,6
0.484,0.001,375,429,2,50,0.0001,804,6
0.484,0.001,428,476,2,50,0.0001,904,6
0.484,0.001,479,525,2,50,0.0001,1004,6
0.484,0.001,532,572,2,50,0.0001,1104,6
0.484,0.001,580,624,2,50,0.0001,1204,6
0.484,0.001,630,674,2,50,0.0001,1304,6
0.484,0.001,683,721,2,50,0.0001,1404,6
0.484,0.001,735,769,2,50,0.0001,1504,6
0.484,0.001,786,818,2,50,0.0001,1604,6
0.484,0.001,847,857,2,50,0.0001,1704,6
0.484,0.001,890,914,2,50,0.0001,1804,6
0.484,0.001,945,959,2,50,0.0001,1904,6
0.484,0.001,994,1010,2,50,0.0001,2004,6
0.482,0.001,57,47,2,50,0.0001,104,7
0.482,0.001,116,88,2,50,0.0001,204,7
0.48,0.001,167,137,2,50,0.0001,304,7
0.482,0.001,216,188,2,50,0.0001,404,7
0.482,0.001,265,239,2,50,0.0001,504,7
0.484,0.001,305,299,2,50,0.0001,604,7
0.488,0.001,356,348,2,50,0.0001,704,7
0.486,0.001,409,395,2,50,0.0001,804,7
0.488,0.001,454,450,2,50,0.0001,904,7
0.492,0.001,504,500,2,50,0.0001,1004,7
0.498,0.001,549,555,2,50,0.0001,1104,7
0.508,0.001,601,603,2,50,0.0001,1204,7
0.516,0.001,659,645,2,50,0.0001,1304,7
0.518,0.001,705,699,2,50,0.0001,1404,7
0.526,0.001,748,756,2,50,0.0001,1504,7
0.538,0.001,802,802,2,50,0.0001,1604,7
0.544,0.001,860,844,2,50,0.0001,1704,7
0.554,0.001,911,893,2,50,0.0001,1804,7
0.56,0.001,960,944,2,50,0.0001,1904,7
0.57,0.001,1014,990,2,50,0.0001,2004,7
0.446,0.001,65,39,2,50,0.0001,104,8
0.446,0.001,119,85,2,50,0.0001,204,8
0.446,0.001,164,140,2,50,0.0001,304,8
0.446,0.001,207,197,2,50,0.0001,404,8
0.446,0.001,252,252,2,50,0.0001,504,8
0.45,0.001,297,307,2,50,0.0001,604,8
0.45,0.001,356,348,2,50,0.0001,704,8
0.45,0.001,414,390,2,50,0.0001,804,8
0.452,0.001,465,439,2,50,0.0001,904,8
0.452,0.001,508,496,2,50,0.0001,1004,8
0.452,0.001,559,545,2,50,0.0001,1104,8
0.454,0.001,607,597,2,50,0.0001,1204,8
0.456,0.001,653,651,2,50,0.0001,1304,8
0.456,0.001,707,697,2,50,0.0001,1404,8
0.456,0.001,760,744,2,50,0.0001,1504,8
0.458,0.001,807,797,2,50,0.0001,1604,8
0.458,0.001,852,852,2,50,0.0001,1704,8
0.46,0.001,903,901,2,50,0.0001,1804,8
0.464,0.001,951,953,2,50,0.0001,1904,8
0.466,0.001,990,1014,2,50,0.0001,2004,8
0.416,0.001,47,57,2,50,0.0001,104,9
0.416,0.001,106,98,2,50,0.0001,204,9
0.416,0.001,158,146,2,50,0.0001,304,9
0.416,0.001,204,200,2,50,0.0001,404,9
0.416,0.001,260,244,2,50,0.0001,504,9
0.416,0.001,314,290,2,50,0.0001,604,9
0.416,0.001,367,337,2,50,0.0001,704,9
0.416,0.001,412,392,2,50,0.0001,804,9
0.416,0.001,467,437,2,50,0.0001,904,9
0.416,0.001,514,490,2,50,0.0001,1004,9
0.418,0.001,562,542,2,50,0.0001,1104,9
0.418,0.001,615,589,2,50,0.0001,1204,9
0.418,0.001,661,643,2,50,0.0001,1304,9
0.418,0.001,708,696,2,50,0.0001,1404,9
0.42,0.001,754,750,2,50,0.0001,1504,9
0.422,0.001,802,802,2,50,0.0001,1604,9
0.422,0.001,858,846,2,50,0.0001,1704,9
0.422,0.001,908,896,2,50,0.0001,1804,9
0.424,0.001,959,945,2,50,0.0001,1904,9
0.426,0.001,1005,999,2,50,0.0001,2004,9
0.552,0.001,52,52,2,50,0.0001,104,10
0.552,0.001,98,106,2,50,0.0001,204,10
0.552,0.001,145,159,2,50,0.0001,304,10
0.552,0.001,193,211,2,50,0.0001,404,10
0.552,0.001,238,266,2,50,0.0001,504,10
0.552,0.001,291,313,2,50,0.0001,604,10
0.552,0.001,354,350,2,50,0.0001,704,10
0.552,0.001,403,401,2,50,0.0001,804,10
0.552,0.001,455,449,2,50,0.0001,904,10
0.552,0.001,504,500,2,50,0.0001,1004,10
0.552,0.001,551,553,2,50,0.0001,1104,10
0.552,0.001,601,603,2,50,0.0001,1204,10
0.552,0.001,649,655,2,50,0.0001,1304,10
0.552,0.001,691,713,2,50,0.0001,1404,10
0.552,0.001,746,758,2,50,0.0001,1504,10
0.552,0.001,790,814,2,50,0.0001,1604,10
0.552,0.001,836,868,2,50,0.0001,1704,10
0.552,0.001,885,919,2,50,0.0001,1804,10
0.552,0.001,930,974,2,50,0.0001,1904,10
0.552,0.001,976,1028,2,50,0.0001,2004,10
0.558,0.001,61,43,2,50,0.0001,104,11
0.556,0.001,111,93,2,50,0.0001,204,11
0.556,0.001,165,139,2,50,0.0001,304,11
0.556,0.001,213,191,2,50,0.0001,404,11
0.556,0.001,266,238,2,50,0.0001,504,11
0.56,0.001,314,290,2,50,0.0001,604,11
0.56,0.001,382,322,2,50,0.0001,704,11
0.56,0.001,425,379,2,50,0.0001,804,11
0.558,0.001,468,436,2,50,0.0001,904,11
0.558,0.001,521,483,2,50,0.0001,1004,11
0.56,0.001,572,532,2,50,0.0001,1104,11
0.558,0.001,614,590,2,50,0.0001,1204,11
0.558,0.001,669,635,2,50,0.0001,1304,11
0.562,0.001,717,687,2,50,0.0001,1404,11
0.562,0.001,764,740,2,50,0.0001,1504,11
0.564,0.001,807,797,2,50,0.0001,1604,11
0.566,0.001,851,853,2,50,0.0001,1704,11
0.568,0.001,896,908,2,50,0.0001,1804,11
0.566,0.001,945,959,2,50,0.0001,1904,11
0.568,0.001,986,1018,2,50,0.0001,2004,11
0.506,0.001,50,54,2,50,0.0001,104,12
0.506,0.001,101,103,2,50,0.0001,204,12
0.506,0.001,146,158,2,50,0.0001,304,12
0.508,0.001,191,213,2,50,0.0001,404,12
0.51,0.001,240,264,2,50,0.0001,504,12
0.508,0.001,297,307,2,50,0.0001,604,12
0.508,0.001,348,356,2,50,0.0001,704,12
0.512,0.001,400,404,2,50,0.0001,804,12
0.514,0.001,450,454,2,50,0.0001,904,12
0.516,0.001,501,503,2,50,0.0001,1004,12
0.518,0.001,548,556,2,50,0.0001,1104,12
0.522,0.001,605,599,2,50,0.0001,1204,12
0.522,0.001,659,645,2,50,0.0001,1304,12
0.524,0.001,707,697,2,50,0.0001,1404,12
0.528,0.001,759,745,2,50,0.0001,1504,12
0.53,0.001,803,801,2,50,0.0001,1604,12
0.54,0.001,854,850,2,50,0.0001,1704,12
0.544,0.001,904,900,2,50,0.0001,1804,12
0.552,0.001,960,944,2,50,0.0001,1904,12
0.552,0.001,1013,991,2,50,0.0001,2004,12
0.524,0.001,51,53,2,50,0.0001,104,13
0.524,0.001,101,103,2,50,0.0001,204,13
0.524,0.001,146,158,2,50,0.0001,304,13
0.524,0.001,185,219,2,50,0.0001,404,13
0.524,0.001,230,274,2,50,0.0001,504,13
0.524,0.001,282,322,2,50,0.0001,604,13
0.524,0.001,327,377,2,50,0.0001,704,13
0.524,0.001,369,435,2,50,0.0001,804,13
0.524,0.001,419,485,2,50,0.0001,904,13
0.524,0.001,470,534,2,50,0.0001,1004,13
0.524,0.001,523,581,2,50,0.0001,1104,13
0.524,0.001,569,635,2,50,0.0001,1204,13
0.524,0.001,620,684,2,50,0.0001,1304,13
0.524,0.001,674,730,2,50,0.0001,1404,13
0.524,0.001,723,781,2,50,0.0001,1504,13
0.524,0.001,776,828,2,50,0.0001,1604,13
0.524,0.001,829,875,2,50,0.0001,1704,13
0.524,0.001,888,916,2,50,0.0001,1804,13
0.522,0.001,936,968,2,50,0.0001,1904,13
0.522,0.001,990,1014,2,50,0.0001,2004,13
0.518,0.001,56,48,2,50,0.0001,104,14
0.512,0.001,108,96,2,50,0.0001,204,14
0.516,0.001,153,151,2,50,0.0001,304,14
0.52,0.001,210,194,2,50,0.0001,404,14
0.518,0.001,257,247,2,50,0.0001,504,14
0.52,0.001,306,298,2,50,0.0001,604,14
0.52,0.001,349,355,2,50,0.0001,704,14
0.524,0.001,401,403,2,50,0.0001,804,14
0.532,0.001,449,455,2,50,0.0001,904,14
0.532,0.001,498,506,2,50,0.0001,1004,14
0.534,0.001,548,556,2,50,0.0001,1104,14
0.54,0.001,602,602,2,50,0.0001,1204,14
0.544,0.001,659,645,2,50,0.0001,1304,14
0.546,0.001,713,691,2,50,0.0001,1404,14
0.552,0.001,759,745,2,50,0.0001,1504,14
0.546,0.001,810,794,2,50,0.0001,1604,14
0.552,0.001,861,843,2,50,0.0001,1704,14
0.562,0.001,914,890,2,50,0.0001,1804,14
0.568,0.001,968,936,2,50,0.0001,1904,14
0.58,0.001,1012,992,2,50,0.0001,2004,14
0.572,0.001,46,58,2,50,0.0001,104,15
0.572,0.001,86,118,2,50,0.0001,204,15
0.568,0.001,130,174,2,50,0.0001,304,15
0.566,0.001,173,231,2,50,0.0001,404,15
0.568,0.001,235,269,2,50,0.0001,504,15
0.57,0.001,285,319,2,50,0.0001,604,15
0.572,0.001,338,366,2,50,0.0001,704,15
0.57,0.001,385,419,2,50,0.0001,804,15
0.572,0.001,426,478,2,50,0.0001,904,15
0.572,0.001,482,522,2,50,0.0001,1004,15
0.576,0.001,521,583,2,50,0.0001,1104,15
0.578,0.001,570,634,2,50,0.0001,1204,15
0.578,0.001,620,684,2,50,0.0001,1304,15
0.584,0.001,679,725,2,50,0.0001,1404,15
0.584,0.001,732,772,2,50,0.0001,1504,15
0.594,0.001,787,817,2,50,0.0001,1604,15
0.598,0.001,839,865,2,50,0.0001,1704,15
0.6,0.001,887,917,2,50,0.0001,1804,15
0.598,0.001,930,974,2,50,0.0001,1904,15
0.598,0.001,988,1016,2,50,0.0001,2004,15
0.414,0.001,56,48,2,50,0.0001,104,16
0.414,0.001,102,102,2,50,0.0001,204,16
0.414,0.001,151,153,2,50,0.0001,304,16
0.414,0.001,196,208,2,50,0.0001,404,16
0.414,0.001,243,261,2,50,0.0001,504,16
0.414,0.001,283,321,2,50,0.0001,604,16
0.414,0.001,332,372,2,50,0.0001,704,16
0.414,0.001,377,427,2,50,0.0001,804,16
0.416,0.001,432,472,2,50,0.0001,904,16
0.414,0.001,483,521,2,50,0.0001,1004,16
0.416,0.001,528,576,2,50,0.0001,1104,16
0.418,0.001,581,623,2,50,0.0001,1204,16
0.418,0.001,636,668,2,50,0.0001,1304,16
0.418,0.001,679,725,2,50,0.0001,1404,16
0.418,0.001,726,778,2,50,0.0001,1504,16
0.418,0.001,764,840,2,50,0.0001,1604,16
0.418,0.001,819,885,2,50,0.0001,1704,16
0.42,0.001,871,933,2,50,0.0001,1804,16
0.422,0.001,924,980,2,50,0.0001,1904,16
0.422,0.001,981,1023,2,50,0.0001,2004,16
0.45,0.001,42,62,2,50,0.0001,104,17
0.456,0.001,89,115,2,50,0.0001,204,17
0.46,0.001,137,167,2,50,0.0001,304,17
0.462,0.001,188,216,2,50,0.0001,404,17
0.464,0.001,236,268,2,50,0.0001,504,17
0.466,0.001,294,310,2,50,0.0001,604,17
0.464,0.001,345,359,2,50,0.0001,704,17
0.464,0.001,398,406,2,50,0.0001,804,17
0.466,0.001,451,453,2,50,0.0001,904,17
0.468,0.001,507,497,2,50,0.0001,1004,17
0.474,0.001,553,551,2,50,0.0001,1104,17
0.474,0.001,594,610,2,50,0.0001,1204,17
0.482,0.001,653,651,2,50,0.0001,1304,17
0.49,0.001,699,705,2,50,0.0001,1404,17
0.5,0.001,748,756,2,50,0.0001,1504,17
0.502,0.001,800,804,2,50,0.0001,1604,17
0.5,0.001,840,864,2,50,0.0001,1704,17
0.502,0.001,885,919,2,50,0.0001,1804,17
0.5,0.001,942,962,2,50,0.0001,1904,17
0.498,0.001,997,1007,2,50,0.0001,2004,17
0.44,0.001,59,45,2,50,0.0001,104,18
0.44,0.001,113,91,2,50,0.0001,204,18
0.44,0.001,166,138,2,50,0.0001,304,18
0.442,0.001,219,185,2,50,0.0001,404,18
0.442,0.001,278,226,2,50,0.0001,504,18
0.442,0.001,326,278,2,50,0.0001,604,18
0.444,0.001,380,324,2,50,0.0001,704,18
0.448,0.001,426,378,2,50,0.0001,804,18
0.448,0.001,474,430,2,50,0.0001,904,18
0.448,0.001,521,483,2,50,0.0001,1004,18
0.452,0.001,570,534,2,50,0.0001,1104,18
0.456,0.001,616,588,2,50,0.0001,1204,18
0.458,0.001,671,633,2,50,0.0001,1304,18
0.464,0.001,718,686,2,50,0.0001,1404,18
0.464,0.001,771,733,2,50,0.0001,1504,18
0.47,0.001,821,783,2,50,0.0001,1604,18
0.474,0.001,872,832,2,50,0.0001,1704,18
0.478,0.001,912,892,2,50,0.0001,1804,18
0.476,0.001,962,942,2,50,0.0001,1904,18
0.486,0.001,1007,997,2,50,0.0001,2004,18
0.514,0.001,56,48,2,50,0.0001,104,19
0.514,0.001,107,97,2,50,0.0001,204,19
0.514,0.001,165,139,2,50,0.0001,304,19
0.514,0.001,229,175,2,50,0.0001,404,19
0.514,0.001,277,227,2,50,0.0001,504,19
0.514,0.001,332,272,2,50,0.0001,604,19
0.514,0.001,386,318,2,50,0.0001,704,19
0.514,0.001,434,370,2,50,0.0001,804,19
0.514,0.001,485,419,2,50,0.0001,904,19
0.514,0.001,534,470,2,50,0.0001,1004,19
0.514,0.001,579,525,2,50,0.0001,1104,19
0.514,0.001,623,581,2,50,0.0001,1204,19
0.514,0.001,669,635,2,50,0.0001,1304,19
0.514,0.001,714,690,2,50,0.0001,1404,19
0.514,0.001,760,744,2,50,0.0001,1504,19
0.514,0.001,816,788,2,50,0.0001,1604,19
0.514,0.001,863,841,2,50,0.0001,1704,19
0.514,0.001,905,899,2,50,0.0001,1804,19
0.514,0.001,954,950,2,50,0.0001,1904,19
0.514,0.001,1009,995,2,50,0.0001,2004,19
0.506,0.001,61,43,2,50,0.0001,104,20
0.508,0.001,113,91,2,50,0.0001,204,20
0.508,0.001,168,136,2,50,0.0001,304,20
0.512,0.001,218,186,2,50,0.0001,404,20
0.51,0.001,267,237,2,50,0.0001,504,20
0.514,0.001,307,297,2,50,0.0001,604,20
0.514,0.001,365,339,2,50,0.0001,704,20
0.516,0.001,419,385,2,50,0.0001,804,20
0.516,0.001,471,433,2,50,0.0001,904,20
0.516,0.001,526,478,2,50,0.0001,1004,20
0.516,0.001,577,527,2,50,0.0001,1104,20
0.516,0.001,625,579,2,50,0.0001,1204,20
0.518,0.001,669,635,2,50,0.0001,1304,20
0.518,0.001,721,683,2,50,0.0001,1404,20
0.52,0.001,768,736,2,50,0.0001,1504,20
0.524,0.001,826,778,2,50,0.0001,1604,20
0.528,0.001,875,829,2,50,0.0001,1704,20
0.53,0.001,918,886,2,50,0.0001,1804,20
0.53,0.001,956,948,2,50,0.0001,1904,20
0.528,0.001,1004,1000,2,50,0.0001,2004,20
0.462,0.001,56,48,2,50,0.001,104,1
0.458,0.001,100,104,2,50,0.001,204,1
0.456,0.001,151,153,2,50,0.001,304,1
0.45,0.001,196,208,2,50,0.001,404,1
0.46,0.001,246,258,2,50,0.001,504,1
0.458,0.001,307,297,2,50,0.001,604,1
0.484,0.001,357,347,2,50,0.001,704,1
0.502,0.001,400,404,2,50,0.001,804,1
0.51,0.001,450,454,2,50,0.001,904,1
0.522,0.001,493,511,2,50,0.001,1004,1
0.55,0.001,539,565,2,50,0.001,1104,1
0.578,0.001,585,619,2,50,0.001,1204,1
0.618,0.001,635,669,2,50,0.001,1304,1
0.66,0.001,682,722,2,50,0.001,1404,1
0.702,0.001,727,777,2,50,0.001,1504,1
0.714,0.001,783,821,2,50,0.001,1604,1
0.744,0.001,838,866,2,50,0.001,1704,1
0.762,0.001,888,916,2,50,0.001,1804,1
0.756,0.001,939,965,2,50,0.001,1904,1
0.792,0.001,990,1014,2,50,0.001,2004,1
0.528,0.001,44,60,2,50,0.001,104,2
0.532,0.001,87,117,2,50,0.001,204,2
0.538,0.001,133,171,2,50,0.001,304,2
0.542,0.001,177,227,2,50,0.001,404,2
0.534,0.001,226,278,2,50,0.001,504,2
0.522,0.001,269,335,2,50,0.001,604,2
0.518,0.001,324,380,2,50,0.001,704,2
0.518,0.001,377,427,2,50,0.001,804,2
0.518,0.001,423,481,2,50,0.001,904,2
0.518,0.001,469,535,2,50,0.001,1004,2
0.518,0.001,525,579,2,50,0.001,1104,2
0.518,0.001,582,622,2,50,0.001,1204,2
0.532,0.001,639,665,2,50,0.001,1304,2
0.554,0.001,694,710,2,50,0.001,1404,2
0.596,0.001,746,758,2,50,0.001,1504,2
0.626,0.001,800,804,2,50,0.001,1604,2
0.654,0.001,848,856,2,50,0.001,1704,2
0.68,0.001,902,902,2,50,0.001,1804,2
0.676,0.001,955,949,2,50,0.001,1904,2
0.69,0.001,1010,994,2,50,0.001,2004,2
0.476,0.001,60,44,2,50,0.001,104,3
0.478,0.001,113,91,2,50,0.001,204,3
0.476,0.001,153,151,2,50,0.001,304,3
0.474,0.001,208,196,2,50,0.001,404,3
0.47,0.001,258,246,2,50,0.001,504,3
0.468,0.001,303,301,2,50,0.001,604,3
0.466,0.001,350,354,2,50,0.001,704,3
0.468,0.001,395,409,2,50,0.001,804,3
0.468,0.001,449,455,2,50,0.001,904,3
0.468,0.001,499,505,2,50,0.001,1004,3
0.456,0.001,549,555,2,50,0.001,1104,3
0.458,0.001,607,597,2,50,0.001,1204,3
0.482,0.001,656,648,2,50,0.001,1304,3
0.554,0.001,702,702,2,50,0.001,1404,3
0.588,0.001,751,753,2,50,0.001,1504,3
0.626,0.001,802,802,2,50,0.001,1604,3
0.66,0.001,846,858,2,50,0.001,1704,3
0.706,0.001,898,906,2,50,0.001,1804,3
0.824,0.001,939,965,2,50,0.001,1904,3
0.832,0.001,1001,1003,2,50,0.001,2004,3
0.5,0.001,60,44,2,50,0.001,104,4
0.502,0.001,110,94,2,50,0.001,204,4
0.5,0.001,157,147,2,50,0.001,304,4
0.506,0.001,211,193,2,50,0.001,404,4
0.51,0.001,266,238,2,50,0.001,504,4
0.496,0.001,314,290,2,50,0.001,604,4
0.508,0.001,360,344,2,50,0.001,704,4
0.524,0.001,414,390,2,50,0.001,804,4
0.534,0.001,461,443,2,50,0.001,904,4
0.574,0.001,510,494,2,50,0.001,1004,4
0.588,0.001,559,545,2,50,0.001,1104,4
0.604,0.001,606,598,2,50,0.001,1204,4
0.628,0.001,653,651,2,50,0.001,1304,4
0.666,0.001,701,703,2,50,0.001,1404,4
0.678,0.001,743,761,2,50,0.001,1504,4
0.692,0.001,796,808,2,50,0.001,1604,4
0.694,0.001,844,860,2,50,0.001,1704,4
0.714,0.001,892,912,2,50,0.001,1804,4
0.732,0.001,952,952,2,50,0.001,1904,4
0.744,0.001,1008,996,2,50,0.001,2004,4
0.494,0.001,45,59,2,50,0.001,104,5
0.494,0.001,90,114,2,50,0.001,204,5
0.494,0.001,143,161,2,50,0.001,304,5
0.494,0.001,194,210,2,50,0.001,404,5
0.494,0.001,249,255,2,50,0.001,504,5
0.494,0.001,307,297,2,50,0.001,604,5
0.496,0.001,354,350,2,50,0.001,704,5
0.496,0.001,395,409,2,50,0.001,804,5
0.494,0.001,439,465,2,50,0.001,904,5
0.502,0.001,493,511,2,50,0.001,1004,5
0.502,0.001,548,556,2,50,0.001,1104,5
0.544,0.001,596,608,2,50,0.001,1204,5
0.582,0.001,648,656,2,50,0.001,1304,5
0.59,0.001,698,706,2,50,0.001,1404,5
0.612,0.001,748,756,2,50,0.001,1504,5
0.632,0.001,805,799,2,50,0.001,1604,5
0.646,0.001,863,841,2,50,0.001,1704,5
0.656,0.001,910,894,2,50,0.001,1804,5
0.672,0.001,953,951,2,50,0.001,1904,5
0.684,0.001,1002,1002,2,50,0.001,2004,5
0.48,0.001,47,57,2,50,0.001,104,6
0.478,0.001,105,99,2,50,0.001,204,6
0.478,0.001,158,146,2,50,0.001,304,6
0.476,0.001,205,199,2,50,0.001,404,6
0.478,0.001,269,235,2,50,0.001,504,6
0.486,0.001,313,291,2,50,0.001,604,6
0.49,0.001,354,350,2,50,0.001,704,6
0.5,0.001,405,399,2,50,0.001,804,6
0.51,0.001,454,450,2,50,0.001,904,6
0.552,0.001,509,495,2,50,0.001,1004,6
0.564,0.001,554,550,2,50,0.001,1104,6
0.596,0.001,598,606,2,50,0.001,1204,6
0.622,0.001,641,663,2,50,0.001,1304,6
0.662,0.001,694,710,2,50,0.001,1404,6
0.704,0.001,749,755,2,50,0.001,1504,6
0.716,0.001,806,798,2,50,0.001,1604,6
0.738,0.001,852,852,2,50,0.001,1704,6
0.742,0.001,897,907,2,50,0.001,1804,6
0.742,0.001,950,954,2,50,0.001,1904,6
0.754,0.001,1003,1001,2,50,0.001,2004,6
0.478,0.001,52,52,2,50,0.001,104,7
0.478,0.001,104,100,2,50,0.001,204,7
0.478,0.001,147,157,2,50,0.001,304,7
0.478,0.001,188,216,2,50,0.001,404,7
0.478,0.001,239,265,2,50,0.001,504,7
0.478,0.001,292,312,2,50,0.001,604,7
0.478,0.001,343,361,2,50,0.001,704,7
0.478,0.001,398,406,2,50,0.001,804,7
0.478,0.001,450,454,2,50,0.001,904,7
0.478,0.001,504,500,2,50,0.001,1004,7
0.48,0.001,553,551,2,50,0.001,1104,7
0.486,0.001,601,603,2,50,0.001,1204,7
0.508,0.001,647,657,2,50,0.001,1304,7
0.538,0.001,700,704,2,50,0.001,1404,7
0.554,0.001,745,759,2,50,0.001,1504,7
0.58,0.001,795,809,2,50,0.001,1604,7
0.614,0.001,851,853,2,50,0.001,1704,7
0.652,0.001,890,914,2,50,0.001,1804,7
0.666,0.001,941,963,2,50,0.001,1904,7
0.708,0.001,991,1013,2,50,0.001,2004,7
0.516,0.001,52,52,2,50,0.001,104,8
0.518,0.001,93,111,2,50,0.001,204,8
0.512,0.001,139,165,2,50,0.001,304,8
0.518,0.001,186,218,2,50,0.001,404,8
0.52,0.001,235,269,2,50,0.001,504,8
0.528,0.001,282,322,2,50,0.001,604,8
0.54,0.001,342,362,2,50,0.001,704,8
0.552,0.001,389,415,2,50,0.001,804,8
0.554,0.001,441,463,2,50,0.001,904,8
0.56,0.001,487,517,2,50,0.001,1004,8
0.56,0.001,548,556,2,50,0.001,1104,8
0.564,0.001,598,606,2,50,0.001,1204,8
0.566,0.001,653,651,2,50,0.001,1304,8
0.566,0.001,707,697,2,50,0.001,1404,8
0.584,0.001,751,753,2,50,0.001,1504,8
0.596,0.001,807,797,2,50,0.001,1604,8
0.602,0.001,860,844,2,50,0.001,1704,8
0.618,0.001,911,893,2,50,0.001,1804,8
0.624,0.001,968,936,2,50,0.001,1904,8
0.66,0.001,1016,988,2,50,0.001,2004,8
0.52,0.001,52,52,2,50,0.001,104,9
0.524,0.001,101,103,2,50,0.001,204,9
0.518,0.001,150,154,2,50,0.001,304,9
0.508,0.001,202,202,2,50,0.001,404,9
0.498,0.001,244,260,2,50,0.001,504,9
0.498,0.001,302,302,2,50,0.001,604,9
0.496,0.001,353,351,2,50,0.001,704,9
0.504,0.001,407,397,2,50,0.001,804,9
0.51,0.001,471,433,2,50,0.001,904,9
0.52,0.001,523,481,2,50,0.001,1004,9
0.534,0.001,563,541,2,50,0.001,1104,9
0.526,0.001,610,594,2,50,0.001,1204,9
0.536,0.001,661,643,2,50,0.001,1304,9
0.526,0.001,708,696,2,50,0.001,1404,9
0.538,0.001,764,740,2,50,0.001,1504,9
0.562,0.001,816,788,2,50,0.001,1604,9
0.59,0.001,858,846,2,50,0.001,1704,9
0.636,0.001,910,894,2,50,0.001,1804,9
0.644,0.001,957,947,2,50,0.001,1904,9
0.706,0.001,1012,992,2,50,0.001,2004,9
0.53,0.001,55,49,2,50,0.001,104,10
0.546,0.001,100,104,2,50,0.001,204,10
0.568,0.001,150,154,2,50,0.001,304,10
0.568,0.001,205,199,2,50,0.001,404,10
0.566,0.001,253,251,2,50,0.001,504,10
0.532,0.001,300,304,2,50,0.001,604,10
0.502,0.001,353,351,2,50,0.001,704,10
0.49,0.001,405,399,2,50,0.001,804,10
0.508,0.001,458,446,2,50,0.001,904,10
0.532,0.001,508,496,2,50,0.001,1004,10
0.568,0.001,557,547,2,50,0.001,1104,10
0.612,0.001,607,597,2,50,0.001,1204,10
0.71,0.001,656,648,2,50,0.001,1304,10
0.778,0.001,706,698,2,50,0.001,1404,10
0.774,0.001,754,750,2,50,0.001,1504,10
0.77,0.001,808,796,2,50,0.001,1604,10
0.792,0.001,855,849,2,50,0.001,1704,10
0.812,0.001,900,904,2,50,0.001,1804,10
0.82,0.001,955,949,2,50,0.001,1904,10
0.82,0.001,1005,999,2,50,0.001,2004,10
0.504,0.001,55,49,2,50,0.001,104,11
0.504,0.001,115,89,2,50,0.001,204,11
0.504,0.001,163,141,2,50,0.001,304,11
0.51,0.001,216,188,2,50,0.001,404,11
0.51,0.001,255,249,2,50,0.001,504,11
0.53,0.001,306,298,2,50,0.001,604,11
0.544,0.001,353,351,2,50,0.001,704,11
0.55,0.001,402,402,2,50,0.001,804,11
0.554,0.001,453,451,2,50,0.001,904,11
0.58,0.001,498,506,2,50,0.001,1004,11
0.6,0.001,545,559,2,50,0.001,1104,11
0.598,0.001,598,606,2,50,0.001,1204,11
0.598,0.001,652,652,2,50,0.001,1304,11
0.602,0.001,703,701,2,50,0.001,1404,11
0.598,0.001,754,750,2,50,0.001,1504,11
0.6,0.001,812,792,2,50,0.001,1604,11
0.612,0.001,862,842,2,50,0.001,1704,11
0.682,0.001,912,892,2,50,0.001,1804,11
0.718,0.001,955,949,2,50,0.001,1904,11
0.742,0.001,1000,1004,2,50,0.001,2004,11
0.518,0.001,50,54,2,50,0.001,104,12
0.518,0.001,100,104,2,50,0.001,204,12
0.518,0.001,148,156,2,50,0.001,304,12
0.518,0.001,200,204,2,50,0.001,404,12
0.518,0.001,243,261,2,50,0.001,504,12
0.518,0.001,293,311,2,50,0.001,604,12
0.518,0.001,340,364,2,50,0.001,704,12
0.518,0.001,393,411,2,50,0.001,804,12
0.518,0.001,437,467,2,50,0.001,904,12
0.518,0.001,494,510,2,50,0.001,1004,12
0.516,0.001,535,569,2,50,0.001,1104,12
0.52,0.001,587,617,2,50,0.001,1204,12
0.542,0.001,639,665,2,50,0.001,1304,12
0.558,0.001,691,713,2,50,0.001,1404,12
0.564,0.001,739,765,2,50,0.001,1504,12
0.576,0.001,789,815,2,50,0.001,1604,12
0.61,0.001,849,855,2,50,0.001,1704,12
0.676,0.001,902,902,2,50,0.001,1804,12
0.684,0.001,945,959,2,50,0.001,1904,12
0.702,0.001,993,1011,2,50,0.001,2004,12
0.424,0.001,50,54,2,50,0.001,104,13
0.428,0.001,103,101,2,50,0.001,204,13
0.434,0.001,145,159,2,50,0.001,304,13
0.442,0.001,190,214,2,50,0.001,404,13
0.456,0.001,250,254,2,50,0.001,504,13
0.44,0.001,295,309,2,50,0.001,604,13
0.45,0.001,351,353,2,50,0.001,704,13
0.458,0.001,398,406,2,50,0.001,804,13
0.466,0.001,451,453,2,50,0.001,904,13
0.492,0.001,505,499,2,50,0.001,1004,13
0.514,0.001,555,549,2,50,0.001,1104,13
0.55,0.001,605,599,2,50,0.001,1204,13
0.61,0.001,649,655,2,50,0.001,1304,13
0.656,0.001,699,705,2,50,0.001,1404,13
0.704,0.001,747,757,2,50,0.001,1504,13
0.742,0.001,787,817,2,50,0.001,1604,13
0.746,0.001,844,860,2,50,0.001,1704,13
0.762,0.001,892,912,2,50,0.001,1804,13
0.784,0.001,939,965,2,50,0.001,1904,13
0.794,0.001,992,1012,2,50,0.001,2004,13
0.498,0.001,36,68,2,50,0.001,104,14
0.498,0.001,93,111,2,50,0.001,204,14
0.496,0.001,133,171,2,50,0.001,304,14
0.492,0.001,187,217,2,50,0.001,404,14
0.484,0.001,246,258,2,50,0.001,504,14
0.472,0.001,292,312,2,50,0.001,604,14
0.452,0.001,344,360,2,50,0.001,704,14
0.442,0.001,398,406,2,50,0.001,804,14
0.44,0.001,435,469,2,50,0.001,904,14
0.482,0.001,484,520,2,50,0.001,1004,14
0.526,0.001,537,567,2,50,0.001,1104,14
0.556,0.001,593,611,2,50,0.001,1204,14
0.59,0.001,645,659,2,50,0.001,1304,14
0.622,0.001,700,704,2,50,0.001,1404,14
0.652,0.001,748,756,2,50,0.001,1504,14
0.658,0.001,794,810,2,50,0.001,1604,14
0.67,0.001,844,860,2,50,0.001,1704,14
0.676,0.001,899,905,2,50,0.001,1804,14
0.682,0.001,946,958,2,50,0.001,1904,14
0.71,0.001,1000,1004,2,50,0.001,2004,14
0.492,0.001,54,50,2,50,0.001,104,15
0.492,0.001,98,106,2,50,0.001,204,15
0.492,0.001,145,159,2,50,0.001,304,15
0.492,0.001,203,201,2,50,0.001,404,15
0.492,0.001,251,253,2,50,0.001,504,15
0.492,0.001,302,302,2,50,0.001,604,15
0.492,0.001,351,353,2,50,0.001,704,15
0.492,0.001,403,401,2,50,0.001,804,15
0.492,0.001,458,446,2,50,0.001,904,15
0.528,0.001,513,491,2,50,0.001,1004,15
0.574,0.001,564,540,2,50,0.001,1104,15
0.612,0.001,606,598,2,50,0.001,1204,15
0.632,0.001,655,649,2,50,0.001,1304,15
0.672,0.001,709,695,2,50,0.001,1404,15
0.716,0.001,759,745,2,50,0.001,1504,15
0.748,0.001,805,799,2,50,0.001,1604,15
0.76,0.001,860,844,2,50,0.001,1704,15
0.784,0.001,912,892,2,50,0.001,1804,15
0.738,0.001,960,944,2,50,0.001,1904,15
0.736,0.001,998,1006,2,50,0.001,2004,15
0.452,0.001,50,54,2,50,0.001,104,16
0.452,0.001,99,105,2,50,0.001,204,16
0.452,0.001,145,159,2,50,0.001,304,16
0.452,0.001,204,200,2,50,0.001,404,16
0.458,0.001,252,252,2,50,0.001,504,16
0.458,0.001,306,298,2,50,0.001,604,16
0.456,0.001,356,348,2,50,0.001,704,16
0.488,0.001,409,395,2,50,0.001,804,16
0.562,0.001,466,438,2,50,0.001,904,16
0.598,0.001,508,496,2,50,0.001,1004,16
0.592,0.001,566,538,2,50,0.001,1104,16
0.604,0.001,616,588,2,50,0.001,1204,16
0.64,0.001,665,639,2,50,0.001,1304,16
0.676,0.001,715,689,2,50,0.001,1404,16
0.704,0.001,769,735,2,50,0.001,1504,16
0.718,0.001,820,784,2,50,0.001,1604,16
0.72,0.001,865,839,2,50,0.001,1704,16
0.726,0.001,912,892,2,50,0.001,1804,16
0.726,0.001,965,939,2,50,0.001,1904,16
0.736,0.001,1017,987,2,50,0.001,2004,16
0.47,0.001,43,61,2,50,0.001,104,17
0.494,0.001,91,113,2,50,0.001,204,17
0.5,0.001,142,162,2,50,0.001,304,17
0.52,0.001,188,216,2,50,0.001,404,17
0.54,0.001,242,262,2,50,0.001,504,17
0.582,0.001,292,312,2,50,0.001,604,17
0.614,0.001,344,360,2,50,0.001,704,17
0.63,0.001,395,409,2,50,0.001,804,17
0.65,0.001,440,464,2,50,0.001,904,17
0.67,0.001,490,514,2,50,0.001,1004,17
0.7,0.001,537,567,2,50,0.001,1104,17
0.704,0.001,586,618,2,50,0.001,1204,17
0.698,0.001,639,665,2,50,0.001,1304,17
0.708,0.001,693,711,2,50,0.001,1404,17
0.714,0.001,738,766,2,50,0.001,1504,17
0.712,0.001,794,810,2,50,0.001,1604,17
0.71,0.001,846,858,2,50,0.001,1704,17
0.71,0.001,904,900,2,50,0.001,1804,17
0.712,0.001,955,949,2,50,0.001,1904,17
0.708,0.001,1001,1003,2,50,0.001,2004,17
0.528,0.001,56,48,2,50,0.001,104,18
0.526,0.001,104,100,2,50,0.001,204,18
0.54,0.001,147,157,2,50,0.001,304,18
0.552,0.001,197,207,2,50,0.001,404,18
0.576,0.001,238,266,2,50,0.001,504,18
0.586,0.001,292,312,2,50,0.001,604,18
0.634,0.001,336,368,2,50,0.001,704,18
0.64,0.001,396,408,2,50,0.001,804,18
0.682,0.001,443,461,2,50,0.001,904,18
0.684,0.001,498,506,2,50,0.001,1004,18
0.684,0.001,544,560,2,50,0.001,1104,18
0.686,0.001,591,613,2,50,0.001,1204,18
0.692,0.001,652,652,2,50,0.001,1304,18
0.698,0.001,693,711,2,50,0.001,1404,18
0.704,0.001,739,765,2,50,0.001,1504,18
0.7,0.001,786,818,2,50,0.001,1604,18
0.706,0.001,835,869,2,50,0.001,1704,18
0.714,0.001,882,922,2,50,0.001,1804,18
0.746,0.001,936,968,2,50,0.001,1904,18
0.766,0.001,993,1011,2,50,0.001,2004,18
0.528,0.001,45,59,2,50,0.001,104,19
0.53,0.001,98,106,2,50,0.001,204,19
0.53,0.001,154,150,2,50,0.001,304,19
0.528,0.001,208,196,2,50,0.001,404,19
0.532,0.001,256,248,2,50,0.001,504,19
0.534,0.001,308,296,2,50,0.001,604,19
0.538,0.001,358,346,2,50,0.001,704,19
0.54,0.001,408,396,2,50,0.001,804,19
0.55,0.001,461,443,2,50,0.001,904,19
0.562,0.001,513,491,2,50,0.001,1004,19
0.566,0.001,573,531,2,50,0.001,1104,19
0.578,0.001,623,581,2,50,0.001,1204,19
0.592,0.001,673,631,2,50,0.001,1304,19
0.638,0.001,723,681,2,50,0.001,1404,19
0.662,0.001,781,723,2,50,0.001,1504,19
0.674,0.001,831,773,2,50,0.001,1604,19
0.69,0.001,875,829,2,50,0.001,1704,19
0.698,0.001,929,875,2,50,0.001,1804,19
0.698,0.001,984,920,2,50,0.001,1904,19
0.708,0.001,1026,978,2,50,0.001,2004,19
0.47,0.001,54,50,2,50,0.001,104,20
0.456,0.001,113,91,2,50,0.001,204,20
0.466,0.001,160,144,2,50,0.001,304,20
0.466,0.001,214,190,2,50,0.001,404,20
0.462,0.001,265,239,2,50,0.001,504,20
0.472,0.001,308,296,2,50,0.001,604,20
0.504,0.001,347,357,2,50,0.001,704,20
0.55,0.001,403,401,2,50,0.001,804,20
0.59,0.001,454,450,2,50,0.001,904,20
0.642,0.001,508,496,2,50,0.001,1004,20
0.682,0.001,553,551,2,50,0.001,1104,20
0.712,0.001,599,605,2,50,0.001,1204,20
0.736,0.001,652,652,2,50,0.001,1304,20
0.762,0.001,707,697,2,50,0.001,1404,20
0.79,0.001,755,749,2,50,0.001,1504,20
0.816,0.001,804,800,2,50,0.001,1604,20
0.806,0.001,853,851,2,50,0.001,1704,20
0.818,0.001,904,900,2,50,0.001,1804,20
0.84,0.001,956,948,2,50,0.001,1904,20
0.838,0.001,1004,1000,2,50,0.001,2004,20
0.48,0.001,54,50,2,50,0.01,104,1
0.474,0.001,109,95,2,50,0.01,204,1
0.428,0.001,152,152,2,50,0.01,304,1
0.616,0.001,199,205,2,50,0.01,404,1
0.696,0.001,255,249,2,50,0.01,504,1
0.696,0.001,301,303,2,50,0.01,604,1
0.728,0.001,353,351,2,50,0.01,704,1
0.754,0.001,397,407,2,50,0.01,804,1
0.764,0.001,449,455,2,50,0.01,904,1
0.816,0.001,496,508,2,50,0.01,1004,1
0.844,0.001,549,555,2,50,0.01,1104,1
0.864,0.001,602,602,2,50,0.01,1204,1
0.864,0.001,652,652,2,50,0.01,1304,1
0.886,0.001,713,691,2,50,0.01,1404,1
0.89,0.001,768,736,2,50,0.01,1504,1
0.916,0.001,821,783,2,50,0.01,1604,1
0.922,0.001,869,835,2,50,0.01,1704,1
0.93,0.001,908,896,2,50,0.01,1804,1
0.932,0.001,957,947,2,50,0.01,1904,1
0.932,0.001,1012,992,2,50,0.01,2004,1
0.588,0.001,49,55,2,50,0.01,104,2
0.568,0.001,93,111,2,50,0.01,204,2
0.648,0.001,138,166,2,50,0.01,304,2
0.676,0.001,191,213,2,50,0.01,404,2
0.704,0.001,239,265,2,50,0.01,504,2
0.784,0.001,290,314,2,50,0.01,604,2
0.8,0.001,341,363,2,50,0.01,704,2
0.816,0.001,389,415,2,50,0.01,804,2
0.82,0.001,443,461,2,50,0.01,904,2
0.842,0.001,491,513,2,50,0.01,1004,2
0.856,0.001,535,569,2,50,0.01,1104,2
0.864,0.001,593,611,2,50,0.01,1204,2
0.876,0.001,646,658,2,50,0.01,1304,2
0.882,0.001,699,705,2,50,0.01,1404,2
0.894,0.001,742,762,2,50,0.01,1504,2
0.906,0.001,791,813,2,50,0.01,1604,2
0.908,0.001,846,858,2,50,0.01,1704,2
0.92,0.001,890,914,2,50,0.01,1804,2
0.924,0.001,943,961,2,50,0.01,1904,2
0.942,0.001,994,1010,2,50,0.01,2004,2
0.454,0.001,56,48,2,50,0.01,104,3
0.552,0.001,101,103,2,50,0.01,204,3
0.58,0.001,150,154,2,50,0.01,304,3
0.588,0.001,205,199,2,50,0.01,404,3
0.6,0.001,260,244,2,50,0.01,504,3
0.662,0.001,316,288,2,50,0.01,604,3
0.692,0.001,365,339,2,50,0.01,704,3
0.804,0.001,412,392,2,50,0.01,804,3
0.896,0.001,461,443,2,50,0.01,904,3
0.878,0.001,506,498,2,50,0.01,1004,3
0.864,0.001,551,553,2,50,0.01,1104,3
0.88,0.001,606,598,2,50,0.01,1204,3
0.906,0.001,665,639,2,50,0.01,1304,3
0.92,0.001,708,696,2,50,0.01,1404,3
0.918,0.001,766,738,2,50,0.01,1504,3
0.924,0.001,821,783,2,50,0.01,1604,3
0.93,0.001,865,839,2,50,0.01,1704,3
0.936,0.001,915,889,2,50,0.01,1804,3
0.94,0.001,964,940,2,50,0.01,1904,3
0.944,0.001,1018,986,2,50,0.01,2004,3
0.394,0.001,43,61,2,50,0.01,104,4
0.48,0.001,91,113,2,50,0.01,204,4
0.544,0.001,142,162,2,50,0.01,304,4
0.628,0.001,197,207,2,50,0.01,404,4
0.66,0.001,243,261,2,50,0.01,504,4
0.65,0.001,292,312,2,50,0.01,604,4
0.668,0.001,345,359,2,50,0.01,704,4
0.71,0.001,401,403,2,50,0.01,804,4
0.766,0.001,440,464,2,50,0.01,904,4
0.81,0.001,490,514,2,50,0.01,1004,4
0.854,0.001,540,564,2,50,0.01,1104,4
0.886,0.001,594,610,2,50,0.01,1204,4
0.884,0.001,639,665,2,50,0.01,1304,4
0.888,0.001,691,713,2,50,0.01,1404,4
0.892,0.001,745,759,2,50,0.01,1504,4
0.904,0.001,795,809,2,50,0.01,1604,4
0.902,0.001,842,862,2,50,0.01,1704,4
0.908,0.001,882,922,2,50,0.01,1804,4
0.908,0.001,933,971,2,50,0.01,1904,4
0.92,0.001,991,1013,2,50,0.01,2004,4
0.4,0.001,57,47,2,50,0.01,104,5
0.434,0.001,109,95,2,50,0.01,204,5
0.564,0.001,160,144,2,50,0.01,304,5
0.612,0.001,205,199,2,50,0.01,404,5
0.624,0.001,256,248,2,50,0.01,504,5
0.64,0.001,295,309,2,50,0.01,604,5
0.684,0.001,352,352,2,50,0.01,704,5
0.846,0.001,402,402,2,50,0.01,804,5
0.87,0.001,452,452,2,50,0.01,904,5
0.854,0.001,501,503,2,50,0.01,1004,5
0.85,0.001,553,551,2,50,0.01,1104,5
0.878,0.001,604,600,2,50,0.01,1204,5
0.89,0.001,657,647,2,50,0.01,1304,5
0.898,0.001,703,701,2,50,0.01,1404,5
0.896,0.001,752,752,2,50,0.01,1504,5
0.902,0.001,810,794,2,50,0.01,1604,5
0.92,0.001,850,854,2,50,0.01,1704,5
0.912,0.001,901,903,2,50,0.01,1804,5
0.908,0.001,950,954,2,50,0.01,1904,5
0.918,0.001,999,1005,2,50,0.01,2004,5
0.582,0.001,46,58,2,50,0.01,104,6
0.628,0.001,91,113,2,50,0.01,204,6
0.602,0.001,152,152,2,50,0.01,304,6
0.686,0.001,201,203,2,50,0.01,404,6
0.772,0.001,249,255,2,50,0.01,504,6
0.818,0.001,300,304,2,50,0.01,604,6
0.83,0.001,349,355,2,50,0.01,704,6
0.834,0.001,408,396,2,50,0.01,804,6
0.834,0.001,452,452,2,50,0.01,904,6
0.842,0.001,499,505,2,50,0.01,1004,6
0.852,0.001,545,559,2,50,0.01,1104,6
0.874,0.001,592,612,2,50,0.01,1204,6
0.864,0.001,638,666,2,50,0.01,1304,6
0.884,0.001,696,708,2,50,0.01,1404,6
0.898,0.001,748,756,2,50,0.01,1504,6
0.906,0.001,802,802,2,50,0.01,1604,6
0.906,0.001,853,851,2,50,0.01,1704,6
0.916,0.001,909,895,2,50,0.01,1804,6
0.916,0.001,956,948,2,50,0.01,1904,6
0.922,0.001,1003,1001,2,50,0.01,2004,6
0.416,0.001,56,48,2,50,0.01,104,7
0.462,0.001,116,88,2,50,0.01,204,7
0.566,0.001,169,135,2,50,0.01,304,7
0.634,0.001,214,190,2,50,0.01,404,7
0.688,0.001,267,237,2,50,0.01,504,7
0.746,0.001,317,287,2,50,0.01,604,7
0.82,0.001,362,342,2,50,0.01,704,7
0.85,0.001,418,386,2,50,0.01,804,7
0.858,0.001,469,435,2,50,0.01,904,7
0.884,0.001,509,495,2,50,0.01,1004,7
0.95,0.001,557,547,2,50,0.01,1104,7
0.92,0.001,604,600,2,50,0.01,1204,7
0.922,0.001,650,654,2,50,0.01,1304,7
0.924,0.001,708,696,2,50,0.01,1404,7
0.928,0.001,753,751,2,50,0.01,1504,7
0.936,0.001,808,796,2,50,0.01,1604,7
0.942,0.001,854,850,2,50,0.01,1704,7
0.942,0.001,906,898,2,50,0.01,1804,7
0.946,0.001,956,948,2,50,0.01,1904,7
0.952,0.001,1005,999,2,50,0.01,2004,7
0.576,0.001,52,52,2,50,0.01,104,8
0.612,0.001,105,99,2,50,0.01,204,8
0.588,0.001,153,151,2,50,0.01,304,8
0.678,0.001,201,203,2,50,0.01,404,8
0.732,0.001,239,265,2,50,0.01,504,8
0.75,0.001,289,315,2,50,0.01,604,8
0.79,0.001,345,359,2,50,0.01,704,8
0.814,0.001,401,403,2,50,0.01,804,8
0.83,0.001,447,457,2,50,0.01,904,8
0.854,0.001,491,513,2,50,0.01,1004,8
0.862,0.001,533,571,2,50,0.01,1104,8
0.864,0.001,584,620,2,50,0.01,1204,8
0.856,0.001,633,671,2,50,0.01,1304,8
0.886,0.001,684,720,2,50,0.01,1404,8
0.89,0.001,733,771,2,50,0.01,1504,8
0.898,0.001,796,808,2,50,0.01,1604,8
0.906,0.001,848,856,2,50,0.01,1704,8
0.9,0.001,899,905,2,50,0.01,1804,8
0.902,0.001,953,951,2,50,0.01,1904,8
0.914,0.001,1006,998,2,50,0.01,2004,8
0.59,0.001,49,55,2,50,0.01,104,9
0.568,0.001,93,111,2,50,0.01,204,9
0.548,0.001,141,163,2,50,0.01,304,9
0.646,0.001,190,214,2,50,0.01,404,9
0.716,0.001,240,264,2,50,0.01,504,9
0.726,0.001,295,309,2,50,0.01,604,9
0.742,0.001,343,361,2,50,0.01,704,9
0.758,0.001,403,401,2,50,0.01,804,9
0.794,0.001,451,453,2,50,0.01,904,9
0.812,0.001,499,505,2,50,0.01,1004,9
0.82,0.001,564,540,2,50,0.01,1104,9
0.854,0.001,614,590,2,50,0.01,1204,9
0.892,0.001,669,635,2,50,0.01,1304,9
0.894,0.001,715,689,2,50,0.01,1404,9
0.896,0.001,758,746,2,50,0.01,1504,9
0.91,0.001,806,798,2,50,0.01,1604,9
0.924,0.001,858,846,2,50,0.01,1704,9
0.924,0.001,904,900,2,50,0.01,1804,9
0.93,0.001,953,951,2,50,0.01,1904,9
0.934,0.001,1000,1004,2,50,0.01,2004,9
0.666,0.001,51,53,2,50,0.01,104,10
0.716,0.001,96,108,2,50,0.01,204,10
0.71,0.001,151,153,2,50,0.01,304,10
0.712,0.001,199,205,2,50,0.01,404,10
0.722,0.001,246,258,2,50,0.01,504,10
0.744,0.001,288,316,2,50,0.01,604,10
0.77,0.001,338,366,2,50,0.01,704,10
0.798,0.001,389,415,2,50,0.01,804,10
0.82,0.001,438,466,2,50,0.01,904,10
0.854,0.001,487,517,2,50,0.01,1004,10
0.874,0.001,544,560,2,50,0.01,1104,10
0.884,0.001,595,609,2,50,0.01,1204,10
0.898,0.001,639,665,2,50,0.01,1304,10
0.904,0.001,690,714,2,50,0.01,1404,10
0.914,0.001,748,756,2,50,0.01,1504,10
0.914,0.001,796,808,2,50,0.01,1604,10
0.918,0.001,854,850,2,50,0.01,1704,10
0.93,0.001,909,895,2,50,0.01,1804,10
0.936,0.001,952,952,2,50,0.01,1904,10
0.93,0.001,1002,1002,2,50,0.01,2004,10
0.486,0.001,59,45,2,50,0.01,104,11
0.5,0.001,106,98,2,50,0.01,204,11
0.538,0.001,148,156,2,50,0.01,304,11
0.602,0.001,196,208,2,50,0.01,404,11
0.668,0.001,250,254,2,50,0.01,504,11
0.68,0.001,300,304,2,50,0.01,604,11
0.75,0.001,341,363,2,50,0.01,704,11
0.774,0.001,395,409,2,50,0.01,804,11
0.724,0.001,444,460,2,50,0.01,904,11
0.764,0.001,497,507,2,50,0.01,1004,11
0.802,0.001,540,564,2,50,0.01,1104,11
0.808,0.001,595,609,2,50,0.01,1204,11
0.888,0.001,649,655,2,50,0.01,1304,11
0.858,0.001,700,704,2,50,0.01,1404,11
0.834,0.001,748,756,2,50,0.01,1504,11
0.846,0.001,797,807,2,50,0.01,1604,11
0.87,0.001,854,850,2,50,0.01,1704,11
0.898,0.001,910,894,2,50,0.01,1804,11
0.9,0.001,956,948,2,50,0.01,1904,11
0.918,0.001,997,1007,2,50,0.01,2004,11
0.592,0.001,50,54,2,50,0.01,104,12
0.582,0.001,100,104,2,50,0.01,204,12
0.564,0.001,150,154,2,50,0.01,304,12
0.6,0.001,196,208,2,50,0.01,404,12
0.676,0.001,239,265,2,50,0.01,504,12
0.712,0.001,283,321,2,50,0.01,604,12
0.716,0.001,337,367,2,50,0.01,704,12
0.74,0.001,392,412,2,50,0.01,804,12
0.76,0.001,436,468,2,50,0.01,904,12
0.782,0.001,491,513,2,50,0.01,1004,12
0.816,0.001,539,565,2,50,0.01,1104,12
0.824,0.001,583,621,2,50,0.01,1204,12
0.816,0.001,633,671,2,50,0.01,1304,12
0.826,0.001,685,719,2,50,0.01,1404,12
0.864,0.001,730,774,2,50,0.01,1504,12
0.872,0.001,774,830,2,50,0.01,1604,12
0.884,0.001,829,875,2,50,0.01,1704,12
0.902,0.001,880,924,2,50,0.01,1804,12
0.916,0.001,926,978,2,50,0.01,1904,12
0.924,0.001,973,1031,2,50,0.01,2004,12
0.53,0.001,57,47,2,50,0.01,104,13
0.564,0.001,103,101,2,50,0.01,204,13
0.584,0.001,154,150,2,50,0.01,304,13
0.612,0.001,205,199,2,50,0.01,404,13
0.624,0.001,251,253,2,50,0.01,504,13
0.702,0.001,299,305,2,50,0.01,604,13
0.76,0.001,346,358,2,50,0.01,704,13
0.786,0.001,401,403,2,50,0.01,804,13
0.802,0.001,447,457,2,50,0.01,904,13
0.84,0.001,493,511,2,50,0.01,1004,13
0.818,0.001,541,563,2,50,0.01,1104,13
0.844,0.001,591,613,2,50,0.01,1204,13
0.878,0.001,642,662,2,50,0.01,1304,13
0.892,0.001,689,715,2,50,0.01,1404,13
0.89,0.001,743,761,2,50,0.01,1504,13
0.912,0.001,790,814,2,50,0.01,1604,13
0.918,0.001,844,860,2,50,0.01,1704,13
0.912,0.001,902,902,2,50,0.01,1804,13
0.924,0.001,956,948,2,50,0.01,1904,13
0.952,0.001,1011,993,2,50,0.01,2004,13
0.49,0.001,49,55,2,50,0.01,104,14
0.512,0.001,96,108,2,50,0.01,204,14
0.54,0.001,154,150,2,50,0.01,304,14
0.612,0.001,198,206,2,50,0.01,404,14
0.674,0.001,239,265,2,50,0.01,504,14
0.764,0.001,296,308,2,50,0.01,604,14
0.808,0.001,345,359,2,50,0.01,704,14
0.852,0.001,389,415,2,50,0.01,804,14
0.864,0.001,436,468,2,50,0.01,904,14
0.864,0.001,487,517,2,50,0.01,1004,14
0.864,0.001,537,567,2,50,0.01,1104,14
0.874,0.001,586,618,2,50,0.01,1204,14
0.882,0.001,643,661,2,50,0.01,1304,14
0.926,0.001,693,711,2,50,0.01,1404,14
0.93,0.001,749,755,2,50,0.01,1504,14
0.936,0.001,798,806,2,50,0.01,1604,14
0.938,0.001,841,863,2,50,0.01,1704,14
0.94,0.001,884,920,2,50,0.01,1804,14
0.944,0.001,932,972,2,50,0.01,1904,14
0.948,0.001,985,1019,2,50,0.01,2004,14
0.454,0.001,49,55,2,50,0.01,104,15
0.476,0.001,95,109,2,50,0.01,204,15
0.536,0.001,153,151,2,50,0.01,304,15
0.584,0.001,205,199,2,50,0.01,404,15
0.666,0.001,257,247,2,50,0.01,504,15
0.698,0.001,316,288,2,50,0.01,604,15
0.724,0.001,368,336,2,50,0.01,704,15
0.752,0.001,424,380,2,50,0.01,804,15
0.762,0.001,469,435,2,50,0.01,904,15
0.81,0.001,516,488,2,50,0.01,1004,15
0.848,0.001,565,539,2,50,0.01,1104,15
0.864,0.001,615,589,2,50,0.01,1204,15
0.87,0.001,654,650,2,50,0.01,1304,15
0.888,0.001,715,689,2,50,0.01,1404,15
0.906,0.001,763,741,2,50,0.01,1504,15
0.928,0.001,818,786,2,50,0.01,1604,15
0.93,0.001,863,841,2,50,0.01,1704,15
0.936,0.001,912,892,2,50,0.01,1804,15
0.934,0.001,964,940,2,50,0.01,1904,15
0.948,0.001,1005,999,2,50,0.01,2004,15
0.568,0.001,48,56,2,50,0.01,104,16
0.528,0.001,88,116,2,50,0.01,204,16
0.514,0.001,138,166,2,50,0.01,304,16
0.526,0.001,189,215,2,50,0.01,404,16
0.616,0.001,238,266,2,50,0.01,504,16
0.72,0.001,283,321,2,50,0.01,604,16
0.766,0.001,342,362,2,50,0.01,704,16
0.794,0.001,382,422,2,50,0.01,804,16
0.8,0.001,437,467,2,50,0.01,904,16
0.818,0.001,488,516,2,50,0.01,1004,16
0.81,0.001,546,558,2,50,0.01,1104,16
0.82,0.001,602,602,2,50,0.01,1204,16
0.818,0.001,649,655,2,50,0.01,1304,16
0.856,0.001,704,700,2,50,0.01,1404,16
0.866,0.001,756,748,2,50,0.01,1504,16
0.894,0.001,803,801,2,50,0.01,1604,16
0.906,0.001,852,852,2,50,0.01,1704,16
0.922,0.001,902,902,2,50,0.01,1804,16
0.93,0.001,949,955,2,50,0.01,1904,16
0.93,0.001,999,1005,2,50,0.01,2004,16
0.512,0.001,53,51,2,50,0.01,104,17
0.598,0.001,106,98,2,50,0.01,204,17
0.598,0.001,150,154,2,50,0.01,304,17
0.632,0.001,194,210,2,50,0.01,404,17
0.692,0.001,250,254,2,50,0.01,504,17
0.69,0.001,308,296,2,50,0.01,604,17
0.692,0.001,357,347,2,50,0.01,704,17
0.69,0.001,409,395,2,50,0.01,804,17
0.728,0.001,460,444,2,50,0.01,904,17
0.78,0.001,504,500,2,50,0.01,1004,17
0.824,0.001,558,546,2,50,0.01,1104,17
0.86,0.001,597,607,2,50,0.01,1204,17
0.91,0.001,647,657,2,50,0.01,1304,17
0.918,0.001,708,696,2,50,0.01,1404,17
0.922,0.001,758,746,2,50,0.01,1504,17
0.924,0.001,803,801,2,50,0.01,1604,17
0.924,0.001,855,849,2,50,0.01,1704,17
0.924,0.001,913,891,2,50,0.01,1804,17
0.926,0.001,966,938,2,50,0.01,1904,17
0.932,0.001,1016,988,2,50,0.01,2004,17
0.504,0.001,51,53,2,50,0.01,104,18
0.626,0.001,97,107,2,50,0.01,204,18
0.656,0.001,147,157,2,50,0.01,304,18
0.644,0.001,186,218,2,50,0.01,404,18
0.648,0.001,235,269,2,50,0.01,504,18
0.748,0.001,287,317,2,50,0.01,604,18
0.808,0.001,338,366,2,50,0.01,704,18
0.838,0.001,395,409,2,50,0.01,804,18
0.818,0.001,452,452,2,50,0.01,904,18
0.876,0.001,493,511,2,50,0.01,1004,18
0.87,0.001,546,558,2,50,0.01,1104,18
0.872,0.001,601,603,2,50,0.01,1204,18
0.886,0.001,651,653,2,50,0.01,1304,18
0.896,0.001,699,705,2,50,0.01,1404,18
0.898,0.001,753,751,2,50,0.01,1504,18
0.908,0.001,806,798,2,50,0.01,1604,18
0.904,0.001,848,856,2,50,0.01,1704,18
0.912,0.001,897,907,2,50,0.01,1804,18
0.918,0.001,943,961,2,50,0.01,1904,18
0.928,0.001,993,1011,2,50,0.01,2004,18
0.478,0.001,43,61,2,50,0.01,104,19
0.528,0.001,95,109,2,50,0.01,204,19
0.626,0.001,148,156,2,50,0.01,304,19
0.59,0.001,192,212,2,50,0.01,404,19
0.66,0.001,241,263,2,50,0.01,504,19
0.67,0.001,294,310,2,50,0.01,604,19
0.79,0.001,339,365,2,50,0.01,704,19
0.772,0.001,393,411,2,50,0.01,804,19
0.794,0.001,447,457,2,50,0.01,904,19
0.848,0.001,497,507,2,50,0.01,1004,19
0.852,0.001,548,556,2,50,0.01,1104,19
0.858,0.001,598,606,2,50,0.01,1204,19
0.872,0.001,643,661,2,50,0.01,1304,19
0.888,0.001,693,711,2,50,0.01,1404,19
0.898,0.001,745,759,2,50,0.01,1504,19
0.9,0.001,802,802,2,50,0.01,1604,19
0.908,0.001,845,859,2,50,0.01,1704,19
0.908,0.001,888,916,2,50,0.01,1804,19
0.908,0.001,933,971,2,50,0.01,1904,19
0.92,0.001,989,1015,2,50,0.01,2004,19
0.494,0.001,48,56,2,50,0.01,104,20
0.522,0.001,97,107,2,50,0.01,204,20
0.62,0.001,136,168,2,50,0.01,304,20
0.674,0.001,174,230,2,50,0.01,404,20
0.688,0.001,225,279,2,50,0.01,504,20
0.854,0.001,272,332,2,50,0.01,604,20
0.78,0.001,324,380,2,50,0.01,704,20
0.76,0.001,364,440,2,50,0.01,804,20
0.758,0.001,408,496,2,50,0.01,904,20
0.8,0.001,460,544,2,50,0.01,1004,20
0.862,0.001,522,582,2,50,0.01,1104,20
0.864,0.001,573,631,2,50,0.01,1204,20
0.868,0.001,633,671,2,50,0.01,1304,20
0.886,0.001,682,722,2,50,0.01,1404,20
0.894,0.001,738,766,2,50,0.01,1504,20
0.906,0.001,788,816,2,50,0.01,1604,20
0.908,0.001,835,869,2,50,0.01,1704,20
0.914,0.001,882,922,2,50,0.01,1804,20
0.906,0.001,927,977,2,50,0.01,1904,20
0.924,0.001,975,1029,2,50,0.01,2004,20
0.474,1e-05,50,54,2,100,0.0001,104,1
0.474,1e-05,97,107,2,100,0.0001,204,1
0.474,1e-05,160,144,2,100,0.0001,304,1
0.474,1e-05,208,196,2,100,0.0001,404,1
0.474,1e-05,259,245,2,100,0.0001,504,1
0.474,1e-05,311,293,2,100,0.0001,604,1
0.474,1e-05,356,348,2,100,0.0001,704,1
0.474,1e-05,409,395,2,100,0.0001,804,1
0.474,1e-05,467,437,2,100,0.0001,904,1
0.474,1e-05,521,483,2,100,0.0001,1004,1
0.474,1e-05,565,539,2,100,0.0001,1104,1
0.474,1e-05,612,592,2,100,0.0001,1204,1
0.476,1e-05,659,645,2,100,0.0001,1304,1
0.476,1e-05,703,701,2,100,0.0001,1404,1
0.476,1e-05,752,752,2,100,0.0001,1504,1
0.476,1e-05,811,793,2,100,0.0001,1604,1
0.478,1e-05,859,845,2,100,0.0001,1704,1
0.478,1e-05,896,908,2,100,0.0001,1804,1
0.48,1e-05,939,965,2,100,0.0001,1904,1
0.484,1e-05,989,1015,2,100,0.0001,2004,1
0.484,1e-05,58,46,2,100,0.0001,104,2
0.486,1e-05,105,99,2,100,0.0001,204,2
0.488,1e-05,154,150,2,100,0.0001,304,2
0.484,1e-05,198,206,2,100,0.0001,404,2
0.488,1e-05,244,260,2,100,0.0001,504,2
0.486,1e-05,299,305,2,100,0.0001,604,2
0.486,1e-05,345,359,2,100,0.0001,704,2
0.486,1e-05,396,408,2,100,0.0001,804,2
0.484,1e-05,452,452,2,100,0.0001,904,2
0.484,1e-05,499,505,2,100,0.0001,1004,2
0.48,1e-05,546,558,2,100,0.0001,1104,2
0.478,1e-05,598,606,2,100,0.0001,1204,2
0.484,1e-05,649,655,2,100,0.0001,1304,2
0.478,1e-05,696,708,2,100,0.0001,1404,2
0.502,1e-05,751,753,2,100,0.0001,1504,2
0.512,1e-05,800,804,2,100,0.0001,1604,2
0.524,1e-05,848,856,2,100,0.0001,1704,2
0.538,1e-05,897,907,2,100,0.0001,1804,2
0.554,1e-05,939,965,2,100,0.0001,1904,2
0.572,1e-05,989,1015,2,100,0.0001,2004,2
0.508,1e-05,47,57,2,100,0.0001,104,3
0.508,1e-05,101,103,2,100,0.0001,204,3
0.506,1e-05,144,160,2,100,0.0001,304,3
0.512,1e-05,184,220,2,100,0.0001,404,3
0.51,1e-05,243,261,2,100,0.0001,504,3
0.512,1e-05,298,306,2,100,0.0001,604,3
0.516,1e-05,349,355,2,100,0.0001,704,3
0.52,1e-05,392,412,2,100,0.0001,804,3
0.528,1e-05,451,453,2,100,0.0001,904,3
0.534,1e-05,502,502,2,100,0.0001,1004,3
0.532,1e-05,551,553,2,100,0.0001,1104,3
0.532,1e-05,595,609,2,100,0.0001,1204,3
0.534,1e-05,652,652,2,100,0.0001,1304,3
0.532,1e-05,705,699,2,100,0.0001,1404,3
0.532,1e-05,749,755,2,100,0.0001,1504,3
0.536,1e-05,802,802,2,100,0.0001,1604,3
0.528,1e-05,861,843,2,100,0.0001,1704,3
0.532,1e-05,908,896,2,100,0.0001,1804,3
0.534,1e-05,955,949,2,100,0.0001,1904,3
0.538,1e-05,1004,1000,2,100,0.0001,2004,3
0.448,1e-05,50,54,2,100,0.0001,104,4
0.456,1e-05,115,89,2,100,0.0001,204,4
0.456,1e-05,164,140,2,100,0.0001,304,4
0.456,1e-05,217,187,2,100,0.0001,404,4
0.458,1e-05,262,242,2,100,0.0001,504,4
0.454,1e-05,302,302,2,100,0.0001,604,4
0.452,1e-05,347,357,2,100,0.0001,704,4
0.458,1e-05,397,407,2,100,0.0001,804,4
0.454,1e-05,447,457,2,100,0.0001,904,4
0.46,1e-05,494,510,2,100,0.0001,1004,4
0.464,1e-05,546,558,2,100,0.0001,1104,4
0.476,1e-05,597,607,2,100,0.0001,1204,4
0.484,1e-05,646,658,2,100,0.0001,1304,4
0.484,1e-05,695,709,2,100,0.0001,1404,4
0.492,1e-05,747,757,2,100,0.0001,1504,4
0.496,1e-05,804,800,2,100,0.0001,1604,4
0.51,1e-05,857,847,2,100,0.0001,1704,4
0.514,1e-05,906,898,2,100,0.0001,1804,4
0.506,1e-05,955,949,2,100,0.0001,1904,4
0.51,1e-05,1000,1004,2,100,0.0001,2004,4
0.532,1e-05,49,55,2,100,0.0001,104,5
0.532,1e-05,89,115,2,100,0.0001,204,5
0.532,1e-05,147,157,2,100,0.0001,304,5
0.534,1e-05,200,204,2,100,0.0001,404,5
0.534,1e-05,244,260,2,100,0.0001,504,5
0.534,1e-05,298,306,2,100,0.0001,604,5
0.534,1e-05,350,354,2,100,0.0001,704,5
0.534,1e-05,399,405,2,100,0.0001,804,5
0.534,1e-05,453,451,2,100,0.0001,904,5
0.534,1e-05,503,501,2,100,0.0001,1004,5
0.536,1e-05,558,546,2,100,0.0001,1104,5
0.538,1e-05,612,592,2,100,0.0001,1204,5
0.538,1e-05,664,640,2,100,0.0001,1304,5
0.538,1e-05,717,687,2,100,0.0001,1404,5
0.538,1e-05,773,731,2,100,0.0001,1504,5
0.542,1e-05,814,790,2,100,0.0001,1604,5
0.546,1e-05,863,841,2,100,0.0001,1704,5
0.548,1e-05,908,896,2,100,0.0001,1804,5
0.554,1e-05,959,945,2,100,0.0001,1904,5
0.558,1e-05,1009,995,2,100,0.0001,2004,5
0.454,1e-05,56,48,2,100,0.0001,104,6
0.454,1e-05,107,97,2,100,0.0001,204,6
0.454,1e-05,160,144,2,100,0.0001,304,6
0.454,1e-05,199,205,2,100,0.0001,404,6
0.454,1e-05,254,250,2,100,0.0001,504,6
0.458,1e-05,300,304,2,100,0.0001,604,6
0.46,1e-05,350,354,2,100,0.0001,704,6
0.458,1e-05,399,405,2,100,0.0001,804,6
0.46,1e-05,452,452,2,100,0.0001,904,6
0.462,1e-05,502,502,2,100,0.0001,1004,6
0.47,1e-05,547,557,2,100,0.0001,1104,6
0.474,1e-05,593,611,2,100,0.0001,1204,6
0.484,1e-05,632,672,2,100,0.0001,1304,6
0.486,1e-05,678,726,2,100,0.0001,1404,6
0.506,1e-05,723,781,2,100,0.0001,1504,6
0.506,1e-05,784,820,2,100,0.0001,1604,6
0.51,1e-05,834,870,2,100,0.0001,1704,6
0.51,1e-05,881,923,2,100,0.0001,1804,6
0.526,1e-05,923,981,2,100,0.0001,1904,6
0.532,1e-05,979,1025,2,100,0.0001,2004,6
0.558,1e-05,47,57,2,100,0.0001,104,7
0.558,1e-05,96,108,2,100,0.0001,204,7
0.558,1e-05,146,158,2,100,0.0001,304,7
0.558,1e-05,199,205,2,100,0.0001,404,7
0.56,1e-05,247,257,2,100,0.0001,504,7
0.56,1e-05,297,307,2,100,0.0001,604,7
0.562,1e-05,336,368,2,100,0.0001,704,7
0.564,1e-05,396,408,2,100,0.0001,804,7
0.564,1e-05,446,458,2,100,0.0001,904,7
0.564,1e-05,496,508,2,100,0.0001,1004,7
0.564,1e-05,549,555,2,100,0.0001,1104,7
0.57,1e-05,606,598,2,100,0.0001,1204,7
0.578,1e-05,656,648,2,100,0.0001,1304,7
0.58,1e-05,701,703,2,100,0.0001,1404,7
0.582,1e-05,751,753,2,100,0.0001,1504,7
0.584,1e-05,795,809,2,100,0.0001,1604,7
0.586,1e-05,848,856,2,100,0.0001,1704,7
0.596,1e-05,899,905,2,100,0.0001,1804,7
0.596,1e-05,949,955,2,100,0.0001,1904,7
0.596,1e-05,1004,1000,2,100,0.0001,2004,7
0.598,1e-05,49,55,2,100,0.0001,104,8
0.598,1e-05,96,108,2,100,0.0001,204,8
0.598,1e-05,150,154,2,100,0.0001,304,8
0.598,1e-05,204,200,2,100,0.0001,404,8
0.6,1e-05,257,247,2,100,0.0001,504,8
0.6,1e-05,308,296,2,100,0.0001,604,8
0.598,1e-05,361,343,2,100,0.0001,704,8
0.598,1e-05,411,393,2,100,0.0001,804,8
0.598,1e-05,463,441,2,100,0.0001,904,8
0.6,1e-05,512,492,2,100,0.0001,1004,8
0.602,1e-05,560,544,2,100,0.0001,1104,8
0.602,1e-05,615,589,2,100,0.0001,1204,8
0.598,1e-05,653,651,2,100,0.0001,1304,8
0.598,1e-05,701,703,2,100,0.0001,1404,8
0.594,1e-05,752,752,2,100,0.0001,1504,8
0.596,1e-05,806,798,2,100,0.0001,1604,8
0.598,1e-05,857,847,2,100,0.0001,1704,8
0.6,1e-05,903,901,2,100,0.0001,1804,8
0.6,1e-05,948,956,2,100,0.0001,1904,8
0.598,1e-05,1001,1003,2,100,0.0001,2004,8
0.424,1e-05,53,51,2,100,0.0001,104,9
0.424,1e-05,98,106,2,100,0.0001,204,9
0.424,1e-05,149,155,2,100,0.0001,304,9
0.424,1e-05,206,198,2,100,0.0001,404,9
0.424,1e-05,267,237,2,100,0.0001,504,9
0.424,1e-05,319,285,2,100,0.0001,604,9
0.426,1e-05,370,334,2,100,0.0001,704,9
0.426,1e-05,412,392,2,100,0.0001,804,9
0.426,1e-05,458,446,2,100,0.0001,904,9
0.426,1e-05,502,502,2,100,0.0001,1004,9
0.426,1e-05,551,553,2,100,0.0001,1104,9
0.426,1e-05,600,604,2,100,0.0001,1204,9
0.428,1e-05,650,654,2,100,0.0001,1304,9
0.428,1e-05,699,705,2,100,0.0001,1404,9
0.428,1e-05,746,758,2,100,0.0001,1504,9
0.43,1e-05,798,806,2,100,0.0001,1604,9
0.43,1e-05,854,850,2,100,0.0001,1704,9
0.436,1e-05,897,907,2,100,0.0001,1804,9
0.436,1e-05,952,952,2,100,0.0001,1904,9
0.438,1e-05,1008,996,2,100,0.0001,2004,9
0.466,1e-05,54,50,2,100,0.0001,104,10
0.466,1e-05,107,97,2,100,0.0001,204,10
0.464,1e-05,159,145,2,100,0.0001,304,10
0.466,1e-05,213,191,2,100,0.0001,404,10
0.462,1e-05,263,241,2,100,0.0001,504,10
0.462,1e-05,312,292,2,100,0.0001,604,10
0.468,1e-05,359,345,2,100,0.0001,704,10
0.47,1e-05,406,398,2,100,0.0001,804,10
0.472,1e-05,454,450,2,100,0.0001,904,10
0.47,1e-05,509,495,2,100,0.0001,1004,10
0.476,1e-05,558,546,2,100,0.0001,1104,10
0.476,1e-05,606,598,2,100,0.0001,1204,10
0.484,1e-05,668,636,2,100,0.0001,1304,10
0.492,1e-05,710,694,2,100,0.0001,1404,10
0.492,1e-05,765,739,2,100,0.0001,1504,10
0.5,1e-05,811,793,2,100,0.0001,1604,10
0.498,1e-05,861,843,2,100,0.0001,1704,10
0.502,1e-05,907,897,2,100,0.0001,1804,10
0.514,1e-05,954,950,2,100,0.0001,1904,10
0.522,1e-05,997,1007,2,100,0.0001,2004,10
0.574,1e-05,47,57,2,100,0.0001,104,11
0.574,1e-05,96,108,2,100,0.0001,204,11
0.576,1e-05,147,157,2,100,0.0001,304,11
0.58,1e-05,192,212,2,100,0.0001,404,11
0.582,1e-05,248,256,2,100,0.0001,504,11
0.582,1e-05,299,305,2,100,0.0001,604,11
0.582,1e-05,350,354,2,100,0.0001,704,11
0.584,1e-05,401,403,2,100,0.0001,804,11
0.582,1e-05,453,451,2,100,0.0001,904,11
0.584,1e-05,495,509,2,100,0.0001,1004,11
0.588,1e-05,547,557,2,100,0.0001,1104,11
0.588,1e-05,600,604,2,100,0.0001,1204,11
0.592,1e-05,662,642,2,100,0.0001,1304,11
0.6,1e-05,709,695,2,100,0.0001,1404,11
0.602,1e-05,760,744,2,100,0.0001,1504,11
0.61,1e-05,813,791,2,100,0.0001,1604,11
0.61,1e-05,873,831,2,100,0.0001,1704,11
0.614,1e-05,919,885,2,100,0.0001,1804,11
0.618,1e-05,971,933,2,100,0.0001,1904,11
0.622,1e-05,1023,981,2,100,0.0001,2004,11
0.44,1e-05,54,50,2,100,0.0001,104,12
0.442,1e-05,106,98,2,100,0.0001,204,12
0.442,1e-05,160,144,2,100,0.0001,304,12
0.44,1e-05,210,194,2,100,0.0001,404,12
0.438,1e-05,264,240,2,100,0.0001,504,12
0.438,1e-05,318,286,2,100,0.0001,604,12
0.44,1e-05,372,332,2,100,0.0001,704,12
0.436,1e-05,420,384,2,100,0.0001,804,12
0.438,1e-05,465,439,2,100,0.0001,904,12
0.438,1e-05,518,486,2,100,0.0001,1004,12
0.44,1e-05,572,532,2,100,0.0001,1104,12
0.444,1e-05,616,588,2,100,0.0001,1204,12
0.452,1e-05,670,634,2,100,0.0001,1304,12
0.46,1e-05,718,686,2,100,0.0001,1404,12
0.472,1e-05,763,741,2,100,0.0001,1504,12
0.482,1e-05,811,793,2,100,0.0001,1604,12
0.5,1e-05,862,842,2,100,0.0001,1704,12
0.52,1e-05,904,900,2,100,0.0001,1804,12
0.534,1e-05,963,941,2,100,0.0001,1904,12
0.552,1e-05,1013,991,2,100,0.0001,2004,12
0.482,1e-05,56,48,2,100,0.0001,104,13
0.482,1e-05,111,93,2,100,0.0001,204,13
0.482,1e-05,165,139,2,100,0.0001,304,13
0.482,1e-05,217,187,2,100,0.0001,404,13
0.476,1e-05,260,244,2,100,0.0001,504,13
0.476,1e-05,301,303,2,100,0.0001,604,13
0.472,1e-05,338,366,2,100,0.0001,704,13
0.466,1e-05,393,411,2,100,0.0001,804,13
0.464,1e-05,443,461,2,100,0.0001,904,13
0.464,1e-05,484,520,2,100,0.0001,1004,13
0.462,1e-05,535,569,2,100,0.0001,1104,13
0.458,1e-05,579,625,2,100,0.0001,1204,13
0.458,1e-05,629,675,2,100,0.0001,1304,13
0.456,1e-05,686,718,2,100,0.0001,1404,13
0.45,1e-05,737,767,2,100,0.0001,1504,13
0.444,1e-05,787,817,2,100,0.0001,1604,13
0.43,1e-05,834,870,2,100,0.0001,1704,13
0.426,1e-05,879,925,2,100,0.0001,1804,13
0.414,1e-05,938,966,2,100,0.0001,1904,13
0.404,1e-05,989,1015,2,100,0.0001,2004,13
0.674,1e-05,66,38,2,100,0.0001,104,14
0.68,1e-05,120,84,2,100,0.0001,204,14
0.682,1e-05,161,143,2,100,0.0001,304,14
0.682,1e-05,216,188,2,100,0.0001,404,14
0.686,1e-05,275,229,2,100,0.0001,504,14
0.69,1e-05,330,274,2,100,0.0001,604,14
0.692,1e-05,378,326,2,100,0.0001,704,14
0.7,1e-05,428,376,2,100,0.0001,804,14
0.708,1e-05,475,429,2,100,0.0001,904,14
0.718,1e-05,526,478,2,100,0.0001,1004,14
0.724,1e-05,583,521,2,100,0.0001,1104,14
0.724,1e-05,628,576,2,100,0.0001,1204,14
0.716,1e-05,677,627,2,100,0.0001,1304,14
0.714,1e-05,740,664,2,100,0.0001,1404,14
0.716,1e-05,790,714,2,100,0.0001,1504,14
0.718,1e-05,833,771,2,100,0.0001,1604,14
0.728,1e-05,884,820,2,100,0.0001,1704,14
0.72,1e-05,930,874,2,100,0.0001,1804,14
0.698,1e-05,976,928,2,100,0.0001,1904,14
0.686,1e-05,1023,981,2,100,0.0001,2004,14
0.396,1e-05,49,55,2,100,0.0001,104,15
0.396,1e-05,102,102,2,100,0.0001,204,15
0.396,1e-05,151,153,2,100,0.0001,304,15
0.396,1e-05,202,202,2,100,0.0001,404,15
0.4,1e-05,256,248,2,100,0.0001,504,15
0.4,1e-05,299,305,2,100,0.0001,604,15
0.4,1e-05,349,355,2,100,0.0001,704,15
0.4,1e-05,403,401,2,100,0.0001,804,15
0.398,1e-05,456,448,2,100,0.0001,904,15
0.398,1e-05,506,498,2,100,0.0001,1004,15
0.4,1e-05,554,550,2,100,0.0001,1104,15
0.406,1e-05,609,595,2,100,0.0001,1204,15
0.412,1e-05,655,649,2,100,0.0001,1304,15
0.414,1e-05,702,702,2,100,0.0001,1404,15
0.42,1e-05,746,758,2,100,0.0001,1504,15
0.418,1e-05,792,812,2,100,0.0001,1604,15
0.412,1e-05,838,866,2,100,0.0001,1704,15
0.418,1e-05,891,913,2,100,0.0001,1804,15
0.436,1e-05,944,960,2,100,0.0001,1904,15
0.448,1e-05,1000,1004,2,100,0.0001,2004,15
0.512,1e-05,56,48,2,100,0.0001,104,16
0.516,1e-05,112,92,2,100,0.0001,204,16
0.52,1e-05,151,153,2,100,0.0001,304,16
0.524,1e-05,197,207,2,100,0.0001,404,16
0.524,1e-05,251,253,2,100,0.0001,504,16
0.522,1e-05,308,296,2,100,0.0001,604,16
0.52,1e-05,356,348,2,100,0.0001,704,16
0.524,1e-05,404,400,2,100,0.0001,804,16
0.526,1e-05,449,455,2,100,0.0001,904,16
0.526,1e-05,501,503,2,100,0.0001,1004,16
0.534,1e-05,543,561,2,100,0.0001,1104,16
0.528,1e-05,588,616,2,100,0.0001,1204,16
0.528,1e-05,641,663,2,100,0.0001,1304,16
0.534,1e-05,688,716,2,100,0.0001,1404,16
0.538,1e-05,736,768,2,100,0.0001,1504,16
0.56,1e-05,789,815,2,100,0.0001,1604,16
0.58,1e-05,834,870,2,100,0.0001,1704,16
0.588,1e-05,894,910,2,100,0.0001,1804,16
0.6,1e-05,938,966,2,100,0.0001,1904,16
0.606,1e-05,983,1021,2,100,0.0001,2004,16
0.51,1e-05,56,48,2,100,0.0001,104,17
0.51,1e-05,103,101,2,100,0.0001,204,17
0.512,1e-05,168,136,2,100,0.0001,304,17
0.516,1e-05,223,181,2,100,0.0001,404,17
0.518,1e-05,268,236,2,100,0.0001,504,17
0.518,1e-05,311,293,2,100,0.0001,604,17
0.518,1e-05,367,337,2,100,0.0001,704,17
0.516,1e-05,410,394,2,100,0.0001,804,17
0.518,1e-05,459,445,2,100,0.0001,904,17
0.518,1e-05,506,498,2,100,0.0001,1004,17
0.518,1e-05,564,540,2,100,0.0001,1104,17
0.52,1e-05,615,589,2,100,0.0001,1204,17
0.522,1e-05,660,644,2,100,0.0001,1304,17
0.524,1e-05,710,694,2,100,0.0001,1404,17
0.53,1e-05,768,736,2,100,0.0001,1504,17
0.532,1e-05,811,793,2,100,0.0001,1604,17
0.534,1e-05,857,847,2,100,0.0001,1704,17
0.536,1e-05,893,911,2,100,0.0001,1804,17
0.544,1e-05,945,959,2,100,0.0001,1904,17
0.556,1e-05,992,1012,2,100,0.0001,2004,17
0.558,1e-05,42,62,2,100,0.0001,104,18
0.564,1e-05,97,107,2,100,0.0001,204,18
0.566,1e-05,148,156,2,100,0.0001,304,18
0.576,1e-05,200,204,2,100,0.0001,404,18
0.576,1e-05,253,251,2,100,0.0001,504,18
0.58,1e-05,307,297,2,100,0.0001,604,18
0.586,1e-05,354,350,2,100,0.0001,704,18
0.6,1e-05,398,406,2,100,0.0001,804,18
0.604,1e-05,448,456,2,100,0.0001,904,18
0.606,1e-05,504,500,2,100,0.0001,1004,18
0.628,1e-05,549,555,2,100,0.0001,1104,18
0.644,1e-05,593,611,2,100,0.0001,1204,18
0.648,1e-05,649,655,2,100,0.0001,1304,18
0.65,1e-05,697,707,2,100,0.0001,1404,18
0.652,1e-05,744,760,2,100,0.0001,1504,18
0.658,1e-05,800,804,2,100,0.0001,1604,18
0.652,1e-05,853,851,2,100,0.0001,1704,18
0.654,1e-05,903,901,2,100,0.0001,1804,18
0.648,1e-05,959,945,2,100,0.0001,1904,18
0.652,1e-05,1001,1003,2,100,0.0001,2004,18
0.514,1e-05,50,54,2,100,0.0001,104,19
0.514,1e-05,98,106,2,100,0.0001,204,19
0.512,1e-05,145,159,2,100,0.0001,304,19
0.512,1e-05,183,221,2,100,0.0001,404,19
0.508,1e-05,233,271,2,100,0.0001,504,19
0.508,1e-05,289,315,2,100,0.0001,604,19
0.51,1e-05,339,365,2,100,0.0001,704,19
0.512,1e-05,402,402,2,100,0.0001,804,19
0.51,1e-05,450,454,2,100,0.0001,904,19
0.51,1e-05,501,503,2,100,0.0001,1004,19
0.506,1e-05,555,549,2,100,0.0001,1104,19
0.502,1e-05,610,594,2,100,0.0001,1204,19
0.502,1e-05,659,645,2,100,0.0001,1304,19
0.502,1e-05,711,693,2,100,0.0001,1404,19
0.506,1e-05,763,741,2,100,0.0001,1504,19
0.504,1e-05,813,791,2,100,0.0001,1604,19
0.504,1e-05,868,836,2,100,0.0001,1704,19
0.51,1e-05,922,882,2,100,0.0001,1804,19
0.514,1e-05,971,933,2,100,0.0001,1904,19
0.518,1e-05,1018,986,2,100,0.0001,2004,19
0.454,1e-05,58,46,2,100,0.0001,104,20
0.458,1e-05,97,107,2,100,0.0001,204,20
0.462,1e-05,148,156,2,100,0.0001,304,20
0.458,1e-05,195,209,2,100,0.0001,404,20
0.458,1e-05,241,263,2,100,0.0001,504,20
0.462,1e-05,291,313,2,100,0.0001,604,20
0.468,1e-05,340,364,2,100,0.0001,704,20
0.466,1e-05,396,408,2,100,0.0001,804,20
0.464,1e-05,449,455,2,100,0.0001,904,20
0.472,1e-05,502,502,2,100,0.0001,1004,20
0.47,1e-05,551,553,2,100,0.0001,1104,20
0.478,1e-05,595,609,2,100,0.0001,1204,20
0.48,1e-05,651,653,2,100,0.0001,1304,20
0.486,1e-05,701,703,2,100,0.0001,1404,20
0.49,1e-05,749,755,2,100,0.0001,1504,20
0.502,1e-05,792,812,2,100,0.0001,1604,20
0.508,1e-05,842,862,2,100,0.0001,1704,20
0.53,1e-05,886,918,2,100,0.0001,1804,20
0.542,1e-05,938,966,2,100,0.0001,1904,20
0.554,1e-05,987,1017,2,100,0.0001,2004,20
0.526,1e-05,58,46,2,100,0.001,104,1
0.544,1e-05,110,94,2,100,0.001,204,1
0.54,1e-05,162,142,2,100,0.001,304,1
0.548,1e-05,205,199,2,100,0.001,404,1
0.562,1e-05,257,247,2,100,0.001,504,1
0.568,1e-05,308,296,2,100,0.001,604,1
0.6,1e-05,363,341,2,100,0.001,704,1
0.61,1e-05,419,385,2,100,0.001,804,1
0.604,1e-05,469,435,2,100,0.001,904,1
0.642,1e-05,526,478,2,100,0.001,1004,1
0.65,1e-05,578,526,2,100,0.001,1104,1
0.682,1e-05,632,572,2,100,0.001,1204,1
0.694,1e-05,674,630,2,100,0.001,1304,1
0.712,1e-05,725,679,2,100,0.001,1404,1
0.728,1e-05,776,728,2,100,0.001,1504,1
0.758,1e-05,822,782,2,100,0.001,1604,1
0.758,1e-05,874,830,2,100,0.001,1704,1
0.768,1e-05,924,880,2,100,0.001,1804,1
0.782,1e-05,976,928,2,100,0.001,1904,1
0.79,1e-05,1016,988,2,100,0.001,2004,1
0.47,1e-05,59,45,2,100,0.001,104,2
0.476,1e-05,102,102,2,100,0.001,204,2
0.476,1e-05,158,146,2,100,0.001,304,2
0.484,1e-05,206,198,2,100,0.001,404,2
0.488,1e-05,255,249,2,100,0.001,504,2
0.502,1e-05,311,293,2,100,0.001,604,2
0.526,1e-05,360,344,2,100,0.001,704,2
0.546,1e-05,412,392,2,100,0.001,804,2
0.566,1e-05,463,441,2,100,0.001,904,2
0.58,1e-05,504,500,2,100,0.001,1004,2
0.592,1e-05,548,556,2,100,0.001,1104,2
0.604,1e-05,591,613,2,100,0.001,1204,2
0.618,1e-05,641,663,2,100,0.001,1304,2
0.686,1e-05,690,714,2,100,0.001,1404,2
0.724,1e-05,746,758,2,100,0.001,1504,2
0.742,1e-05,800,804,2,100,0.001,1604,2
0.84,1e-05,844,860,2,100,0.001,1704,2
0.856,1e-05,891,913,2,100,0.001,1804,2
0.846,1e-05,942,962,2,100,0.001,1904,2
0.852,1e-05,1001,1003,2,100,0.001,2004,2
0.482,1e-05,52,52,2,100,0.001,104,3
0.482,1e-05,103,101,2,100,0.001,204,3
0.482,1e-05,156,148,2,100,0.001,304,3
0.482,1e-05,194,210,2,100,0.001,404,3
0.482,1e-05,243,261,2,100,0.001,504,3
0.482,1e-05,303,301,2,100,0.001,604,3
0.48,1e-05,362,342,2,100,0.001,704,3
0.464,1e-05,405,399,2,100,0.001,804,3
0.454,1e-05,459,445,2,100,0.001,904,3
0.45,1e-05,513,491,2,100,0.001,1004,3
0.464,1e-05,561,543,2,100,0.001,1104,3
0.466,1e-05,614,590,2,100,0.001,1204,3
0.452,1e-05,671,633,2,100,0.001,1304,3
0.462,1e-05,718,686,2,100,0.001,1404,3
0.604,1e-05,766,738,2,100,0.001,1504,3
0.706,1e-05,813,791,2,100,0.001,1604,3
0.712,1e-05,852,852,2,100,0.001,1704,3
0.786,1e-05,912,892,2,100,0.001,1804,3
0.82,1e-05,964,940,2,100,0.001,1904,3
0.838,1e-05,1011,993,2,100,0.001,2004,3
0.58,1e-05,51,53,2,100,0.001,104,4
0.584,1e-05,110,94,2,100,0.001,204,4
0.598,1e-05,163,141,2,100,0.001,304,4
0.628,1e-05,202,202,2,100,0.001,404,4
0.652,1e-05,254,250,2,100,0.001,504,4
0.658,1e-05,307,297,2,100,0.001,604,4
0.648,1e-05,358,346,2,100,0.001,704,4
0.652,1e-05,408,396,2,100,0.001,804,4
0.654,1e-05,461,443,2,100,0.001,904,4
0.656,1e-05,513,491,2,100,0.001,1004,4
0.674,1e-05,567,537,2,100,0.001,1104,4
0.678,1e-05,622,582,2,100,0.001,1204,4
0.668,1e-05,674,630,2,100,0.001,1304,4
0.692,1e-05,717,687,2,100,0.001,1404,4
0.702,1e-05,764,740,2,100,0.001,1504,4
0.722,1e-05,807,797,2,100,0.001,1604,4
0.74,1e-05,847,857,2,100,0.001,1704,4
0.768,1e-05,901,903,2,100,0.001,1804,4
0.78,1e-05,952,952,2,100,0.001,1904,4
0.802,1e-05,1009,995,2,100,0.001,2004,4
0.46,1e-05,52,52,2,100,0.001,104,5
0.46,1e-05,105,99,2,100,0.001,204,5
0.46,1e-05,158,146,2,100,0.001,304,5
0.46,1e-05,211,193,2,100,0.001,404,5
0.452,1e-05,263,241,2,100,0.001,504,5
0.48,1e-05,310,294,2,100,0.001,604,5
0.506,1e-05,361,343,2,100,0.001,704,5
0.518,1e-05,423,381,2,100,0.001,804,5
0.518,1e-05,474,430,2,100,0.001,904,5
0.536,1e-05,523,481,2,100,0.001,1004,5
0.55,1e-05,571,533,2,100,0.001,1104,5
0.59,1e-05,626,578,2,100,0.001,1204,5
0.628,1e-05,668,636,2,100,0.001,1304,5
0.68,1e-05,723,681,2,100,0.001,1404,5
0.686,1e-05,772,732,2,100,0.001,1504,5
0.712,1e-05,818,786,2,100,0.001,1604,5
0.73,1e-05,875,829,2,100,0.001,1704,5
0.768,1e-05,927,877,2,100,0.001,1804,5
0.802,1e-05,975,929,2,100,0.001,1904,5
0.848,1e-05,1022,982,2,100,0.001,2004,5
0.49,1e-05,46,58,2,100,0.001,104,6
0.482,1e-05,94,110,2,100,0.001,204,6
0.478,1e-05,143,161,2,100,0.001,304,6
0.478,1e-05,185,219,2,100,0.001,404,6
0.478,1e-05,236,268,2,100,0.001,504,6
0.482,1e-05,288,316,2,100,0.001,604,6
0.512,1e-05,342,362,2,100,0.001,704,6
0.574,1e-05,396,408,2,100,0.001,804,6
0.58,1e-05,437,467,2,100,0.001,904,6
0.626,1e-05,488,516,2,100,0.001,1004,6
0.638,1e-05,544,560,2,100,0.001,1104,6
0.662,1e-05,594,610,2,100,0.001,1204,6
0.662,1e-05,637,667,2,100,0.001,1304,6
0.67,1e-05,690,714,2,100,0.001,1404,6
0.662,1e-05,743,761,2,100,0.001,1504,6
0.658,1e-05,795,809,2,100,0.001,1604,6
0.668,1e-05,846,858,2,100,0.001,1704,6
0.666,1e-05,896,908,2,100,0.001,1804,6
0.672,1e-05,946,958,2,100,0.001,1904,6
0.684,1e-05,991,1013,2,100,0.001,2004,6
0.518,1e-05,52,52,2,100,0.001,104,7
0.546,1e-05,105,99,2,100,0.001,204,7
0.55,1e-05,160,144,2,100,0.001,304,7
0.566,1e-05,199,205,2,100,0.001,404,7
0.574,1e-05,246,258,2,100,0.001,504,7
0.58,1e-05,293,311,2,100,0.001,604,7
0.588,1e-05,349,355,2,100,0.001,704,7
0.604,1e-05,392,412,2,100,0.001,804,7
0.646,1e-05,444,460,2,100,0.001,904,7
0.642,1e-05,488,516,2,100,0.001,1004,7
0.658,1e-05,541,563,2,100,0.001,1104,7
0.686,1e-05,597,607,2,100,0.001,1204,7
0.694,1e-05,650,654,2,100,0.001,1304,7
0.704,1e-05,699,705,2,100,0.001,1404,7
0.718,1e-05,751,753,2,100,0.001,1504,7
0.726,1e-05,804,800,2,100,0.001,1604,7
0.726,1e-05,850,854,2,100,0.001,1704,7
0.72,1e-05,905,899,2,100,0.001,1804,7
0.728,1e-05,955,949,2,100,0.001,1904,7
0.732,1e-05,1006,998,2,100,0.001,2004,7
0.568,1e-05,56,48,2,100,0.001,104,8
0.584,1e-05,109,95,2,100,0.001,204,8
0.606,1e-05,161,143,2,100,0.001,304,8
0.616,1e-05,206,198,2,100,0.001,404,8
0.622,1e-05,253,251,2,100,0.001,504,8
0.624,1e-05,306,298,2,100,0.001,604,8
0.62,1e-05,358,346,2,100,0.001,704,8
0.626,1e-05,410,394,2,100,0.001,804,8
0.626,1e-05,455,449,2,100,0.001,904,8
0.616,1e-05,507,497,2,100,0.001,1004,8
0.652,1e-05,556,548,2,100,0.001,1104,8
0.726,1e-05,611,593,2,100,0.001,1204,8
0.744,1e-05,657,647,2,100,0.001,1304,8
0.764,1e-05,711,693,2,100,0.001,1404,8
0.766,1e-05,754,750,2,100,0.001,1504,8
0.79,1e-05,806,798,2,100,0.001,1604,8
0.806,1e-05,859,845,2,100,0.001,1704,8
0.812,1e-05,911,893,2,100,0.001,1804,8
0.82,1e-05,968,936,2,100,0.001,1904,8
0.822,1e-05,1019,985,2,100,0.001,2004,8
0.462,1e-05,53,51,2,100,0.001,104,9
0.47,1e-05,104,100,2,100,0.001,204,9
0.496,1e-05,155,149,2,100,0.001,304,9
0.514,1e-05,202,202,2,100,0.001,404,9
0.534,1e-05,248,256,2,100,0.001,504,9
0.572,1e-05,295,309,2,100,0.001,604,9
0.576,1e-05,340,364,2,100,0.001,704,9
0.584,1e-05,400,404,2,100,0.001,804,9
0.62,1e-05,445,459,2,100,0.001,904,9
0.676,1e-05,495,509,2,100,0.001,1004,9
0.724,1e-05,547,557,2,100,0.001,1104,9
0.748,1e-05,607,597,2,100,0.001,1204,9
0.756,1e-05,660,644,2,100,0.001,1304,9
0.764,1e-05,718,686,2,100,0.001,1404,9
0.778,1e-05,771,733,2,100,0.001,1504,9
0.802,1e-05,817,787,2,100,0.001,1604,9
0.802,1e-05,863,841,2,100,0.001,1704,9
0.808,1e-05,911,893,2,100,0.001,1804,9
0.812,1e-05,962,942,2,100,0.001,1904,9
0.816,1e-05,1015,989,2,100,0.001,2004,9
0.482,1e-05,63,41,2,100,0.001,104,10
0.484,1e-05,101,103,2,100,0.001,204,10
0.488,1e-05,158,146,2,100,0.001,304,10
0.496,1e-05,211,193,2,100,0.001,404,10
0.52,1e-05,257,247,2,100,0.001,504,10
0.572,1e-05,315,289,2,100,0.001,604,10
0.578,1e-05,358,346,2,100,0.001,704,10
0.586,1e-05,408,396,2,100,0.001,804,10
0.582,1e-05,455,449,2,100,0.001,904,10
0.596,1e-05,512,492,2,100,0.001,1004,10
0.604,1e-05,555,549,2,100,0.001,1104,10
0.63,1e-05,608,596,2,100,0.001,1204,10
0.65,1e-05,659,645,2,100,0.001,1304,10
0.672,1e-05,702,702,2,100,0.001,1404,10
0.67,1e-05,758,746,2,100,0.001,1504,10
0.76,1e-05,797,807,2,100,0.001,1604,10
0.852,1e-05,838,866,2,100,0.001,1704,10
0.836,1e-05,890,914,2,100,0.001,1804,10
0.848,1e-05,946,958,2,100,0.001,1904,10
0.844,1e-05,993,1011,2,100,0.001,2004,10
0.466,1e-05,45,59,2,100,0.001,104,11
0.472,1e-05,101,103,2,100,0.001,204,11
0.472,1e-05,146,158,2,100,0.001,304,11
0.486,1e-05,204,200,2,100,0.001,404,11
0.496,1e-05,258,246,2,100,0.001,504,11
0.54,1e-05,312,292,2,100,0.001,604,11
0.586,1e-05,364,340,2,100,0.001,704,11
0.626,1e-05,416,388,2,100,0.001,804,11
0.682,1e-05,465,439,2,100,0.001,904,11
0.714,1e-05,517,487,2,100,0.001,1004,11
0.718,1e-05,568,536,2,100,0.001,1104,11
0.746,1e-05,622,582,2,100,0.001,1204,11
0.76,1e-05,676,628,2,100,0.001,1304,11
0.786,1e-05,729,675,2,100,0.001,1404,11
0.794,1e-05,780,724,2,100,0.001,1504,11
0.82,1e-05,828,776,2,100,0.001,1604,11
0.81,1e-05,878,826,2,100,0.001,1704,11
0.824,1e-05,927,877,2,100,0.001,1804,11
0.848,1e-05,971,933,2,100,0.001,1904,11
0.862,1e-05,1021,983,2,100,0.001,2004,11
0.522,1e-05,52,52,2,100,0.001,104,12
0.522,1e-05,107,97,2,100,0.001,204,12
0.522,1e-05,152,152,2,100,0.001,304,12
0.522,1e-05,205,199,2,100,0.001,404,12
0.522,1e-05,264,240,2,100,0.001,504,12
0.522,1e-05,315,289,2,100,0.001,604,12
0.522,1e-05,362,342,2,100,0.001,704,12
0.522,1e-05,408,396,2,100,0.001,804,12
0.542,1e-05,453,451,2,100,0.001,904,12
0.598,1e-05,506,498,2,100,0.001,1004,12
0.602,1e-05,551,553,2,100,0.001,1104,12
0.636,1e-05,609,595,2,100,0.001,1204,12
0.694,1e-05,653,651,2,100,0.001,1304,12
0.736,1e-05,694,710,2,100,0.001,1404,12
0.744,1e-05,747,757,2,100,0.001,1504,12
0.74,1e-05,796,808,2,100,0.001,1604,12
0.746,1e-05,851,853,2,100,0.001,1704,12
0.768,1e-05,899,905,2,100,0.001,1804,12
0.778,1e-05,945,959,2,100,0.001,1904,12
0.794,1e-05,991,1013,2,100,0.001,2004,12
0.462,1e-05,54,50,2,100,0.001,104,13
0.462,1e-05,99,105,2,100,0.001,204,13
0.484,1e-05,150,154,2,100,0.001,304,13
0.508,1e-05,201,203,2,100,0.001,404,13
0.52,1e-05,252,252,2,100,0.001,504,13
0.524,1e-05,312,292,2,100,0.001,604,13
0.542,1e-05,362,342,2,100,0.001,704,13
0.552,1e-05,407,397,2,100,0.001,804,13
0.568,1e-05,460,444,2,100,0.001,904,13
0.564,1e-05,512,492,2,100,0.001,1004,13
0.562,1e-05,558,546,2,100,0.001,1104,13
0.57,1e-05,604,600,2,100,0.001,1204,13
0.6,1e-05,652,652,2,100,0.001,1304,13
0.622,1e-05,710,694,2,100,0.001,1404,13
0.632,1e-05,760,744,2,100,0.001,1504,13
0.65,1e-05,810,794,2,100,0.001,1604,13
0.668,1e-05,850,854,2,100,0.001,1704,13
0.674,1e-05,904,900,2,100,0.001,1804,13
0.688,1e-05,947,957,2,100,0.001,1904,13
0.72,1e-05,999,1005,2,100,0.001,2004,13
0.534,1e-05,45,59,2,100,0.001,104,14
0.532,1e-05,96,108,2,100,0.001,204,14
0.526,1e-05,141,163,2,100,0.001,304,14
0.524,1e-05,191,213,2,100,0.001,404,14
0.524,1e-05,241,263,2,100,0.001,504,14
0.534,1e-05,287,317,2,100,0.001,604,14
0.594,1e-05,343,361,2,100,0.001,704,14
0.63,1e-05,387,417,2,100,0.001,804,14
0.67,1e-05,443,461,2,100,0.001,904,14
0.682,1e-05,489,515,2,100,0.001,1004,14
0.708,1e-05,542,562,2,100,0.001,1104,14
0.728,1e-05,591,613,2,100,0.001,1204,14
0.742,1e-05,633,671,2,100,0.001,1304,14
0.756,1e-05,677,727,2,100,0.001,1404,14
0.764,1e-05,729,775,2,100,0.001,1504,14
0.78,1e-05,781,823,2,100,0.001,1604,14
0.792,1e-05,834,870,2,100,0.001,1704,14
0.8,1e-05,880,924,2,100,0.001,1804,14
0.808,1e-05,936,968,2,100,0.001,1904,14
0.814,1e-05,982,1022,2,100,0.001,2004,14
0.478,1e-05,49,55,2,100,0.001,104,15
0.486,1e-05,93,111,2,100,0.001,204,15
0.496,1e-05,139,165,2,100,0.001,304,15
0.51,1e-05,193,211,2,100,0.001,404,15
0.51,1e-05,237,267,2,100,0.001,504,15
0.54,1e-05,294,310,2,100,0.001,604,15
0.562,1e-05,343,361,2,100,0.001,704,15
0.584,1e-05,396,408,2,100,0.001,804,15
0.594,1e-05,447,457,2,100,0.001,904,15
0.606,1e-05,499,505,2,100,0.001,1004,15
0.622,1e-05,557,547,2,100,0.001,1104,15
0.628,1e-05,611,593,2,100,0.001,1204,15
0.658,1e-05,668,636,2,100,0.001,1304,15
0.664,1e-05,713,691,2,100,0.001,1404,15
0.67,1e-05,764,740,2,100,0.001,1504,15
0.692,1e-05,808,796,2,100,0.001,1604,15
0.708,1e-05,858,846,2,100,0.001,1704,15
0.722,1e-05,906,898,2,100,0.001,1804,15
0.74,1e-05,956,948,2,100,0.001,1904,15
0.784,1e-05,1001,1003,2,100,0.001,2004,15
0.55,1e-05,52,52,2,100,0.001,104,16
0.582,1e-05,105,99,2,100,0.001,204,16
0.588,1e-05,157,147,2,100,0.001,304,16
0.602,1e-05,205,199,2,100,0.001,404,16
0.604,1e-05,257,247,2,100,0.001,504,16
0.618,1e-05,306,298,2,100,0.001,604,16
0.634,1e-05,357,347,2,100,0.001,704,16
0.642,1e-05,402,402,2,100,0.001,804,16
0.646,1e-05,457,447,2,100,0.001,904,16
0.646,1e-05,504,500,2,100,0.001,1004,16
0.678,1e-05,548,556,2,100,0.001,1104,16
0.694,1e-05,608,596,2,100,0.001,1204,16
0.708,1e-05,652,652,2,100,0.001,1304,16
0.71,1e-05,700,704,2,100,0.001,1404,16
0.738,1e-05,748,756,2,100,0.001,1504,16
0.78,1e-05,797,807,2,100,0.001,1604,16
0.81,1e-05,849,855,2,100,0.001,1704,16
0.814,1e-05,903,901,2,100,0.001,1804,16
0.82,1e-05,958,946,2,100,0.001,1904,16
0.816,1e-05,1007,997,2,100,0.001,2004,16
0.518,1e-05,53,51,2,100,0.001,104,17
0.516,1e-05,112,92,2,100,0.001,204,17
0.504,1e-05,163,141,2,100,0.001,304,17
0.492,1e-05,209,195,2,100,0.001,404,17
0.486,1e-05,256,248,2,100,0.001,504,17
0.49,1e-05,307,297,2,100,0.001,604,17
0.486,1e-05,359,345,2,100,0.001,704,17
0.494,1e-05,414,390,2,100,0.001,804,17
0.514,1e-05,462,442,2,100,0.001,904,17
0.528,1e-05,515,489,2,100,0.001,1004,17
0.528,1e-05,568,536,2,100,0.001,1104,17
0.55,1e-05,621,583,2,100,0.001,1204,17
0.586,1e-05,665,639,2,100,0.001,1304,17
0.602,1e-05,719,685,2,100,0.001,1404,17
0.68,1e-05,763,741,2,100,0.001,1504,17
0.748,1e-05,807,797,2,100,0.001,1604,17
0.676,1e-05,861,843,2,100,0.001,1704,17
0.744,1e-05,914,890,2,100,0.001,1804,17
0.83,1e-05,969,935,2,100,0.001,1904,17
0.846,1e-05,1021,983,2,100,0.001,2004,17
0.458,1e-05,52,52,2,100,0.001,104,18
0.482,1e-05,99,105,2,100,0.001,204,18
0.482,1e-05,157,147,2,100,0.001,304,18
0.504,1e-05,202,202,2,100,0.001,404,18
0.528,1e-05,255,249,2,100,0.001,504,18
0.554,1e-05,313,291,2,100,0.001,604,18
0.538,1e-05,367,337,2,100,0.001,704,18
0.524,1e-05,417,387,2,100,0.001,804,18
0.502,1e-05,470,434,2,100,0.001,904,18
0.526,1e-05,515,489,2,100,0.001,1004,18
0.556,1e-05,566,538,2,100,0.001,1104,18
0.576,1e-05,611,593,2,100,0.001,1204,18
0.626,1e-05,655,649,2,100,0.001,1304,18
0.636,1e-05,712,692,2,100,0.001,1404,18
0.658,1e-05,762,742,2,100,0.001,1504,18
0.678,1e-05,814,790,2,100,0.001,1604,18
0.7,1e-05,856,848,2,100,0.001,1704,18
0.756,1e-05,901,903,2,100,0.001,1804,18
0.794,1e-05,953,951,2,100,0.001,1904,18
0.84,1e-05,1005,999,2,100,0.001,2004,18
0.468,1e-05,49,55,2,100,0.001,104,19
0.482,1e-05,100,104,2,100,0.001,204,19
0.496,1e-05,155,149,2,100,0.001,304,19
0.526,1e-05,208,196,2,100,0.001,404,19
0.576,1e-05,260,244,2,100,0.001,504,19
0.628,1e-05,310,294,2,100,0.001,604,19
0.672,1e-05,357,347,2,100,0.001,704,19
0.684,1e-05,405,399,2,100,0.001,804,19
0.692,1e-05,445,459,2,100,0.001,904,19
0.704,1e-05,507,497,2,100,0.001,1004,19
0.724,1e-05,562,542,2,100,0.001,1104,19
0.738,1e-05,618,586,2,100,0.001,1204,19
0.75,1e-05,663,641,2,100,0.001,1304,19
0.752,1e-05,703,701,2,100,0.001,1404,19
0.768,1e-05,748,756,2,100,0.001,1504,19
0.772,1e-05,793,811,2,100,0.001,1604,19
0.778,1e-05,854,850,2,100,0.001,1704,19
0.792,1e-05,905,899,2,100,0.001,1804,19
0.812,1e-05,954,950,2,100,0.001,1904,19
0.822,1e-05,1007,997,2,100,0.001,2004,19
0.526,1e-05,48,56,2,100,0.001,104,20
0.532,1e-05,107,97,2,100,0.001,204,20
0.536,1e-05,162,142,2,100,0.001,304,20
0.55,1e-05,216,188,2,100,0.001,404,20
0.556,1e-05,265,239,2,100,0.001,504,20
0.568,1e-05,316,288,2,100,0.001,604,20
0.568,1e-05,369,335,2,100,0.001,704,20
0.578,1e-05,420,384,2,100,0.001,804,20
0.586,1e-05,472,432,2,100,0.001,904,20
0.588,1e-05,521,483,2,100,0.001,1004,20
0.59,1e-05,565,539,2,100,0.001,1104,20
0.596,1e-05,615,589,2,100,0.001,1204,20
0.59,1e-05,659,645,2,100,0.001,1304,20
0.594,1e-05,704,700,2,100,0.001,1404,20
0.606,1e-05,750,754,2,100,0.001,1504,20
0.706,1e-05,792,812,2,100,0.001,1604,20
0.768,1e-05,839,865,2,100,0.001,1704,20
0.804,1e-05,895,909,2,100,0.001,1804,20
0.806,1e-05,946,958,2,100,0.001,1904,20
0.824,1e-05,1005,999,2,100,0.001,2004,20
0.606,1e-05,50,54,2,100,0.01,104,1
0.614,1e-05,102,102,2,100,0.01,204,1
0.556,1e-05,153,151,2,100,0.01,304,1
0.56,1e-05,205,199,2,100,0.01,404,1
0.596,1e-05,254,250,2,100,0.01,504,1
0.72,1e-05,301,303,2,100,0.01,604,1
0.75,1e-05,357,347,2,100,0.01,704,1
0.76,1e-05,398,406,2,100,0.01,804,1
0.79,1e-05,449,455,2,100,0.01,904,1
0.836,1e-05,496,508,2,100,0.01,1004,1
0.854,1e-05,546,558,2,100,0.01,1104,1
0.868,1e-05,594,610,2,100,0.01,1204,1
0.898,1e-05,645,659,2,100,0.01,1304,1
0.916,1e-05,696,708,2,100,0.01,1404,1
0.918,1e-05,752,752,2,100,0.01,1504,1
0.916,1e-05,802,802,2,100,0.01,1604,1
0.916,1e-05,851,853,2,100,0.01,1704,1
0.918,1e-05,897,907,2,100,0.01,1804,1
0.926,1e-05,952,952,2,100,0.01,1904,1
0.938,1e-05,1004,1000,2,100,0.01,2004,1
0.496,1e-05,46,58,2,100,0.01,104,2
0.662,1e-05,93,111,2,100,0.01,204,2
0.7,1e-05,139,165,2,100,0.01,304,2
0.748,1e-05,187,217,2,100,0.01,404,2
0.79,1e-05,238,266,2,100,0.01,504,2
0.828,1e-05,290,314,2,100,0.01,604,2
0.84,1e-05,343,361,2,100,0.01,704,2
0.866,1e-05,395,409,2,100,0.01,804,2
0.884,1e-05,437,467,2,100,0.01,904,2
0.878,1e-05,482,522,2,100,0.01,1004,2
0.892,1e-05,532,572,2,100,0.01,1104,2
0.904,1e-05,581,623,2,100,0.01,1204,2
0.904,1e-05,634,670,2,100,0.01,1304,2
0.922,1e-05,685,719,2,100,0.01,1404,2
0.924,1e-05,734,770,2,100,0.01,1504,2
0.936,1e-05,788,816,2,100,0.01,1604,2
0.944,1e-05,849,855,2,100,0.01,1704,2
0.95,1e-05,905,899,2,100,0.01,1804,2
0.952,1e-05,945,959,2,100,0.01,1904,2
0.956,1e-05,1003,1001,2,100,0.01,2004,2
0.516,1e-05,43,61,2,100,0.01,104,3
0.662,1e-05,92,112,2,100,0.01,204,3
0.686,1e-05,145,159,2,100,0.01,304,3
0.69,1e-05,200,204,2,100,0.01,404,3
0.69,1e-05,256,248,2,100,0.01,504,3
0.692,1e-05,300,304,2,100,0.01,604,3
0.736,1e-05,340,364,2,100,0.01,704,3
0.77,1e-05,393,411,2,100,0.01,804,3
0.792,1e-05,441,463,2,100,0.01,904,3
0.814,1e-05,490,514,2,100,0.01,1004,3
0.846,1e-05,532,572,2,100,0.01,1104,3
0.874,1e-05,577,627,2,100,0.01,1204,3
0.89,1e-05,626,678,2,100,0.01,1304,3
0.888,1e-05,680,724,2,100,0.01,1404,3
0.888,1e-05,737,767,2,100,0.01,1504,3
0.902,1e-05,784,820,2,100,0.01,1604,3
0.916,1e-05,833,871,2,100,0.01,1704,3
0.922,1e-05,880,924,2,100,0.01,1804,3
0.932,1e-05,933,971,2,100,0.01,1904,3
0.94,1e-05,992,1012,2,100,0.01,2004,3
0.516,1e-05,51,53,2,100,0.01,104,4
0.628,1e-05,103,101,2,100,0.01,204,4
0.588,1e-05,148,156,2,100,0.01,304,4
0.574,1e-05,193,211,2,100,0.01,404,4
0.588,1e-05,235,269,2,100,0.01,504,4
0.624,1e-05,283,321,2,100,0.01,604,4
0.714,1e-05,344,360,2,100,0.01,704,4
0.776,1e-05,399,405,2,100,0.01,804,4
0.834,1e-05,444,460,2,100,0.01,904,4
0.842,1e-05,493,511,2,100,0.01,1004,4
0.826,1e-05,534,570,2,100,0.01,1104,4
0.866,1e-05,590,614,2,100,0.01,1204,4
0.88,1e-05,636,668,2,100,0.01,1304,4
0.898,1e-05,685,719,2,100,0.01,1404,4
0.91,1e-05,739,765,2,100,0.01,1504,4
0.92,1e-05,789,815,2,100,0.01,1604,4
0.91,1e-05,844,860,2,100,0.01,1704,4
0.918,1e-05,895,909,2,100,0.01,1804,4
0.922,1e-05,944,960,2,100,0.01,1904,4
0.928,1e-05,995,1009,2,100,0.01,2004,4
0.532,1e-05,48,56,2,100,0.01,104,5
0.676,1e-05,91,113,2,100,0.01,204,5
0.726,1e-05,150,154,2,100,0.01,304,5
0.84,1e-05,205,199,2,100,0.01,404,5
0.666,1e-05,255,249,2,100,0.01,504,5
0.732,1e-05,310,294,2,100,0.01,604,5
0.888,1e-05,368,336,2,100,0.01,704,5
0.88,1e-05,413,391,2,100,0.01,804,5
0.872,1e-05,460,444,2,100,0.01,904,5
0.88,1e-05,514,490,2,100,0.01,1004,5
0.896,1e-05,567,537,2,100,0.01,1104,5
0.93,1e-05,621,583,2,100,0.01,1204,5
0.934,1e-05,664,640,2,100,0.01,1304,5
0.932,1e-05,714,690,2,100,0.01,1404,5
0.936,1e-05,764,740,2,100,0.01,1504,5
0.946,1e-05,816,788,2,100,0.01,1604,5
0.954,1e-05,866,838,2,100,0.01,1704,5
0.956,1e-05,914,890,2,100,0.01,1804,5
0.956,1e-05,960,944,2,100,0.01,1904,5
0.96,1e-05,1011,993,2,100,0.01,2004,5
0.576,1e-05,55,49,2,100,0.01,104,6
0.592,1e-05,98,106,2,100,0.01,204,6
0.614,1e-05,135,169,2,100,0.01,304,6
0.698,1e-05,182,222,2,100,0.01,404,6
0.726,1e-05,232,272,2,100,0.01,504,6
0.762,1e-05,288,316,2,100,0.01,604,6
0.804,1e-05,341,363,2,100,0.01,704,6
0.83,1e-05,390,414,2,100,0.01,804,6
0.838,1e-05,445,459,2,100,0.01,904,6
0.858,1e-05,499,505,2,100,0.01,1004,6
0.874,1e-05,556,548,2,100,0.01,1104,6
0.888,1e-05,605,599,2,100,0.01,1204,6
0.888,1e-05,652,652,2,100,0.01,1304,6
0.91,1e-05,707,697,2,100,0.01,1404,6
0.922,1e-05,754,750,2,100,0.01,1504,6
0.926,1e-05,804,800,2,100,0.01,1604,6
0.934,1e-05,850,854,2,100,0.01,1704,6
0.94,1e-05,896,908,2,100,0.01,1804,6
0.936,1e-05,948,956,2,100,0.01,1904,6
0.944,1e-05,1002,1002,2,100,0.01,2004,6
0.498,1e-05,56,48,2,100,0.01,104,7
0.622,1e-05,102,102,2,100,0.01,204,7
0.654,1e-05,160,144,2,100,0.01,304,7
0.664,1e-05,213,191,2,100,0.01,404,7
0.558,1e-05,257,247,2,100,0.01,504,7
0.674,1e-05,304,300,2,100,0.01,604,7
0.758,1e-05,356,348,2,100,0.01,704,7
0.822,1e-05,409,395,2,100,0.01,804,7
0.808,1e-05,461,443,2,100,0.01,904,7
0.85,1e-05,513,491,2,100,0.01,1004,7
0.872,1e-05,563,541,2,100,0.01,1104,7
0.9,1e-05,617,587,2,100,0.01,1204,7
0.902,1e-05,668,636,2,100,0.01,1304,7
0.922,1e-05,712,692,2,100,0.01,1404,7
0.928,1e-05,759,745,2,100,0.01,1504,7
0.936,1e-05,801,803,2,100,0.01,1604,7
0.946,1e-05,854,850,2,100,0.01,1704,7
0.946,1e-05,907,897,2,100,0.01,1804,7
0.948,1e-05,955,949,2,100,0.01,1904,7
0.948,1e-05,1000,1004,2,100,0.01,2004,7
0.566,1e-05,56,48,2,100,0.01,104,8
0.58,1e-05,107,97,2,100,0.01,204,8
0.554,1e-05,167,137,2,100,0.01,304,8
0.542,1e-05,229,175,2,100,0.01,404,8
0.566,1e-05,279,225,2,100,0.01,504,8
0.746,1e-05,333,271,2,100,0.01,604,8
0.82,1e-05,380,324,2,100,0.01,704,8
0.876,1e-05,426,378,2,100,0.01,804,8
0.868,1e-05,475,429,2,100,0.01,904,8
0.858,1e-05,527,477,2,100,0.01,1004,8
0.864,1e-05,571,533,2,100,0.01,1104,8
0.89,1e-05,624,580,2,100,0.01,1204,8
0.906,1e-05,669,635,2,100,0.01,1304,8
0.9,1e-05,719,685,2,100,0.01,1404,8
0.91,1e-05,777,727,2,100,0.01,1504,8
0.91,1e-05,824,780,2,100,0.01,1604,8
0.924,1e-05,867,837,2,100,0.01,1704,8
0.916,1e-05,909,895,2,100,0.01,1804,8
0.924,1e-05,962,942,2,100,0.01,1904,8
0.938,1e-05,1008,996,2,100,0.01,2004,8
0.474,1e-05,51,53,2,100,0.01,104,9
0.54,1e-05,101,103,2,100,0.01,204,9
0.564,1e-05,153,151,2,100,0.01,304,9
0.564,1e-05,204,200,2,100,0.01,404,9
0.578,1e-05,254,250,2,100,0.01,504,9
0.608,1e-05,311,293,2,100,0.01,604,9
0.664,1e-05,353,351,2,100,0.01,704,9
0.752,1e-05,402,402,2,100,0.01,804,9
0.832,1e-05,457,447,2,100,0.01,904,9
0.856,1e-05,498,506,2,100,0.01,1004,9
0.864,1e-05,545,559,2,100,0.01,1104,9
0.926,1e-05,591,613,2,100,0.01,1204,9
0.926,1e-05,649,655,2,100,0.01,1304,9
0.942,1e-05,694,710,2,100,0.01,1404,9
0.94,1e-05,747,757,2,100,0.01,1504,9
0.938,1e-05,788,816,2,100,0.01,1604,9
0.938,1e-05,846,858,2,100,0.01,1704,9
0.94,1e-05,889,915,2,100,0.01,1804,9
0.948,1e-05,940,964,2,100,0.01,1904,9
0.954,1e-05,995,1009,2,100,0.01,2004,9
0.532,1e-05,50,54,2,100,0.01,104,10
0.568,1e-05,100,104,2,100,0.01,204,10
0.592,1e-05,147,157,2,100,0.01,304,10
0.64,1e-05,199,205,2,100,0.01,404,10
0.67,1e-05,252,252,2,100,0.01,504,10
0.704,1e-05,296,308,2,100,0.01,604,10
0.754,1e-05,351,353,2,100,0.01,704,10
0.812,1e-05,403,401,2,100,0.01,804,10
0.78,1e-05,451,453,2,100,0.01,904,10
0.804,1e-05,514,490,2,100,0.01,1004,10
0.866,1e-05,569,535,2,100,0.01,1104,10
0.904,1e-05,622,582,2,100,0.01,1204,10
0.922,1e-05,680,624,2,100,0.01,1304,10
0.932,1e-05,723,681,2,100,0.01,1404,10
0.938,1e-05,774,730,2,100,0.01,1504,10
0.942,1e-05,823,781,2,100,0.01,1604,10
0.934,1e-05,870,834,2,100,0.01,1704,10
0.934,1e-05,911,893,2,100,0.01,1804,10
0.95,1e-05,961,943,2,100,0.01,1904,10
0.958,1e-05,1009,995,2,100,0.01,2004,10
0.42,1e-05,50,54,2,100,0.01,104,11
0.638,1e-05,101,103,2,100,0.01,204,11
0.624,1e-05,147,157,2,100,0.01,304,11
0.748,1e-05,202,202,2,100,0.01,404,11
0.782,1e-05,259,245,2,100,0.01,504,11
0.806,1e-05,304,300,2,100,0.01,604,11
0.876,1e-05,354,350,2,100,0.01,704,11
0.882,1e-05,406,398,2,100,0.01,804,11
0.898,1e-05,459,445,2,100,0.01,904,11
0.912,1e-05,507,497,2,100,0.01,1004,11
0.916,1e-05,550,554,2,100,0.01,1104,11
0.92,1e-05,599,605,2,100,0.01,1204,11
0.926,1e-05,652,652,2,100,0.01,1304,11
0.928,1e-05,697,707,2,100,0.01,1404,11
0.934,1e-05,753,751,2,100,0.01,1504,11
0.952,1e-05,807,797,2,100,0.01,1604,11
0.952,1e-05,858,846,2,100,0.01,1704,11
0.952,1e-05,910,894,2,100,0.01,1804,11
0.956,1e-05,957,947,2,100,0.01,1904,11
0.958,1e-05,1011,993,2,100,0.01,2004,11
0.542,1e-05,62,42,2,100,0.01,104,12
0.506,1e-05,107,97,2,100,0.01,204,12
0.536,1e-05,161,143,2,100,0.01,304,12
0.544,1e-05,218,186,2,100,0.01,404,12
0.558,1e-05,262,242,2,100,0.01,504,12
0.77,1e-05,308,296,2,100,0.01,604,12
0.856,1e-05,361,343,2,100,0.01,704,12
0.874,1e-05,401,403,2,100,0.01,804,12
0.876,1e-05,455,449,2,100,0.01,904,12
0.886,1e-05,495,509,2,100,0.01,1004,12
0.876,1e-05,540,564,2,100,0.01,1104,12
0.894,1e-05,594,610,2,100,0.01,1204,12
0.908,1e-05,648,656,2,100,0.01,1304,12
0.908,1e-05,694,710,2,100,0.01,1404,12
0.908,1e-05,746,758,2,100,0.01,1504,12
0.918,1e-05,801,803,2,100,0.01,1604,12
0.922,1e-05,862,842,2,100,0.01,1704,12
0.928,1e-05,909,895,2,100,0.01,1804,12
0.928,1e-05,959,945,2,100,0.01,1904,12
0.934,1e-05,1007,997,2,100,0.01,2004,12
0.626,1e-05,59,45,2,100,0.01,104,13
0.45,1e-05,113,91,2,100,0.01,204,13
0.506,1e-05,161,143,2,100,0.01,304,13
0.512,1e-05,204,200,2,100,0.01,404,13
0.554,1e-05,248,256,2,100,0.01,504,13
0.782,1e-05,292,312,2,100,0.01,604,13
0.782,1e-05,341,363,2,100,0.01,704,13
0.806,1e-05,391,413,2,100,0.01,804,13
0.808,1e-05,441,463,2,100,0.01,904,13
0.856,1e-05,490,514,2,100,0.01,1004,13
0.894,1e-05,542,562,2,100,0.01,1104,13
0.914,1e-05,583,621,2,100,0.01,1204,13
0.906,1e-05,627,677,2,100,0.01,1304,13
0.914,1e-05,683,721,2,100,0.01,1404,13
0.926,1e-05,734,770,2,100,0.01,1504,13
0.934,1e-05,779,825,2,100,0.01,1604,13
0.948,1e-05,833,871,2,100,0.01,1704,13
0.952,1e-05,889,915,2,100,0.01,1804,13
0.956,1e-05,941,963,2,100,0.01,1904,13
0.962,1e-05,996,1008,2,100,0.01,2004,13
0.55,1e-05,49,55,2,100,0.01,104,14
0.586,1e-05,105,99,2,100,0.01,204,14
0.592,1e-05,153,151,2,100,0.01,304,14
0.602,1e-05,212,192,2,100,0.01,404,14
0.596,1e-05,256,248,2,100,0.01,504,14
0.608,1e-05,301,303,2,100,0.01,604,14
0.65,1e-05,352,352,2,100,0.01,704,14
0.724,1e-05,399,405,2,100,0.01,804,14
0.766,1e-05,451,453,2,100,0.01,904,14
0.808,1e-05,503,501,2,100,0.01,1004,14
0.854,1e-05,551,553,2,100,0.01,1104,14
0.874,1e-05,609,595,2,100,0.01,1204,14
0.89,1e-05,660,644,2,100,0.01,1304,14
0.898,1e-05,704,700,2,100,0.01,1404,14
0.926,1e-05,756,748,2,100,0.01,1504,14
0.924,1e-05,812,792,2,100,0.01,1604,14
0.924,1e-05,858,846,2,100,0.01,1704,14
0.924,1e-05,903,901,2,100,0.01,1804,14
0.942,1e-05,949,955,2,100,0.01,1904,14
0.952,1e-05,998,1006,2,100,0.01,2004,14
0.572,1e-05,48,56,2,100,0.01,104,15
0.604,1e-05,96,108,2,100,0.01,204,15
0.598,1e-05,149,155,2,100,0.01,304,15
0.624,1e-05,194,210,2,100,0.01,404,15
0.668,1e-05,252,252,2,100,0.01,504,15
0.738,1e-05,297,307,2,100,0.01,604,15
0.75,1e-05,346,358,2,100,0.01,704,15
0.79,1e-05,398,406,2,100,0.01,804,15
0.828,1e-05,445,459,2,100,0.01,904,15
0.852,1e-05,504,500,2,100,0.01,1004,15
0.864,1e-05,550,554,2,100,0.01,1104,15
0.862,1e-05,602,602,2,100,0.01,1204,15
0.862,1e-05,656,648,2,100,0.01,1304,15
0.88,1e-05,714,690,2,100,0.01,1404,15
0.902,1e-05,756,748,2,100,0.01,1504,15
0.928,1e-05,800,804,2,100,0.01,1604,15
0.93,1e-05,851,853,2,100,0.01,1704,15
0.92,1e-05,895,909,2,100,0.01,1804,15
0.932,1e-05,943,961,2,100,0.01,1904,15
0.946,1e-05,988,1016,2,100,0.01,2004,15
0.662,1e-05,48,56,2,100,0.01,104,16
0.698,1e-05,98,106,2,100,0.01,204,16
0.708,1e-05,149,155,2,100,0.01,304,16
0.746,1e-05,198,206,2,100,0.01,404,16
0.758,1e-05,253,251,2,100,0.01,504,16
0.786,1e-05,309,295,2,100,0.01,604,16
0.772,1e-05,371,333,2,100,0.01,704,16
0.802,1e-05,422,382,2,100,0.01,804,16
0.858,1e-05,470,434,2,100,0.01,904,16
0.872,1e-05,520,484,2,100,0.01,1004,16
0.9,1e-05,573,531,2,100,0.01,1104,16
0.9,1e-05,624,580,2,100,0.01,1204,16
0.898,1e-05,674,630,2,100,0.01,1304,16
0.904,1e-05,725,679,2,100,0.01,1404,16
0.912,1e-05,772,732,2,100,0.01,1504,16
0.916,1e-05,812,792,2,100,0.01,1604,16
0.92,1e-05,858,846,2,100,0.01,1704,16
0.928,1e-05,906,898,2,100,0.01,1804,16
0.944,1e-05,951,953,2,100,0.01,1904,16
0.944,1e-05,999,1005,2,100,0.01,2004,16
0.452,1e-05,50,54,2,100,0.01,104,17
0.57,1e-05,98,106,2,100,0.01,204,17
0.576,1e-05,157,147,2,100,0.01,304,17
0.584,1e-05,212,192,2,100,0.01,404,17
0.576,1e-05,260,244,2,100,0.01,504,17
0.614,1e-05,314,290,2,100,0.01,604,17
0.778,1e-05,365,339,2,100,0.01,704,17
0.788,1e-05,420,384,2,100,0.01,804,17
0.754,1e-05,463,441,2,100,0.01,904,17
0.866,1e-05,506,498,2,100,0.01,1004,17
0.808,1e-05,550,554,2,100,0.01,1104,17
0.854,1e-05,595,609,2,100,0.01,1204,17
0.88,1e-05,639,665,2,100,0.01,1304,17
0.918,1e-05,679,725,2,100,0.01,1404,17
0.928,1e-05,724,780,2,100,0.01,1504,17
0.93,1e-05,772,832,2,100,0.01,1604,17
0.922,1e-05,821,883,2,100,0.01,1704,17
0.94,1e-05,876,928,2,100,0.01,1804,17
0.952,1e-05,927,977,2,100,0.01,1904,17
0.954,1e-05,978,1026,2,100,0.01,2004,17
0.412,1e-05,55,49,2,100,0.01,104,18
0.51,1e-05,97,107,2,100,0.01,204,18
0.562,1e-05,148,156,2,100,0.01,304,18
0.604,1e-05,202,202,2,100,0.01,404,18
0.624,1e-05,256,248,2,100,0.01,504,18
0.764,1e-05,307,297,2,100,0.01,604,18
0.862,1e-05,355,349,2,100,0.01,704,18
0.886,1e-05,400,404,2,100,0.01,804,18
0.888,1e-05,445,459,2,100,0.01,904,18
0.904,1e-05,487,517,2,100,0.01,1004,18
0.894,1e-05,532,572,2,100,0.01,1104,18
0.904,1e-05,587,617,2,100,0.01,1204,18
0.91,1e-05,635,669,2,100,0.01,1304,18
0.914,1e-05,688,716,2,100,0.01,1404,18
0.922,1e-05,741,763,2,100,0.01,1504,18
0.926,1e-05,797,807,2,100,0.01,1604,18
0.928,1e-05,844,860,2,100,0.01,1704,18
0.928,1e-05,898,906,2,100,0.01,1804,18
0.93,1e-05,952,952,2,100,0.01,1904,18
0.938,1e-05,1003,1001,2,100,0.01,2004,18
0.478,1e-05,54,50,2,100,0.01,104,19
0.648,1e-05,108,96,2,100,0.01,204,19
0.678,1e-05,158,146,2,100,0.01,304,19
0.75,1e-05,203,201,2,100,0.01,404,19
0.752,1e-05,252,252,2,100,0.01,504,19
0.796,1e-05,297,307,2,100,0.01,604,19
0.788,1e-05,347,357,2,100,0.01,704,19
0.832,1e-05,405,399,2,100,0.01,804,19
0.916,1e-05,452,452,2,100,0.01,904,19
0.926,1e-05,509,495,2,100,0.01,1004,19
0.926,1e-05,559,545,2,100,0.01,1104,19
0.932,1e-05,603,601,2,100,0.01,1204,19
0.938,1e-05,651,653,2,100,0.01,1304,19
0.95,1e-05,702,702,2,100,0.01,1404,19
0.956,1e-05,749,755,2,100,0.01,1504,19
0.96,1e-05,798,806,2,100,0.01,1604,19
0.96,1e-05,846,858,2,100,0.01,1704,19
0.968,1e-05,898,906,2,100,0.01,1804,19
0.968,1e-05,950,954,2,100,0.01,1904,19
0.964,1e-05,1004,1000,2,100,0.01,2004,19
0.608,1e-05,50,54,2,100,0.01,104,20
0.686,1e-05,103,101,2,100,0.01,204,20
0.492,1e-05,170,134,2,100,0.01,304,20
0.5,1e-05,229,175,2,100,0.01,404,20
0.534,1e-05,274,230,2,100,0.01,504,20
0.6,1e-05,323,281,2,100,0.01,604,20
0.67,1e-05,372,332,2,100,0.01,704,20
0.882,1e-05,419,385,2,100,0.01,804,20
0.884,1e-05,477,427,2,100,0.01,904,20
0.896,1e-05,521,483,2,100,0.01,1004,20
0.934,1e-05,573,531,2,100,0.01,1104,20
0.924,1e-05,616,588,2,100,0.01,1204,20
0.916,1e-05,664,640,2,100,0.01,1304,20
0.932,1e-05,717,687,2,100,0.01,1404,20
0.934,1e-05,766,738,2,100,0.01,1504,20
0.95,1e-05,823,781,2,100,0.01,1604,20
0.944,1e-05,873,831,2,100,0.01,1704,20
0.948,1e-05,923,881,2,100,0.01,1804,20
0.95,1e-05,971,933,2,100,0.01,1904,20
0.95,1e-05,1024,980,2,100,0.01,2004,20
0.532,0.0001,50,54,2,100,0.0001,104,1
0.532,0.0001,106,98,2,100,0.0001,204,1
0.532,0.0001,155,149,2,100,0.0001,304,1
0.53,0.0001,211,193,2,100,0.0001,404,1
0.53,0.0001,256,248,2,100,0.0001,504,1
0.53,0.0001,313,291,2,100,0.0001,604,1
0.53,0.0001,365,339,2,100,0.0001,704,1
0.532,0.0001,409,395,2,100,0.0001,804,1
0.534,0.0001,467,437,2,100,0.0001,904,1
0.536,0.0001,521,483,2,100,0.0001,1004,1
0.536,0.0001,568,536,2,100,0.0001,1104,1
0.536,0.0001,616,588,2,100,0.0001,1204,1
0.538,0.0001,665,639,2,100,0.0001,1304,1
0.538,0.0001,711,693,2,100,0.0001,1404,1
0.54,0.0001,771,733,2,100,0.0001,1504,1
0.544,0.0001,820,784,2,100,0.0001,1604,1
0.54,0.0001,864,840,2,100,0.0001,1704,1
0.544,0.0001,908,896,2,100,0.0001,1804,1
0.548,0.0001,955,949,2,100,0.0001,1904,1
0.556,0.0001,1016,988,2,100,0.0001,2004,1
0.498,0.0001,51,53,2,100,0.0001,104,2
0.498,0.0001,107,97,2,100,0.0001,204,2
0.498,0.0001,153,151,2,100,0.0001,304,2
0.498,0.0001,200,204,2,100,0.0001,404,2
0.498,0.0001,257,247,2,100,0.0001,504,2
0.498,0.0001,313,291,2,100,0.0001,604,2
0.498,0.0001,364,340,2,100,0.0001,704,2
0.498,0.0001,411,393,2,100,0.0001,804,2
0.498,0.0001,460,444,2,100,0.0001,904,2
0.498,0.0001,509,495,2,100,0.0001,1004,2
0.498,0.0001,559,545,2,100,0.0001,1104,2
0.498,0.0001,614,590,2,100,0.0001,1204,2
0.498,0.0001,659,645,2,100,0.0001,1304,2
0.498,0.0001,703,701,2,100,0.0001,1404,2
0.498,0.0001,753,751,2,100,0.0001,1504,2
0.498,0.0001,803,801,2,100,0.0001,1604,2
0.498,0.0001,847,857,2,100,0.0001,1704,2
0.498,0.0001,907,897,2,100,0.0001,1804,2
0.498,0.0001,951,953,2,100,0.0001,1904,2
0.498,0.0001,1001,1003,2,100,0.0001,2004,2
0.462,0.0001,47,57,2,100,0.0001,104,3
0.464,0.0001,96,108,2,100,0.0001,204,3
0.464,0.0001,152,152,2,100,0.0001,304,3
0.464,0.0001,198,206,2,100,0.0001,404,3
0.466,0.0001,245,259,2,100,0.0001,504,3
0.468,0.0001,289,315,2,100,0.0001,604,3
0.47,0.0001,331,373,2,100,0.0001,704,3
0.474,0.0001,390,414,2,100,0.0001,804,3
0.476,0.0001,445,459,2,100,0.0001,904,3
0.476,0.0001,498,506,2,100,0.0001,1004,3
0.474,0.0001,553,551,2,100,0.0001,1104,3
0.48,0.0001,600,604,2,100,0.0001,1204,3
0.486,0.0001,654,650,2,100,0.0001,1304,3
0.494,0.0001,703,701,2,100,0.0001,1404,3
0.498,0.0001,750,754,2,100,0.0001,1504,3
0.524,0.0001,798,806,2,100,0.0001,1604,3
0.538,0.0001,850,854,2,100,0.0001,1704,3
0.554,0.0001,908,896,2,100,0.0001,1804,3
0.57,0.0001,956,948,2,100,0.0001,1904,3
0.59,0.0001,1004,1000,2,100,0.0001,2004,3
0.47,0.0001,56,48,2,100,0.0001,104,4
0.47,0.0001,102,102,2,100,0.0001,204,4
0.47,0.0001,158,146,2,100,0.0001,304,4
0.47,0.0001,213,191,2,100,0.0001,404,4
0.47,0.0001,259,245,2,100,0.0001,504,4
0.47,0.0001,311,293,2,100,0.0001,604,4
0.47,0.0001,357,347,2,100,0.0001,704,4
0.47,0.0001,413,391,2,100,0.0001,804,4
0.47,0.0001,456,448,2,100,0.0001,904,4
0.47,0.0001,512,492,2,100,0.0001,1004,4
0.468,0.0001,561,543,2,100,0.0001,1104,4
0.464,0.0001,612,592,2,100,0.0001,1204,4
0.464,0.0001,662,642,2,100,0.0001,1304,4
0.464,0.0001,712,692,2,100,0.0001,1404,4
0.464,0.0001,752,752,2,100,0.0001,1504,4
0.464,0.0001,806,798,2,100,0.0001,1604,4
0.462,0.0001,858,846,2,100,0.0001,1704,4
0.46,0.0001,910,894,2,100,0.0001,1804,4
0.48,0.0001,966,938,2,100,0.0001,1904,4
0.492,0.0001,1017,987,2,100,0.0001,2004,4
0.51,0.0001,50,54,2,100,0.0001,104,5
0.51,0.0001,99,105,2,100,0.0001,204,5
0.51,0.0001,145,159,2,100,0.0001,304,5
0.51,0.0001,195,209,2,100,0.0001,404,5
0.51,0.0001,248,256,2,100,0.0001,504,5
0.51,0.0001,306,298,2,100,0.0001,604,5
0.51,0.0001,357,347,2,100,0.0001,704,5
0.51,0.0001,409,395,2,100,0.0001,804,5
0.51,0.0001,455,449,2,100,0.0001,904,5
0.51,0.0001,499,505,2,100,0.0001,1004,5
0.51,0.0001,543,561,2,100,0.0001,1104,5
0.51,0.0001,594,610,2,100,0.0001,1204,5
0.51,0.0001,641,663,2,100,0.0001,1304,5
0.51,0.0001,696,708,2,100,0.0001,1404,5
0.512,0.0001,740,764,2,100,0.0001,1504,5
0.512,0.0001,794,810,2,100,0.0001,1604,5
0.512,0.0001,844,860,2,100,0.0001,1704,5
0.514,0.0001,896,908,2,100,0.0001,1804,5
0.516,0.0001,948,956,2,100,0.0001,1904,5
0.518,0.0001,997,1007,2,100,0.0001,2004,5
0.498,0.0001,52,52,2,100,0.0001,104,6
0.498,0.0001,106,98,2,100,0.0001,204,6
0.498,0.0001,156,148,2,100,0.0001,304,6
0.498,0.0001,197,207,2,100,0.0001,404,6
0.498,0.0001,248,256,2,100,0.0001,504,6
0.498,0.0001,295,309,2,100,0.0001,604,6
0.498,0.0001,352,352,2,100,0.0001,704,6
0.498,0.0001,404,400,2,100,0.0001,804,6
0.498,0.0001,452,452,2,100,0.0001,904,6
0.498,0.0001,503,501,2,100,0.0001,1004,6
0.498,0.0001,563,541,2,100,0.0001,1104,6
0.498,0.0001,604,600,2,100,0.0001,1204,6
0.498,0.0001,654,650,2,100,0.0001,1304,6
0.498,0.0001,697,707,2,100,0.0001,1404,6
0.498,0.0001,750,754,2,100,0.0001,1504,6
0.498,0.0001,808,796,2,100,0.0001,1604,6
0.498,0.0001,852,852,2,100,0.0001,1704,6
0.498,0.0001,902,902,2,100,0.0001,1804,6
0.498,0.0001,951,953,2,100,0.0001,1904,6
0.498,0.0001,1003,1001,2,100,0.0001,2004,6
0.468,0.0001,52,52,2,100,0.0001,104,7
0.466,0.0001,112,92,2,100,0.0001,204,7
0.466,0.0001,152,152,2,100,0.0001,304,7
0.466,0.0001,199,205,2,100,0.0001,404,7
0.464,0.0001,247,257,2,100,0.0001,504,7
0.464,0.0001,300,304,2,100,0.0001,604,7
0.464,0.0001,356,348,2,100,0.0001,704,7
0.464,0.0001,408,396,2,100,0.0001,804,7
0.462,0.0001,455,449,2,100,0.0001,904,7
0.46,0.0001,506,498,2,100,0.0001,1004,7
0.458,0.0001,561,543,2,100,0.0001,1104,7
0.454,0.0001,600,604,2,100,0.0001,1204,7
0.454,0.0001,648,656,2,100,0.0001,1304,7
0.45,0.0001,700,704,2,100,0.0001,1404,7
0.446,0.0001,756,748,2,100,0.0001,1504,7
0.448,0.0001,812,792,2,100,0.0001,1604,7
0.448,0.0001,867,837,2,100,0.0001,1704,7
0.456,0.0001,917,887,2,100,0.0001,1804,7
0.46,0.0001,970,934,2,100,0.0001,1904,7
0.466,0.0001,1013,991,2,100,0.0001,2004,7
0.522,0.0001,48,56,2,100,0.0001,104,8
0.528,0.0001,104,100,2,100,0.0001,204,8
0.524,0.0001,152,152,2,100,0.0001,304,8
0.524,0.0001,209,195,2,100,0.0001,404,8
0.524,0.0001,251,253,2,100,0.0001,504,8
0.528,0.0001,303,301,2,100,0.0001,604,8
0.536,0.0001,349,355,2,100,0.0001,704,8
0.536,0.0001,401,403,2,100,0.0001,804,8
0.54,0.0001,453,451,2,100,0.0001,904,8
0.554,0.0001,509,495,2,100,0.0001,1004,8
0.556,0.0001,556,548,2,100,0.0001,1104,8
0.562,0.0001,603,601,2,100,0.0001,1204,8
0.562,0.0001,653,651,2,100,0.0001,1304,8
0.574,0.0001,703,701,2,100,0.0001,1404,8
0.578,0.0001,741,763,2,100,0.0001,1504,8
0.592,0.0001,800,804,2,100,0.0001,1604,8
0.592,0.0001,854,850,2,100,0.0001,1704,8
0.602,0.0001,912,892,2,100,0.0001,1804,8
0.598,0.0001,957,947,2,100,0.0001,1904,8
0.604,0.0001,1007,997,2,100,0.0001,2004,8
0.39,0.0001,52,52,2,100,0.0001,104,9
0.392,0.0001,108,96,2,100,0.0001,204,9
0.394,0.0001,158,146,2,100,0.0001,304,9
0.392,0.0001,211,193,2,100,0.0001,404,9
0.392,0.0001,264,240,2,100,0.0001,504,9
0.39,0.0001,309,295,2,100,0.0001,604,9
0.392,0.0001,361,343,2,100,0.0001,704,9
0.39,0.0001,415,389,2,100,0.0001,804,9
0.392,0.0001,461,443,2,100,0.0001,904,9
0.396,0.0001,511,493,2,100,0.0001,1004,9
0.396,0.0001,555,549,2,100,0.0001,1104,9
0.4,0.0001,601,603,2,100,0.0001,1204,9
0.404,0.0001,647,657,2,100,0.0001,1304,9
0.406,0.0001,703,701,2,100,0.0001,1404,9
0.396,0.0001,742,762,2,100,0.0001,1504,9
0.388,0.0001,797,807,2,100,0.0001,1604,9
0.416,0.0001,844,860,2,100,0.0001,1704,9
0.42,0.0001,890,914,2,100,0.0001,1804,9
0.432,0.0001,937,967,2,100,0.0001,1904,9
0.442,0.0001,981,1023,2,100,0.0001,2004,9
0.512,0.0001,50,54,2,100,0.0001,104,10
0.512,0.0001,98,106,2,100,0.0001,204,10
0.514,0.0001,142,162,2,100,0.0001,304,10
0.514,0.0001,193,211,2,100,0.0001,404,10
0.516,0.0001,246,258,2,100,0.0001,504,10
0.52,0.0001,292,312,2,100,0.0001,604,10
0.52,0.0001,337,367,2,100,0.0001,704,10
0.522,0.0001,387,417,2,100,0.0001,804,10
0.522,0.0001,437,467,2,100,0.0001,904,10
0.524,0.0001,480,524,2,100,0.0001,1004,10
0.522,0.0001,536,568,2,100,0.0001,1104,10
0.526,0.0001,590,614,2,100,0.0001,1204,10
0.524,0.0001,642,662,2,100,0.0001,1304,10
0.53,0.0001,690,714,2,100,0.0001,1404,10
0.538,0.0001,746,758,2,100,0.0001,1504,10
0.534,0.0001,794,810,2,100,0.0001,1604,10
0.534,0.0001,841,863,2,100,0.0001,1704,10
0.532,0.0001,896,908,2,100,0.0001,1804,10
0.536,0.0001,947,957,2,100,0.0001,1904,10
0.538,0.0001,1001,1003,2,100,0.0001,2004,10
0.498,0.0001,54,50,2,100,0.0001,104,11
0.498,0.0001,104,100,2,100,0.0001,204,11
0.498,0.0001,155,149,2,100,0.0001,304,11
0.498,0.0001,200,204,2,100,0.0001,404,11
0.498,0.0001,249,255,2,100,0.0001,504,11
0.498,0.0001,305,299,2,100,0.0001,604,11
0.498,0.0001,360,344,2,100,0.0001,704,11
0.498,0.0001,412,392,2,100,0.0001,804,11
0.498,0.0001,461,443,2,100,0.0001,904,11
0.498,0.0001,507,497,2,100,0.0001,1004,11
0.498,0.0001,554,550,2,100,0.0001,1104,11
0.498,0.0001,599,605,2,100,0.0001,1204,11
0.498,0.0001,637,667,2,100,0.0001,1304,11
0.502,0.0001,691,713,2,100,0.0001,1404,11
0.506,0.0001,743,761,2,100,0.0001,1504,11
0.512,0.0001,792,812,2,100,0.0001,1604,11
0.516,0.0001,846,858,2,100,0.0001,1704,11
0.518,0.0001,894,910,2,100,0.0001,1804,11
0.52,0.0001,948,956,2,100,0.0001,1904,11
0.522,0.0001,1003,1001,2,100,0.0001,2004,11
0.542,0.0001,57,47,2,100,0.0001,104,12
0.542,0.0001,108,96,2,100,0.0001,204,12
0.542,0.0001,153,151,2,100,0.0001,304,12
0.54,0.0001,208,196,2,100,0.0001,404,12
0.542,0.0001,256,248,2,100,0.0001,504,12
0.546,0.0001,303,301,2,100,0.0001,604,12
0.552,0.0001,355,349,2,100,0.0001,704,12
0.556,0.0001,401,403,2,100,0.0001,804,12
0.56,0.0001,451,453,2,100,0.0001,904,12
0.572,0.0001,500,504,2,100,0.0001,1004,12
0.58,0.0001,550,554,2,100,0.0001,1104,12
0.59,0.0001,597,607,2,100,0.0001,1204,12
0.598,0.0001,642,662,2,100,0.0001,1304,12
0.604,0.0001,691,713,2,100,0.0001,1404,12
0.598,0.0001,735,769,2,100,0.0001,1504,12
0.596,0.0001,793,811,2,100,0.0001,1604,12
0.59,0.0001,846,858,2,100,0.0001,1704,12
0.594,0.0001,903,901,2,100,0.0001,1804,12
0.594,0.0001,941,963,2,100,0.0001,1904,12
0.596,0.0001,984,1020,2,100,0.0001,2004,12
0.504,0.0001,52,52,2,100,0.0001,104,13
0.504,0.0001,106,98,2,100,0.0001,204,13
0.504,0.0001,157,147,2,100,0.0001,304,13
0.504,0.0001,214,190,2,100,0.0001,404,13
0.504,0.0001,266,238,2,100,0.0001,504,13
0.504,0.0001,308,296,2,100,0.0001,604,13
0.504,0.0001,359,345,2,100,0.0001,704,13
0.504,0.0001,411,393,2,100,0.0001,804,13
0.504,0.0001,458,446,2,100,0.0001,904,13
0.504,0.0001,512,492,2,100,0.0001,1004,13
0.504,0.0001,562,542,2,100,0.0001,1104,13
0.504,0.0001,606,598,2,100,0.0001,1204,13
0.504,0.0001,657,647,2,100,0.0001,1304,13
0.504,0.0001,705,699,2,100,0.0001,1404,13
0.504,0.0001,754,750,2,100,0.0001,1504,13
0.504,0.0001,806,798,2,100,0.0001,1604,13
0.504,0.0001,855,849,2,100,0.0001,1704,13
0.504,0.0001,903,901,2,100,0.0001,1804,13
0.504,0.0001,949,955,2,100,0.0001,1904,13
0.502,0.0001,1000,1004,2,100,0.0001,2004,13
0.55,0.0001,50,54,2,100,0.0001,104,14
0.55,0.0001,104,100,2,100,0.0001,204,14
0.552,0.0001,154,150,2,100,0.0001,304,14
0.552,0.0001,211,193,2,100,0.0001,404,14
0.554,0.0001,265,239,2,100,0.0001,504,14
0.554,0.0001,311,293,2,100,0.0001,604,14
0.552,0.0001,363,341,2,100,0.0001,704,14
0.552,0.0001,417,387,2,100,0.0001,804,14
0.552,0.0001,456,448,2,100,0.0001,904,14
0.554,0.0001,512,492,2,100,0.0001,1004,14
0.556,0.0001,562,542,2,100,0.0001,1104,14
0.558,0.0001,608,596,2,100,0.0001,1204,14
0.552,0.0001,660,644,2,100,0.0001,1304,14
0.552,0.0001,709,695,2,100,0.0001,1404,14
0.548,0.0001,755,749,2,100,0.0001,1504,14
0.554,0.0001,806,798,2,100,0.0001,1604,14
0.554,0.0001,851,853,2,100,0.0001,1704,14
0.556,0.0001,907,897,2,100,0.0001,1804,14
0.55,0.0001,964,940,2,100,0.0001,1904,14
0.558,0.0001,1008,996,2,100,0.0001,2004,14
0.508,0.0001,42,62,2,100,0.0001,104,15
0.508,0.0001,82,122,2,100,0.0001,204,15
0.508,0.0001,131,173,2,100,0.0001,304,15
0.508,0.0001,178,226,2,100,0.0001,404,15
0.508,0.0001,236,268,2,100,0.0001,504,15
0.508,0.0001,290,314,2,100,0.0001,604,15
0.508,0.0001,336,368,2,100,0.0001,704,15
0.508,0.0001,382,422,2,100,0.0001,804,15
0.508,0.0001,434,470,2,100,0.0001,904,15
0.508,0.0001,486,518,2,100,0.0001,1004,15
0.508,0.0001,538,566,2,100,0.0001,1104,15
0.508,0.0001,589,615,2,100,0.0001,1204,15
0.506,0.0001,645,659,2,100,0.0001,1304,15
0.504,0.0001,699,705,2,100,0.0001,1404,15
0.502,0.0001,756,748,2,100,0.0001,1504,15
0.502,0.0001,801,803,2,100,0.0001,1604,15
0.538,0.0001,845,859,2,100,0.0001,1704,15
0.55,0.0001,900,904,2,100,0.0001,1804,15
0.566,0.0001,946,958,2,100,0.0001,1904,15
0.572,0.0001,996,1008,2,100,0.0001,2004,15
0.516,0.0001,47,57,2,100,0.0001,104,16
0.516,0.0001,95,109,2,100,0.0001,204,16
0.516,0.0001,156,148,2,100,0.0001,304,16
0.516,0.0001,209,195,2,100,0.0001,404,16
0.516,0.0001,260,244,2,100,0.0001,504,16
0.516,0.0001,309,295,2,100,0.0001,604,16
0.516,0.0001,359,345,2,100,0.0001,704,16
0.516,0.0001,408,396,2,100,0.0001,804,16
0.516,0.0001,448,456,2,100,0.0001,904,16
0.516,0.0001,493,511,2,100,0.0001,1004,16
0.516,0.0001,543,561,2,100,0.0001,1104,16
0.516,0.0001,597,607,2,100,0.0001,1204,16
0.516,0.0001,651,653,2,100,0.0001,1304,16
0.516,0.0001,705,699,2,100,0.0001,1404,16
0.516,0.0001,756,748,2,100,0.0001,1504,16
0.516,0.0001,815,789,2,100,0.0001,1604,16
0.516,0.0001,861,843,2,100,0.0001,1704,16
0.516,0.0001,908,896,2,100,0.0001,1804,16
0.516,0.0001,955,949,2,100,0.0001,1904,16
0.516,0.0001,1010,994,2,100,0.0001,2004,16
0.434,0.0001,58,46,2,100,0.0001,104,17
0.434,0.0001,101,103,2,100,0.0001,204,17
0.434,0.0001,146,158,2,100,0.0001,304,17
0.434,0.0001,199,205,2,100,0.0001,404,17
0.436,0.0001,251,253,2,100,0.0001,504,17
0.436,0.0001,303,301,2,100,0.0001,604,17
0.436,0.0001,353,351,2,100,0.0001,704,17
0.436,0.0001,402,402,2,100,0.0001,804,17
0.434,0.0001,457,447,2,100,0.0001,904,17
0.434,0.0001,508,496,2,100,0.0001,1004,17
0.434,0.0001,552,552,2,100,0.0001,1104,17
0.438,0.0001,600,604,2,100,0.0001,1204,17
0.442,0.0001,656,648,2,100,0.0001,1304,17
0.446,0.0001,706,698,2,100,0.0001,1404,17
0.448,0.0001,754,750,2,100,0.0001,1504,17
0.46,0.0001,798,806,2,100,0.0001,1604,17
0.474,0.0001,849,855,2,100,0.0001,1704,17
0.476,0.0001,889,915,2,100,0.0001,1804,17
0.48,0.0001,941,963,2,100,0.0001,1904,17
0.476,0.0001,993,1011,2,100,0.0001,2004,17
0.564,0.0001,40,64,2,100,0.0001,104,18
0.562,0.0001,92,112,2,100,0.0001,204,18
0.562,0.0001,140,164,2,100,0.0001,304,18
0.582,0.0001,188,216,2,100,0.0001,404,18
0.582,0.0001,246,258,2,100,0.0001,504,18
0.584,0.0001,302,302,2,100,0.0001,604,18
0.582,0.0001,350,354,2,100,0.0001,704,18
0.586,0.0001,388,416,2,100,0.0001,804,18
0.592,0.0001,437,467,2,100,0.0001,904,18
0.586,0.0001,495,509,2,100,0.0001,1004,18
0.588,0.0001,545,559,2,100,0.0001,1104,18
0.58,0.0001,587,617,2,100,0.0001,1204,18
0.588,0.0001,630,674,2,100,0.0001,1304,18
0.602,0.0001,682,722,2,100,0.0001,1404,18
0.604,0.0001,737,767,2,100,0.0001,1504,18
0.61,0.0001,789,815,2,100,0.0001,1604,18
0.622,0.0001,846,858,2,100,0.0001,1704,18
0.634,0.0001,888,916,2,100,0.0001,1804,18
0.658,0.0001,944,960,2,100,0.0001,1904,18
0.664,0.0001,998,1006,2,100,0.0001,2004,18
0.526,0.0001,48,56,2,100,0.0001,104,19
0.53,0.0001,105,99,2,100,0.0001,204,19
0.538,0.0001,157,147,2,100,0.0001,304,19
0.54,0.0001,208,196,2,100,0.0001,404,19
0.544,0.0001,251,253,2,100,0.0001,504,19
0.54,0.0001,302,302,2,100,0.0001,604,19
0.544,0.0001,353,351,2,100,0.0001,704,19
0.54,0.0001,403,401,2,100,0.0001,804,19
0.544,0.0001,452,452,2,100,0.0001,904,19
0.546,0.0001,500,504,2,100,0.0001,1004,19
0.54,0.0001,555,549,2,100,0.0001,1104,19
0.54,0.0001,599,605,2,100,0.0001,1204,19
0.544,0.0001,655,649,2,100,0.0001,1304,19
0.542,0.0001,704,700,2,100,0.0001,1404,19
0.542,0.0001,753,751,2,100,0.0001,1504,19
0.544,0.0001,806,798,2,100,0.0001,1604,19
0.55,0.0001,849,855,2,100,0.0001,1704,19
0.55,0.0001,896,908,2,100,0.0001,1804,19
0.552,0.0001,946,958,2,100,0.0001,1904,19
0.56,0.0001,998,1006,2,100,0.0001,2004,19
0.422,0.0001,56,48,2,100,0.0001,104,20
0.422,0.0001,108,96,2,100,0.0001,204,20
0.422,0.0001,159,145,2,100,0.0001,304,20
0.422,0.0001,209,195,2,100,0.0001,404,20
0.424,0.0001,269,235,2,100,0.0001,504,20
0.43,0.0001,306,298,2,100,0.0001,604,20
0.436,0.0001,355,349,2,100,0.0001,704,20
0.438,0.0001,400,404,2,100,0.0001,804,20
0.438,0.0001,448,456,2,100,0.0001,904,20
0.434,0.0001,496,508,2,100,0.0001,1004,20
0.43,0.0001,549,555,2,100,0.0001,1104,20
0.42,0.0001,600,604,2,100,0.0001,1204,20
0.418,0.0001,647,657,2,100,0.0001,1304,20
0.412,0.0001,693,711,2,100,0.0001,1404,20
0.408,0.0001,749,755,2,100,0.0001,1504,20
0.404,0.0001,807,797,2,100,0.0001,1604,20
0.404,0.0001,857,847,2,100,0.0001,1704,20
0.398,0.0001,909,895,2,100,0.0001,1804,20
0.402,0.0001,963,941,2,100,0.0001,1904,20
0.398,0.0001,1016,988,2,100,0.0001,2004,20
0.516,0.0001,50,54,2,100,0.001,104,1
0.52,0.0001,96,108,2,100,0.001,204,1
0.524,0.0001,142,162,2,100,0.001,304,1
0.526,0.0001,201,203,2,100,0.001,404,1
0.54,0.0001,258,246,2,100,0.001,504,1
0.554,0.0001,307,297,2,100,0.001,604,1
0.552,0.0001,363,341,2,100,0.001,704,1
0.558,0.0001,410,394,2,100,0.001,804,1
0.578,0.0001,464,440,2,100,0.001,904,1
0.614,0.0001,504,500,2,100,0.001,1004,1
0.626,0.0001,556,548,2,100,0.001,1104,1
0.658,0.0001,603,601,2,100,0.001,1204,1
0.688,0.0001,651,653,2,100,0.001,1304,1
0.714,0.0001,703,701,2,100,0.001,1404,1
0.728,0.0001,751,753,2,100,0.001,1504,1
0.74,0.0001,809,795,2,100,0.001,1604,1
0.756,0.0001,862,842,2,100,0.001,1704,1
0.776,0.0001,910,894,2,100,0.001,1804,1
0.81,0.0001,959,945,2,100,0.001,1904,1
0.85,0.0001,1003,1001,2,100,0.001,2004,1
0.584,0.0001,60,44,2,100,0.001,104,2
0.59,0.0001,117,87,2,100,0.001,204,2
0.584,0.0001,164,140,2,100,0.001,304,2
0.572,0.0001,222,182,2,100,0.001,404,2
0.576,0.0001,268,236,2,100,0.001,504,2
0.58,0.0001,307,297,2,100,0.001,604,2
0.574,0.0001,362,342,2,100,0.001,704,2
0.58,0.0001,420,384,2,100,0.001,804,2
0.592,0.0001,467,437,2,100,0.001,904,2
0.596,0.0001,522,482,2,100,0.001,1004,2
0.61,0.0001,566,538,2,100,0.001,1104,2
0.618,0.0001,605,599,2,100,0.001,1204,2
0.628,0.0001,649,655,2,100,0.001,1304,2
0.626,0.0001,704,700,2,100,0.001,1404,2
0.632,0.0001,749,755,2,100,0.001,1504,2
0.71,0.0001,794,810,2,100,0.001,1604,2
0.762,0.0001,848,856,2,100,0.001,1704,2
0.794,0.0001,898,906,2,100,0.001,1804,2
0.808,0.0001,950,954,2,100,0.001,1904,2
0.806,0.0001,996,1008,2,100,0.001,2004,2
0.538,0.0001,59,45,2,100,0.001,104,3
0.564,0.0001,108,96,2,100,0.001,204,3
0.586,0.0001,156,148,2,100,0.001,304,3
0.7,0.0001,213,191,2,100,0.001,404,3
0.7,0.0001,259,245,2,100,0.001,504,3
0.702,0.0001,308,296,2,100,0.001,604,3
0.702,0.0001,362,342,2,100,0.001,704,3
0.706,0.0001,414,390,2,100,0.001,804,3
0.72,0.0001,462,442,2,100,0.001,904,3
0.728,0.0001,507,497,2,100,0.001,1004,3
0.726,0.0001,554,550,2,100,0.001,1104,3
0.742,0.0001,608,596,2,100,0.001,1204,3
0.758,0.0001,660,644,2,100,0.001,1304,3
0.754,0.0001,707,697,2,100,0.001,1404,3
0.75,0.0001,760,744,2,100,0.001,1504,3
0.752,0.0001,804,800,2,100,0.001,1604,3
0.766,0.0001,852,852,2,100,0.001,1704,3
0.77,0.0001,902,902,2,100,0.001,1804,3
0.762,0.0001,954,950,2,100,0.001,1904,3
0.776,0.0001,1008,996,2,100,0.001,2004,3
0.504,0.0001,35,69,2,100,0.001,104,4
0.504,0.0001,89,115,2,100,0.001,204,4
0.5,0.0001,147,157,2,100,0.001,304,4
0.506,0.0001,193,211,2,100,0.001,404,4
0.542,0.0001,240,264,2,100,0.001,504,4
0.578,0.0001,293,311,2,100,0.001,604,4
0.628,0.0001,344,360,2,100,0.001,704,4
0.666,0.0001,394,410,2,100,0.001,804,4
0.7,0.0001,444,460,2,100,0.001,904,4
0.712,0.0001,493,511,2,100,0.001,1004,4
0.72,0.0001,533,571,2,100,0.001,1104,4
0.736,0.0001,585,619,2,100,0.001,1204,4
0.748,0.0001,641,663,2,100,0.001,1304,4
0.75,0.0001,691,713,2,100,0.001,1404,4
0.746,0.0001,737,767,2,100,0.001,1504,4
0.756,0.0001,788,816,2,100,0.001,1604,4
0.772,0.0001,846,858,2,100,0.001,1704,4
0.784,0.0001,888,916,2,100,0.001,1804,4
0.782,0.0001,946,958,2,100,0.001,1904,4
0.794,0.0001,1000,1004,2,100,0.001,2004,4
0.504,0.0001,50,54,2,100,0.001,104,5
0.504,0.0001,97,107,2,100,0.001,204,5
0.504,0.0001,143,161,2,100,0.001,304,5
0.504,0.0001,188,216,2,100,0.001,404,5
0.504,0.0001,246,258,2,100,0.001,504,5
0.504,0.0001,292,312,2,100,0.001,604,5
0.504,0.0001,349,355,2,100,0.001,704,5
0.518,0.0001,395,409,2,100,0.001,804,5
0.538,0.0001,454,450,2,100,0.001,904,5
0.572,0.0001,503,501,2,100,0.001,1004,5
0.608,0.0001,556,548,2,100,0.001,1104,5
0.654,0.0001,615,589,2,100,0.001,1204,5
0.678,0.0001,662,642,2,100,0.001,1304,5
0.724,0.0001,710,694,2,100,0.001,1404,5
0.74,0.0001,758,746,2,100,0.001,1504,5
0.758,0.0001,802,802,2,100,0.001,1604,5
0.782,0.0001,854,850,2,100,0.001,1704,5
0.802,0.0001,902,902,2,100,0.001,1804,5
0.81,0.0001,959,945,2,100,0.001,1904,5
0.818,0.0001,1004,1000,2,100,0.001,2004,5
0.436,0.0001,54,50,2,100,0.001,104,6
0.436,0.0001,99,105,2,100,0.001,204,6
0.438,0.0001,141,163,2,100,0.001,304,6
0.466,0.0001,195,209,2,100,0.001,404,6
0.488,0.0001,233,271,2,100,0.001,504,6
0.508,0.0001,284,320,2,100,0.001,604,6
0.526,0.0001,339,365,2,100,0.001,704,6
0.536,0.0001,391,413,2,100,0.001,804,6
0.548,0.0001,440,464,2,100,0.001,904,6
0.568,0.0001,486,518,2,100,0.001,1004,6
0.586,0.0001,537,567,2,100,0.001,1104,6
0.598,0.0001,576,628,2,100,0.001,1204,6
0.616,0.0001,631,673,2,100,0.001,1304,6
0.676,0.0001,689,715,2,100,0.001,1404,6
0.718,0.0001,735,769,2,100,0.001,1504,6
0.784,0.0001,789,815,2,100,0.001,1604,6
0.802,0.0001,841,863,2,100,0.001,1704,6
0.834,0.0001,893,911,2,100,0.001,1804,6
0.846,0.0001,950,954,2,100,0.001,1904,6
0.86,0.0001,1002,1002,2,100,0.001,2004,6
0.552,0.0001,59,45,2,100,0.001,104,7
0.562,0.0001,108,96,2,100,0.001,204,7
0.586,0.0001,152,152,2,100,0.001,304,7
0.618,0.0001,202,202,2,100,0.001,404,7
0.654,0.0001,262,242,2,100,0.001,504,7
0.684,0.0001,319,285,2,100,0.001,604,7
0.702,0.0001,373,331,2,100,0.001,704,7
0.732,0.0001,420,384,2,100,0.001,804,7
0.744,0.0001,468,436,2,100,0.001,904,7
0.75,0.0001,516,488,2,100,0.001,1004,7
0.748,0.0001,568,536,2,100,0.001,1104,7
0.746,0.0001,627,577,2,100,0.001,1204,7
0.742,0.0001,681,623,2,100,0.001,1304,7
0.736,0.0001,737,667,2,100,0.001,1404,7
0.744,0.0001,777,727,2,100,0.001,1504,7
0.75,0.0001,821,783,2,100,0.001,1604,7
0.756,0.0001,871,833,2,100,0.001,1704,7
0.768,0.0001,920,884,2,100,0.001,1804,7
0.772,0.0001,974,930,2,100,0.001,1904,7
0.79,0.0001,1025,979,2,100,0.001,2004,7
0.5,0.0001,51,53,2,100,0.001,104,8
0.5,0.0001,105,99,2,100,0.001,204,8
0.5,0.0001,155,149,2,100,0.001,304,8
0.504,0.0001,202,202,2,100,0.001,404,8
0.51,0.0001,244,260,2,100,0.001,504,8
0.522,0.0001,292,312,2,100,0.001,604,8
0.54,0.0001,336,368,2,100,0.001,704,8
0.598,0.0001,391,413,2,100,0.001,804,8
0.648,0.0001,435,469,2,100,0.001,904,8
0.7,0.0001,492,512,2,100,0.001,1004,8
0.742,0.0001,540,564,2,100,0.001,1104,8
0.748,0.0001,586,618,2,100,0.001,1204,8
0.758,0.0001,629,675,2,100,0.001,1304,8
0.758,0.0001,678,726,2,100,0.001,1404,8
0.76,0.0001,733,771,2,100,0.001,1504,8
0.762,0.0001,792,812,2,100,0.001,1604,8
0.774,0.0001,852,852,2,100,0.001,1704,8
0.78,0.0001,902,902,2,100,0.001,1804,8
0.79,0.0001,954,950,2,100,0.001,1904,8
0.798,0.0001,1002,1002,2,100,0.001,2004,8
0.466,0.0001,62,42,2,100,0.001,104,9
0.464,0.0001,97,107,2,100,0.001,204,9
0.462,0.0001,155,149,2,100,0.001,304,9
0.458,0.0001,211,193,2,100,0.001,404,9
0.478,0.0001,261,243,2,100,0.001,504,9
0.524,0.0001,307,297,2,100,0.001,604,9
0.536,0.0001,369,335,2,100,0.001,704,9
0.548,0.0001,415,389,2,100,0.001,804,9
0.564,0.0001,464,440,2,100,0.001,904,9
0.57,0.0001,516,488,2,100,0.001,1004,9
0.578,0.0001,565,539,2,100,0.001,1104,9
0.592,0.0001,615,589,2,100,0.001,1204,9
0.588,0.0001,653,651,2,100,0.001,1304,9
0.61,0.0001,707,697,2,100,0.001,1404,9
0.618,0.0001,760,744,2,100,0.001,1504,9
0.616,0.0001,803,801,2,100,0.001,1604,9
0.754,0.0001,857,847,2,100,0.001,1704,9
0.768,0.0001,905,899,2,100,0.001,1804,9
0.774,0.0001,946,958,2,100,0.001,1904,9
0.778,0.0001,1003,1001,2,100,0.001,2004,9
0.486,0.0001,58,46,2,100,0.001,104,10
0.518,0.0001,113,91,2,100,0.001,204,10
0.566,0.0001,157,147,2,100,0.001,304,10
0.57,0.0001,205,199,2,100,0.001,404,10
0.568,0.0001,258,246,2,100,0.001,504,10
0.574,0.0001,314,290,2,100,0.001,604,10
0.584,0.0001,366,338,2,100,0.001,704,10
0.614,0.0001,422,382,2,100,0.001,804,10
0.642,0.0001,474,430,2,100,0.001,904,10
0.672,0.0001,523,481,2,100,0.001,1004,10
0.66,0.0001,574,530,2,100,0.001,1104,10
0.664,0.0001,629,575,2,100,0.001,1204,10
0.736,0.0001,679,625,2,100,0.001,1304,10
0.782,0.0001,725,679,2,100,0.001,1404,10
0.78,0.0001,773,731,2,100,0.001,1504,10
0.832,0.0001,826,778,2,100,0.001,1604,10
0.858,0.0001,868,836,2,100,0.001,1704,10
0.864,0.0001,917,887,2,100,0.001,1804,10
0.862,0.0001,963,941,2,100,0.001,1904,10
0.84,0.0001,1010,994,2,100,0.001,2004,10
0.526,0.0001,55,49,2,100,0.001,104,11
0.544,0.0001,101,103,2,100,0.001,204,11
0.54,0.0001,150,154,2,100,0.001,304,11
0.526,0.0001,192,212,2,100,0.001,404,11
0.518,0.0001,245,259,2,100,0.001,504,11
0.546,0.0001,295,309,2,100,0.001,604,11
0.562,0.0001,344,360,2,100,0.001,704,11
0.6,0.0001,399,405,2,100,0.001,804,11
0.63,0.0001,449,455,2,100,0.001,904,11
0.668,0.0001,496,508,2,100,0.001,1004,11
0.678,0.0001,545,559,2,100,0.001,1104,11
0.69,0.0001,589,615,2,100,0.001,1204,11
0.686,0.0001,630,674,2,100,0.001,1304,11
0.684,0.0001,679,725,2,100,0.001,1404,11
0.684,0.0001,739,765,2,100,0.001,1504,11
0.694,0.0001,791,813,2,100,0.001,1604,11
0.706,0.0001,841,863,2,100,0.001,1704,11
0.712,0.0001,891,913,2,100,0.001,1804,11
0.726,0.0001,938,966,2,100,0.001,1904,11
0.726,0.0001,994,1010,2,100,0.001,2004,11
0.448,0.0001,52,52,2,100,0.001,104,12
0.442,0.0001,106,98,2,100,0.001,204,12
0.464,0.0001,153,151,2,100,0.001,304,12
0.532,0.0001,198,206,2,100,0.001,404,12
0.578,0.0001,242,262,2,100,0.001,504,12
0.616,0.0001,291,313,2,100,0.001,604,12
0.64,0.0001,344,360,2,100,0.001,704,12
0.652,0.0001,396,408,2,100,0.001,804,12
0.664,0.0001,451,453,2,100,0.001,904,12
0.666,0.0001,496,508,2,100,0.001,1004,12
0.664,0.0001,548,556,2,100,0.001,1104,12
0.666,0.0001,606,598,2,100,0.001,1204,12
0.67,0.0001,664,640,2,100,0.001,1304,12
0.682,0.0001,720,684,2,100,0.001,1404,12
0.694,0.0001,764,740,2,100,0.001,1504,12
0.714,0.0001,812,792,2,100,0.001,1604,12
0.71,0.0001,860,844,2,100,0.001,1704,12
0.726,0.0001,905,899,2,100,0.001,1804,12
0.748,0.0001,945,959,2,100,0.001,1904,12
0.774,0.0001,996,1008,2,100,0.001,2004,12
0.688,0.0001,57,47,2,100,0.001,104,13
0.702,0.0001,112,92,2,100,0.001,204,13
0.744,0.0001,152,152,2,100,0.001,304,13
0.778,0.0001,200,204,2,100,0.001,404,13
0.778,0.0001,250,254,2,100,0.001,504,13
0.766,0.0001,296,308,2,100,0.001,604,13
0.748,0.0001,346,358,2,100,0.001,704,13
0.772,0.0001,394,410,2,100,0.001,804,13
0.788,0.0001,443,461,2,100,0.001,904,13
0.784,0.0001,492,512,2,100,0.001,1004,13
0.77,0.0001,543,561,2,100,0.001,1104,13
0.77,0.0001,591,613,2,100,0.001,1204,13
0.77,0.0001,645,659,2,100,0.001,1304,13
0.778,0.0001,704,700,2,100,0.001,1404,13
0.796,0.0001,753,751,2,100,0.001,1504,13
0.808,0.0001,797,807,2,100,0.001,1604,13
0.814,0.0001,851,853,2,100,0.001,1704,13
0.826,0.0001,908,896,2,100,0.001,1804,13
0.848,0.0001,956,948,2,100,0.001,1904,13
0.854,0.0001,1001,1003,2,100,0.001,2004,13
0.492,0.0001,50,54,2,100,0.001,104,14
0.5,0.0001,109,95,2,100,0.001,204,14
0.51,0.0001,157,147,2,100,0.001,304,14
0.528,0.0001,206,198,2,100,0.001,404,14
0.564,0.0001,252,252,2,100,0.001,504,14
0.59,0.0001,303,301,2,100,0.001,604,14
0.592,0.0001,363,341,2,100,0.001,704,14
0.622,0.0001,416,388,2,100,0.001,804,14
0.634,0.0001,467,437,2,100,0.001,904,14
0.65,0.0001,524,480,2,100,0.001,1004,14
0.62,0.0001,568,536,2,100,0.001,1104,14
0.622,0.0001,615,589,2,100,0.001,1204,14
0.628,0.0001,674,630,2,100,0.001,1304,14
0.744,0.0001,718,686,2,100,0.001,1404,14
0.754,0.0001,768,736,2,100,0.001,1504,14
0.798,0.0001,808,796,2,100,0.001,1604,14
0.822,0.0001,854,850,2,100,0.001,1704,14
0.826,0.0001,904,900,2,100,0.001,1804,14
0.826,0.0001,952,952,2,100,0.001,1904,14
0.824,0.0001,998,1006,2,100,0.001,2004,14
0.49,0.0001,56,48,2,100,0.001,104,15
0.494,0.0001,105,99,2,100,0.001,204,15
0.508,0.0001,150,154,2,100,0.001,304,15
0.522,0.0001,204,200,2,100,0.001,404,15
0.542,0.0001,257,247,2,100,0.001,504,15
0.554,0.0001,301,303,2,100,0.001,604,15
0.55,0.0001,356,348,2,100,0.001,704,15
0.56,0.0001,408,396,2,100,0.001,804,15
0.58,0.0001,464,440,2,100,0.001,904,15
0.59,0.0001,506,498,2,100,0.001,1004,15
0.614,0.0001,554,550,2,100,0.001,1104,15
0.622,0.0001,596,608,2,100,0.001,1204,15
0.676,0.0001,636,668,2,100,0.001,1304,15
0.772,0.0001,684,720,2,100,0.001,1404,15
0.848,0.0001,731,773,2,100,0.001,1504,15
0.85,0.0001,783,821,2,100,0.001,1604,15
0.842,0.0001,831,873,2,100,0.001,1704,15
0.842,0.0001,890,914,2,100,0.001,1804,15
0.838,0.0001,947,957,2,100,0.001,1904,15
0.86,0.0001,1002,1002,2,100,0.001,2004,15
0.46,0.0001,49,55,2,100,0.001,104,16
0.458,0.0001,103,101,2,100,0.001,204,16
0.456,0.0001,139,165,2,100,0.001,304,16
0.454,0.0001,196,208,2,100,0.001,404,16
0.48,0.0001,238,266,2,100,0.001,504,16
0.484,0.0001,284,320,2,100,0.001,604,16
0.534,0.0001,343,361,2,100,0.001,704,16
0.532,0.0001,391,413,2,100,0.001,804,16
0.544,0.0001,442,462,2,100,0.001,904,16
0.544,0.0001,490,514,2,100,0.001,1004,16
0.56,0.0001,550,554,2,100,0.001,1104,16
0.58,0.0001,597,607,2,100,0.001,1204,16
0.582,0.0001,654,650,2,100,0.001,1304,16
0.584,0.0001,706,698,2,100,0.001,1404,16
0.59,0.0001,753,751,2,100,0.001,1504,16
0.64,0.0001,814,790,2,100,0.001,1604,16
0.696,0.0001,854,850,2,100,0.001,1704,16
0.756,0.0001,911,893,2,100,0.001,1804,16
0.798,0.0001,965,939,2,100,0.001,1904,16
0.802,0.0001,1021,983,2,100,0.001,2004,16
0.514,0.0001,56,48,2,100,0.001,104,17
0.516,0.0001,100,104,2,100,0.001,204,17
0.526,0.0001,149,155,2,100,0.001,304,17
0.522,0.0001,196,208,2,100,0.001,404,17
0.542,0.0001,242,262,2,100,0.001,504,17
0.542,0.0001,299,305,2,100,0.001,604,17
0.56,0.0001,347,357,2,100,0.001,704,17
0.584,0.0001,402,402,2,100,0.001,804,17
0.61,0.0001,451,453,2,100,0.001,904,17
0.662,0.0001,495,509,2,100,0.001,1004,17
0.668,0.0001,546,558,2,100,0.001,1104,17
0.666,0.0001,593,611,2,100,0.001,1204,17
0.672,0.0001,648,656,2,100,0.001,1304,17
0.68,0.0001,694,710,2,100,0.001,1404,17
0.688,0.0001,744,760,2,100,0.001,1504,17
0.698,0.0001,786,818,2,100,0.001,1604,17
0.708,0.0001,835,869,2,100,0.001,1704,17
0.716,0.0001,886,918,2,100,0.001,1804,17
0.73,0.0001,937,967,2,100,0.001,1904,17
0.742,0.0001,995,1009,2,100,0.001,2004,17
0.594,0.0001,49,55,2,100,0.001,104,18
0.652,0.0001,105,99,2,100,0.001,204,18
0.726,0.0001,151,153,2,100,0.001,304,18
0.732,0.0001,198,206,2,100,0.001,404,18
0.758,0.0001,253,251,2,100,0.001,504,18
0.76,0.0001,300,304,2,100,0.001,604,18
0.736,0.0001,356,348,2,100,0.001,704,18
0.746,0.0001,405,399,2,100,0.001,804,18
0.776,0.0001,458,446,2,100,0.001,904,18
0.792,0.0001,510,494,2,100,0.001,1004,18
0.796,0.0001,554,550,2,100,0.001,1104,18
0.796,0.0001,594,610,2,100,0.001,1204,18
0.802,0.0001,643,661,2,100,0.001,1304,18
0.798,0.0001,694,710,2,100,0.001,1404,18
0.804,0.0001,750,754,2,100,0.001,1504,18
0.802,0.0001,801,803,2,100,0.001,1604,18
0.784,0.0001,849,855,2,100,0.001,1704,18
0.782,0.0001,904,900,2,100,0.001,1804,18
0.81,0.0001,958,946,2,100,0.001,1904,18
0.82,0.0001,1005,999,2,100,0.001,2004,18
0.52,0.0001,57,47,2,100,0.001,104,19
0.52,0.0001,103,101,2,100,0.001,204,19
0.52,0.0001,156,148,2,100,0.001,304,19
0.528,0.0001,209,195,2,100,0.001,404,19
0.532,0.0001,253,251,2,100,0.001,504,19
0.544,0.0001,303,301,2,100,0.001,604,19
0.562,0.0001,357,347,2,100,0.001,704,19
0.65,0.0001,398,406,2,100,0.001,804,19
0.664,0.0001,440,464,2,100,0.001,904,19
0.664,0.0001,487,517,2,100,0.001,1004,19
0.722,0.0001,539,565,2,100,0.001,1104,19
0.742,0.0001,590,614,2,100,0.001,1204,19
0.746,0.0001,638,666,2,100,0.001,1304,19
0.752,0.0001,686,718,2,100,0.001,1404,19
0.758,0.0001,736,768,2,100,0.001,1504,19
0.772,0.0001,790,814,2,100,0.001,1604,19
0.776,0.0001,839,865,2,100,0.001,1704,19
0.792,0.0001,888,916,2,100,0.001,1804,19
0.8,0.0001,937,967,2,100,0.001,1904,19
0.826,0.0001,992,1012,2,100,0.001,2004,19
0.538,0.0001,54,50,2,100,0.001,104,20
0.538,0.0001,105,99,2,100,0.001,204,20
0.506,0.0001,154,150,2,100,0.001,304,20
0.42,0.0001,206,198,2,100,0.001,404,20
0.436,0.0001,260,244,2,100,0.001,504,20
0.528,0.0001,318,286,2,100,0.001,604,20
0.592,0.0001,360,344,2,100,0.001,704,20
0.636,0.0001,417,387,2,100,0.001,804,20
0.644,0.0001,467,437,2,100,0.001,904,20
0.664,0.0001,510,494,2,100,0.001,1004,20
0.686,0.0001,569,535,2,100,0.001,1104,20
0.7,0.0001,623,581,2,100,0.001,1204,20
0.716,0.0001,667,637,2,100,0.001,1304,20
0.71,0.0001,719,685,2,100,0.001,1404,20
0.724,0.0001,771,733,2,100,0.001,1504,20
0.722,0.0001,821,783,2,100,0.001,1604,20
0.724,0.0001,862,842,2,100,0.001,1704,20
0.73,0.0001,921,883,2,100,0.001,1804,20
0.742,0.0001,974,930,2,100,0.001,1904,20
0.746,0.0001,1021,983,2,100,0.001,2004,20
0.522,0.0001,45,59,2,100,0.01,104,1
0.678,0.0001,106,98,2,100,0.01,204,1
0.65,0.0001,162,142,2,100,0.01,304,1
0.544,0.0001,211,193,2,100,0.01,404,1
0.596,0.0001,262,242,2,100,0.01,504,1
0.732,0.0001,317,287,2,100,0.01,604,1
0.776,0.0001,370,334,2,100,0.01,704,1
0.802,0.0001,420,384,2,100,0.01,804,1
0.794,0.0001,469,435,2,100,0.01,904,1
0.83,0.0001,519,485,2,100,0.01,1004,1
0.854,0.0001,574,530,2,100,0.01,1104,1
0.89,0.0001,627,577,2,100,0.01,1204,1
0.904,0.0001,674,630,2,100,0.01,1304,1
0.912,0.0001,724,680,2,100,0.01,1404,1
0.908,0.0001,770,734,2,100,0.01,1504,1
0.908,0.0001,816,788,2,100,0.01,1604,1
0.92,0.0001,869,835,2,100,0.01,1704,1
0.938,0.0001,923,881,2,100,0.01,1804,1
0.938,0.0001,966,938,2,100,0.01,1904,1
0.94,0.0001,1012,992,2,100,0.01,2004,1
0.478,0.0001,55,49,2,100,0.01,104,2
0.53,0.0001,94,110,2,100,0.01,204,2
0.548,0.0001,142,162,2,100,0.01,304,2
0.538,0.0001,195,209,2,100,0.01,404,2
0.582,0.0001,242,262,2,100,0.01,504,2
0.618,0.0001,285,319,2,100,0.01,604,2
0.764,0.0001,338,366,2,100,0.01,704,2
0.788,0.0001,392,412,2,100,0.01,804,2
0.786,0.0001,441,463,2,100,0.01,904,2
0.87,0.0001,493,511,2,100,0.01,1004,2
0.834,0.0001,547,557,2,100,0.01,1104,2
0.9,0.0001,590,614,2,100,0.01,1204,2
0.908,0.0001,628,676,2,100,0.01,1304,2
0.922,0.0001,684,720,2,100,0.01,1404,2
0.92,0.0001,741,763,2,100,0.01,1504,2
0.934,0.0001,794,810,2,100,0.01,1604,2
0.94,0.0001,848,856,2,100,0.01,1704,2
0.95,0.0001,893,911,2,100,0.01,1804,2
0.944,0.0001,945,959,2,100,0.01,1904,2
0.952,0.0001,996,1008,2,100,0.01,2004,2
0.48,0.0001,49,55,2,100,0.01,104,3
0.604,0.0001,92,112,2,100,0.01,204,3
0.646,0.0001,156,148,2,100,0.01,304,3
0.626,0.0001,213,191,2,100,0.01,404,3
0.682,0.0001,262,242,2,100,0.01,504,3
0.664,0.0001,312,292,2,100,0.01,604,3
0.652,0.0001,362,342,2,100,0.01,704,3
0.658,0.0001,418,386,2,100,0.01,804,3
0.682,0.0001,465,439,2,100,0.01,904,3
0.888,0.0001,515,489,2,100,0.01,1004,3
0.922,0.0001,570,534,2,100,0.01,1104,3
0.932,0.0001,618,586,2,100,0.01,1204,3
0.938,0.0001,665,639,2,100,0.01,1304,3
0.942,0.0001,717,687,2,100,0.01,1404,3
0.938,0.0001,769,735,2,100,0.01,1504,3
0.938,0.0001,819,785,2,100,0.01,1604,3
0.946,0.0001,864,840,2,100,0.01,1704,3
0.946,0.0001,913,891,2,100,0.01,1804,3
0.95,0.0001,960,944,2,100,0.01,1904,3
0.954,0.0001,1012,992,2,100,0.01,2004,3
0.482,0.0001,45,59,2,100,0.01,104,4
0.522,0.0001,92,112,2,100,0.01,204,4
0.562,0.0001,145,159,2,100,0.01,304,4
0.588,0.0001,203,201,2,100,0.01,404,4
0.618,0.0001,258,246,2,100,0.01,504,4
0.692,0.0001,310,294,2,100,0.01,604,4
0.626,0.0001,357,347,2,100,0.01,704,4
0.7,0.0001,408,396,2,100,0.01,804,4
0.92,0.0001,454,450,2,100,0.01,904,4
0.878,0.0001,508,496,2,100,0.01,1004,4
0.858,0.0001,556,548,2,100,0.01,1104,4
0.89,0.0001,597,607,2,100,0.01,1204,4
0.912,0.0001,649,655,2,100,0.01,1304,4
0.94,0.0001,699,705,2,100,0.01,1404,4
0.946,0.0001,748,756,2,100,0.01,1504,4
0.94,0.0001,796,808,2,100,0.01,1604,4
0.93,0.0001,837,867,2,100,0.01,1704,4
0.948,0.0001,895,909,2,100,0.01,1804,4
0.95,0.0001,939,965,2,100,0.01,1904,4
0.95,0.0001,1004,1000,2,100,0.01,2004,4
0.598,0.0001,52,52,2,100,0.01,104,5
0.41,0.0001,105,99,2,100,0.01,204,5
0.42,0.0001,153,151,2,100,0.01,304,5
0.524,0.0001,205,199,2,100,0.01,404,5
0.66,0.0001,259,245,2,100,0.01,504,5
0.738,0.0001,310,294,2,100,0.01,604,5
0.758,0.0001,360,344,2,100,0.01,704,5
0.766,0.0001,416,388,2,100,0.01,804,5
0.78,0.0001,462,442,2,100,0.01,904,5
0.788,0.0001,519,485,2,100,0.01,1004,5
0.81,0.0001,574,530,2,100,0.01,1104,5
0.848,0.0001,624,580,2,100,0.01,1204,5
0.854,0.0001,671,633,2,100,0.01,1304,5
0.878,0.0001,726,678,2,100,0.01,1404,5
0.884,0.0001,768,736,2,100,0.01,1504,5
0.908,0.0001,818,786,2,100,0.01,1604,5
0.922,0.0001,860,844,2,100,0.01,1704,5
0.916,0.0001,915,889,2,100,0.01,1804,5
0.922,0.0001,965,939,2,100,0.01,1904,5
0.938,0.0001,1020,984,2,100,0.01,2004,5
0.514,0.0001,54,50,2,100,0.01,104,6
0.658,0.0001,98,106,2,100,0.01,204,6
0.708,0.0001,147,157,2,100,0.01,304,6
0.62,0.0001,196,208,2,100,0.01,404,6
0.668,0.0001,239,265,2,100,0.01,504,6
0.742,0.0001,291,313,2,100,0.01,604,6
0.812,0.0001,349,355,2,100,0.01,704,6
0.822,0.0001,391,413,2,100,0.01,804,6
0.848,0.0001,443,461,2,100,0.01,904,6
0.844,0.0001,497,507,2,100,0.01,1004,6
0.856,0.0001,543,561,2,100,0.01,1104,6
0.874,0.0001,590,614,2,100,0.01,1204,6
0.894,0.0001,640,664,2,100,0.01,1304,6
0.906,0.0001,691,713,2,100,0.01,1404,6
0.916,0.0001,740,764,2,100,0.01,1504,6
0.924,0.0001,787,817,2,100,0.01,1604,6
0.926,0.0001,827,877,2,100,0.01,1704,6
0.94,0.0001,887,917,2,100,0.01,1804,6
0.954,0.0001,940,964,2,100,0.01,1904,6
0.95,0.0001,998,1006,2,100,0.01,2004,6
0.478,0.0001,53,51,2,100,0.01,104,7
0.586,0.0001,98,106,2,100,0.01,204,7
0.6,0.0001,147,157,2,100,0.01,304,7
0.664,0.0001,198,206,2,100,0.01,404,7
0.702,0.0001,251,253,2,100,0.01,504,7
0.756,0.0001,297,307,2,100,0.01,604,7
0.772,0.0001,355,349,2,100,0.01,704,7
0.818,0.0001,400,404,2,100,0.01,804,7
0.864,0.0001,443,461,2,100,0.01,904,7
0.864,0.0001,499,505,2,100,0.01,1004,7
0.852,0.0001,544,560,2,100,0.01,1104,7
0.862,0.0001,598,606,2,100,0.01,1204,7
0.87,0.0001,651,653,2,100,0.01,1304,7
0.914,0.0001,706,698,2,100,0.01,1404,7
0.922,0.0001,753,751,2,100,0.01,1504,7
0.904,0.0001,808,796,2,100,0.01,1604,7
0.924,0.0001,861,843,2,100,0.01,1704,7
0.922,0.0001,914,890,2,100,0.01,1804,7
0.924,0.0001,960,944,2,100,0.01,1904,7
0.928,0.0001,1013,991,2,100,0.01,2004,7
0.592,0.0001,56,48,2,100,0.01,104,8
0.76,0.0001,98,106,2,100,0.01,204,8
0.772,0.0001,147,157,2,100,0.01,304,8
0.792,0.0001,194,210,2,100,0.01,404,8
0.612,0.0001,245,259,2,100,0.01,504,8
0.682,0.0001,300,304,2,100,0.01,604,8
0.744,0.0001,342,362,2,100,0.01,704,8
0.854,0.0001,390,414,2,100,0.01,804,8
0.83,0.0001,439,465,2,100,0.01,904,8
0.836,0.0001,490,514,2,100,0.01,1004,8
0.846,0.0001,535,569,2,100,0.01,1104,8
0.87,0.0001,585,619,2,100,0.01,1204,8
0.87,0.0001,642,662,2,100,0.01,1304,8
0.88,0.0001,689,715,2,100,0.01,1404,8
0.884,0.0001,734,770,2,100,0.01,1504,8
0.894,0.0001,780,824,2,100,0.01,1604,8
0.904,0.0001,843,861,2,100,0.01,1704,8
0.908,0.0001,896,908,2,100,0.01,1804,8
0.91,0.0001,940,964,2,100,0.01,1904,8
0.928,0.0001,992,1012,2,100,0.01,2004,8
0.564,0.0001,58,46,2,100,0.01,104,9
0.578,0.0001,113,91,2,100,0.01,204,9
0.628,0.0001,163,141,2,100,0.01,304,9
0.696,0.0001,211,193,2,100,0.01,404,9
0.708,0.0001,260,244,2,100,0.01,504,9
0.69,0.0001,320,284,2,100,0.01,604,9
0.694,0.0001,367,337,2,100,0.01,704,9
0.722,0.0001,419,385,2,100,0.01,804,9
0.73,0.0001,475,429,2,100,0.01,904,9
0.792,0.0001,518,486,2,100,0.01,1004,9
0.826,0.0001,579,525,2,100,0.01,1104,9
0.856,0.0001,625,579,2,100,0.01,1204,9
0.906,0.0001,681,623,2,100,0.01,1304,9
0.918,0.0001,735,669,2,100,0.01,1404,9
0.914,0.0001,779,725,2,100,0.01,1504,9
0.92,0.0001,823,781,2,100,0.01,1604,9
0.926,0.0001,872,832,2,100,0.01,1704,9
0.938,0.0001,925,879,2,100,0.01,1804,9
0.95,0.0001,975,929,2,100,0.01,1904,9
0.95,0.0001,1017,987,2,100,0.01,2004,9
0.634,0.0001,46,58,2,100,0.01,104,10
0.602,0.0001,95,109,2,100,0.01,204,10
0.64,0.0001,145,159,2,100,0.01,304,10
0.734,0.0001,198,206,2,100,0.01,404,10
0.746,0.0001,252,252,2,100,0.01,504,10
0.758,0.0001,295,309,2,100,0.01,604,10
0.788,0.0001,345,359,2,100,0.01,704,10
0.824,0.0001,401,403,2,100,0.01,804,10
0.844,0.0001,457,447,2,100,0.01,904,10
0.872,0.0001,510,494,2,100,0.01,1004,10
0.876,0.0001,566,538,2,100,0.01,1104,10
0.892,0.0001,619,585,2,100,0.01,1204,10
0.906,0.0001,675,629,2,100,0.01,1304,10
0.918,0.0001,723,681,2,100,0.01,1404,10
0.918,0.0001,763,741,2,100,0.01,1504,10
0.936,0.0001,807,797,2,100,0.01,1604,10
0.944,0.0001,859,845,2,100,0.01,1704,10
0.95,0.0001,911,893,2,100,0.01,1804,10
0.958,0.0001,962,942,2,100,0.01,1904,10
0.964,0.0001,1007,997,2,100,0.01,2004,10
0.512,0.0001,55,49,2,100,0.01,104,11
0.59,0.0001,103,101,2,100,0.01,204,11
0.614,0.0001,153,151,2,100,0.01,304,11
0.618,0.0001,199,205,2,100,0.01,404,11
0.66,0.0001,255,249,2,100,0.01,504,11
0.81,0.0001,307,297,2,100,0.01,604,11
0.856,0.0001,357,347,2,100,0.01,704,11
0.876,0.0001,403,401,2,100,0.01,804,11
0.864,0.0001,455,449,2,100,0.01,904,11
0.886,0.0001,502,502,2,100,0.01,1004,11
0.912,0.0001,555,549,2,100,0.01,1104,11
0.928,0.0001,607,597,2,100,0.01,1204,11
0.928,0.0001,660,644,2,100,0.01,1304,11
0.936,0.0001,712,692,2,100,0.01,1404,11
0.932,0.0001,764,740,2,100,0.01,1504,11
0.944,0.0001,810,794,2,100,0.01,1604,11
0.946,0.0001,859,845,2,100,0.01,1704,11
0.948,0.0001,908,896,2,100,0.01,1804,11
0.952,0.0001,952,952,2,100,0.01,1904,11
0.956,0.0001,1005,999,2,100,0.01,2004,11
0.486,0.0001,55,49,2,100,0.01,104,12
0.538,0.0001,102,102,2,100,0.01,204,12
0.552,0.0001,138,166,2,100,0.01,304,12
0.54,0.0001,186,218,2,100,0.01,404,12
0.53,0.0001,242,262,2,100,0.01,504,12
0.578,0.0001,288,316,2,100,0.01,604,12
0.608,0.0001,337,367,2,100,0.01,704,12
0.656,0.0001,386,418,2,100,0.01,804,12
0.728,0.0001,437,467,2,100,0.01,904,12
0.848,0.0001,483,521,2,100,0.01,1004,12
0.884,0.0001,534,570,2,100,0.01,1104,12
0.912,0.0001,587,617,2,100,0.01,1204,12
0.932,0.0001,643,661,2,100,0.01,1304,12
0.94,0.0001,688,716,2,100,0.01,1404,12
0.952,0.0001,738,766,2,100,0.01,1504,12
0.942,0.0001,792,812,2,100,0.01,1604,12
0.952,0.0001,844,860,2,100,0.01,1704,12
0.962,0.0001,899,905,2,100,0.01,1804,12
0.966,0.0001,955,949,2,100,0.01,1904,12
0.968,0.0001,1010,994,2,100,0.01,2004,12
0.556,0.0001,47,57,2,100,0.01,104,13
0.588,0.0001,96,108,2,100,0.01,204,13
0.578,0.0001,152,152,2,100,0.01,304,13
0.696,0.0001,198,206,2,100,0.01,404,13
0.7,0.0001,249,255,2,100,0.01,504,13
0.706,0.0001,298,306,2,100,0.01,604,13
0.722,0.0001,353,351,2,100,0.01,704,13
0.794,0.0001,405,399,2,100,0.01,804,13
0.828,0.0001,451,453,2,100,0.01,904,13
0.852,0.0001,505,499,2,100,0.01,1004,13
0.888,0.0001,565,539,2,100,0.01,1104,13
0.912,0.0001,609,595,2,100,0.01,1204,13
0.922,0.0001,649,655,2,100,0.01,1304,13
0.926,0.0001,699,705,2,100,0.01,1404,13
0.932,0.0001,749,755,2,100,0.01,1504,13
0.93,0.0001,810,794,2,100,0.01,1604,13
0.934,0.0001,863,841,2,100,0.01,1704,13
0.942,0.0001,909,895,2,100,0.01,1804,13
0.946,0.0001,957,947,2,100,0.01,1904,13
0.952,0.0001,1009,995,2,100,0.01,2004,13
0.502,0.0001,45,59,2,100,0.01,104,14
0.55,0.0001,97,107,2,100,0.01,204,14
0.662,0.0001,143,161,2,100,0.01,304,14
0.722,0.0001,199,205,2,100,0.01,404,14
0.748,0.0001,245,259,2,100,0.01,504,14
0.758,0.0001,304,300,2,100,0.01,604,14
0.77,0.0001,354,350,2,100,0.01,704,14
0.786,0.0001,400,404,2,100,0.01,804,14
0.812,0.0001,452,452,2,100,0.01,904,14
0.836,0.0001,500,504,2,100,0.01,1004,14
0.86,0.0001,543,561,2,100,0.01,1104,14
0.908,0.0001,594,610,2,100,0.01,1204,14
0.922,0.0001,645,659,2,100,0.01,1304,14
0.912,0.0001,696,708,2,100,0.01,1404,14
0.922,0.0001,748,756,2,100,0.01,1504,14
0.94,0.0001,795,809,2,100,0.01,1604,14
0.944,0.0001,836,868,2,100,0.01,1704,14
0.942,0.0001,889,915,2,100,0.01,1804,14
0.938,0.0001,936,968,2,100,0.01,1904,14
0.948,0.0001,996,1008,2,100,0.01,2004,14
0.68,0.0001,45,59,2,100,0.01,104,15
0.614,0.0001,99,105,2,100,0.01,204,15
0.66,0.0001,149,155,2,100,0.01,304,15
0.778,0.0001,200,204,2,100,0.01,404,15
0.784,0.0001,252,252,2,100,0.01,504,15
0.706,0.0001,302,302,2,100,0.01,604,15
0.686,0.0001,358,346,2,100,0.01,704,15
0.792,0.0001,409,395,2,100,0.01,804,15
0.814,0.0001,461,443,2,100,0.01,904,15
0.816,0.0001,508,496,2,100,0.01,1004,15
0.852,0.0001,560,544,2,100,0.01,1104,15
0.878,0.0001,593,611,2,100,0.01,1204,15
0.894,0.0001,647,657,2,100,0.01,1304,15
0.896,0.0001,693,711,2,100,0.01,1404,15
0.904,0.0001,749,755,2,100,0.01,1504,15
0.92,0.0001,801,803,2,100,0.01,1604,15
0.92,0.0001,854,850,2,100,0.01,1704,15
0.922,0.0001,900,904,2,100,0.01,1804,15
0.932,0.0001,945,959,2,100,0.01,1904,15
0.95,0.0001,992,1012,2,100,0.01,2004,15
0.568,0.0001,47,57,2,100,0.01,104,16
0.69,0.0001,93,111,2,100,0.01,204,16
0.702,0.0001,142,162,2,100,0.01,304,16
0.714,0.0001,187,217,2,100,0.01,404,16
0.728,0.0001,238,266,2,100,0.01,504,16
0.714,0.0001,299,305,2,100,0.01,604,16
0.74,0.0001,358,346,2,100,0.01,704,16
0.784,0.0001,402,402,2,100,0.01,804,16
0.794,0.0001,447,457,2,100,0.01,904,16
0.84,0.0001,504,500,2,100,0.01,1004,16
0.894,0.0001,560,544,2,100,0.01,1104,16
0.918,0.0001,606,598,2,100,0.01,1204,16
0.916,0.0001,655,649,2,100,0.01,1304,16
0.922,0.0001,699,705,2,100,0.01,1404,16
0.93,0.0001,755,749,2,100,0.01,1504,16
0.936,0.0001,808,796,2,100,0.01,1604,16
0.946,0.0001,847,857,2,100,0.01,1704,16
0.954,0.0001,905,899,2,100,0.01,1804,16
0.956,0.0001,952,952,2,100,0.01,1904,16
0.95,0.0001,1014,990,2,100,0.01,2004,16
0.534,0.0001,48,56,2,100,0.01,104,17
0.58,0.0001,102,102,2,100,0.01,204,17
0.578,0.0001,146,158,2,100,0.01,304,17
0.6,0.0001,191,213,2,100,0.01,404,17
0.72,0.0001,242,262,2,100,0.01,504,17
0.762,0.0001,291,313,2,100,0.01,604,17
0.808,0.0001,340,364,2,100,0.01,704,17
0.848,0.0001,388,416,2,100,0.01,804,17
0.848,0.0001,442,462,2,100,0.01,904,17
0.882,0.0001,493,511,2,100,0.01,1004,17
0.908,0.0001,544,560,2,100,0.01,1104,17
0.922,0.0001,587,617,2,100,0.01,1204,17
0.928,0.0001,643,661,2,100,0.01,1304,17
0.94,0.0001,698,706,2,100,0.01,1404,17
0.944,0.0001,747,757,2,100,0.01,1504,17
0.95,0.0001,797,807,2,100,0.01,1604,17
0.946,0.0001,842,862,2,100,0.01,1704,17
0.96,0.0001,901,903,2,100,0.01,1804,17
0.964,0.0001,952,952,2,100,0.01,1904,17
0.964,0.0001,1002,1002,2,100,0.01,2004,17
0.474,0.0001,57,47,2,100,0.01,104,18
0.638,0.0001,103,101,2,100,0.01,204,18
0.682,0.0001,155,149,2,100,0.01,304,18
0.708,0.0001,208,196,2,100,0.01,404,18
0.764,0.0001,261,243,2,100,0.01,504,18
0.764,0.0001,313,291,2,100,0.01,604,18
0.796,0.0001,369,335,2,100,0.01,704,18
0.826,0.0001,417,387,2,100,0.01,804,18
0.846,0.0001,474,430,2,100,0.01,904,18
0.876,0.0001,517,487,2,100,0.01,1004,18
0.91,0.0001,574,530,2,100,0.01,1104,18
0.922,0.0001,617,587,2,100,0.01,1204,18
0.928,0.0001,663,641,2,100,0.01,1304,18
0.926,0.0001,711,693,2,100,0.01,1404,18
0.924,0.0001,768,736,2,100,0.01,1504,18
0.922,0.0001,818,786,2,100,0.01,1604,18
0.932,0.0001,866,838,2,100,0.01,1704,18
0.946,0.0001,910,894,2,100,0.01,1804,18
0.944,0.0001,960,944,2,100,0.01,1904,18
0.948,0.0001,1011,993,2,100,0.01,2004,18
0.528,0.0001,58,46,2,100,0.01,104,19
0.486,0.0001,103,101,2,100,0.01,204,19
0.486,0.0001,150,154,2,100,0.01,304,19
0.502,0.0001,204,200,2,100,0.01,404,19
0.662,0.0001,256,248,2,100,0.01,504,19
0.676,0.0001,300,304,2,100,0.01,604,19
0.704,0.0001,351,353,2,100,0.01,704,19
0.822,0.0001,395,409,2,100,0.01,804,19
0.868,0.0001,443,461,2,100,0.01,904,19
0.916,0.0001,497,507,2,100,0.01,1004,19
0.93,0.0001,547,557,2,100,0.01,1104,19
0.934,0.0001,603,601,2,100,0.01,1204,19
0.944,0.0001,657,647,2,100,0.01,1304,19
0.928,0.0001,705,699,2,100,0.01,1404,19
0.918,0.0001,748,756,2,100,0.01,1504,19
0.938,0.0001,796,808,2,100,0.01,1604,19
0.948,0.0001,846,858,2,100,0.01,1704,19
0.948,0.0001,904,900,2,100,0.01,1804,19
0.958,0.0001,956,948,2,100,0.01,1904,19
0.964,0.0001,1009,995,2,100,0.01,2004,19
0.524,0.0001,59,45,2,100,0.01,104,20
0.53,0.0001,109,95,2,100,0.01,204,20
0.542,0.0001,158,146,2,100,0.01,304,20
0.594,0.0001,205,199,2,100,0.01,404,20
0.624,0.0001,254,250,2,100,0.01,504,20
0.706,0.0001,300,304,2,100,0.01,604,20
0.744,0.0001,346,358,2,100,0.01,704,20
0.798,0.0001,398,406,2,100,0.01,804,20
0.776,0.0001,448,456,2,100,0.01,904,20
0.864,0.0001,499,505,2,100,0.01,1004,20
0.894,0.0001,545,559,2,100,0.01,1104,20
0.888,0.0001,589,615,2,100,0.01,1204,20
0.906,0.0001,632,672,2,100,0.01,1304,20
0.936,0.0001,683,721,2,100,0.01,1404,20
0.946,0.0001,728,776,2,100,0.01,1504,20
0.942,0.0001,783,821,2,100,0.01,1604,20
0.95,0.0001,828,876,2,100,0.01,1704,20
0.968,0.0001,879,925,2,100,0.01,1804,20
0.968,0.0001,930,974,2,100,0.01,1904,20
0.97,0.0001,990,1014,2,100,0.01,2004,20
0.522,0.001,50,54,2,100,0.0001,104,1
0.522,0.001,106,98,2,100,0.0001,204,1
0.522,0.001,161,143,2,100,0.0001,304,1
0.522,0.001,206,198,2,100,0.0001,404,1
0.522,0.001,257,247,2,100,0.0001,504,1
0.522,0.001,307,297,2,100,0.0001,604,1
0.522,0.001,357,347,2,100,0.0001,704,1
0.522,0.001,414,390,2,100,0.0001,804,1
0.522,0.001,462,442,2,100,0.0001,904,1
0.522,0.001,508,496,2,100,0.0001,1004,1
0.522,0.001,560,544,2,100,0.0001,1104,1
0.522,0.001,618,586,2,100,0.0001,1204,1
0.522,0.001,659,645,2,100,0.0001,1304,1
0.522,0.001,701,703,2,100,0.0001,1404,1
0.522,0.001,756,748,2,100,0.0001,1504,1
0.526,0.001,803,801,2,100,0.0001,1604,1
0.526,0.001,863,841,2,100,0.0001,1704,1
0.53,0.001,909,895,2,100,0.0001,1804,1
0.532,0.001,960,944,2,100,0.0001,1904,1
0.536,0.001,1013,991,2,100,0.0001,2004,1
0.534,0.001,50,54,2,100,0.0001,104,2
0.536,0.001,95,109,2,100,0.0001,204,2
0.542,0.001,136,168,2,100,0.0001,304,2
0.542,0.001,200,204,2,100,0.0001,404,2
0.544,0.001,255,249,2,100,0.0001,504,2
0.544,0.001,298,306,2,100,0.0001,604,2
0.544,0.001,343,361,2,100,0.0001,704,2
0.546,0.001,400,404,2,100,0.0001,804,2
0.548,0.001,447,457,2,100,0.0001,904,2
0.55,0.001,489,515,2,100,0.0001,1004,2
0.546,0.001,542,562,2,100,0.0001,1104,2
0.55,0.001,591,613,2,100,0.0001,1204,2
0.548,0.001,643,661,2,100,0.0001,1304,2
0.55,0.001,694,710,2,100,0.0001,1404,2
0.548,0.001,743,761,2,100,0.0001,1504,2
0.552,0.001,799,805,2,100,0.0001,1604,2
0.558,0.001,841,863,2,100,0.0001,1704,2
0.558,0.001,893,911,2,100,0.0001,1804,2
0.558,0.001,940,964,2,100,0.0001,1904,2
0.564,0.001,999,1005,2,100,0.0001,2004,2
0.498,0.001,53,51,2,100,0.0001,104,3
0.498,0.001,110,94,2,100,0.0001,204,3
0.5,0.001,159,145,2,100,0.0001,304,3
0.502,0.001,206,198,2,100,0.0001,404,3
0.508,0.001,256,248,2,100,0.0001,504,3
0.512,0.001,307,297,2,100,0.0001,604,3
0.52,0.001,361,343,2,100,0.0001,704,3
0.52,0.001,417,387,2,100,0.0001,804,3
0.522,0.001,474,430,2,100,0.0001,904,3
0.532,0.001,529,475,2,100,0.0001,1004,3
0.54,0.001,573,531,2,100,0.0001,1104,3
0.544,0.001,621,583,2,100,0.0001,1204,3
0.55,0.001,672,632,2,100,0.0001,1304,3
0.562,0.001,722,682,2,100,0.0001,1404,3
0.566,0.001,774,730,2,100,0.0001,1504,3
0.578,0.001,821,783,2,100,0.0001,1604,3
0.594,0.001,872,832,2,100,0.0001,1704,3
0.608,0.001,920,884,2,100,0.0001,1804,3
0.612,0.001,964,940,2,100,0.0001,1904,3
0.616,0.001,1009,995,2,100,0.0001,2004,3
0.504,0.001,43,61,2,100,0.0001,104,4
0.504,0.001,92,112,2,100,0.0001,204,4
0.51,0.001,140,164,2,100,0.0001,304,4
0.52,0.001,183,221,2,100,0.0001,404,4
0.538,0.001,227,277,2,100,0.0001,504,4
0.56,0.001,283,321,2,100,0.0001,604,4
0.592,0.001,338,366,2,100,0.0001,704,4
0.63,0.001,379,425,2,100,0.0001,804,4
0.638,0.001,432,472,2,100,0.0001,904,4
0.644,0.001,481,523,2,100,0.0001,1004,4
0.642,0.001,530,574,2,100,0.0001,1104,4
0.65,0.001,582,622,2,100,0.0001,1204,4
0.646,0.001,635,669,2,100,0.0001,1304,4
0.65,0.001,695,709,2,100,0.0001,1404,4
0.648,0.001,743,761,2,100,0.0001,1504,4
0.652,0.001,795,809,2,100,0.0001,1604,4
0.666,0.001,851,853,2,100,0.0001,1704,4
0.676,0.001,897,907,2,100,0.0001,1804,4
0.688,0.001,941,963,2,100,0.0001,1904,4
0.694,0.001,994,1010,2,100,0.0001,2004,4
0.514,0.001,57,47,2,100,0.0001,104,5
0.514,0.001,114,90,2,100,0.0001,204,5
0.514,0.001,164,140,2,100,0.0001,304,5
0.514,0.001,208,196,2,100,0.0001,404,5
0.514,0.001,258,246,2,100,0.0001,504,5
0.516,0.001,317,287,2,100,0.0001,604,5
0.518,0.001,367,337,2,100,0.0001,704,5
0.518,0.001,407,397,2,100,0.0001,804,5
0.518,0.001,458,446,2,100,0.0001,904,5
0.52,0.001,509,495,2,100,0.0001,1004,5
0.522,0.001,560,544,2,100,0.0001,1104,5
0.522,0.001,610,594,2,100,0.0001,1204,5
0.522,0.001,662,642,2,100,0.0001,1304,5
0.522,0.001,720,684,2,100,0.0001,1404,5
0.522,0.001,763,741,2,100,0.0001,1504,5
0.526,0.001,813,791,2,100,0.0001,1604,5
0.53,0.001,860,844,2,100,0.0001,1704,5
0.536,0.001,921,883,2,100,0.0001,1804,5
0.546,0.001,966,938,2,100,0.0001,1904,5
0.554,0.001,1009,995,2,100,0.0001,2004,5
0.51,0.001,52,52,2,100,0.0001,104,6
0.51,0.001,100,104,2,100,0.0001,204,6
0.51,0.001,157,147,2,100,0.0001,304,6
0.512,0.001,204,200,2,100,0.0001,404,6
0.512,0.001,252,252,2,100,0.0001,504,6
0.512,0.001,301,303,2,100,0.0001,604,6
0.512,0.001,345,359,2,100,0.0001,704,6
0.512,0.001,400,404,2,100,0.0001,804,6
0.512,0.001,445,459,2,100,0.0001,904,6
0.512,0.001,499,505,2,100,0.0001,1004,6
0.51,0.001,547,557,2,100,0.0001,1104,6
0.506,0.001,590,614,2,100,0.0001,1204,6
0.504,0.001,639,665,2,100,0.0001,1304,6
0.504,0.001,685,719,2,100,0.0001,1404,6
0.5,0.001,743,761,2,100,0.0001,1504,6
0.494,0.001,797,807,2,100,0.0001,1604,6
0.488,0.001,842,862,2,100,0.0001,1704,6
0.486,0.001,887,917,2,100,0.0001,1804,6
0.48,0.001,942,962,2,100,0.0001,1904,6
0.484,0.001,988,1016,2,100,0.0001,2004,6
0.554,0.001,62,42,2,100,0.0001,104,7
0.554,0.001,114,90,2,100,0.0001,204,7
0.554,0.001,164,140,2,100,0.0001,304,7
0.554,0.001,217,187,2,100,0.0001,404,7
0.556,0.001,269,235,2,100,0.0001,504,7
0.56,0.001,318,286,2,100,0.0001,604,7
0.56,0.001,366,338,2,100,0.0001,704,7
0.558,0.001,410,394,2,100,0.0001,804,7
0.562,0.001,461,443,2,100,0.0001,904,7
0.566,0.001,514,490,2,100,0.0001,1004,7
0.568,0.001,565,539,2,100,0.0001,1104,7
0.568,0.001,604,600,2,100,0.0001,1204,7
0.566,0.001,657,647,2,100,0.0001,1304,7
0.566,0.001,706,698,2,100,0.0001,1404,7
0.566,0.001,759,745,2,100,0.0001,1504,7
0.572,0.001,804,800,2,100,0.0001,1604,7
0.57,0.001,850,854,2,100,0.0001,1704,7
0.572,0.001,907,897,2,100,0.0001,1804,7
0.57,0.001,955,949,2,100,0.0001,1904,7
0.574,0.001,1005,999,2,100,0.0001,2004,7
0.42,0.001,52,52,2,100,0.0001,104,8
0.426,0.001,108,96,2,100,0.0001,204,8
0.434,0.001,149,155,2,100,0.0001,304,8
0.442,0.001,198,206,2,100,0.0001,404,8
0.45,0.001,248,256,2,100,0.0001,504,8
0.464,0.001,289,315,2,100,0.0001,604,8
0.484,0.001,342,362,2,100,0.0001,704,8
0.498,0.001,386,418,2,100,0.0001,804,8
0.498,0.001,435,469,2,100,0.0001,904,8
0.504,0.001,489,515,2,100,0.0001,1004,8
0.492,0.001,539,565,2,100,0.0001,1104,8
0.504,0.001,585,619,2,100,0.0001,1204,8
0.514,0.001,638,666,2,100,0.0001,1304,8
0.516,0.001,691,713,2,100,0.0001,1404,8
0.518,0.001,735,769,2,100,0.0001,1504,8
0.514,0.001,787,817,2,100,0.0001,1604,8
0.528,0.001,837,867,2,100,0.0001,1704,8
0.54,0.001,890,914,2,100,0.0001,1804,8
0.544,0.001,942,962,2,100,0.0001,1904,8
0.56,0.001,990,1014,2,100,0.0001,2004,8
0.514,0.001,53,51,2,100,0.0001,104,9
0.514,0.001,103,101,2,100,0.0001,204,9
0.514,0.001,153,151,2,100,0.0001,304,9
0.514,0.001,200,204,2,100,0.0001,404,9
0.514,0.001,249,255,2,100,0.0001,504,9
0.514,0.001,290,314,2,100,0.0001,604,9
0.514,0.001,340,364,2,100,0.0001,704,9
0.514,0.001,391,413,2,100,0.0001,804,9
0.514,0.001,440,464,2,100,0.0001,904,9
0.514,0.001,492,512,2,100,0.0001,1004,9
0.516,0.001,545,559,2,100,0.0001,1104,9
0.522,0.001,595,609,2,100,0.0001,1204,9
0.528,0.001,646,658,2,100,0.0001,1304,9
0.538,0.001,695,709,2,100,0.0001,1404,9
0.54,0.001,747,757,2,100,0.0001,1504,9
0.54,0.001,796,808,2,100,0.0001,1604,9
0.542,0.001,844,860,2,100,0.0001,1704,9
0.546,0.001,896,908,2,100,0.0001,1804,9
0.556,0.001,955,949,2,100,0.0001,1904,9
0.56,0.001,1006,998,2,100,0.0001,2004,9
0.498,0.001,47,57,2,100,0.0001,104,10
0.498,0.001,98,106,2,100,0.0001,204,10
0.5,0.001,148,156,2,100,0.0001,304,10
0.5,0.001,198,206,2,100,0.0001,404,10
0.502,0.001,254,250,2,100,0.0001,504,10
0.504,0.001,301,303,2,100,0.0001,604,10
0.506,0.001,356,348,2,100,0.0001,704,10
0.508,0.001,408,396,2,100,0.0001,804,10
0.508,0.001,456,448,2,100,0.0001,904,10
0.51,0.001,500,504,2,100,0.0001,1004,10
0.512,0.001,552,552,2,100,0.0001,1104,10
0.514,0.001,602,602,2,100,0.0001,1204,10
0.514,0.001,646,658,2,100,0.0001,1304,10
0.516,0.001,693,711,2,100,0.0001,1404,10
0.52,0.001,753,751,2,100,0.0001,1504,10
0.524,0.001,808,796,2,100,0.0001,1604,10
0.526,0.001,855,849,2,100,0.0001,1704,10
0.53,0.001,902,902,2,100,0.0001,1804,10
0.542,0.001,959,945,2,100,0.0001,1904,10
0.55,0.001,1002,1002,2,100,0.0001,2004,10
0.478,0.001,41,63,2,100,0.0001,104,11
0.478,0.001,89,115,2,100,0.0001,204,11
0.478,0.001,140,164,2,100,0.0001,304,11
0.478,0.001,191,213,2,100,0.0001,404,11
0.478,0.001,248,256,2,100,0.0001,504,11
0.478,0.001,288,316,2,100,0.0001,604,11
0.478,0.001,343,361,2,100,0.0001,704,11
0.478,0.001,393,411,2,100,0.0001,804,11
0.478,0.001,441,463,2,100,0.0001,904,11
0.478,0.001,485,519,2,100,0.0001,1004,11
0.478,0.001,546,558,2,100,0.0001,1104,11
0.48,0.001,597,607,2,100,0.0001,1204,11
0.48,0.001,651,653,2,100,0.0001,1304,11
0.48,0.001,696,708,2,100,0.0001,1404,11
0.48,0.001,743,761,2,100,0.0001,1504,11
0.48,0.001,795,809,2,100,0.0001,1604,11
0.48,0.001,849,855,2,100,0.0001,1704,11
0.482,0.001,893,911,2,100,0.0001,1804,11
0.484,0.001,940,964,2,100,0.0001,1904,11
0.488,0.001,991,1013,2,100,0.0001,2004,11
0.522,0.001,51,53,2,100,0.0001,104,12
0.526,0.001,100,104,2,100,0.0001,204,12
0.526,0.001,147,157,2,100,0.0001,304,12
0.53,0.001,200,204,2,100,0.0001,404,12
0.532,0.001,251,253,2,100,0.0001,504,12
0.534,0.001,305,299,2,100,0.0001,604,12
0.536,0.001,367,337,2,100,0.0001,704,12
0.538,0.001,408,396,2,100,0.0001,804,12
0.544,0.001,451,453,2,100,0.0001,904,12
0.54,0.001,501,503,2,100,0.0001,1004,12
0.544,0.001,553,551,2,100,0.0001,1104,12
0.544,0.001,610,594,2,100,0.0001,1204,12
0.546,0.001,654,650,2,100,0.0001,1304,12
0.548,0.001,701,703,2,100,0.0001,1404,12
0.55,0.001,755,749,2,100,0.0001,1504,12
0.556,0.001,804,800,2,100,0.0001,1604,12
0.558,0.001,849,855,2,100,0.0001,1704,12
0.564,0.001,900,904,2,100,0.0001,1804,12
0.562,0.001,951,953,2,100,0.0001,1904,12
0.57,0.001,997,1007,2,100,0.0001,2004,12
0.426,0.001,46,58,2,100,0.0001,104,13
0.428,0.001,101,103,2,100,0.0001,204,13
0.428,0.001,151,153,2,100,0.0001,304,13
0.428,0.001,203,201,2,100,0.0001,404,13
0.428,0.001,249,255,2,100,0.0001,504,13
0.43,0.001,299,305,2,100,0.0001,604,13
0.432,0.001,349,355,2,100,0.0001,704,13
0.432,0.001,400,404,2,100,0.0001,804,13
0.432,0.001,446,458,2,100,0.0001,904,13
0.432,0.001,494,510,2,100,0.0001,1004,13
0.432,0.001,539,565,2,100,0.0001,1104,13
0.43,0.001,581,623,2,100,0.0001,1204,13
0.432,0.001,632,672,2,100,0.0001,1304,13
0.436,0.001,684,720,2,100,0.0001,1404,13
0.432,0.001,734,770,2,100,0.0001,1504,13
0.434,0.001,782,822,2,100,0.0001,1604,13
0.432,0.001,828,876,2,100,0.0001,1704,13
0.438,0.001,882,922,2,100,0.0001,1804,13
0.444,0.001,933,971,2,100,0.0001,1904,13
0.466,0.001,988,1016,2,100,0.0001,2004,13
0.552,0.001,54,50,2,100,0.0001,104,14
0.55,0.001,111,93,2,100,0.0001,204,14
0.552,0.001,161,143,2,100,0.0001,304,14
0.55,0.001,212,192,2,100,0.0001,404,14
0.556,0.001,265,239,2,100,0.0001,504,14
0.558,0.001,313,291,2,100,0.0001,604,14
0.56,0.001,366,338,2,100,0.0001,704,14
0.56,0.001,410,394,2,100,0.0001,804,14
0.56,0.001,458,446,2,100,0.0001,904,14
0.56,0.001,514,490,2,100,0.0001,1004,14
0.56,0.001,568,536,2,100,0.0001,1104,14
0.562,0.001,619,585,2,100,0.0001,1204,14
0.558,0.001,667,637,2,100,0.0001,1304,14
0.558,0.001,713,691,2,100,0.0001,1404,14
0.564,0.001,764,740,2,100,0.0001,1504,14
0.572,0.001,803,801,2,100,0.0001,1604,14
0.57,0.001,853,851,2,100,0.0001,1704,14
0.576,0.001,908,896,2,100,0.0001,1804,14
0.588,0.001,962,942,2,100,0.0001,1904,14
0.582,0.001,1007,997,2,100,0.0001,2004,14
0.404,0.001,51,53,2,100,0.0001,104,15
0.402,0.001,106,98,2,100,0.0001,204,15
0.396,0.001,157,147,2,100,0.0001,304,15
0.394,0.001,206,198,2,100,0.0001,404,15
0.394,0.001,254,250,2,100,0.0001,504,15
0.398,0.001,299,305,2,100,0.0001,604,15
0.402,0.001,353,351,2,100,0.0001,704,15
0.402,0.001,400,404,2,100,0.0001,804,15
0.398,0.001,445,459,2,100,0.0001,904,15
0.396,0.001,499,505,2,100,0.0001,1004,15
0.392,0.001,549,555,2,100,0.0001,1104,15
0.396,0.001,599,605,2,100,0.0001,1204,15
0.396,0.001,643,661,2,100,0.0001,1304,15
0.398,0.001,701,703,2,100,0.0001,1404,15
0.402,0.001,748,756,2,100,0.0001,1504,15
0.404,0.001,797,807,2,100,0.0001,1604,15
0.408,0.001,847,857,2,100,0.0001,1704,15
0.414,0.001,902,902,2,100,0.0001,1804,15
0.42,0.001,958,946,2,100,0.0001,1904,15
0.428,0.001,1002,1002,2,100,0.0001,2004,15
0.364,0.001,51,53,2,100,0.0001,104,16
0.368,0.001,94,110,2,100,0.0001,204,16
0.374,0.001,150,154,2,100,0.0001,304,16
0.378,0.001,193,211,2,100,0.0001,404,16
0.374,0.001,244,260,2,100,0.0001,504,16
0.37,0.001,299,305,2,100,0.0001,604,16
0.368,0.001,346,358,2,100,0.0001,704,16
0.376,0.001,396,408,2,100,0.0001,804,16
0.388,0.001,449,455,2,100,0.0001,904,16
0.396,0.001,499,505,2,100,0.0001,1004,16
0.404,0.001,546,558,2,100,0.0001,1104,16
0.412,0.001,600,604,2,100,0.0001,1204,16
0.418,0.001,646,658,2,100,0.0001,1304,16
0.434,0.001,680,724,2,100,0.0001,1404,16
0.45,0.001,737,767,2,100,0.0001,1504,16
0.456,0.001,786,818,2,100,0.0001,1604,16
0.472,0.001,837,867,2,100,0.0001,1704,16
0.508,0.001,888,916,2,100,0.0001,1804,16
0.522,0.001,938,966,2,100,0.0001,1904,16
0.544,0.001,992,1012,2,100,0.0001,2004,16
0.462,0.001,59,45,2,100,0.0001,104,17
0.462,0.001,111,93,2,100,0.0001,204,17
0.462,0.001,160,144,2,100,0.0001,304,17
0.462,0.001,210,194,2,100,0.0001,404,17
0.462,0.001,255,249,2,100,0.0001,504,17
0.462,0.001,313,291,2,100,0.0001,604,17
0.462,0.001,367,337,2,100,0.0001,704,17
0.462,0.001,415,389,2,100,0.0001,804,17
0.462,0.001,461,443,2,100,0.0001,904,17
0.462,0.001,521,483,2,100,0.0001,1004,17
0.462,0.001,576,528,2,100,0.0001,1104,17
0.462,0.001,623,581,2,100,0.0001,1204,17
0.462,0.001,669,635,2,100,0.0001,1304,17
0.462,0.001,718,686,2,100,0.0001,1404,17
0.462,0.001,764,740,2,100,0.0001,1504,17
0.462,0.001,816,788,2,100,0.0001,1604,17
0.462,0.001,874,830,2,100,0.0001,1704,17
0.462,0.001,921,883,2,100,0.0001,1804,17
0.462,0.001,967,937,2,100,0.0001,1904,17
0.462,0.001,1021,983,2,100,0.0001,2004,17
0.49,0.001,59,45,2,100,0.0001,104,18
0.49,0.001,107,97,2,100,0.0001,204,18
0.49,0.001,157,147,2,100,0.0001,304,18
0.49,0.001,202,202,2,100,0.0001,404,18
0.49,0.001,259,245,2,100,0.0001,504,18
0.49,0.001,300,304,2,100,0.0001,604,18
0.49,0.001,344,360,2,100,0.0001,704,18
0.49,0.001,393,411,2,100,0.0001,804,18
0.49,0.001,441,463,2,100,0.0001,904,18
0.49,0.001,492,512,2,100,0.0001,1004,18
0.49,0.001,554,550,2,100,0.0001,1104,18
0.488,0.001,601,603,2,100,0.0001,1204,18
0.488,0.001,655,649,2,100,0.0001,1304,18
0.488,0.001,710,694,2,100,0.0001,1404,18
0.488,0.001,756,748,2,100,0.0001,1504,18
0.486,0.001,811,793,2,100,0.0001,1604,18
0.486,0.001,861,843,2,100,0.0001,1704,18
0.486,0.001,913,891,2,100,0.0001,1804,18
0.486,0.001,961,943,2,100,0.0001,1904,18
0.486,0.001,1007,997,2,100,0.0001,2004,18
0.536,0.001,62,42,2,100,0.0001,104,19
0.536,0.001,104,100,2,100,0.0001,204,19
0.536,0.001,150,154,2,100,0.0001,304,19
0.536,0.001,208,196,2,100,0.0001,404,19
0.538,0.001,263,241,2,100,0.0001,504,19
0.542,0.001,319,285,2,100,0.0001,604,19
0.546,0.001,363,341,2,100,0.0001,704,19
0.546,0.001,405,399,2,100,0.0001,804,19
0.554,0.001,462,442,2,100,0.0001,904,19
0.556,0.001,504,500,2,100,0.0001,1004,19
0.566,0.001,550,554,2,100,0.0001,1104,19
0.57,0.001,603,601,2,100,0.0001,1204,19
0.57,0.001,652,652,2,100,0.0001,1304,19
0.58,0.001,704,700,2,100,0.0001,1404,19
0.59,0.001,760,744,2,100,0.0001,1504,19
0.602,0.001,815,789,2,100,0.0001,1604,19
0.618,0.001,869,835,2,100,0.0001,1704,19
0.624,0.001,921,883,2,100,0.0001,1804,19
0.628,0.001,972,932,2,100,0.0001,1904,19
0.63,0.001,1016,988,2,100,0.0001,2004,19
0.512,0.001,60,44,2,100,0.0001,104,20
0.512,0.001,103,101,2,100,0.0001,204,20
0.512,0.001,156,148,2,100,0.0001,304,20
0.512,0.001,210,194,2,100,0.0001,404,20
0.512,0.001,260,244,2,100,0.0001,504,20
0.512,0.001,304,300,2,100,0.0001,604,20
0.512,0.001,354,350,2,100,0.0001,704,20
0.512,0.001,397,407,2,100,0.0001,804,20
0.512,0.001,446,458,2,100,0.0001,904,20
0.512,0.001,504,500,2,100,0.0001,1004,20
0.512,0.001,553,551,2,100,0.0001,1104,20
0.512,0.001,597,607,2,100,0.0001,1204,20
0.512,0.001,653,651,2,100,0.0001,1304,20
0.512,0.001,707,697,2,100,0.0001,1404,20
0.512,0.001,756,748,2,100,0.0001,1504,20
0.512,0.001,803,801,2,100,0.0001,1604,20
0.512,0.001,855,849,2,100,0.0001,1704,20
0.512,0.001,903,901,2,100,0.0001,1804,20
0.512,0.001,955,949,2,100,0.0001,1904,20
0.512,0.001,1008,996,2,100,0.0001,2004,20
0.498,0.001,50,54,2,100,0.001,104,1
0.524,0.001,105,99,2,100,0.001,204,1
0.56,0.001,144,160,2,100,0.001,304,1
0.602,0.001,202,202,2,100,0.001,404,1
0.616,0.001,256,248,2,100,0.001,504,1
0.63,0.001,300,304,2,100,0.001,604,1
0.63,0.001,358,346,2,100,0.001,704,1
0.638,0.001,411,393,2,100,0.001,804,1
0.644,0.001,464,440,2,100,0.001,904,1
0.684,0.001,522,482,2,100,0.001,1004,1
0.718,0.001,568,536,2,100,0.001,1104,1
0.756,0.001,616,588,2,100,0.001,1204,1
0.734,0.001,667,637,2,100,0.001,1304,1
0.742,0.001,722,682,2,100,0.001,1404,1
0.754,0.001,770,734,2,100,0.001,1504,1
0.762,0.001,813,791,2,100,0.001,1604,1
0.77,0.001,864,840,2,100,0.001,1704,1
0.798,0.001,928,876,2,100,0.001,1804,1
0.814,0.001,973,931,2,100,0.001,1904,1
0.83,0.001,1027,977,2,100,0.001,2004,1
0.504,0.001,54,50,2,100,0.001,104,2
0.516,0.001,103,101,2,100,0.001,204,2
0.524,0.001,160,144,2,100,0.001,304,2
0.536,0.001,203,201,2,100,0.001,404,2
0.552,0.001,254,250,2,100,0.001,504,2
0.584,0.001,296,308,2,100,0.001,604,2
0.592,0.001,343,361,2,100,0.001,704,2
0.612,0.001,395,409,2,100,0.001,804,2
0.61,0.001,444,460,2,100,0.001,904,2
0.612,0.001,485,519,2,100,0.001,1004,2
0.614,0.001,532,572,2,100,0.001,1104,2
0.62,0.001,578,626,2,100,0.001,1204,2
0.628,0.001,625,679,2,100,0.001,1304,2
0.636,0.001,675,729,2,100,0.001,1404,2
0.67,0.001,733,771,2,100,0.001,1504,2
0.72,0.001,789,815,2,100,0.001,1604,2
0.738,0.001,841,863,2,100,0.001,1704,2
0.778,0.001,890,914,2,100,0.001,1804,2
0.79,0.001,937,967,2,100,0.001,1904,2
0.816,0.001,984,1020,2,100,0.001,2004,2
0.514,0.001,55,49,2,100,0.001,104,3
0.514,0.001,101,103,2,100,0.001,204,3
0.514,0.001,150,154,2,100,0.001,304,3
0.514,0.001,196,208,2,100,0.001,404,3
0.514,0.001,243,261,2,100,0.001,504,3
0.512,0.001,303,301,2,100,0.001,604,3
0.5,0.001,355,349,2,100,0.001,704,3
0.476,0.001,404,400,2,100,0.001,804,3
0.484,0.001,454,450,2,100,0.001,904,3
0.488,0.001,502,502,2,100,0.001,1004,3
0.496,0.001,561,543,2,100,0.001,1104,3
0.524,0.001,612,592,2,100,0.001,1204,3
0.552,0.001,668,636,2,100,0.001,1304,3
0.578,0.001,717,687,2,100,0.001,1404,3
0.572,0.001,773,731,2,100,0.001,1504,3
0.58,0.001,823,781,2,100,0.001,1604,3
0.602,0.001,874,830,2,100,0.001,1704,3
0.608,0.001,922,882,2,100,0.001,1804,3
0.636,0.001,965,939,2,100,0.001,1904,3
0.65,0.001,1009,995,2,100,0.001,2004,3
0.534,0.001,54,50,2,100,0.001,104,4
0.59,0.001,111,93,2,100,0.001,204,4
0.612,0.001,161,143,2,100,0.001,304,4
0.648,0.001,207,197,2,100,0.001,404,4
0.684,0.001,263,241,2,100,0.001,504,4
0.692,0.001,312,292,2,100,0.001,604,4
0.716,0.001,360,344,2,100,0.001,704,4
0.728,0.001,406,398,2,100,0.001,804,4
0.726,0.001,454,450,2,100,0.001,904,4
0.74,0.001,501,503,2,100,0.001,1004,4
0.752,0.001,550,554,2,100,0.001,1104,4
0.758,0.001,601,603,2,100,0.001,1204,4
0.74,0.001,646,658,2,100,0.001,1304,4
0.748,0.001,694,710,2,100,0.001,1404,4
0.736,0.001,739,765,2,100,0.001,1504,4
0.75,0.001,793,811,2,100,0.001,1604,4
0.742,0.001,845,859,2,100,0.001,1704,4
0.742,0.001,896,908,2,100,0.001,1804,4
0.742,0.001,953,951,2,100,0.001,1904,4
0.756,0.001,1000,1004,2,100,0.001,2004,4
0.474,0.001,40,64,2,100,0.001,104,5
0.488,0.001,88,116,2,100,0.001,204,5
0.492,0.001,137,167,2,100,0.001,304,5
0.494,0.001,176,228,2,100,0.001,404,5
0.498,0.001,224,280,2,100,0.001,504,5
0.498,0.001,275,329,2,100,0.001,604,5
0.502,0.001,325,379,2,100,0.001,704,5
0.514,0.001,381,423,2,100,0.001,804,5
0.536,0.001,430,474,2,100,0.001,904,5
0.564,0.001,479,525,2,100,0.001,1004,5
0.606,0.001,531,573,2,100,0.001,1104,5
0.65,0.001,590,614,2,100,0.001,1204,5
0.67,0.001,634,670,2,100,0.001,1304,5
0.706,0.001,684,720,2,100,0.001,1404,5
0.744,0.001,735,769,2,100,0.001,1504,5
0.772,0.001,780,824,2,100,0.001,1604,5
0.768,0.001,841,863,2,100,0.001,1704,5
0.782,0.001,889,915,2,100,0.001,1804,5
0.79,0.001,940,964,2,100,0.001,1904,5
0.798,0.001,995,1009,2,100,0.001,2004,5
0.47,0.001,51,53,2,100,0.001,104,6
0.478,0.001,99,105,2,100,0.001,204,6
0.5,0.001,153,151,2,100,0.001,304,6
0.53,0.001,204,200,2,100,0.001,404,6
0.544,0.001,259,245,2,100,0.001,504,6
0.574,0.001,303,301,2,100,0.001,604,6
0.586,0.001,348,356,2,100,0.001,704,6
0.59,0.001,394,410,2,100,0.001,804,6
0.6,0.001,449,455,2,100,0.001,904,6
0.74,0.001,493,511,2,100,0.001,1004,6
0.76,0.001,538,566,2,100,0.001,1104,6
0.746,0.001,586,618,2,100,0.001,1204,6
0.736,0.001,640,664,2,100,0.001,1304,6
0.754,0.001,690,714,2,100,0.001,1404,6
0.762,0.001,745,759,2,100,0.001,1504,6
0.786,0.001,794,810,2,100,0.001,1604,6
0.79,0.001,848,856,2,100,0.001,1704,6
0.802,0.001,900,904,2,100,0.001,1804,6
0.81,0.001,954,950,2,100,0.001,1904,6
0.818,0.001,992,1012,2,100,0.001,2004,6
0.512,0.001,55,49,2,100,0.001,104,7
0.512,0.001,111,93,2,100,0.001,204,7
0.518,0.001,156,148,2,100,0.001,304,7
0.522,0.001,205,199,2,100,0.001,404,7
0.522,0.001,257,247,2,100,0.001,504,7
0.522,0.001,305,299,2,100,0.001,604,7
0.524,0.001,353,351,2,100,0.001,704,7
0.536,0.001,405,399,2,100,0.001,804,7
0.556,0.001,455,449,2,100,0.001,904,7
0.586,0.001,505,499,2,100,0.001,1004,7
0.61,0.001,558,546,2,100,0.001,1104,7
0.648,0.001,615,589,2,100,0.001,1204,7
0.674,0.001,665,639,2,100,0.001,1304,7
0.718,0.001,716,688,2,100,0.001,1404,7
0.754,0.001,761,743,2,100,0.001,1504,7
0.78,0.001,809,795,2,100,0.001,1604,7
0.81,0.001,865,839,2,100,0.001,1704,7
0.828,0.001,912,892,2,100,0.001,1804,7
0.826,0.001,964,940,2,100,0.001,1904,7
0.852,0.001,1015,989,2,100,0.001,2004,7
0.602,0.001,49,55,2,100,0.001,104,8
0.596,0.001,93,111,2,100,0.001,204,8
0.596,0.001,148,156,2,100,0.001,304,8
0.604,0.001,199,205,2,100,0.001,404,8
0.604,0.001,248,256,2,100,0.001,504,8
0.606,0.001,296,308,2,100,0.001,604,8
0.602,0.001,342,362,2,100,0.001,704,8
0.602,0.001,391,413,2,100,0.001,804,8
0.612,0.001,440,464,2,100,0.001,904,8
0.632,0.001,495,509,2,100,0.001,1004,8
0.648,0.001,550,554,2,100,0.001,1104,8
0.67,0.001,598,606,2,100,0.001,1204,8
0.7,0.001,647,657,2,100,0.001,1304,8
0.716,0.001,699,705,2,100,0.001,1404,8
0.722,0.001,746,758,2,100,0.001,1504,8
0.726,0.001,794,810,2,100,0.001,1604,8
0.73,0.001,840,864,2,100,0.001,1704,8
0.744,0.001,885,919,2,100,0.001,1804,8
0.752,0.001,933,971,2,100,0.001,1904,8
0.784,0.001,982,1022,2,100,0.001,2004,8
0.506,0.001,51,53,2,100,0.001,104,9
0.506,0.001,98,106,2,100,0.001,204,9
0.506,0.001,144,160,2,100,0.001,304,9
0.48,0.001,197,207,2,100,0.001,404,9
0.46,0.001,250,254,2,100,0.001,504,9
0.444,0.001,297,307,2,100,0.001,604,9
0.494,0.001,344,360,2,100,0.001,704,9
0.556,0.001,396,408,2,100,0.001,804,9
0.594,0.001,449,455,2,100,0.001,904,9
0.644,0.001,500,504,2,100,0.001,1004,9
0.69,0.001,547,557,2,100,0.001,1104,9
0.732,0.001,601,603,2,100,0.001,1204,9
0.718,0.001,653,651,2,100,0.001,1304,9
0.712,0.001,705,699,2,100,0.001,1404,9
0.696,0.001,747,757,2,100,0.001,1504,9
0.706,0.001,797,807,2,100,0.001,1604,9
0.744,0.001,851,853,2,100,0.001,1704,9
0.752,0.001,898,906,2,100,0.001,1804,9
0.758,0.001,953,951,2,100,0.001,1904,9
0.768,0.001,1005,999,2,100,0.001,2004,9
0.502,0.001,47,57,2,100,0.001,104,10
0.502,0.001,95,109,2,100,0.001,204,10
0.502,0.001,144,160,2,100,0.001,304,10
0.508,0.001,199,205,2,100,0.001,404,10
0.534,0.001,253,251,2,100,0.001,504,10
0.564,0.001,311,293,2,100,0.001,604,10
0.594,0.001,358,346,2,100,0.001,704,10
0.604,0.001,413,391,2,100,0.001,804,10
0.61,0.001,465,439,2,100,0.001,904,10
0.618,0.001,512,492,2,100,0.001,1004,10
0.652,0.001,559,545,2,100,0.001,1104,10
0.676,0.001,610,594,2,100,0.001,1204,10
0.702,0.001,659,645,2,100,0.001,1304,10
0.712,0.001,702,702,2,100,0.001,1404,10
0.714,0.001,749,755,2,100,0.001,1504,10
0.726,0.001,800,804,2,100,0.001,1604,10
0.738,0.001,852,852,2,100,0.001,1704,10
0.74,0.001,901,903,2,100,0.001,1804,10
0.75,0.001,956,948,2,100,0.001,1904,10
0.758,0.001,1001,1003,2,100,0.001,2004,10
0.494,0.001,57,47,2,100,0.001,104,11
0.506,0.001,106,98,2,100,0.001,204,11
0.514,0.001,153,151,2,100,0.001,304,11
0.518,0.001,209,195,2,100,0.001,404,11
0.524,0.001,258,246,2,100,0.001,504,11
0.534,0.001,308,296,2,100,0.001,604,11
0.534,0.001,357,347,2,100,0.001,704,11
0.554,0.001,402,402,2,100,0.001,804,11
0.56,0.001,451,453,2,100,0.001,904,11
0.564,0.001,504,500,2,100,0.001,1004,11
0.568,0.001,553,551,2,100,0.001,1104,11
0.576,0.001,604,600,2,100,0.001,1204,11
0.634,0.001,657,647,2,100,0.001,1304,11
0.676,0.001,711,693,2,100,0.001,1404,11
0.678,0.001,760,744,2,100,0.001,1504,11
0.71,0.001,802,802,2,100,0.001,1604,11
0.74,0.001,856,848,2,100,0.001,1704,11
0.772,0.001,903,901,2,100,0.001,1804,11
0.764,0.001,951,953,2,100,0.001,1904,11
0.774,0.001,1003,1001,2,100,0.001,2004,11
0.502,0.001,52,52,2,100,0.001,104,12
0.512,0.001,99,105,2,100,0.001,204,12
0.522,0.001,154,150,2,100,0.001,304,12
0.52,0.001,205,199,2,100,0.001,404,12
0.536,0.001,261,243,2,100,0.001,504,12
0.552,0.001,303,301,2,100,0.001,604,12
0.566,0.001,361,343,2,100,0.001,704,12
0.616,0.001,419,385,2,100,0.001,804,12
0.65,0.001,457,447,2,100,0.001,904,12
0.66,0.001,506,498,2,100,0.001,1004,12
0.666,0.001,565,539,2,100,0.001,1104,12
0.666,0.001,622,582,2,100,0.001,1204,12
0.66,0.001,667,637,2,100,0.001,1304,12
0.664,0.001,714,690,2,100,0.001,1404,12
0.678,0.001,768,736,2,100,0.001,1504,12
0.7,0.001,817,787,2,100,0.001,1604,12
0.724,0.001,869,835,2,100,0.001,1704,12
0.746,0.001,913,891,2,100,0.001,1804,12
0.73,0.001,965,939,2,100,0.001,1904,12
0.782,0.001,1013,991,2,100,0.001,2004,12
0.596,0.001,58,46,2,100,0.001,104,13
0.64,0.001,116,88,2,100,0.001,204,13
0.676,0.001,164,140,2,100,0.001,304,13
0.704,0.001,216,188,2,100,0.001,404,13
0.644,0.001,269,235,2,100,0.001,504,13
0.642,0.001,316,288,2,100,0.001,604,13
0.646,0.001,363,341,2,100,0.001,704,13
0.722,0.001,398,406,2,100,0.001,804,13
0.754,0.001,449,455,2,100,0.001,904,13
0.748,0.001,496,508,2,100,0.001,1004,13
0.748,0.001,554,550,2,100,0.001,1104,13
0.748,0.001,608,596,2,100,0.001,1204,13
0.754,0.001,661,643,2,100,0.001,1304,13
0.758,0.001,711,693,2,100,0.001,1404,13
0.764,0.001,764,740,2,100,0.001,1504,13
0.766,0.001,806,798,2,100,0.001,1604,13
0.766,0.001,858,846,2,100,0.001,1704,13
0.764,0.001,903,901,2,100,0.001,1804,13
0.768,0.001,957,947,2,100,0.001,1904,13
0.776,0.001,1006,998,2,100,0.001,2004,13
0.482,0.001,59,45,2,100,0.001,104,14
0.51,0.001,108,96,2,100,0.001,204,14
0.504,0.001,160,144,2,100,0.001,304,14
0.518,0.001,208,196,2,100,0.001,404,14
0.548,0.001,255,249,2,100,0.001,504,14
0.566,0.001,299,305,2,100,0.001,604,14
0.586,0.001,354,350,2,100,0.001,704,14
0.59,0.001,403,401,2,100,0.001,804,14
0.58,0.001,445,459,2,100,0.001,904,14
0.58,0.001,492,512,2,100,0.001,1004,14
0.61,0.001,544,560,2,100,0.001,1104,14
0.636,0.001,597,607,2,100,0.001,1204,14
0.672,0.001,650,654,2,100,0.001,1304,14
0.704,0.001,699,705,2,100,0.001,1404,14
0.73,0.001,747,757,2,100,0.001,1504,14
0.752,0.001,800,804,2,100,0.001,1604,14
0.808,0.001,846,858,2,100,0.001,1704,14
0.836,0.001,894,910,2,100,0.001,1804,14
0.856,0.001,953,951,2,100,0.001,1904,14
0.866,0.001,1006,998,2,100,0.001,2004,14
0.48,0.001,53,51,2,100,0.001,104,15
0.48,0.001,100,104,2,100,0.001,204,15
0.482,0.001,159,145,2,100,0.001,304,15
0.482,0.001,210,194,2,100,0.001,404,15
0.482,0.001,258,246,2,100,0.001,504,15
0.486,0.001,313,291,2,100,0.001,604,15
0.498,0.001,359,345,2,100,0.001,704,15
0.524,0.001,404,400,2,100,0.001,804,15
0.524,0.001,457,447,2,100,0.001,904,15
0.54,0.001,508,496,2,100,0.001,1004,15
0.544,0.001,565,539,2,100,0.001,1104,15
0.552,0.001,619,585,2,100,0.001,1204,15
0.562,0.001,658,646,2,100,0.001,1304,15
0.614,0.001,703,701,2,100,0.001,1404,15
0.676,0.001,752,752,2,100,0.001,1504,15
0.718,0.001,802,802,2,100,0.001,1604,15
0.698,0.001,859,845,2,100,0.001,1704,15
0.692,0.001,902,902,2,100,0.001,1804,15
0.692,0.001,952,952,2,100,0.001,1904,15
0.728,0.001,1011,993,2,100,0.001,2004,15
0.49,0.001,55,49,2,100,0.001,104,16
0.558,0.001,106,98,2,100,0.001,204,16
0.604,0.001,147,157,2,100,0.001,304,16
0.602,0.001,197,207,2,100,0.001,404,16
0.594,0.001,247,257,2,100,0.001,504,16
0.592,0.001,298,306,2,100,0.001,604,16
0.588,0.001,342,362,2,100,0.001,704,16
0.588,0.001,399,405,2,100,0.001,804,16
0.612,0.001,451,453,2,100,0.001,904,16
0.646,0.001,499,505,2,100,0.001,1004,16
0.69,0.001,546,558,2,100,0.001,1104,16
0.712,0.001,595,609,2,100,0.001,1204,16
0.72,0.001,652,652,2,100,0.001,1304,16
0.746,0.001,707,697,2,100,0.001,1404,16
0.766,0.001,756,748,2,100,0.001,1504,16
0.76,0.001,802,802,2,100,0.001,1604,16
0.772,0.001,852,852,2,100,0.001,1704,16
0.782,0.001,911,893,2,100,0.001,1804,16
0.784,0.001,960,944,2,100,0.001,1904,16
0.794,0.001,1001,1003,2,100,0.001,2004,16
0.532,0.001,51,53,2,100,0.001,104,17
0.516,0.001,99,105,2,100,0.001,204,17
0.51,0.001,147,157,2,100,0.001,304,17
0.496,0.001,193,211,2,100,0.001,404,17
0.48,0.001,243,261,2,100,0.001,504,17
0.456,0.001,294,310,2,100,0.001,604,17
0.522,0.001,345,359,2,100,0.001,704,17
0.556,0.001,395,409,2,100,0.001,804,17
0.586,0.001,439,465,2,100,0.001,904,17
0.626,0.001,488,516,2,100,0.001,1004,17
0.654,0.001,539,565,2,100,0.001,1104,17
0.694,0.001,589,615,2,100,0.001,1204,17
0.75,0.001,644,660,2,100,0.001,1304,17
0.772,0.001,700,704,2,100,0.001,1404,17
0.778,0.001,743,761,2,100,0.001,1504,17
0.786,0.001,793,811,2,100,0.001,1604,17
0.808,0.001,839,865,2,100,0.001,1704,17
0.82,0.001,891,913,2,100,0.001,1804,17
0.816,0.001,943,961,2,100,0.001,1904,17
0.822,0.001,993,1011,2,100,0.001,2004,17
0.472,0.001,58,46,2,100,0.001,104,18
0.468,0.001,113,91,2,100,0.001,204,18
0.472,0.001,154,150,2,100,0.001,304,18
0.494,0.001,202,202,2,100,0.001,404,18
0.504,0.001,247,257,2,100,0.001,504,18
0.524,0.001,301,303,2,100,0.001,604,18
0.524,0.001,354,350,2,100,0.001,704,18
0.536,0.001,408,396,2,100,0.001,804,18
0.554,0.001,457,447,2,100,0.001,904,18
0.594,0.001,513,491,2,100,0.001,1004,18
0.632,0.001,563,541,2,100,0.001,1104,18
0.652,0.001,613,591,2,100,0.001,1204,18
0.678,0.001,664,640,2,100,0.001,1304,18
0.704,0.001,720,684,2,100,0.001,1404,18
0.736,0.001,766,738,2,100,0.001,1504,18
0.78,0.001,819,785,2,100,0.001,1604,18
0.816,0.001,868,836,2,100,0.001,1704,18
0.856,0.001,915,889,2,100,0.001,1804,18
0.868,0.001,962,942,2,100,0.001,1904,18
0.88,0.001,1014,990,2,100,0.001,2004,18
0.466,0.001,53,51,2,100,0.001,104,19
0.464,0.001,102,102,2,100,0.001,204,19
0.468,0.001,144,160,2,100,0.001,304,19
0.462,0.001,191,213,2,100,0.001,404,19
0.48,0.001,248,256,2,100,0.001,504,19
0.468,0.001,290,314,2,100,0.001,604,19
0.502,0.001,336,368,2,100,0.001,704,19
0.564,0.001,387,417,2,100,0.001,804,19
0.582,0.001,432,472,2,100,0.001,904,19
0.592,0.001,485,519,2,100,0.001,1004,19
0.59,0.001,535,569,2,100,0.001,1104,19
0.614,0.001,587,617,2,100,0.001,1204,19
0.69,0.001,645,659,2,100,0.001,1304,19
0.724,0.001,690,714,2,100,0.001,1404,19
0.732,0.001,746,758,2,100,0.001,1504,19
0.73,0.001,795,809,2,100,0.001,1604,19
0.746,0.001,843,861,2,100,0.001,1704,19
0.752,0.001,890,914,2,100,0.001,1804,19
0.77,0.001,943,961,2,100,0.001,1904,19
0.78,0.001,986,1018,2,100,0.001,2004,19
0.418,0.001,52,52,2,100,0.001,104,20
0.448,0.001,109,95,2,100,0.001,204,20
0.47,0.001,161,143,2,100,0.001,304,20
0.494,0.001,215,189,2,100,0.001,404,20
0.482,0.001,270,234,2,100,0.001,504,20
0.48,0.001,321,283,2,100,0.001,604,20
0.51,0.001,368,336,2,100,0.001,704,20
0.522,0.001,416,388,2,100,0.001,804,20
0.588,0.001,465,439,2,100,0.001,904,20
0.646,0.001,513,491,2,100,0.001,1004,20
0.652,0.001,570,534,2,100,0.001,1104,20
0.658,0.001,623,581,2,100,0.001,1204,20
0.676,0.001,676,628,2,100,0.001,1304,20
0.73,0.001,723,681,2,100,0.001,1404,20
0.742,0.001,771,733,2,100,0.001,1504,20
0.748,0.001,825,779,2,100,0.001,1604,20
0.77,0.001,869,835,2,100,0.001,1704,20
0.788,0.001,914,890,2,100,0.001,1804,20
0.792,0.001,964,940,2,100,0.001,1904,20
0.8,0.001,1011,993,2,100,0.001,2004,20
0.494,0.001,56,48,2,100,0.01,104,1
0.51,0.001,105,99,2,100,0.01,204,1
0.534,0.001,149,155,2,100,0.01,304,1
0.49,0.001,201,203,2,100,0.01,404,1
0.568,0.001,254,250,2,100,0.01,504,1
0.672,0.001,303,301,2,100,0.01,604,1
0.73,0.001,350,354,2,100,0.01,704,1
0.786,0.001,398,406,2,100,0.01,804,1
0.838,0.001,454,450,2,100,0.01,904,1
0.896,0.001,517,487,2,100,0.01,1004,1
0.932,0.001,569,535,2,100,0.01,1104,1
0.942,0.001,608,596,2,100,0.01,1204,1
0.954,0.001,653,651,2,100,0.01,1304,1
0.946,0.001,699,705,2,100,0.01,1404,1
0.956,0.001,752,752,2,100,0.01,1504,1
0.94,0.001,803,801,2,100,0.01,1604,1
0.948,0.001,862,842,2,100,0.01,1704,1
0.948,0.001,919,885,2,100,0.01,1804,1
0.948,0.001,965,939,2,100,0.01,1904,1
0.958,0.001,1013,991,2,100,0.01,2004,1
0.476,0.001,50,54,2,100,0.01,104,2
0.516,0.001,99,105,2,100,0.01,204,2
0.522,0.001,146,158,2,100,0.01,304,2
0.54,0.001,191,213,2,100,0.01,404,2
0.588,0.001,250,254,2,100,0.01,504,2
0.648,0.001,299,305,2,100,0.01,604,2
0.576,0.001,352,352,2,100,0.01,704,2
0.632,0.001,405,399,2,100,0.01,804,2
0.66,0.001,448,456,2,100,0.01,904,2
0.774,0.001,501,503,2,100,0.01,1004,2
0.81,0.001,557,547,2,100,0.01,1104,2
0.884,0.001,614,590,2,100,0.01,1204,2
0.904,0.001,666,638,2,100,0.01,1304,2
0.914,0.001,718,686,2,100,0.01,1404,2
0.928,0.001,768,736,2,100,0.01,1504,2
0.944,0.001,814,790,2,100,0.01,1604,2
0.948,0.001,872,832,2,100,0.01,1704,2
0.948,0.001,913,891,2,100,0.01,1804,2
0.95,0.001,966,938,2,100,0.01,1904,2
0.956,0.001,1014,990,2,100,0.01,2004,2
0.488,0.001,48,56,2,100,0.01,104,3
0.568,0.001,92,112,2,100,0.01,204,3
0.566,0.001,135,169,2,100,0.01,304,3
0.676,0.001,188,216,2,100,0.01,404,3
0.748,0.001,234,270,2,100,0.01,504,3
0.742,0.001,276,328,2,100,0.01,604,3
0.78,0.001,328,376,2,100,0.01,704,3
0.85,0.001,390,414,2,100,0.01,804,3
0.874,0.001,431,473,2,100,0.01,904,3
0.87,0.001,482,522,2,100,0.01,1004,3
0.878,0.001,531,573,2,100,0.01,1104,3
0.904,0.001,581,623,2,100,0.01,1204,3
0.936,0.001,640,664,2,100,0.01,1304,3
0.93,0.001,697,707,2,100,0.01,1404,3
0.94,0.001,745,759,2,100,0.01,1504,3
0.944,0.001,802,802,2,100,0.01,1604,3
0.944,0.001,859,845,2,100,0.01,1704,3
0.948,0.001,901,903,2,100,0.01,1804,3
0.952,0.001,944,960,2,100,0.01,1904,3
0.954,0.001,998,1006,2,100,0.01,2004,3
0.482,0.001,48,56,2,100,0.01,104,4
0.582,0.001,100,104,2,100,0.01,204,4
0.616,0.001,149,155,2,100,0.01,304,4
0.598,0.001,210,194,2,100,0.01,404,4
0.618,0.001,258,246,2,100,0.01,504,4
0.78,0.001,303,301,2,100,0.01,604,4
0.732,0.001,350,354,2,100,0.01,704,4
0.798,0.001,395,409,2,100,0.01,804,4
0.848,0.001,444,460,2,100,0.01,904,4
0.878,0.001,500,504,2,100,0.01,1004,4
0.884,0.001,551,553,2,100,0.01,1104,4
0.91,0.001,607,597,2,100,0.01,1204,4
0.924,0.001,670,634,2,100,0.01,1304,4
0.924,0.001,714,690,2,100,0.01,1404,4
0.934,0.001,759,745,2,100,0.01,1504,4
0.948,0.001,809,795,2,100,0.01,1604,4
0.952,0.001,863,841,2,100,0.01,1704,4
0.952,0.001,904,900,2,100,0.01,1804,4
0.952,0.001,947,957,2,100,0.01,1904,4
0.958,0.001,993,1011,2,100,0.01,2004,4
0.548,0.001,49,55,2,100,0.01,104,5
0.606,0.001,95,109,2,100,0.01,204,5
0.618,0.001,142,162,2,100,0.01,304,5
0.622,0.001,195,209,2,100,0.01,404,5
0.61,0.001,248,256,2,100,0.01,504,5
0.666,0.001,292,312,2,100,0.01,604,5
0.75,0.001,346,358,2,100,0.01,704,5
0.774,0.001,402,402,2,100,0.01,804,5
0.832,0.001,458,446,2,100,0.01,904,5
0.878,0.001,508,496,2,100,0.01,1004,5
0.858,0.001,548,556,2,100,0.01,1104,5
0.91,0.001,601,603,2,100,0.01,1204,5
0.896,0.001,659,645,2,100,0.01,1304,5
0.916,0.001,707,697,2,100,0.01,1404,5
0.922,0.001,755,749,2,100,0.01,1504,5
0.93,0.001,806,798,2,100,0.01,1604,5
0.948,0.001,855,849,2,100,0.01,1704,5
0.946,0.001,909,895,2,100,0.01,1804,5
0.946,0.001,956,948,2,100,0.01,1904,5
0.958,0.001,1008,996,2,100,0.01,2004,5
0.46,0.001,48,56,2,100,0.01,104,6
0.562,0.001,107,97,2,100,0.01,204,6
0.666,0.001,161,143,2,100,0.01,304,6
0.716,0.001,218,186,2,100,0.01,404,6
0.784,0.001,263,241,2,100,0.01,504,6
0.796,0.001,309,295,2,100,0.01,604,6
0.682,0.001,358,346,2,100,0.01,704,6
0.686,0.001,416,388,2,100,0.01,804,6
0.774,0.001,475,429,2,100,0.01,904,6
0.89,0.001,522,482,2,100,0.01,1004,6
0.886,0.001,565,539,2,100,0.01,1104,6
0.888,0.001,616,588,2,100,0.01,1204,6
0.89,0.001,670,634,2,100,0.01,1304,6
0.904,0.001,722,682,2,100,0.01,1404,6
0.924,0.001,777,727,2,100,0.01,1504,6
0.936,0.001,824,780,2,100,0.01,1604,6
0.93,0.001,876,828,2,100,0.01,1704,6
0.944,0.001,916,888,2,100,0.01,1804,6
0.942,0.001,963,941,2,100,0.01,1904,6
0.954,0.001,1008,996,2,100,0.01,2004,6
0.576,0.001,51,53,2,100,0.01,104,7
0.62,0.001,102,102,2,100,0.01,204,7
0.628,0.001,146,158,2,100,0.01,304,7
0.73,0.001,189,215,2,100,0.01,404,7
0.676,0.001,236,268,2,100,0.01,504,7
0.792,0.001,279,325,2,100,0.01,604,7
0.85,0.001,337,367,2,100,0.01,704,7
0.854,0.001,391,413,2,100,0.01,804,7
0.888,0.001,440,464,2,100,0.01,904,7
0.878,0.001,498,506,2,100,0.01,1004,7
0.86,0.001,551,553,2,100,0.01,1104,7
0.896,0.001,601,603,2,100,0.01,1204,7
0.908,0.001,656,648,2,100,0.01,1304,7
0.922,0.001,701,703,2,100,0.01,1404,7
0.926,0.001,748,756,2,100,0.01,1504,7
0.942,0.001,799,805,2,100,0.01,1604,7
0.948,0.001,847,857,2,100,0.01,1704,7
0.948,0.001,890,914,2,100,0.01,1804,7
0.948,0.001,940,964,2,100,0.01,1904,7
0.954,0.001,993,1011,2,100,0.01,2004,7
0.54,0.001,52,52,2,100,0.01,104,8
0.628,0.001,100,104,2,100,0.01,204,8
0.55,0.001,148,156,2,100,0.01,304,8
0.614,0.001,203,201,2,100,0.01,404,8
0.762,0.001,249,255,2,100,0.01,504,8
0.812,0.001,302,302,2,100,0.01,604,8
0.78,0.001,349,355,2,100,0.01,704,8
0.85,0.001,400,404,2,100,0.01,804,8
0.87,0.001,450,454,2,100,0.01,904,8
0.91,0.001,500,504,2,100,0.01,1004,8
0.926,0.001,554,550,2,100,0.01,1104,8
0.942,0.001,602,602,2,100,0.01,1204,8
0.952,0.001,657,647,2,100,0.01,1304,8
0.96,0.001,707,697,2,100,0.01,1404,8
0.956,0.001,759,745,2,100,0.01,1504,8
0.96,0.001,817,787,2,100,0.01,1604,8
0.964,0.001,870,834,2,100,0.01,1704,8
0.962,0.001,919,885,2,100,0.01,1804,8
0.964,0.001,968,936,2,100,0.01,1904,8
0.966,0.001,1015,989,2,100,0.01,2004,8
0.5,0.001,52,52,2,100,0.01,104,9
0.53,0.001,96,108,2,100,0.01,204,9
0.51,0.001,143,161,2,100,0.01,304,9
0.556,0.001,182,222,2,100,0.01,404,9
0.61,0.001,236,268,2,100,0.01,504,9
0.706,0.001,292,312,2,100,0.01,604,9
0.716,0.001,343,361,2,100,0.01,704,9
0.762,0.001,394,410,2,100,0.01,804,9
0.858,0.001,444,460,2,100,0.01,904,9
0.876,0.001,494,510,2,100,0.01,1004,9
0.906,0.001,535,569,2,100,0.01,1104,9
0.9,0.001,589,615,2,100,0.01,1204,9
0.888,0.001,639,665,2,100,0.01,1304,9
0.908,0.001,694,710,2,100,0.01,1404,9
0.916,0.001,744,760,2,100,0.01,1504,9
0.922,0.001,789,815,2,100,0.01,1604,9
0.928,0.001,844,860,2,100,0.01,1704,9
0.926,0.001,907,897,2,100,0.01,1804,9
0.928,0.001,951,953,2,100,0.01,1904,9
0.934,0.001,998,1006,2,100,0.01,2004,9
0.698,0.001,46,58,2,100,0.01,104,10
0.684,0.001,97,107,2,100,0.01,204,10
0.696,0.001,155,149,2,100,0.01,304,10
0.786,0.001,209,195,2,100,0.01,404,10
0.808,0.001,246,258,2,100,0.01,504,10
0.802,0.001,296,308,2,100,0.01,604,10
0.82,0.001,350,354,2,100,0.01,704,10
0.834,0.001,405,399,2,100,0.01,804,10
0.854,0.001,455,449,2,100,0.01,904,10
0.878,0.001,508,496,2,100,0.01,1004,10
0.884,0.001,562,542,2,100,0.01,1104,10
0.886,0.001,608,596,2,100,0.01,1204,10
0.898,0.001,657,647,2,100,0.01,1304,10
0.906,0.001,707,697,2,100,0.01,1404,10
0.914,0.001,761,743,2,100,0.01,1504,10
0.916,0.001,811,793,2,100,0.01,1604,10
0.922,0.001,869,835,2,100,0.01,1704,10
0.944,0.001,913,891,2,100,0.01,1804,10
0.948,0.001,967,937,2,100,0.01,1904,10
0.946,0.001,1021,983,2,100,0.01,2004,10
0.456,0.001,50,54,2,100,0.01,104,11
0.594,0.001,105,99,2,100,0.01,204,11
0.57,0.001,163,141,2,100,0.01,304,11
0.584,0.001,214,190,2,100,0.01,404,11
0.588,0.001,261,243,2,100,0.01,504,11
0.596,0.001,315,289,2,100,0.01,604,11
0.65,0.001,362,342,2,100,0.01,704,11
0.678,0.001,418,386,2,100,0.01,804,11
0.676,0.001,473,431,2,100,0.01,904,11
0.736,0.001,523,481,2,100,0.01,1004,11
0.778,0.001,564,540,2,100,0.01,1104,11
0.786,0.001,621,583,2,100,0.01,1204,11
0.834,0.001,671,633,2,100,0.01,1304,11
0.86,0.001,726,678,2,100,0.01,1404,11
0.864,0.001,777,727,2,100,0.01,1504,11
0.892,0.001,830,774,2,100,0.01,1604,11
0.906,0.001,876,828,2,100,0.01,1704,11
0.916,0.001,921,883,2,100,0.01,1804,11
0.922,0.001,971,933,2,100,0.01,1904,11
0.936,0.001,1020,984,2,100,0.01,2004,11
0.594,0.001,48,56,2,100,0.01,104,12
0.52,0.001,103,101,2,100,0.01,204,12
0.538,0.001,151,153,2,100,0.01,304,12
0.658,0.001,190,214,2,100,0.01,404,12
0.732,0.001,235,269,2,100,0.01,504,12
0.736,0.001,281,323,2,100,0.01,604,12
0.75,0.001,334,370,2,100,0.01,704,12
0.78,0.001,377,427,2,100,0.01,804,12
0.812,0.001,437,467,2,100,0.01,904,12
0.828,0.001,485,519,2,100,0.01,1004,12
0.82,0.001,532,572,2,100,0.01,1104,12
0.862,0.001,588,616,2,100,0.01,1204,12
0.882,0.001,633,671,2,100,0.01,1304,12
0.906,0.001,688,716,2,100,0.01,1404,12
0.906,0.001,741,763,2,100,0.01,1504,12
0.916,0.001,786,818,2,100,0.01,1604,12
0.928,0.001,838,866,2,100,0.01,1704,12
0.946,0.001,885,919,2,100,0.01,1804,12
0.94,0.001,935,969,2,100,0.01,1904,12
0.952,0.001,996,1008,2,100,0.01,2004,12
0.5,0.001,52,52,2,100,0.01,104,13
0.708,0.001,99,105,2,100,0.01,204,13
0.678,0.001,144,160,2,100,0.01,304,13
0.71,0.001,190,214,2,100,0.01,404,13
0.732,0.001,247,257,2,100,0.01,504,13
0.808,0.001,304,300,2,100,0.01,604,13
0.834,0.001,359,345,2,100,0.01,704,13
0.862,0.001,404,400,2,100,0.01,804,13
0.874,0.001,455,449,2,100,0.01,904,13
0.896,0.001,504,500,2,100,0.01,1004,13
0.904,0.001,556,548,2,100,0.01,1104,13
0.93,0.001,608,596,2,100,0.01,1204,13
0.948,0.001,660,644,2,100,0.01,1304,13
0.942,0.001,715,689,2,100,0.01,1404,13
0.94,0.001,770,734,2,100,0.01,1504,13
0.946,0.001,820,784,2,100,0.01,1604,13
0.95,0.001,870,834,2,100,0.01,1704,13
0.958,0.001,916,888,2,100,0.01,1804,13
0.964,0.001,963,941,2,100,0.01,1904,13
0.964,0.001,1013,991,2,100,0.01,2004,13
0.432,0.001,56,48,2,100,0.01,104,14
0.568,0.001,98,106,2,100,0.01,204,14
0.582,0.001,156,148,2,100,0.01,304,14
0.68,0.001,205,199,2,100,0.01,404,14
0.68,0.001,257,247,2,100,0.01,504,14
0.73,0.001,312,292,2,100,0.01,604,14
0.74,0.001,366,338,2,100,0.01,704,14
0.754,0.001,414,390,2,100,0.01,804,14
0.776,0.001,457,447,2,100,0.01,904,14
0.814,0.001,511,493,2,100,0.01,1004,14
0.836,0.001,557,547,2,100,0.01,1104,14
0.874,0.001,609,595,2,100,0.01,1204,14
0.872,0.001,644,660,2,100,0.01,1304,14
0.898,0.001,701,703,2,100,0.01,1404,14
0.902,0.001,754,750,2,100,0.01,1504,14
0.912,0.001,801,803,2,100,0.01,1604,14
0.912,0.001,856,848,2,100,0.01,1704,14
0.928,0.001,909,895,2,100,0.01,1804,14
0.932,0.001,956,948,2,100,0.01,1904,14
0.926,0.001,1006,998,2,100,0.01,2004,14
0.666,0.001,47,57,2,100,0.01,104,15
0.66,0.001,99,105,2,100,0.01,204,15
0.658,0.001,147,157,2,100,0.01,304,15
0.69,0.001,201,203,2,100,0.01,404,15
0.73,0.001,258,246,2,100,0.01,504,15
0.824,0.001,306,298,2,100,0.01,604,15
0.838,0.001,356,348,2,100,0.01,704,15
0.822,0.001,403,401,2,100,0.01,804,15
0.83,0.001,450,454,2,100,0.01,904,15
0.86,0.001,502,502,2,100,0.01,1004,15
0.868,0.001,552,552,2,100,0.01,1104,15
0.9,0.001,608,596,2,100,0.01,1204,15
0.91,0.001,659,645,2,100,0.01,1304,15
0.92,0.001,711,693,2,100,0.01,1404,15
0.92,0.001,760,744,2,100,0.01,1504,15
0.928,0.001,811,793,2,100,0.01,1604,15
0.936,0.001,853,851,2,100,0.01,1704,15
0.936,0.001,903,901,2,100,0.01,1804,15
0.94,0.001,950,954,2,100,0.01,1904,15
0.948,0.001,1006,998,2,100,0.01,2004,15
0.528,0.001,52,52,2,100,0.01,104,16
0.634,0.001,102,102,2,100,0.01,204,16
0.656,0.001,158,146,2,100,0.01,304,16
0.636,0.001,206,198,2,100,0.01,404,16
0.634,0.001,252,252,2,100,0.01,504,16
0.74,0.001,299,305,2,100,0.01,604,16
0.766,0.001,348,356,2,100,0.01,704,16
0.782,0.001,402,402,2,100,0.01,804,16
0.816,0.001,453,451,2,100,0.01,904,16
0.842,0.001,500,504,2,100,0.01,1004,16
0.844,0.001,550,554,2,100,0.01,1104,16
0.864,0.001,591,613,2,100,0.01,1204,16
0.896,0.001,644,660,2,100,0.01,1304,16
0.892,0.001,692,712,2,100,0.01,1404,16
0.894,0.001,736,768,2,100,0.01,1504,16
0.9,0.001,784,820,2,100,0.01,1604,16
0.922,0.001,837,867,2,100,0.01,1704,16
0.918,0.001,888,916,2,100,0.01,1804,16
0.93,0.001,943,961,2,100,0.01,1904,16
0.942,0.001,985,1019,2,100,0.01,2004,16
0.496,0.001,53,51,2,100,0.01,104,17
0.628,0.001,107,97,2,100,0.01,204,17
0.632,0.001,160,144,2,100,0.01,304,17
0.712,0.001,223,181,2,100,0.01,404,17
0.816,0.001,268,236,2,100,0.01,504,17
0.74,0.001,317,287,2,100,0.01,604,17
0.658,0.001,362,342,2,100,0.01,704,17
0.884,0.001,415,389,2,100,0.01,804,17
0.89,0.001,468,436,2,100,0.01,904,17
0.892,0.001,520,484,2,100,0.01,1004,17
0.9,0.001,567,537,2,100,0.01,1104,17
0.908,0.001,607,597,2,100,0.01,1204,17
0.908,0.001,663,641,2,100,0.01,1304,17
0.928,0.001,708,696,2,100,0.01,1404,17
0.934,0.001,755,749,2,100,0.01,1504,17
0.928,0.001,809,795,2,100,0.01,1604,17
0.938,0.001,856,848,2,100,0.01,1704,17
0.938,0.001,910,894,2,100,0.01,1804,17
0.942,0.001,950,954,2,100,0.01,1904,17
0.946,0.001,995,1009,2,100,0.01,2004,17
0.472,0.001,52,52,2,100,0.01,104,18
0.656,0.001,105,99,2,100,0.01,204,18
0.688,0.001,153,151,2,100,0.01,304,18
0.716,0.001,207,197,2,100,0.01,404,18
0.704,0.001,259,245,2,100,0.01,504,18
0.73,0.001,314,290,2,100,0.01,604,18
0.76,0.001,359,345,2,100,0.01,704,18
0.784,0.001,405,399,2,100,0.01,804,18
0.806,0.001,451,453,2,100,0.01,904,18
0.838,0.001,498,506,2,100,0.01,1004,18
0.868,0.001,547,557,2,100,0.01,1104,18
0.894,0.001,598,606,2,100,0.01,1204,18
0.898,0.001,643,661,2,100,0.01,1304,18
0.914,0.001,707,697,2,100,0.01,1404,18
0.916,0.001,756,748,2,100,0.01,1504,18
0.942,0.001,812,792,2,100,0.01,1604,18
0.94,0.001,858,846,2,100,0.01,1704,18
0.946,0.001,914,890,2,100,0.01,1804,18
0.94,0.001,966,938,2,100,0.01,1904,18
0.946,0.001,1016,988,2,100,0.01,2004,18
0.552,0.001,54,50,2,100,0.01,104,19
0.61,0.001,106,98,2,100,0.01,204,19
0.62,0.001,170,134,2,100,0.01,304,19
0.742,0.001,215,189,2,100,0.01,404,19
0.726,0.001,259,245,2,100,0.01,504,19
0.736,0.001,309,295,2,100,0.01,604,19
0.75,0.001,362,342,2,100,0.01,704,19
0.782,0.001,412,392,2,100,0.01,804,19
0.826,0.001,466,438,2,100,0.01,904,19
0.884,0.001,518,486,2,100,0.01,1004,19
0.922,0.001,569,535,2,100,0.01,1104,19
0.914,0.001,624,580,2,100,0.01,1204,19
0.928,0.001,672,632,2,100,0.01,1304,19
0.93,0.001,720,684,2,100,0.01,1404,19
0.936,0.001,773,731,2,100,0.01,1504,19
0.936,0.001,817,787,2,100,0.01,1604,19
0.938,0.001,867,837,2,100,0.01,1704,19
0.942,0.001,911,893,2,100,0.01,1804,19
0.944,0.001,957,947,2,100,0.01,1904,19
0.95,0.001,1009,995,2,100,0.01,2004,19
0.572,0.001,55,49,2,100,0.01,104,20
0.688,0.001,96,108,2,100,0.01,204,20
0.738,0.001,147,157,2,100,0.01,304,20
0.748,0.001,190,214,2,100,0.01,404,20
0.788,0.001,249,255,2,100,0.01,504,20
0.804,0.001,299,305,2,100,0.01,604,20
0.826,0.001,359,345,2,100,0.01,704,20
0.862,0.001,411,393,2,100,0.01,804,20
0.886,0.001,457,447,2,100,0.01,904,20
0.902,0.001,504,500,2,100,0.01,1004,20
0.936,0.001,552,552,2,100,0.01,1104,20
0.918,0.001,597,607,2,100,0.01,1204,20
0.902,0.001,663,641,2,100,0.01,1304,20
0.922,0.001,712,692,2,100,0.01,1404,20
0.926,0.001,764,740,2,100,0.01,1504,20
0.946,0.001,818,786,2,100,0.01,1604,20
0.95,0.001,867,837,2,100,0.01,1704,20
0.95,0.001,914,890,2,100,0.01,1804,20
0.952,0.001,962,942,2,100,0.01,1904,20
0.96,0.001,1006,998,2,100,0.01,2004,20
0.468,1e-05,52,52,10,2,0.0001,104,1
0.468,1e-05,105,99,10,2,0.0001,204,1
0.468,1e-05,152,152,10,2,0.0001,304,1
0.468,1e-05,204,200,10,2,0.0001,404,1
0.468,1e-05,255,249,10,2,0.0001,504,1
0.47,1e-05,304,300,10,2,0.0001,604,1
0.47,1e-05,345,359,10,2,0.0001,704,1
0.47,1e-05,392,412,10,2,0.0001,804,1
0.47,1e-05,441,463,10,2,0.0001,904,1
0.472,1e-05,490,514,10,2,0.0001,1004,1
0.472,1e-05,543,561,10,2,0.0001,1104,1
0.472,1e-05,591,613,10,2,0.0001,1204,1
0.472,1e-05,635,669,10,2,0.0001,1304,1
0.474,1e-05,684,720,10,2,0.0001,1404,1
0.474,1e-05,742,762,10,2,0.0001,1504,1
0.472,1e-05,784,820,10,2,0.0001,1604,1
0.474,1e-05,833,871,10,2,0.0001,1704,1
0.474,1e-05,878,926,10,2,0.0001,1804,1
0.474,1e-05,934,970,10,2,0.0001,1904,1
0.472,1e-05,983,1021,10,2,0.0001,2004,1
0.516,1e-05,53,51,10,2,0.0001,104,2
0.516,1e-05,107,97,10,2,0.0001,204,2
0.516,1e-05,155,149,10,2,0.0001,304,2
0.516,1e-05,202,202,10,2,0.0001,404,2
0.516,1e-05,250,254,10,2,0.0001,504,2
0.516,1e-05,298,306,10,2,0.0001,604,2
0.516,1e-05,346,358,10,2,0.0001,704,2
0.518,1e-05,403,401,10,2,0.0001,804,2
0.516,1e-05,452,452,10,2,0.0001,904,2
0.516,1e-05,497,507,10,2,0.0001,1004,2
0.516,1e-05,548,556,10,2,0.0001,1104,2
0.516,1e-05,594,610,10,2,0.0001,1204,2
0.518,1e-05,645,659,10,2,0.0001,1304,2
0.518,1e-05,699,705,10,2,0.0001,1404,2
0.518,1e-05,746,758,10,2,0.0001,1504,2
0.518,1e-05,792,812,10,2,0.0001,1604,2
0.518,1e-05,853,851,10,2,0.0001,1704,2
0.52,1e-05,906,898,10,2,0.0001,1804,2
0.52,1e-05,954,950,10,2,0.0001,1904,2
0.522,1e-05,1009,995,10,2,0.0001,2004,2
0.49,1e-05,55,49,10,2,0.0001,104,3
0.49,1e-05,102,102,10,2,0.0001,204,3
0.49,1e-05,151,153,10,2,0.0001,304,3
0.49,1e-05,198,206,10,2,0.0001,404,3
0.49,1e-05,253,251,10,2,0.0001,504,3
0.49,1e-05,299,305,10,2,0.0001,604,3
0.49,1e-05,348,356,10,2,0.0001,704,3
0.49,1e-05,405,399,10,2,0.0001,804,3
0.49,1e-05,462,442,10,2,0.0001,904,3
0.49,1e-05,504,500,10,2,0.0001,1004,3
0.49,1e-05,551,553,10,2,0.0001,1104,3
0.49,1e-05,597,607,10,2,0.0001,1204,3
0.49,1e-05,649,655,10,2,0.0001,1304,3
0.49,1e-05,699,705,10,2,0.0001,1404,3
0.49,1e-05,751,753,10,2,0.0001,1504,3
0.49,1e-05,803,801,10,2,0.0001,1604,3
0.49,1e-05,851,853,10,2,0.0001,1704,3
0.49,1e-05,899,905,10,2,0.0001,1804,3
0.49,1e-05,944,960,10,2,0.0001,1904,3
0.49,1e-05,997,1007,10,2,0.0001,2004,3
0.51,1e-05,53,51,10,2,0.0001,104,4
0.51,1e-05,107,97,10,2,0.0001,204,4
0.51,1e-05,160,144,10,2,0.0001,304,4
0.51,1e-05,206,198,10,2,0.0001,404,4
0.51,1e-05,261,243,10,2,0.0001,504,4
0.512,1e-05,309,295,10,2,0.0001,604,4
0.512,1e-05,360,344,10,2,0.0001,704,4
0.514,1e-05,402,402,10,2,0.0001,804,4
0.514,1e-05,448,456,10,2,0.0001,904,4
0.514,1e-05,499,505,10,2,0.0001,1004,4
0.514,1e-05,554,550,10,2,0.0001,1104,4
0.516,1e-05,614,590,10,2,0.0001,1204,4
0.516,1e-05,661,643,10,2,0.0001,1304,4
0.516,1e-05,715,689,10,2,0.0001,1404,4
0.516,1e-05,761,743,10,2,0.0001,1504,4
0.516,1e-05,808,796,10,2,0.0001,1604,4
0.516,1e-05,863,841,10,2,0.0001,1704,4
0.516,1e-05,911,893,10,2,0.0001,1804,4
0.516,1e-05,954,950,10,2,0.0001,1904,4
0.516,1e-05,1007,997,10,2,0.0001,2004,4
0.478,1e-05,49,55,10,2,0.0001,104,5
0.478,1e-05,106,98,10,2,0.0001,204,5
0.478,1e-05,155,149,10,2,0.0001,304,5
0.478,1e-05,204,200,10,2,0.0001,404,5
0.478,1e-05,254,250,10,2,0.0001,504,5
0.478,1e-05,306,298,10,2,0.0001,604,5
0.478,1e-05,355,349,10,2,0.0001,704,5
0.478,1e-05,410,394,10,2,0.0001,804,5
0.48,1e-05,455,449,10,2,0.0001,904,5
0.48,1e-05,506,498,10,2,0.0001,1004,5
0.48,1e-05,559,545,10,2,0.0001,1104,5
0.478,1e-05,615,589,10,2,0.0001,1204,5
0.478,1e-05,668,636,10,2,0.0001,1304,5
0.48,1e-05,721,683,10,2,0.0001,1404,5
0.48,1e-05,762,742,10,2,0.0001,1504,5
0.48,1e-05,817,787,10,2,0.0001,1604,5
0.484,1e-05,856,848,10,2,0.0001,1704,5
0.486,1e-05,902,902,10,2,0.0001,1804,5
0.486,1e-05,951,953,10,2,0.0001,1904,5
0.486,1e-05,1002,1002,10,2,0.0001,2004,5
0.52,1e-05,48,56,10,2,0.0001,104,6
0.52,1e-05,96,108,10,2,0.0001,204,6
0.52,1e-05,147,157,10,2,0.0001,304,6
0.52,1e-05,194,210,10,2,0.0001,404,6
0.52,1e-05,243,261,10,2,0.0001,504,6
0.52,1e-05,289,315,10,2,0.0001,604,6
0.52,1e-05,336,368,10,2,0.0001,704,6
0.52,1e-05,387,417,10,2,0.0001,804,6
0.52,1e-05,438,466,10,2,0.0001,904,6
0.52,1e-05,489,515,10,2,0.0001,1004,6
0.52,1e-05,541,563,10,2,0.0001,1104,6
0.52,1e-05,594,610,10,2,0.0001,1204,6
0.518,1e-05,651,653,10,2,0.0001,1304,6
0.518,1e-05,706,698,10,2,0.0001,1404,6
0.518,1e-05,757,747,10,2,0.0001,1504,6
0.518,1e-05,809,795,10,2,0.0001,1604,6
0.518,1e-05,859,845,10,2,0.0001,1704,6
0.518,1e-05,906,898,10,2,0.0001,1804,6
0.52,1e-05,946,958,10,2,0.0001,1904,6
0.522,1e-05,1004,1000,10,2,0.0001,2004,6
0.472,1e-05,62,42,10,2,0.0001,104,7
0.472,1e-05,103,101,10,2,0.0001,204,7
0.472,1e-05,159,145,10,2,0.0001,304,7
0.472,1e-05,205,199,10,2,0.0001,404,7
0.472,1e-05,245,259,10,2,0.0001,504,7
0.472,1e-05,297,307,10,2,0.0001,604,7
0.472,1e-05,347,357,10,2,0.0001,704,7
0.472,1e-05,394,410,10,2,0.0001,804,7
0.472,1e-05,450,454,10,2,0.0001,904,7
0.472,1e-05,503,501,10,2,0.0001,1004,7
0.472,1e-05,550,554,10,2,0.0001,1104,7
0.472,1e-05,599,605,10,2,0.0001,1204,7
0.472,1e-05,648,656,10,2,0.0001,1304,7
0.472,1e-05,701,703,10,2,0.0001,1404,7
0.472,1e-05,749,755,10,2,0.0001,1504,7
0.472,1e-05,792,812,10,2,0.0001,1604,7
0.472,1e-05,841,863,10,2,0.0001,1704,7
0.472,1e-05,887,917,10,2,0.0001,1804,7
0.472,1e-05,938,966,10,2,0.0001,1904,7
0.472,1e-05,986,1018,10,2,0.0001,2004,7
0.534,1e-05,53,51,10,2,0.0001,104,8
0.534,1e-05,101,103,10,2,0.0001,204,8
0.534,1e-05,147,157,10,2,0.0001,304,8
0.534,1e-05,193,211,10,2,0.0001,404,8
0.534,1e-05,243,261,10,2,0.0001,504,8
0.534,1e-05,299,305,10,2,0.0001,604,8
0.536,1e-05,353,351,10,2,0.0001,704,8
0.536,1e-05,397,407,10,2,0.0001,804,8
0.534,1e-05,447,457,10,2,0.0001,904,8
0.534,1e-05,494,510,10,2,0.0001,1004,8
0.534,1e-05,546,558,10,2,0.0001,1104,8
0.534,1e-05,597,607,10,2,0.0001,1204,8
0.534,1e-05,638,666,10,2,0.0001,1304,8
0.534,1e-05,689,715,10,2,0.0001,1404,8
0.534,1e-05,740,764,10,2,0.0001,1504,8
0.534,1e-05,794,810,10,2,0.0001,1604,8
0.532,1e-05,845,859,10,2,0.0001,1704,8
0.532,1e-05,897,907,10,2,0.0001,1804,8
0.532,1e-05,943,961,10,2,0.0001,1904,8
0.532,1e-05,996,1008,10,2,0.0001,2004,8
0.532,1e-05,57,47,10,2,0.0001,104,9
0.532,1e-05,110,94,10,2,0.0001,204,9
0.532,1e-05,165,139,10,2,0.0001,304,9
0.534,1e-05,221,183,10,2,0.0001,404,9
0.534,1e-05,278,226,10,2,0.0001,504,9
0.534,1e-05,330,274,10,2,0.0001,604,9
0.534,1e-05,373,331,10,2,0.0001,704,9
0.534,1e-05,426,378,10,2,0.0001,804,9
0.534,1e-05,467,437,10,2,0.0001,904,9
0.536,1e-05,522,482,10,2,0.0001,1004,9
0.536,1e-05,562,542,10,2,0.0001,1104,9
0.536,1e-05,607,597,10,2,0.0001,1204,9
0.536,1e-05,653,651,10,2,0.0001,1304,9
0.534,1e-05,706,698,10,2,0.0001,1404,9
0.534,1e-05,759,745,10,2,0.0001,1504,9
0.534,1e-05,814,790,10,2,0.0001,1604,9
0.532,1e-05,866,838,10,2,0.0001,1704,9
0.532,1e-05,911,893,10,2,0.0001,1804,9
0.534,1e-05,963,941,10,2,0.0001,1904,9
0.536,1e-05,1013,991,10,2,0.0001,2004,9
0.462,1e-05,55,49,10,2,0.0001,104,10
0.462,1e-05,105,99,10,2,0.0001,204,10
0.462,1e-05,154,150,10,2,0.0001,304,10
0.462,1e-05,205,199,10,2,0.0001,404,10
0.462,1e-05,256,248,10,2,0.0001,504,10
0.462,1e-05,305,299,10,2,0.0001,604,10
0.462,1e-05,355,349,10,2,0.0001,704,10
0.462,1e-05,402,402,10,2,0.0001,804,10
0.462,1e-05,443,461,10,2,0.0001,904,10
0.462,1e-05,489,515,10,2,0.0001,1004,10
0.462,1e-05,546,558,10,2,0.0001,1104,10
0.462,1e-05,597,607,10,2,0.0001,1204,10
0.462,1e-05,648,656,10,2,0.0001,1304,10
0.462,1e-05,698,706,10,2,0.0001,1404,10
0.462,1e-05,756,748,10,2,0.0001,1504,10
0.462,1e-05,802,802,10,2,0.0001,1604,10
0.462,1e-05,846,858,10,2,0.0001,1704,10
0.462,1e-05,895,909,10,2,0.0001,1804,10
0.462,1e-05,939,965,10,2,0.0001,1904,10
0.462,1e-05,983,1021,10,2,0.0001,2004,10
0.486,1e-05,51,53,10,2,0.0001,104,11
0.486,1e-05,95,109,10,2,0.0001,204,11
0.486,1e-05,143,161,10,2,0.0001,304,11
0.486,1e-05,189,215,10,2,0.0001,404,11
0.486,1e-05,244,260,10,2,0.0001,504,11
0.486,1e-05,295,309,10,2,0.0001,604,11
0.486,1e-05,332,372,10,2,0.0001,704,11
0.486,1e-05,387,417,10,2,0.0001,804,11
0.486,1e-05,437,467,10,2,0.0001,904,11
0.486,1e-05,486,518,10,2,0.0001,1004,11
0.486,1e-05,532,572,10,2,0.0001,1104,11
0.486,1e-05,588,616,10,2,0.0001,1204,11
0.486,1e-05,632,672,10,2,0.0001,1304,11
0.486,1e-05,681,723,10,2,0.0001,1404,11
0.486,1e-05,736,768,10,2,0.0001,1504,11
0.486,1e-05,792,812,10,2,0.0001,1604,11
0.486,1e-05,845,859,10,2,0.0001,1704,11
0.486,1e-05,901,903,10,2,0.0001,1804,11
0.486,1e-05,956,948,10,2,0.0001,1904,11
0.486,1e-05,1009,995,10,2,0.0001,2004,11
0.452,1e-05,52,52,10,2,0.0001,104,12
0.452,1e-05,99,105,10,2,0.0001,204,12
0.452,1e-05,146,158,10,2,0.0001,304,12
0.452,1e-05,186,218,10,2,0.0001,404,12
0.454,1e-05,245,259,10,2,0.0001,504,12
0.454,1e-05,305,299,10,2,0.0001,604,12
0.454,1e-05,363,341,10,2,0.0001,704,12
0.454,1e-05,420,384,10,2,0.0001,804,12
0.456,1e-05,469,435,10,2,0.0001,904,12
0.456,1e-05,523,481,10,2,0.0001,1004,12
0.456,1e-05,571,533,10,2,0.0001,1104,12
0.456,1e-05,616,588,10,2,0.0001,1204,12
0.456,1e-05,663,641,10,2,0.0001,1304,12
0.458,1e-05,716,688,10,2,0.0001,1404,12
0.456,1e-05,767,737,10,2,0.0001,1504,12
0.456,1e-05,809,795,10,2,0.0001,1604,12
0.458,1e-05,868,836,10,2,0.0001,1704,12
0.462,1e-05,924,880,10,2,0.0001,1804,12
0.462,1e-05,970,934,10,2,0.0001,1904,12
0.462,1e-05,1016,988,10,2,0.0001,2004,12
0.47,1e-05,49,55,10,2,0.0001,104,13
0.47,1e-05,99,105,10,2,0.0001,204,13
0.47,1e-05,151,153,10,2,0.0001,304,13
0.468,1e-05,203,201,10,2,0.0001,404,13
0.47,1e-05,254,250,10,2,0.0001,504,13
0.47,1e-05,304,300,10,2,0.0001,604,13
0.47,1e-05,349,355,10,2,0.0001,704,13
0.47,1e-05,403,401,10,2,0.0001,804,13
0.47,1e-05,454,450,10,2,0.0001,904,13
0.47,1e-05,507,497,10,2,0.0001,1004,13
0.468,1e-05,556,548,10,2,0.0001,1104,13
0.472,1e-05,604,600,10,2,0.0001,1204,13
0.472,1e-05,647,657,10,2,0.0001,1304,13
0.472,1e-05,704,700,10,2,0.0001,1404,13
0.472,1e-05,755,749,10,2,0.0001,1504,13
0.472,1e-05,799,805,10,2,0.0001,1604,13
0.472,1e-05,847,857,10,2,0.0001,1704,13
0.472,1e-05,892,912,10,2,0.0001,1804,13
0.472,1e-05,948,956,10,2,0.0001,1904,13
0.472,1e-05,998,1006,10,2,0.0001,2004,13
0.464,1e-05,52,52,10,2,0.0001,104,14
0.464,1e-05,103,101,10,2,0.0001,204,14
0.464,1e-05,156,148,10,2,0.0001,304,14
0.464,1e-05,206,198,10,2,0.0001,404,14
0.464,1e-05,257,247,10,2,0.0001,504,14
0.464,1e-05,306,298,10,2,0.0001,604,14
0.464,1e-05,356,348,10,2,0.0001,704,14
0.464,1e-05,400,404,10,2,0.0001,804,14
0.464,1e-05,446,458,10,2,0.0001,904,14
0.464,1e-05,495,509,10,2,0.0001,1004,14
0.464,1e-05,544,560,10,2,0.0001,1104,14
0.464,1e-05,589,615,10,2,0.0001,1204,14
0.464,1e-05,635,669,10,2,0.0001,1304,14
0.464,1e-05,683,721,10,2,0.0001,1404,14
0.462,1e-05,737,767,10,2,0.0001,1504,14
0.462,1e-05,787,817,10,2,0.0001,1604,14
0.462,1e-05,837,867,10,2,0.0001,1704,14
0.462,1e-05,890,914,10,2,0.0001,1804,14
0.464,1e-05,947,957,10,2,0.0001,1904,14
0.464,1e-05,994,1010,10,2,0.0001,2004,14
0.504,1e-05,57,47,10,2,0.0001,104,15
0.504,1e-05,102,102,10,2,0.0001,204,15
0.504,1e-05,155,149,10,2,0.0001,304,15
0.504,1e-05,210,194,10,2,0.0001,404,15
0.504,1e-05,263,241,10,2,0.0001,504,15
0.504,1e-05,313,291,10,2,0.0001,604,15
0.504,1e-05,371,333,10,2,0.0001,704,15
0.504,1e-05,418,386,10,2,0.0001,804,15
0.504,1e-05,466,438,10,2,0.0001,904,15
0.506,1e-05,513,491,10,2,0.0001,1004,15
0.506,1e-05,560,544,10,2,0.0001,1104,15
0.506,1e-05,611,593,10,2,0.0001,1204,15
0.508,1e-05,664,640,10,2,0.0001,1304,15
0.508,1e-05,712,692,10,2,0.0001,1404,15
0.508,1e-05,758,746,10,2,0.0001,1504,15
0.508,1e-05,803,801,10,2,0.0001,1604,15
0.508,1e-05,851,853,10,2,0.0001,1704,15
0.508,1e-05,899,905,10,2,0.0001,1804,15
0.508,1e-05,947,957,10,2,0.0001,1904,15
0.508,1e-05,998,1006,10,2,0.0001,2004,15
0.488,1e-05,58,46,10,2,0.0001,104,16
0.488,1e-05,110,94,10,2,0.0001,204,16
0.488,1e-05,166,138,10,2,0.0001,304,16
0.488,1e-05,213,191,10,2,0.0001,404,16
0.488,1e-05,254,250,10,2,0.0001,504,16
0.488,1e-05,313,291,10,2,0.0001,604,16
0.488,1e-05,359,345,10,2,0.0001,704,16
0.488,1e-05,401,403,10,2,0.0001,804,16
0.488,1e-05,449,455,10,2,0.0001,904,16
0.488,1e-05,495,509,10,2,0.0001,1004,16
0.488,1e-05,540,564,10,2,0.0001,1104,16
0.488,1e-05,586,618,10,2,0.0001,1204,16
0.488,1e-05,638,666,10,2,0.0001,1304,16
0.488,1e-05,692,712,10,2,0.0001,1404,16
0.488,1e-05,741,763,10,2,0.0001,1504,16
0.488,1e-05,792,812,10,2,0.0001,1604,16
0.488,1e-05,848,856,10,2,0.0001,1704,16
0.488,1e-05,901,903,10,2,0.0001,1804,16
0.488,1e-05,953,951,10,2,0.0001,1904,16
0.488,1e-05,1008,996,10,2,0.0001,2004,16
0.502,1e-05,49,55,10,2,0.0001,104,17
0.502,1e-05,103,101,10,2,0.0001,204,17
0.502,1e-05,156,148,10,2,0.0001,304,17
0.502,1e-05,211,193,10,2,0.0001,404,17
0.502,1e-05,261,243,10,2,0.0001,504,17
0.5,1e-05,312,292,10,2,0.0001,604,17
0.5,1e-05,347,357,10,2,0.0001,704,17
0.504,1e-05,402,402,10,2,0.0001,804,17
0.504,1e-05,445,459,10,2,0.0001,904,17
0.504,1e-05,505,499,10,2,0.0001,1004,17
0.502,1e-05,552,552,10,2,0.0001,1104,17
0.502,1e-05,610,594,10,2,0.0001,1204,17
0.502,1e-05,654,650,10,2,0.0001,1304,17
0.502,1e-05,705,699,10,2,0.0001,1404,17
0.5,1e-05,754,750,10,2,0.0001,1504,17
0.496,1e-05,800,804,10,2,0.0001,1604,17
0.496,1e-05,847,857,10,2,0.0001,1704,17
0.496,1e-05,899,905,10,2,0.0001,1804,17
0.498,1e-05,955,949,10,2,0.0001,1904,17
0.496,1e-05,1012,992,10,2,0.0001,2004,17
0.554,1e-05,52,52,10,2,0.0001,104,18
0.554,1e-05,101,103,10,2,0.0001,204,18
0.554,1e-05,148,156,10,2,0.0001,304,18
0.554,1e-05,190,214,10,2,0.0001,404,18
0.556,1e-05,239,265,10,2,0.0001,504,18
0.556,1e-05,292,312,10,2,0.0001,604,18
0.556,1e-05,338,366,10,2,0.0001,704,18
0.556,1e-05,390,414,10,2,0.0001,804,18
0.556,1e-05,447,457,10,2,0.0001,904,18
0.556,1e-05,496,508,10,2,0.0001,1004,18
0.556,1e-05,543,561,10,2,0.0001,1104,18
0.556,1e-05,597,607,10,2,0.0001,1204,18
0.556,1e-05,648,656,10,2,0.0001,1304,18
0.556,1e-05,708,696,10,2,0.0001,1404,18
0.556,1e-05,764,740,10,2,0.0001,1504,18
0.556,1e-05,820,784,10,2,0.0001,1604,18
0.556,1e-05,863,841,10,2,0.0001,1704,18
0.558,1e-05,918,886,10,2,0.0001,1804,18
0.558,1e-05,981,923,10,2,0.0001,1904,18
0.558,1e-05,1027,977,10,2,0.0001,2004,18
0.498,1e-05,52,52,10,2,0.0001,104,19
0.498,1e-05,97,107,10,2,0.0001,204,19
0.498,1e-05,145,159,10,2,0.0001,304,19
0.498,1e-05,193,211,10,2,0.0001,404,19
0.498,1e-05,253,251,10,2,0.0001,504,19
0.498,1e-05,303,301,10,2,0.0001,604,19
0.498,1e-05,346,358,10,2,0.0001,704,19
0.498,1e-05,392,412,10,2,0.0001,804,19
0.498,1e-05,446,458,10,2,0.0001,904,19
0.498,1e-05,492,512,10,2,0.0001,1004,19
0.498,1e-05,538,566,10,2,0.0001,1104,19
0.498,1e-05,581,623,10,2,0.0001,1204,19
0.498,1e-05,641,663,10,2,0.0001,1304,19
0.496,1e-05,688,716,10,2,0.0001,1404,19
0.496,1e-05,743,761,10,2,0.0001,1504,19
0.496,1e-05,795,809,10,2,0.0001,1604,19
0.496,1e-05,841,863,10,2,0.0001,1704,19
0.494,1e-05,892,912,10,2,0.0001,1804,19
0.494,1e-05,942,962,10,2,0.0001,1904,19
0.494,1e-05,989,1015,10,2,0.0001,2004,19
0.508,1e-05,58,46,10,2,0.0001,104,20
0.508,1e-05,104,100,10,2,0.0001,204,20
0.508,1e-05,166,138,10,2,0.0001,304,20
0.508,1e-05,218,186,10,2,0.0001,404,20
0.508,1e-05,267,237,10,2,0.0001,504,20
0.508,1e-05,327,277,10,2,0.0001,604,20
0.508,1e-05,371,333,10,2,0.0001,704,20
0.508,1e-05,424,380,10,2,0.0001,804,20
0.508,1e-05,477,427,10,2,0.0001,904,20
0.508,1e-05,519,485,10,2,0.0001,1004,20
0.508,1e-05,575,529,10,2,0.0001,1104,20
0.508,1e-05,623,581,10,2,0.0001,1204,20
0.508,1e-05,675,629,10,2,0.0001,1304,20
0.508,1e-05,725,679,10,2,0.0001,1404,20
0.508,1e-05,771,733,10,2,0.0001,1504,20
0.508,1e-05,816,788,10,2,0.0001,1604,20
0.508,1e-05,862,842,10,2,0.0001,1704,20
0.508,1e-05,905,899,10,2,0.0001,1804,20
0.508,1e-05,954,950,10,2,0.0001,1904,20
0.508,1e-05,1006,998,10,2,0.0001,2004,20
0.498,1e-05,53,51,10,2,0.001,104,1
0.502,1e-05,101,103,10,2,0.001,204,1
0.502,1e-05,156,148,10,2,0.001,304,1
0.502,1e-05,206,198,10,2,0.001,404,1
0.504,1e-05,253,251,10,2,0.001,504,1
0.506,1e-05,295,309,10,2,0.001,604,1
0.504,1e-05,348,356,10,2,0.001,704,1
0.504,1e-05,392,412,10,2,0.001,804,1
0.502,1e-05,443,461,10,2,0.001,904,1
0.496,1e-05,488,516,10,2,0.001,1004,1
0.496,1e-05,534,570,10,2,0.001,1104,1
0.494,1e-05,591,613,10,2,0.001,1204,1
0.498,1e-05,644,660,10,2,0.001,1304,1
0.494,1e-05,691,713,10,2,0.001,1404,1
0.494,1e-05,750,754,10,2,0.001,1504,1
0.492,1e-05,798,806,10,2,0.001,1604,1
0.494,1e-05,846,858,10,2,0.001,1704,1
0.49,1e-05,900,904,10,2,0.001,1804,1
0.494,1e-05,949,955,10,2,0.001,1904,1
0.496,1e-05,997,1007,10,2,0.001,2004,1
0.492,1e-05,57,47,10,2,0.001,104,2
0.492,1e-05,115,89,10,2,0.001,204,2
0.492,1e-05,164,140,10,2,0.001,304,2
0.492,1e-05,220,184,10,2,0.001,404,2
0.492,1e-05,262,242,10,2,0.001,504,2
0.492,1e-05,315,289,10,2,0.001,604,2
0.492,1e-05,368,336,10,2,0.001,704,2
0.492,1e-05,413,391,10,2,0.001,804,2
0.492,1e-05,464,440,10,2,0.001,904,2
0.492,1e-05,509,495,10,2,0.001,1004,2
0.492,1e-05,558,546,10,2,0.001,1104,2
0.492,1e-05,606,598,10,2,0.001,1204,2
0.492,1e-05,667,637,10,2,0.001,1304,2
0.492,1e-05,718,686,10,2,0.001,1404,2
0.492,1e-05,767,737,10,2,0.001,1504,2
0.492,1e-05,816,788,10,2,0.001,1604,2
0.492,1e-05,864,840,10,2,0.001,1704,2
0.492,1e-05,913,891,10,2,0.001,1804,2
0.492,1e-05,959,945,10,2,0.001,1904,2
0.492,1e-05,1006,998,10,2,0.001,2004,2
0.516,1e-05,48,56,10,2,0.001,104,3
0.516,1e-05,95,109,10,2,0.001,204,3
0.516,1e-05,146,158,10,2,0.001,304,3
0.516,1e-05,196,208,10,2,0.001,404,3
0.516,1e-05,244,260,10,2,0.001,504,3
0.516,1e-05,298,306,10,2,0.001,604,3
0.516,1e-05,347,357,10,2,0.001,704,3
0.516,1e-05,403,401,10,2,0.001,804,3
0.516,1e-05,450,454,10,2,0.001,904,3
0.516,1e-05,498,506,10,2,0.001,1004,3
0.516,1e-05,557,547,10,2,0.001,1104,3
0.516,1e-05,602,602,10,2,0.001,1204,3
0.516,1e-05,655,649,10,2,0.001,1304,3
0.516,1e-05,709,695,10,2,0.001,1404,3
0.516,1e-05,762,742,10,2,0.001,1504,3
0.516,1e-05,817,787,10,2,0.001,1604,3
0.514,1e-05,866,838,10,2,0.001,1704,3
0.514,1e-05,912,892,10,2,0.001,1804,3
0.518,1e-05,965,939,10,2,0.001,1904,3
0.518,1e-05,1012,992,10,2,0.001,2004,3
0.502,1e-05,53,51,10,2,0.001,104,4
0.504,1e-05,107,97,10,2,0.001,204,4
0.508,1e-05,159,145,10,2,0.001,304,4
0.508,1e-05,214,190,10,2,0.001,404,4
0.508,1e-05,272,232,10,2,0.001,504,4
0.506,1e-05,328,276,10,2,0.001,604,4
0.504,1e-05,378,326,10,2,0.001,704,4
0.504,1e-05,425,379,10,2,0.001,804,4
0.51,1e-05,472,432,10,2,0.001,904,4
0.512,1e-05,520,484,10,2,0.001,1004,4
0.512,1e-05,565,539,10,2,0.001,1104,4
0.51,1e-05,623,581,10,2,0.001,1204,4
0.508,1e-05,673,631,10,2,0.001,1304,4
0.51,1e-05,715,689,10,2,0.001,1404,4
0.508,1e-05,761,743,10,2,0.001,1504,4
0.512,1e-05,805,799,10,2,0.001,1604,4
0.516,1e-05,855,849,10,2,0.001,1704,4
0.516,1e-05,905,899,10,2,0.001,1804,4
0.52,1e-05,953,951,10,2,0.001,1904,4
0.522,1e-05,999,1005,10,2,0.001,2004,4
0.528,1e-05,60,44,10,2,0.001,104,5
0.528,1e-05,107,97,10,2,0.001,204,5
0.528,1e-05,156,148,10,2,0.001,304,5
0.528,1e-05,205,199,10,2,0.001,404,5
0.526,1e-05,255,249,10,2,0.001,504,5
0.53,1e-05,304,300,10,2,0.001,604,5
0.53,1e-05,359,345,10,2,0.001,704,5
0.538,1e-05,401,403,10,2,0.001,804,5
0.538,1e-05,453,451,10,2,0.001,904,5
0.54,1e-05,501,503,10,2,0.001,1004,5
0.534,1e-05,546,558,10,2,0.001,1104,5
0.532,1e-05,601,603,10,2,0.001,1204,5
0.538,1e-05,655,649,10,2,0.001,1304,5
0.54,1e-05,713,691,10,2,0.001,1404,5
0.544,1e-05,762,742,10,2,0.001,1504,5
0.542,1e-05,808,796,10,2,0.001,1604,5
0.546,1e-05,861,843,10,2,0.001,1704,5
0.548,1e-05,913,891,10,2,0.001,1804,5
0.546,1e-05,967,937,10,2,0.001,1904,5
0.55,1e-05,1019,985,10,2,0.001,2004,5
0.47,1e-05,48,56,10,2,0.001,104,6
0.47,1e-05,105,99,10,2,0.001,204,6
0.47,1e-05,152,152,10,2,0.001,304,6
0.47,1e-05,193,211,10,2,0.001,404,6
0.47,1e-05,238,266,10,2,0.001,504,6
0.476,1e-05,290,314,10,2,0.001,604,6
0.478,1e-05,342,362,10,2,0.001,704,6
0.478,1e-05,389,415,10,2,0.001,804,6
0.474,1e-05,453,451,10,2,0.001,904,6
0.476,1e-05,496,508,10,2,0.001,1004,6
0.476,1e-05,553,551,10,2,0.001,1104,6
0.474,1e-05,602,602,10,2,0.001,1204,6
0.474,1e-05,653,651,10,2,0.001,1304,6
0.48,1e-05,702,702,10,2,0.001,1404,6
0.482,1e-05,755,749,10,2,0.001,1504,6
0.484,1e-05,803,801,10,2,0.001,1604,6
0.486,1e-05,853,851,10,2,0.001,1704,6
0.494,1e-05,902,902,10,2,0.001,1804,6
0.5,1e-05,963,941,10,2,0.001,1904,6
0.504,1e-05,1014,990,10,2,0.001,2004,6
0.52,1e-05,50,54,10,2,0.001,104,7
0.52,1e-05,102,102,10,2,0.001,204,7
0.52,1e-05,150,154,10,2,0.001,304,7
0.52,1e-05,186,218,10,2,0.001,404,7
0.52,1e-05,232,272,10,2,0.001,504,7
0.52,1e-05,284,320,10,2,0.001,604,7
0.52,1e-05,336,368,10,2,0.001,704,7
0.52,1e-05,382,422,10,2,0.001,804,7
0.52,1e-05,437,467,10,2,0.001,904,7
0.52,1e-05,488,516,10,2,0.001,1004,7
0.52,1e-05,537,567,10,2,0.001,1104,7
0.52,1e-05,585,619,10,2,0.001,1204,7
0.52,1e-05,638,666,10,2,0.001,1304,7
0.52,1e-05,697,707,10,2,0.001,1404,7
0.52,1e-05,745,759,10,2,0.001,1504,7
0.52,1e-05,800,804,10,2,0.001,1604,7
0.52,1e-05,849,855,10,2,0.001,1704,7
0.52,1e-05,888,916,10,2,0.001,1804,7
0.52,1e-05,939,965,10,2,0.001,1904,7
0.52,1e-05,992,1012,10,2,0.001,2004,7
0.486,1e-05,52,52,10,2,0.001,104,8
0.488,1e-05,104,100,10,2,0.001,204,8
0.494,1e-05,146,158,10,2,0.001,304,8
0.498,1e-05,202,202,10,2,0.001,404,8
0.496,1e-05,250,254,10,2,0.001,504,8
0.498,1e-05,307,297,10,2,0.001,604,8
0.492,1e-05,364,340,10,2,0.001,704,8
0.494,1e-05,409,395,10,2,0.001,804,8
0.496,1e-05,466,438,10,2,0.001,904,8
0.5,1e-05,530,474,10,2,0.001,1004,8
0.5,1e-05,576,528,10,2,0.001,1104,8
0.506,1e-05,626,578,10,2,0.001,1204,8
0.51,1e-05,682,622,10,2,0.001,1304,8
0.51,1e-05,725,679,10,2,0.001,1404,8
0.514,1e-05,769,735,10,2,0.001,1504,8
0.512,1e-05,809,795,10,2,0.001,1604,8
0.52,1e-05,856,848,10,2,0.001,1704,8
0.522,1e-05,901,903,10,2,0.001,1804,8
0.524,1e-05,946,958,10,2,0.001,1904,8
0.524,1e-05,997,1007,10,2,0.001,2004,8
0.498,1e-05,52,52,10,2,0.001,104,9
0.498,1e-05,103,101,10,2,0.001,204,9
0.498,1e-05,150,154,10,2,0.001,304,9
0.498,1e-05,205,199,10,2,0.001,404,9
0.498,1e-05,244,260,10,2,0.001,504,9
0.498,1e-05,289,315,10,2,0.001,604,9
0.498,1e-05,335,369,10,2,0.001,704,9
0.498,1e-05,387,417,10,2,0.001,804,9
0.498,1e-05,432,472,10,2,0.001,904,9
0.498,1e-05,488,516,10,2,0.001,1004,9
0.498,1e-05,538,566,10,2,0.001,1104,9
0.498,1e-05,596,608,10,2,0.001,1204,9
0.498,1e-05,648,656,10,2,0.001,1304,9
0.498,1e-05,705,699,10,2,0.001,1404,9
0.498,1e-05,756,748,10,2,0.001,1504,9
0.498,1e-05,802,802,10,2,0.001,1604,9
0.498,1e-05,850,854,10,2,0.001,1704,9
0.498,1e-05,901,903,10,2,0.001,1804,9
0.498,1e-05,956,948,10,2,0.001,1904,9
0.498,1e-05,1001,1003,10,2,0.001,2004,9
0.464,1e-05,67,37,10,2,0.001,104,10
0.464,1e-05,112,92,10,2,0.001,204,10
0.464,1e-05,158,146,10,2,0.001,304,10
0.464,1e-05,206,198,10,2,0.001,404,10
0.464,1e-05,254,250,10,2,0.001,504,10
0.466,1e-05,314,290,10,2,0.001,604,10
0.464,1e-05,367,337,10,2,0.001,704,10
0.464,1e-05,422,382,10,2,0.001,804,10
0.466,1e-05,474,430,10,2,0.001,904,10
0.468,1e-05,524,480,10,2,0.001,1004,10
0.476,1e-05,581,523,10,2,0.001,1104,10
0.48,1e-05,632,572,10,2,0.001,1204,10
0.482,1e-05,681,623,10,2,0.001,1304,10
0.484,1e-05,726,678,10,2,0.001,1404,10
0.476,1e-05,770,734,10,2,0.001,1504,10
0.478,1e-05,821,783,10,2,0.001,1604,10
0.474,1e-05,868,836,10,2,0.001,1704,10
0.47,1e-05,915,889,10,2,0.001,1804,10
0.474,1e-05,957,947,10,2,0.001,1904,10
0.474,1e-05,1000,1004,10,2,0.001,2004,10
0.476,1e-05,39,65,10,2,0.001,104,11
0.476,1e-05,91,113,10,2,0.001,204,11
0.476,1e-05,145,159,10,2,0.001,304,11
0.476,1e-05,198,206,10,2,0.001,404,11
0.476,1e-05,254,250,10,2,0.001,504,11
0.476,1e-05,301,303,10,2,0.001,604,11
0.476,1e-05,352,352,10,2,0.001,704,11
0.476,1e-05,412,392,10,2,0.001,804,11
0.476,1e-05,458,446,10,2,0.001,904,11
0.476,1e-05,505,499,10,2,0.001,1004,11
0.476,1e-05,558,546,10,2,0.001,1104,11
0.476,1e-05,611,593,10,2,0.001,1204,11
0.476,1e-05,665,639,10,2,0.001,1304,11
0.476,1e-05,716,688,10,2,0.001,1404,11
0.476,1e-05,760,744,10,2,0.001,1504,11
0.476,1e-05,807,797,10,2,0.001,1604,11
0.476,1e-05,856,848,10,2,0.001,1704,11
0.476,1e-05,913,891,10,2,0.001,1804,11
0.476,1e-05,967,937,10,2,0.001,1904,11
0.476,1e-05,1014,990,10,2,0.001,2004,11
0.528,1e-05,49,55,10,2,0.001,104,12
0.53,1e-05,103,101,10,2,0.001,204,12
0.53,1e-05,157,147,10,2,0.001,304,12
0.532,1e-05,204,200,10,2,0.001,404,12
0.534,1e-05,240,264,10,2,0.001,504,12
0.536,1e-05,288,316,10,2,0.001,604,12
0.538,1e-05,334,370,10,2,0.001,704,12
0.538,1e-05,381,423,10,2,0.001,804,12
0.538,1e-05,445,459,10,2,0.001,904,12
0.54,1e-05,495,509,10,2,0.001,1004,12
0.538,1e-05,547,557,10,2,0.001,1104,12
0.538,1e-05,595,609,10,2,0.001,1204,12
0.54,1e-05,644,660,10,2,0.001,1304,12
0.542,1e-05,690,714,10,2,0.001,1404,12
0.544,1e-05,744,760,10,2,0.001,1504,12
0.544,1e-05,798,806,10,2,0.001,1604,12
0.544,1e-05,857,847,10,2,0.001,1704,12
0.546,1e-05,911,893,10,2,0.001,1804,12
0.544,1e-05,959,945,10,2,0.001,1904,12
0.544,1e-05,1010,994,10,2,0.001,2004,12
0.51,1e-05,51,53,10,2,0.001,104,13
0.51,1e-05,100,104,10,2,0.001,204,13
0.51,1e-05,146,158,10,2,0.001,304,13
0.51,1e-05,199,205,10,2,0.001,404,13
0.51,1e-05,252,252,10,2,0.001,504,13
0.51,1e-05,299,305,10,2,0.001,604,13
0.51,1e-05,334,370,10,2,0.001,704,13
0.51,1e-05,378,426,10,2,0.001,804,13
0.51,1e-05,438,466,10,2,0.001,904,13
0.51,1e-05,497,507,10,2,0.001,1004,13
0.51,1e-05,542,562,10,2,0.001,1104,13
0.51,1e-05,591,613,10,2,0.001,1204,13
0.51,1e-05,638,666,10,2,0.001,1304,13
0.51,1e-05,695,709,10,2,0.001,1404,13
0.51,1e-05,753,751,10,2,0.001,1504,13
0.51,1e-05,812,792,10,2,0.001,1604,13
0.51,1e-05,860,844,10,2,0.001,1704,13
0.51,1e-05,904,900,10,2,0.001,1804,13
0.51,1e-05,956,948,10,2,0.001,1904,13
0.51,1e-05,1007,997,10,2,0.001,2004,13
0.496,1e-05,51,53,10,2,0.001,104,14
0.496,1e-05,104,100,10,2,0.001,204,14
0.496,1e-05,149,155,10,2,0.001,304,14
0.494,1e-05,196,208,10,2,0.001,404,14
0.494,1e-05,248,256,10,2,0.001,504,14
0.494,1e-05,301,303,10,2,0.001,604,14
0.494,1e-05,355,349,10,2,0.001,704,14
0.494,1e-05,403,401,10,2,0.001,804,14
0.494,1e-05,453,451,10,2,0.001,904,14
0.494,1e-05,500,504,10,2,0.001,1004,14
0.494,1e-05,541,563,10,2,0.001,1104,14
0.496,1e-05,587,617,10,2,0.001,1204,14
0.496,1e-05,637,667,10,2,0.001,1304,14
0.496,1e-05,685,719,10,2,0.001,1404,14
0.496,1e-05,746,758,10,2,0.001,1504,14
0.498,1e-05,797,807,10,2,0.001,1604,14
0.498,1e-05,848,856,10,2,0.001,1704,14
0.498,1e-05,903,901,10,2,0.001,1804,14
0.498,1e-05,955,949,10,2,0.001,1904,14
0.5,1e-05,1002,1002,10,2,0.001,2004,14
0.528,1e-05,48,56,10,2,0.001,104,15
0.526,1e-05,97,107,10,2,0.001,204,15
0.524,1e-05,144,160,10,2,0.001,304,15
0.528,1e-05,193,211,10,2,0.001,404,15
0.528,1e-05,243,261,10,2,0.001,504,15
0.528,1e-05,297,307,10,2,0.001,604,15
0.528,1e-05,350,354,10,2,0.001,704,15
0.53,1e-05,399,405,10,2,0.001,804,15
0.534,1e-05,452,452,10,2,0.001,904,15
0.538,1e-05,498,506,10,2,0.001,1004,15
0.54,1e-05,541,563,10,2,0.001,1104,15
0.546,1e-05,596,608,10,2,0.001,1204,15
0.548,1e-05,649,655,10,2,0.001,1304,15
0.548,1e-05,690,714,10,2,0.001,1404,15
0.552,1e-05,756,748,10,2,0.001,1504,15
0.558,1e-05,807,797,10,2,0.001,1604,15
0.56,1e-05,846,858,10,2,0.001,1704,15
0.56,1e-05,902,902,10,2,0.001,1804,15
0.564,1e-05,955,949,10,2,0.001,1904,15
0.564,1e-05,1009,995,10,2,0.001,2004,15
0.49,1e-05,48,56,10,2,0.001,104,16
0.488,1e-05,112,92,10,2,0.001,204,16
0.488,1e-05,172,132,10,2,0.001,304,16
0.486,1e-05,221,183,10,2,0.001,404,16
0.486,1e-05,269,235,10,2,0.001,504,16
0.484,1e-05,321,283,10,2,0.001,604,16
0.486,1e-05,356,348,10,2,0.001,704,16
0.486,1e-05,397,407,10,2,0.001,804,16
0.486,1e-05,451,453,10,2,0.001,904,16
0.486,1e-05,503,501,10,2,0.001,1004,16
0.486,1e-05,554,550,10,2,0.001,1104,16
0.488,1e-05,600,604,10,2,0.001,1204,16
0.484,1e-05,644,660,10,2,0.001,1304,16
0.48,1e-05,687,717,10,2,0.001,1404,16
0.482,1e-05,747,757,10,2,0.001,1504,16
0.48,1e-05,796,808,10,2,0.001,1604,16
0.48,1e-05,849,855,10,2,0.001,1704,16
0.474,1e-05,910,894,10,2,0.001,1804,16
0.474,1e-05,965,939,10,2,0.001,1904,16
0.47,1e-05,1009,995,10,2,0.001,2004,16
0.476,1e-05,59,45,10,2,0.001,104,17
0.474,1e-05,111,93,10,2,0.001,204,17
0.476,1e-05,160,144,10,2,0.001,304,17
0.474,1e-05,204,200,10,2,0.001,404,17
0.474,1e-05,250,254,10,2,0.001,504,17
0.476,1e-05,303,301,10,2,0.001,604,17
0.474,1e-05,356,348,10,2,0.001,704,17
0.47,1e-05,410,394,10,2,0.001,804,17
0.47,1e-05,467,437,10,2,0.001,904,17
0.472,1e-05,518,486,10,2,0.001,1004,17
0.468,1e-05,563,541,10,2,0.001,1104,17
0.468,1e-05,616,588,10,2,0.001,1204,17
0.466,1e-05,670,634,10,2,0.001,1304,17
0.47,1e-05,711,693,10,2,0.001,1404,17
0.472,1e-05,763,741,10,2,0.001,1504,17
0.478,1e-05,818,786,10,2,0.001,1604,17
0.48,1e-05,870,834,10,2,0.001,1704,17
0.478,1e-05,924,880,10,2,0.001,1804,17
0.478,1e-05,971,933,10,2,0.001,1904,17
0.482,1e-05,1015,989,10,2,0.001,2004,17
0.502,1e-05,56,48,10,2,0.001,104,18
0.502,1e-05,105,99,10,2,0.001,204,18
0.504,1e-05,157,147,10,2,0.001,304,18
0.504,1e-05,212,192,10,2,0.001,404,18
0.504,1e-05,253,251,10,2,0.001,504,18
0.508,1e-05,304,300,10,2,0.001,604,18
0.508,1e-05,354,350,10,2,0.001,704,18
0.512,1e-05,404,400,10,2,0.001,804,18
0.514,1e-05,454,450,10,2,0.001,904,18
0.516,1e-05,506,498,10,2,0.001,1004,18
0.52,1e-05,555,549,10,2,0.001,1104,18
0.524,1e-05,609,595,10,2,0.001,1204,18
0.524,1e-05,648,656,10,2,0.001,1304,18
0.528,1e-05,704,700,10,2,0.001,1404,18
0.532,1e-05,760,744,10,2,0.001,1504,18
0.538,1e-05,809,795,10,2,0.001,1604,18
0.542,1e-05,856,848,10,2,0.001,1704,18
0.55,1e-05,901,903,10,2,0.001,1804,18
0.566,1e-05,946,958,10,2,0.001,1904,18
0.568,1e-05,999,1005,10,2,0.001,2004,18
0.522,1e-05,45,59,10,2,0.001,104,19
0.522,1e-05,98,106,10,2,0.001,204,19
0.522,1e-05,148,156,10,2,0.001,304,19
0.522,1e-05,198,206,10,2,0.001,404,19
0.522,1e-05,265,239,10,2,0.001,504,19
0.522,1e-05,317,287,10,2,0.001,604,19
0.522,1e-05,370,334,10,2,0.001,704,19
0.522,1e-05,412,392,10,2,0.001,804,19
0.522,1e-05,472,432,10,2,0.001,904,19
0.522,1e-05,525,479,10,2,0.001,1004,19
0.522,1e-05,572,532,10,2,0.001,1104,19
0.522,1e-05,619,585,10,2,0.001,1204,19
0.522,1e-05,673,631,10,2,0.001,1304,19
0.522,1e-05,729,675,10,2,0.001,1404,19
0.522,1e-05,781,723,10,2,0.001,1504,19
0.522,1e-05,826,778,10,2,0.001,1604,19
0.522,1e-05,873,831,10,2,0.001,1704,19
0.522,1e-05,908,896,10,2,0.001,1804,19
0.522,1e-05,965,939,10,2,0.001,1904,19
0.522,1e-05,1013,991,10,2,0.001,2004,19
0.502,1e-05,47,57,10,2,0.001,104,20
0.502,1e-05,96,108,10,2,0.001,204,20
0.498,1e-05,149,155,10,2,0.001,304,20
0.502,1e-05,192,212,10,2,0.001,404,20
0.5,1e-05,240,264,10,2,0.001,504,20
0.5,1e-05,294,310,10,2,0.001,604,20
0.498,1e-05,349,355,10,2,0.001,704,20
0.504,1e-05,400,404,10,2,0.001,804,20
0.508,1e-05,451,453,10,2,0.001,904,20
0.508,1e-05,504,500,10,2,0.001,1004,20
0.508,1e-05,553,551,10,2,0.001,1104,20
0.512,1e-05,609,595,10,2,0.001,1204,20
0.512,1e-05,661,643,10,2,0.001,1304,20
0.51,1e-05,713,691,10,2,0.001,1404,20
0.51,1e-05,757,747,10,2,0.001,1504,20
0.512,1e-05,808,796,10,2,0.001,1604,20
0.514,1e-05,850,854,10,2,0.001,1704,20
0.512,1e-05,904,900,10,2,0.001,1804,20
0.524,1e-05,956,948,10,2,0.001,1904,20
0.524,1e-05,1003,1001,10,2,0.001,2004,20
0.498,1e-05,55,49,10,2,0.01,104,1
0.498,1e-05,110,94,10,2,0.01,204,1
0.5,1e-05,156,148,10,2,0.01,304,1
0.506,1e-05,207,197,10,2,0.01,404,1
0.516,1e-05,260,244,10,2,0.01,504,1
0.53,1e-05,315,289,10,2,0.01,604,1
0.506,1e-05,361,343,10,2,0.01,704,1
0.498,1e-05,416,388,10,2,0.01,804,1
0.508,1e-05,461,443,10,2,0.01,904,1
0.526,1e-05,514,490,10,2,0.01,1004,1
0.54,1e-05,557,547,10,2,0.01,1104,1
0.58,1e-05,605,599,10,2,0.01,1204,1
0.616,1e-05,652,652,10,2,0.01,1304,1
0.628,1e-05,697,707,10,2,0.01,1404,1
0.65,1e-05,745,759,10,2,0.01,1504,1
0.668,1e-05,796,808,10,2,0.01,1604,1
0.668,1e-05,850,854,10,2,0.01,1704,1
0.672,1e-05,909,895,10,2,0.01,1804,1
0.682,1e-05,953,951,10,2,0.01,1904,1
0.69,1e-05,1001,1003,10,2,0.01,2004,1
0.496,1e-05,41,63,10,2,0.01,104,2
0.496,1e-05,91,113,10,2,0.01,204,2
0.496,1e-05,137,167,10,2,0.01,304,2
0.494,1e-05,185,219,10,2,0.01,404,2
0.492,1e-05,229,275,10,2,0.01,504,2
0.498,1e-05,278,326,10,2,0.01,604,2
0.5,1e-05,324,380,10,2,0.01,704,2
0.528,1e-05,380,424,10,2,0.01,804,2
0.56,1e-05,433,471,10,2,0.01,904,2
0.582,1e-05,479,525,10,2,0.01,1004,2
0.584,1e-05,536,568,10,2,0.01,1104,2
0.584,1e-05,592,612,10,2,0.01,1204,2
0.582,1e-05,648,656,10,2,0.01,1304,2
0.572,1e-05,699,705,10,2,0.01,1404,2
0.578,1e-05,743,761,10,2,0.01,1504,2
0.582,1e-05,798,806,10,2,0.01,1604,2
0.58,1e-05,850,854,10,2,0.01,1704,2
0.594,1e-05,899,905,10,2,0.01,1804,2
0.604,1e-05,961,943,10,2,0.01,1904,2
0.608,1e-05,1004,1000,10,2,0.01,2004,2
0.546,1e-05,50,54,10,2,0.01,104,3
0.554,1e-05,109,95,10,2,0.01,204,3
0.55,1e-05,158,146,10,2,0.01,304,3
0.558,1e-05,207,197,10,2,0.01,404,3
0.558,1e-05,256,248,10,2,0.01,504,3
0.552,1e-05,306,298,10,2,0.01,604,3
0.564,1e-05,350,354,10,2,0.01,704,3
0.568,1e-05,402,402,10,2,0.01,804,3
0.57,1e-05,458,446,10,2,0.01,904,3
0.558,1e-05,509,495,10,2,0.01,1004,3
0.584,1e-05,562,542,10,2,0.01,1104,3
0.598,1e-05,604,600,10,2,0.01,1204,3
0.6,1e-05,654,650,10,2,0.01,1304,3
0.592,1e-05,697,707,10,2,0.01,1404,3
0.594,1e-05,745,759,10,2,0.01,1504,3
0.604,1e-05,796,808,10,2,0.01,1604,3
0.622,1e-05,851,853,10,2,0.01,1704,3
0.636,1e-05,894,910,10,2,0.01,1804,3
0.63,1e-05,937,967,10,2,0.01,1904,3
0.642,1e-05,985,1019,10,2,0.01,2004,3
0.482,1e-05,50,54,10,2,0.01,104,4
0.476,1e-05,93,111,10,2,0.01,204,4
0.488,1e-05,150,154,10,2,0.01,304,4
0.496,1e-05,202,202,10,2,0.01,404,4
0.506,1e-05,245,259,10,2,0.01,504,4
0.51,1e-05,292,312,10,2,0.01,604,4
0.528,1e-05,350,354,10,2,0.01,704,4
0.552,1e-05,394,410,10,2,0.01,804,4
0.572,1e-05,447,457,10,2,0.01,904,4
0.568,1e-05,495,509,10,2,0.01,1004,4
0.578,1e-05,539,565,10,2,0.01,1104,4
0.598,1e-05,583,621,10,2,0.01,1204,4
0.612,1e-05,643,661,10,2,0.01,1304,4
0.63,1e-05,695,709,10,2,0.01,1404,4
0.648,1e-05,740,764,10,2,0.01,1504,4
0.656,1e-05,790,814,10,2,0.01,1604,4
0.642,1e-05,844,860,10,2,0.01,1704,4
0.674,1e-05,895,909,10,2,0.01,1804,4
0.684,1e-05,947,957,10,2,0.01,1904,4
0.694,1e-05,1005,999,10,2,0.01,2004,4
0.5,1e-05,48,56,10,2,0.01,104,5
0.5,1e-05,89,115,10,2,0.01,204,5
0.496,1e-05,139,165,10,2,0.01,304,5
0.506,1e-05,194,210,10,2,0.01,404,5
0.512,1e-05,244,260,10,2,0.01,504,5
0.516,1e-05,282,322,10,2,0.01,604,5
0.526,1e-05,338,366,10,2,0.01,704,5
0.546,1e-05,394,410,10,2,0.01,804,5
0.544,1e-05,452,452,10,2,0.01,904,5
0.558,1e-05,503,501,10,2,0.01,1004,5
0.566,1e-05,555,549,10,2,0.01,1104,5
0.57,1e-05,604,600,10,2,0.01,1204,5
0.578,1e-05,653,651,10,2,0.01,1304,5
0.574,1e-05,709,695,10,2,0.01,1404,5
0.578,1e-05,758,746,10,2,0.01,1504,5
0.582,1e-05,806,798,10,2,0.01,1604,5
0.586,1e-05,857,847,10,2,0.01,1704,5
0.59,1e-05,908,896,10,2,0.01,1804,5
0.604,1e-05,955,949,10,2,0.01,1904,5
0.612,1e-05,999,1005,10,2,0.01,2004,5
0.488,1e-05,49,55,10,2,0.01,104,6
0.494,1e-05,97,107,10,2,0.01,204,6
0.502,1e-05,142,162,10,2,0.01,304,6
0.506,1e-05,189,215,10,2,0.01,404,6
0.508,1e-05,231,273,10,2,0.01,504,6
0.516,1e-05,277,327,10,2,0.01,604,6
0.528,1e-05,328,376,10,2,0.01,704,6
0.524,1e-05,381,423,10,2,0.01,804,6
0.538,1e-05,421,483,10,2,0.01,904,6
0.532,1e-05,474,530,10,2,0.01,1004,6
0.536,1e-05,527,577,10,2,0.01,1104,6
0.55,1e-05,584,620,10,2,0.01,1204,6
0.564,1e-05,629,675,10,2,0.01,1304,6
0.614,1e-05,687,717,10,2,0.01,1404,6
0.72,1e-05,735,769,10,2,0.01,1504,6
0.722,1e-05,789,815,10,2,0.01,1604,6
0.72,1e-05,842,862,10,2,0.01,1704,6
0.724,1e-05,902,902,10,2,0.01,1804,6
0.72,1e-05,950,954,10,2,0.01,1904,6
0.73,1e-05,1000,1004,10,2,0.01,2004,6
0.472,1e-05,46,58,10,2,0.01,104,7
0.494,1e-05,92,112,10,2,0.01,204,7
0.496,1e-05,145,159,10,2,0.01,304,7
0.516,1e-05,194,210,10,2,0.01,404,7
0.526,1e-05,248,256,10,2,0.01,504,7
0.554,1e-05,298,306,10,2,0.01,604,7
0.566,1e-05,350,354,10,2,0.01,704,7
0.586,1e-05,399,405,10,2,0.01,804,7
0.61,1e-05,451,453,10,2,0.01,904,7
0.634,1e-05,501,503,10,2,0.01,1004,7
0.642,1e-05,552,552,10,2,0.01,1104,7
0.668,1e-05,601,603,10,2,0.01,1204,7
0.682,1e-05,651,653,10,2,0.01,1304,7
0.718,1e-05,699,705,10,2,0.01,1404,7
0.752,1e-05,747,757,10,2,0.01,1504,7
0.76,1e-05,795,809,10,2,0.01,1604,7
0.766,1e-05,849,855,10,2,0.01,1704,7
0.776,1e-05,896,908,10,2,0.01,1804,7
0.788,1e-05,945,959,10,2,0.01,1904,7
0.802,1e-05,991,1013,10,2,0.01,2004,7
0.5,1e-05,51,53,10,2,0.01,104,8
0.5,1e-05,95,109,10,2,0.01,204,8
0.5,1e-05,145,159,10,2,0.01,304,8
0.5,1e-05,196,208,10,2,0.01,404,8
0.5,1e-05,245,259,10,2,0.01,504,8
0.5,1e-05,301,303,10,2,0.01,604,8
0.5,1e-05,349,355,10,2,0.01,704,8
0.502,1e-05,402,402,10,2,0.01,804,8
0.502,1e-05,451,453,10,2,0.01,904,8
0.518,1e-05,505,499,10,2,0.01,1004,8
0.562,1e-05,558,546,10,2,0.01,1104,8
0.62,1e-05,604,600,10,2,0.01,1204,8
0.65,1e-05,656,648,10,2,0.01,1304,8
0.668,1e-05,717,687,10,2,0.01,1404,8
0.688,1e-05,766,738,10,2,0.01,1504,8
0.698,1e-05,817,787,10,2,0.01,1604,8
0.702,1e-05,865,839,10,2,0.01,1704,8
0.708,1e-05,907,897,10,2,0.01,1804,8
0.712,1e-05,959,945,10,2,0.01,1904,8
0.72,1e-05,1002,1002,10,2,0.01,2004,8
0.522,1e-05,56,48,10,2,0.01,104,9
0.52,1e-05,108,96,10,2,0.01,204,9
0.52,1e-05,166,138,10,2,0.01,304,9
0.512,1e-05,217,187,10,2,0.01,404,9
0.51,1e-05,257,247,10,2,0.01,504,9
0.526,1e-05,313,291,10,2,0.01,604,9
0.53,1e-05,361,343,10,2,0.01,704,9
0.536,1e-05,411,393,10,2,0.01,804,9
0.536,1e-05,458,446,10,2,0.01,904,9
0.554,1e-05,514,490,10,2,0.01,1004,9
0.56,1e-05,559,545,10,2,0.01,1104,9
0.58,1e-05,599,605,10,2,0.01,1204,9
0.576,1e-05,652,652,10,2,0.01,1304,9
0.584,1e-05,702,702,10,2,0.01,1404,9
0.608,1e-05,751,753,10,2,0.01,1504,9
0.642,1e-05,797,807,10,2,0.01,1604,9
0.656,1e-05,851,853,10,2,0.01,1704,9
0.702,1e-05,897,907,10,2,0.01,1804,9
0.726,1e-05,952,952,10,2,0.01,1904,9
0.746,1e-05,1011,993,10,2,0.01,2004,9
0.506,1e-05,50,54,10,2,0.01,104,10
0.512,1e-05,103,101,10,2,0.01,204,10
0.514,1e-05,152,152,10,2,0.01,304,10
0.524,1e-05,196,208,10,2,0.01,404,10
0.528,1e-05,246,258,10,2,0.01,504,10
0.534,1e-05,299,305,10,2,0.01,604,10
0.546,1e-05,356,348,10,2,0.01,704,10
0.56,1e-05,413,391,10,2,0.01,804,10
0.576,1e-05,465,439,10,2,0.01,904,10
0.558,1e-05,509,495,10,2,0.01,1004,10
0.566,1e-05,549,555,10,2,0.01,1104,10
0.564,1e-05,599,605,10,2,0.01,1204,10
0.566,1e-05,650,654,10,2,0.01,1304,10
0.576,1e-05,695,709,10,2,0.01,1404,10
0.592,1e-05,750,754,10,2,0.01,1504,10
0.59,1e-05,801,803,10,2,0.01,1604,10
0.604,1e-05,855,849,10,2,0.01,1704,10
0.61,1e-05,900,904,10,2,0.01,1804,10
0.612,1e-05,944,960,10,2,0.01,1904,10
0.622,1e-05,1000,1004,10,2,0.01,2004,10
0.498,1e-05,56,48,10,2,0.01,104,11
0.51,1e-05,110,94,10,2,0.01,204,11
0.522,1e-05,162,142,10,2,0.01,304,11
0.524,1e-05,207,197,10,2,0.01,404,11
0.53,1e-05,265,239,10,2,0.01,504,11
0.528,1e-05,314,290,10,2,0.01,604,11
0.544,1e-05,359,345,10,2,0.01,704,11
0.57,1e-05,411,393,10,2,0.01,804,11
0.584,1e-05,458,446,10,2,0.01,904,11
0.606,1e-05,514,490,10,2,0.01,1004,11
0.632,1e-05,570,534,10,2,0.01,1104,11
0.662,1e-05,618,586,10,2,0.01,1204,11
0.57,1e-05,665,639,10,2,0.01,1304,11
0.584,1e-05,726,678,10,2,0.01,1404,11
0.596,1e-05,779,725,10,2,0.01,1504,11
0.72,1e-05,824,780,10,2,0.01,1604,11
0.742,1e-05,869,835,10,2,0.01,1704,11
0.74,1e-05,923,881,10,2,0.01,1804,11
0.746,1e-05,966,938,10,2,0.01,1904,11
0.746,1e-05,1021,983,10,2,0.01,2004,11
0.524,1e-05,45,59,10,2,0.01,104,12
0.528,1e-05,94,110,10,2,0.01,204,12
0.54,1e-05,146,158,10,2,0.01,304,12
0.548,1e-05,196,208,10,2,0.01,404,12
0.55,1e-05,245,259,10,2,0.01,504,12
0.556,1e-05,292,312,10,2,0.01,604,12
0.562,1e-05,322,382,10,2,0.01,704,12
0.564,1e-05,376,428,10,2,0.01,804,12
0.566,1e-05,434,470,10,2,0.01,904,12
0.592,1e-05,486,518,10,2,0.01,1004,12
0.608,1e-05,542,562,10,2,0.01,1104,12
0.606,1e-05,598,606,10,2,0.01,1204,12
0.596,1e-05,647,657,10,2,0.01,1304,12
0.594,1e-05,688,716,10,2,0.01,1404,12
0.592,1e-05,733,771,10,2,0.01,1504,12
0.594,1e-05,779,825,10,2,0.01,1604,12
0.604,1e-05,839,865,10,2,0.01,1704,12
0.604,1e-05,887,917,10,2,0.01,1804,12
0.622,1e-05,939,965,10,2,0.01,1904,12
0.636,1e-05,991,1013,10,2,0.01,2004,12
0.478,1e-05,52,52,10,2,0.01,104,13
0.474,1e-05,102,102,10,2,0.01,204,13
0.478,1e-05,158,146,10,2,0.01,304,13
0.492,1e-05,204,200,10,2,0.01,404,13
0.5,1e-05,249,255,10,2,0.01,504,13
0.5,1e-05,304,300,10,2,0.01,604,13
0.49,1e-05,352,352,10,2,0.01,704,13
0.486,1e-05,399,405,10,2,0.01,804,13
0.482,1e-05,449,455,10,2,0.01,904,13
0.482,1e-05,500,504,10,2,0.01,1004,13
0.504,1e-05,548,556,10,2,0.01,1104,13
0.512,1e-05,591,613,10,2,0.01,1204,13
0.52,1e-05,639,665,10,2,0.01,1304,13
0.538,1e-05,691,713,10,2,0.01,1404,13
0.538,1e-05,740,764,10,2,0.01,1504,13
0.55,1e-05,788,816,10,2,0.01,1604,13
0.546,1e-05,839,865,10,2,0.01,1704,13
0.54,1e-05,884,920,10,2,0.01,1804,13
0.548,1e-05,937,967,10,2,0.01,1904,13
0.572,1e-05,992,1012,10,2,0.01,2004,13
0.482,1e-05,57,47,10,2,0.01,104,14
0.482,1e-05,112,92,10,2,0.01,204,14
0.482,1e-05,156,148,10,2,0.01,304,14
0.482,1e-05,199,205,10,2,0.01,404,14
0.482,1e-05,245,259,10,2,0.01,504,14
0.482,1e-05,288,316,10,2,0.01,604,14
0.482,1e-05,337,367,10,2,0.01,704,14
0.482,1e-05,388,416,10,2,0.01,804,14
0.482,1e-05,438,466,10,2,0.01,904,14
0.482,1e-05,494,510,10,2,0.01,1004,14
0.482,1e-05,546,558,10,2,0.01,1104,14
0.482,1e-05,606,598,10,2,0.01,1204,14
0.62,1e-05,658,646,10,2,0.01,1304,14
0.622,1e-05,697,707,10,2,0.01,1404,14
0.624,1e-05,743,761,10,2,0.01,1504,14
0.642,1e-05,791,813,10,2,0.01,1604,14
0.654,1e-05,835,869,10,2,0.01,1704,14
0.662,1e-05,895,909,10,2,0.01,1804,14
0.668,1e-05,942,962,10,2,0.01,1904,14
0.666,1e-05,993,1011,10,2,0.01,2004,14
0.496,1e-05,56,48,10,2,0.01,104,15
0.496,1e-05,96,108,10,2,0.01,204,15
0.494,1e-05,141,163,10,2,0.01,304,15
0.492,1e-05,188,216,10,2,0.01,404,15
0.49,1e-05,237,267,10,2,0.01,504,15
0.486,1e-05,292,312,10,2,0.01,604,15
0.488,1e-05,337,367,10,2,0.01,704,15
0.504,1e-05,386,418,10,2,0.01,804,15
0.506,1e-05,444,460,10,2,0.01,904,15
0.542,1e-05,499,505,10,2,0.01,1004,15
0.578,1e-05,542,562,10,2,0.01,1104,15
0.624,1e-05,596,608,10,2,0.01,1204,15
0.686,1e-05,645,659,10,2,0.01,1304,15
0.754,1e-05,694,710,10,2,0.01,1404,15
0.782,1e-05,744,760,10,2,0.01,1504,15
0.806,1e-05,794,810,10,2,0.01,1604,15
0.832,1e-05,849,855,10,2,0.01,1704,15
0.85,1e-05,904,900,10,2,0.01,1804,15
0.858,1e-05,951,953,10,2,0.01,1904,15
0.86,1e-05,1001,1003,10,2,0.01,2004,15
0.51,1e-05,49,55,10,2,0.01,104,16
0.51,1e-05,108,96,10,2,0.01,204,16
0.51,1e-05,159,145,10,2,0.01,304,16
0.51,1e-05,209,195,10,2,0.01,404,16
0.51,1e-05,267,237,10,2,0.01,504,16
0.51,1e-05,319,285,10,2,0.01,604,16
0.51,1e-05,374,330,10,2,0.01,704,16
0.51,1e-05,419,385,10,2,0.01,804,16
0.508,1e-05,468,436,10,2,0.01,904,16
0.506,1e-05,511,493,10,2,0.01,1004,16
0.512,1e-05,553,551,10,2,0.01,1104,16
0.522,1e-05,605,599,10,2,0.01,1204,16
0.552,1e-05,653,651,10,2,0.01,1304,16
0.606,1e-05,702,702,10,2,0.01,1404,16
0.64,1e-05,750,754,10,2,0.01,1504,16
0.644,1e-05,813,791,10,2,0.01,1604,16
0.63,1e-05,864,840,10,2,0.01,1704,16
0.64,1e-05,913,891,10,2,0.01,1804,16
0.668,1e-05,961,943,10,2,0.01,1904,16
0.698,1e-05,1007,997,10,2,0.01,2004,16
0.49,1e-05,50,54,10,2,0.01,104,17
0.49,1e-05,93,111,10,2,0.01,204,17
0.49,1e-05,143,161,10,2,0.01,304,17
0.49,1e-05,188,216,10,2,0.01,404,17
0.49,1e-05,239,265,10,2,0.01,504,17
0.49,1e-05,286,318,10,2,0.01,604,17
0.49,1e-05,329,375,10,2,0.01,704,17
0.49,1e-05,378,426,10,2,0.01,804,17
0.49,1e-05,432,472,10,2,0.01,904,17
0.49,1e-05,474,530,10,2,0.01,1004,17
0.49,1e-05,537,567,10,2,0.01,1104,17
0.49,1e-05,595,609,10,2,0.01,1204,17
0.49,1e-05,649,655,10,2,0.01,1304,17
0.49,1e-05,708,696,10,2,0.01,1404,17
0.49,1e-05,752,752,10,2,0.01,1504,17
0.49,1e-05,799,805,10,2,0.01,1604,17
0.49,1e-05,857,847,10,2,0.01,1704,17
0.49,1e-05,904,900,10,2,0.01,1804,17
0.49,1e-05,945,959,10,2,0.01,1904,17
0.49,1e-05,997,1007,10,2,0.01,2004,17
0.552,1e-05,53,51,10,2,0.01,104,18
0.558,1e-05,105,99,10,2,0.01,204,18
0.568,1e-05,150,154,10,2,0.01,304,18
0.584,1e-05,207,197,10,2,0.01,404,18
0.604,1e-05,253,251,10,2,0.01,504,18
0.606,1e-05,307,297,10,2,0.01,604,18
0.604,1e-05,362,342,10,2,0.01,704,18
0.598,1e-05,406,398,10,2,0.01,804,18
0.6,1e-05,451,453,10,2,0.01,904,18
0.606,1e-05,499,505,10,2,0.01,1004,18
0.612,1e-05,551,553,10,2,0.01,1104,18
0.604,1e-05,605,599,10,2,0.01,1204,18
0.6,1e-05,653,651,10,2,0.01,1304,18
0.596,1e-05,705,699,10,2,0.01,1404,18
0.604,1e-05,759,745,10,2,0.01,1504,18
0.598,1e-05,806,798,10,2,0.01,1604,18
0.604,1e-05,856,848,10,2,0.01,1704,18
0.618,1e-05,914,890,10,2,0.01,1804,18
0.64,1e-05,955,949,10,2,0.01,1904,18
0.658,1e-05,1007,997,10,2,0.01,2004,18
0.506,1e-05,51,53,10,2,0.01,104,19
0.492,1e-05,105,99,10,2,0.01,204,19
0.496,1e-05,155,149,10,2,0.01,304,19
0.512,1e-05,203,201,10,2,0.01,404,19
0.524,1e-05,256,248,10,2,0.01,504,19
0.526,1e-05,300,304,10,2,0.01,604,19
0.54,1e-05,349,355,10,2,0.01,704,19
0.532,1e-05,398,406,10,2,0.01,804,19
0.536,1e-05,445,459,10,2,0.01,904,19
0.518,1e-05,489,515,10,2,0.01,1004,19
0.514,1e-05,542,562,10,2,0.01,1104,19
0.514,1e-05,598,606,10,2,0.01,1204,19
0.524,1e-05,650,654,10,2,0.01,1304,19
0.558,1e-05,706,698,10,2,0.01,1404,19
0.568,1e-05,760,744,10,2,0.01,1504,19
0.584,1e-05,817,787,10,2,0.01,1604,19
0.594,1e-05,862,842,10,2,0.01,1704,19
0.6,1e-05,905,899,10,2,0.01,1804,19
0.592,1e-05,953,951,10,2,0.01,1904,19
0.616,1e-05,999,1005,10,2,0.01,2004,19
0.508,1e-05,53,51,10,2,0.01,104,20
0.508,1e-05,96,108,10,2,0.01,204,20
0.508,1e-05,151,153,10,2,0.01,304,20
0.508,1e-05,200,204,10,2,0.01,404,20
0.508,1e-05,245,259,10,2,0.01,504,20
0.508,1e-05,297,307,10,2,0.01,604,20
0.508,1e-05,359,345,10,2,0.01,704,20
0.508,1e-05,397,407,10,2,0.01,804,20
0.508,1e-05,456,448,10,2,0.01,904,20
0.508,1e-05,510,494,10,2,0.01,1004,20
0.508,1e-05,569,535,10,2,0.01,1104,20
0.508,1e-05,616,588,10,2,0.01,1204,20
0.508,1e-05,670,634,10,2,0.01,1304,20
0.508,1e-05,716,688,10,2,0.01,1404,20
0.508,1e-05,764,740,10,2,0.01,1504,20
0.508,1e-05,806,798,10,2,0.01,1604,20
0.508,1e-05,857,847,10,2,0.01,1704,20
0.508,1e-05,905,899,10,2,0.01,1804,20
0.508,1e-05,961,943,10,2,0.01,1904,20
0.508,1e-05,1006,998,10,2,0.01,2004,20
0.496,0.0001,50,54,10,2,0.0001,104,1
0.496,0.0001,101,103,10,2,0.0001,204,1
0.496,0.0001,158,146,10,2,0.0001,304,1
0.496,0.0001,208,196,10,2,0.0001,404,1
0.496,0.0001,260,244,10,2,0.0001,504,1
0.496,0.0001,306,298,10,2,0.0001,604,1
0.496,0.0001,356,348,10,2,0.0001,704,1
0.496,0.0001,417,387,10,2,0.0001,804,1
0.496,0.0001,466,438,10,2,0.0001,904,1
0.496,0.0001,516,488,10,2,0.0001,1004,1
0.496,0.0001,564,540,10,2,0.0001,1104,1
0.496,0.0001,606,598,10,2,0.0001,1204,1
0.496,0.0001,650,654,10,2,0.0001,1304,1
0.496,0.0001,697,707,10,2,0.0001,1404,1
0.496,0.0001,758,746,10,2,0.0001,1504,1
0.496,0.0001,808,796,10,2,0.0001,1604,1
0.496,0.0001,861,843,10,2,0.0001,1704,1
0.496,0.0001,907,897,10,2,0.0001,1804,1
0.496,0.0001,951,953,10,2,0.0001,1904,1
0.496,0.0001,1000,1004,10,2,0.0001,2004,1
0.504,0.0001,60,44,10,2,0.0001,104,2
0.504,0.0001,106,98,10,2,0.0001,204,2
0.504,0.0001,151,153,10,2,0.0001,304,2
0.504,0.0001,205,199,10,2,0.0001,404,2
0.504,0.0001,254,250,10,2,0.0001,504,2
0.504,0.0001,310,294,10,2,0.0001,604,2
0.504,0.0001,354,350,10,2,0.0001,704,2
0.504,0.0001,404,400,10,2,0.0001,804,2
0.504,0.0001,450,454,10,2,0.0001,904,2
0.504,0.0001,497,507,10,2,0.0001,1004,2
0.504,0.0001,539,565,10,2,0.0001,1104,2
0.504,0.0001,586,618,10,2,0.0001,1204,2
0.504,0.0001,635,669,10,2,0.0001,1304,2
0.504,0.0001,691,713,10,2,0.0001,1404,2
0.504,0.0001,733,771,10,2,0.0001,1504,2
0.504,0.0001,783,821,10,2,0.0001,1604,2
0.504,0.0001,841,863,10,2,0.0001,1704,2
0.504,0.0001,895,909,10,2,0.0001,1804,2
0.504,0.0001,950,954,10,2,0.0001,1904,2
0.504,0.0001,1004,1000,10,2,0.0001,2004,2
0.512,0.0001,58,46,10,2,0.0001,104,3
0.512,0.0001,105,99,10,2,0.0001,204,3
0.512,0.0001,156,148,10,2,0.0001,304,3
0.512,0.0001,211,193,10,2,0.0001,404,3
0.514,0.0001,258,246,10,2,0.0001,504,3
0.514,0.0001,310,294,10,2,0.0001,604,3
0.514,0.0001,357,347,10,2,0.0001,704,3
0.514,0.0001,409,395,10,2,0.0001,804,3
0.514,0.0001,462,442,10,2,0.0001,904,3
0.516,0.0001,511,493,10,2,0.0001,1004,3
0.516,0.0001,550,554,10,2,0.0001,1104,3
0.516,0.0001,596,608,10,2,0.0001,1204,3
0.516,0.0001,649,655,10,2,0.0001,1304,3
0.514,0.0001,704,700,10,2,0.0001,1404,3
0.514,0.0001,761,743,10,2,0.0001,1504,3
0.514,0.0001,806,798,10,2,0.0001,1604,3
0.514,0.0001,849,855,10,2,0.0001,1704,3
0.514,0.0001,899,905,10,2,0.0001,1804,3
0.514,0.0001,952,952,10,2,0.0001,1904,3
0.514,0.0001,999,1005,10,2,0.0001,2004,3
0.502,0.0001,52,52,10,2,0.0001,104,4
0.502,0.0001,96,108,10,2,0.0001,204,4
0.502,0.0001,140,164,10,2,0.0001,304,4
0.502,0.0001,201,203,10,2,0.0001,404,4
0.502,0.0001,258,246,10,2,0.0001,504,4
0.502,0.0001,302,302,10,2,0.0001,604,4
0.502,0.0001,348,356,10,2,0.0001,704,4
0.502,0.0001,402,402,10,2,0.0001,804,4
0.502,0.0001,447,457,10,2,0.0001,904,4
0.502,0.0001,502,502,10,2,0.0001,1004,4
0.502,0.0001,549,555,10,2,0.0001,1104,4
0.502,0.0001,598,606,10,2,0.0001,1204,4
0.502,0.0001,649,655,10,2,0.0001,1304,4
0.502,0.0001,701,703,10,2,0.0001,1404,4
0.502,0.0001,754,750,10,2,0.0001,1504,4
0.502,0.0001,811,793,10,2,0.0001,1604,4
0.502,0.0001,856,848,10,2,0.0001,1704,4
0.502,0.0001,910,894,10,2,0.0001,1804,4
0.502,0.0001,958,946,10,2,0.0001,1904,4
0.502,0.0001,1001,1003,10,2,0.0001,2004,4
0.548,0.0001,53,51,10,2,0.0001,104,5
0.548,0.0001,99,105,10,2,0.0001,204,5
0.548,0.0001,151,153,10,2,0.0001,304,5
0.548,0.0001,205,199,10,2,0.0001,404,5
0.548,0.0001,255,249,10,2,0.0001,504,5
0.548,0.0001,305,299,10,2,0.0001,604,5
0.548,0.0001,351,353,10,2,0.0001,704,5
0.548,0.0001,394,410,10,2,0.0001,804,5
0.548,0.0001,444,460,10,2,0.0001,904,5
0.548,0.0001,493,511,10,2,0.0001,1004,5
0.548,0.0001,541,563,10,2,0.0001,1104,5
0.548,0.0001,591,613,10,2,0.0001,1204,5
0.548,0.0001,645,659,10,2,0.0001,1304,5
0.548,0.0001,699,705,10,2,0.0001,1404,5
0.548,0.0001,749,755,10,2,0.0001,1504,5
0.548,0.0001,797,807,10,2,0.0001,1604,5
0.548,0.0001,835,869,10,2,0.0001,1704,5
0.548,0.0001,888,916,10,2,0.0001,1804,5
0.548,0.0001,930,974,10,2,0.0001,1904,5
0.548,0.0001,978,1026,10,2,0.0001,2004,5
0.49,0.0001,45,59,10,2,0.0001,104,6
0.49,0.0001,97,107,10,2,0.0001,204,6
0.49,0.0001,151,153,10,2,0.0001,304,6
0.49,0.0001,196,208,10,2,0.0001,404,6
0.492,0.0001,254,250,10,2,0.0001,504,6
0.492,0.0001,304,300,10,2,0.0001,604,6
0.494,0.0001,353,351,10,2,0.0001,704,6
0.492,0.0001,405,399,10,2,0.0001,804,6
0.494,0.0001,458,446,10,2,0.0001,904,6
0.494,0.0001,506,498,10,2,0.0001,1004,6
0.494,0.0001,559,545,10,2,0.0001,1104,6
0.494,0.0001,618,586,10,2,0.0001,1204,6
0.494,0.0001,672,632,10,2,0.0001,1304,6
0.494,0.0001,718,686,10,2,0.0001,1404,6
0.494,0.0001,769,735,10,2,0.0001,1504,6
0.496,0.0001,818,786,10,2,0.0001,1604,6
0.496,0.0001,863,841,10,2,0.0001,1704,6
0.496,0.0001,916,888,10,2,0.0001,1804,6
0.496,0.0001,970,934,10,2,0.0001,1904,6
0.496,0.0001,1015,989,10,2,0.0001,2004,6
0.516,0.0001,58,46,10,2,0.0001,104,7
0.516,0.0001,112,92,10,2,0.0001,204,7
0.516,0.0001,163,141,10,2,0.0001,304,7
0.516,0.0001,213,191,10,2,0.0001,404,7
0.516,0.0001,255,249,10,2,0.0001,504,7
0.516,0.0001,309,295,10,2,0.0001,604,7
0.516,0.0001,366,338,10,2,0.0001,704,7
0.516,0.0001,407,397,10,2,0.0001,804,7
0.516,0.0001,464,440,10,2,0.0001,904,7
0.516,0.0001,517,487,10,2,0.0001,1004,7
0.516,0.0001,573,531,10,2,0.0001,1104,7
0.516,0.0001,627,577,10,2,0.0001,1204,7
0.516,0.0001,679,625,10,2,0.0001,1304,7
0.516,0.0001,726,678,10,2,0.0001,1404,7
0.516,0.0001,771,733,10,2,0.0001,1504,7
0.516,0.0001,815,789,10,2,0.0001,1604,7
0.516,0.0001,860,844,10,2,0.0001,1704,7
0.516,0.0001,908,896,10,2,0.0001,1804,7
0.516,0.0001,956,948,10,2,0.0001,1904,7
0.516,0.0001,1010,994,10,2,0.0001,2004,7
0.484,0.0001,49,55,10,2,0.0001,104,8
0.484,0.0001,100,104,10,2,0.0001,204,8
0.484,0.0001,154,150,10,2,0.0001,304,8
0.484,0.0001,205,199,10,2,0.0001,404,8
0.484,0.0001,256,248,10,2,0.0001,504,8
0.484,0.0001,300,304,10,2,0.0001,604,8
0.484,0.0001,347,357,10,2,0.0001,704,8
0.484,0.0001,389,415,10,2,0.0001,804,8
0.484,0.0001,437,467,10,2,0.0001,904,8
0.484,0.0001,485,519,10,2,0.0001,1004,8
0.484,0.0001,533,571,10,2,0.0001,1104,8
0.484,0.0001,583,621,10,2,0.0001,1204,8
0.484,0.0001,637,667,10,2,0.0001,1304,8
0.484,0.0001,684,720,10,2,0.0001,1404,8
0.484,0.0001,748,756,10,2,0.0001,1504,8
0.484,0.0001,802,802,10,2,0.0001,1604,8
0.484,0.0001,852,852,10,2,0.0001,1704,8
0.484,0.0001,902,902,10,2,0.0001,1804,8
0.484,0.0001,957,947,10,2,0.0001,1904,8
0.484,0.0001,1010,994,10,2,0.0001,2004,8
0.496,0.0001,56,48,10,2,0.0001,104,9
0.496,0.0001,105,99,10,2,0.0001,204,9
0.496,0.0001,158,146,10,2,0.0001,304,9
0.496,0.0001,207,197,10,2,0.0001,404,9
0.496,0.0001,254,250,10,2,0.0001,504,9
0.496,0.0001,302,302,10,2,0.0001,604,9
0.496,0.0001,352,352,10,2,0.0001,704,9
0.496,0.0001,406,398,10,2,0.0001,804,9
0.498,0.0001,449,455,10,2,0.0001,904,9
0.498,0.0001,490,514,10,2,0.0001,1004,9
0.498,0.0001,544,560,10,2,0.0001,1104,9
0.498,0.0001,593,611,10,2,0.0001,1204,9
0.498,0.0001,648,656,10,2,0.0001,1304,9
0.496,0.0001,705,699,10,2,0.0001,1404,9
0.494,0.0001,761,743,10,2,0.0001,1504,9
0.494,0.0001,807,797,10,2,0.0001,1604,9
0.494,0.0001,853,851,10,2,0.0001,1704,9
0.494,0.0001,909,895,10,2,0.0001,1804,9
0.494,0.0001,959,945,10,2,0.0001,1904,9
0.494,0.0001,1005,999,10,2,0.0001,2004,9
0.516,0.0001,43,61,10,2,0.0001,104,10
0.516,0.0001,97,107,10,2,0.0001,204,10
0.516,0.0001,144,160,10,2,0.0001,304,10
0.516,0.0001,196,208,10,2,0.0001,404,10
0.516,0.0001,248,256,10,2,0.0001,504,10
0.516,0.0001,302,302,10,2,0.0001,604,10
0.516,0.0001,352,352,10,2,0.0001,704,10
0.516,0.0001,399,405,10,2,0.0001,804,10
0.516,0.0001,451,453,10,2,0.0001,904,10
0.516,0.0001,502,502,10,2,0.0001,1004,10
0.516,0.0001,558,546,10,2,0.0001,1104,10
0.516,0.0001,610,594,10,2,0.0001,1204,10
0.516,0.0001,669,635,10,2,0.0001,1304,10
0.516,0.0001,719,685,10,2,0.0001,1404,10
0.516,0.0001,763,741,10,2,0.0001,1504,10
0.516,0.0001,808,796,10,2,0.0001,1604,10
0.516,0.0001,852,852,10,2,0.0001,1704,10
0.516,0.0001,901,903,10,2,0.0001,1804,10
0.516,0.0001,945,959,10,2,0.0001,1904,10
0.516,0.0001,994,1010,10,2,0.0001,2004,10
0.504,0.0001,52,52,10,2,0.0001,104,11
0.504,0.0001,95,109,10,2,0.0001,204,11
0.504,0.0001,145,159,10,2,0.0001,304,11
0.504,0.0001,192,212,10,2,0.0001,404,11
0.504,0.0001,238,266,10,2,0.0001,504,11
0.504,0.0001,290,314,10,2,0.0001,604,11
0.504,0.0001,336,368,10,2,0.0001,704,11
0.506,0.0001,386,418,10,2,0.0001,804,11
0.506,0.0001,446,458,10,2,0.0001,904,11
0.506,0.0001,494,510,10,2,0.0001,1004,11
0.506,0.0001,540,564,10,2,0.0001,1104,11
0.506,0.0001,593,611,10,2,0.0001,1204,11
0.506,0.0001,641,663,10,2,0.0001,1304,11
0.506,0.0001,699,705,10,2,0.0001,1404,11
0.506,0.0001,749,755,10,2,0.0001,1504,11
0.506,0.0001,791,813,10,2,0.0001,1604,11
0.506,0.0001,845,859,10,2,0.0001,1704,11
0.506,0.0001,893,911,10,2,0.0001,1804,11
0.506,0.0001,947,957,10,2,0.0001,1904,11
0.506,0.0001,1000,1004,10,2,0.0001,2004,11
0.524,0.0001,46,58,10,2,0.0001,104,12
0.524,0.0001,97,107,10,2,0.0001,204,12
0.524,0.0001,153,151,10,2,0.0001,304,12
0.524,0.0001,197,207,10,2,0.0001,404,12
0.524,0.0001,241,263,10,2,0.0001,504,12
0.524,0.0001,292,312,10,2,0.0001,604,12
0.524,0.0001,339,365,10,2,0.0001,704,12
0.524,0.0001,393,411,10,2,0.0001,804,12
0.524,0.0001,438,466,10,2,0.0001,904,12
0.524,0.0001,489,515,10,2,0.0001,1004,12
0.524,0.0001,543,561,10,2,0.0001,1104,12
0.524,0.0001,606,598,10,2,0.0001,1204,12
0.524,0.0001,655,649,10,2,0.0001,1304,12
0.524,0.0001,714,690,10,2,0.0001,1404,12
0.528,0.0001,763,741,10,2,0.0001,1504,12
0.526,0.0001,813,791,10,2,0.0001,1604,12
0.522,0.0001,859,845,10,2,0.0001,1704,12
0.522,0.0001,901,903,10,2,0.0001,1804,12
0.522,0.0001,951,953,10,2,0.0001,1904,12
0.52,0.0001,997,1007,10,2,0.0001,2004,12
0.506,0.0001,56,48,10,2,0.0001,104,13
0.506,0.0001,111,93,10,2,0.0001,204,13
0.506,0.0001,158,146,10,2,0.0001,304,13
0.508,0.0001,199,205,10,2,0.0001,404,13
0.508,0.0001,257,247,10,2,0.0001,504,13
0.508,0.0001,308,296,10,2,0.0001,604,13
0.508,0.0001,347,357,10,2,0.0001,704,13
0.508,0.0001,398,406,10,2,0.0001,804,13
0.508,0.0001,448,456,10,2,0.0001,904,13
0.508,0.0001,500,504,10,2,0.0001,1004,13
0.506,0.0001,551,553,10,2,0.0001,1104,13
0.506,0.0001,602,602,10,2,0.0001,1204,13
0.506,0.0001,646,658,10,2,0.0001,1304,13
0.506,0.0001,691,713,10,2,0.0001,1404,13
0.508,0.0001,739,765,10,2,0.0001,1504,13
0.508,0.0001,791,813,10,2,0.0001,1604,13
0.508,0.0001,846,858,10,2,0.0001,1704,13
0.508,0.0001,891,913,10,2,0.0001,1804,13
0.51,0.0001,947,957,10,2,0.0001,1904,13
0.51,0.0001,998,1006,10,2,0.0001,2004,13
0.556,0.0001,60,44,10,2,0.0001,104,14
0.556,0.0001,103,101,10,2,0.0001,204,14
0.556,0.0001,157,147,10,2,0.0001,304,14
0.556,0.0001,200,204,10,2,0.0001,404,14
0.556,0.0001,251,253,10,2,0.0001,504,14
0.558,0.0001,304,300,10,2,0.0001,604,14
0.558,0.0001,355,349,10,2,0.0001,704,14
0.558,0.0001,408,396,10,2,0.0001,804,14
0.558,0.0001,458,446,10,2,0.0001,904,14
0.558,0.0001,509,495,10,2,0.0001,1004,14
0.558,0.0001,555,549,10,2,0.0001,1104,14
0.558,0.0001,603,601,10,2,0.0001,1204,14
0.558,0.0001,649,655,10,2,0.0001,1304,14
0.558,0.0001,705,699,10,2,0.0001,1404,14
0.558,0.0001,751,753,10,2,0.0001,1504,14
0.558,0.0001,797,807,10,2,0.0001,1604,14
0.558,0.0001,848,856,10,2,0.0001,1704,14
0.558,0.0001,899,905,10,2,0.0001,1804,14
0.558,0.0001,957,947,10,2,0.0001,1904,14
0.558,0.0001,1011,993,10,2,0.0001,2004,14
0.52,0.0001,54,50,10,2,0.0001,104,15
0.52,0.0001,99,105,10,2,0.0001,204,15
0.52,0.0001,146,158,10,2,0.0001,304,15
0.52,0.0001,187,217,10,2,0.0001,404,15
0.52,0.0001,227,277,10,2,0.0001,504,15
0.52,0.0001,274,330,10,2,0.0001,604,15
0.52,0.0001,322,382,10,2,0.0001,704,15
0.52,0.0001,368,436,10,2,0.0001,804,15
0.52,0.0001,426,478,10,2,0.0001,904,15
0.52,0.0001,475,529,10,2,0.0001,1004,15
0.52,0.0001,524,580,10,2,0.0001,1104,15
0.52,0.0001,574,630,10,2,0.0001,1204,15
0.52,0.0001,627,677,10,2,0.0001,1304,15
0.52,0.0001,679,725,10,2,0.0001,1404,15
0.52,0.0001,735,769,10,2,0.0001,1504,15
0.52,0.0001,779,825,10,2,0.0001,1604,15
0.52,0.0001,843,861,10,2,0.0001,1704,15
0.52,0.0001,893,911,10,2,0.0001,1804,15
0.52,0.0001,954,950,10,2,0.0001,1904,15
0.52,0.0001,1012,992,10,2,0.0001,2004,15
0.53,0.0001,49,55,10,2,0.0001,104,16
0.53,0.0001,103,101,10,2,0.0001,204,16
0.53,0.0001,149,155,10,2,0.0001,304,16
0.53,0.0001,199,205,10,2,0.0001,404,16
0.53,0.0001,238,266,10,2,0.0001,504,16
0.53,0.0001,287,317,10,2,0.0001,604,16
0.53,0.0001,343,361,10,2,0.0001,704,16
0.53,0.0001,394,410,10,2,0.0001,804,16
0.53,0.0001,444,460,10,2,0.0001,904,16
0.53,0.0001,504,500,10,2,0.0001,1004,16
0.53,0.0001,558,546,10,2,0.0001,1104,16
0.53,0.0001,611,593,10,2,0.0001,1204,16
0.53,0.0001,662,642,10,2,0.0001,1304,16
0.53,0.0001,709,695,10,2,0.0001,1404,16
0.53,0.0001,760,744,10,2,0.0001,1504,16
0.53,0.0001,804,800,10,2,0.0001,1604,16
0.53,0.0001,851,853,10,2,0.0001,1704,16
0.53,0.0001,895,909,10,2,0.0001,1804,16
0.53,0.0001,941,963,10,2,0.0001,1904,16
0.53,0.0001,987,1017,10,2,0.0001,2004,16
0.504,0.0001,46,58,10,2,0.0001,104,17
0.504,0.0001,93,111,10,2,0.0001,204,17
0.504,0.0001,143,161,10,2,0.0001,304,17
0.504,0.0001,189,215,10,2,0.0001,404,17
0.504,0.0001,244,260,10,2,0.0001,504,17
0.504,0.0001,298,306,10,2,0.0001,604,17
0.504,0.0001,350,354,10,2,0.0001,704,17
0.504,0.0001,405,399,10,2,0.0001,804,17
0.504,0.0001,454,450,10,2,0.0001,904,17
0.504,0.0001,509,495,10,2,0.0001,1004,17
0.504,0.0001,559,545,10,2,0.0001,1104,17
0.504,0.0001,600,604,10,2,0.0001,1204,17
0.504,0.0001,653,651,10,2,0.0001,1304,17
0.504,0.0001,703,701,10,2,0.0001,1404,17
0.504,0.0001,752,752,10,2,0.0001,1504,17
0.504,0.0001,797,807,10,2,0.0001,1604,17
0.504,0.0001,849,855,10,2,0.0001,1704,17
0.504,0.0001,896,908,10,2,0.0001,1804,17
0.504,0.0001,941,963,10,2,0.0001,1904,17
0.504,0.0001,1000,1004,10,2,0.0001,2004,17
0.484,0.0001,47,57,10,2,0.0001,104,18
0.484,0.0001,104,100,10,2,0.0001,204,18
0.484,0.0001,159,145,10,2,0.0001,304,18
0.484,0.0001,214,190,10,2,0.0001,404,18
0.484,0.0001,257,247,10,2,0.0001,504,18
0.484,0.0001,309,295,10,2,0.0001,604,18
0.484,0.0001,361,343,10,2,0.0001,704,18
0.484,0.0001,415,389,10,2,0.0001,804,18
0.486,0.0001,460,444,10,2,0.0001,904,18
0.488,0.0001,513,491,10,2,0.0001,1004,18
0.488,0.0001,557,547,10,2,0.0001,1104,18
0.49,0.0001,606,598,10,2,0.0001,1204,18
0.49,0.0001,662,642,10,2,0.0001,1304,18
0.492,0.0001,718,686,10,2,0.0001,1404,18
0.492,0.0001,768,736,10,2,0.0001,1504,18
0.492,0.0001,820,784,10,2,0.0001,1604,18
0.492,0.0001,869,835,10,2,0.0001,1704,18
0.494,0.0001,916,888,10,2,0.0001,1804,18
0.492,0.0001,968,936,10,2,0.0001,1904,18
0.492,0.0001,1019,985,10,2,0.0001,2004,18
0.502,0.0001,53,51,10,2,0.0001,104,19
0.502,0.0001,109,95,10,2,0.0001,204,19
0.502,0.0001,157,147,10,2,0.0001,304,19
0.502,0.0001,207,197,10,2,0.0001,404,19
0.502,0.0001,264,240,10,2,0.0001,504,19
0.502,0.0001,312,292,10,2,0.0001,604,19
0.502,0.0001,365,339,10,2,0.0001,704,19
0.502,0.0001,413,391,10,2,0.0001,804,19
0.502,0.0001,454,450,10,2,0.0001,904,19
0.502,0.0001,506,498,10,2,0.0001,1004,19
0.502,0.0001,557,547,10,2,0.0001,1104,19
0.502,0.0001,603,601,10,2,0.0001,1204,19
0.502,0.0001,652,652,10,2,0.0001,1304,19
0.502,0.0001,703,701,10,2,0.0001,1404,19
0.502,0.0001,749,755,10,2,0.0001,1504,19
0.502,0.0001,794,810,10,2,0.0001,1604,19
0.502,0.0001,847,857,10,2,0.0001,1704,19
0.502,0.0001,902,902,10,2,0.0001,1804,19
0.502,0.0001,953,951,10,2,0.0001,1904,19
0.502,0.0001,1003,1001,10,2,0.0001,2004,19
0.506,0.0001,48,56,10,2,0.0001,104,20
0.506,0.0001,95,109,10,2,0.0001,204,20
0.506,0.0001,142,162,10,2,0.0001,304,20
0.508,0.0001,193,211,10,2,0.0001,404,20
0.508,0.0001,247,257,10,2,0.0001,504,20
0.508,0.0001,302,302,10,2,0.0001,604,20
0.508,0.0001,357,347,10,2,0.0001,704,20
0.506,0.0001,397,407,10,2,0.0001,804,20
0.506,0.0001,445,459,10,2,0.0001,904,20
0.506,0.0001,496,508,10,2,0.0001,1004,20
0.508,0.0001,553,551,10,2,0.0001,1104,20
0.508,0.0001,600,604,10,2,0.0001,1204,20
0.508,0.0001,654,650,10,2,0.0001,1304,20
0.506,0.0001,702,702,10,2,0.0001,1404,20
0.506,0.0001,751,753,10,2,0.0001,1504,20
0.504,0.0001,798,806,10,2,0.0001,1604,20
0.504,0.0001,845,859,10,2,0.0001,1704,20
0.506,0.0001,886,918,10,2,0.0001,1804,20
0.506,0.0001,941,963,10,2,0.0001,1904,20
0.504,0.0001,992,1012,10,2,0.0001,2004,20
0.494,0.0001,48,56,10,2,0.001,104,1
0.494,0.0001,98,106,10,2,0.001,204,1
0.494,0.0001,147,157,10,2,0.001,304,1
0.494,0.0001,192,212,10,2,0.001,404,1
0.494,0.0001,244,260,10,2,0.001,504,1
0.494,0.0001,299,305,10,2,0.001,604,1
0.494,0.0001,348,356,10,2,0.001,704,1
0.494,0.0001,405,399,10,2,0.001,804,1
0.494,0.0001,459,445,10,2,0.001,904,1
0.494,0.0001,511,493,10,2,0.001,1004,1
0.494,0.0001,553,551,10,2,0.001,1104,1
0.494,0.0001,601,603,10,2,0.001,1204,1
0.494,0.0001,649,655,10,2,0.001,1304,1
0.494,0.0001,698,706,10,2,0.001,1404,1
0.494,0.0001,753,751,10,2,0.001,1504,1
0.494,0.0001,806,798,10,2,0.001,1604,1
0.494,0.0001,857,847,10,2,0.001,1704,1
0.494,0.0001,908,896,10,2,0.001,1804,1
0.494,0.0001,952,952,10,2,0.001,1904,1
0.494,0.0001,1005,999,10,2,0.001,2004,1
0.478,0.0001,50,54,10,2,0.001,104,2
0.476,0.0001,100,104,10,2,0.001,204,2
0.48,0.0001,144,160,10,2,0.001,304,2
0.482,0.0001,186,218,10,2,0.001,404,2
0.484,0.0001,240,264,10,2,0.001,504,2
0.486,0.0001,288,316,10,2,0.001,604,2
0.488,0.0001,339,365,10,2,0.001,704,2
0.492,0.0001,394,410,10,2,0.001,804,2
0.49,0.0001,435,469,10,2,0.001,904,2
0.49,0.0001,489,515,10,2,0.001,1004,2
0.492,0.0001,536,568,10,2,0.001,1104,2
0.496,0.0001,581,623,10,2,0.001,1204,2
0.5,0.0001,633,671,10,2,0.001,1304,2
0.504,0.0001,688,716,10,2,0.001,1404,2
0.508,0.0001,734,770,10,2,0.001,1504,2
0.516,0.0001,782,822,10,2,0.001,1604,2
0.516,0.0001,839,865,10,2,0.001,1704,2
0.528,0.0001,886,918,10,2,0.001,1804,2
0.534,0.0001,930,974,10,2,0.001,1904,2
0.544,0.0001,981,1023,10,2,0.001,2004,2
0.472,0.0001,46,58,10,2,0.001,104,3
0.474,0.0001,100,104,10,2,0.001,204,3
0.474,0.0001,158,146,10,2,0.001,304,3
0.474,0.0001,209,195,10,2,0.001,404,3
0.474,0.0001,260,244,10,2,0.001,504,3
0.476,0.0001,304,300,10,2,0.001,604,3
0.474,0.0001,360,344,10,2,0.001,704,3
0.472,0.0001,409,395,10,2,0.001,804,3
0.472,0.0001,463,441,10,2,0.001,904,3
0.474,0.0001,511,493,10,2,0.001,1004,3
0.474,0.0001,563,541,10,2,0.001,1104,3
0.476,0.0001,611,593,10,2,0.001,1204,3
0.476,0.0001,657,647,10,2,0.001,1304,3
0.478,0.0001,704,700,10,2,0.001,1404,3
0.478,0.0001,762,742,10,2,0.001,1504,3
0.482,0.0001,811,793,10,2,0.001,1604,3
0.484,0.0001,859,845,10,2,0.001,1704,3
0.498,0.0001,905,899,10,2,0.001,1804,3
0.498,0.0001,954,950,10,2,0.001,1904,3
0.502,0.0001,1006,998,10,2,0.001,2004,3
0.49,0.0001,60,44,10,2,0.001,104,4
0.49,0.0001,104,100,10,2,0.001,204,4
0.49,0.0001,154,150,10,2,0.001,304,4
0.49,0.0001,208,196,10,2,0.001,404,4
0.49,0.0001,262,242,10,2,0.001,504,4
0.49,0.0001,313,291,10,2,0.001,604,4
0.49,0.0001,364,340,10,2,0.001,704,4
0.49,0.0001,412,392,10,2,0.001,804,4
0.49,0.0001,464,440,10,2,0.001,904,4
0.49,0.0001,513,491,10,2,0.001,1004,4
0.49,0.0001,554,550,10,2,0.001,1104,4
0.49,0.0001,606,598,10,2,0.001,1204,4
0.49,0.0001,657,647,10,2,0.001,1304,4
0.49,0.0001,701,703,10,2,0.001,1404,4
0.49,0.0001,747,757,10,2,0.001,1504,4
0.49,0.0001,796,808,10,2,0.001,1604,4
0.474,0.0001,850,854,10,2,0.001,1704,4
0.472,0.0001,900,904,10,2,0.001,1804,4
0.476,0.0001,949,955,10,2,0.001,1904,4
0.47,0.0001,997,1007,10,2,0.001,2004,4
0.496,0.0001,44,60,10,2,0.001,104,5
0.496,0.0001,99,105,10,2,0.001,204,5
0.498,0.0001,146,158,10,2,0.001,304,5
0.498,0.0001,193,211,10,2,0.001,404,5
0.498,0.0001,235,269,10,2,0.001,504,5
0.498,0.0001,290,314,10,2,0.001,604,5
0.502,0.0001,340,364,10,2,0.001,704,5
0.5,0.0001,389,415,10,2,0.001,804,5
0.5,0.0001,434,470,10,2,0.001,904,5
0.508,0.0001,490,514,10,2,0.001,1004,5
0.51,0.0001,539,565,10,2,0.001,1104,5
0.512,0.0001,594,610,10,2,0.001,1204,5
0.518,0.0001,648,656,10,2,0.001,1304,5
0.524,0.0001,699,705,10,2,0.001,1404,5
0.526,0.0001,753,751,10,2,0.001,1504,5
0.528,0.0001,803,801,10,2,0.001,1604,5
0.532,0.0001,857,847,10,2,0.001,1704,5
0.53,0.0001,907,897,10,2,0.001,1804,5
0.532,0.0001,954,950,10,2,0.001,1904,5
0.536,0.0001,1000,1004,10,2,0.001,2004,5
0.512,0.0001,59,45,10,2,0.001,104,6
0.512,0.0001,106,98,10,2,0.001,204,6
0.512,0.0001,153,151,10,2,0.001,304,6
0.512,0.0001,205,199,10,2,0.001,404,6
0.512,0.0001,257,247,10,2,0.001,504,6
0.512,0.0001,315,289,10,2,0.001,604,6
0.512,0.0001,364,340,10,2,0.001,704,6
0.512,0.0001,407,397,10,2,0.001,804,6
0.512,0.0001,461,443,10,2,0.001,904,6
0.512,0.0001,510,494,10,2,0.001,1004,6
0.512,0.0001,558,546,10,2,0.001,1104,6
0.512,0.0001,608,596,10,2,0.001,1204,6
0.512,0.0001,656,648,10,2,0.001,1304,6
0.512,0.0001,707,697,10,2,0.001,1404,6
0.512,0.0001,751,753,10,2,0.001,1504,6
0.512,0.0001,800,804,10,2,0.001,1604,6
0.512,0.0001,857,847,10,2,0.001,1704,6
0.512,0.0001,909,895,10,2,0.001,1804,6
0.512,0.0001,969,935,10,2,0.001,1904,6
0.512,0.0001,1008,996,10,2,0.001,2004,6
0.5,0.0001,64,40,10,2,0.001,104,7
0.5,0.0001,117,87,10,2,0.001,204,7
0.5,0.0001,163,141,10,2,0.001,304,7
0.5,0.0001,209,195,10,2,0.001,404,7
0.5,0.0001,261,243,10,2,0.001,504,7
0.5,0.0001,305,299,10,2,0.001,604,7
0.5,0.0001,357,347,10,2,0.001,704,7
0.5,0.0001,417,387,10,2,0.001,804,7
0.5,0.0001,465,439,10,2,0.001,904,7
0.5,0.0001,515,489,10,2,0.001,1004,7
0.5,0.0001,566,538,10,2,0.001,1104,7
0.5,0.0001,604,600,10,2,0.001,1204,7
0.5,0.0001,653,651,10,2,0.001,1304,7
0.5,0.0001,706,698,10,2,0.001,1404,7
0.5,0.0001,757,747,10,2,0.001,1504,7
0.5,0.0001,799,805,10,2,0.001,1604,7
0.5,0.0001,849,855,10,2,0.001,1704,7
0.5,0.0001,900,904,10,2,0.001,1804,7
0.5,0.0001,948,956,10,2,0.001,1904,7
0.5,0.0001,1002,1002,10,2,0.001,2004,7
0.474,0.0001,56,48,10,2,0.001,104,8
0.474,0.0001,103,101,10,2,0.001,204,8
0.474,0.0001,161,143,10,2,0.001,304,8
0.474,0.0001,208,196,10,2,0.001,404,8
0.474,0.0001,261,243,10,2,0.001,504,8
0.476,0.0001,307,297,10,2,0.001,604,8
0.474,0.0001,350,354,10,2,0.001,704,8
0.476,0.0001,405,399,10,2,0.001,804,8
0.478,0.0001,465,439,10,2,0.001,904,8
0.478,0.0001,519,485,10,2,0.001,1004,8
0.482,0.0001,566,538,10,2,0.001,1104,8
0.482,0.0001,616,588,10,2,0.001,1204,8
0.484,0.0001,662,642,10,2,0.001,1304,8
0.486,0.0001,710,694,10,2,0.001,1404,8
0.488,0.0001,763,741,10,2,0.001,1504,8
0.492,0.0001,819,785,10,2,0.001,1604,8
0.494,0.0001,868,836,10,2,0.001,1704,8
0.498,0.0001,922,882,10,2,0.001,1804,8
0.5,0.0001,971,933,10,2,0.001,1904,8
0.498,0.0001,1015,989,10,2,0.001,2004,8
0.494,0.0001,49,55,10,2,0.001,104,9
0.494,0.0001,107,97,10,2,0.001,204,9
0.494,0.0001,157,147,10,2,0.001,304,9
0.494,0.0001,202,202,10,2,0.001,404,9
0.494,0.0001,252,252,10,2,0.001,504,9
0.494,0.0001,310,294,10,2,0.001,604,9
0.492,0.0001,357,347,10,2,0.001,704,9
0.492,0.0001,399,405,10,2,0.001,804,9
0.492,0.0001,450,454,10,2,0.001,904,9
0.494,0.0001,498,506,10,2,0.001,1004,9
0.494,0.0001,547,557,10,2,0.001,1104,9
0.494,0.0001,585,619,10,2,0.001,1204,9
0.496,0.0001,638,666,10,2,0.001,1304,9
0.498,0.0001,684,720,10,2,0.001,1404,9
0.498,0.0001,737,767,10,2,0.001,1504,9
0.5,0.0001,787,817,10,2,0.001,1604,9
0.5,0.0001,840,864,10,2,0.001,1704,9
0.5,0.0001,900,904,10,2,0.001,1804,9
0.5,0.0001,951,953,10,2,0.001,1904,9
0.502,0.0001,999,1005,10,2,0.001,2004,9
0.464,0.0001,50,54,10,2,0.001,104,10
0.464,0.0001,101,103,10,2,0.001,204,10
0.464,0.0001,152,152,10,2,0.001,304,10
0.464,0.0001,203,201,10,2,0.001,404,10
0.464,0.0001,251,253,10,2,0.001,504,10
0.464,0.0001,300,304,10,2,0.001,604,10
0.464,0.0001,353,351,10,2,0.001,704,10
0.464,0.0001,398,406,10,2,0.001,804,10
0.464,0.0001,450,454,10,2,0.001,904,10
0.464,0.0001,504,500,10,2,0.001,1004,10
0.464,0.0001,555,549,10,2,0.001,1104,10
0.464,0.0001,609,595,10,2,0.001,1204,10
0.464,0.0001,660,644,10,2,0.001,1304,10
0.464,0.0001,717,687,10,2,0.001,1404,10
0.464,0.0001,762,742,10,2,0.001,1504,10
0.464,0.0001,816,788,10,2,0.001,1604,10
0.464,0.0001,869,835,10,2,0.001,1704,10
0.464,0.0001,915,889,10,2,0.001,1804,10
0.464,0.0001,966,938,10,2,0.001,1904,10
0.464,0.0001,1020,984,10,2,0.001,2004,10
0.5,0.0001,55,49,10,2,0.001,104,11
0.5,0.0001,107,97,10,2,0.001,204,11
0.5,0.0001,153,151,10,2,0.001,304,11
0.5,0.0001,211,193,10,2,0.001,404,11
0.5,0.0001,254,250,10,2,0.001,504,11
0.5,0.0001,314,290,10,2,0.001,604,11
0.5,0.0001,354,350,10,2,0.001,704,11
0.5,0.0001,406,398,10,2,0.001,804,11
0.5,0.0001,466,438,10,2,0.001,904,11
0.5,0.0001,514,490,10,2,0.001,1004,11
0.5,0.0001,561,543,10,2,0.001,1104,11
0.5,0.0001,612,592,10,2,0.001,1204,11
0.5,0.0001,654,650,10,2,0.001,1304,11
0.5,0.0001,700,704,10,2,0.001,1404,11
0.5,0.0001,753,751,10,2,0.001,1504,11
0.496,0.0001,812,792,10,2,0.001,1604,11
0.498,0.0001,854,850,10,2,0.001,1704,11
0.5,0.0001,903,901,10,2,0.001,1804,11
0.502,0.0001,953,951,10,2,0.001,1904,11
0.502,0.0001,1002,1002,10,2,0.001,2004,11
0.496,0.0001,49,55,10,2,0.001,104,12
0.496,0.0001,106,98,10,2,0.001,204,12
0.496,0.0001,154,150,10,2,0.001,304,12
0.496,0.0001,202,202,10,2,0.001,404,12
0.496,0.0001,250,254,10,2,0.001,504,12
0.496,0.0001,294,310,10,2,0.001,604,12
0.496,0.0001,341,363,10,2,0.001,704,12
0.496,0.0001,389,415,10,2,0.001,804,12
0.496,0.0001,434,470,10,2,0.001,904,12
0.496,0.0001,485,519,10,2,0.001,1004,12
0.496,0.0001,542,562,10,2,0.001,1104,12
0.496,0.0001,594,610,10,2,0.001,1204,12
0.496,0.0001,642,662,10,2,0.001,1304,12
0.496,0.0001,689,715,10,2,0.001,1404,12
0.496,0.0001,740,764,10,2,0.001,1504,12
0.496,0.0001,795,809,10,2,0.001,1604,12
0.496,0.0001,848,856,10,2,0.001,1704,12
0.496,0.0001,893,911,10,2,0.001,1804,12
0.496,0.0001,942,962,10,2,0.001,1904,12
0.496,0.0001,1000,1004,10,2,0.001,2004,12
0.442,0.0001,54,50,10,2,0.001,104,13
0.444,0.0001,111,93,10,2,0.001,204,13
0.444,0.0001,162,142,10,2,0.001,304,13
0.448,0.0001,215,189,10,2,0.001,404,13
0.446,0.0001,258,246,10,2,0.001,504,13
0.444,0.0001,308,296,10,2,0.001,604,13
0.444,0.0001,350,354,10,2,0.001,704,13
0.446,0.0001,403,401,10,2,0.001,804,13
0.444,0.0001,454,450,10,2,0.001,904,13
0.446,0.0001,499,505,10,2,0.001,1004,13
0.444,0.0001,551,553,10,2,0.001,1104,13
0.444,0.0001,609,595,10,2,0.001,1204,13
0.45,0.0001,655,649,10,2,0.001,1304,13
0.454,0.0001,702,702,10,2,0.001,1404,13
0.46,0.0001,752,752,10,2,0.001,1504,13
0.472,0.0001,805,799,10,2,0.001,1604,13
0.472,0.0001,855,849,10,2,0.001,1704,13
0.478,0.0001,914,890,10,2,0.001,1804,13
0.496,0.0001,959,945,10,2,0.001,1904,13
0.502,0.0001,1010,994,10,2,0.001,2004,13
0.502,0.0001,57,47,10,2,0.001,104,14
0.502,0.0001,108,96,10,2,0.001,204,14
0.502,0.0001,151,153,10,2,0.001,304,14
0.502,0.0001,200,204,10,2,0.001,404,14
0.502,0.0001,257,247,10,2,0.001,504,14
0.502,0.0001,312,292,10,2,0.001,604,14
0.502,0.0001,359,345,10,2,0.001,704,14
0.502,0.0001,406,398,10,2,0.001,804,14
0.502,0.0001,455,449,10,2,0.001,904,14
0.502,0.0001,497,507,10,2,0.001,1004,14
0.502,0.0001,547,557,10,2,0.001,1104,14
0.502,0.0001,598,606,10,2,0.001,1204,14
0.502,0.0001,653,651,10,2,0.001,1304,14
0.502,0.0001,700,704,10,2,0.001,1404,14
0.502,0.0001,753,751,10,2,0.001,1504,14
0.502,0.0001,812,792,10,2,0.001,1604,14
0.502,0.0001,857,847,10,2,0.001,1704,14
0.502,0.0001,910,894,10,2,0.001,1804,14
0.502,0.0001,956,948,10,2,0.001,1904,14
0.502,0.0001,1003,1001,10,2,0.001,2004,14
0.5,0.0001,52,52,10,2,0.001,104,15
0.498,0.0001,106,98,10,2,0.001,204,15
0.498,0.0001,152,152,10,2,0.001,304,15
0.498,0.0001,201,203,10,2,0.001,404,15
0.498,0.0001,250,254,10,2,0.001,504,15
0.496,0.0001,307,297,10,2,0.001,604,15
0.494,0.0001,359,345,10,2,0.001,704,15
0.496,0.0001,401,403,10,2,0.001,804,15
0.496,0.0001,443,461,10,2,0.001,904,15
0.494,0.0001,493,511,10,2,0.001,1004,15
0.494,0.0001,547,557,10,2,0.001,1104,15
0.494,0.0001,597,607,10,2,0.001,1204,15
0.49,0.0001,646,658,10,2,0.001,1304,15
0.49,0.0001,705,699,10,2,0.001,1404,15
0.49,0.0001,758,746,10,2,0.001,1504,15
0.488,0.0001,807,797,10,2,0.001,1604,15
0.488,0.0001,853,851,10,2,0.001,1704,15
0.488,0.0001,905,899,10,2,0.001,1804,15
0.486,0.0001,955,949,10,2,0.001,1904,15
0.486,0.0001,1010,994,10,2,0.001,2004,15
0.5,0.0001,52,52,10,2,0.001,104,16
0.5,0.0001,105,99,10,2,0.001,204,16
0.5,0.0001,163,141,10,2,0.001,304,16
0.5,0.0001,216,188,10,2,0.001,404,16
0.5,0.0001,267,237,10,2,0.001,504,16
0.5,0.0001,317,287,10,2,0.001,604,16
0.5,0.0001,370,334,10,2,0.001,704,16
0.5,0.0001,421,383,10,2,0.001,804,16
0.5,0.0001,464,440,10,2,0.001,904,16
0.5,0.0001,518,486,10,2,0.001,1004,16
0.5,0.0001,571,533,10,2,0.001,1104,16
0.5,0.0001,624,580,10,2,0.001,1204,16
0.5,0.0001,664,640,10,2,0.001,1304,16
0.5,0.0001,709,695,10,2,0.001,1404,16
0.5,0.0001,759,745,10,2,0.001,1504,16
0.5,0.0001,801,803,10,2,0.001,1604,16
0.5,0.0001,855,849,10,2,0.001,1704,16
0.5,0.0001,903,901,10,2,0.001,1804,16
0.5,0.0001,959,945,10,2,0.001,1904,16
0.5,0.0001,1002,1002,10,2,0.001,2004,16
0.558,0.0001,51,53,10,2,0.001,104,17
0.558,0.0001,106,98,10,2,0.001,204,17
0.56,0.0001,155,149,10,2,0.001,304,17
0.56,0.0001,196,208,10,2,0.001,404,17
0.56,0.0001,251,253,10,2,0.001,504,17
0.562,0.0001,296,308,10,2,0.001,604,17
0.562,0.0001,345,359,10,2,0.001,704,17
0.562,0.0001,392,412,10,2,0.001,804,17
0.564,0.0001,438,466,10,2,0.001,904,17
0.564,0.0001,491,513,10,2,0.001,1004,17
0.564,0.0001,549,555,10,2,0.001,1104,17
0.564,0.0001,597,607,10,2,0.001,1204,17
0.566,0.0001,653,651,10,2,0.001,1304,17
0.572,0.0001,703,701,10,2,0.001,1404,17
0.58,0.0001,754,750,10,2,0.001,1504,17
0.58,0.0001,796,808,10,2,0.001,1604,17
0.59,0.0001,849,855,10,2,0.001,1704,17
0.592,0.0001,902,902,10,2,0.001,1804,17
0.598,0.0001,955,949,10,2,0.001,1904,17
0.598,0.0001,1009,995,10,2,0.001,2004,17
0.498,0.0001,47,57,10,2,0.001,104,18
0.498,0.0001,99,105,10,2,0.001,204,18
0.5,0.0001,145,159,10,2,0.001,304,18
0.502,0.0001,198,206,10,2,0.001,404,18
0.504,0.0001,259,245,10,2,0.001,504,18
0.506,0.0001,310,294,10,2,0.001,604,18
0.506,0.0001,359,345,10,2,0.001,704,18
0.506,0.0001,408,396,10,2,0.001,804,18
0.506,0.0001,446,458,10,2,0.001,904,18
0.506,0.0001,496,508,10,2,0.001,1004,18
0.51,0.0001,548,556,10,2,0.001,1104,18
0.514,0.0001,593,611,10,2,0.001,1204,18
0.512,0.0001,647,657,10,2,0.001,1304,18
0.516,0.0001,698,706,10,2,0.001,1404,18
0.518,0.0001,748,756,10,2,0.001,1504,18
0.52,0.0001,800,804,10,2,0.001,1604,18
0.522,0.0001,846,858,10,2,0.001,1704,18
0.53,0.0001,901,903,10,2,0.001,1804,18
0.54,0.0001,947,957,10,2,0.001,1904,18
0.558,0.0001,1002,1002,10,2,0.001,2004,18
0.502,0.0001,54,50,10,2,0.001,104,19
0.504,0.0001,97,107,10,2,0.001,204,19
0.504,0.0001,141,163,10,2,0.001,304,19
0.498,0.0001,198,206,10,2,0.001,404,19
0.5,0.0001,253,251,10,2,0.001,504,19
0.5,0.0001,296,308,10,2,0.001,604,19
0.5,0.0001,346,358,10,2,0.001,704,19
0.494,0.0001,394,410,10,2,0.001,804,19
0.496,0.0001,450,454,10,2,0.001,904,19
0.496,0.0001,496,508,10,2,0.001,1004,19
0.5,0.0001,546,558,10,2,0.001,1104,19
0.496,0.0001,596,608,10,2,0.001,1204,19
0.496,0.0001,645,659,10,2,0.001,1304,19
0.498,0.0001,697,707,10,2,0.001,1404,19
0.498,0.0001,743,761,10,2,0.001,1504,19
0.5,0.0001,787,817,10,2,0.001,1604,19
0.5,0.0001,836,868,10,2,0.001,1704,19
0.504,0.0001,896,908,10,2,0.001,1804,19
0.506,0.0001,953,951,10,2,0.001,1904,19
0.504,0.0001,1000,1004,10,2,0.001,2004,19
0.476,0.0001,49,55,10,2,0.001,104,20
0.476,0.0001,102,102,10,2,0.001,204,20
0.476,0.0001,150,154,10,2,0.001,304,20
0.476,0.0001,197,207,10,2,0.001,404,20
0.476,0.0001,237,267,10,2,0.001,504,20
0.476,0.0001,288,316,10,2,0.001,604,20
0.476,0.0001,344,360,10,2,0.001,704,20
0.478,0.0001,392,412,10,2,0.001,804,20
0.48,0.0001,445,459,10,2,0.001,904,20
0.48,0.0001,506,498,10,2,0.001,1004,20
0.48,0.0001,554,550,10,2,0.001,1104,20
0.482,0.0001,614,590,10,2,0.001,1204,20
0.482,0.0001,662,642,10,2,0.001,1304,20
0.48,0.0001,707,697,10,2,0.001,1404,20
0.48,0.0001,755,749,10,2,0.001,1504,20
0.482,0.0001,806,798,10,2,0.001,1604,20
0.482,0.0001,846,858,10,2,0.001,1704,20
0.484,0.0001,893,911,10,2,0.001,1804,20
0.484,0.0001,940,964,10,2,0.001,1904,20
0.484,0.0001,990,1014,10,2,0.001,2004,20
0.484,0.0001,61,43,10,2,0.01,104,1
0.486,0.0001,119,85,10,2,0.01,204,1
0.49,0.0001,176,128,10,2,0.01,304,1
0.49,0.0001,223,181,10,2,0.01,404,1
0.492,0.0001,264,240,10,2,0.01,504,1
0.494,0.0001,312,292,10,2,0.01,604,1
0.496,0.0001,359,345,10,2,0.01,704,1
0.512,0.0001,412,392,10,2,0.01,804,1
0.522,0.0001,461,443,10,2,0.01,904,1
0.542,0.0001,508,496,10,2,0.01,1004,1
0.546,0.0001,547,557,10,2,0.01,1104,1
0.558,0.0001,600,604,10,2,0.01,1204,1
0.56,0.0001,647,657,10,2,0.01,1304,1
0.572,0.0001,700,704,10,2,0.01,1404,1
0.57,0.0001,758,746,10,2,0.01,1504,1
0.57,0.0001,808,796,10,2,0.01,1604,1
0.564,0.0001,860,844,10,2,0.01,1704,1
0.574,0.0001,914,890,10,2,0.01,1804,1
0.574,0.0001,961,943,10,2,0.01,1904,1
0.574,0.0001,1007,997,10,2,0.01,2004,1
0.528,0.0001,56,48,10,2,0.01,104,2
0.53,0.0001,104,100,10,2,0.01,204,2
0.53,0.0001,159,145,10,2,0.01,304,2
0.53,0.0001,203,201,10,2,0.01,404,2
0.532,0.0001,260,244,10,2,0.01,504,2
0.524,0.0001,308,296,10,2,0.01,604,2
0.53,0.0001,361,343,10,2,0.01,704,2
0.524,0.0001,415,389,10,2,0.01,804,2
0.53,0.0001,468,436,10,2,0.01,904,2
0.532,0.0001,507,497,10,2,0.01,1004,2
0.528,0.0001,568,536,10,2,0.01,1104,2
0.534,0.0001,615,589,10,2,0.01,1204,2
0.542,0.0001,662,642,10,2,0.01,1304,2
0.544,0.0001,715,689,10,2,0.01,1404,2
0.556,0.0001,767,737,10,2,0.01,1504,2
0.564,0.0001,807,797,10,2,0.01,1604,2
0.566,0.0001,862,842,10,2,0.01,1704,2
0.574,0.0001,906,898,10,2,0.01,1804,2
0.578,0.0001,956,948,10,2,0.01,1904,2
0.582,0.0001,1002,1002,10,2,0.01,2004,2
0.482,0.0001,60,44,10,2,0.01,104,3
0.484,0.0001,105,99,10,2,0.01,204,3
0.482,0.0001,160,144,10,2,0.01,304,3
0.48,0.0001,213,191,10,2,0.01,404,3
0.478,0.0001,262,242,10,2,0.01,504,3
0.486,0.0001,312,292,10,2,0.01,604,3
0.508,0.0001,363,341,10,2,0.01,704,3
0.532,0.0001,414,390,10,2,0.01,804,3
0.56,0.0001,454,450,10,2,0.01,904,3
0.618,0.0001,506,498,10,2,0.01,1004,3
0.694,0.0001,565,539,10,2,0.01,1104,3
0.722,0.0001,610,594,10,2,0.01,1204,3
0.748,0.0001,655,649,10,2,0.01,1304,3
0.78,0.0001,707,697,10,2,0.01,1404,3
0.78,0.0001,755,749,10,2,0.01,1504,3
0.82,0.0001,805,799,10,2,0.01,1604,3
0.836,0.0001,855,849,10,2,0.01,1704,3
0.856,0.0001,913,891,10,2,0.01,1804,3
0.858,0.0001,970,934,10,2,0.01,1904,3
0.874,0.0001,1015,989,10,2,0.01,2004,3
0.48,0.0001,45,59,10,2,0.01,104,4
0.488,0.0001,90,114,10,2,0.01,204,4
0.508,0.0001,135,169,10,2,0.01,304,4
0.518,0.0001,189,215,10,2,0.01,404,4
0.528,0.0001,237,267,10,2,0.01,504,4
0.522,0.0001,296,308,10,2,0.01,604,4
0.536,0.0001,343,361,10,2,0.01,704,4
0.522,0.0001,397,407,10,2,0.01,804,4
0.526,0.0001,455,449,10,2,0.01,904,4
0.526,0.0001,501,503,10,2,0.01,1004,4
0.534,0.0001,550,554,10,2,0.01,1104,4
0.524,0.0001,598,606,10,2,0.01,1204,4
0.514,0.0001,646,658,10,2,0.01,1304,4
0.516,0.0001,691,713,10,2,0.01,1404,4
0.538,0.0001,739,765,10,2,0.01,1504,4
0.558,0.0001,802,802,10,2,0.01,1604,4
0.558,0.0001,849,855,10,2,0.01,1704,4
0.558,0.0001,900,904,10,2,0.01,1804,4
0.556,0.0001,946,958,10,2,0.01,1904,4
0.57,0.0001,1002,1002,10,2,0.01,2004,4
0.51,0.0001,56,48,10,2,0.01,104,5
0.512,0.0001,110,94,10,2,0.01,204,5
0.516,0.0001,168,136,10,2,0.01,304,5
0.52,0.0001,210,194,10,2,0.01,404,5
0.528,0.0001,255,249,10,2,0.01,504,5
0.538,0.0001,302,302,10,2,0.01,604,5
0.556,0.0001,356,348,10,2,0.01,704,5
0.558,0.0001,408,396,10,2,0.01,804,5
0.562,0.0001,455,449,10,2,0.01,904,5
0.494,0.0001,508,496,10,2,0.01,1004,5
0.502,0.0001,556,548,10,2,0.01,1104,5
0.504,0.0001,608,596,10,2,0.01,1204,5
0.506,0.0001,659,645,10,2,0.01,1304,5
0.506,0.0001,720,684,10,2,0.01,1404,5
0.522,0.0001,766,738,10,2,0.01,1504,5
0.528,0.0001,822,782,10,2,0.01,1604,5
0.546,0.0001,865,839,10,2,0.01,1704,5
0.558,0.0001,920,884,10,2,0.01,1804,5
0.576,0.0001,969,935,10,2,0.01,1904,5
0.578,0.0001,1020,984,10,2,0.01,2004,5
0.514,0.0001,52,52,10,2,0.01,104,6
0.514,0.0001,103,101,10,2,0.01,204,6
0.516,0.0001,155,149,10,2,0.01,304,6
0.518,0.0001,208,196,10,2,0.01,404,6
0.526,0.0001,257,247,10,2,0.01,504,6
0.528,0.0001,300,304,10,2,0.01,604,6
0.528,0.0001,353,351,10,2,0.01,704,6
0.524,0.0001,403,401,10,2,0.01,804,6
0.54,0.0001,446,458,10,2,0.01,904,6
0.532,0.0001,487,517,10,2,0.01,1004,6
0.544,0.0001,543,561,10,2,0.01,1104,6
0.548,0.0001,600,604,10,2,0.01,1204,6
0.552,0.0001,655,649,10,2,0.01,1304,6
0.566,0.0001,700,704,10,2,0.01,1404,6
0.564,0.0001,757,747,10,2,0.01,1504,6
0.588,0.0001,811,793,10,2,0.01,1604,6
0.598,0.0001,862,842,10,2,0.01,1704,6
0.608,0.0001,909,895,10,2,0.01,1804,6
0.618,0.0001,958,946,10,2,0.01,1904,6
0.714,0.0001,1001,1003,10,2,0.01,2004,6
0.566,0.0001,50,54,10,2,0.01,104,7
0.58,0.0001,103,101,10,2,0.01,204,7
0.598,0.0001,153,151,10,2,0.01,304,7
0.618,0.0001,208,196,10,2,0.01,404,7
0.624,0.0001,262,242,10,2,0.01,504,7
0.634,0.0001,318,286,10,2,0.01,604,7
0.646,0.0001,373,331,10,2,0.01,704,7
0.684,0.0001,416,388,10,2,0.01,804,7
0.71,0.0001,462,442,10,2,0.01,904,7
0.746,0.0001,517,487,10,2,0.01,1004,7
0.778,0.0001,560,544,10,2,0.01,1104,7
0.824,0.0001,604,600,10,2,0.01,1204,7
0.836,0.0001,649,655,10,2,0.01,1304,7
0.858,0.0001,710,694,10,2,0.01,1404,7
0.87,0.0001,762,742,10,2,0.01,1504,7
0.878,0.0001,814,790,10,2,0.01,1604,7
0.882,0.0001,869,835,10,2,0.01,1704,7
0.888,0.0001,922,882,10,2,0.01,1804,7
0.896,0.0001,963,941,10,2,0.01,1904,7
0.9,0.0001,1011,993,10,2,0.01,2004,7
0.5,0.0001,49,55,10,2,0.01,104,8
0.5,0.0001,91,113,10,2,0.01,204,8
0.5,0.0001,150,154,10,2,0.01,304,8
0.5,0.0001,200,204,10,2,0.01,404,8
0.5,0.0001,256,248,10,2,0.01,504,8
0.5,0.0001,313,291,10,2,0.01,604,8
0.502,0.0001,366,338,10,2,0.01,704,8
0.514,0.0001,414,390,10,2,0.01,804,8
0.504,0.0001,468,436,10,2,0.01,904,8
0.506,0.0001,519,485,10,2,0.01,1004,8
0.54,0.0001,563,541,10,2,0.01,1104,8
0.554,0.0001,607,597,10,2,0.01,1204,8
0.568,0.0001,656,648,10,2,0.01,1304,8
0.564,0.0001,707,697,10,2,0.01,1404,8
0.58,0.0001,753,751,10,2,0.01,1504,8
0.608,0.0001,807,797,10,2,0.01,1604,8
0.634,0.0001,850,854,10,2,0.01,1704,8
0.64,0.0001,904,900,10,2,0.01,1804,8
0.652,0.0001,959,945,10,2,0.01,1904,8
0.666,0.0001,1002,1002,10,2,0.01,2004,8
0.482,0.0001,56,48,10,2,0.01,104,9
0.49,0.0001,103,101,10,2,0.01,204,9
0.48,0.0001,154,150,10,2,0.01,304,9
0.47,0.0001,208,196,10,2,0.01,404,9
0.504,0.0001,262,242,10,2,0.01,504,9
0.516,0.0001,306,298,10,2,0.01,604,9
0.532,0.0001,352,352,10,2,0.01,704,9
0.528,0.0001,405,399,10,2,0.01,804,9
0.528,0.0001,447,457,10,2,0.01,904,9
0.54,0.0001,497,507,10,2,0.01,1004,9
0.544,0.0001,549,555,10,2,0.01,1104,9
0.55,0.0001,595,609,10,2,0.01,1204,9
0.592,0.0001,644,660,10,2,0.01,1304,9
0.634,0.0001,699,705,10,2,0.01,1404,9
0.624,0.0001,753,751,10,2,0.01,1504,9
0.648,0.0001,805,799,10,2,0.01,1604,9
0.668,0.0001,857,847,10,2,0.01,1704,9
0.682,0.0001,900,904,10,2,0.01,1804,9
0.684,0.0001,948,956,10,2,0.01,1904,9
0.682,0.0001,1011,993,10,2,0.01,2004,9
0.56,0.0001,57,47,10,2,0.01,104,10
0.57,0.0001,108,96,10,2,0.01,204,10
0.574,0.0001,165,139,10,2,0.01,304,10
0.57,0.0001,219,185,10,2,0.01,404,10
0.596,0.0001,267,237,10,2,0.01,504,10
0.616,0.0001,318,286,10,2,0.01,604,10
0.642,0.0001,360,344,10,2,0.01,704,10
0.654,0.0001,410,394,10,2,0.01,804,10
0.668,0.0001,457,447,10,2,0.01,904,10
0.672,0.0001,504,500,10,2,0.01,1004,10
0.682,0.0001,560,544,10,2,0.01,1104,10
0.7,0.0001,606,598,10,2,0.01,1204,10
0.71,0.0001,643,661,10,2,0.01,1304,10
0.71,0.0001,695,709,10,2,0.01,1404,10
0.714,0.0001,746,758,10,2,0.01,1504,10
0.716,0.0001,797,807,10,2,0.01,1604,10
0.716,0.0001,849,855,10,2,0.01,1704,10
0.718,0.0001,902,902,10,2,0.01,1804,10
0.716,0.0001,950,954,10,2,0.01,1904,10
0.716,0.0001,1003,1001,10,2,0.01,2004,10
0.536,0.0001,59,45,10,2,0.01,104,11
0.538,0.0001,101,103,10,2,0.01,204,11
0.54,0.0001,147,157,10,2,0.01,304,11
0.538,0.0001,196,208,10,2,0.01,404,11
0.54,0.0001,247,257,10,2,0.01,504,11
0.546,0.0001,306,298,10,2,0.01,604,11
0.556,0.0001,364,340,10,2,0.01,704,11
0.566,0.0001,418,386,10,2,0.01,804,11
0.582,0.0001,462,442,10,2,0.01,904,11
0.6,0.0001,517,487,10,2,0.01,1004,11
0.606,0.0001,568,536,10,2,0.01,1104,11
0.62,0.0001,611,593,10,2,0.01,1204,11
0.632,0.0001,660,644,10,2,0.01,1304,11
0.666,0.0001,704,700,10,2,0.01,1404,11
0.684,0.0001,767,737,10,2,0.01,1504,11
0.72,0.0001,815,789,10,2,0.01,1604,11
0.738,0.0001,855,849,10,2,0.01,1704,11
0.74,0.0001,911,893,10,2,0.01,1804,11
0.758,0.0001,963,941,10,2,0.01,1904,11
0.758,0.0001,1020,984,10,2,0.01,2004,11
0.522,0.0001,46,58,10,2,0.01,104,12
0.522,0.0001,91,113,10,2,0.01,204,12
0.528,0.0001,132,172,10,2,0.01,304,12
0.54,0.0001,174,230,10,2,0.01,404,12
0.542,0.0001,224,280,10,2,0.01,504,12
0.53,0.0001,273,331,10,2,0.01,604,12
0.526,0.0001,326,378,10,2,0.01,704,12
0.532,0.0001,374,430,10,2,0.01,804,12
0.518,0.0001,418,486,10,2,0.01,904,12
0.498,0.0001,459,545,10,2,0.01,1004,12
0.504,0.0001,506,598,10,2,0.01,1104,12
0.496,0.0001,552,652,10,2,0.01,1204,12
0.512,0.0001,610,694,10,2,0.01,1304,12
0.534,0.0001,662,742,10,2,0.01,1404,12
0.56,0.0001,720,784,10,2,0.01,1504,12
0.572,0.0001,773,831,10,2,0.01,1604,12
0.596,0.0001,837,867,10,2,0.01,1704,12
0.622,0.0001,885,919,10,2,0.01,1804,12
0.652,0.0001,934,970,10,2,0.01,1904,12
0.674,0.0001,983,1021,10,2,0.01,2004,12
0.5,0.0001,59,45,10,2,0.01,104,13
0.502,0.0001,105,99,10,2,0.01,204,13
0.51,0.0001,148,156,10,2,0.01,304,13
0.53,0.0001,201,203,10,2,0.01,404,13
0.544,0.0001,251,253,10,2,0.01,504,13
0.566,0.0001,301,303,10,2,0.01,604,13
0.588,0.0001,348,356,10,2,0.01,704,13
0.612,0.0001,397,407,10,2,0.01,804,13
0.624,0.0001,447,457,10,2,0.01,904,13
0.632,0.0001,499,505,10,2,0.01,1004,13
0.62,0.0001,544,560,10,2,0.01,1104,13
0.638,0.0001,598,606,10,2,0.01,1204,13
0.668,0.0001,645,659,10,2,0.01,1304,13
0.678,0.0001,695,709,10,2,0.01,1404,13
0.676,0.0001,742,762,10,2,0.01,1504,13
0.686,0.0001,790,814,10,2,0.01,1604,13
0.7,0.0001,845,859,10,2,0.01,1704,13
0.704,0.0001,890,914,10,2,0.01,1804,13
0.698,0.0001,938,966,10,2,0.01,1904,13
0.71,0.0001,999,1005,10,2,0.01,2004,13
0.516,0.0001,49,55,10,2,0.01,104,14
0.52,0.0001,103,101,10,2,0.01,204,14
0.526,0.0001,156,148,10,2,0.01,304,14
0.532,0.0001,204,200,10,2,0.01,404,14
0.528,0.0001,261,243,10,2,0.01,504,14
0.54,0.0001,319,285,10,2,0.01,604,14
0.562,0.0001,360,344,10,2,0.01,704,14
0.582,0.0001,418,386,10,2,0.01,804,14
0.588,0.0001,466,438,10,2,0.01,904,14
0.604,0.0001,520,484,10,2,0.01,1004,14
0.612,0.0001,562,542,10,2,0.01,1104,14
0.632,0.0001,614,590,10,2,0.01,1204,14
0.612,0.0001,657,647,10,2,0.01,1304,14
0.636,0.0001,707,697,10,2,0.01,1404,14
0.638,0.0001,759,745,10,2,0.01,1504,14
0.726,0.0001,804,800,10,2,0.01,1604,14
0.726,0.0001,850,854,10,2,0.01,1704,14
0.724,0.0001,892,912,10,2,0.01,1804,14
0.726,0.0001,947,957,10,2,0.01,1904,14
0.728,0.0001,1007,997,10,2,0.01,2004,14
0.486,0.0001,58,46,10,2,0.01,104,15
0.486,0.0001,111,93,10,2,0.01,204,15
0.486,0.0001,167,137,10,2,0.01,304,15
0.486,0.0001,220,184,10,2,0.01,404,15
0.486,0.0001,267,237,10,2,0.01,504,15
0.486,0.0001,321,283,10,2,0.01,604,15
0.486,0.0001,356,348,10,2,0.01,704,15
0.486,0.0001,412,392,10,2,0.01,804,15
0.486,0.0001,460,444,10,2,0.01,904,15
0.486,0.0001,517,487,10,2,0.01,1004,15
0.486,0.0001,568,536,10,2,0.01,1104,15
0.486,0.0001,612,592,10,2,0.01,1204,15
0.486,0.0001,662,642,10,2,0.01,1304,15
0.486,0.0001,710,694,10,2,0.01,1404,15
0.486,0.0001,749,755,10,2,0.01,1504,15
0.486,0.0001,796,808,10,2,0.01,1604,15
0.486,0.0001,856,848,10,2,0.01,1704,15
0.536,0.0001,899,905,10,2,0.01,1804,15
0.54,0.0001,949,955,10,2,0.01,1904,15
0.542,0.0001,995,1009,10,2,0.01,2004,15
0.512,0.0001,56,48,10,2,0.01,104,16
0.512,0.0001,101,103,10,2,0.01,204,16
0.512,0.0001,153,151,10,2,0.01,304,16
0.512,0.0001,210,194,10,2,0.01,404,16
0.512,0.0001,256,248,10,2,0.01,504,16
0.512,0.0001,305,299,10,2,0.01,604,16
0.512,0.0001,355,349,10,2,0.01,704,16
0.512,0.0001,393,411,10,2,0.01,804,16
0.512,0.0001,451,453,10,2,0.01,904,16
0.512,0.0001,503,501,10,2,0.01,1004,16
0.512,0.0001,550,554,10,2,0.01,1104,16
0.512,0.0001,600,604,10,2,0.01,1204,16
0.512,0.0001,655,649,10,2,0.01,1304,16
0.512,0.0001,707,697,10,2,0.01,1404,16
0.514,0.0001,754,750,10,2,0.01,1504,16
0.528,0.0001,808,796,10,2,0.01,1604,16
0.58,0.0001,856,848,10,2,0.01,1704,16
0.596,0.0001,911,893,10,2,0.01,1804,16
0.614,0.0001,965,939,10,2,0.01,1904,16
0.672,0.0001,1008,996,10,2,0.01,2004,16
0.526,0.0001,53,51,10,2,0.01,104,17
0.532,0.0001,105,99,10,2,0.01,204,17
0.532,0.0001,157,147,10,2,0.01,304,17
0.532,0.0001,207,197,10,2,0.01,404,17
0.534,0.0001,256,248,10,2,0.01,504,17
0.532,0.0001,309,295,10,2,0.01,604,17
0.534,0.0001,353,351,10,2,0.01,704,17
0.53,0.0001,399,405,10,2,0.01,804,17
0.532,0.0001,448,456,10,2,0.01,904,17
0.546,0.0001,501,503,10,2,0.01,1004,17
0.55,0.0001,553,551,10,2,0.01,1104,17
0.57,0.0001,594,610,10,2,0.01,1204,17
0.554,0.0001,642,662,10,2,0.01,1304,17
0.556,0.0001,693,711,10,2,0.01,1404,17
0.56,0.0001,739,765,10,2,0.01,1504,17
0.57,0.0001,794,810,10,2,0.01,1604,17
0.59,0.0001,841,863,10,2,0.01,1704,17
0.572,0.0001,895,909,10,2,0.01,1804,17
0.58,0.0001,954,950,10,2,0.01,1904,17
0.584,0.0001,1004,1000,10,2,0.01,2004,17
0.54,0.0001,50,54,10,2,0.01,104,18
0.54,0.0001,98,106,10,2,0.01,204,18
0.54,0.0001,149,155,10,2,0.01,304,18
0.54,0.0001,197,207,10,2,0.01,404,18
0.54,0.0001,235,269,10,2,0.01,504,18
0.54,0.0001,282,322,10,2,0.01,604,18
0.54,0.0001,336,368,10,2,0.01,704,18
0.54,0.0001,390,414,10,2,0.01,804,18
0.54,0.0001,435,469,10,2,0.01,904,18
0.54,0.0001,487,517,10,2,0.01,1004,18
0.54,0.0001,526,578,10,2,0.01,1104,18
0.54,0.0001,576,628,10,2,0.01,1204,18
0.54,0.0001,627,677,10,2,0.01,1304,18
0.54,0.0001,669,735,10,2,0.01,1404,18
0.54,0.0001,716,788,10,2,0.01,1504,18
0.54,0.0001,765,839,10,2,0.01,1604,18
0.54,0.0001,814,890,10,2,0.01,1704,18
0.54,0.0001,863,941,10,2,0.01,1804,18
0.54,0.0001,919,985,10,2,0.01,1904,18
0.914,0.0001,982,1022,10,2,0.01,2004,18
0.464,0.0001,49,55,10,2,0.01,104,19
0.464,0.0001,90,114,10,2,0.01,204,19
0.464,0.0001,143,161,10,2,0.01,304,19
0.464,0.0001,186,218,10,2,0.01,404,19
0.464,0.0001,233,271,10,2,0.01,504,19
0.464,0.0001,284,320,10,2,0.01,604,19
0.464,0.0001,336,368,10,2,0.01,704,19
0.464,0.0001,390,414,10,2,0.01,804,19
0.5,0.0001,439,465,10,2,0.01,904,19
0.516,0.0001,498,506,10,2,0.01,1004,19
0.522,0.0001,533,571,10,2,0.01,1104,19
0.53,0.0001,581,623,10,2,0.01,1204,19
0.542,0.0001,638,666,10,2,0.01,1304,19
0.556,0.0001,686,718,10,2,0.01,1404,19
0.56,0.0001,738,766,10,2,0.01,1504,19
0.566,0.0001,787,817,10,2,0.01,1604,19
0.568,0.0001,838,866,10,2,0.01,1704,19
0.574,0.0001,887,917,10,2,0.01,1804,19
0.576,0.0001,935,969,10,2,0.01,1904,19
0.582,0.0001,984,1020,10,2,0.01,2004,19
0.514,0.0001,48,56,10,2,0.01,104,20
0.514,0.0001,91,113,10,2,0.01,204,20
0.514,0.0001,132,172,10,2,0.01,304,20
0.514,0.0001,181,223,10,2,0.01,404,20
0.514,0.0001,229,275,10,2,0.01,504,20
0.514,0.0001,285,319,10,2,0.01,604,20
0.514,0.0001,323,381,10,2,0.01,704,20
0.514,0.0001,373,431,10,2,0.01,804,20
0.514,0.0001,434,470,10,2,0.01,904,20
0.522,0.0001,485,519,10,2,0.01,1004,20
0.55,0.0001,534,570,10,2,0.01,1104,20
0.594,0.0001,585,619,10,2,0.01,1204,20
0.606,0.0001,640,664,10,2,0.01,1304,20
0.614,0.0001,688,716,10,2,0.01,1404,20
0.612,0.0001,734,770,10,2,0.01,1504,20
0.634,0.0001,790,814,10,2,0.01,1604,20
0.66,0.0001,835,869,10,2,0.01,1704,20
0.674,0.0001,885,919,10,2,0.01,1804,20
0.732,0.0001,940,964,10,2,0.01,1904,20
0.77,0.0001,995,1009,10,2,0.01,2004,20
0.492,0.001,56,48,10,2,0.0001,104,1
0.492,0.001,109,95,10,2,0.0001,204,1
0.492,0.001,155,149,10,2,0.0001,304,1
0.492,0.001,201,203,10,2,0.0001,404,1
0.492,0.001,253,251,10,2,0.0001,504,1
0.494,0.001,301,303,10,2,0.0001,604,1
0.494,0.001,359,345,10,2,0.0001,704,1
0.494,0.001,413,391,10,2,0.0001,804,1
0.494,0.001,465,439,10,2,0.0001,904,1
0.494,0.001,519,485,10,2,0.0001,1004,1
0.494,0.001,563,541,10,2,0.0001,1104,1
0.496,0.001,622,582,10,2,0.0001,1204,1
0.496,0.001,666,638,10,2,0.0001,1304,1
0.496,0.001,724,680,10,2,0.0001,1404,1
0.496,0.001,764,740,10,2,0.0001,1504,1
0.496,0.001,815,789,10,2,0.0001,1604,1
0.496,0.001,867,837,10,2,0.0001,1704,1
0.494,0.001,911,893,10,2,0.0001,1804,1
0.496,0.001,961,943,10,2,0.0001,1904,1
0.496,0.001,1008,996,10,2,0.0001,2004,1
0.532,0.001,49,55,10,2,0.0001,104,2
0.532,0.001,98,106,10,2,0.0001,204,2
0.532,0.001,149,155,10,2,0.0001,304,2
0.532,0.001,193,211,10,2,0.0001,404,2
0.532,0.001,241,263,10,2,0.0001,504,2
0.532,0.001,291,313,10,2,0.0001,604,2
0.532,0.001,340,364,10,2,0.0001,704,2
0.532,0.001,392,412,10,2,0.0001,804,2
0.532,0.001,445,459,10,2,0.0001,904,2
0.532,0.001,491,513,10,2,0.0001,1004,2
0.532,0.001,542,562,10,2,0.0001,1104,2
0.532,0.001,599,605,10,2,0.0001,1204,2
0.532,0.001,648,656,10,2,0.0001,1304,2
0.532,0.001,702,702,10,2,0.0001,1404,2
0.532,0.001,751,753,10,2,0.0001,1504,2
0.532,0.001,795,809,10,2,0.0001,1604,2
0.532,0.001,848,856,10,2,0.0001,1704,2
0.532,0.001,889,915,10,2,0.0001,1804,2
0.532,0.001,935,969,10,2,0.0001,1904,2
0.532,0.001,986,1018,10,2,0.0001,2004,2
0.484,0.001,53,51,10,2,0.0001,104,3
0.484,0.001,100,104,10,2,0.0001,204,3
0.484,0.001,145,159,10,2,0.0001,304,3
0.484,0.001,201,203,10,2,0.0001,404,3
0.484,0.001,252,252,10,2,0.0001,504,3
0.484,0.001,299,305,10,2,0.0001,604,3
0.486,0.001,343,361,10,2,0.0001,704,3
0.486,0.001,393,411,10,2,0.0001,804,3
0.488,0.001,438,466,10,2,0.0001,904,3
0.488,0.001,490,514,10,2,0.0001,1004,3
0.488,0.001,546,558,10,2,0.0001,1104,3
0.488,0.001,597,607,10,2,0.0001,1204,3
0.488,0.001,647,657,10,2,0.0001,1304,3
0.488,0.001,694,710,10,2,0.0001,1404,3
0.488,0.001,741,763,10,2,0.0001,1504,3
0.488,0.001,793,811,10,2,0.0001,1604,3
0.488,0.001,848,856,10,2,0.0001,1704,3
0.488,0.001,892,912,10,2,0.0001,1804,3
0.488,0.001,949,955,10,2,0.0001,1904,3
0.488,0.001,995,1009,10,2,0.0001,2004,3
0.518,0.001,52,52,10,2,0.0001,104,4
0.518,0.001,115,89,10,2,0.0001,204,4
0.518,0.001,163,141,10,2,0.0001,304,4
0.518,0.001,213,191,10,2,0.0001,404,4
0.518,0.001,259,245,10,2,0.0001,504,4
0.518,0.001,314,290,10,2,0.0001,604,4
0.518,0.001,367,337,10,2,0.0001,704,4
0.518,0.001,417,387,10,2,0.0001,804,4
0.518,0.001,472,432,10,2,0.0001,904,4
0.518,0.001,510,494,10,2,0.0001,1004,4
0.518,0.001,558,546,10,2,0.0001,1104,4
0.518,0.001,607,597,10,2,0.0001,1204,4
0.518,0.001,657,647,10,2,0.0001,1304,4
0.518,0.001,708,696,10,2,0.0001,1404,4
0.518,0.001,761,743,10,2,0.0001,1504,4
0.518,0.001,809,795,10,2,0.0001,1604,4
0.518,0.001,854,850,10,2,0.0001,1704,4
0.518,0.001,907,897,10,2,0.0001,1804,4
0.518,0.001,954,950,10,2,0.0001,1904,4
0.518,0.001,1011,993,10,2,0.0001,2004,4
0.48,0.001,51,53,10,2,0.0001,104,5
0.48,0.001,98,106,10,2,0.0001,204,5
0.48,0.001,147,157,10,2,0.0001,304,5
0.48,0.001,203,201,10,2,0.0001,404,5
0.48,0.001,255,249,10,2,0.0001,504,5
0.48,0.001,305,299,10,2,0.0001,604,5
0.48,0.001,356,348,10,2,0.0001,704,5
0.48,0.001,408,396,10,2,0.0001,804,5
0.48,0.001,461,443,10,2,0.0001,904,5
0.48,0.001,508,496,10,2,0.0001,1004,5
0.48,0.001,558,546,10,2,0.0001,1104,5
0.48,0.001,613,591,10,2,0.0001,1204,5
0.48,0.001,667,637,10,2,0.0001,1304,5
0.48,0.001,714,690,10,2,0.0001,1404,5
0.48,0.001,762,742,10,2,0.0001,1504,5
0.48,0.001,815,789,10,2,0.0001,1604,5
0.48,0.001,862,842,10,2,0.0001,1704,5
0.48,0.001,912,892,10,2,0.0001,1804,5
0.48,0.001,959,945,10,2,0.0001,1904,5
0.48,0.001,1012,992,10,2,0.0001,2004,5
0.516,0.001,55,49,10,2,0.0001,104,6
0.516,0.001,104,100,10,2,0.0001,204,6
0.516,0.001,157,147,10,2,0.0001,304,6
0.516,0.001,212,192,10,2,0.0001,404,6
0.516,0.001,264,240,10,2,0.0001,504,6
0.516,0.001,317,287,10,2,0.0001,604,6
0.516,0.001,371,333,10,2,0.0001,704,6
0.516,0.001,416,388,10,2,0.0001,804,6
0.516,0.001,470,434,10,2,0.0001,904,6
0.516,0.001,526,478,10,2,0.0001,1004,6
0.516,0.001,577,527,10,2,0.0001,1104,6
0.516,0.001,630,574,10,2,0.0001,1204,6
0.516,0.001,678,626,10,2,0.0001,1304,6
0.516,0.001,724,680,10,2,0.0001,1404,6
0.516,0.001,776,728,10,2,0.0001,1504,6
0.516,0.001,822,782,10,2,0.0001,1604,6
0.516,0.001,865,839,10,2,0.0001,1704,6
0.516,0.001,913,891,10,2,0.0001,1804,6
0.516,0.001,963,941,10,2,0.0001,1904,6
0.516,0.001,1010,994,10,2,0.0001,2004,6
0.448,0.001,47,57,10,2,0.0001,104,7
0.448,0.001,92,112,10,2,0.0001,204,7
0.448,0.001,137,167,10,2,0.0001,304,7
0.448,0.001,195,209,10,2,0.0001,404,7
0.448,0.001,245,259,10,2,0.0001,504,7
0.448,0.001,295,309,10,2,0.0001,604,7
0.448,0.001,344,360,10,2,0.0001,704,7
0.448,0.001,396,408,10,2,0.0001,804,7
0.448,0.001,452,452,10,2,0.0001,904,7
0.448,0.001,505,499,10,2,0.0001,1004,7
0.448,0.001,548,556,10,2,0.0001,1104,7
0.448,0.001,585,619,10,2,0.0001,1204,7
0.446,0.001,633,671,10,2,0.0001,1304,7
0.446,0.001,690,714,10,2,0.0001,1404,7
0.448,0.001,742,762,10,2,0.0001,1504,7
0.448,0.001,787,817,10,2,0.0001,1604,7
0.45,0.001,834,870,10,2,0.0001,1704,7
0.45,0.001,884,920,10,2,0.0001,1804,7
0.45,0.001,936,968,10,2,0.0001,1904,7
0.45,0.001,986,1018,10,2,0.0001,2004,7
0.48,0.001,55,49,10,2,0.0001,104,8
0.48,0.001,103,101,10,2,0.0001,204,8
0.48,0.001,144,160,10,2,0.0001,304,8
0.48,0.001,195,209,10,2,0.0001,404,8
0.484,0.001,246,258,10,2,0.0001,504,8
0.484,0.001,292,312,10,2,0.0001,604,8
0.484,0.001,352,352,10,2,0.0001,704,8
0.482,0.001,399,405,10,2,0.0001,804,8
0.482,0.001,449,455,10,2,0.0001,904,8
0.482,0.001,501,503,10,2,0.0001,1004,8
0.482,0.001,557,547,10,2,0.0001,1104,8
0.484,0.001,609,595,10,2,0.0001,1204,8
0.484,0.001,648,656,10,2,0.0001,1304,8
0.486,0.001,694,710,10,2,0.0001,1404,8
0.486,0.001,748,756,10,2,0.0001,1504,8
0.486,0.001,799,805,10,2,0.0001,1604,8
0.486,0.001,849,855,10,2,0.0001,1704,8
0.486,0.001,903,901,10,2,0.0001,1804,8
0.486,0.001,954,950,10,2,0.0001,1904,8
0.486,0.001,1000,1004,10,2,0.0001,2004,8
0.512,0.001,50,54,10,2,0.0001,104,9
0.514,0.001,101,103,10,2,0.0001,204,9
0.514,0.001,149,155,10,2,0.0001,304,9
0.514,0.001,195,209,10,2,0.0001,404,9
0.514,0.001,239,265,10,2,0.0001,504,9
0.514,0.001,289,315,10,2,0.0001,604,9
0.514,0.001,338,366,10,2,0.0001,704,9
0.514,0.001,390,414,10,2,0.0001,804,9
0.514,0.001,448,456,10,2,0.0001,904,9
0.514,0.001,509,495,10,2,0.0001,1004,9
0.514,0.001,557,547,10,2,0.0001,1104,9
0.514,0.001,603,601,10,2,0.0001,1204,9
0.514,0.001,654,650,10,2,0.0001,1304,9
0.514,0.001,704,700,10,2,0.0001,1404,9
0.514,0.001,749,755,10,2,0.0001,1504,9
0.514,0.001,804,800,10,2,0.0001,1604,9
0.514,0.001,855,849,10,2,0.0001,1704,9
0.514,0.001,899,905,10,2,0.0001,1804,9
0.514,0.001,944,960,10,2,0.0001,1904,9
0.514,0.001,984,1020,10,2,0.0001,2004,9
0.524,0.001,59,45,10,2,0.0001,104,10
0.524,0.001,107,97,10,2,0.0001,204,10
0.524,0.001,157,147,10,2,0.0001,304,10
0.524,0.001,203,201,10,2,0.0001,404,10
0.524,0.001,251,253,10,2,0.0001,504,10
0.524,0.001,291,313,10,2,0.0001,604,10
0.524,0.001,344,360,10,2,0.0001,704,10
0.524,0.001,401,403,10,2,0.0001,804,10
0.524,0.001,459,445,10,2,0.0001,904,10
0.524,0.001,516,488,10,2,0.0001,1004,10
0.524,0.001,568,536,10,2,0.0001,1104,10
0.522,0.001,610,594,10,2,0.0001,1204,10
0.522,0.001,673,631,10,2,0.0001,1304,10
0.522,0.001,726,678,10,2,0.0001,1404,10
0.522,0.001,773,731,10,2,0.0001,1504,10
0.524,0.001,828,776,10,2,0.0001,1604,10
0.524,0.001,873,831,10,2,0.0001,1704,10
0.526,0.001,920,884,10,2,0.0001,1804,10
0.526,0.001,971,933,10,2,0.0001,1904,10
0.526,0.001,1019,985,10,2,0.0001,2004,10
0.512,0.001,53,51,10,2,0.0001,104,11
0.512,0.001,102,102,10,2,0.0001,204,11
0.512,0.001,161,143,10,2,0.0001,304,11
0.512,0.001,210,194,10,2,0.0001,404,11
0.512,0.001,262,242,10,2,0.0001,504,11
0.512,0.001,307,297,10,2,0.0001,604,11
0.512,0.001,351,353,10,2,0.0001,704,11
0.512,0.001,399,405,10,2,0.0001,804,11
0.512,0.001,453,451,10,2,0.0001,904,11
0.512,0.001,506,498,10,2,0.0001,1004,11
0.512,0.001,552,552,10,2,0.0001,1104,11
0.512,0.001,603,601,10,2,0.0001,1204,11
0.512,0.001,657,647,10,2,0.0001,1304,11
0.512,0.001,707,697,10,2,0.0001,1404,11
0.512,0.001,753,751,10,2,0.0001,1504,11
0.512,0.001,803,801,10,2,0.0001,1604,11
0.512,0.001,842,862,10,2,0.0001,1704,11
0.512,0.001,888,916,10,2,0.0001,1804,11
0.512,0.001,941,963,10,2,0.0001,1904,11
0.512,0.001,985,1019,10,2,0.0001,2004,11
0.52,0.001,57,47,10,2,0.0001,104,12
0.52,0.001,109,95,10,2,0.0001,204,12
0.52,0.001,162,142,10,2,0.0001,304,12
0.52,0.001,207,197,10,2,0.0001,404,12
0.52,0.001,252,252,10,2,0.0001,504,12
0.52,0.001,302,302,10,2,0.0001,604,12
0.52,0.001,347,357,10,2,0.0001,704,12
0.52,0.001,404,400,10,2,0.0001,804,12
0.52,0.001,456,448,10,2,0.0001,904,12
0.52,0.001,506,498,10,2,0.0001,1004,12
0.52,0.001,552,552,10,2,0.0001,1104,12
0.52,0.001,605,599,10,2,0.0001,1204,12
0.52,0.001,660,644,10,2,0.0001,1304,12
0.52,0.001,711,693,10,2,0.0001,1404,12
0.52,0.001,756,748,10,2,0.0001,1504,12
0.52,0.001,807,797,10,2,0.0001,1604,12
0.52,0.001,870,834,10,2,0.0001,1704,12
0.52,0.001,912,892,10,2,0.0001,1804,12
0.52,0.001,961,943,10,2,0.0001,1904,12
0.52,0.001,1012,992,10,2,0.0001,2004,12
0.51,0.001,52,52,10,2,0.0001,104,13
0.51,0.001,95,109,10,2,0.0001,204,13
0.51,0.001,144,160,10,2,0.0001,304,13
0.51,0.001,191,213,10,2,0.0001,404,13
0.51,0.001,239,265,10,2,0.0001,504,13
0.51,0.001,287,317,10,2,0.0001,604,13
0.51,0.001,334,370,10,2,0.0001,704,13
0.51,0.001,384,420,10,2,0.0001,804,13
0.51,0.001,434,470,10,2,0.0001,904,13
0.51,0.001,483,521,10,2,0.0001,1004,13
0.51,0.001,543,561,10,2,0.0001,1104,13
0.51,0.001,600,604,10,2,0.0001,1204,13
0.51,0.001,649,655,10,2,0.0001,1304,13
0.51,0.001,696,708,10,2,0.0001,1404,13
0.51,0.001,748,756,10,2,0.0001,1504,13
0.51,0.001,798,806,10,2,0.0001,1604,13
0.51,0.001,855,849,10,2,0.0001,1704,13
0.51,0.001,898,906,10,2,0.0001,1804,13
0.51,0.001,950,954,10,2,0.0001,1904,13
0.51,0.001,1007,997,10,2,0.0001,2004,13
0.528,0.001,61,43,10,2,0.0001,104,14
0.528,0.001,111,93,10,2,0.0001,204,14
0.528,0.001,162,142,10,2,0.0001,304,14
0.528,0.001,210,194,10,2,0.0001,404,14
0.528,0.001,258,246,10,2,0.0001,504,14
0.528,0.001,309,295,10,2,0.0001,604,14
0.528,0.001,359,345,10,2,0.0001,704,14
0.528,0.001,417,387,10,2,0.0001,804,14
0.528,0.001,463,441,10,2,0.0001,904,14
0.528,0.001,513,491,10,2,0.0001,1004,14
0.528,0.001,566,538,10,2,0.0001,1104,14
0.528,0.001,615,589,10,2,0.0001,1204,14
0.528,0.001,673,631,10,2,0.0001,1304,14
0.528,0.001,729,675,10,2,0.0001,1404,14
0.528,0.001,779,725,10,2,0.0001,1504,14
0.528,0.001,825,779,10,2,0.0001,1604,14
0.528,0.001,879,825,10,2,0.0001,1704,14
0.528,0.001,924,880,10,2,0.0001,1804,14
0.528,0.001,978,926,10,2,0.0001,1904,14
0.528,0.001,1016,988,10,2,0.0001,2004,14
0.496,0.001,57,47,10,2,0.0001,104,15
0.496,0.001,106,98,10,2,0.0001,204,15
0.496,0.001,157,147,10,2,0.0001,304,15
0.496,0.001,212,192,10,2,0.0001,404,15
0.496,0.001,254,250,10,2,0.0001,504,15
0.496,0.001,304,300,10,2,0.0001,604,15
0.496,0.001,344,360,10,2,0.0001,704,15
0.496,0.001,389,415,10,2,0.0001,804,15
0.496,0.001,445,459,10,2,0.0001,904,15
0.496,0.001,491,513,10,2,0.0001,1004,15
0.496,0.001,551,553,10,2,0.0001,1104,15
0.496,0.001,599,605,10,2,0.0001,1204,15
0.496,0.001,652,652,10,2,0.0001,1304,15
0.496,0.001,702,702,10,2,0.0001,1404,15
0.496,0.001,753,751,10,2,0.0001,1504,15
0.496,0.001,799,805,10,2,0.0001,1604,15
0.496,0.001,852,852,10,2,0.0001,1704,15
0.496,0.001,907,897,10,2,0.0001,1804,15
0.496,0.001,953,951,10,2,0.0001,1904,15
0.496,0.001,1004,1000,10,2,0.0001,2004,15
0.468,0.001,52,52,10,2,0.0001,104,16
0.468,0.001,96,108,10,2,0.0001,204,16
0.468,0.001,152,152,10,2,0.0001,304,16
0.468,0.001,206,198,10,2,0.0001,404,16
0.47,0.001,254,250,10,2,0.0001,504,16
0.47,0.001,313,291,10,2,0.0001,604,16
0.466,0.001,358,346,10,2,0.0001,704,16
0.466,0.001,401,403,10,2,0.0001,804,16
0.466,0.001,451,453,10,2,0.0001,904,16
0.468,0.001,500,504,10,2,0.0001,1004,16
0.466,0.001,550,554,10,2,0.0001,1104,16
0.466,0.001,602,602,10,2,0.0001,1204,16
0.466,0.001,647,657,10,2,0.0001,1304,16
0.468,0.001,701,703,10,2,0.0001,1404,16
0.466,0.001,756,748,10,2,0.0001,1504,16
0.466,0.001,799,805,10,2,0.0001,1604,16
0.466,0.001,851,853,10,2,0.0001,1704,16
0.466,0.001,896,908,10,2,0.0001,1804,16
0.466,0.001,957,947,10,2,0.0001,1904,16
0.466,0.001,1003,1001,10,2,0.0001,2004,16
0.518,0.001,54,50,10,2,0.0001,104,17
0.518,0.001,104,100,10,2,0.0001,204,17
0.518,0.001,153,151,10,2,0.0001,304,17
0.518,0.001,194,210,10,2,0.0001,404,17
0.518,0.001,245,259,10,2,0.0001,504,17
0.518,0.001,296,308,10,2,0.0001,604,17
0.518,0.001,348,356,10,2,0.0001,704,17
0.518,0.001,404,400,10,2,0.0001,804,17
0.518,0.001,454,450,10,2,0.0001,904,17
0.516,0.001,504,500,10,2,0.0001,1004,17
0.516,0.001,560,544,10,2,0.0001,1104,17
0.518,0.001,603,601,10,2,0.0001,1204,17
0.52,0.001,647,657,10,2,0.0001,1304,17
0.52,0.001,702,702,10,2,0.0001,1404,17
0.52,0.001,749,755,10,2,0.0001,1504,17
0.52,0.001,799,805,10,2,0.0001,1604,17
0.522,0.001,844,860,10,2,0.0001,1704,17
0.522,0.001,899,905,10,2,0.0001,1804,17
0.52,0.001,944,960,10,2,0.0001,1904,17
0.52,0.001,991,1013,10,2,0.0001,2004,17
0.516,0.001,44,60,10,2,0.0001,104,18
0.516,0.001,93,111,10,2,0.0001,204,18
0.516,0.001,158,146,10,2,0.0001,304,18
0.516,0.001,211,193,10,2,0.0001,404,18
0.516,0.001,252,252,10,2,0.0001,504,18
0.516,0.001,296,308,10,2,0.0001,604,18
0.516,0.001,351,353,10,2,0.0001,704,18
0.516,0.001,406,398,10,2,0.0001,804,18
0.516,0.001,449,455,10,2,0.0001,904,18
0.516,0.001,504,500,10,2,0.0001,1004,18
0.516,0.001,552,552,10,2,0.0001,1104,18
0.516,0.001,604,600,10,2,0.0001,1204,18
0.516,0.001,658,646,10,2,0.0001,1304,18
0.516,0.001,710,694,10,2,0.0001,1404,18
0.516,0.001,747,757,10,2,0.0001,1504,18
0.516,0.001,798,806,10,2,0.0001,1604,18
0.516,0.001,856,848,10,2,0.0001,1704,18
0.516,0.001,915,889,10,2,0.0001,1804,18
0.516,0.001,962,942,10,2,0.0001,1904,18
0.516,0.001,1010,994,10,2,0.0001,2004,18
0.536,0.001,51,53,10,2,0.0001,104,19
0.536,0.001,95,109,10,2,0.0001,204,19
0.536,0.001,143,161,10,2,0.0001,304,19
0.536,0.001,191,213,10,2,0.0001,404,19
0.536,0.001,239,265,10,2,0.0001,504,19
0.536,0.001,300,304,10,2,0.0001,604,19
0.536,0.001,350,354,10,2,0.0001,704,19
0.536,0.001,398,406,10,2,0.0001,804,19
0.536,0.001,449,455,10,2,0.0001,904,19
0.536,0.001,491,513,10,2,0.0001,1004,19
0.536,0.001,541,563,10,2,0.0001,1104,19
0.536,0.001,593,611,10,2,0.0001,1204,19
0.536,0.001,646,658,10,2,0.0001,1304,19
0.536,0.001,702,702,10,2,0.0001,1404,19
0.536,0.001,753,751,10,2,0.0001,1504,19
0.536,0.001,800,804,10,2,0.0001,1604,19
0.536,0.001,851,853,10,2,0.0001,1704,19
0.536,0.001,900,904,10,2,0.0001,1804,19
0.542,0.001,955,949,10,2,0.0001,1904,19
0.542,0.001,1009,995,10,2,0.0001,2004,19
0.508,0.001,54,50,10,2,0.0001,104,20
0.508,0.001,102,102,10,2,0.0001,204,20
0.508,0.001,150,154,10,2,0.0001,304,20
0.508,0.001,205,199,10,2,0.0001,404,20
0.508,0.001,252,252,10,2,0.0001,504,20
0.508,0.001,296,308,10,2,0.0001,604,20
0.508,0.001,346,358,10,2,0.0001,704,20
0.508,0.001,397,407,10,2,0.0001,804,20
0.508,0.001,442,462,10,2,0.0001,904,20
0.508,0.001,493,511,10,2,0.0001,1004,20
0.508,0.001,545,559,10,2,0.0001,1104,20
0.508,0.001,593,611,10,2,0.0001,1204,20
0.508,0.001,638,666,10,2,0.0001,1304,20
0.508,0.001,688,716,10,2,0.0001,1404,20
0.508,0.001,745,759,10,2,0.0001,1504,20
0.508,0.001,796,808,10,2,0.0001,1604,20
0.508,0.001,853,851,10,2,0.0001,1704,20
0.508,0.001,900,904,10,2,0.0001,1804,20
0.508,0.001,954,950,10,2,0.0001,1904,20
0.508,0.001,1006,998,10,2,0.0001,2004,20
0.482,0.001,56,48,10,2,0.001,104,1
0.482,0.001,105,99,10,2,0.001,204,1
0.482,0.001,157,147,10,2,0.001,304,1
0.484,0.001,207,197,10,2,0.001,404,1
0.484,0.001,255,249,10,2,0.001,504,1
0.484,0.001,313,291,10,2,0.001,604,1
0.484,0.001,362,342,10,2,0.001,704,1
0.484,0.001,417,387,10,2,0.001,804,1
0.486,0.001,469,435,10,2,0.001,904,1
0.482,0.001,513,491,10,2,0.001,1004,1
0.484,0.001,557,547,10,2,0.001,1104,1
0.484,0.001,604,600,10,2,0.001,1204,1
0.484,0.001,654,650,10,2,0.001,1304,1
0.486,0.001,697,707,10,2,0.001,1404,1
0.486,0.001,742,762,10,2,0.001,1504,1
0.488,0.001,791,813,10,2,0.001,1604,1
0.488,0.001,843,861,10,2,0.001,1704,1
0.494,0.001,897,907,10,2,0.001,1804,1
0.494,0.001,943,961,10,2,0.001,1904,1
0.494,0.001,986,1018,10,2,0.001,2004,1
0.51,0.001,44,60,10,2,0.001,104,2
0.512,0.001,103,101,10,2,0.001,204,2
0.51,0.001,157,147,10,2,0.001,304,2
0.51,0.001,203,201,10,2,0.001,404,2
0.512,0.001,254,250,10,2,0.001,504,2
0.51,0.001,306,298,10,2,0.001,604,2
0.512,0.001,360,344,10,2,0.001,704,2
0.508,0.001,408,396,10,2,0.001,804,2
0.51,0.001,462,442,10,2,0.001,904,2
0.506,0.001,521,483,10,2,0.001,1004,2
0.508,0.001,568,536,10,2,0.001,1104,2
0.51,0.001,612,592,10,2,0.001,1204,2
0.506,0.001,666,638,10,2,0.001,1304,2
0.51,0.001,713,691,10,2,0.001,1404,2
0.508,0.001,762,742,10,2,0.001,1504,2
0.508,0.001,810,794,10,2,0.001,1604,2
0.512,0.001,860,844,10,2,0.001,1704,2
0.514,0.001,914,890,10,2,0.001,1804,2
0.52,0.001,959,945,10,2,0.001,1904,2
0.522,0.001,1006,998,10,2,0.001,2004,2
0.496,0.001,54,50,10,2,0.001,104,3
0.494,0.001,108,96,10,2,0.001,204,3
0.494,0.001,157,147,10,2,0.001,304,3
0.492,0.001,207,197,10,2,0.001,404,3
0.492,0.001,243,261,10,2,0.001,504,3
0.49,0.001,290,314,10,2,0.001,604,3
0.492,0.001,340,364,10,2,0.001,704,3
0.492,0.001,390,414,10,2,0.001,804,3
0.492,0.001,438,466,10,2,0.001,904,3
0.494,0.001,492,512,10,2,0.001,1004,3
0.494,0.001,549,555,10,2,0.001,1104,3
0.5,0.001,599,605,10,2,0.001,1204,3
0.508,0.001,650,654,10,2,0.001,1304,3
0.512,0.001,702,702,10,2,0.001,1404,3
0.51,0.001,748,756,10,2,0.001,1504,3
0.508,0.001,806,798,10,2,0.001,1604,3
0.508,0.001,865,839,10,2,0.001,1704,3
0.506,0.001,916,888,10,2,0.001,1804,3
0.506,0.001,962,942,10,2,0.001,1904,3
0.504,0.001,1005,999,10,2,0.001,2004,3
0.518,0.001,50,54,10,2,0.001,104,4
0.518,0.001,102,102,10,2,0.001,204,4
0.516,0.001,152,152,10,2,0.001,304,4
0.518,0.001,206,198,10,2,0.001,404,4
0.518,0.001,260,244,10,2,0.001,504,4
0.516,0.001,311,293,10,2,0.001,604,4
0.52,0.001,366,338,10,2,0.001,704,4
0.52,0.001,411,393,10,2,0.001,804,4
0.52,0.001,466,438,10,2,0.001,904,4
0.52,0.001,513,491,10,2,0.001,1004,4
0.52,0.001,561,543,10,2,0.001,1104,4
0.522,0.001,610,594,10,2,0.001,1204,4
0.524,0.001,657,647,10,2,0.001,1304,4
0.524,0.001,713,691,10,2,0.001,1404,4
0.522,0.001,760,744,10,2,0.001,1504,4
0.524,0.001,806,798,10,2,0.001,1604,4
0.524,0.001,865,839,10,2,0.001,1704,4
0.524,0.001,914,890,10,2,0.001,1804,4
0.528,0.001,973,931,10,2,0.001,1904,4
0.528,0.001,1016,988,10,2,0.001,2004,4
0.492,0.001,53,51,10,2,0.001,104,5
0.492,0.001,97,107,10,2,0.001,204,5
0.492,0.001,142,162,10,2,0.001,304,5
0.492,0.001,191,213,10,2,0.001,404,5
0.492,0.001,246,258,10,2,0.001,504,5
0.492,0.001,296,308,10,2,0.001,604,5
0.492,0.001,348,356,10,2,0.001,704,5
0.492,0.001,398,406,10,2,0.001,804,5
0.492,0.001,444,460,10,2,0.001,904,5
0.492,0.001,487,517,10,2,0.001,1004,5
0.492,0.001,539,565,10,2,0.001,1104,5
0.492,0.001,587,617,10,2,0.001,1204,5
0.492,0.001,646,658,10,2,0.001,1304,5
0.492,0.001,701,703,10,2,0.001,1404,5
0.492,0.001,744,760,10,2,0.001,1504,5
0.492,0.001,793,811,10,2,0.001,1604,5
0.498,0.001,847,857,10,2,0.001,1704,5
0.502,0.001,895,909,10,2,0.001,1804,5
0.502,0.001,943,961,10,2,0.001,1904,5
0.506,0.001,997,1007,10,2,0.001,2004,5
0.518,0.001,54,50,10,2,0.001,104,6
0.518,0.001,106,98,10,2,0.001,204,6
0.518,0.001,158,146,10,2,0.001,304,6
0.518,0.001,208,196,10,2,0.001,404,6
0.518,0.001,253,251,10,2,0.001,504,6
0.518,0.001,304,300,10,2,0.001,604,6
0.518,0.001,350,354,10,2,0.001,704,6
0.518,0.001,405,399,10,2,0.001,804,6
0.518,0.001,453,451,10,2,0.001,904,6
0.518,0.001,510,494,10,2,0.001,1004,6
0.518,0.001,563,541,10,2,0.001,1104,6
0.518,0.001,615,589,10,2,0.001,1204,6
0.518,0.001,665,639,10,2,0.001,1304,6
0.518,0.001,712,692,10,2,0.001,1404,6
0.518,0.001,771,733,10,2,0.001,1504,6
0.518,0.001,827,777,10,2,0.001,1604,6
0.518,0.001,879,825,10,2,0.001,1704,6
0.518,0.001,917,887,10,2,0.001,1804,6
0.518,0.001,965,939,10,2,0.001,1904,6
0.518,0.001,1011,993,10,2,0.001,2004,6
0.476,0.001,49,55,10,2,0.001,104,7
0.476,0.001,98,106,10,2,0.001,204,7
0.476,0.001,149,155,10,2,0.001,304,7
0.476,0.001,202,202,10,2,0.001,404,7
0.476,0.001,247,257,10,2,0.001,504,7
0.478,0.001,300,304,10,2,0.001,604,7
0.478,0.001,348,356,10,2,0.001,704,7
0.476,0.001,402,402,10,2,0.001,804,7
0.478,0.001,451,453,10,2,0.001,904,7
0.48,0.001,497,507,10,2,0.001,1004,7
0.484,0.001,544,560,10,2,0.001,1104,7
0.486,0.001,597,607,10,2,0.001,1204,7
0.484,0.001,654,650,10,2,0.001,1304,7
0.486,0.001,698,706,10,2,0.001,1404,7
0.486,0.001,741,763,10,2,0.001,1504,7
0.488,0.001,798,806,10,2,0.001,1604,7
0.49,0.001,841,863,10,2,0.001,1704,7
0.5,0.001,891,913,10,2,0.001,1804,7
0.502,0.001,950,954,10,2,0.001,1904,7
0.504,0.001,997,1007,10,2,0.001,2004,7
0.462,0.001,49,55,10,2,0.001,104,8
0.462,0.001,97,107,10,2,0.001,204,8
0.462,0.001,154,150,10,2,0.001,304,8
0.462,0.001,213,191,10,2,0.001,404,8
0.462,0.001,264,240,10,2,0.001,504,8
0.462,0.001,310,294,10,2,0.001,604,8
0.464,0.001,360,344,10,2,0.001,704,8
0.464,0.001,405,399,10,2,0.001,804,8
0.464,0.001,454,450,10,2,0.001,904,8
0.466,0.001,497,507,10,2,0.001,1004,8
0.468,0.001,542,562,10,2,0.001,1104,8
0.468,0.001,584,620,10,2,0.001,1204,8
0.478,0.001,642,662,10,2,0.001,1304,8
0.482,0.001,695,709,10,2,0.001,1404,8
0.486,0.001,748,756,10,2,0.001,1504,8
0.486,0.001,799,805,10,2,0.001,1604,8
0.494,0.001,846,858,10,2,0.001,1704,8
0.494,0.001,901,903,10,2,0.001,1804,8
0.494,0.001,949,955,10,2,0.001,1904,8
0.496,0.001,1002,1002,10,2,0.001,2004,8
0.48,0.001,53,51,10,2,0.001,104,9
0.48,0.001,101,103,10,2,0.001,204,9
0.48,0.001,151,153,10,2,0.001,304,9
0.48,0.001,205,199,10,2,0.001,404,9
0.48,0.001,246,258,10,2,0.001,504,9
0.48,0.001,298,306,10,2,0.001,604,9
0.48,0.001,341,363,10,2,0.001,704,9
0.48,0.001,387,417,10,2,0.001,804,9
0.48,0.001,439,465,10,2,0.001,904,9
0.48,0.001,497,507,10,2,0.001,1004,9
0.48,0.001,543,561,10,2,0.001,1104,9
0.48,0.001,588,616,10,2,0.001,1204,9
0.48,0.001,635,669,10,2,0.001,1304,9
0.48,0.001,683,721,10,2,0.001,1404,9
0.48,0.001,741,763,10,2,0.001,1504,9
0.48,0.001,795,809,10,2,0.001,1604,9
0.48,0.001,844,860,10,2,0.001,1704,9
0.48,0.001,891,913,10,2,0.001,1804,9
0.48,0.001,948,956,10,2,0.001,1904,9
0.48,0.001,992,1012,10,2,0.001,2004,9
0.494,0.001,49,55,10,2,0.001,104,10
0.494,0.001,104,100,10,2,0.001,204,10
0.494,0.001,163,141,10,2,0.001,304,10
0.494,0.001,228,176,10,2,0.001,404,10
0.494,0.001,271,233,10,2,0.001,504,10
0.494,0.001,322,282,10,2,0.001,604,10
0.494,0.001,373,331,10,2,0.001,704,10
0.494,0.001,423,381,10,2,0.001,804,10
0.494,0.001,464,440,10,2,0.001,904,10
0.494,0.001,515,489,10,2,0.001,1004,10
0.494,0.001,572,532,10,2,0.001,1104,10
0.494,0.001,628,576,10,2,0.001,1204,10
0.494,0.001,672,632,10,2,0.001,1304,10
0.494,0.001,718,686,10,2,0.001,1404,10
0.494,0.001,770,734,10,2,0.001,1504,10
0.494,0.001,802,802,10,2,0.001,1604,10
0.494,0.001,853,851,10,2,0.001,1704,10
0.494,0.001,901,903,10,2,0.001,1804,10
0.494,0.001,953,951,10,2,0.001,1904,10
0.494,0.001,1005,999,10,2,0.001,2004,10
0.482,0.001,58,46,10,2,0.001,104,11
0.482,0.001,103,101,10,2,0.001,204,11
0.482,0.001,153,151,10,2,0.001,304,11
0.482,0.001,209,195,10,2,0.001,404,11
0.482,0.001,256,248,10,2,0.001,504,11
0.482,0.001,304,300,10,2,0.001,604,11
0.482,0.001,357,347,10,2,0.001,704,11
0.482,0.001,417,387,10,2,0.001,804,11
0.482,0.001,468,436,10,2,0.001,904,11
0.482,0.001,511,493,10,2,0.001,1004,11
0.482,0.001,562,542,10,2,0.001,1104,11
0.482,0.001,603,601,10,2,0.001,1204,11
0.482,0.001,646,658,10,2,0.001,1304,11
0.482,0.001,702,702,10,2,0.001,1404,11
0.482,0.001,752,752,10,2,0.001,1504,11
0.482,0.001,790,814,10,2,0.001,1604,11
0.482,0.001,836,868,10,2,0.001,1704,11
0.482,0.001,896,908,10,2,0.001,1804,11
0.482,0.001,948,956,10,2,0.001,1904,11
0.482,0.001,993,1011,10,2,0.001,2004,11
0.526,0.001,55,49,10,2,0.001,104,12
0.526,0.001,110,94,10,2,0.001,204,12
0.524,0.001,171,133,10,2,0.001,304,12
0.524,0.001,222,182,10,2,0.001,404,12
0.524,0.001,270,234,10,2,0.001,504,12
0.524,0.001,307,297,10,2,0.001,604,12
0.522,0.001,351,353,10,2,0.001,704,12
0.524,0.001,402,402,10,2,0.001,804,12
0.524,0.001,446,458,10,2,0.001,904,12
0.524,0.001,497,507,10,2,0.001,1004,12
0.52,0.001,540,564,10,2,0.001,1104,12
0.522,0.001,586,618,10,2,0.001,1204,12
0.514,0.001,634,670,10,2,0.001,1304,12
0.518,0.001,685,719,10,2,0.001,1404,12
0.526,0.001,738,766,10,2,0.001,1504,12
0.526,0.001,781,823,10,2,0.001,1604,12
0.524,0.001,832,872,10,2,0.001,1704,12
0.524,0.001,892,912,10,2,0.001,1804,12
0.524,0.001,943,961,10,2,0.001,1904,12
0.522,0.001,986,1018,10,2,0.001,2004,12
0.474,0.001,63,41,10,2,0.001,104,13
0.48,0.001,106,98,10,2,0.001,204,13
0.48,0.001,162,142,10,2,0.001,304,13
0.48,0.001,206,198,10,2,0.001,404,13
0.48,0.001,256,248,10,2,0.001,504,13
0.48,0.001,304,300,10,2,0.001,604,13
0.478,0.001,350,354,10,2,0.001,704,13
0.48,0.001,407,397,10,2,0.001,804,13
0.476,0.001,463,441,10,2,0.001,904,13
0.48,0.001,504,500,10,2,0.001,1004,13
0.484,0.001,549,555,10,2,0.001,1104,13
0.482,0.001,594,610,10,2,0.001,1204,13
0.486,0.001,643,661,10,2,0.001,1304,13
0.488,0.001,693,711,10,2,0.001,1404,13
0.492,0.001,742,762,10,2,0.001,1504,13
0.492,0.001,801,803,10,2,0.001,1604,13
0.496,0.001,853,851,10,2,0.001,1704,13
0.496,0.001,903,901,10,2,0.001,1804,13
0.49,0.001,953,951,10,2,0.001,1904,13
0.494,0.001,1002,1002,10,2,0.001,2004,13
0.52,0.001,50,54,10,2,0.001,104,14
0.526,0.001,93,111,10,2,0.001,204,14
0.526,0.001,142,162,10,2,0.001,304,14
0.526,0.001,187,217,10,2,0.001,404,14
0.528,0.001,237,267,10,2,0.001,504,14
0.53,0.001,295,309,10,2,0.001,604,14
0.528,0.001,352,352,10,2,0.001,704,14
0.532,0.001,398,406,10,2,0.001,804,14
0.536,0.001,452,452,10,2,0.001,904,14
0.538,0.001,506,498,10,2,0.001,1004,14
0.538,0.001,555,549,10,2,0.001,1104,14
0.538,0.001,600,604,10,2,0.001,1204,14
0.54,0.001,652,652,10,2,0.001,1304,14
0.542,0.001,708,696,10,2,0.001,1404,14
0.544,0.001,766,738,10,2,0.001,1504,14
0.544,0.001,807,797,10,2,0.001,1604,14
0.548,0.001,858,846,10,2,0.001,1704,14
0.55,0.001,906,898,10,2,0.001,1804,14
0.55,0.001,957,947,10,2,0.001,1904,14
0.548,0.001,1007,997,10,2,0.001,2004,14
0.512,0.001,50,54,10,2,0.001,104,15
0.512,0.001,102,102,10,2,0.001,204,15
0.512,0.001,153,151,10,2,0.001,304,15
0.512,0.001,205,199,10,2,0.001,404,15
0.512,0.001,247,257,10,2,0.001,504,15
0.512,0.001,302,302,10,2,0.001,604,15
0.512,0.001,348,356,10,2,0.001,704,15
0.512,0.001,401,403,10,2,0.001,804,15
0.512,0.001,450,454,10,2,0.001,904,15
0.512,0.001,497,507,10,2,0.001,1004,15
0.512,0.001,548,556,10,2,0.001,1104,15
0.512,0.001,602,602,10,2,0.001,1204,15
0.512,0.001,654,650,10,2,0.001,1304,15
0.512,0.001,706,698,10,2,0.001,1404,15
0.512,0.001,755,749,10,2,0.001,1504,15
0.512,0.001,813,791,10,2,0.001,1604,15
0.512,0.001,867,837,10,2,0.001,1704,15
0.512,0.001,914,890,10,2,0.001,1804,15
0.512,0.001,964,940,10,2,0.001,1904,15
0.512,0.001,1008,996,10,2,0.001,2004,15
0.474,0.001,53,51,10,2,0.001,104,16
0.474,0.001,98,106,10,2,0.001,204,16
0.474,0.001,140,164,10,2,0.001,304,16
0.474,0.001,182,222,10,2,0.001,404,16
0.474,0.001,230,274,10,2,0.001,504,16
0.474,0.001,277,327,10,2,0.001,604,16
0.474,0.001,333,371,10,2,0.001,704,16
0.474,0.001,393,411,10,2,0.001,804,16
0.474,0.001,451,453,10,2,0.001,904,16
0.474,0.001,501,503,10,2,0.001,1004,16
0.474,0.001,548,556,10,2,0.001,1104,16
0.474,0.001,597,607,10,2,0.001,1204,16
0.474,0.001,643,661,10,2,0.001,1304,16
0.474,0.001,696,708,10,2,0.001,1404,16
0.474,0.001,743,761,10,2,0.001,1504,16
0.474,0.001,800,804,10,2,0.001,1604,16
0.474,0.001,853,851,10,2,0.001,1704,16
0.474,0.001,900,904,10,2,0.001,1804,16
0.474,0.001,947,957,10,2,0.001,1904,16
0.474,0.001,989,1015,10,2,0.001,2004,16
0.476,0.001,52,52,10,2,0.001,104,17
0.476,0.001,105,99,10,2,0.001,204,17
0.476,0.001,152,152,10,2,0.001,304,17
0.476,0.001,195,209,10,2,0.001,404,17
0.476,0.001,254,250,10,2,0.001,504,17
0.476,0.001,305,299,10,2,0.001,604,17
0.476,0.001,347,357,10,2,0.001,704,17
0.476,0.001,401,403,10,2,0.001,804,17
0.476,0.001,442,462,10,2,0.001,904,17
0.476,0.001,493,511,10,2,0.001,1004,17
0.476,0.001,538,566,10,2,0.001,1104,17
0.476,0.001,593,611,10,2,0.001,1204,17
0.476,0.001,645,659,10,2,0.001,1304,17
0.478,0.001,692,712,10,2,0.001,1404,17
0.48,0.001,743,761,10,2,0.001,1504,17
0.48,0.001,800,804,10,2,0.001,1604,17
0.48,0.001,850,854,10,2,0.001,1704,17
0.474,0.001,899,905,10,2,0.001,1804,17
0.476,0.001,942,962,10,2,0.001,1904,17
0.476,0.001,989,1015,10,2,0.001,2004,17
0.526,0.001,51,53,10,2,0.001,104,18
0.526,0.001,103,101,10,2,0.001,204,18
0.526,0.001,146,158,10,2,0.001,304,18
0.526,0.001,200,204,10,2,0.001,404,18
0.526,0.001,252,252,10,2,0.001,504,18
0.526,0.001,295,309,10,2,0.001,604,18
0.526,0.001,334,370,10,2,0.001,704,18
0.526,0.001,388,416,10,2,0.001,804,18
0.526,0.001,434,470,10,2,0.001,904,18
0.526,0.001,490,514,10,2,0.001,1004,18
0.526,0.001,542,562,10,2,0.001,1104,18
0.526,0.001,590,614,10,2,0.001,1204,18
0.526,0.001,639,665,10,2,0.001,1304,18
0.526,0.001,687,717,10,2,0.001,1404,18
0.526,0.001,731,773,10,2,0.001,1504,18
0.526,0.001,785,819,10,2,0.001,1604,18
0.526,0.001,837,867,10,2,0.001,1704,18
0.526,0.001,888,916,10,2,0.001,1804,18
0.526,0.001,935,969,10,2,0.001,1904,18
0.526,0.001,989,1015,10,2,0.001,2004,18
0.508,0.001,56,48,10,2,0.001,104,19
0.508,0.001,108,96,10,2,0.001,204,19
0.508,0.001,157,147,10,2,0.001,304,19
0.508,0.001,206,198,10,2,0.001,404,19
0.508,0.001,259,245,10,2,0.001,504,19
0.508,0.001,312,292,10,2,0.001,604,19
0.508,0.001,358,346,10,2,0.001,704,19
0.508,0.001,400,404,10,2,0.001,804,19
0.508,0.001,445,459,10,2,0.001,904,19
0.508,0.001,508,496,10,2,0.001,1004,19
0.508,0.001,555,549,10,2,0.001,1104,19
0.508,0.001,600,604,10,2,0.001,1204,19
0.508,0.001,648,656,10,2,0.001,1304,19
0.508,0.001,699,705,10,2,0.001,1404,19
0.508,0.001,749,755,10,2,0.001,1504,19
0.508,0.001,800,804,10,2,0.001,1604,19
0.508,0.001,848,856,10,2,0.001,1704,19
0.508,0.001,895,909,10,2,0.001,1804,19
0.508,0.001,954,950,10,2,0.001,1904,19
0.508,0.001,1006,998,10,2,0.001,2004,19
0.556,0.001,53,51,10,2,0.001,104,20
0.556,0.001,99,105,10,2,0.001,204,20
0.554,0.001,155,149,10,2,0.001,304,20
0.556,0.001,211,193,10,2,0.001,404,20
0.558,0.001,259,245,10,2,0.001,504,20
0.56,0.001,311,293,10,2,0.001,604,20
0.562,0.001,360,344,10,2,0.001,704,20
0.568,0.001,419,385,10,2,0.001,804,20
0.57,0.001,470,434,10,2,0.001,904,20
0.57,0.001,522,482,10,2,0.001,1004,20
0.576,0.001,566,538,10,2,0.001,1104,20
0.576,0.001,627,577,10,2,0.001,1204,20
0.58,0.001,679,625,10,2,0.001,1304,20
0.584,0.001,734,670,10,2,0.001,1404,20
0.59,0.001,783,721,10,2,0.001,1504,20
0.598,0.001,828,776,10,2,0.001,1604,20
0.6,0.001,876,828,10,2,0.001,1704,20
0.608,0.001,931,873,10,2,0.001,1804,20
0.616,0.001,977,927,10,2,0.001,1904,20
0.618,0.001,1021,983,10,2,0.001,2004,20
0.534,0.001,61,43,10,2,0.01,104,1
0.54,0.001,109,95,10,2,0.01,204,1
0.536,0.001,156,148,10,2,0.01,304,1
0.542,0.001,208,196,10,2,0.01,404,1
0.546,0.001,249,255,10,2,0.01,504,1
0.562,0.001,293,311,10,2,0.01,604,1
0.566,0.001,346,358,10,2,0.01,704,1
0.564,0.001,394,410,10,2,0.01,804,1
0.566,0.001,451,453,10,2,0.01,904,1
0.568,0.001,509,495,10,2,0.01,1004,1
0.576,0.001,559,545,10,2,0.01,1104,1
0.568,0.001,613,591,10,2,0.01,1204,1
0.572,0.001,654,650,10,2,0.01,1304,1
0.58,0.001,705,699,10,2,0.01,1404,1
0.59,0.001,756,748,10,2,0.01,1504,1
0.612,0.001,806,798,10,2,0.01,1604,1
0.66,0.001,859,845,10,2,0.01,1704,1
0.672,0.001,903,901,10,2,0.01,1804,1
0.712,0.001,948,956,10,2,0.01,1904,1
0.738,0.001,996,1008,10,2,0.01,2004,1
0.484,0.001,58,46,10,2,0.01,104,2
0.49,0.001,102,102,10,2,0.01,204,2
0.494,0.001,155,149,10,2,0.01,304,2
0.504,0.001,210,194,10,2,0.01,404,2
0.51,0.001,271,233,10,2,0.01,504,2
0.534,0.001,317,287,10,2,0.01,604,2
0.536,0.001,366,338,10,2,0.01,704,2
0.536,0.001,414,390,10,2,0.01,804,2
0.556,0.001,465,439,10,2,0.01,904,2
0.584,0.001,506,498,10,2,0.01,1004,2
0.594,0.001,558,546,10,2,0.01,1104,2
0.61,0.001,619,585,10,2,0.01,1204,2
0.602,0.001,662,642,10,2,0.01,1304,2
0.616,0.001,716,688,10,2,0.01,1404,2
0.654,0.001,766,738,10,2,0.01,1504,2
0.73,0.001,817,787,10,2,0.01,1604,2
0.786,0.001,863,841,10,2,0.01,1704,2
0.804,0.001,906,898,10,2,0.01,1804,2
0.816,0.001,957,947,10,2,0.01,1904,2
0.83,0.001,1003,1001,10,2,0.01,2004,2
0.474,0.001,50,54,10,2,0.01,104,3
0.48,0.001,100,104,10,2,0.01,204,3
0.484,0.001,145,159,10,2,0.01,304,3
0.494,0.001,196,208,10,2,0.01,404,3
0.51,0.001,252,252,10,2,0.01,504,3
0.524,0.001,301,303,10,2,0.01,604,3
0.54,0.001,347,357,10,2,0.01,704,3
0.544,0.001,396,408,10,2,0.01,804,3
0.542,0.001,438,466,10,2,0.01,904,3
0.548,0.001,484,520,10,2,0.01,1004,3
0.554,0.001,532,572,10,2,0.01,1104,3
0.564,0.001,577,627,10,2,0.01,1204,3
0.562,0.001,632,672,10,2,0.01,1304,3
0.57,0.001,692,712,10,2,0.01,1404,3
0.6,0.001,756,748,10,2,0.01,1504,3
0.6,0.001,800,804,10,2,0.01,1604,3
0.616,0.001,851,853,10,2,0.01,1704,3
0.624,0.001,909,895,10,2,0.01,1804,3
0.628,0.001,962,942,10,2,0.01,1904,3
0.636,0.001,1009,995,10,2,0.01,2004,3
0.492,0.001,45,59,10,2,0.01,104,4
0.492,0.001,94,110,10,2,0.01,204,4
0.492,0.001,139,165,10,2,0.01,304,4
0.492,0.001,188,216,10,2,0.01,404,4
0.492,0.001,236,268,10,2,0.01,504,4
0.492,0.001,293,311,10,2,0.01,604,4
0.492,0.001,344,360,10,2,0.01,704,4
0.492,0.001,391,413,10,2,0.01,804,4
0.492,0.001,440,464,10,2,0.01,904,4
0.492,0.001,493,511,10,2,0.01,1004,4
0.492,0.001,547,557,10,2,0.01,1104,4
0.492,0.001,597,607,10,2,0.01,1204,4
0.492,0.001,655,649,10,2,0.01,1304,4
0.492,0.001,699,705,10,2,0.01,1404,4
0.492,0.001,747,757,10,2,0.01,1504,4
0.492,0.001,795,809,10,2,0.01,1604,4
0.492,0.001,843,861,10,2,0.01,1704,4
0.492,0.001,901,903,10,2,0.01,1804,4
0.492,0.001,951,953,10,2,0.01,1904,4
0.492,0.001,998,1006,10,2,0.01,2004,4
0.492,0.001,47,57,10,2,0.01,104,5
0.498,0.001,94,110,10,2,0.01,204,5
0.492,0.001,154,150,10,2,0.01,304,5
0.494,0.001,201,203,10,2,0.01,404,5
0.508,0.001,248,256,10,2,0.01,504,5
0.514,0.001,296,308,10,2,0.01,604,5
0.508,0.001,342,362,10,2,0.01,704,5
0.51,0.001,392,412,10,2,0.01,804,5
0.526,0.001,445,459,10,2,0.01,904,5
0.522,0.001,502,502,10,2,0.01,1004,5
0.536,0.001,550,554,10,2,0.01,1104,5
0.542,0.001,601,603,10,2,0.01,1204,5
0.558,0.001,654,650,10,2,0.01,1304,5
0.562,0.001,702,702,10,2,0.01,1404,5
0.562,0.001,749,755,10,2,0.01,1504,5
0.572,0.001,800,804,10,2,0.01,1604,5
0.582,0.001,846,858,10,2,0.01,1704,5
0.592,0.001,895,909,10,2,0.01,1804,5
0.59,0.001,948,956,10,2,0.01,1904,5
0.598,0.001,997,1007,10,2,0.01,2004,5
0.488,0.001,50,54,10,2,0.01,104,6
0.486,0.001,105,99,10,2,0.01,204,6
0.492,0.001,148,156,10,2,0.01,304,6
0.49,0.001,200,204,10,2,0.01,404,6
0.482,0.001,249,255,10,2,0.01,504,6
0.484,0.001,300,304,10,2,0.01,604,6
0.494,0.001,356,348,10,2,0.01,704,6
0.512,0.001,405,399,10,2,0.01,804,6
0.516,0.001,446,458,10,2,0.01,904,6
0.522,0.001,492,512,10,2,0.01,1004,6
0.546,0.001,546,558,10,2,0.01,1104,6
0.562,0.001,595,609,10,2,0.01,1204,6
0.572,0.001,647,657,10,2,0.01,1304,6
0.572,0.001,691,713,10,2,0.01,1404,6
0.594,0.001,738,766,10,2,0.01,1504,6
0.616,0.001,791,813,10,2,0.01,1604,6
0.616,0.001,849,855,10,2,0.01,1704,6
0.628,0.001,903,901,10,2,0.01,1804,6
0.64,0.001,951,953,10,2,0.01,1904,6
0.644,0.001,1007,997,10,2,0.01,2004,6
0.506,0.001,55,49,10,2,0.01,104,7
0.512,0.001,107,97,10,2,0.01,204,7
0.514,0.001,161,143,10,2,0.01,304,7
0.524,0.001,207,197,10,2,0.01,404,7
0.528,0.001,261,243,10,2,0.01,504,7
0.536,0.001,323,281,10,2,0.01,604,7
0.548,0.001,376,328,10,2,0.01,704,7
0.554,0.001,425,379,10,2,0.01,804,7
0.554,0.001,480,424,10,2,0.01,904,7
0.556,0.001,528,476,10,2,0.01,1004,7
0.572,0.001,583,521,10,2,0.01,1104,7
0.592,0.001,620,584,10,2,0.01,1204,7
0.634,0.001,672,632,10,2,0.01,1304,7
0.67,0.001,722,682,10,2,0.01,1404,7
0.704,0.001,775,729,10,2,0.01,1504,7
0.72,0.001,820,784,10,2,0.01,1604,7
0.738,0.001,868,836,10,2,0.01,1704,7
0.74,0.001,923,881,10,2,0.01,1804,7
0.736,0.001,968,936,10,2,0.01,1904,7
0.738,0.001,1011,993,10,2,0.01,2004,7
0.48,0.001,56,48,10,2,0.01,104,8
0.48,0.001,110,94,10,2,0.01,204,8
0.48,0.001,170,134,10,2,0.01,304,8
0.48,0.001,219,185,10,2,0.01,404,8
0.48,0.001,267,237,10,2,0.01,504,8
0.48,0.001,316,288,10,2,0.01,604,8
0.48,0.001,361,343,10,2,0.01,704,8
0.48,0.001,408,396,10,2,0.01,804,8
0.48,0.001,462,442,10,2,0.01,904,8
0.48,0.001,524,480,10,2,0.01,1004,8
0.48,0.001,574,530,10,2,0.01,1104,8
0.48,0.001,628,576,10,2,0.01,1204,8
0.654,0.001,674,630,10,2,0.01,1304,8
0.742,0.001,724,680,10,2,0.01,1404,8
0.75,0.001,780,724,10,2,0.01,1504,8
0.762,0.001,827,777,10,2,0.01,1604,8
0.78,0.001,879,825,10,2,0.01,1704,8
0.79,0.001,928,876,10,2,0.01,1804,8
0.796,0.001,972,932,10,2,0.01,1904,8
0.802,0.001,1012,992,10,2,0.01,2004,8
0.488,0.001,57,47,10,2,0.01,104,9
0.5,0.001,106,98,10,2,0.01,204,9
0.502,0.001,164,140,10,2,0.01,304,9
0.516,0.001,207,197,10,2,0.01,404,9
0.506,0.001,248,256,10,2,0.01,504,9
0.51,0.001,298,306,10,2,0.01,604,9
0.512,0.001,354,350,10,2,0.01,704,9
0.492,0.001,413,391,10,2,0.01,804,9
0.504,0.001,453,451,10,2,0.01,904,9
0.516,0.001,501,503,10,2,0.01,1004,9
0.514,0.001,552,552,10,2,0.01,1104,9
0.52,0.001,597,607,10,2,0.01,1204,9
0.526,0.001,646,658,10,2,0.01,1304,9
0.542,0.001,698,706,10,2,0.01,1404,9
0.54,0.001,756,748,10,2,0.01,1504,9
0.532,0.001,807,797,10,2,0.01,1604,9
0.526,0.001,862,842,10,2,0.01,1704,9
0.546,0.001,910,894,10,2,0.01,1804,9
0.562,0.001,959,945,10,2,0.01,1904,9
0.558,0.001,1002,1002,10,2,0.01,2004,9
0.524,0.001,51,53,10,2,0.01,104,10
0.522,0.001,99,105,10,2,0.01,204,10
0.518,0.001,152,152,10,2,0.01,304,10
0.532,0.001,206,198,10,2,0.01,404,10
0.528,0.001,258,246,10,2,0.01,504,10
0.514,0.001,311,293,10,2,0.01,604,10
0.532,0.001,358,346,10,2,0.01,704,10
0.534,0.001,403,401,10,2,0.01,804,10
0.526,0.001,451,453,10,2,0.01,904,10
0.526,0.001,498,506,10,2,0.01,1004,10
0.536,0.001,547,557,10,2,0.01,1104,10
0.554,0.001,602,602,10,2,0.01,1204,10
0.572,0.001,656,648,10,2,0.01,1304,10
0.58,0.001,710,694,10,2,0.01,1404,10
0.584,0.001,765,739,10,2,0.01,1504,10
0.594,0.001,820,784,10,2,0.01,1604,10
0.604,0.001,867,837,10,2,0.01,1704,10
0.62,0.001,926,878,10,2,0.01,1804,10
0.606,0.001,970,934,10,2,0.01,1904,10
0.626,0.001,1013,991,10,2,0.01,2004,10
0.514,0.001,48,56,10,2,0.01,104,11
0.514,0.001,91,113,10,2,0.01,204,11
0.514,0.001,135,169,10,2,0.01,304,11
0.514,0.001,195,209,10,2,0.01,404,11
0.514,0.001,249,255,10,2,0.01,504,11
0.528,0.001,301,303,10,2,0.01,604,11
0.554,0.001,349,355,10,2,0.01,704,11
0.598,0.001,389,415,10,2,0.01,804,11
0.616,0.001,439,465,10,2,0.01,904,11
0.628,0.001,481,523,10,2,0.01,1004,11
0.616,0.001,542,562,10,2,0.01,1104,11
0.628,0.001,590,614,10,2,0.01,1204,11
0.642,0.001,642,662,10,2,0.01,1304,11
0.636,0.001,695,709,10,2,0.01,1404,11
0.652,0.001,750,754,10,2,0.01,1504,11
0.656,0.001,795,809,10,2,0.01,1604,11
0.664,0.001,840,864,10,2,0.01,1704,11
0.678,0.001,888,916,10,2,0.01,1804,11
0.674,0.001,938,966,10,2,0.01,1904,11
0.672,0.001,995,1009,10,2,0.01,2004,11
0.532,0.001,60,44,10,2,0.01,104,12
0.532,0.001,111,93,10,2,0.01,204,12
0.532,0.001,167,137,10,2,0.01,304,12
0.532,0.001,222,182,10,2,0.01,404,12
0.532,0.001,268,236,10,2,0.01,504,12
0.532,0.001,318,286,10,2,0.01,604,12
0.532,0.001,370,334,10,2,0.01,704,12
0.532,0.001,416,388,10,2,0.01,804,12
0.532,0.001,460,444,10,2,0.01,904,12
0.532,0.001,511,493,10,2,0.01,1004,12
0.532,0.001,559,545,10,2,0.01,1104,12
0.532,0.001,612,592,10,2,0.01,1204,12
0.532,0.001,669,635,10,2,0.01,1304,12
0.532,0.001,726,678,10,2,0.01,1404,12
0.532,0.001,775,729,10,2,0.01,1504,12
0.532,0.001,815,789,10,2,0.01,1604,12
0.532,0.001,866,838,10,2,0.01,1704,12
0.532,0.001,921,883,10,2,0.01,1804,12
0.532,0.001,970,934,10,2,0.01,1904,12
0.532,0.001,1018,986,10,2,0.01,2004,12
0.464,0.001,51,53,10,2,0.01,104,13
0.464,0.001,93,111,10,2,0.01,204,13
0.464,0.001,140,164,10,2,0.01,304,13
0.464,0.001,189,215,10,2,0.01,404,13
0.464,0.001,240,264,10,2,0.01,504,13
0.464,0.001,297,307,10,2,0.01,604,13
0.464,0.001,347,357,10,2,0.01,704,13
0.464,0.001,386,418,10,2,0.01,804,13
0.464,0.001,437,467,10,2,0.01,904,13
0.464,0.001,484,520,10,2,0.01,1004,13
0.464,0.001,531,573,10,2,0.01,1104,13
0.464,0.001,579,625,10,2,0.01,1204,13
0.464,0.001,631,673,10,2,0.01,1304,13
0.464,0.001,686,718,10,2,0.01,1404,13
0.464,0.001,736,768,10,2,0.01,1504,13
0.464,0.001,783,821,10,2,0.01,1604,13
0.448,0.001,832,872,10,2,0.01,1704,13
0.448,0.001,880,924,10,2,0.01,1804,13
0.566,0.001,931,973,10,2,0.01,1904,13
0.572,0.001,984,1020,10,2,0.01,2004,13
0.478,0.001,53,51,10,2,0.01,104,14
0.476,0.001,109,95,10,2,0.01,204,14
0.474,0.001,162,142,10,2,0.01,304,14
0.478,0.001,219,185,10,2,0.01,404,14
0.494,0.001,260,244,10,2,0.01,504,14
0.5,0.001,304,300,10,2,0.01,604,14
0.504,0.001,353,351,10,2,0.01,704,14
0.512,0.001,399,405,10,2,0.01,804,14
0.524,0.001,447,457,10,2,0.01,904,14
0.526,0.001,506,498,10,2,0.01,1004,14
0.528,0.001,555,549,10,2,0.01,1104,14
0.532,0.001,617,587,10,2,0.01,1204,14
0.54,0.001,664,640,10,2,0.01,1304,14
0.542,0.001,711,693,10,2,0.01,1404,14
0.524,0.001,757,747,10,2,0.01,1504,14
0.57,0.001,800,804,10,2,0.01,1604,14
0.594,0.001,848,856,10,2,0.01,1704,14
0.694,0.001,895,909,10,2,0.01,1804,14
0.696,0.001,944,960,10,2,0.01,1904,14
0.698,0.001,986,1018,10,2,0.01,2004,14
0.498,0.001,60,44,10,2,0.01,104,15
0.498,0.001,113,91,10,2,0.01,204,15
0.498,0.001,156,148,10,2,0.01,304,15
0.498,0.001,211,193,10,2,0.01,404,15
0.498,0.001,261,243,10,2,0.01,504,15
0.498,0.001,311,293,10,2,0.01,604,15
0.498,0.001,367,337,10,2,0.01,704,15
0.498,0.001,409,395,10,2,0.01,804,15
0.5,0.001,467,437,10,2,0.01,904,15
0.512,0.001,517,487,10,2,0.01,1004,15
0.534,0.001,566,538,10,2,0.01,1104,15
0.548,0.001,613,591,10,2,0.01,1204,15
0.56,0.001,660,644,10,2,0.01,1304,15
0.568,0.001,702,702,10,2,0.01,1404,15
0.576,0.001,748,756,10,2,0.01,1504,15
0.588,0.001,804,800,10,2,0.01,1604,15
0.6,0.001,851,853,10,2,0.01,1704,15
0.616,0.001,904,900,10,2,0.01,1804,15
0.628,0.001,956,948,10,2,0.01,1904,15
0.646,0.001,1001,1003,10,2,0.01,2004,15
0.514,0.001,54,50,10,2,0.01,104,16
0.522,0.001,103,101,10,2,0.01,204,16
0.53,0.001,164,140,10,2,0.01,304,16
0.532,0.001,207,197,10,2,0.01,404,16
0.55,0.001,263,241,10,2,0.01,504,16
0.562,0.001,307,297,10,2,0.01,604,16
0.56,0.001,361,343,10,2,0.01,704,16
0.556,0.001,410,394,10,2,0.01,804,16
0.548,0.001,451,453,10,2,0.01,904,16
0.544,0.001,496,508,10,2,0.01,1004,16
0.538,0.001,542,562,10,2,0.01,1104,16
0.546,0.001,595,609,10,2,0.01,1204,16
0.578,0.001,647,657,10,2,0.01,1304,16
0.608,0.001,697,707,10,2,0.01,1404,16
0.642,0.001,749,755,10,2,0.01,1504,16
0.666,0.001,797,807,10,2,0.01,1604,16
0.68,0.001,852,852,10,2,0.01,1704,16
0.686,0.001,904,900,10,2,0.01,1804,16
0.682,0.001,951,953,10,2,0.01,1904,16
0.632,0.001,999,1005,10,2,0.01,2004,16
0.536,0.001,52,52,10,2,0.01,104,17
0.54,0.001,87,117,10,2,0.01,204,17
0.546,0.001,137,167,10,2,0.01,304,17
0.546,0.001,191,213,10,2,0.01,404,17
0.542,0.001,239,265,10,2,0.01,504,17
0.54,0.001,293,311,10,2,0.01,604,17
0.552,0.001,343,361,10,2,0.01,704,17
0.584,0.001,391,413,10,2,0.01,804,17
0.61,0.001,445,459,10,2,0.01,904,17
0.646,0.001,491,513,10,2,0.01,1004,17
0.672,0.001,536,568,10,2,0.01,1104,17
0.696,0.001,585,619,10,2,0.01,1204,17
0.73,0.001,637,667,10,2,0.01,1304,17
0.768,0.001,685,719,10,2,0.01,1404,17
0.772,0.001,737,767,10,2,0.01,1504,17
0.774,0.001,780,824,10,2,0.01,1604,17
0.788,0.001,831,873,10,2,0.01,1704,17
0.788,0.001,880,924,10,2,0.01,1804,17
0.788,0.001,937,967,10,2,0.01,1904,17
0.794,0.001,995,1009,10,2,0.01,2004,17
0.512,0.001,43,61,10,2,0.01,104,18
0.516,0.001,97,107,10,2,0.01,204,18
0.52,0.001,146,158,10,2,0.01,304,18
0.524,0.001,198,206,10,2,0.01,404,18
0.538,0.001,247,257,10,2,0.01,504,18
0.576,0.001,297,307,10,2,0.01,604,18
0.596,0.001,353,351,10,2,0.01,704,18
0.624,0.001,395,409,10,2,0.01,804,18
0.648,0.001,441,463,10,2,0.01,904,18
0.67,0.001,498,506,10,2,0.01,1004,18
0.678,0.001,542,562,10,2,0.01,1104,18
0.694,0.001,589,615,10,2,0.01,1204,18
0.702,0.001,643,661,10,2,0.01,1304,18
0.718,0.001,688,716,10,2,0.01,1404,18
0.72,0.001,747,757,10,2,0.01,1504,18
0.72,0.001,798,806,10,2,0.01,1604,18
0.722,0.001,848,856,10,2,0.01,1704,18
0.722,0.001,902,902,10,2,0.01,1804,18
0.722,0.001,960,944,10,2,0.01,1904,18
0.722,0.001,1008,996,10,2,0.01,2004,18
0.514,0.001,53,51,10,2,0.01,104,19
0.532,0.001,106,98,10,2,0.01,204,19
0.532,0.001,156,148,10,2,0.01,304,19
0.538,0.001,209,195,10,2,0.01,404,19
0.54,0.001,253,251,10,2,0.01,504,19
0.558,0.001,290,314,10,2,0.01,604,19
0.554,0.001,341,363,10,2,0.01,704,19
0.55,0.001,388,416,10,2,0.01,804,19
0.534,0.001,444,460,10,2,0.01,904,19
0.546,0.001,483,521,10,2,0.01,1004,19
0.544,0.001,538,566,10,2,0.01,1104,19
0.542,0.001,585,619,10,2,0.01,1204,19
0.538,0.001,638,666,10,2,0.01,1304,19
0.556,0.001,688,716,10,2,0.01,1404,19
0.562,0.001,743,761,10,2,0.01,1504,19
0.568,0.001,787,817,10,2,0.01,1604,19
0.538,0.001,846,858,10,2,0.01,1704,19
0.552,0.001,897,907,10,2,0.01,1804,19
0.586,0.001,949,955,10,2,0.01,1904,19
0.606,0.001,995,1009,10,2,0.01,2004,19
0.552,0.001,45,59,10,2,0.01,104,20
0.57,0.001,91,113,10,2,0.01,204,20
0.582,0.001,139,165,10,2,0.01,304,20
0.586,0.001,184,220,10,2,0.01,404,20
0.598,0.001,233,271,10,2,0.01,504,20
0.598,0.001,278,326,10,2,0.01,604,20
0.6,0.001,325,379,10,2,0.01,704,20
0.594,0.001,382,422,10,2,0.01,804,20
0.592,0.001,436,468,10,2,0.01,904,20
0.588,0.001,483,521,10,2,0.01,1004,20
0.578,0.001,540,564,10,2,0.01,1104,20
0.576,0.001,584,620,10,2,0.01,1204,20
0.574,0.001,638,666,10,2,0.01,1304,20
0.576,0.001,687,717,10,2,0.01,1404,20
0.576,0.001,735,769,10,2,0.01,1504,20
0.578,0.001,787,817,10,2,0.01,1604,20
0.584,0.001,846,858,10,2,0.01,1704,20
0.608,0.001,891,913,10,2,0.01,1804,20
0.632,0.001,940,964,10,2,0.01,1904,20
0.61,0.001,984,1020,10,2,0.01,2004,20
0.47,1e-05,46,58,10,10,0.0001,104,1
0.47,1e-05,100,104,10,10,0.0001,204,1
0.47,1e-05,153,151,10,10,0.0001,304,1
0.468,1e-05,197,207,10,10,0.0001,404,1
0.468,1e-05,248,256,10,10,0.0001,504,1
0.468,1e-05,304,300,10,10,0.0001,604,1
0.47,1e-05,350,354,10,10,0.0001,704,1
0.47,1e-05,399,405,10,10,0.0001,804,1
0.47,1e-05,448,456,10,10,0.0001,904,1
0.47,1e-05,491,513,10,10,0.0001,1004,1
0.47,1e-05,540,564,10,10,0.0001,1104,1
0.47,1e-05,582,622,10,10,0.0001,1204,1
0.47,1e-05,625,679,10,10,0.0001,1304,1
0.47,1e-05,677,727,10,10,0.0001,1404,1
0.47,1e-05,728,776,10,10,0.0001,1504,1
0.47,1e-05,785,819,10,10,0.0001,1604,1
0.47,1e-05,834,870,10,10,0.0001,1704,1
0.47,1e-05,895,909,10,10,0.0001,1804,1
0.468,1e-05,938,966,10,10,0.0001,1904,1
0.468,1e-05,995,1009,10,10,0.0001,2004,1
0.494,1e-05,56,48,10,10,0.0001,104,2
0.496,1e-05,101,103,10,10,0.0001,204,2
0.496,1e-05,145,159,10,10,0.0001,304,2
0.496,1e-05,190,214,10,10,0.0001,404,2
0.496,1e-05,252,252,10,10,0.0001,504,2
0.496,1e-05,308,296,10,10,0.0001,604,2
0.496,1e-05,360,344,10,10,0.0001,704,2
0.496,1e-05,403,401,10,10,0.0001,804,2
0.496,1e-05,447,457,10,10,0.0001,904,2
0.496,1e-05,500,504,10,10,0.0001,1004,2
0.496,1e-05,550,554,10,10,0.0001,1104,2
0.494,1e-05,605,599,10,10,0.0001,1204,2
0.494,1e-05,657,647,10,10,0.0001,1304,2
0.494,1e-05,698,706,10,10,0.0001,1404,2
0.494,1e-05,746,758,10,10,0.0001,1504,2
0.494,1e-05,800,804,10,10,0.0001,1604,2
0.494,1e-05,836,868,10,10,0.0001,1704,2
0.494,1e-05,896,908,10,10,0.0001,1804,2
0.496,1e-05,946,958,10,10,0.0001,1904,2
0.496,1e-05,1001,1003,10,10,0.0001,2004,2
0.502,1e-05,46,58,10,10,0.0001,104,3
0.5,1e-05,92,112,10,10,0.0001,204,3
0.5,1e-05,146,158,10,10,0.0001,304,3
0.502,1e-05,198,206,10,10,0.0001,404,3
0.502,1e-05,250,254,10,10,0.0001,504,3
0.504,1e-05,299,305,10,10,0.0001,604,3
0.504,1e-05,353,351,10,10,0.0001,704,3
0.504,1e-05,401,403,10,10,0.0001,804,3
0.504,1e-05,456,448,10,10,0.0001,904,3
0.504,1e-05,503,501,10,10,0.0001,1004,3
0.504,1e-05,559,545,10,10,0.0001,1104,3
0.504,1e-05,602,602,10,10,0.0001,1204,3
0.504,1e-05,656,648,10,10,0.0001,1304,3
0.504,1e-05,701,703,10,10,0.0001,1404,3
0.504,1e-05,743,761,10,10,0.0001,1504,3
0.506,1e-05,794,810,10,10,0.0001,1604,3
0.506,1e-05,848,856,10,10,0.0001,1704,3
0.506,1e-05,895,909,10,10,0.0001,1804,3
0.506,1e-05,948,956,10,10,0.0001,1904,3
0.506,1e-05,1006,998,10,10,0.0001,2004,3
0.502,1e-05,58,46,10,10,0.0001,104,4
0.502,1e-05,99,105,10,10,0.0001,204,4
0.502,1e-05,145,159,10,10,0.0001,304,4
0.504,1e-05,196,208,10,10,0.0001,404,4
0.504,1e-05,244,260,10,10,0.0001,504,4
0.504,1e-05,302,302,10,10,0.0001,604,4
0.504,1e-05,356,348,10,10,0.0001,704,4
0.504,1e-05,406,398,10,10,0.0001,804,4
0.504,1e-05,462,442,10,10,0.0001,904,4
0.504,1e-05,512,492,10,10,0.0001,1004,4
0.51,1e-05,558,546,10,10,0.0001,1104,4
0.508,1e-05,618,586,10,10,0.0001,1204,4
0.508,1e-05,660,644,10,10,0.0001,1304,4
0.51,1e-05,711,693,10,10,0.0001,1404,4
0.512,1e-05,754,750,10,10,0.0001,1504,4
0.518,1e-05,802,802,10,10,0.0001,1604,4
0.518,1e-05,851,853,10,10,0.0001,1704,4
0.522,1e-05,891,913,10,10,0.0001,1804,4
0.526,1e-05,951,953,10,10,0.0001,1904,4
0.528,1e-05,993,1011,10,10,0.0001,2004,4
0.484,1e-05,52,52,10,10,0.0001,104,5
0.486,1e-05,107,97,10,10,0.0001,204,5
0.486,1e-05,161,143,10,10,0.0001,304,5
0.486,1e-05,210,194,10,10,0.0001,404,5
0.486,1e-05,265,239,10,10,0.0001,504,5
0.486,1e-05,316,288,10,10,0.0001,604,5
0.486,1e-05,368,336,10,10,0.0001,704,5
0.486,1e-05,420,384,10,10,0.0001,804,5
0.486,1e-05,470,434,10,10,0.0001,904,5
0.488,1e-05,512,492,10,10,0.0001,1004,5
0.49,1e-05,562,542,10,10,0.0001,1104,5
0.488,1e-05,617,587,10,10,0.0001,1204,5
0.488,1e-05,669,635,10,10,0.0001,1304,5
0.488,1e-05,727,677,10,10,0.0001,1404,5
0.488,1e-05,768,736,10,10,0.0001,1504,5
0.49,1e-05,817,787,10,10,0.0001,1604,5
0.49,1e-05,864,840,10,10,0.0001,1704,5
0.492,1e-05,913,891,10,10,0.0001,1804,5
0.494,1e-05,959,945,10,10,0.0001,1904,5
0.494,1e-05,1005,999,10,10,0.0001,2004,5
0.46,1e-05,52,52,10,10,0.0001,104,6
0.46,1e-05,99,105,10,10,0.0001,204,6
0.458,1e-05,156,148,10,10,0.0001,304,6
0.458,1e-05,203,201,10,10,0.0001,404,6
0.46,1e-05,263,241,10,10,0.0001,504,6
0.46,1e-05,313,291,10,10,0.0001,604,6
0.462,1e-05,360,344,10,10,0.0001,704,6
0.46,1e-05,409,395,10,10,0.0001,804,6
0.46,1e-05,460,444,10,10,0.0001,904,6
0.458,1e-05,512,492,10,10,0.0001,1004,6
0.46,1e-05,571,533,10,10,0.0001,1104,6
0.456,1e-05,622,582,10,10,0.0001,1204,6
0.452,1e-05,676,628,10,10,0.0001,1304,6
0.452,1e-05,731,673,10,10,0.0001,1404,6
0.452,1e-05,776,728,10,10,0.0001,1504,6
0.454,1e-05,821,783,10,10,0.0001,1604,6
0.452,1e-05,871,833,10,10,0.0001,1704,6
0.452,1e-05,913,891,10,10,0.0001,1804,6
0.452,1e-05,970,934,10,10,0.0001,1904,6
0.454,1e-05,1017,987,10,10,0.0001,2004,6
0.576,1e-05,55,49,10,10,0.0001,104,7
0.578,1e-05,100,104,10,10,0.0001,204,7
0.578,1e-05,153,151,10,10,0.0001,304,7
0.58,1e-05,205,199,10,10,0.0001,404,7
0.58,1e-05,257,247,10,10,0.0001,504,7
0.58,1e-05,313,291,10,10,0.0001,604,7
0.578,1e-05,376,328,10,10,0.0001,704,7
0.578,1e-05,424,380,10,10,0.0001,804,7
0.578,1e-05,474,430,10,10,0.0001,904,7
0.578,1e-05,519,485,10,10,0.0001,1004,7
0.58,1e-05,573,531,10,10,0.0001,1104,7
0.58,1e-05,619,585,10,10,0.0001,1204,7
0.58,1e-05,668,636,10,10,0.0001,1304,7
0.58,1e-05,705,699,10,10,0.0001,1404,7
0.582,1e-05,757,747,10,10,0.0001,1504,7
0.584,1e-05,798,806,10,10,0.0001,1604,7
0.584,1e-05,853,851,10,10,0.0001,1704,7
0.582,1e-05,914,890,10,10,0.0001,1804,7
0.582,1e-05,957,947,10,10,0.0001,1904,7
0.574,1e-05,1011,993,10,10,0.0001,2004,7
0.508,1e-05,54,50,10,10,0.0001,104,8
0.508,1e-05,113,91,10,10,0.0001,204,8
0.508,1e-05,165,139,10,10,0.0001,304,8
0.508,1e-05,214,190,10,10,0.0001,404,8
0.506,1e-05,259,245,10,10,0.0001,504,8
0.506,1e-05,301,303,10,10,0.0001,604,8
0.506,1e-05,353,351,10,10,0.0001,704,8
0.506,1e-05,401,403,10,10,0.0001,804,8
0.506,1e-05,449,455,10,10,0.0001,904,8
0.506,1e-05,501,503,10,10,0.0001,1004,8
0.506,1e-05,546,558,10,10,0.0001,1104,8
0.506,1e-05,592,612,10,10,0.0001,1204,8
0.506,1e-05,643,661,10,10,0.0001,1304,8
0.506,1e-05,693,711,10,10,0.0001,1404,8
0.506,1e-05,746,758,10,10,0.0001,1504,8
0.506,1e-05,794,810,10,10,0.0001,1604,8
0.506,1e-05,837,867,10,10,0.0001,1704,8
0.504,1e-05,887,917,10,10,0.0001,1804,8
0.504,1e-05,941,963,10,10,0.0001,1904,8
0.506,1e-05,998,1006,10,10,0.0001,2004,8
0.462,1e-05,63,41,10,10,0.0001,104,9
0.462,1e-05,112,92,10,10,0.0001,204,9
0.462,1e-05,167,137,10,10,0.0001,304,9
0.462,1e-05,211,193,10,10,0.0001,404,9
0.462,1e-05,259,245,10,10,0.0001,504,9
0.462,1e-05,309,295,10,10,0.0001,604,9
0.46,1e-05,359,345,10,10,0.0001,704,9
0.46,1e-05,406,398,10,10,0.0001,804,9
0.458,1e-05,458,446,10,10,0.0001,904,9
0.458,1e-05,511,493,10,10,0.0001,1004,9
0.458,1e-05,557,547,10,10,0.0001,1104,9
0.458,1e-05,605,599,10,10,0.0001,1204,9
0.458,1e-05,655,649,10,10,0.0001,1304,9
0.458,1e-05,701,703,10,10,0.0001,1404,9
0.456,1e-05,754,750,10,10,0.0001,1504,9
0.454,1e-05,795,809,10,10,0.0001,1604,9
0.454,1e-05,846,858,10,10,0.0001,1704,9
0.454,1e-05,900,904,10,10,0.0001,1804,9
0.454,1e-05,949,955,10,10,0.0001,1904,9
0.454,1e-05,995,1009,10,10,0.0001,2004,9
0.49,1e-05,58,46,10,10,0.0001,104,10
0.49,1e-05,109,95,10,10,0.0001,204,10
0.49,1e-05,160,144,10,10,0.0001,304,10
0.49,1e-05,207,197,10,10,0.0001,404,10
0.49,1e-05,256,248,10,10,0.0001,504,10
0.49,1e-05,308,296,10,10,0.0001,604,10
0.49,1e-05,362,342,10,10,0.0001,704,10
0.49,1e-05,414,390,10,10,0.0001,804,10
0.492,1e-05,459,445,10,10,0.0001,904,10
0.492,1e-05,503,501,10,10,0.0001,1004,10
0.492,1e-05,556,548,10,10,0.0001,1104,10
0.492,1e-05,612,592,10,10,0.0001,1204,10
0.494,1e-05,669,635,10,10,0.0001,1304,10
0.496,1e-05,721,683,10,10,0.0001,1404,10
0.496,1e-05,771,733,10,10,0.0001,1504,10
0.496,1e-05,818,786,10,10,0.0001,1604,10
0.498,1e-05,871,833,10,10,0.0001,1704,10
0.498,1e-05,920,884,10,10,0.0001,1804,10
0.498,1e-05,971,933,10,10,0.0001,1904,10
0.498,1e-05,1016,988,10,10,0.0001,2004,10
0.512,1e-05,57,47,10,10,0.0001,104,11
0.512,1e-05,114,90,10,10,0.0001,204,11
0.514,1e-05,165,139,10,10,0.0001,304,11
0.514,1e-05,217,187,10,10,0.0001,404,11
0.512,1e-05,267,237,10,10,0.0001,504,11
0.512,1e-05,323,281,10,10,0.0001,604,11
0.514,1e-05,382,322,10,10,0.0001,704,11
0.514,1e-05,431,373,10,10,0.0001,804,11
0.514,1e-05,482,422,10,10,0.0001,904,11
0.514,1e-05,533,471,10,10,0.0001,1004,11
0.516,1e-05,580,524,10,10,0.0001,1104,11
0.518,1e-05,634,570,10,10,0.0001,1204,11
0.516,1e-05,671,633,10,10,0.0001,1304,11
0.514,1e-05,723,681,10,10,0.0001,1404,11
0.516,1e-05,773,731,10,10,0.0001,1504,11
0.518,1e-05,820,784,10,10,0.0001,1604,11
0.522,1e-05,879,825,10,10,0.0001,1704,11
0.522,1e-05,930,874,10,10,0.0001,1804,11
0.522,1e-05,977,927,10,10,0.0001,1904,11
0.526,1e-05,1022,982,10,10,0.0001,2004,11
0.51,1e-05,57,47,10,10,0.0001,104,12
0.508,1e-05,105,99,10,10,0.0001,204,12
0.508,1e-05,146,158,10,10,0.0001,304,12
0.508,1e-05,191,213,10,10,0.0001,404,12
0.51,1e-05,242,262,10,10,0.0001,504,12
0.51,1e-05,294,310,10,10,0.0001,604,12
0.51,1e-05,343,361,10,10,0.0001,704,12
0.51,1e-05,391,413,10,10,0.0001,804,12
0.51,1e-05,451,453,10,10,0.0001,904,12
0.51,1e-05,499,505,10,10,0.0001,1004,12
0.51,1e-05,551,553,10,10,0.0001,1104,12
0.51,1e-05,598,606,10,10,0.0001,1204,12
0.51,1e-05,651,653,10,10,0.0001,1304,12
0.51,1e-05,701,703,10,10,0.0001,1404,12
0.508,1e-05,755,749,10,10,0.0001,1504,12
0.504,1e-05,796,808,10,10,0.0001,1604,12
0.506,1e-05,842,862,10,10,0.0001,1704,12
0.504,1e-05,896,908,10,10,0.0001,1804,12
0.506,1e-05,943,961,10,10,0.0001,1904,12
0.51,1e-05,993,1011,10,10,0.0001,2004,12
0.528,1e-05,50,54,10,10,0.0001,104,13
0.528,1e-05,109,95,10,10,0.0001,204,13
0.528,1e-05,151,153,10,10,0.0001,304,13
0.528,1e-05,208,196,10,10,0.0001,404,13
0.528,1e-05,261,243,10,10,0.0001,504,13
0.528,1e-05,304,300,10,10,0.0001,604,13
0.528,1e-05,354,350,10,10,0.0001,704,13
0.528,1e-05,403,401,10,10,0.0001,804,13
0.528,1e-05,447,457,10,10,0.0001,904,13
0.53,1e-05,489,515,10,10,0.0001,1004,13
0.53,1e-05,543,561,10,10,0.0001,1104,13
0.532,1e-05,594,610,10,10,0.0001,1204,13
0.53,1e-05,647,657,10,10,0.0001,1304,13
0.532,1e-05,683,721,10,10,0.0001,1404,13
0.532,1e-05,738,766,10,10,0.0001,1504,13
0.532,1e-05,795,809,10,10,0.0001,1604,13
0.532,1e-05,847,857,10,10,0.0001,1704,13
0.532,1e-05,892,912,10,10,0.0001,1804,13
0.532,1e-05,937,967,10,10,0.0001,1904,13
0.532,1e-05,995,1009,10,10,0.0001,2004,13
0.484,1e-05,50,54,10,10,0.0001,104,14
0.484,1e-05,92,112,10,10,0.0001,204,14
0.484,1e-05,147,157,10,10,0.0001,304,14
0.484,1e-05,197,207,10,10,0.0001,404,14
0.486,1e-05,251,253,10,10,0.0001,504,14
0.486,1e-05,296,308,10,10,0.0001,604,14
0.486,1e-05,351,353,10,10,0.0001,704,14
0.484,1e-05,413,391,10,10,0.0001,804,14
0.482,1e-05,461,443,10,10,0.0001,904,14
0.482,1e-05,508,496,10,10,0.0001,1004,14
0.486,1e-05,562,542,10,10,0.0001,1104,14
0.486,1e-05,611,593,10,10,0.0001,1204,14
0.486,1e-05,656,648,10,10,0.0001,1304,14
0.486,1e-05,702,702,10,10,0.0001,1404,14
0.486,1e-05,738,766,10,10,0.0001,1504,14
0.488,1e-05,792,812,10,10,0.0001,1604,14
0.486,1e-05,840,864,10,10,0.0001,1704,14
0.488,1e-05,891,913,10,10,0.0001,1804,14
0.488,1e-05,940,964,10,10,0.0001,1904,14
0.484,1e-05,989,1015,10,10,0.0001,2004,14
0.504,1e-05,47,57,10,10,0.0001,104,15
0.504,1e-05,104,100,10,10,0.0001,204,15
0.504,1e-05,158,146,10,10,0.0001,304,15
0.506,1e-05,207,197,10,10,0.0001,404,15
0.506,1e-05,267,237,10,10,0.0001,504,15
0.506,1e-05,311,293,10,10,0.0001,604,15
0.506,1e-05,355,349,10,10,0.0001,704,15
0.506,1e-05,405,399,10,10,0.0001,804,15
0.506,1e-05,453,451,10,10,0.0001,904,15
0.506,1e-05,505,499,10,10,0.0001,1004,15
0.506,1e-05,555,549,10,10,0.0001,1104,15
0.508,1e-05,600,604,10,10,0.0001,1204,15
0.508,1e-05,654,650,10,10,0.0001,1304,15
0.508,1e-05,699,705,10,10,0.0001,1404,15
0.506,1e-05,752,752,10,10,0.0001,1504,15
0.508,1e-05,798,806,10,10,0.0001,1604,15
0.508,1e-05,851,853,10,10,0.0001,1704,15
0.506,1e-05,901,903,10,10,0.0001,1804,15
0.506,1e-05,956,948,10,10,0.0001,1904,15
0.508,1e-05,1002,1002,10,10,0.0001,2004,15
0.46,1e-05,55,49,10,10,0.0001,104,16
0.462,1e-05,106,98,10,10,0.0001,204,16
0.462,1e-05,157,147,10,10,0.0001,304,16
0.462,1e-05,204,200,10,10,0.0001,404,16
0.46,1e-05,246,258,10,10,0.0001,504,16
0.46,1e-05,302,302,10,10,0.0001,604,16
0.46,1e-05,361,343,10,10,0.0001,704,16
0.46,1e-05,410,394,10,10,0.0001,804,16
0.462,1e-05,464,440,10,10,0.0001,904,16
0.462,1e-05,517,487,10,10,0.0001,1004,16
0.464,1e-05,573,531,10,10,0.0001,1104,16
0.464,1e-05,620,584,10,10,0.0001,1204,16
0.464,1e-05,673,631,10,10,0.0001,1304,16
0.464,1e-05,728,676,10,10,0.0001,1404,16
0.464,1e-05,767,737,10,10,0.0001,1504,16
0.464,1e-05,820,784,10,10,0.0001,1604,16
0.464,1e-05,873,831,10,10,0.0001,1704,16
0.464,1e-05,925,879,10,10,0.0001,1804,16
0.464,1e-05,964,940,10,10,0.0001,1904,16
0.466,1e-05,1008,996,10,10,0.0001,2004,16
0.48,1e-05,61,43,10,10,0.0001,104,17
0.48,1e-05,105,99,10,10,0.0001,204,17
0.48,1e-05,156,148,10,10,0.0001,304,17
0.48,1e-05,212,192,10,10,0.0001,404,17
0.48,1e-05,252,252,10,10,0.0001,504,17
0.478,1e-05,311,293,10,10,0.0001,604,17
0.478,1e-05,351,353,10,10,0.0001,704,17
0.478,1e-05,404,400,10,10,0.0001,804,17
0.476,1e-05,455,449,10,10,0.0001,904,17
0.476,1e-05,499,505,10,10,0.0001,1004,17
0.476,1e-05,564,540,10,10,0.0001,1104,17
0.476,1e-05,612,592,10,10,0.0001,1204,17
0.476,1e-05,658,646,10,10,0.0001,1304,17
0.476,1e-05,708,696,10,10,0.0001,1404,17
0.476,1e-05,754,750,10,10,0.0001,1504,17
0.478,1e-05,804,800,10,10,0.0001,1604,17
0.48,1e-05,860,844,10,10,0.0001,1704,17
0.478,1e-05,908,896,10,10,0.0001,1804,17
0.478,1e-05,961,943,10,10,0.0001,1904,17
0.48,1e-05,1004,1000,10,10,0.0001,2004,17
0.492,1e-05,55,49,10,10,0.0001,104,18
0.492,1e-05,107,97,10,10,0.0001,204,18
0.492,1e-05,159,145,10,10,0.0001,304,18
0.492,1e-05,206,198,10,10,0.0001,404,18
0.492,1e-05,248,256,10,10,0.0001,504,18
0.492,1e-05,310,294,10,10,0.0001,604,18
0.492,1e-05,357,347,10,10,0.0001,704,18
0.494,1e-05,404,400,10,10,0.0001,804,18
0.494,1e-05,454,450,10,10,0.0001,904,18
0.496,1e-05,499,505,10,10,0.0001,1004,18
0.496,1e-05,550,554,10,10,0.0001,1104,18
0.496,1e-05,606,598,10,10,0.0001,1204,18
0.496,1e-05,654,650,10,10,0.0001,1304,18
0.496,1e-05,704,700,10,10,0.0001,1404,18
0.496,1e-05,755,749,10,10,0.0001,1504,18
0.496,1e-05,804,800,10,10,0.0001,1604,18
0.496,1e-05,855,849,10,10,0.0001,1704,18
0.494,1e-05,905,899,10,10,0.0001,1804,18
0.494,1e-05,958,946,10,10,0.0001,1904,18
0.492,1e-05,1010,994,10,10,0.0001,2004,18
0.456,1e-05,46,58,10,10,0.0001,104,19
0.456,1e-05,95,109,10,10,0.0001,204,19
0.456,1e-05,141,163,10,10,0.0001,304,19
0.456,1e-05,185,219,10,10,0.0001,404,19
0.456,1e-05,230,274,10,10,0.0001,504,19
0.456,1e-05,281,323,10,10,0.0001,604,19
0.456,1e-05,328,376,10,10,0.0001,704,19
0.456,1e-05,382,422,10,10,0.0001,804,19
0.456,1e-05,430,474,10,10,0.0001,904,19
0.458,1e-05,488,516,10,10,0.0001,1004,19
0.458,1e-05,536,568,10,10,0.0001,1104,19
0.458,1e-05,586,618,10,10,0.0001,1204,19
0.458,1e-05,641,663,10,10,0.0001,1304,19
0.458,1e-05,683,721,10,10,0.0001,1404,19
0.458,1e-05,734,770,10,10,0.0001,1504,19
0.46,1e-05,782,822,10,10,0.0001,1604,19
0.46,1e-05,844,860,10,10,0.0001,1704,19
0.46,1e-05,889,915,10,10,0.0001,1804,19
0.462,1e-05,943,961,10,10,0.0001,1904,19
0.468,1e-05,1003,1001,10,10,0.0001,2004,19
0.46,1e-05,49,55,10,10,0.0001,104,20
0.46,1e-05,108,96,10,10,0.0001,204,20
0.46,1e-05,163,141,10,10,0.0001,304,20
0.46,1e-05,216,188,10,10,0.0001,404,20
0.46,1e-05,267,237,10,10,0.0001,504,20
0.46,1e-05,312,292,10,10,0.0001,604,20
0.46,1e-05,366,338,10,10,0.0001,704,20
0.46,1e-05,411,393,10,10,0.0001,804,20
0.462,1e-05,457,447,10,10,0.0001,904,20
0.462,1e-05,505,499,10,10,0.0001,1004,20
0.464,1e-05,562,542,10,10,0.0001,1104,20
0.464,1e-05,606,598,10,10,0.0001,1204,20
0.464,1e-05,657,647,10,10,0.0001,1304,20
0.464,1e-05,704,700,10,10,0.0001,1404,20
0.464,1e-05,749,755,10,10,0.0001,1504,20
0.466,1e-05,800,804,10,10,0.0001,1604,20
0.466,1e-05,851,853,10,10,0.0001,1704,20
0.47,1e-05,911,893,10,10,0.0001,1804,20
0.474,1e-05,949,955,10,10,0.0001,1904,20
0.476,1e-05,1004,1000,10,10,0.0001,2004,20
0.478,1e-05,50,54,10,10,0.001,104,1
0.482,1e-05,98,106,10,10,0.001,204,1
0.488,1e-05,152,152,10,10,0.001,304,1
0.49,1e-05,200,204,10,10,0.001,404,1
0.488,1e-05,251,253,10,10,0.001,504,1
0.49,1e-05,301,303,10,10,0.001,604,1
0.492,1e-05,343,361,10,10,0.001,704,1
0.502,1e-05,391,413,10,10,0.001,804,1
0.5,1e-05,453,451,10,10,0.001,904,1
0.51,1e-05,503,501,10,10,0.001,1004,1
0.506,1e-05,551,553,10,10,0.001,1104,1
0.508,1e-05,603,601,10,10,0.001,1204,1
0.508,1e-05,650,654,10,10,0.001,1304,1
0.516,1e-05,706,698,10,10,0.001,1404,1
0.524,1e-05,758,746,10,10,0.001,1504,1
0.54,1e-05,795,809,10,10,0.001,1604,1
0.544,1e-05,847,857,10,10,0.001,1704,1
0.55,1e-05,899,905,10,10,0.001,1804,1
0.554,1e-05,957,947,10,10,0.001,1904,1
0.562,1e-05,1002,1002,10,10,0.001,2004,1
0.524,1e-05,49,55,10,10,0.001,104,2
0.526,1e-05,96,108,10,10,0.001,204,2
0.522,1e-05,137,167,10,10,0.001,304,2
0.522,1e-05,191,213,10,10,0.001,404,2
0.524,1e-05,237,267,10,10,0.001,504,2
0.526,1e-05,288,316,10,10,0.001,604,2
0.526,1e-05,332,372,10,10,0.001,704,2
0.528,1e-05,387,417,10,10,0.001,804,2
0.53,1e-05,439,465,10,10,0.001,904,2
0.536,1e-05,487,517,10,10,0.001,1004,2
0.536,1e-05,539,565,10,10,0.001,1104,2
0.54,1e-05,591,613,10,10,0.001,1204,2
0.544,1e-05,642,662,10,10,0.001,1304,2
0.554,1e-05,695,709,10,10,0.001,1404,2
0.558,1e-05,748,756,10,10,0.001,1504,2
0.566,1e-05,796,808,10,10,0.001,1604,2
0.582,1e-05,851,853,10,10,0.001,1704,2
0.594,1e-05,899,905,10,10,0.001,1804,2
0.616,1e-05,954,950,10,10,0.001,1904,2
0.626,1e-05,1001,1003,10,10,0.001,2004,2
0.546,1e-05,54,50,10,10,0.001,104,3
0.546,1e-05,108,96,10,10,0.001,204,3
0.546,1e-05,161,143,10,10,0.001,304,3
0.546,1e-05,209,195,10,10,0.001,404,3
0.544,1e-05,256,248,10,10,0.001,504,3
0.544,1e-05,306,298,10,10,0.001,604,3
0.544,1e-05,362,342,10,10,0.001,704,3
0.548,1e-05,416,388,10,10,0.001,804,3
0.548,1e-05,467,437,10,10,0.001,904,3
0.556,1e-05,525,479,10,10,0.001,1004,3
0.554,1e-05,574,530,10,10,0.001,1104,3
0.56,1e-05,630,574,10,10,0.001,1204,3
0.566,1e-05,673,631,10,10,0.001,1304,3
0.568,1e-05,714,690,10,10,0.001,1404,3
0.566,1e-05,755,749,10,10,0.001,1504,3
0.574,1e-05,811,793,10,10,0.001,1604,3
0.572,1e-05,864,840,10,10,0.001,1704,3
0.586,1e-05,911,893,10,10,0.001,1804,3
0.594,1e-05,963,941,10,10,0.001,1904,3
0.598,1e-05,1012,992,10,10,0.001,2004,3
0.454,1e-05,50,54,10,10,0.001,104,4
0.456,1e-05,91,113,10,10,0.001,204,4
0.462,1e-05,147,157,10,10,0.001,304,4
0.468,1e-05,200,204,10,10,0.001,404,4
0.464,1e-05,255,249,10,10,0.001,504,4
0.468,1e-05,297,307,10,10,0.001,604,4
0.474,1e-05,350,354,10,10,0.001,704,4
0.476,1e-05,397,407,10,10,0.001,804,4
0.478,1e-05,448,456,10,10,0.001,904,4
0.478,1e-05,498,506,10,10,0.001,1004,4
0.476,1e-05,551,553,10,10,0.001,1104,4
0.476,1e-05,600,604,10,10,0.001,1204,4
0.478,1e-05,652,652,10,10,0.001,1304,4
0.49,1e-05,700,704,10,10,0.001,1404,4
0.498,1e-05,747,757,10,10,0.001,1504,4
0.508,1e-05,794,810,10,10,0.001,1604,4
0.516,1e-05,858,846,10,10,0.001,1704,4
0.518,1e-05,909,895,10,10,0.001,1804,4
0.528,1e-05,955,949,10,10,0.001,1904,4
0.532,1e-05,1008,996,10,10,0.001,2004,4
0.55,1e-05,41,63,10,10,0.001,104,5
0.548,1e-05,84,120,10,10,0.001,204,5
0.55,1e-05,139,165,10,10,0.001,304,5
0.548,1e-05,190,214,10,10,0.001,404,5
0.55,1e-05,247,257,10,10,0.001,504,5
0.552,1e-05,292,312,10,10,0.001,604,5
0.552,1e-05,349,355,10,10,0.001,704,5
0.552,1e-05,398,406,10,10,0.001,804,5
0.554,1e-05,450,454,10,10,0.001,904,5
0.556,1e-05,499,505,10,10,0.001,1004,5
0.562,1e-05,548,556,10,10,0.001,1104,5
0.56,1e-05,599,605,10,10,0.001,1204,5
0.568,1e-05,657,647,10,10,0.001,1304,5
0.574,1e-05,698,706,10,10,0.001,1404,5
0.574,1e-05,752,752,10,10,0.001,1504,5
0.576,1e-05,808,796,10,10,0.001,1604,5
0.584,1e-05,848,856,10,10,0.001,1704,5
0.586,1e-05,890,914,10,10,0.001,1804,5
0.598,1e-05,939,965,10,10,0.001,1904,5
0.61,1e-05,981,1023,10,10,0.001,2004,5
0.53,1e-05,53,51,10,10,0.001,104,6
0.536,1e-05,92,112,10,10,0.001,204,6
0.54,1e-05,147,157,10,10,0.001,304,6
0.54,1e-05,198,206,10,10,0.001,404,6
0.542,1e-05,257,247,10,10,0.001,504,6
0.542,1e-05,303,301,10,10,0.001,604,6
0.538,1e-05,356,348,10,10,0.001,704,6
0.544,1e-05,405,399,10,10,0.001,804,6
0.548,1e-05,464,440,10,10,0.001,904,6
0.544,1e-05,512,492,10,10,0.001,1004,6
0.544,1e-05,564,540,10,10,0.001,1104,6
0.544,1e-05,610,594,10,10,0.001,1204,6
0.554,1e-05,663,641,10,10,0.001,1304,6
0.556,1e-05,713,691,10,10,0.001,1404,6
0.556,1e-05,764,740,10,10,0.001,1504,6
0.564,1e-05,816,788,10,10,0.001,1604,6
0.57,1e-05,867,837,10,10,0.001,1704,6
0.584,1e-05,908,896,10,10,0.001,1804,6
0.604,1e-05,967,937,10,10,0.001,1904,6
0.616,1e-05,1021,983,10,10,0.001,2004,6
0.494,1e-05,55,49,10,10,0.001,104,7
0.492,1e-05,105,99,10,10,0.001,204,7
0.494,1e-05,159,145,10,10,0.001,304,7
0.496,1e-05,210,194,10,10,0.001,404,7
0.494,1e-05,257,247,10,10,0.001,504,7
0.498,1e-05,305,299,10,10,0.001,604,7
0.502,1e-05,347,357,10,10,0.001,704,7
0.508,1e-05,393,411,10,10,0.001,804,7
0.516,1e-05,440,464,10,10,0.001,904,7
0.52,1e-05,492,512,10,10,0.001,1004,7
0.524,1e-05,553,551,10,10,0.001,1104,7
0.53,1e-05,603,601,10,10,0.001,1204,7
0.532,1e-05,656,648,10,10,0.001,1304,7
0.54,1e-05,709,695,10,10,0.001,1404,7
0.552,1e-05,752,752,10,10,0.001,1504,7
0.562,1e-05,796,808,10,10,0.001,1604,7
0.572,1e-05,846,858,10,10,0.001,1704,7
0.586,1e-05,899,905,10,10,0.001,1804,7
0.604,1e-05,951,953,10,10,0.001,1904,7
0.624,1e-05,998,1006,10,10,0.001,2004,7
0.466,1e-05,46,58,10,10,0.001,104,8
0.466,1e-05,102,102,10,10,0.001,204,8
0.466,1e-05,151,153,10,10,0.001,304,8
0.466,1e-05,202,202,10,10,0.001,404,8
0.466,1e-05,251,253,10,10,0.001,504,8
0.466,1e-05,303,301,10,10,0.001,604,8
0.466,1e-05,352,352,10,10,0.001,704,8
0.466,1e-05,411,393,10,10,0.001,804,8
0.466,1e-05,463,441,10,10,0.001,904,8
0.466,1e-05,517,487,10,10,0.001,1004,8
0.468,1e-05,568,536,10,10,0.001,1104,8
0.468,1e-05,612,592,10,10,0.001,1204,8
0.472,1e-05,654,650,10,10,0.001,1304,8
0.472,1e-05,703,701,10,10,0.001,1404,8
0.48,1e-05,747,757,10,10,0.001,1504,8
0.488,1e-05,804,800,10,10,0.001,1604,8
0.488,1e-05,859,845,10,10,0.001,1704,8
0.49,1e-05,907,897,10,10,0.001,1804,8
0.506,1e-05,964,940,10,10,0.001,1904,8
0.516,1e-05,1019,985,10,10,0.001,2004,8
0.422,1e-05,47,57,10,10,0.001,104,9
0.428,1e-05,87,117,10,10,0.001,204,9
0.432,1e-05,133,171,10,10,0.001,304,9
0.432,1e-05,176,228,10,10,0.001,404,9
0.432,1e-05,238,266,10,10,0.001,504,9
0.428,1e-05,287,317,10,10,0.001,604,9
0.428,1e-05,334,370,10,10,0.001,704,9
0.428,1e-05,378,426,10,10,0.001,804,9
0.434,1e-05,432,472,10,10,0.001,904,9
0.436,1e-05,485,519,10,10,0.001,1004,9
0.444,1e-05,534,570,10,10,0.001,1104,9
0.45,1e-05,594,610,10,10,0.001,1204,9
0.456,1e-05,649,655,10,10,0.001,1304,9
0.474,1e-05,692,712,10,10,0.001,1404,9
0.482,1e-05,742,762,10,10,0.001,1504,9
0.496,1e-05,796,808,10,10,0.001,1604,9
0.502,1e-05,850,854,10,10,0.001,1704,9
0.518,1e-05,895,909,10,10,0.001,1804,9
0.526,1e-05,951,953,10,10,0.001,1904,9
0.534,1e-05,1001,1003,10,10,0.001,2004,9
0.502,1e-05,59,45,10,10,0.001,104,10
0.502,1e-05,104,100,10,10,0.001,204,10
0.502,1e-05,160,144,10,10,0.001,304,10
0.502,1e-05,208,196,10,10,0.001,404,10
0.504,1e-05,259,245,10,10,0.001,504,10
0.508,1e-05,311,293,10,10,0.001,604,10
0.514,1e-05,359,345,10,10,0.001,704,10
0.51,1e-05,409,395,10,10,0.001,804,10
0.516,1e-05,463,441,10,10,0.001,904,10
0.518,1e-05,513,491,10,10,0.001,1004,10
0.518,1e-05,556,548,10,10,0.001,1104,10
0.518,1e-05,617,587,10,10,0.001,1204,10
0.518,1e-05,664,640,10,10,0.001,1304,10
0.524,1e-05,699,705,10,10,0.001,1404,10
0.526,1e-05,754,750,10,10,0.001,1504,10
0.526,1e-05,796,808,10,10,0.001,1604,10
0.53,1e-05,852,852,10,10,0.001,1704,10
0.54,1e-05,891,913,10,10,0.001,1804,10
0.548,1e-05,948,956,10,10,0.001,1904,10
0.56,1e-05,1006,998,10,10,0.001,2004,10
0.512,1e-05,51,53,10,10,0.001,104,11
0.514,1e-05,105,99,10,10,0.001,204,11
0.51,1e-05,154,150,10,10,0.001,304,11
0.512,1e-05,204,200,10,10,0.001,404,11
0.512,1e-05,255,249,10,10,0.001,504,11
0.512,1e-05,309,295,10,10,0.001,604,11
0.51,1e-05,358,346,10,10,0.001,704,11
0.512,1e-05,406,398,10,10,0.001,804,11
0.514,1e-05,461,443,10,10,0.001,904,11
0.514,1e-05,511,493,10,10,0.001,1004,11
0.518,1e-05,555,549,10,10,0.001,1104,11
0.522,1e-05,599,605,10,10,0.001,1204,11
0.522,1e-05,651,653,10,10,0.001,1304,11
0.522,1e-05,707,697,10,10,0.001,1404,11
0.528,1e-05,756,748,10,10,0.001,1504,11
0.532,1e-05,804,800,10,10,0.001,1604,11
0.53,1e-05,853,851,10,10,0.001,1704,11
0.532,1e-05,919,885,10,10,0.001,1804,11
0.538,1e-05,968,936,10,10,0.001,1904,11
0.54,1e-05,1015,989,10,10,0.001,2004,11
0.518,1e-05,42,62,10,10,0.001,104,12
0.522,1e-05,90,114,10,10,0.001,204,12
0.522,1e-05,141,163,10,10,0.001,304,12
0.526,1e-05,196,208,10,10,0.001,404,12
0.522,1e-05,243,261,10,10,0.001,504,12
0.528,1e-05,290,314,10,10,0.001,604,12
0.53,1e-05,341,363,10,10,0.001,704,12
0.532,1e-05,389,415,10,10,0.001,804,12
0.538,1e-05,439,465,10,10,0.001,904,12
0.542,1e-05,490,514,10,10,0.001,1004,12
0.546,1e-05,534,570,10,10,0.001,1104,12
0.548,1e-05,581,623,10,10,0.001,1204,12
0.552,1e-05,631,673,10,10,0.001,1304,12
0.566,1e-05,680,724,10,10,0.001,1404,12
0.582,1e-05,733,771,10,10,0.001,1504,12
0.586,1e-05,797,807,10,10,0.001,1604,12
0.602,1e-05,849,855,10,10,0.001,1704,12
0.61,1e-05,901,903,10,10,0.001,1804,12
0.616,1e-05,947,957,10,10,0.001,1904,12
0.626,1e-05,992,1012,10,10,0.001,2004,12
0.484,1e-05,54,50,10,10,0.001,104,13
0.484,1e-05,103,101,10,10,0.001,204,13
0.484,1e-05,149,155,10,10,0.001,304,13
0.484,1e-05,198,206,10,10,0.001,404,13
0.484,1e-05,242,262,10,10,0.001,504,13
0.484,1e-05,296,308,10,10,0.001,604,13
0.488,1e-05,345,359,10,10,0.001,704,13
0.49,1e-05,394,410,10,10,0.001,804,13
0.49,1e-05,453,451,10,10,0.001,904,13
0.49,1e-05,507,497,10,10,0.001,1004,13
0.488,1e-05,554,550,10,10,0.001,1104,13
0.49,1e-05,613,591,10,10,0.001,1204,13
0.486,1e-05,667,637,10,10,0.001,1304,13
0.488,1e-05,719,685,10,10,0.001,1404,13
0.488,1e-05,768,736,10,10,0.001,1504,13
0.486,1e-05,815,789,10,10,0.001,1604,13
0.484,1e-05,858,846,10,10,0.001,1704,13
0.496,1e-05,910,894,10,10,0.001,1804,13
0.512,1e-05,961,943,10,10,0.001,1904,13
0.522,1e-05,1010,994,10,10,0.001,2004,13
0.45,1e-05,43,61,10,10,0.001,104,14
0.448,1e-05,104,100,10,10,0.001,204,14
0.446,1e-05,149,155,10,10,0.001,304,14
0.442,1e-05,208,196,10,10,0.001,404,14
0.444,1e-05,261,243,10,10,0.001,504,14
0.45,1e-05,312,292,10,10,0.001,604,14
0.448,1e-05,361,343,10,10,0.001,704,14
0.452,1e-05,401,403,10,10,0.001,804,14
0.456,1e-05,444,460,10,10,0.001,904,14
0.46,1e-05,486,518,10,10,0.001,1004,14
0.468,1e-05,540,564,10,10,0.001,1104,14
0.476,1e-05,590,614,10,10,0.001,1204,14
0.472,1e-05,636,668,10,10,0.001,1304,14
0.48,1e-05,691,713,10,10,0.001,1404,14
0.49,1e-05,740,764,10,10,0.001,1504,14
0.496,1e-05,799,805,10,10,0.001,1604,14
0.5,1e-05,847,857,10,10,0.001,1704,14
0.506,1e-05,897,907,10,10,0.001,1804,14
0.51,1e-05,943,961,10,10,0.001,1904,14
0.522,1e-05,996,1008,10,10,0.001,2004,14
0.548,1e-05,46,58,10,10,0.001,104,15
0.548,1e-05,89,115,10,10,0.001,204,15
0.55,1e-05,146,158,10,10,0.001,304,15
0.552,1e-05,187,217,10,10,0.001,404,15
0.556,1e-05,236,268,10,10,0.001,504,15
0.562,1e-05,296,308,10,10,0.001,604,15
0.564,1e-05,338,366,10,10,0.001,704,15
0.576,1e-05,380,424,10,10,0.001,804,15
0.584,1e-05,428,476,10,10,0.001,904,15
0.59,1e-05,475,529,10,10,0.001,1004,15
0.594,1e-05,534,570,10,10,0.001,1104,15
0.6,1e-05,584,620,10,10,0.001,1204,15
0.608,1e-05,634,670,10,10,0.001,1304,15
0.62,1e-05,680,724,10,10,0.001,1404,15
0.632,1e-05,739,765,10,10,0.001,1504,15
0.648,1e-05,790,814,10,10,0.001,1604,15
0.656,1e-05,837,867,10,10,0.001,1704,15
0.672,1e-05,889,915,10,10,0.001,1804,15
0.682,1e-05,948,956,10,10,0.001,1904,15
0.694,1e-05,1000,1004,10,10,0.001,2004,15
0.512,1e-05,49,55,10,10,0.001,104,16
0.516,1e-05,107,97,10,10,0.001,204,16
0.518,1e-05,156,148,10,10,0.001,304,16
0.52,1e-05,208,196,10,10,0.001,404,16
0.524,1e-05,246,258,10,10,0.001,504,16
0.538,1e-05,298,306,10,10,0.001,604,16
0.54,1e-05,353,351,10,10,0.001,704,16
0.544,1e-05,399,405,10,10,0.001,804,16
0.56,1e-05,450,454,10,10,0.001,904,16
0.568,1e-05,491,513,10,10,0.001,1004,16
0.572,1e-05,545,559,10,10,0.001,1104,16
0.568,1e-05,601,603,10,10,0.001,1204,16
0.578,1e-05,649,655,10,10,0.001,1304,16
0.582,1e-05,693,711,10,10,0.001,1404,16
0.588,1e-05,749,755,10,10,0.001,1504,16
0.6,1e-05,801,803,10,10,0.001,1604,16
0.6,1e-05,858,846,10,10,0.001,1704,16
0.606,1e-05,905,899,10,10,0.001,1804,16
0.608,1e-05,953,951,10,10,0.001,1904,16
0.606,1e-05,997,1007,10,10,0.001,2004,16
0.464,1e-05,48,56,10,10,0.001,104,17
0.466,1e-05,97,107,10,10,0.001,204,17
0.466,1e-05,144,160,10,10,0.001,304,17
0.466,1e-05,198,206,10,10,0.001,404,17
0.468,1e-05,253,251,10,10,0.001,504,17
0.468,1e-05,291,313,10,10,0.001,604,17
0.47,1e-05,341,363,10,10,0.001,704,17
0.472,1e-05,384,420,10,10,0.001,804,17
0.476,1e-05,429,475,10,10,0.001,904,17
0.484,1e-05,480,524,10,10,0.001,1004,17
0.486,1e-05,531,573,10,10,0.001,1104,17
0.486,1e-05,580,624,10,10,0.001,1204,17
0.496,1e-05,631,673,10,10,0.001,1304,17
0.506,1e-05,685,719,10,10,0.001,1404,17
0.51,1e-05,734,770,10,10,0.001,1504,17
0.518,1e-05,794,810,10,10,0.001,1604,17
0.522,1e-05,851,853,10,10,0.001,1704,17
0.54,1e-05,905,899,10,10,0.001,1804,17
0.54,1e-05,952,952,10,10,0.001,1904,17
0.558,1e-05,1009,995,10,10,0.001,2004,17
0.464,1e-05,59,45,10,10,0.001,104,18
0.462,1e-05,106,98,10,10,0.001,204,18
0.464,1e-05,156,148,10,10,0.001,304,18
0.466,1e-05,207,197,10,10,0.001,404,18
0.47,1e-05,255,249,10,10,0.001,504,18
0.474,1e-05,307,297,10,10,0.001,604,18
0.478,1e-05,351,353,10,10,0.001,704,18
0.474,1e-05,408,396,10,10,0.001,804,18
0.484,1e-05,458,446,10,10,0.001,904,18
0.496,1e-05,513,491,10,10,0.001,1004,18
0.5,1e-05,566,538,10,10,0.001,1104,18
0.504,1e-05,613,591,10,10,0.001,1204,18
0.512,1e-05,655,649,10,10,0.001,1304,18
0.52,1e-05,696,708,10,10,0.001,1404,18
0.522,1e-05,744,760,10,10,0.001,1504,18
0.532,1e-05,796,808,10,10,0.001,1604,18
0.542,1e-05,844,860,10,10,0.001,1704,18
0.552,1e-05,892,912,10,10,0.001,1804,18
0.558,1e-05,935,969,10,10,0.001,1904,18
0.564,1e-05,985,1019,10,10,0.001,2004,18
0.51,1e-05,58,46,10,10,0.001,104,19
0.51,1e-05,114,90,10,10,0.001,204,19
0.51,1e-05,164,140,10,10,0.001,304,19
0.508,1e-05,203,201,10,10,0.001,404,19
0.508,1e-05,249,255,10,10,0.001,504,19
0.506,1e-05,299,305,10,10,0.001,604,19
0.508,1e-05,350,354,10,10,0.001,704,19
0.51,1e-05,400,404,10,10,0.001,804,19
0.512,1e-05,452,452,10,10,0.001,904,19
0.512,1e-05,510,494,10,10,0.001,1004,19
0.52,1e-05,564,540,10,10,0.001,1104,19
0.524,1e-05,613,591,10,10,0.001,1204,19
0.524,1e-05,649,655,10,10,0.001,1304,19
0.532,1e-05,692,712,10,10,0.001,1404,19
0.538,1e-05,743,761,10,10,0.001,1504,19
0.544,1e-05,789,815,10,10,0.001,1604,19
0.554,1e-05,841,863,10,10,0.001,1704,19
0.554,1e-05,896,908,10,10,0.001,1804,19
0.566,1e-05,952,952,10,10,0.001,1904,19
0.578,1e-05,1008,996,10,10,0.001,2004,19
0.538,1e-05,52,52,10,10,0.001,104,20
0.538,1e-05,100,104,10,10,0.001,204,20
0.538,1e-05,149,155,10,10,0.001,304,20
0.538,1e-05,206,198,10,10,0.001,404,20
0.538,1e-05,267,237,10,10,0.001,504,20
0.538,1e-05,313,291,10,10,0.001,604,20
0.538,1e-05,368,336,10,10,0.001,704,20
0.538,1e-05,415,389,10,10,0.001,804,20
0.538,1e-05,466,438,10,10,0.001,904,20
0.538,1e-05,514,490,10,10,0.001,1004,20
0.538,1e-05,564,540,10,10,0.001,1104,20
0.538,1e-05,613,591,10,10,0.001,1204,20
0.538,1e-05,664,640,10,10,0.001,1304,20
0.538,1e-05,710,694,10,10,0.001,1404,20
0.538,1e-05,767,737,10,10,0.001,1504,20
0.538,1e-05,814,790,10,10,0.001,1604,20
0.538,1e-05,870,834,10,10,0.001,1704,20
0.538,1e-05,923,881,10,10,0.001,1804,20
0.538,1e-05,975,929,10,10,0.001,1904,20
0.538,1e-05,1021,983,10,10,0.001,2004,20
0.54,1e-05,56,48,10,10,0.01,104,1
0.548,1e-05,115,89,10,10,0.01,204,1
0.592,1e-05,160,144,10,10,0.01,304,1
0.604,1e-05,208,196,10,10,0.01,404,1
0.608,1e-05,254,250,10,10,0.01,504,1
0.638,1e-05,308,296,10,10,0.01,604,1
0.654,1e-05,355,349,10,10,0.01,704,1
0.696,1e-05,406,398,10,10,0.01,804,1
0.73,1e-05,458,446,10,10,0.01,904,1
0.756,1e-05,519,485,10,10,0.01,1004,1
0.778,1e-05,571,533,10,10,0.01,1104,1
0.81,1e-05,612,592,10,10,0.01,1204,1
0.834,1e-05,663,641,10,10,0.01,1304,1
0.872,1e-05,706,698,10,10,0.01,1404,1
0.91,1e-05,764,740,10,10,0.01,1504,1
0.918,1e-05,817,787,10,10,0.01,1604,1
0.922,1e-05,875,829,10,10,0.01,1704,1
0.928,1e-05,924,880,10,10,0.01,1804,1
0.936,1e-05,980,924,10,10,0.01,1904,1
0.934,1e-05,1025,979,10,10,0.01,2004,1
0.488,1e-05,53,51,10,10,0.01,104,2
0.512,1e-05,103,101,10,10,0.01,204,2
0.518,1e-05,147,157,10,10,0.01,304,2
0.526,1e-05,206,198,10,10,0.01,404,2
0.546,1e-05,262,242,10,10,0.01,504,2
0.574,1e-05,311,293,10,10,0.01,604,2
0.592,1e-05,358,346,10,10,0.01,704,2
0.598,1e-05,424,380,10,10,0.01,804,2
0.616,1e-05,479,425,10,10,0.01,904,2
0.642,1e-05,529,475,10,10,0.01,1004,2
0.664,1e-05,571,533,10,10,0.01,1104,2
0.718,1e-05,618,586,10,10,0.01,1204,2
0.768,1e-05,677,627,10,10,0.01,1304,2
0.838,1e-05,728,676,10,10,0.01,1404,2
0.882,1e-05,775,729,10,10,0.01,1504,2
0.894,1e-05,827,777,10,10,0.01,1604,2
0.91,1e-05,866,838,10,10,0.01,1704,2
0.93,1e-05,905,899,10,10,0.01,1804,2
0.94,1e-05,957,947,10,10,0.01,1904,2
0.952,1e-05,1008,996,10,10,0.01,2004,2
0.486,1e-05,60,44,10,10,0.01,104,3
0.5,1e-05,109,95,10,10,0.01,204,3
0.512,1e-05,154,150,10,10,0.01,304,3
0.562,1e-05,202,202,10,10,0.01,404,3
0.586,1e-05,252,252,10,10,0.01,504,3
0.594,1e-05,301,303,10,10,0.01,604,3
0.618,1e-05,347,357,10,10,0.01,704,3
0.642,1e-05,399,405,10,10,0.01,804,3
0.704,1e-05,448,456,10,10,0.01,904,3
0.73,1e-05,499,505,10,10,0.01,1004,3
0.79,1e-05,547,557,10,10,0.01,1104,3
0.84,1e-05,600,604,10,10,0.01,1204,3
0.872,1e-05,657,647,10,10,0.01,1304,3
0.902,1e-05,710,694,10,10,0.01,1404,3
0.934,1e-05,760,744,10,10,0.01,1504,3
0.93,1e-05,807,797,10,10,0.01,1604,3
0.932,1e-05,861,843,10,10,0.01,1704,3
0.932,1e-05,909,895,10,10,0.01,1804,3
0.948,1e-05,962,942,10,10,0.01,1904,3
0.952,1e-05,1010,994,10,10,0.01,2004,3
0.456,1e-05,57,47,10,10,0.01,104,4
0.482,1e-05,104,100,10,10,0.01,204,4
0.534,1e-05,156,148,10,10,0.01,304,4
0.546,1e-05,210,194,10,10,0.01,404,4
0.566,1e-05,250,254,10,10,0.01,504,4
0.578,1e-05,308,296,10,10,0.01,604,4
0.612,1e-05,359,345,10,10,0.01,704,4
0.644,1e-05,410,394,10,10,0.01,804,4
0.684,1e-05,465,439,10,10,0.01,904,4
0.73,1e-05,521,483,10,10,0.01,1004,4
0.764,1e-05,570,534,10,10,0.01,1104,4
0.794,1e-05,623,581,10,10,0.01,1204,4
0.812,1e-05,674,630,10,10,0.01,1304,4
0.854,1e-05,715,689,10,10,0.01,1404,4
0.884,1e-05,768,736,10,10,0.01,1504,4
0.898,1e-05,820,784,10,10,0.01,1604,4
0.904,1e-05,867,837,10,10,0.01,1704,4
0.926,1e-05,912,892,10,10,0.01,1804,4
0.932,1e-05,949,955,10,10,0.01,1904,4
0.942,1e-05,996,1008,10,10,0.01,2004,4
0.55,1e-05,58,46,10,10,0.01,104,5
0.554,1e-05,109,95,10,10,0.01,204,5
0.552,1e-05,148,156,10,10,0.01,304,5
0.546,1e-05,193,211,10,10,0.01,404,5
0.558,1e-05,246,258,10,10,0.01,504,5
0.58,1e-05,293,311,10,10,0.01,604,5
0.588,1e-05,346,358,10,10,0.01,704,5
0.614,1e-05,389,415,10,10,0.01,804,5
0.638,1e-05,439,465,10,10,0.01,904,5
0.666,1e-05,491,513,10,10,0.01,1004,5
0.692,1e-05,540,564,10,10,0.01,1104,5
0.722,1e-05,593,611,10,10,0.01,1204,5
0.746,1e-05,647,657,10,10,0.01,1304,5
0.768,1e-05,709,695,10,10,0.01,1404,5
0.8,1e-05,748,756,10,10,0.01,1504,5
0.804,1e-05,791,813,10,10,0.01,1604,5
0.78,1e-05,849,855,10,10,0.01,1704,5
0.84,1e-05,896,908,10,10,0.01,1804,5
0.854,1e-05,942,962,10,10,0.01,1904,5
0.87,1e-05,983,1021,10,10,0.01,2004,5
0.516,1e-05,54,50,10,10,0.01,104,6
0.526,1e-05,105,99,10,10,0.01,204,6
0.554,1e-05,148,156,10,10,0.01,304,6
0.57,1e-05,189,215,10,10,0.01,404,6
0.58,1e-05,242,262,10,10,0.01,504,6
0.62,1e-05,290,314,10,10,0.01,604,6
0.636,1e-05,338,366,10,10,0.01,704,6
0.67,1e-05,381,423,10,10,0.01,804,6
0.68,1e-05,427,477,10,10,0.01,904,6
0.726,1e-05,477,527,10,10,0.01,1004,6
0.75,1e-05,532,572,10,10,0.01,1104,6
0.796,1e-05,586,618,10,10,0.01,1204,6
0.816,1e-05,637,667,10,10,0.01,1304,6
0.848,1e-05,689,715,10,10,0.01,1404,6
0.878,1e-05,734,770,10,10,0.01,1504,6
0.9,1e-05,783,821,10,10,0.01,1604,6
0.924,1e-05,833,871,10,10,0.01,1704,6
0.936,1e-05,889,915,10,10,0.01,1804,6
0.944,1e-05,943,961,10,10,0.01,1904,6
0.952,1e-05,986,1018,10,10,0.01,2004,6
0.49,1e-05,62,42,10,10,0.01,104,7
0.508,1e-05,101,103,10,10,0.01,204,7
0.538,1e-05,144,160,10,10,0.01,304,7
0.542,1e-05,190,214,10,10,0.01,404,7
0.532,1e-05,242,262,10,10,0.01,504,7
0.518,1e-05,293,311,10,10,0.01,604,7
0.566,1e-05,338,366,10,10,0.01,704,7
0.644,1e-05,386,418,10,10,0.01,804,7
0.66,1e-05,430,474,10,10,0.01,904,7
0.68,1e-05,487,517,10,10,0.01,1004,7
0.716,1e-05,536,568,10,10,0.01,1104,7
0.754,1e-05,583,621,10,10,0.01,1204,7
0.806,1e-05,634,670,10,10,0.01,1304,7
0.846,1e-05,684,720,10,10,0.01,1404,7
0.87,1e-05,736,768,10,10,0.01,1504,7
0.894,1e-05,788,816,10,10,0.01,1604,7
0.912,1e-05,842,862,10,10,0.01,1704,7
0.946,1e-05,888,916,10,10,0.01,1804,7
0.956,1e-05,935,969,10,10,0.01,1904,7
0.96,1e-05,978,1026,10,10,0.01,2004,7
0.522,1e-05,55,49,10,10,0.01,104,8
0.538,1e-05,110,94,10,10,0.01,204,8
0.55,1e-05,163,141,10,10,0.01,304,8
0.562,1e-05,224,180,10,10,0.01,404,8
0.562,1e-05,279,225,10,10,0.01,504,8
0.578,1e-05,330,274,10,10,0.01,604,8
0.562,1e-05,383,321,10,10,0.01,704,8
0.584,1e-05,433,371,10,10,0.01,804,8
0.61,1e-05,472,432,10,10,0.01,904,8
0.652,1e-05,523,481,10,10,0.01,1004,8
0.742,1e-05,568,536,10,10,0.01,1104,8
0.84,1e-05,617,587,10,10,0.01,1204,8
0.89,1e-05,673,631,10,10,0.01,1304,8
0.928,1e-05,720,684,10,10,0.01,1404,8
0.95,1e-05,770,734,10,10,0.01,1504,8
0.952,1e-05,820,784,10,10,0.01,1604,8
0.954,1e-05,867,837,10,10,0.01,1704,8
0.958,1e-05,915,889,10,10,0.01,1804,8
0.962,1e-05,969,935,10,10,0.01,1904,8
0.962,1e-05,1010,994,10,10,0.01,2004,8
0.516,1e-05,56,48,10,10,0.01,104,9
0.538,1e-05,98,106,10,10,0.01,204,9
0.568,1e-05,150,154,10,10,0.01,304,9
0.576,1e-05,197,207,10,10,0.01,404,9
0.59,1e-05,243,261,10,10,0.01,504,9
0.614,1e-05,301,303,10,10,0.01,604,9
0.604,1e-05,362,342,10,10,0.01,704,9
0.644,1e-05,417,387,10,10,0.01,804,9
0.684,1e-05,476,428,10,10,0.01,904,9
0.72,1e-05,530,474,10,10,0.01,1004,9
0.76,1e-05,572,532,10,10,0.01,1104,9
0.804,1e-05,614,590,10,10,0.01,1204,9
0.834,1e-05,661,643,10,10,0.01,1304,9
0.854,1e-05,705,699,10,10,0.01,1404,9
0.876,1e-05,755,749,10,10,0.01,1504,9
0.9,1e-05,799,805,10,10,0.01,1604,9
0.912,1e-05,844,860,10,10,0.01,1704,9
0.918,1e-05,901,903,10,10,0.01,1804,9
0.93,1e-05,951,953,10,10,0.01,1904,9
0.938,1e-05,1001,1003,10,10,0.01,2004,9
0.526,1e-05,51,53,10,10,0.01,104,10
0.544,1e-05,101,103,10,10,0.01,204,10
0.542,1e-05,156,148,10,10,0.01,304,10
0.552,1e-05,203,201,10,10,0.01,404,10
0.536,1e-05,252,252,10,10,0.01,504,10
0.542,1e-05,310,294,10,10,0.01,604,10
0.56,1e-05,361,343,10,10,0.01,704,10
0.584,1e-05,415,389,10,10,0.01,804,10
0.614,1e-05,465,439,10,10,0.01,904,10
0.642,1e-05,511,493,10,10,0.01,1004,10
0.66,1e-05,557,547,10,10,0.01,1104,10
0.692,1e-05,599,605,10,10,0.01,1204,10
0.7,1e-05,657,647,10,10,0.01,1304,10
0.726,1e-05,709,695,10,10,0.01,1404,10
0.73,1e-05,761,743,10,10,0.01,1504,10
0.752,1e-05,808,796,10,10,0.01,1604,10
0.768,1e-05,856,848,10,10,0.01,1704,10
0.802,1e-05,905,899,10,10,0.01,1804,10
0.834,1e-05,959,945,10,10,0.01,1904,10
0.842,1e-05,1009,995,10,10,0.01,2004,10
0.536,1e-05,61,43,10,10,0.01,104,11
0.548,1e-05,100,104,10,10,0.01,204,11
0.544,1e-05,147,157,10,10,0.01,304,11
0.558,1e-05,202,202,10,10,0.01,404,11
0.608,1e-05,257,247,10,10,0.01,504,11
0.642,1e-05,299,305,10,10,0.01,604,11
0.666,1e-05,347,357,10,10,0.01,704,11
0.686,1e-05,399,405,10,10,0.01,804,11
0.722,1e-05,459,445,10,10,0.01,904,11
0.728,1e-05,513,491,10,10,0.01,1004,11
0.756,1e-05,561,543,10,10,0.01,1104,11
0.792,1e-05,604,600,10,10,0.01,1204,11
0.82,1e-05,653,651,10,10,0.01,1304,11
0.866,1e-05,700,704,10,10,0.01,1404,11
0.898,1e-05,755,749,10,10,0.01,1504,11
0.928,1e-05,802,802,10,10,0.01,1604,11
0.934,1e-05,850,854,10,10,0.01,1704,11
0.942,1e-05,899,905,10,10,0.01,1804,11
0.95,1e-05,947,957,10,10,0.01,1904,11
0.952,1e-05,998,1006,10,10,0.01,2004,11
0.514,1e-05,49,55,10,10,0.01,104,12
0.528,1e-05,105,99,10,10,0.01,204,12
0.548,1e-05,149,155,10,10,0.01,304,12
0.556,1e-05,192,212,10,10,0.01,404,12
0.556,1e-05,244,260,10,10,0.01,504,12
0.55,1e-05,301,303,10,10,0.01,604,12
0.532,1e-05,355,349,10,10,0.01,704,12
0.532,1e-05,401,403,10,10,0.01,804,12
0.57,1e-05,454,450,10,10,0.01,904,12
0.604,1e-05,505,499,10,10,0.01,1004,12
0.63,1e-05,553,551,10,10,0.01,1104,12
0.672,1e-05,598,606,10,10,0.01,1204,12
0.712,1e-05,651,653,10,10,0.01,1304,12
0.722,1e-05,705,699,10,10,0.01,1404,12
0.734,1e-05,753,751,10,10,0.01,1504,12
0.754,1e-05,810,794,10,10,0.01,1604,12
0.79,1e-05,866,838,10,10,0.01,1704,12
0.84,1e-05,922,882,10,10,0.01,1804,12
0.874,1e-05,967,937,10,10,0.01,1904,12
0.88,1e-05,1016,988,10,10,0.01,2004,12
0.574,1e-05,37,67,10,10,0.01,104,13
0.592,1e-05,90,114,10,10,0.01,204,13
0.604,1e-05,152,152,10,10,0.01,304,13
0.592,1e-05,201,203,10,10,0.01,404,13
0.546,1e-05,259,245,10,10,0.01,504,13
0.558,1e-05,312,292,10,10,0.01,604,13
0.582,1e-05,362,342,10,10,0.01,704,13
0.63,1e-05,418,386,10,10,0.01,804,13
0.67,1e-05,469,435,10,10,0.01,904,13
0.724,1e-05,524,480,10,10,0.01,1004,13
0.748,1e-05,583,521,10,10,0.01,1104,13
0.75,1e-05,633,571,10,10,0.01,1204,13
0.75,1e-05,685,619,10,10,0.01,1304,13
0.814,1e-05,737,667,10,10,0.01,1404,13
0.866,1e-05,781,723,10,10,0.01,1504,13
0.888,1e-05,830,774,10,10,0.01,1604,13
0.91,1e-05,869,835,10,10,0.01,1704,13
0.91,1e-05,919,885,10,10,0.01,1804,13
0.9,1e-05,961,943,10,10,0.01,1904,13
0.922,1e-05,1017,987,10,10,0.01,2004,13
0.436,1e-05,53,51,10,10,0.01,104,14
0.48,1e-05,110,94,10,10,0.01,204,14
0.49,1e-05,158,146,10,10,0.01,304,14
0.536,1e-05,210,194,10,10,0.01,404,14
0.552,1e-05,270,234,10,10,0.01,504,14
0.584,1e-05,317,287,10,10,0.01,604,14
0.6,1e-05,365,339,10,10,0.01,704,14
0.64,1e-05,413,391,10,10,0.01,804,14
0.672,1e-05,463,441,10,10,0.01,904,14
0.706,1e-05,512,492,10,10,0.01,1004,14
0.732,1e-05,552,552,10,10,0.01,1104,14
0.766,1e-05,599,605,10,10,0.01,1204,14
0.81,1e-05,661,643,10,10,0.01,1304,14
0.84,1e-05,713,691,10,10,0.01,1404,14
0.856,1e-05,764,740,10,10,0.01,1504,14
0.874,1e-05,814,790,10,10,0.01,1604,14
0.882,1e-05,870,834,10,10,0.01,1704,14
0.904,1e-05,909,895,10,10,0.01,1804,14
0.912,1e-05,953,951,10,10,0.01,1904,14
0.926,1e-05,1001,1003,10,10,0.01,2004,14
0.482,1e-05,50,54,10,10,0.01,104,15
0.488,1e-05,91,113,10,10,0.01,204,15
0.506,1e-05,142,162,10,10,0.01,304,15
0.532,1e-05,191,213,10,10,0.01,404,15
0.574,1e-05,243,261,10,10,0.01,504,15
0.622,1e-05,292,312,10,10,0.01,604,15
0.644,1e-05,341,363,10,10,0.01,704,15
0.66,1e-05,392,412,10,10,0.01,804,15
0.654,1e-05,445,459,10,10,0.01,904,15
0.704,1e-05,487,517,10,10,0.01,1004,15
0.764,1e-05,535,569,10,10,0.01,1104,15
0.82,1e-05,582,622,10,10,0.01,1204,15
0.868,1e-05,630,674,10,10,0.01,1304,15
0.906,1e-05,680,724,10,10,0.01,1404,15
0.934,1e-05,738,766,10,10,0.01,1504,15
0.94,1e-05,787,817,10,10,0.01,1604,15
0.942,1e-05,838,866,10,10,0.01,1704,15
0.952,1e-05,891,913,10,10,0.01,1804,15
0.952,1e-05,936,968,10,10,0.01,1904,15
0.956,1e-05,990,1014,10,10,0.01,2004,15
0.424,1e-05,50,54,10,10,0.01,104,16
0.444,1e-05,108,96,10,10,0.01,204,16
0.484,1e-05,157,147,10,10,0.01,304,16
0.516,1e-05,212,192,10,10,0.01,404,16
0.54,1e-05,274,230,10,10,0.01,504,16
0.552,1e-05,327,277,10,10,0.01,604,16
0.576,1e-05,380,324,10,10,0.01,704,16
0.596,1e-05,421,383,10,10,0.01,804,16
0.612,1e-05,468,436,10,10,0.01,904,16
0.636,1e-05,518,486,10,10,0.01,1004,16
0.652,1e-05,565,539,10,10,0.01,1104,16
0.686,1e-05,618,586,10,10,0.01,1204,16
0.714,1e-05,667,637,10,10,0.01,1304,16
0.756,1e-05,721,683,10,10,0.01,1404,16
0.792,1e-05,769,735,10,10,0.01,1504,16
0.828,1e-05,826,778,10,10,0.01,1604,16
0.864,1e-05,871,833,10,10,0.01,1704,16
0.9,1e-05,914,890,10,10,0.01,1804,16
0.916,1e-05,960,944,10,10,0.01,1904,16
0.934,1e-05,1006,998,10,10,0.01,2004,16
0.538,1e-05,51,53,10,10,0.01,104,17
0.56,1e-05,105,99,10,10,0.01,204,17
0.548,1e-05,149,155,10,10,0.01,304,17
0.55,1e-05,205,199,10,10,0.01,404,17
0.574,1e-05,255,249,10,10,0.01,504,17
0.598,1e-05,309,295,10,10,0.01,604,17
0.614,1e-05,359,345,10,10,0.01,704,17
0.636,1e-05,415,389,10,10,0.01,804,17
0.652,1e-05,460,444,10,10,0.01,904,17
0.696,1e-05,510,494,10,10,0.01,1004,17
0.734,1e-05,562,542,10,10,0.01,1104,17
0.778,1e-05,611,593,10,10,0.01,1204,17
0.826,1e-05,657,647,10,10,0.01,1304,17
0.888,1e-05,708,696,10,10,0.01,1404,17
0.902,1e-05,752,752,10,10,0.01,1504,17
0.918,1e-05,805,799,10,10,0.01,1604,17
0.948,1e-05,851,853,10,10,0.01,1704,17
0.948,1e-05,893,911,10,10,0.01,1804,17
0.942,1e-05,951,953,10,10,0.01,1904,17
0.954,1e-05,1003,1001,10,10,0.01,2004,17
0.502,1e-05,58,46,10,10,0.01,104,18
0.524,1e-05,113,91,10,10,0.01,204,18
0.542,1e-05,153,151,10,10,0.01,304,18
0.564,1e-05,200,204,10,10,0.01,404,18
0.568,1e-05,249,255,10,10,0.01,504,18
0.592,1e-05,304,300,10,10,0.01,604,18
0.61,1e-05,362,342,10,10,0.01,704,18
0.656,1e-05,416,388,10,10,0.01,804,18
0.67,1e-05,457,447,10,10,0.01,904,18
0.724,1e-05,507,497,10,10,0.01,1004,18
0.736,1e-05,564,540,10,10,0.01,1104,18
0.786,1e-05,613,591,10,10,0.01,1204,18
0.814,1e-05,662,642,10,10,0.01,1304,18
0.862,1e-05,708,696,10,10,0.01,1404,18
0.88,1e-05,757,747,10,10,0.01,1504,18
0.922,1e-05,813,791,10,10,0.01,1604,18
0.94,1e-05,857,847,10,10,0.01,1704,18
0.948,1e-05,907,897,10,10,0.01,1804,18
0.952,1e-05,955,949,10,10,0.01,1904,18
0.95,1e-05,1006,998,10,10,0.01,2004,18
0.596,1e-05,57,47,10,10,0.01,104,19
0.614,1e-05,104,100,10,10,0.01,204,19
0.614,1e-05,148,156,10,10,0.01,304,19
0.622,1e-05,194,210,10,10,0.01,404,19
0.614,1e-05,235,269,10,10,0.01,504,19
0.608,1e-05,288,316,10,10,0.01,604,19
0.598,1e-05,334,370,10,10,0.01,704,19
0.622,1e-05,375,429,10,10,0.01,804,19
0.66,1e-05,417,487,10,10,0.01,904,19
0.716,1e-05,473,531,10,10,0.01,1004,19
0.76,1e-05,523,581,10,10,0.01,1104,19
0.782,1e-05,574,630,10,10,0.01,1204,19
0.792,1e-05,629,675,10,10,0.01,1304,19
0.828,1e-05,676,728,10,10,0.01,1404,19
0.876,1e-05,730,774,10,10,0.01,1504,19
0.9,1e-05,773,831,10,10,0.01,1604,19
0.91,1e-05,822,882,10,10,0.01,1704,19
0.914,1e-05,882,922,10,10,0.01,1804,19
0.918,1e-05,932,972,10,10,0.01,1904,19
0.928,1e-05,988,1016,10,10,0.01,2004,19
0.496,1e-05,52,52,10,10,0.01,104,20
0.498,1e-05,105,99,10,10,0.01,204,20
0.498,1e-05,159,145,10,10,0.01,304,20
0.508,1e-05,210,194,10,10,0.01,404,20
0.534,1e-05,260,244,10,10,0.01,504,20
0.548,1e-05,306,298,10,10,0.01,604,20
0.568,1e-05,362,342,10,10,0.01,704,20
0.622,1e-05,417,387,10,10,0.01,804,20
0.716,1e-05,462,442,10,10,0.01,904,20
0.786,1e-05,505,499,10,10,0.01,1004,20
0.804,1e-05,558,546,10,10,0.01,1104,20
0.822,1e-05,608,596,10,10,0.01,1204,20
0.862,1e-05,656,648,10,10,0.01,1304,20
0.87,1e-05,710,694,10,10,0.01,1404,20
0.886,1e-05,758,746,10,10,0.01,1504,20
0.888,1e-05,807,797,10,10,0.01,1604,20
0.904,1e-05,852,852,10,10,0.01,1704,20
0.908,1e-05,905,899,10,10,0.01,1804,20
0.914,1e-05,950,954,10,10,0.01,1904,20
0.916,1e-05,1004,1000,10,10,0.01,2004,20
0.526,0.0001,53,51,10,10,0.0001,104,1
0.526,0.0001,105,99,10,10,0.0001,204,1
0.526,0.0001,151,153,10,10,0.0001,304,1
0.526,0.0001,204,200,10,10,0.0001,404,1
0.526,0.0001,250,254,10,10,0.0001,504,1
0.526,0.0001,306,298,10,10,0.0001,604,1
0.526,0.0001,356,348,10,10,0.0001,704,1
0.526,0.0001,408,396,10,10,0.0001,804,1
0.526,0.0001,456,448,10,10,0.0001,904,1
0.526,0.0001,499,505,10,10,0.0001,1004,1
0.526,0.0001,555,549,10,10,0.0001,1104,1
0.526,0.0001,609,595,10,10,0.0001,1204,1
0.526,0.0001,664,640,10,10,0.0001,1304,1
0.526,0.0001,719,685,10,10,0.0001,1404,1
0.526,0.0001,764,740,10,10,0.0001,1504,1
0.526,0.0001,814,790,10,10,0.0001,1604,1
0.526,0.0001,876,828,10,10,0.0001,1704,1
0.526,0.0001,921,883,10,10,0.0001,1804,1
0.526,0.0001,970,934,10,10,0.0001,1904,1
0.526,0.0001,1015,989,10,10,0.0001,2004,1
0.488,0.0001,49,55,10,10,0.0001,104,2
0.488,0.0001,90,114,10,10,0.0001,204,2
0.488,0.0001,145,159,10,10,0.0001,304,2
0.488,0.0001,190,214,10,10,0.0001,404,2
0.49,0.0001,245,259,10,10,0.0001,504,2
0.49,0.0001,294,310,10,10,0.0001,604,2
0.49,0.0001,345,359,10,10,0.0001,704,2
0.49,0.0001,392,412,10,10,0.0001,804,2
0.488,0.0001,433,471,10,10,0.0001,904,2
0.488,0.0001,481,523,10,10,0.0001,1004,2
0.488,0.0001,531,573,10,10,0.0001,1104,2
0.488,0.0001,574,630,10,10,0.0001,1204,2
0.486,0.0001,623,681,10,10,0.0001,1304,2
0.486,0.0001,679,725,10,10,0.0001,1404,2
0.484,0.0001,738,766,10,10,0.0001,1504,2
0.484,0.0001,786,818,10,10,0.0001,1604,2
0.49,0.0001,843,861,10,10,0.0001,1704,2
0.49,0.0001,894,910,10,10,0.0001,1804,2
0.49,0.0001,952,952,10,10,0.0001,1904,2
0.49,0.0001,1005,999,10,10,0.0001,2004,2
0.5,0.0001,48,56,10,10,0.0001,104,3
0.5,0.0001,97,107,10,10,0.0001,204,3
0.5,0.0001,152,152,10,10,0.0001,304,3
0.502,0.0001,200,204,10,10,0.0001,404,3
0.502,0.0001,247,257,10,10,0.0001,504,3
0.502,0.0001,302,302,10,10,0.0001,604,3
0.502,0.0001,360,344,10,10,0.0001,704,3
0.502,0.0001,402,402,10,10,0.0001,804,3
0.504,0.0001,455,449,10,10,0.0001,904,3
0.502,0.0001,500,504,10,10,0.0001,1004,3
0.502,0.0001,551,553,10,10,0.0001,1104,3
0.502,0.0001,598,606,10,10,0.0001,1204,3
0.502,0.0001,640,664,10,10,0.0001,1304,3
0.502,0.0001,695,709,10,10,0.0001,1404,3
0.506,0.0001,742,762,10,10,0.0001,1504,3
0.506,0.0001,794,810,10,10,0.0001,1604,3
0.506,0.0001,839,865,10,10,0.0001,1704,3
0.506,0.0001,893,911,10,10,0.0001,1804,3
0.508,0.0001,948,956,10,10,0.0001,1904,3
0.51,0.0001,1001,1003,10,10,0.0001,2004,3
0.558,0.0001,59,45,10,10,0.0001,104,4
0.558,0.0001,106,98,10,10,0.0001,204,4
0.558,0.0001,152,152,10,10,0.0001,304,4
0.558,0.0001,201,203,10,10,0.0001,404,4
0.558,0.0001,257,247,10,10,0.0001,504,4
0.558,0.0001,308,296,10,10,0.0001,604,4
0.558,0.0001,351,353,10,10,0.0001,704,4
0.56,0.0001,397,407,10,10,0.0001,804,4
0.56,0.0001,443,461,10,10,0.0001,904,4
0.56,0.0001,504,500,10,10,0.0001,1004,4
0.558,0.0001,551,553,10,10,0.0001,1104,4
0.558,0.0001,596,608,10,10,0.0001,1204,4
0.558,0.0001,648,656,10,10,0.0001,1304,4
0.558,0.0001,694,710,10,10,0.0001,1404,4
0.56,0.0001,741,763,10,10,0.0001,1504,4
0.56,0.0001,786,818,10,10,0.0001,1604,4
0.56,0.0001,834,870,10,10,0.0001,1704,4
0.56,0.0001,888,916,10,10,0.0001,1804,4
0.56,0.0001,942,962,10,10,0.0001,1904,4
0.56,0.0001,988,1016,10,10,0.0001,2004,4
0.488,0.0001,53,51,10,10,0.0001,104,5
0.488,0.0001,109,95,10,10,0.0001,204,5
0.488,0.0001,165,139,10,10,0.0001,304,5
0.488,0.0001,216,188,10,10,0.0001,404,5
0.488,0.0001,267,237,10,10,0.0001,504,5
0.488,0.0001,322,282,10,10,0.0001,604,5
0.488,0.0001,375,329,10,10,0.0001,704,5
0.488,0.0001,425,379,10,10,0.0001,804,5
0.488,0.0001,474,430,10,10,0.0001,904,5
0.488,0.0001,523,481,10,10,0.0001,1004,5
0.486,0.0001,569,535,10,10,0.0001,1104,5
0.486,0.0001,616,588,10,10,0.0001,1204,5
0.486,0.0001,674,630,10,10,0.0001,1304,5
0.486,0.0001,723,681,10,10,0.0001,1404,5
0.484,0.0001,770,734,10,10,0.0001,1504,5
0.484,0.0001,818,786,10,10,0.0001,1604,5
0.484,0.0001,867,837,10,10,0.0001,1704,5
0.484,0.0001,928,876,10,10,0.0001,1804,5
0.484,0.0001,975,929,10,10,0.0001,1904,5
0.482,0.0001,1022,982,10,10,0.0001,2004,5
0.514,0.0001,63,41,10,10,0.0001,104,6
0.514,0.0001,110,94,10,10,0.0001,204,6
0.514,0.0001,157,147,10,10,0.0001,304,6
0.514,0.0001,206,198,10,10,0.0001,404,6
0.514,0.0001,258,246,10,10,0.0001,504,6
0.512,0.0001,306,298,10,10,0.0001,604,6
0.512,0.0001,350,354,10,10,0.0001,704,6
0.512,0.0001,394,410,10,10,0.0001,804,6
0.512,0.0001,445,459,10,10,0.0001,904,6
0.512,0.0001,491,513,10,10,0.0001,1004,6
0.512,0.0001,538,566,10,10,0.0001,1104,6
0.512,0.0001,591,613,10,10,0.0001,1204,6
0.512,0.0001,642,662,10,10,0.0001,1304,6
0.512,0.0001,692,712,10,10,0.0001,1404,6
0.512,0.0001,761,743,10,10,0.0001,1504,6
0.512,0.0001,810,794,10,10,0.0001,1604,6
0.512,0.0001,861,843,10,10,0.0001,1704,6
0.514,0.0001,910,894,10,10,0.0001,1804,6
0.514,0.0001,958,946,10,10,0.0001,1904,6
0.516,0.0001,1012,992,10,10,0.0001,2004,6
0.436,0.0001,56,48,10,10,0.0001,104,7
0.438,0.0001,105,99,10,10,0.0001,204,7
0.438,0.0001,158,146,10,10,0.0001,304,7
0.438,0.0001,214,190,10,10,0.0001,404,7
0.438,0.0001,270,234,10,10,0.0001,504,7
0.438,0.0001,321,283,10,10,0.0001,604,7
0.438,0.0001,373,331,10,10,0.0001,704,7
0.436,0.0001,420,384,10,10,0.0001,804,7
0.434,0.0001,473,431,10,10,0.0001,904,7
0.434,0.0001,528,476,10,10,0.0001,1004,7
0.432,0.0001,577,527,10,10,0.0001,1104,7
0.432,0.0001,629,575,10,10,0.0001,1204,7
0.432,0.0001,685,619,10,10,0.0001,1304,7
0.432,0.0001,735,669,10,10,0.0001,1404,7
0.432,0.0001,770,734,10,10,0.0001,1504,7
0.43,0.0001,810,794,10,10,0.0001,1604,7
0.432,0.0001,857,847,10,10,0.0001,1704,7
0.432,0.0001,909,895,10,10,0.0001,1804,7
0.426,0.0001,957,947,10,10,0.0001,1904,7
0.428,0.0001,1008,996,10,10,0.0001,2004,7
0.486,0.0001,56,48,10,10,0.0001,104,8
0.486,0.0001,112,92,10,10,0.0001,204,8
0.486,0.0001,164,140,10,10,0.0001,304,8
0.486,0.0001,210,194,10,10,0.0001,404,8
0.486,0.0001,260,244,10,10,0.0001,504,8
0.486,0.0001,318,286,10,10,0.0001,604,8
0.486,0.0001,372,332,10,10,0.0001,704,8
0.486,0.0001,428,376,10,10,0.0001,804,8
0.486,0.0001,464,440,10,10,0.0001,904,8
0.486,0.0001,511,493,10,10,0.0001,1004,8
0.486,0.0001,556,548,10,10,0.0001,1104,8
0.486,0.0001,601,603,10,10,0.0001,1204,8
0.486,0.0001,653,651,10,10,0.0001,1304,8
0.486,0.0001,706,698,10,10,0.0001,1404,8
0.486,0.0001,765,739,10,10,0.0001,1504,8
0.486,0.0001,814,790,10,10,0.0001,1604,8
0.486,0.0001,859,845,10,10,0.0001,1704,8
0.486,0.0001,911,893,10,10,0.0001,1804,8
0.486,0.0001,951,953,10,10,0.0001,1904,8
0.486,0.0001,1009,995,10,10,0.0001,2004,8
0.49,0.0001,51,53,10,10,0.0001,104,9
0.49,0.0001,105,99,10,10,0.0001,204,9
0.488,0.0001,149,155,10,10,0.0001,304,9
0.49,0.0001,202,202,10,10,0.0001,404,9
0.49,0.0001,252,252,10,10,0.0001,504,9
0.49,0.0001,299,305,10,10,0.0001,604,9
0.49,0.0001,345,359,10,10,0.0001,704,9
0.49,0.0001,396,408,10,10,0.0001,804,9
0.49,0.0001,446,458,10,10,0.0001,904,9
0.488,0.0001,500,504,10,10,0.0001,1004,9
0.49,0.0001,549,555,10,10,0.0001,1104,9
0.492,0.0001,599,605,10,10,0.0001,1204,9
0.49,0.0001,648,656,10,10,0.0001,1304,9
0.492,0.0001,704,700,10,10,0.0001,1404,9
0.492,0.0001,748,756,10,10,0.0001,1504,9
0.492,0.0001,799,805,10,10,0.0001,1604,9
0.496,0.0001,843,861,10,10,0.0001,1704,9
0.502,0.0001,893,911,10,10,0.0001,1804,9
0.506,0.0001,940,964,10,10,0.0001,1904,9
0.506,0.0001,996,1008,10,10,0.0001,2004,9
0.482,0.0001,54,50,10,10,0.0001,104,10
0.484,0.0001,108,96,10,10,0.0001,204,10
0.484,0.0001,161,143,10,10,0.0001,304,10
0.484,0.0001,214,190,10,10,0.0001,404,10
0.484,0.0001,269,235,10,10,0.0001,504,10
0.484,0.0001,318,286,10,10,0.0001,604,10
0.484,0.0001,361,343,10,10,0.0001,704,10
0.486,0.0001,415,389,10,10,0.0001,804,10
0.486,0.0001,463,441,10,10,0.0001,904,10
0.486,0.0001,512,492,10,10,0.0001,1004,10
0.486,0.0001,568,536,10,10,0.0001,1104,10
0.484,0.0001,620,584,10,10,0.0001,1204,10
0.488,0.0001,669,635,10,10,0.0001,1304,10
0.49,0.0001,722,682,10,10,0.0001,1404,10
0.49,0.0001,771,733,10,10,0.0001,1504,10
0.492,0.0001,822,782,10,10,0.0001,1604,10
0.49,0.0001,866,838,10,10,0.0001,1704,10
0.49,0.0001,916,888,10,10,0.0001,1804,10
0.488,0.0001,962,942,10,10,0.0001,1904,10
0.49,0.0001,1020,984,10,10,0.0001,2004,10
0.486,0.0001,50,54,10,10,0.0001,104,11
0.488,0.0001,99,105,10,10,0.0001,204,11
0.488,0.0001,156,148,10,10,0.0001,304,11
0.488,0.0001,208,196,10,10,0.0001,404,11
0.488,0.0001,258,246,10,10,0.0001,504,11
0.488,0.0001,316,288,10,10,0.0001,604,11
0.488,0.0001,365,339,10,10,0.0001,704,11
0.488,0.0001,418,386,10,10,0.0001,804,11
0.488,0.0001,464,440,10,10,0.0001,904,11
0.488,0.0001,509,495,10,10,0.0001,1004,11
0.488,0.0001,561,543,10,10,0.0001,1104,11
0.49,0.0001,615,589,10,10,0.0001,1204,11
0.492,0.0001,672,632,10,10,0.0001,1304,11
0.492,0.0001,728,676,10,10,0.0001,1404,11
0.492,0.0001,775,729,10,10,0.0001,1504,11
0.494,0.0001,827,777,10,10,0.0001,1604,11
0.494,0.0001,873,831,10,10,0.0001,1704,11
0.494,0.0001,922,882,10,10,0.0001,1804,11
0.496,0.0001,975,929,10,10,0.0001,1904,11
0.496,0.0001,1017,987,10,10,0.0001,2004,11
0.498,0.0001,57,47,10,10,0.0001,104,12
0.496,0.0001,112,92,10,10,0.0001,204,12
0.496,0.0001,155,149,10,10,0.0001,304,12
0.496,0.0001,203,201,10,10,0.0001,404,12
0.496,0.0001,249,255,10,10,0.0001,504,12
0.496,0.0001,298,306,10,10,0.0001,604,12
0.496,0.0001,348,356,10,10,0.0001,704,12
0.496,0.0001,399,405,10,10,0.0001,804,12
0.498,0.0001,446,458,10,10,0.0001,904,12
0.498,0.0001,498,506,10,10,0.0001,1004,12
0.498,0.0001,545,559,10,10,0.0001,1104,12
0.496,0.0001,590,614,10,10,0.0001,1204,12
0.496,0.0001,646,658,10,10,0.0001,1304,12
0.496,0.0001,688,716,10,10,0.0001,1404,12
0.496,0.0001,749,755,10,10,0.0001,1504,12
0.496,0.0001,805,799,10,10,0.0001,1604,12
0.496,0.0001,858,846,10,10,0.0001,1704,12
0.496,0.0001,911,893,10,10,0.0001,1804,12
0.498,0.0001,965,939,10,10,0.0001,1904,12
0.5,0.0001,1012,992,10,10,0.0001,2004,12
0.528,0.0001,60,44,10,10,0.0001,104,13
0.528,0.0001,106,98,10,10,0.0001,204,13
0.528,0.0001,145,159,10,10,0.0001,304,13
0.528,0.0001,201,203,10,10,0.0001,404,13
0.528,0.0001,253,251,10,10,0.0001,504,13
0.528,0.0001,302,302,10,10,0.0001,604,13
0.528,0.0001,352,352,10,10,0.0001,704,13
0.528,0.0001,398,406,10,10,0.0001,804,13
0.53,0.0001,459,445,10,10,0.0001,904,13
0.53,0.0001,512,492,10,10,0.0001,1004,13
0.53,0.0001,559,545,10,10,0.0001,1104,13
0.53,0.0001,606,598,10,10,0.0001,1204,13
0.53,0.0001,650,654,10,10,0.0001,1304,13
0.53,0.0001,702,702,10,10,0.0001,1404,13
0.53,0.0001,743,761,10,10,0.0001,1504,13
0.53,0.0001,792,812,10,10,0.0001,1604,13
0.53,0.0001,849,855,10,10,0.0001,1704,13
0.53,0.0001,902,902,10,10,0.0001,1804,13
0.532,0.0001,949,955,10,10,0.0001,1904,13
0.532,0.0001,996,1008,10,10,0.0001,2004,13
0.454,0.0001,48,56,10,10,0.0001,104,14
0.454,0.0001,95,109,10,10,0.0001,204,14
0.452,0.0001,150,154,10,10,0.0001,304,14
0.454,0.0001,192,212,10,10,0.0001,404,14
0.454,0.0001,245,259,10,10,0.0001,504,14
0.456,0.0001,289,315,10,10,0.0001,604,14
0.456,0.0001,342,362,10,10,0.0001,704,14
0.456,0.0001,399,405,10,10,0.0001,804,14
0.456,0.0001,448,456,10,10,0.0001,904,14
0.456,0.0001,495,509,10,10,0.0001,1004,14
0.456,0.0001,551,553,10,10,0.0001,1104,14
0.456,0.0001,593,611,10,10,0.0001,1204,14
0.46,0.0001,646,658,10,10,0.0001,1304,14
0.464,0.0001,697,707,10,10,0.0001,1404,14
0.466,0.0001,748,756,10,10,0.0001,1504,14
0.468,0.0001,796,808,10,10,0.0001,1604,14
0.47,0.0001,851,853,10,10,0.0001,1704,14
0.472,0.0001,901,903,10,10,0.0001,1804,14
0.472,0.0001,944,960,10,10,0.0001,1904,14
0.472,0.0001,998,1006,10,10,0.0001,2004,14
0.448,0.0001,49,55,10,10,0.0001,104,15
0.446,0.0001,99,105,10,10,0.0001,204,15
0.446,0.0001,157,147,10,10,0.0001,304,15
0.446,0.0001,208,196,10,10,0.0001,404,15
0.446,0.0001,253,251,10,10,0.0001,504,15
0.446,0.0001,304,300,10,10,0.0001,604,15
0.446,0.0001,350,354,10,10,0.0001,704,15
0.442,0.0001,409,395,10,10,0.0001,804,15
0.442,0.0001,461,443,10,10,0.0001,904,15
0.442,0.0001,511,493,10,10,0.0001,1004,15
0.442,0.0001,563,541,10,10,0.0001,1104,15
0.444,0.0001,609,595,10,10,0.0001,1204,15
0.444,0.0001,645,659,10,10,0.0001,1304,15
0.442,0.0001,691,713,10,10,0.0001,1404,15
0.442,0.0001,740,764,10,10,0.0001,1504,15
0.444,0.0001,791,813,10,10,0.0001,1604,15
0.446,0.0001,846,858,10,10,0.0001,1704,15
0.448,0.0001,906,898,10,10,0.0001,1804,15
0.452,0.0001,957,947,10,10,0.0001,1904,15
0.454,0.0001,1004,1000,10,10,0.0001,2004,15
0.468,0.0001,55,49,10,10,0.0001,104,16
0.468,0.0001,109,95,10,10,0.0001,204,16
0.468,0.0001,167,137,10,10,0.0001,304,16
0.468,0.0001,222,182,10,10,0.0001,404,16
0.468,0.0001,275,229,10,10,0.0001,504,16
0.468,0.0001,332,272,10,10,0.0001,604,16
0.468,0.0001,386,318,10,10,0.0001,704,16
0.468,0.0001,434,370,10,10,0.0001,804,16
0.468,0.0001,483,421,10,10,0.0001,904,16
0.468,0.0001,535,469,10,10,0.0001,1004,16
0.468,0.0001,581,523,10,10,0.0001,1104,16
0.466,0.0001,633,571,10,10,0.0001,1204,16
0.466,0.0001,685,619,10,10,0.0001,1304,16
0.466,0.0001,736,668,10,10,0.0001,1404,16
0.466,0.0001,774,730,10,10,0.0001,1504,16
0.466,0.0001,824,780,10,10,0.0001,1604,16
0.466,0.0001,879,825,10,10,0.0001,1704,16
0.466,0.0001,927,877,10,10,0.0001,1804,16
0.466,0.0001,971,933,10,10,0.0001,1904,16
0.466,0.0001,1018,986,10,10,0.0001,2004,16
0.474,0.0001,46,58,10,10,0.0001,104,17
0.474,0.0001,91,113,10,10,0.0001,204,17
0.474,0.0001,141,163,10,10,0.0001,304,17
0.474,0.0001,190,214,10,10,0.0001,404,17
0.474,0.0001,240,264,10,10,0.0001,504,17
0.474,0.0001,292,312,10,10,0.0001,604,17
0.474,0.0001,342,362,10,10,0.0001,704,17
0.474,0.0001,395,409,10,10,0.0001,804,17
0.476,0.0001,447,457,10,10,0.0001,904,17
0.476,0.0001,495,509,10,10,0.0001,1004,17
0.478,0.0001,545,559,10,10,0.0001,1104,17
0.478,0.0001,599,605,10,10,0.0001,1204,17
0.478,0.0001,647,657,10,10,0.0001,1304,17
0.478,0.0001,703,701,10,10,0.0001,1404,17
0.478,0.0001,759,745,10,10,0.0001,1504,17
0.478,0.0001,814,790,10,10,0.0001,1604,17
0.478,0.0001,868,836,10,10,0.0001,1704,17
0.478,0.0001,916,888,10,10,0.0001,1804,17
0.482,0.0001,963,941,10,10,0.0001,1904,17
0.482,0.0001,1014,990,10,10,0.0001,2004,17
0.506,0.0001,58,46,10,10,0.0001,104,18
0.508,0.0001,111,93,10,10,0.0001,204,18
0.508,0.0001,162,142,10,10,0.0001,304,18
0.508,0.0001,217,187,10,10,0.0001,404,18
0.508,0.0001,262,242,10,10,0.0001,504,18
0.506,0.0001,314,290,10,10,0.0001,604,18
0.51,0.0001,360,344,10,10,0.0001,704,18
0.51,0.0001,414,390,10,10,0.0001,804,18
0.51,0.0001,467,437,10,10,0.0001,904,18
0.51,0.0001,511,493,10,10,0.0001,1004,18
0.514,0.0001,554,550,10,10,0.0001,1104,18
0.514,0.0001,607,597,10,10,0.0001,1204,18
0.514,0.0001,649,655,10,10,0.0001,1304,18
0.514,0.0001,689,715,10,10,0.0001,1404,18
0.514,0.0001,746,758,10,10,0.0001,1504,18
0.514,0.0001,787,817,10,10,0.0001,1604,18
0.516,0.0001,849,855,10,10,0.0001,1704,18
0.516,0.0001,897,907,10,10,0.0001,1804,18
0.516,0.0001,946,958,10,10,0.0001,1904,18
0.514,0.0001,994,1010,10,10,0.0001,2004,18
0.516,0.0001,47,57,10,10,0.0001,104,19
0.516,0.0001,104,100,10,10,0.0001,204,19
0.516,0.0001,145,159,10,10,0.0001,304,19
0.516,0.0001,191,213,10,10,0.0001,404,19
0.516,0.0001,237,267,10,10,0.0001,504,19
0.516,0.0001,286,318,10,10,0.0001,604,19
0.516,0.0001,337,367,10,10,0.0001,704,19
0.516,0.0001,386,418,10,10,0.0001,804,19
0.516,0.0001,437,467,10,10,0.0001,904,19
0.516,0.0001,485,519,10,10,0.0001,1004,19
0.516,0.0001,534,570,10,10,0.0001,1104,19
0.516,0.0001,586,618,10,10,0.0001,1204,19
0.516,0.0001,639,665,10,10,0.0001,1304,19
0.516,0.0001,690,714,10,10,0.0001,1404,19
0.516,0.0001,739,765,10,10,0.0001,1504,19
0.516,0.0001,787,817,10,10,0.0001,1604,19
0.516,0.0001,839,865,10,10,0.0001,1704,19
0.518,0.0001,896,908,10,10,0.0001,1804,19
0.518,0.0001,943,961,10,10,0.0001,1904,19
0.518,0.0001,991,1013,10,10,0.0001,2004,19
0.504,0.0001,50,54,10,10,0.0001,104,20
0.504,0.0001,103,101,10,10,0.0001,204,20
0.504,0.0001,150,154,10,10,0.0001,304,20
0.504,0.0001,195,209,10,10,0.0001,404,20
0.504,0.0001,250,254,10,10,0.0001,504,20
0.504,0.0001,301,303,10,10,0.0001,604,20
0.504,0.0001,349,355,10,10,0.0001,704,20
0.504,0.0001,400,404,10,10,0.0001,804,20
0.504,0.0001,448,456,10,10,0.0001,904,20
0.508,0.0001,497,507,10,10,0.0001,1004,20
0.508,0.0001,550,554,10,10,0.0001,1104,20
0.506,0.0001,600,604,10,10,0.0001,1204,20
0.506,0.0001,653,651,10,10,0.0001,1304,20
0.504,0.0001,703,701,10,10,0.0001,1404,20
0.504,0.0001,754,750,10,10,0.0001,1504,20
0.504,0.0001,809,795,10,10,0.0001,1604,20
0.504,0.0001,863,841,10,10,0.0001,1704,20
0.504,0.0001,925,879,10,10,0.0001,1804,20
0.504,0.0001,964,940,10,10,0.0001,1904,20
0.502,0.0001,1017,987,10,10,0.0001,2004,20
0.506,0.0001,51,53,10,10,0.001,104,1
0.504,0.0001,95,109,10,10,0.001,204,1
0.504,0.0001,153,151,10,10,0.001,304,1
0.506,0.0001,212,192,10,10,0.001,404,1
0.506,0.0001,267,237,10,10,0.001,504,1
0.506,0.0001,307,297,10,10,0.001,604,1
0.506,0.0001,352,352,10,10,0.001,704,1
0.504,0.0001,398,406,10,10,0.001,804,1
0.504,0.0001,448,456,10,10,0.001,904,1
0.51,0.0001,492,512,10,10,0.001,1004,1
0.504,0.0001,544,560,10,10,0.001,1104,1
0.502,0.0001,597,607,10,10,0.001,1204,1
0.498,0.0001,653,651,10,10,0.001,1304,1
0.5,0.0001,697,707,10,10,0.001,1404,1
0.508,0.0001,751,753,10,10,0.001,1504,1
0.516,0.0001,801,803,10,10,0.001,1604,1
0.53,0.0001,860,844,10,10,0.001,1704,1
0.534,0.0001,906,898,10,10,0.001,1804,1
0.534,0.0001,957,947,10,10,0.001,1904,1
0.536,0.0001,1005,999,10,10,0.001,2004,1
0.486,0.0001,56,48,10,10,0.001,104,2
0.486,0.0001,100,104,10,10,0.001,204,2
0.486,0.0001,153,151,10,10,0.001,304,2
0.484,0.0001,201,203,10,10,0.001,404,2
0.484,0.0001,258,246,10,10,0.001,504,2
0.484,0.0001,311,293,10,10,0.001,604,2
0.484,0.0001,354,350,10,10,0.001,704,2
0.482,0.0001,405,399,10,10,0.001,804,2
0.478,0.0001,455,449,10,10,0.001,904,2
0.476,0.0001,494,510,10,10,0.001,1004,2
0.476,0.0001,536,568,10,10,0.001,1104,2
0.476,0.0001,586,618,10,10,0.001,1204,2
0.48,0.0001,641,663,10,10,0.001,1304,2
0.478,0.0001,689,715,10,10,0.001,1404,2
0.478,0.0001,736,768,10,10,0.001,1504,2
0.48,0.0001,788,816,10,10,0.001,1604,2
0.486,0.0001,845,859,10,10,0.001,1704,2
0.502,0.0001,891,913,10,10,0.001,1804,2
0.522,0.0001,949,955,10,10,0.001,1904,2
0.556,0.0001,1003,1001,10,10,0.001,2004,2
0.498,0.0001,54,50,10,10,0.001,104,3
0.498,0.0001,110,94,10,10,0.001,204,3
0.498,0.0001,167,137,10,10,0.001,304,3
0.498,0.0001,208,196,10,10,0.001,404,3
0.5,0.0001,261,243,10,10,0.001,504,3
0.502,0.0001,313,291,10,10,0.001,604,3
0.502,0.0001,351,353,10,10,0.001,704,3
0.504,0.0001,404,400,10,10,0.001,804,3
0.504,0.0001,453,451,10,10,0.001,904,3
0.512,0.0001,504,500,10,10,0.001,1004,3
0.516,0.0001,549,555,10,10,0.001,1104,3
0.522,0.0001,591,613,10,10,0.001,1204,3
0.53,0.0001,632,672,10,10,0.001,1304,3
0.546,0.0001,682,722,10,10,0.001,1404,3
0.552,0.0001,736,768,10,10,0.001,1504,3
0.564,0.0001,791,813,10,10,0.001,1604,3
0.574,0.0001,848,856,10,10,0.001,1704,3
0.59,0.0001,900,904,10,10,0.001,1804,3
0.598,0.0001,954,950,10,10,0.001,1904,3
0.612,0.0001,996,1008,10,10,0.001,2004,3
0.524,0.0001,47,57,10,10,0.001,104,4
0.524,0.0001,106,98,10,10,0.001,204,4
0.522,0.0001,160,144,10,10,0.001,304,4
0.522,0.0001,210,194,10,10,0.001,404,4
0.526,0.0001,256,248,10,10,0.001,504,4
0.524,0.0001,301,303,10,10,0.001,604,4
0.52,0.0001,351,353,10,10,0.001,704,4
0.522,0.0001,400,404,10,10,0.001,804,4
0.522,0.0001,454,450,10,10,0.001,904,4
0.528,0.0001,502,502,10,10,0.001,1004,4
0.536,0.0001,552,552,10,10,0.001,1104,4
0.534,0.0001,601,603,10,10,0.001,1204,4
0.542,0.0001,643,661,10,10,0.001,1304,4
0.55,0.0001,690,714,10,10,0.001,1404,4
0.56,0.0001,746,758,10,10,0.001,1504,4
0.57,0.0001,792,812,10,10,0.001,1604,4
0.582,0.0001,842,862,10,10,0.001,1704,4
0.6,0.0001,890,914,10,10,0.001,1804,4
0.602,0.0001,938,966,10,10,0.001,1904,4
0.606,0.0001,992,1012,10,10,0.001,2004,4
0.53,0.0001,60,44,10,10,0.001,104,5
0.53,0.0001,115,89,10,10,0.001,204,5
0.53,0.0001,168,136,10,10,0.001,304,5
0.53,0.0001,222,182,10,10,0.001,404,5
0.53,0.0001,266,238,10,10,0.001,504,5
0.53,0.0001,317,287,10,10,0.001,604,5
0.53,0.0001,368,336,10,10,0.001,704,5
0.532,0.0001,426,378,10,10,0.001,804,5
0.534,0.0001,476,428,10,10,0.001,904,5
0.534,0.0001,528,476,10,10,0.001,1004,5
0.536,0.0001,580,524,10,10,0.001,1104,5
0.54,0.0001,628,576,10,10,0.001,1204,5
0.546,0.0001,680,624,10,10,0.001,1304,5
0.546,0.0001,725,679,10,10,0.001,1404,5
0.548,0.0001,778,726,10,10,0.001,1504,5
0.554,0.0001,823,781,10,10,0.001,1604,5
0.558,0.0001,869,835,10,10,0.001,1704,5
0.564,0.0001,912,892,10,10,0.001,1804,5
0.568,0.0001,965,939,10,10,0.001,1904,5
0.58,0.0001,1016,988,10,10,0.001,2004,5
0.524,0.0001,51,53,10,10,0.001,104,6
0.532,0.0001,98,106,10,10,0.001,204,6
0.534,0.0001,145,159,10,10,0.001,304,6
0.532,0.0001,198,206,10,10,0.001,404,6
0.532,0.0001,239,265,10,10,0.001,504,6
0.528,0.0001,297,307,10,10,0.001,604,6
0.528,0.0001,344,360,10,10,0.001,704,6
0.526,0.0001,390,414,10,10,0.001,804,6
0.53,0.0001,440,464,10,10,0.001,904,6
0.518,0.0001,488,516,10,10,0.001,1004,6
0.532,0.0001,544,560,10,10,0.001,1104,6
0.54,0.0001,602,602,10,10,0.001,1204,6
0.542,0.0001,652,652,10,10,0.001,1304,6
0.546,0.0001,695,709,10,10,0.001,1404,6
0.554,0.0001,747,757,10,10,0.001,1504,6
0.57,0.0001,792,812,10,10,0.001,1604,6
0.574,0.0001,840,864,10,10,0.001,1704,6
0.576,0.0001,893,911,10,10,0.001,1804,6
0.588,0.0001,941,963,10,10,0.001,1904,6
0.596,0.0001,990,1014,10,10,0.001,2004,6
0.536,0.0001,53,51,10,10,0.001,104,7
0.534,0.0001,101,103,10,10,0.001,204,7
0.532,0.0001,149,155,10,10,0.001,304,7
0.534,0.0001,198,206,10,10,0.001,404,7
0.532,0.0001,243,261,10,10,0.001,504,7
0.528,0.0001,295,309,10,10,0.001,604,7
0.526,0.0001,341,363,10,10,0.001,704,7
0.522,0.0001,394,410,10,10,0.001,804,7
0.52,0.0001,439,465,10,10,0.001,904,7
0.524,0.0001,491,513,10,10,0.001,1004,7
0.534,0.0001,537,567,10,10,0.001,1104,7
0.536,0.0001,589,615,10,10,0.001,1204,7
0.54,0.0001,648,656,10,10,0.001,1304,7
0.552,0.0001,693,711,10,10,0.001,1404,7
0.558,0.0001,743,761,10,10,0.001,1504,7
0.566,0.0001,792,812,10,10,0.001,1604,7
0.592,0.0001,847,857,10,10,0.001,1704,7
0.602,0.0001,897,907,10,10,0.001,1804,7
0.608,0.0001,949,955,10,10,0.001,1904,7
0.618,0.0001,1001,1003,10,10,0.001,2004,7
0.474,0.0001,45,59,10,10,0.001,104,8
0.472,0.0001,92,112,10,10,0.001,204,8
0.472,0.0001,149,155,10,10,0.001,304,8
0.478,0.0001,203,201,10,10,0.001,404,8
0.476,0.0001,245,259,10,10,0.001,504,8
0.478,0.0001,304,300,10,10,0.001,604,8
0.482,0.0001,356,348,10,10,0.001,704,8
0.486,0.0001,394,410,10,10,0.001,804,8
0.488,0.0001,441,463,10,10,0.001,904,8
0.498,0.0001,490,514,10,10,0.001,1004,8
0.5,0.0001,529,575,10,10,0.001,1104,8
0.5,0.0001,576,628,10,10,0.001,1204,8
0.506,0.0001,628,676,10,10,0.001,1304,8
0.506,0.0001,669,735,10,10,0.001,1404,8
0.508,0.0001,719,785,10,10,0.001,1504,8
0.522,0.0001,777,827,10,10,0.001,1604,8
0.532,0.0001,830,874,10,10,0.001,1704,8
0.548,0.0001,888,916,10,10,0.001,1804,8
0.556,0.0001,940,964,10,10,0.001,1904,8
0.574,0.0001,990,1014,10,10,0.001,2004,8
0.496,0.0001,50,54,10,10,0.001,104,9
0.496,0.0001,103,101,10,10,0.001,204,9
0.496,0.0001,154,150,10,10,0.001,304,9
0.496,0.0001,207,197,10,10,0.001,404,9
0.496,0.0001,259,245,10,10,0.001,504,9
0.494,0.0001,304,300,10,10,0.001,604,9
0.496,0.0001,349,355,10,10,0.001,704,9
0.494,0.0001,403,401,10,10,0.001,804,9
0.494,0.0001,458,446,10,10,0.001,904,9
0.494,0.0001,511,493,10,10,0.001,1004,9
0.504,0.0001,556,548,10,10,0.001,1104,9
0.506,0.0001,609,595,10,10,0.001,1204,9
0.498,0.0001,657,647,10,10,0.001,1304,9
0.494,0.0001,707,697,10,10,0.001,1404,9
0.492,0.0001,753,751,10,10,0.001,1504,9
0.496,0.0001,807,797,10,10,0.001,1604,9
0.498,0.0001,852,852,10,10,0.001,1704,9
0.502,0.0001,912,892,10,10,0.001,1804,9
0.518,0.0001,963,941,10,10,0.001,1904,9
0.532,0.0001,1005,999,10,10,0.001,2004,9
0.464,0.0001,62,42,10,10,0.001,104,10
0.462,0.0001,114,90,10,10,0.001,204,10
0.464,0.0001,165,139,10,10,0.001,304,10
0.47,0.0001,215,189,10,10,0.001,404,10
0.474,0.0001,268,236,10,10,0.001,504,10
0.472,0.0001,315,289,10,10,0.001,604,10
0.47,0.0001,363,341,10,10,0.001,704,10
0.472,0.0001,407,397,10,10,0.001,804,10
0.482,0.0001,466,438,10,10,0.001,904,10
0.494,0.0001,515,489,10,10,0.001,1004,10
0.492,0.0001,570,534,10,10,0.001,1104,10
0.494,0.0001,625,579,10,10,0.001,1204,10
0.502,0.0001,673,631,10,10,0.001,1304,10
0.512,0.0001,717,687,10,10,0.001,1404,10
0.512,0.0001,772,732,10,10,0.001,1504,10
0.52,0.0001,825,779,10,10,0.001,1604,10
0.524,0.0001,879,825,10,10,0.001,1704,10
0.53,0.0001,924,880,10,10,0.001,1804,10
0.536,0.0001,974,930,10,10,0.001,1904,10
0.552,0.0001,1025,979,10,10,0.001,2004,10
0.476,0.0001,47,57,10,10,0.001,104,11
0.476,0.0001,92,112,10,10,0.001,204,11
0.478,0.0001,131,173,10,10,0.001,304,11
0.474,0.0001,182,222,10,10,0.001,404,11
0.474,0.0001,229,275,10,10,0.001,504,11
0.472,0.0001,277,327,10,10,0.001,604,11
0.468,0.0001,328,376,10,10,0.001,704,11
0.474,0.0001,380,424,10,10,0.001,804,11
0.472,0.0001,433,471,10,10,0.001,904,11
0.468,0.0001,493,511,10,10,0.001,1004,11
0.464,0.0001,546,558,10,10,0.001,1104,11
0.462,0.0001,601,603,10,10,0.001,1204,11
0.47,0.0001,655,649,10,10,0.001,1304,11
0.478,0.0001,706,698,10,10,0.001,1404,11
0.496,0.0001,760,744,10,10,0.001,1504,11
0.502,0.0001,813,791,10,10,0.001,1604,11
0.508,0.0001,867,837,10,10,0.001,1704,11
0.512,0.0001,914,890,10,10,0.001,1804,11
0.52,0.0001,971,933,10,10,0.001,1904,11
0.524,0.0001,1020,984,10,10,0.001,2004,11
0.524,0.0001,54,50,10,10,0.001,104,12
0.526,0.0001,102,102,10,10,0.001,204,12
0.528,0.0001,151,153,10,10,0.001,304,12
0.53,0.0001,198,206,10,10,0.001,404,12
0.53,0.0001,248,256,10,10,0.001,504,12
0.534,0.0001,303,301,10,10,0.001,604,12
0.54,0.0001,349,355,10,10,0.001,704,12
0.544,0.0001,398,406,10,10,0.001,804,12
0.536,0.0001,443,461,10,10,0.001,904,12
0.538,0.0001,495,509,10,10,0.001,1004,12
0.546,0.0001,542,562,10,10,0.001,1104,12
0.546,0.0001,603,601,10,10,0.001,1204,12
0.554,0.0001,647,657,10,10,0.001,1304,12
0.552,0.0001,694,710,10,10,0.001,1404,12
0.554,0.0001,744,760,10,10,0.001,1504,12
0.56,0.0001,795,809,10,10,0.001,1604,12
0.568,0.0001,851,853,10,10,0.001,1704,12
0.574,0.0001,912,892,10,10,0.001,1804,12
0.576,0.0001,968,936,10,10,0.001,1904,12
0.588,0.0001,1015,989,10,10,0.001,2004,12
0.464,0.0001,56,48,10,10,0.001,104,13
0.466,0.0001,104,100,10,10,0.001,204,13
0.462,0.0001,157,147,10,10,0.001,304,13
0.466,0.0001,196,208,10,10,0.001,404,13
0.47,0.0001,244,260,10,10,0.001,504,13
0.474,0.0001,296,308,10,10,0.001,604,13
0.474,0.0001,349,355,10,10,0.001,704,13
0.482,0.0001,403,401,10,10,0.001,804,13
0.482,0.0001,457,447,10,10,0.001,904,13
0.482,0.0001,516,488,10,10,0.001,1004,13
0.488,0.0001,557,547,10,10,0.001,1104,13
0.486,0.0001,608,596,10,10,0.001,1204,13
0.488,0.0001,654,650,10,10,0.001,1304,13
0.49,0.0001,696,708,10,10,0.001,1404,13
0.504,0.0001,749,755,10,10,0.001,1504,13
0.512,0.0001,800,804,10,10,0.001,1604,13
0.532,0.0001,852,852,10,10,0.001,1704,13
0.54,0.0001,905,899,10,10,0.001,1804,13
0.542,0.0001,959,945,10,10,0.001,1904,13
0.556,0.0001,1007,997,10,10,0.001,2004,13
0.476,0.0001,49,55,10,10,0.001,104,14
0.476,0.0001,104,100,10,10,0.001,204,14
0.476,0.0001,152,152,10,10,0.001,304,14
0.48,0.0001,206,198,10,10,0.001,404,14
0.482,0.0001,259,245,10,10,0.001,504,14
0.488,0.0001,307,297,10,10,0.001,604,14
0.488,0.0001,361,343,10,10,0.001,704,14
0.488,0.0001,395,409,10,10,0.001,804,14
0.492,0.0001,444,460,10,10,0.001,904,14
0.494,0.0001,498,506,10,10,0.001,1004,14
0.498,0.0001,544,560,10,10,0.001,1104,14
0.496,0.0001,595,609,10,10,0.001,1204,14
0.5,0.0001,654,650,10,10,0.001,1304,14
0.5,0.0001,701,703,10,10,0.001,1404,14
0.5,0.0001,745,759,10,10,0.001,1504,14
0.506,0.0001,806,798,10,10,0.001,1604,14
0.506,0.0001,861,843,10,10,0.001,1704,14
0.514,0.0001,911,893,10,10,0.001,1804,14
0.516,0.0001,957,947,10,10,0.001,1904,14
0.526,0.0001,1004,1000,10,10,0.001,2004,14
0.52,0.0001,59,45,10,10,0.001,104,15
0.522,0.0001,103,101,10,10,0.001,204,15
0.518,0.0001,152,152,10,10,0.001,304,15
0.52,0.0001,196,208,10,10,0.001,404,15
0.53,0.0001,244,260,10,10,0.001,504,15
0.532,0.0001,294,310,10,10,0.001,604,15
0.534,0.0001,347,357,10,10,0.001,704,15
0.53,0.0001,391,413,10,10,0.001,804,15
0.532,0.0001,448,456,10,10,0.001,904,15
0.542,0.0001,497,507,10,10,0.001,1004,15
0.542,0.0001,544,560,10,10,0.001,1104,15
0.544,0.0001,598,606,10,10,0.001,1204,15
0.54,0.0001,646,658,10,10,0.001,1304,15
0.54,0.0001,696,708,10,10,0.001,1404,15
0.546,0.0001,745,759,10,10,0.001,1504,15
0.552,0.0001,794,810,10,10,0.001,1604,15
0.562,0.0001,847,857,10,10,0.001,1704,15
0.56,0.0001,895,909,10,10,0.001,1804,15
0.57,0.0001,944,960,10,10,0.001,1904,15
0.584,0.0001,1000,1004,10,10,0.001,2004,15
0.508,0.0001,51,53,10,10,0.001,104,16
0.506,0.0001,101,103,10,10,0.001,204,16
0.504,0.0001,154,150,10,10,0.001,304,16
0.512,0.0001,196,208,10,10,0.001,404,16
0.518,0.0001,245,259,10,10,0.001,504,16
0.526,0.0001,297,307,10,10,0.001,604,16
0.534,0.0001,358,346,10,10,0.001,704,16
0.538,0.0001,406,398,10,10,0.001,804,16
0.542,0.0001,461,443,10,10,0.001,904,16
0.542,0.0001,513,491,10,10,0.001,1004,16
0.544,0.0001,551,553,10,10,0.001,1104,16
0.552,0.0001,597,607,10,10,0.001,1204,16
0.554,0.0001,650,654,10,10,0.001,1304,16
0.56,0.0001,702,702,10,10,0.001,1404,16
0.56,0.0001,746,758,10,10,0.001,1504,16
0.568,0.0001,790,814,10,10,0.001,1604,16
0.578,0.0001,844,860,10,10,0.001,1704,16
0.582,0.0001,897,907,10,10,0.001,1804,16
0.584,0.0001,949,955,10,10,0.001,1904,16
0.598,0.0001,1002,1002,10,10,0.001,2004,16
0.512,0.0001,48,56,10,10,0.001,104,17
0.512,0.0001,100,104,10,10,0.001,204,17
0.516,0.0001,150,154,10,10,0.001,304,17
0.526,0.0001,193,211,10,10,0.001,404,17
0.53,0.0001,242,262,10,10,0.001,504,17
0.526,0.0001,290,314,10,10,0.001,604,17
0.518,0.0001,344,360,10,10,0.001,704,17
0.512,0.0001,392,412,10,10,0.001,804,17
0.524,0.0001,440,464,10,10,0.001,904,17
0.522,0.0001,489,515,10,10,0.001,1004,17
0.52,0.0001,530,574,10,10,0.001,1104,17
0.512,0.0001,577,627,10,10,0.001,1204,17
0.508,0.0001,635,669,10,10,0.001,1304,17
0.51,0.0001,682,722,10,10,0.001,1404,17
0.516,0.0001,732,772,10,10,0.001,1504,17
0.512,0.0001,785,819,10,10,0.001,1604,17
0.516,0.0001,826,878,10,10,0.001,1704,17
0.502,0.0001,880,924,10,10,0.001,1804,17
0.5,0.0001,925,979,10,10,0.001,1904,17
0.51,0.0001,972,1032,10,10,0.001,2004,17
0.454,0.0001,50,54,10,10,0.001,104,18
0.456,0.0001,104,100,10,10,0.001,204,18
0.458,0.0001,156,148,10,10,0.001,304,18
0.458,0.0001,213,191,10,10,0.001,404,18
0.458,0.0001,264,240,10,10,0.001,504,18
0.456,0.0001,314,290,10,10,0.001,604,18
0.46,0.0001,359,345,10,10,0.001,704,18
0.464,0.0001,405,399,10,10,0.001,804,18
0.46,0.0001,457,447,10,10,0.001,904,18
0.462,0.0001,495,509,10,10,0.001,1004,18
0.458,0.0001,537,567,10,10,0.001,1104,18
0.466,0.0001,592,612,10,10,0.001,1204,18
0.474,0.0001,639,665,10,10,0.001,1304,18
0.482,0.0001,691,713,10,10,0.001,1404,18
0.486,0.0001,748,756,10,10,0.001,1504,18
0.5,0.0001,796,808,10,10,0.001,1604,18
0.504,0.0001,848,856,10,10,0.001,1704,18
0.516,0.0001,896,908,10,10,0.001,1804,18
0.528,0.0001,946,958,10,10,0.001,1904,18
0.532,0.0001,1000,1004,10,10,0.001,2004,18
0.552,0.0001,57,47,10,10,0.001,104,19
0.554,0.0001,102,102,10,10,0.001,204,19
0.558,0.0001,149,155,10,10,0.001,304,19
0.558,0.0001,192,212,10,10,0.001,404,19
0.556,0.0001,241,263,10,10,0.001,504,19
0.556,0.0001,288,316,10,10,0.001,604,19
0.564,0.0001,330,374,10,10,0.001,704,19
0.566,0.0001,378,426,10,10,0.001,804,19
0.566,0.0001,429,475,10,10,0.001,904,19
0.574,0.0001,484,520,10,10,0.001,1004,19
0.576,0.0001,536,568,10,10,0.001,1104,19
0.58,0.0001,584,620,10,10,0.001,1204,19
0.584,0.0001,636,668,10,10,0.001,1304,19
0.592,0.0001,690,714,10,10,0.001,1404,19
0.592,0.0001,746,758,10,10,0.001,1504,19
0.6,0.0001,792,812,10,10,0.001,1604,19
0.606,0.0001,846,858,10,10,0.001,1704,19
0.606,0.0001,904,900,10,10,0.001,1804,19
0.614,0.0001,951,953,10,10,0.001,1904,19
0.62,0.0001,1002,1002,10,10,0.001,2004,19
0.478,0.0001,39,65,10,10,0.001,104,20
0.474,0.0001,94,110,10,10,0.001,204,20
0.476,0.0001,144,160,10,10,0.001,304,20
0.478,0.0001,199,205,10,10,0.001,404,20
0.482,0.0001,246,258,10,10,0.001,504,20
0.484,0.0001,295,309,10,10,0.001,604,20
0.482,0.0001,348,356,10,10,0.001,704,20
0.482,0.0001,409,395,10,10,0.001,804,20
0.482,0.0001,446,458,10,10,0.001,904,20
0.484,0.0001,494,510,10,10,0.001,1004,20
0.476,0.0001,541,563,10,10,0.001,1104,20
0.486,0.0001,590,614,10,10,0.001,1204,20
0.49,0.0001,645,659,10,10,0.001,1304,20
0.492,0.0001,693,711,10,10,0.001,1404,20
0.506,0.0001,740,764,10,10,0.001,1504,20
0.506,0.0001,790,814,10,10,0.001,1604,20
0.508,0.0001,845,859,10,10,0.001,1704,20
0.52,0.0001,901,903,10,10,0.001,1804,20
0.524,0.0001,956,948,10,10,0.001,1904,20
0.532,0.0001,1010,994,10,10,0.001,2004,20
0.404,0.0001,46,58,10,10,0.01,104,1
0.398,0.0001,103,101,10,10,0.01,204,1
0.408,0.0001,157,147,10,10,0.01,304,1
0.454,0.0001,207,197,10,10,0.01,404,1
0.472,0.0001,259,245,10,10,0.01,504,1
0.494,0.0001,311,293,10,10,0.01,604,1
0.524,0.0001,369,335,10,10,0.01,704,1
0.522,0.0001,416,388,10,10,0.01,804,1
0.516,0.0001,468,436,10,10,0.01,904,1
0.518,0.0001,517,487,10,10,0.01,1004,1
0.524,0.0001,565,539,10,10,0.01,1104,1
0.582,0.0001,608,596,10,10,0.01,1204,1
0.662,0.0001,663,641,10,10,0.01,1304,1
0.702,0.0001,715,689,10,10,0.01,1404,1
0.76,0.0001,771,733,10,10,0.01,1504,1
0.812,0.0001,827,777,10,10,0.01,1604,1
0.832,0.0001,883,821,10,10,0.01,1704,1
0.88,0.0001,929,875,10,10,0.01,1804,1
0.894,0.0001,978,926,10,10,0.01,1904,1
0.926,0.0001,1030,974,10,10,0.01,2004,1
0.5,0.0001,52,52,10,10,0.01,104,2
0.508,0.0001,107,97,10,10,0.01,204,2
0.524,0.0001,158,146,10,10,0.01,304,2
0.534,0.0001,206,198,10,10,0.01,404,2
0.522,0.0001,254,250,10,10,0.01,504,2
0.526,0.0001,304,300,10,10,0.01,604,2
0.546,0.0001,348,356,10,10,0.01,704,2
0.544,0.0001,402,402,10,10,0.01,804,2
0.578,0.0001,450,454,10,10,0.01,904,2
0.6,0.0001,505,499,10,10,0.01,1004,2
0.644,0.0001,564,540,10,10,0.01,1104,2
0.666,0.0001,603,601,10,10,0.01,1204,2
0.668,0.0001,653,651,10,10,0.01,1304,2
0.706,0.0001,708,696,10,10,0.01,1404,2
0.736,0.0001,766,738,10,10,0.01,1504,2
0.764,0.0001,814,790,10,10,0.01,1604,2
0.782,0.0001,856,848,10,10,0.01,1704,2
0.808,0.0001,904,900,10,10,0.01,1804,2
0.812,0.0001,956,948,10,10,0.01,1904,2
0.828,0.0001,994,1010,10,10,0.01,2004,2
0.538,0.0001,50,54,10,10,0.01,104,3
0.554,0.0001,97,107,10,10,0.01,204,3
0.57,0.0001,138,166,10,10,0.01,304,3
0.596,0.0001,186,218,10,10,0.01,404,3
0.622,0.0001,239,265,10,10,0.01,504,3
0.62,0.0001,287,317,10,10,0.01,604,3
0.622,0.0001,343,361,10,10,0.01,704,3
0.646,0.0001,397,407,10,10,0.01,804,3
0.658,0.0001,456,448,10,10,0.01,904,3
0.66,0.0001,502,502,10,10,0.01,1004,3
0.696,0.0001,545,559,10,10,0.01,1104,3
0.738,0.0001,596,608,10,10,0.01,1204,3
0.786,0.0001,653,651,10,10,0.01,1304,3
0.838,0.0001,705,699,10,10,0.01,1404,3
0.864,0.0001,759,745,10,10,0.01,1504,3
0.892,0.0001,802,802,10,10,0.01,1604,3
0.932,0.0001,849,855,10,10,0.01,1704,3
0.94,0.0001,897,907,10,10,0.01,1804,3
0.95,0.0001,957,947,10,10,0.01,1904,3
0.958,0.0001,1008,996,10,10,0.01,2004,3
0.506,0.0001,56,48,10,10,0.01,104,4
0.528,0.0001,108,96,10,10,0.01,204,4
0.546,0.0001,159,145,10,10,0.01,304,4
0.542,0.0001,208,196,10,10,0.01,404,4
0.56,0.0001,263,241,10,10,0.01,504,4
0.624,0.0001,307,297,10,10,0.01,604,4
0.652,0.0001,369,335,10,10,0.01,704,4
0.662,0.0001,421,383,10,10,0.01,804,4
0.666,0.0001,473,431,10,10,0.01,904,4
0.726,0.0001,530,474,10,10,0.01,1004,4
0.786,0.0001,578,526,10,10,0.01,1104,4
0.846,0.0001,628,576,10,10,0.01,1204,4
0.878,0.0001,666,638,10,10,0.01,1304,4
0.898,0.0001,711,693,10,10,0.01,1404,4
0.918,0.0001,751,753,10,10,0.01,1504,4
0.938,0.0001,796,808,10,10,0.01,1604,4
0.94,0.0001,843,861,10,10,0.01,1704,4
0.95,0.0001,895,909,10,10,0.01,1804,4
0.958,0.0001,945,959,10,10,0.01,1904,4
0.956,0.0001,992,1012,10,10,0.01,2004,4
0.5,0.0001,54,50,10,10,0.01,104,5
0.51,0.0001,92,112,10,10,0.01,204,5
0.526,0.0001,136,168,10,10,0.01,304,5
0.526,0.0001,191,213,10,10,0.01,404,5
0.54,0.0001,242,262,10,10,0.01,504,5
0.568,0.0001,289,315,10,10,0.01,604,5
0.612,0.0001,331,373,10,10,0.01,704,5
0.634,0.0001,380,424,10,10,0.01,804,5
0.654,0.0001,430,474,10,10,0.01,904,5
0.658,0.0001,483,521,10,10,0.01,1004,5
0.672,0.0001,526,578,10,10,0.01,1104,5
0.682,0.0001,580,624,10,10,0.01,1204,5
0.698,0.0001,628,676,10,10,0.01,1304,5
0.712,0.0001,686,718,10,10,0.01,1404,5
0.746,0.0001,735,769,10,10,0.01,1504,5
0.792,0.0001,787,817,10,10,0.01,1604,5
0.818,0.0001,835,869,10,10,0.01,1704,5
0.828,0.0001,891,913,10,10,0.01,1804,5
0.844,0.0001,943,961,10,10,0.01,1904,5
0.862,0.0001,993,1011,10,10,0.01,2004,5
0.494,0.0001,53,51,10,10,0.01,104,6
0.51,0.0001,101,103,10,10,0.01,204,6
0.522,0.0001,144,160,10,10,0.01,304,6
0.566,0.0001,198,206,10,10,0.01,404,6
0.612,0.0001,257,247,10,10,0.01,504,6
0.618,0.0001,314,290,10,10,0.01,604,6
0.638,0.0001,359,345,10,10,0.01,704,6
0.664,0.0001,415,389,10,10,0.01,804,6
0.684,0.0001,460,444,10,10,0.01,904,6
0.702,0.0001,512,492,10,10,0.01,1004,6
0.73,0.0001,563,541,10,10,0.01,1104,6
0.756,0.0001,615,589,10,10,0.01,1204,6
0.774,0.0001,665,639,10,10,0.01,1304,6
0.798,0.0001,714,690,10,10,0.01,1404,6
0.82,0.0001,757,747,10,10,0.01,1504,6
0.85,0.0001,801,803,10,10,0.01,1604,6
0.876,0.0001,857,847,10,10,0.01,1704,6
0.9,0.0001,905,899,10,10,0.01,1804,6
0.916,0.0001,962,942,10,10,0.01,1904,6
0.928,0.0001,1007,997,10,10,0.01,2004,6
0.474,0.0001,50,54,10,10,0.01,104,7
0.498,0.0001,105,99,10,10,0.01,204,7
0.516,0.0001,158,146,10,10,0.01,304,7
0.518,0.0001,205,199,10,10,0.01,404,7
0.532,0.0001,252,252,10,10,0.01,504,7
0.568,0.0001,300,304,10,10,0.01,604,7
0.622,0.0001,355,349,10,10,0.01,704,7
0.682,0.0001,401,403,10,10,0.01,804,7
0.744,0.0001,455,449,10,10,0.01,904,7
0.808,0.0001,512,492,10,10,0.01,1004,7
0.85,0.0001,567,537,10,10,0.01,1104,7
0.866,0.0001,628,576,10,10,0.01,1204,7
0.882,0.0001,674,630,10,10,0.01,1304,7
0.906,0.0001,720,684,10,10,0.01,1404,7
0.926,0.0001,773,731,10,10,0.01,1504,7
0.936,0.0001,824,780,10,10,0.01,1604,7
0.94,0.0001,875,829,10,10,0.01,1704,7
0.948,0.0001,924,880,10,10,0.01,1804,7
0.95,0.0001,968,936,10,10,0.01,1904,7
0.954,0.0001,1015,989,10,10,0.01,2004,7
0.472,0.0001,55,49,10,10,0.01,104,8
0.492,0.0001,105,99,10,10,0.01,204,8
0.51,0.0001,157,147,10,10,0.01,304,8
0.552,0.0001,211,193,10,10,0.01,404,8
0.568,0.0001,262,242,10,10,0.01,504,8
0.582,0.0001,313,291,10,10,0.01,604,8
0.606,0.0001,359,345,10,10,0.01,704,8
0.644,0.0001,402,402,10,10,0.01,804,8
0.672,0.0001,451,453,10,10,0.01,904,8
0.698,0.0001,497,507,10,10,0.01,1004,8
0.712,0.0001,545,559,10,10,0.01,1104,8
0.748,0.0001,601,603,10,10,0.01,1204,8
0.768,0.0001,655,649,10,10,0.01,1304,8
0.814,0.0001,706,698,10,10,0.01,1404,8
0.834,0.0001,756,748,10,10,0.01,1504,8
0.876,0.0001,801,803,10,10,0.01,1604,8
0.886,0.0001,852,852,10,10,0.01,1704,8
0.9,0.0001,905,899,10,10,0.01,1804,8
0.912,0.0001,958,946,10,10,0.01,1904,8
0.906,0.0001,1010,994,10,10,0.01,2004,8
0.538,0.0001,58,46,10,10,0.01,104,9
0.552,0.0001,104,100,10,10,0.01,204,9
0.564,0.0001,149,155,10,10,0.01,304,9
0.574,0.0001,204,200,10,10,0.01,404,9
0.59,0.0001,260,244,10,10,0.01,504,9
0.618,0.0001,311,293,10,10,0.01,604,9
0.622,0.0001,365,339,10,10,0.01,704,9
0.644,0.0001,413,391,10,10,0.01,804,9
0.666,0.0001,466,438,10,10,0.01,904,9
0.708,0.0001,527,477,10,10,0.01,1004,9
0.738,0.0001,572,532,10,10,0.01,1104,9
0.758,0.0001,622,582,10,10,0.01,1204,9
0.794,0.0001,664,640,10,10,0.01,1304,9
0.846,0.0001,710,694,10,10,0.01,1404,9
0.874,0.0001,754,750,10,10,0.01,1504,9
0.882,0.0001,802,802,10,10,0.01,1604,9
0.898,0.0001,854,850,10,10,0.01,1704,9
0.92,0.0001,902,902,10,10,0.01,1804,9
0.932,0.0001,962,942,10,10,0.01,1904,9
0.946,0.0001,1013,991,10,10,0.01,2004,9
0.534,0.0001,49,55,10,10,0.01,104,10
0.534,0.0001,99,105,10,10,0.01,204,10
0.536,0.0001,159,145,10,10,0.01,304,10
0.54,0.0001,207,197,10,10,0.01,404,10
0.554,0.0001,251,253,10,10,0.01,504,10
0.584,0.0001,299,305,10,10,0.01,604,10
0.614,0.0001,351,353,10,10,0.01,704,10
0.62,0.0001,408,396,10,10,0.01,804,10
0.642,0.0001,463,441,10,10,0.01,904,10
0.636,0.0001,511,493,10,10,0.01,1004,10
0.664,0.0001,562,542,10,10,0.01,1104,10
0.7,0.0001,614,590,10,10,0.01,1204,10
0.732,0.0001,667,637,10,10,0.01,1304,10
0.752,0.0001,710,694,10,10,0.01,1404,10
0.77,0.0001,765,739,10,10,0.01,1504,10
0.808,0.0001,816,788,10,10,0.01,1604,10
0.824,0.0001,873,831,10,10,0.01,1704,10
0.838,0.0001,917,887,10,10,0.01,1804,10
0.858,0.0001,965,939,10,10,0.01,1904,10
0.892,0.0001,1019,985,10,10,0.01,2004,10
0.528,0.0001,60,44,10,10,0.01,104,11
0.526,0.0001,102,102,10,10,0.01,204,11
0.54,0.0001,149,155,10,10,0.01,304,11
0.554,0.0001,205,199,10,10,0.01,404,11
0.56,0.0001,251,253,10,10,0.01,504,11
0.576,0.0001,299,305,10,10,0.01,604,11
0.588,0.0001,355,349,10,10,0.01,704,11
0.584,0.0001,404,400,10,10,0.01,804,11
0.594,0.0001,448,456,10,10,0.01,904,11
0.618,0.0001,492,512,10,10,0.01,1004,11
0.66,0.0001,539,565,10,10,0.01,1104,11
0.694,0.0001,581,623,10,10,0.01,1204,11
0.74,0.0001,639,665,10,10,0.01,1304,11
0.78,0.0001,693,711,10,10,0.01,1404,11
0.796,0.0001,745,759,10,10,0.01,1504,11
0.834,0.0001,792,812,10,10,0.01,1604,11
0.88,0.0001,849,855,10,10,0.01,1704,11
0.92,0.0001,903,901,10,10,0.01,1804,11
0.93,0.0001,946,958,10,10,0.01,1904,11
0.954,0.0001,992,1012,10,10,0.01,2004,11
0.51,0.0001,41,63,10,10,0.01,104,12
0.532,0.0001,85,119,10,10,0.01,204,12
0.538,0.0001,135,169,10,10,0.01,304,12
0.58,0.0001,187,217,10,10,0.01,404,12
0.588,0.0001,236,268,10,10,0.01,504,12
0.602,0.0001,287,317,10,10,0.01,604,12
0.648,0.0001,350,354,10,10,0.01,704,12
0.67,0.0001,398,406,10,10,0.01,804,12
0.7,0.0001,446,458,10,10,0.01,904,12
0.756,0.0001,492,512,10,10,0.01,1004,12
0.778,0.0001,536,568,10,10,0.01,1104,12
0.8,0.0001,581,623,10,10,0.01,1204,12
0.82,0.0001,636,668,10,10,0.01,1304,12
0.842,0.0001,684,720,10,10,0.01,1404,12
0.848,0.0001,733,771,10,10,0.01,1504,12
0.88,0.0001,790,814,10,10,0.01,1604,12
0.896,0.0001,831,873,10,10,0.01,1704,12
0.904,0.0001,885,919,10,10,0.01,1804,12
0.908,0.0001,933,971,10,10,0.01,1904,12
0.914,0.0001,987,1017,10,10,0.01,2004,12
0.494,0.0001,59,45,10,10,0.01,104,13
0.5,0.0001,103,101,10,10,0.01,204,13
0.542,0.0001,150,154,10,10,0.01,304,13
0.566,0.0001,203,201,10,10,0.01,404,13
0.574,0.0001,254,250,10,10,0.01,504,13
0.61,0.0001,302,302,10,10,0.01,604,13
0.634,0.0001,351,353,10,10,0.01,704,13
0.68,0.0001,406,398,10,10,0.01,804,13
0.71,0.0001,457,447,10,10,0.01,904,13
0.774,0.0001,510,494,10,10,0.01,1004,13
0.806,0.0001,546,558,10,10,0.01,1104,13
0.848,0.0001,598,606,10,10,0.01,1204,13
0.876,0.0001,648,656,10,10,0.01,1304,13
0.914,0.0001,696,708,10,10,0.01,1404,13
0.938,0.0001,754,750,10,10,0.01,1504,13
0.94,0.0001,803,801,10,10,0.01,1604,13
0.942,0.0001,851,853,10,10,0.01,1704,13
0.952,0.0001,905,899,10,10,0.01,1804,13
0.956,0.0001,956,948,10,10,0.01,1904,13
0.96,0.0001,1006,998,10,10,0.01,2004,13
0.506,0.0001,51,53,10,10,0.01,104,14
0.506,0.0001,105,99,10,10,0.01,204,14
0.506,0.0001,161,143,10,10,0.01,304,14
0.508,0.0001,208,196,10,10,0.01,404,14
0.522,0.0001,267,237,10,10,0.01,504,14
0.542,0.0001,315,289,10,10,0.01,604,14
0.578,0.0001,354,350,10,10,0.01,704,14
0.63,0.0001,397,407,10,10,0.01,804,14
0.676,0.0001,429,475,10,10,0.01,904,14
0.686,0.0001,474,530,10,10,0.01,1004,14
0.702,0.0001,528,576,10,10,0.01,1104,14
0.75,0.0001,586,618,10,10,0.01,1204,14
0.776,0.0001,635,669,10,10,0.01,1304,14
0.834,0.0001,694,710,10,10,0.01,1404,14
0.862,0.0001,745,759,10,10,0.01,1504,14
0.88,0.0001,788,816,10,10,0.01,1604,14
0.894,0.0001,836,868,10,10,0.01,1704,14
0.902,0.0001,884,920,10,10,0.01,1804,14
0.912,0.0001,945,959,10,10,0.01,1904,14
0.92,0.0001,999,1005,10,10,0.01,2004,14
0.522,0.0001,49,55,10,10,0.01,104,15
0.522,0.0001,105,99,10,10,0.01,204,15
0.544,0.0001,164,140,10,10,0.01,304,15
0.564,0.0001,212,192,10,10,0.01,404,15
0.584,0.0001,259,245,10,10,0.01,504,15
0.598,0.0001,304,300,10,10,0.01,604,15
0.6,0.0001,351,353,10,10,0.01,704,15
0.616,0.0001,406,398,10,10,0.01,804,15
0.66,0.0001,463,441,10,10,0.01,904,15
0.706,0.0001,512,492,10,10,0.01,1004,15
0.722,0.0001,566,538,10,10,0.01,1104,15
0.772,0.0001,613,591,10,10,0.01,1204,15
0.802,0.0001,661,643,10,10,0.01,1304,15
0.828,0.0001,711,693,10,10,0.01,1404,15
0.872,0.0001,762,742,10,10,0.01,1504,15
0.922,0.0001,806,798,10,10,0.01,1604,15
0.936,0.0001,862,842,10,10,0.01,1704,15
0.944,0.0001,909,895,10,10,0.01,1804,15
0.946,0.0001,956,948,10,10,0.01,1904,15
0.954,0.0001,1002,1002,10,10,0.01,2004,15
0.502,0.0001,55,49,10,10,0.01,104,16
0.49,0.0001,97,107,10,10,0.01,204,16
0.486,0.0001,149,155,10,10,0.01,304,16
0.486,0.0001,202,202,10,10,0.01,404,16
0.49,0.0001,251,253,10,10,0.01,504,16
0.502,0.0001,305,299,10,10,0.01,604,16
0.53,0.0001,347,357,10,10,0.01,704,16
0.554,0.0001,395,409,10,10,0.01,804,16
0.562,0.0001,446,458,10,10,0.01,904,16
0.592,0.0001,499,505,10,10,0.01,1004,16
0.626,0.0001,551,553,10,10,0.01,1104,16
0.684,0.0001,607,597,10,10,0.01,1204,16
0.724,0.0001,653,651,10,10,0.01,1304,16
0.818,0.0001,696,708,10,10,0.01,1404,16
0.848,0.0001,744,760,10,10,0.01,1504,16
0.87,0.0001,798,806,10,10,0.01,1604,16
0.882,0.0001,843,861,10,10,0.01,1704,16
0.912,0.0001,890,914,10,10,0.01,1804,16
0.934,0.0001,941,963,10,10,0.01,1904,16
0.938,0.0001,989,1015,10,10,0.01,2004,16
0.49,0.0001,42,62,10,10,0.01,104,17
0.494,0.0001,87,117,10,10,0.01,204,17
0.51,0.0001,134,170,10,10,0.01,304,17
0.532,0.0001,192,212,10,10,0.01,404,17
0.556,0.0001,252,252,10,10,0.01,504,17
0.586,0.0001,304,300,10,10,0.01,604,17
0.604,0.0001,365,339,10,10,0.01,704,17
0.634,0.0001,415,389,10,10,0.01,804,17
0.704,0.0001,465,439,10,10,0.01,904,17
0.766,0.0001,511,493,10,10,0.01,1004,17
0.782,0.0001,557,547,10,10,0.01,1104,17
0.848,0.0001,603,601,10,10,0.01,1204,17
0.888,0.0001,653,651,10,10,0.01,1304,17
0.918,0.0001,699,705,10,10,0.01,1404,17
0.926,0.0001,741,763,10,10,0.01,1504,17
0.946,0.0001,789,815,10,10,0.01,1604,17
0.954,0.0001,838,866,10,10,0.01,1704,17
0.958,0.0001,890,914,10,10,0.01,1804,17
0.954,0.0001,939,965,10,10,0.01,1904,17
0.962,0.0001,999,1005,10,10,0.01,2004,17
0.466,0.0001,43,61,10,10,0.01,104,18
0.486,0.0001,94,110,10,10,0.01,204,18
0.488,0.0001,145,159,10,10,0.01,304,18
0.496,0.0001,188,216,10,10,0.01,404,18
0.518,0.0001,232,272,10,10,0.01,504,18
0.602,0.0001,280,324,10,10,0.01,604,18
0.64,0.0001,332,372,10,10,0.01,704,18
0.624,0.0001,383,421,10,10,0.01,804,18
0.64,0.0001,432,472,10,10,0.01,904,18
0.662,0.0001,489,515,10,10,0.01,1004,18
0.7,0.0001,539,565,10,10,0.01,1104,18
0.746,0.0001,586,618,10,10,0.01,1204,18
0.8,0.0001,636,668,10,10,0.01,1304,18
0.836,0.0001,689,715,10,10,0.01,1404,18
0.862,0.0001,747,757,10,10,0.01,1504,18
0.882,0.0001,800,804,10,10,0.01,1604,18
0.898,0.0001,856,848,10,10,0.01,1704,18
0.932,0.0001,912,892,10,10,0.01,1804,18
0.954,0.0001,956,948,10,10,0.01,1904,18
0.964,0.0001,999,1005,10,10,0.01,2004,18
0.528,0.0001,53,51,10,10,0.01,104,19
0.53,0.0001,101,103,10,10,0.01,204,19
0.534,0.0001,146,158,10,10,0.01,304,19
0.548,0.0001,200,204,10,10,0.01,404,19
0.582,0.0001,260,244,10,10,0.01,504,19
0.638,0.0001,314,290,10,10,0.01,604,19
0.68,0.0001,357,347,10,10,0.01,704,19
0.696,0.0001,413,391,10,10,0.01,804,19
0.722,0.0001,467,437,10,10,0.01,904,19
0.752,0.0001,521,483,10,10,0.01,1004,19
0.802,0.0001,574,530,10,10,0.01,1104,19
0.878,0.0001,621,583,10,10,0.01,1204,19
0.894,0.0001,675,629,10,10,0.01,1304,19
0.906,0.0001,725,679,10,10,0.01,1404,19
0.906,0.0001,779,725,10,10,0.01,1504,19
0.906,0.0001,823,781,10,10,0.01,1604,19
0.918,0.0001,872,832,10,10,0.01,1704,19
0.924,0.0001,915,889,10,10,0.01,1804,19
0.932,0.0001,967,937,10,10,0.01,1904,19
0.938,0.0001,1015,989,10,10,0.01,2004,19
0.504,0.0001,68,36,10,10,0.01,104,20
0.502,0.0001,118,86,10,10,0.01,204,20
0.522,0.0001,162,142,10,10,0.01,304,20
0.546,0.0001,212,192,10,10,0.01,404,20
0.57,0.0001,261,243,10,10,0.01,504,20
0.562,0.0001,314,290,10,10,0.01,604,20
0.59,0.0001,373,331,10,10,0.01,704,20
0.624,0.0001,422,382,10,10,0.01,804,20
0.646,0.0001,472,432,10,10,0.01,904,20
0.674,0.0001,511,493,10,10,0.01,1004,20
0.684,0.0001,569,535,10,10,0.01,1104,20
0.738,0.0001,617,587,10,10,0.01,1204,20
0.798,0.0001,671,633,10,10,0.01,1304,20
0.86,0.0001,729,675,10,10,0.01,1404,20
0.892,0.0001,778,726,10,10,0.01,1504,20
0.914,0.0001,823,781,10,10,0.01,1604,20
0.918,0.0001,869,835,10,10,0.01,1704,20
0.938,0.0001,914,890,10,10,0.01,1804,20
0.948,0.0001,959,945,10,10,0.01,1904,20
0.956,0.0001,1011,993,10,10,0.01,2004,20
0.478,0.001,56,48,10,10,0.0001,104,1
0.48,0.001,113,91,10,10,0.0001,204,1
0.48,0.001,160,144,10,10,0.0001,304,1
0.482,0.001,207,197,10,10,0.0001,404,1
0.482,0.001,261,243,10,10,0.0001,504,1
0.482,0.001,303,301,10,10,0.0001,604,1
0.482,0.001,358,346,10,10,0.0001,704,1
0.482,0.001,412,392,10,10,0.0001,804,1
0.482,0.001,462,442,10,10,0.0001,904,1
0.482,0.001,510,494,10,10,0.0001,1004,1
0.482,0.001,566,538,10,10,0.0001,1104,1
0.48,0.001,615,589,10,10,0.0001,1204,1
0.478,0.001,672,632,10,10,0.0001,1304,1
0.478,0.001,720,684,10,10,0.0001,1404,1
0.476,0.001,764,740,10,10,0.0001,1504,1
0.476,0.001,805,799,10,10,0.0001,1604,1
0.476,0.001,860,844,10,10,0.0001,1704,1
0.476,0.001,905,899,10,10,0.0001,1804,1
0.476,0.001,956,948,10,10,0.0001,1904,1
0.476,0.001,1005,999,10,10,0.0001,2004,1
0.512,0.001,55,49,10,10,0.0001,104,2
0.512,0.001,106,98,10,10,0.0001,204,2
0.512,0.001,144,160,10,10,0.0001,304,2
0.512,0.001,202,202,10,10,0.0001,404,2
0.512,0.001,252,252,10,10,0.0001,504,2
0.514,0.001,303,301,10,10,0.0001,604,2
0.516,0.001,353,351,10,10,0.0001,704,2
0.516,0.001,392,412,10,10,0.0001,804,2
0.516,0.001,442,462,10,10,0.0001,904,2
0.518,0.001,494,510,10,10,0.0001,1004,2
0.518,0.001,545,559,10,10,0.0001,1104,2
0.518,0.001,595,609,10,10,0.0001,1204,2
0.518,0.001,650,654,10,10,0.0001,1304,2
0.518,0.001,708,696,10,10,0.0001,1404,2
0.518,0.001,755,749,10,10,0.0001,1504,2
0.518,0.001,804,800,10,10,0.0001,1604,2
0.518,0.001,851,853,10,10,0.0001,1704,2
0.52,0.001,903,901,10,10,0.0001,1804,2
0.522,0.001,961,943,10,10,0.0001,1904,2
0.522,0.001,1004,1000,10,10,0.0001,2004,2
0.498,0.001,59,45,10,10,0.0001,104,3
0.498,0.001,105,99,10,10,0.0001,204,3
0.498,0.001,150,154,10,10,0.0001,304,3
0.498,0.001,203,201,10,10,0.0001,404,3
0.498,0.001,254,250,10,10,0.0001,504,3
0.498,0.001,311,293,10,10,0.0001,604,3
0.5,0.001,362,342,10,10,0.0001,704,3
0.5,0.001,403,401,10,10,0.0001,804,3
0.5,0.001,462,442,10,10,0.0001,904,3
0.5,0.001,514,490,10,10,0.0001,1004,3
0.498,0.001,562,542,10,10,0.0001,1104,3
0.498,0.001,611,593,10,10,0.0001,1204,3
0.498,0.001,658,646,10,10,0.0001,1304,3
0.498,0.001,704,700,10,10,0.0001,1404,3
0.498,0.001,748,756,10,10,0.0001,1504,3
0.5,0.001,790,814,10,10,0.0001,1604,3
0.502,0.001,832,872,10,10,0.0001,1704,3
0.504,0.001,883,921,10,10,0.0001,1804,3
0.506,0.001,932,972,10,10,0.0001,1904,3
0.506,0.001,988,1016,10,10,0.0001,2004,3
0.474,0.001,44,60,10,10,0.0001,104,4
0.474,0.001,97,107,10,10,0.0001,204,4
0.474,0.001,148,156,10,10,0.0001,304,4
0.474,0.001,195,209,10,10,0.0001,404,4
0.474,0.001,244,260,10,10,0.0001,504,4
0.474,0.001,295,309,10,10,0.0001,604,4
0.474,0.001,342,362,10,10,0.0001,704,4
0.474,0.001,390,414,10,10,0.0001,804,4
0.474,0.001,434,470,10,10,0.0001,904,4
0.474,0.001,482,522,10,10,0.0001,1004,4
0.474,0.001,532,572,10,10,0.0001,1104,4
0.476,0.001,581,623,10,10,0.0001,1204,4
0.478,0.001,637,667,10,10,0.0001,1304,4
0.478,0.001,689,715,10,10,0.0001,1404,4
0.478,0.001,748,756,10,10,0.0001,1504,4
0.478,0.001,793,811,10,10,0.0001,1604,4
0.476,0.001,845,859,10,10,0.0001,1704,4
0.476,0.001,901,903,10,10,0.0001,1804,4
0.476,0.001,954,950,10,10,0.0001,1904,4
0.476,0.001,1001,1003,10,10,0.0001,2004,4
0.494,0.001,58,46,10,10,0.0001,104,5
0.494,0.001,108,96,10,10,0.0001,204,5
0.494,0.001,164,140,10,10,0.0001,304,5
0.494,0.001,212,192,10,10,0.0001,404,5
0.494,0.001,269,235,10,10,0.0001,504,5
0.494,0.001,321,283,10,10,0.0001,604,5
0.494,0.001,368,336,10,10,0.0001,704,5
0.494,0.001,419,385,10,10,0.0001,804,5
0.494,0.001,472,432,10,10,0.0001,904,5
0.494,0.001,522,482,10,10,0.0001,1004,5
0.494,0.001,572,532,10,10,0.0001,1104,5
0.496,0.001,625,579,10,10,0.0001,1204,5
0.496,0.001,674,630,10,10,0.0001,1304,5
0.494,0.001,723,681,10,10,0.0001,1404,5
0.496,0.001,769,735,10,10,0.0001,1504,5
0.496,0.001,821,783,10,10,0.0001,1604,5
0.492,0.001,868,836,10,10,0.0001,1704,5
0.492,0.001,915,889,10,10,0.0001,1804,5
0.492,0.001,963,941,10,10,0.0001,1904,5
0.492,0.001,1016,988,10,10,0.0001,2004,5
0.434,0.001,56,48,10,10,0.0001,104,6
0.434,0.001,103,101,10,10,0.0001,204,6
0.434,0.001,150,154,10,10,0.0001,304,6
0.434,0.001,196,208,10,10,0.0001,404,6
0.434,0.001,253,251,10,10,0.0001,504,6
0.434,0.001,304,300,10,10,0.0001,604,6
0.434,0.001,358,346,10,10,0.0001,704,6
0.434,0.001,401,403,10,10,0.0001,804,6
0.434,0.001,445,459,10,10,0.0001,904,6
0.438,0.001,497,507,10,10,0.0001,1004,6
0.438,0.001,552,552,10,10,0.0001,1104,6
0.438,0.001,609,595,10,10,0.0001,1204,6
0.438,0.001,659,645,10,10,0.0001,1304,6
0.438,0.001,703,701,10,10,0.0001,1404,6
0.438,0.001,757,747,10,10,0.0001,1504,6
0.438,0.001,809,795,10,10,0.0001,1604,6
0.44,0.001,856,848,10,10,0.0001,1704,6
0.44,0.001,907,897,10,10,0.0001,1804,6
0.44,0.001,960,944,10,10,0.0001,1904,6
0.44,0.001,1010,994,10,10,0.0001,2004,6
0.474,0.001,53,51,10,10,0.0001,104,7
0.474,0.001,100,104,10,10,0.0001,204,7
0.474,0.001,151,153,10,10,0.0001,304,7
0.474,0.001,204,200,10,10,0.0001,404,7
0.474,0.001,252,252,10,10,0.0001,504,7
0.478,0.001,300,304,10,10,0.0001,604,7
0.478,0.001,350,354,10,10,0.0001,704,7
0.478,0.001,403,401,10,10,0.0001,804,7
0.478,0.001,452,452,10,10,0.0001,904,7
0.48,0.001,505,499,10,10,0.0001,1004,7
0.48,0.001,556,548,10,10,0.0001,1104,7
0.48,0.001,611,593,10,10,0.0001,1204,7
0.48,0.001,664,640,10,10,0.0001,1304,7
0.482,0.001,712,692,10,10,0.0001,1404,7
0.482,0.001,758,746,10,10,0.0001,1504,7
0.482,0.001,801,803,10,10,0.0001,1604,7
0.48,0.001,849,855,10,10,0.0001,1704,7
0.48,0.001,897,907,10,10,0.0001,1804,7
0.482,0.001,948,956,10,10,0.0001,1904,7
0.484,0.001,1002,1002,10,10,0.0001,2004,7
0.472,0.001,52,52,10,10,0.0001,104,8
0.47,0.001,100,104,10,10,0.0001,204,8
0.47,0.001,156,148,10,10,0.0001,304,8
0.472,0.001,201,203,10,10,0.0001,404,8
0.472,0.001,247,257,10,10,0.0001,504,8
0.47,0.001,297,307,10,10,0.0001,604,8
0.47,0.001,351,353,10,10,0.0001,704,8
0.47,0.001,398,406,10,10,0.0001,804,8
0.472,0.001,442,462,10,10,0.0001,904,8
0.474,0.001,482,522,10,10,0.0001,1004,8
0.472,0.001,531,573,10,10,0.0001,1104,8
0.478,0.001,579,625,10,10,0.0001,1204,8
0.476,0.001,635,669,10,10,0.0001,1304,8
0.476,0.001,684,720,10,10,0.0001,1404,8
0.48,0.001,742,762,10,10,0.0001,1504,8
0.478,0.001,795,809,10,10,0.0001,1604,8
0.478,0.001,849,855,10,10,0.0001,1704,8
0.478,0.001,905,899,10,10,0.0001,1804,8
0.478,0.001,956,948,10,10,0.0001,1904,8
0.476,0.001,1016,988,10,10,0.0001,2004,8
0.516,0.001,53,51,10,10,0.0001,104,9
0.516,0.001,95,109,10,10,0.0001,204,9
0.514,0.001,143,161,10,10,0.0001,304,9
0.514,0.001,187,217,10,10,0.0001,404,9
0.516,0.001,228,276,10,10,0.0001,504,9
0.516,0.001,273,331,10,10,0.0001,604,9
0.516,0.001,321,383,10,10,0.0001,704,9
0.516,0.001,377,427,10,10,0.0001,804,9
0.516,0.001,429,475,10,10,0.0001,904,9
0.518,0.001,479,525,10,10,0.0001,1004,9
0.518,0.001,524,580,10,10,0.0001,1104,9
0.522,0.001,585,619,10,10,0.0001,1204,9
0.522,0.001,632,672,10,10,0.0001,1304,9
0.52,0.001,683,721,10,10,0.0001,1404,9
0.522,0.001,733,771,10,10,0.0001,1504,9
0.522,0.001,782,822,10,10,0.0001,1604,9
0.524,0.001,841,863,10,10,0.0001,1704,9
0.524,0.001,895,909,10,10,0.0001,1804,9
0.522,0.001,945,959,10,10,0.0001,1904,9
0.522,0.001,989,1015,10,10,0.0001,2004,9
0.5,0.001,55,49,10,10,0.0001,104,10
0.5,0.001,103,101,10,10,0.0001,204,10
0.5,0.001,150,154,10,10,0.0001,304,10
0.5,0.001,205,199,10,10,0.0001,404,10
0.5,0.001,255,249,10,10,0.0001,504,10
0.5,0.001,302,302,10,10,0.0001,604,10
0.5,0.001,356,348,10,10,0.0001,704,10
0.5,0.001,406,398,10,10,0.0001,804,10
0.5,0.001,456,448,10,10,0.0001,904,10
0.5,0.001,509,495,10,10,0.0001,1004,10
0.5,0.001,558,546,10,10,0.0001,1104,10
0.5,0.001,611,593,10,10,0.0001,1204,10
0.5,0.001,656,648,10,10,0.0001,1304,10
0.5,0.001,698,706,10,10,0.0001,1404,10
0.5,0.001,749,755,10,10,0.0001,1504,10
0.5,0.001,793,811,10,10,0.0001,1604,10
0.5,0.001,845,859,10,10,0.0001,1704,10
0.5,0.001,896,908,10,10,0.0001,1804,10
0.5,0.001,947,957,10,10,0.0001,1904,10
0.5,0.001,1002,1002,10,10,0.0001,2004,10
0.47,0.001,53,51,10,10,0.0001,104,11
0.47,0.001,108,96,10,10,0.0001,204,11
0.47,0.001,156,148,10,10,0.0001,304,11
0.47,0.001,195,209,10,10,0.0001,404,11
0.47,0.001,239,265,10,10,0.0001,504,11
0.468,0.001,293,311,10,10,0.0001,604,11
0.468,0.001,340,364,10,10,0.0001,704,11
0.468,0.001,392,412,10,10,0.0001,804,11
0.468,0.001,443,461,10,10,0.0001,904,11
0.468,0.001,496,508,10,10,0.0001,1004,11
0.47,0.001,551,553,10,10,0.0001,1104,11
0.468,0.001,600,604,10,10,0.0001,1204,11
0.47,0.001,656,648,10,10,0.0001,1304,11
0.47,0.001,709,695,10,10,0.0001,1404,11
0.47,0.001,758,746,10,10,0.0001,1504,11
0.468,0.001,809,795,10,10,0.0001,1604,11
0.468,0.001,851,853,10,10,0.0001,1704,11
0.466,0.001,897,907,10,10,0.0001,1804,11
0.466,0.001,949,955,10,10,0.0001,1904,11
0.472,0.001,1004,1000,10,10,0.0001,2004,11
0.518,0.001,51,53,10,10,0.0001,104,12
0.518,0.001,101,103,10,10,0.0001,204,12
0.518,0.001,152,152,10,10,0.0001,304,12
0.518,0.001,211,193,10,10,0.0001,404,12
0.518,0.001,254,250,10,10,0.0001,504,12
0.518,0.001,296,308,10,10,0.0001,604,12
0.518,0.001,350,354,10,10,0.0001,704,12
0.518,0.001,402,402,10,10,0.0001,804,12
0.518,0.001,451,453,10,10,0.0001,904,12
0.518,0.001,499,505,10,10,0.0001,1004,12
0.518,0.001,552,552,10,10,0.0001,1104,12
0.518,0.001,600,604,10,10,0.0001,1204,12
0.518,0.001,648,656,10,10,0.0001,1304,12
0.518,0.001,692,712,10,10,0.0001,1404,12
0.518,0.001,743,761,10,10,0.0001,1504,12
0.518,0.001,788,816,10,10,0.0001,1604,12
0.518,0.001,837,867,10,10,0.0001,1704,12
0.518,0.001,897,907,10,10,0.0001,1804,12
0.518,0.001,958,946,10,10,0.0001,1904,12
0.518,0.001,1011,993,10,10,0.0001,2004,12
0.522,0.001,50,54,10,10,0.0001,104,13
0.522,0.001,107,97,10,10,0.0001,204,13
0.522,0.001,160,144,10,10,0.0001,304,13
0.522,0.001,211,193,10,10,0.0001,404,13
0.522,0.001,260,244,10,10,0.0001,504,13
0.522,0.001,309,295,10,10,0.0001,604,13
0.522,0.001,371,333,10,10,0.0001,704,13
0.522,0.001,418,386,10,10,0.0001,804,13
0.524,0.001,458,446,10,10,0.0001,904,13
0.524,0.001,499,505,10,10,0.0001,1004,13
0.524,0.001,545,559,10,10,0.0001,1104,13
0.524,0.001,587,617,10,10,0.0001,1204,13
0.524,0.001,637,667,10,10,0.0001,1304,13
0.524,0.001,695,709,10,10,0.0001,1404,13
0.524,0.001,739,765,10,10,0.0001,1504,13
0.524,0.001,792,812,10,10,0.0001,1604,13
0.524,0.001,847,857,10,10,0.0001,1704,13
0.524,0.001,891,913,10,10,0.0001,1804,13
0.524,0.001,943,961,10,10,0.0001,1904,13
0.524,0.001,991,1013,10,10,0.0001,2004,13
0.478,0.001,52,52,10,10,0.0001,104,14
0.478,0.001,103,101,10,10,0.0001,204,14
0.478,0.001,163,141,10,10,0.0001,304,14
0.478,0.001,214,190,10,10,0.0001,404,14
0.478,0.001,272,232,10,10,0.0001,504,14
0.48,0.001,321,283,10,10,0.0001,604,14
0.48,0.001,366,338,10,10,0.0001,704,14
0.48,0.001,420,384,10,10,0.0001,804,14
0.478,0.001,477,427,10,10,0.0001,904,14
0.478,0.001,528,476,10,10,0.0001,1004,14
0.478,0.001,568,536,10,10,0.0001,1104,14
0.48,0.001,613,591,10,10,0.0001,1204,14
0.48,0.001,662,642,10,10,0.0001,1304,14
0.484,0.001,712,692,10,10,0.0001,1404,14
0.488,0.001,753,751,10,10,0.0001,1504,14
0.49,0.001,806,798,10,10,0.0001,1604,14
0.49,0.001,857,847,10,10,0.0001,1704,14
0.492,0.001,905,899,10,10,0.0001,1804,14
0.494,0.001,953,951,10,10,0.0001,1904,14
0.498,0.001,1001,1003,10,10,0.0001,2004,14
0.53,0.001,60,44,10,10,0.0001,104,15
0.53,0.001,106,98,10,10,0.0001,204,15
0.532,0.001,156,148,10,10,0.0001,304,15
0.532,0.001,213,191,10,10,0.0001,404,15
0.534,0.001,265,239,10,10,0.0001,504,15
0.534,0.001,308,296,10,10,0.0001,604,15
0.534,0.001,363,341,10,10,0.0001,704,15
0.534,0.001,418,386,10,10,0.0001,804,15
0.534,0.001,473,431,10,10,0.0001,904,15
0.534,0.001,532,472,10,10,0.0001,1004,15
0.536,0.001,578,526,10,10,0.0001,1104,15
0.536,0.001,623,581,10,10,0.0001,1204,15
0.536,0.001,682,622,10,10,0.0001,1304,15
0.538,0.001,729,675,10,10,0.0001,1404,15
0.538,0.001,773,731,10,10,0.0001,1504,15
0.538,0.001,827,777,10,10,0.0001,1604,15
0.538,0.001,874,830,10,10,0.0001,1704,15
0.538,0.001,925,879,10,10,0.0001,1804,15
0.542,0.001,979,925,10,10,0.0001,1904,15
0.542,0.001,1028,976,10,10,0.0001,2004,15
0.46,0.001,56,48,10,10,0.0001,104,16
0.46,0.001,110,94,10,10,0.0001,204,16
0.46,0.001,164,140,10,10,0.0001,304,16
0.46,0.001,205,199,10,10,0.0001,404,16
0.458,0.001,257,247,10,10,0.0001,504,16
0.458,0.001,308,296,10,10,0.0001,604,16
0.458,0.001,351,353,10,10,0.0001,704,16
0.458,0.001,407,397,10,10,0.0001,804,16
0.458,0.001,465,439,10,10,0.0001,904,16
0.458,0.001,508,496,10,10,0.0001,1004,16
0.456,0.001,557,547,10,10,0.0001,1104,16
0.456,0.001,612,592,10,10,0.0001,1204,16
0.454,0.001,662,642,10,10,0.0001,1304,16
0.458,0.001,715,689,10,10,0.0001,1404,16
0.46,0.001,768,736,10,10,0.0001,1504,16
0.458,0.001,817,787,10,10,0.0001,1604,16
0.456,0.001,874,830,10,10,0.0001,1704,16
0.454,0.001,922,882,10,10,0.0001,1804,16
0.454,0.001,966,938,10,10,0.0001,1904,16
0.454,0.001,1012,992,10,10,0.0001,2004,16
0.488,0.001,44,60,10,10,0.0001,104,17
0.488,0.001,94,110,10,10,0.0001,204,17
0.488,0.001,149,155,10,10,0.0001,304,17
0.488,0.001,200,204,10,10,0.0001,404,17
0.49,0.001,254,250,10,10,0.0001,504,17
0.49,0.001,297,307,10,10,0.0001,604,17
0.49,0.001,356,348,10,10,0.0001,704,17
0.49,0.001,411,393,10,10,0.0001,804,17
0.49,0.001,471,433,10,10,0.0001,904,17
0.492,0.001,526,478,10,10,0.0001,1004,17
0.492,0.001,577,527,10,10,0.0001,1104,17
0.492,0.001,628,576,10,10,0.0001,1204,17
0.492,0.001,675,629,10,10,0.0001,1304,17
0.492,0.001,731,673,10,10,0.0001,1404,17
0.492,0.001,777,727,10,10,0.0001,1504,17
0.492,0.001,820,784,10,10,0.0001,1604,17
0.492,0.001,860,844,10,10,0.0001,1704,17
0.488,0.001,907,897,10,10,0.0001,1804,17
0.49,0.001,956,948,10,10,0.0001,1904,17
0.49,0.001,992,1012,10,10,0.0001,2004,17
0.49,0.001,48,56,10,10,0.0001,104,18
0.488,0.001,100,104,10,10,0.0001,204,18
0.488,0.001,147,157,10,10,0.0001,304,18
0.488,0.001,196,208,10,10,0.0001,404,18
0.488,0.001,254,250,10,10,0.0001,504,18
0.488,0.001,304,300,10,10,0.0001,604,18
0.488,0.001,358,346,10,10,0.0001,704,18
0.486,0.001,404,400,10,10,0.0001,804,18
0.484,0.001,446,458,10,10,0.0001,904,18
0.484,0.001,491,513,10,10,0.0001,1004,18
0.484,0.001,541,563,10,10,0.0001,1104,18
0.484,0.001,592,612,10,10,0.0001,1204,18
0.486,0.001,650,654,10,10,0.0001,1304,18
0.488,0.001,700,704,10,10,0.0001,1404,18
0.488,0.001,760,744,10,10,0.0001,1504,18
0.49,0.001,817,787,10,10,0.0001,1604,18
0.488,0.001,870,834,10,10,0.0001,1704,18
0.49,0.001,922,882,10,10,0.0001,1804,18
0.492,0.001,972,932,10,10,0.0001,1904,18
0.496,0.001,1017,987,10,10,0.0001,2004,18
0.546,0.001,51,53,10,10,0.0001,104,19
0.546,0.001,105,99,10,10,0.0001,204,19
0.546,0.001,151,153,10,10,0.0001,304,19
0.546,0.001,205,199,10,10,0.0001,404,19
0.546,0.001,258,246,10,10,0.0001,504,19
0.546,0.001,305,299,10,10,0.0001,604,19
0.546,0.001,355,349,10,10,0.0001,704,19
0.546,0.001,401,403,10,10,0.0001,804,19
0.546,0.001,448,456,10,10,0.0001,904,19
0.546,0.001,498,506,10,10,0.0001,1004,19
0.546,0.001,549,555,10,10,0.0001,1104,19
0.546,0.001,597,607,10,10,0.0001,1204,19
0.546,0.001,655,649,10,10,0.0001,1304,19
0.546,0.001,700,704,10,10,0.0001,1404,19
0.546,0.001,764,740,10,10,0.0001,1504,19
0.544,0.001,815,789,10,10,0.0001,1604,19
0.544,0.001,876,828,10,10,0.0001,1704,19
0.544,0.001,931,873,10,10,0.0001,1804,19
0.544,0.001,974,930,10,10,0.0001,1904,19
0.544,0.001,1021,983,10,10,0.0001,2004,19
0.496,0.001,51,53,10,10,0.0001,104,20
0.496,0.001,95,109,10,10,0.0001,204,20
0.496,0.001,142,162,10,10,0.0001,304,20
0.496,0.001,193,211,10,10,0.0001,404,20
0.496,0.001,241,263,10,10,0.0001,504,20
0.496,0.001,295,309,10,10,0.0001,604,20
0.496,0.001,349,355,10,10,0.0001,704,20
0.496,0.001,397,407,10,10,0.0001,804,20
0.496,0.001,441,463,10,10,0.0001,904,20
0.496,0.001,493,511,10,10,0.0001,1004,20
0.496,0.001,538,566,10,10,0.0001,1104,20
0.496,0.001,584,620,10,10,0.0001,1204,20
0.496,0.001,631,673,10,10,0.0001,1304,20
0.498,0.001,679,725,10,10,0.0001,1404,20
0.496,0.001,734,770,10,10,0.0001,1504,20
0.498,0.001,786,818,10,10,0.0001,1604,20
0.498,0.001,848,856,10,10,0.0001,1704,20
0.496,0.001,895,909,10,10,0.0001,1804,20
0.496,0.001,950,954,10,10,0.0001,1904,20
0.498,0.001,1007,997,10,10,0.0001,2004,20
0.472,0.001,52,52,10,10,0.001,104,1
0.472,0.001,103,101,10,10,0.001,204,1
0.472,0.001,155,149,10,10,0.001,304,1
0.476,0.001,203,201,10,10,0.001,404,1
0.474,0.001,256,248,10,10,0.001,504,1
0.472,0.001,309,295,10,10,0.001,604,1
0.47,0.001,359,345,10,10,0.001,704,1
0.468,0.001,415,389,10,10,0.001,804,1
0.468,0.001,469,435,10,10,0.001,904,1
0.47,0.001,510,494,10,10,0.001,1004,1
0.474,0.001,565,539,10,10,0.001,1104,1
0.48,0.001,617,587,10,10,0.001,1204,1
0.48,0.001,665,639,10,10,0.001,1304,1
0.49,0.001,719,685,10,10,0.001,1404,1
0.498,0.001,768,736,10,10,0.001,1504,1
0.51,0.001,810,794,10,10,0.001,1604,1
0.522,0.001,857,847,10,10,0.001,1704,1
0.536,0.001,909,895,10,10,0.001,1804,1
0.544,0.001,969,935,10,10,0.001,1904,1
0.546,0.001,1021,983,10,10,0.001,2004,1
0.488,0.001,48,56,10,10,0.001,104,2
0.49,0.001,106,98,10,10,0.001,204,2
0.49,0.001,158,146,10,10,0.001,304,2
0.488,0.001,207,197,10,10,0.001,404,2
0.486,0.001,262,242,10,10,0.001,504,2
0.492,0.001,312,292,10,10,0.001,604,2
0.492,0.001,365,339,10,10,0.001,704,2
0.496,0.001,422,382,10,10,0.001,804,2
0.492,0.001,470,434,10,10,0.001,904,2
0.492,0.001,512,492,10,10,0.001,1004,2
0.49,0.001,569,535,10,10,0.001,1104,2
0.496,0.001,614,590,10,10,0.001,1204,2
0.504,0.001,663,641,10,10,0.001,1304,2
0.512,0.001,718,686,10,10,0.001,1404,2
0.516,0.001,771,733,10,10,0.001,1504,2
0.518,0.001,825,779,10,10,0.001,1604,2
0.526,0.001,865,839,10,10,0.001,1704,2
0.532,0.001,915,889,10,10,0.001,1804,2
0.53,0.001,958,946,10,10,0.001,1904,2
0.544,0.001,1004,1000,10,10,0.001,2004,2
0.486,0.001,55,49,10,10,0.001,104,3
0.488,0.001,109,95,10,10,0.001,204,3
0.49,0.001,154,150,10,10,0.001,304,3
0.492,0.001,201,203,10,10,0.001,404,3
0.49,0.001,252,252,10,10,0.001,504,3
0.492,0.001,311,293,10,10,0.001,604,3
0.494,0.001,354,350,10,10,0.001,704,3
0.498,0.001,398,406,10,10,0.001,804,3
0.508,0.001,451,453,10,10,0.001,904,3
0.506,0.001,501,503,10,10,0.001,1004,3
0.508,0.001,555,549,10,10,0.001,1104,3
0.508,0.001,613,591,10,10,0.001,1204,3
0.512,0.001,677,627,10,10,0.001,1304,3
0.512,0.001,729,675,10,10,0.001,1404,3
0.52,0.001,772,732,10,10,0.001,1504,3
0.53,0.001,818,786,10,10,0.001,1604,3
0.534,0.001,867,837,10,10,0.001,1704,3
0.542,0.001,918,886,10,10,0.001,1804,3
0.546,0.001,973,931,10,10,0.001,1904,3
0.554,0.001,1024,980,10,10,0.001,2004,3
0.52,0.001,54,50,10,10,0.001,104,4
0.522,0.001,107,97,10,10,0.001,204,4
0.522,0.001,162,142,10,10,0.001,304,4
0.522,0.001,215,189,10,10,0.001,404,4
0.522,0.001,267,237,10,10,0.001,504,4
0.522,0.001,324,280,10,10,0.001,604,4
0.522,0.001,371,333,10,10,0.001,704,4
0.52,0.001,420,384,10,10,0.001,804,4
0.526,0.001,475,429,10,10,0.001,904,4
0.526,0.001,521,483,10,10,0.001,1004,4
0.53,0.001,575,529,10,10,0.001,1104,4
0.538,0.001,625,579,10,10,0.001,1204,4
0.542,0.001,671,633,10,10,0.001,1304,4
0.542,0.001,715,689,10,10,0.001,1404,4
0.544,0.001,757,747,10,10,0.001,1504,4
0.56,0.001,809,795,10,10,0.001,1604,4
0.57,0.001,856,848,10,10,0.001,1704,4
0.578,0.001,906,898,10,10,0.001,1804,4
0.592,0.001,954,950,10,10,0.001,1904,4
0.612,0.001,1001,1003,10,10,0.001,2004,4
0.494,0.001,51,53,10,10,0.001,104,5
0.49,0.001,94,110,10,10,0.001,204,5
0.492,0.001,152,152,10,10,0.001,304,5
0.492,0.001,195,209,10,10,0.001,404,5
0.498,0.001,250,254,10,10,0.001,504,5
0.508,0.001,297,307,10,10,0.001,604,5
0.512,0.001,355,349,10,10,0.001,704,5
0.514,0.001,408,396,10,10,0.001,804,5
0.524,0.001,451,453,10,10,0.001,904,5
0.534,0.001,506,498,10,10,0.001,1004,5
0.542,0.001,551,553,10,10,0.001,1104,5
0.55,0.001,600,604,10,10,0.001,1204,5
0.56,0.001,648,656,10,10,0.001,1304,5
0.566,0.001,701,703,10,10,0.001,1404,5
0.572,0.001,753,751,10,10,0.001,1504,5
0.578,0.001,797,807,10,10,0.001,1604,5
0.594,0.001,844,860,10,10,0.001,1704,5
0.604,0.001,898,906,10,10,0.001,1804,5
0.61,0.001,948,956,10,10,0.001,1904,5
0.638,0.001,1000,1004,10,10,0.001,2004,5
0.426,0.001,49,55,10,10,0.001,104,6
0.426,0.001,99,105,10,10,0.001,204,6
0.426,0.001,147,157,10,10,0.001,304,6
0.428,0.001,198,206,10,10,0.001,404,6
0.43,0.001,251,253,10,10,0.001,504,6
0.436,0.001,306,298,10,10,0.001,604,6
0.438,0.001,359,345,10,10,0.001,704,6
0.436,0.001,403,401,10,10,0.001,804,6
0.436,0.001,460,444,10,10,0.001,904,6
0.436,0.001,499,505,10,10,0.001,1004,6
0.436,0.001,546,558,10,10,0.001,1104,6
0.442,0.001,600,604,10,10,0.001,1204,6
0.448,0.001,650,654,10,10,0.001,1304,6
0.462,0.001,700,704,10,10,0.001,1404,6
0.474,0.001,745,759,10,10,0.001,1504,6
0.478,0.001,788,816,10,10,0.001,1604,6
0.482,0.001,844,860,10,10,0.001,1704,6
0.484,0.001,898,906,10,10,0.001,1804,6
0.488,0.001,948,956,10,10,0.001,1904,6
0.51,0.001,994,1010,10,10,0.001,2004,6
0.458,0.001,44,60,10,10,0.001,104,7
0.456,0.001,92,112,10,10,0.001,204,7
0.456,0.001,148,156,10,10,0.001,304,7
0.454,0.001,192,212,10,10,0.001,404,7
0.456,0.001,250,254,10,10,0.001,504,7
0.454,0.001,295,309,10,10,0.001,604,7
0.454,0.001,342,362,10,10,0.001,704,7
0.456,0.001,390,414,10,10,0.001,804,7
0.454,0.001,449,455,10,10,0.001,904,7
0.452,0.001,505,499,10,10,0.001,1004,7
0.454,0.001,552,552,10,10,0.001,1104,7
0.452,0.001,602,602,10,10,0.001,1204,7
0.452,0.001,650,654,10,10,0.001,1304,7
0.46,0.001,696,708,10,10,0.001,1404,7
0.464,0.001,757,747,10,10,0.001,1504,7
0.48,0.001,809,795,10,10,0.001,1604,7
0.498,0.001,864,840,10,10,0.001,1704,7
0.51,0.001,915,889,10,10,0.001,1804,7
0.498,0.001,963,941,10,10,0.001,1904,7
0.508,0.001,1020,984,10,10,0.001,2004,7
0.476,0.001,49,55,10,10,0.001,104,8
0.476,0.001,110,94,10,10,0.001,204,8
0.478,0.001,166,138,10,10,0.001,304,8
0.478,0.001,219,185,10,10,0.001,404,8
0.478,0.001,263,241,10,10,0.001,504,8
0.478,0.001,303,301,10,10,0.001,604,8
0.48,0.001,348,356,10,10,0.001,704,8
0.482,0.001,389,415,10,10,0.001,804,8
0.484,0.001,447,457,10,10,0.001,904,8
0.484,0.001,494,510,10,10,0.001,1004,8
0.484,0.001,545,559,10,10,0.001,1104,8
0.488,0.001,598,606,10,10,0.001,1204,8
0.498,0.001,645,659,10,10,0.001,1304,8
0.504,0.001,694,710,10,10,0.001,1404,8
0.52,0.001,747,757,10,10,0.001,1504,8
0.53,0.001,793,811,10,10,0.001,1604,8
0.542,0.001,852,852,10,10,0.001,1704,8
0.556,0.001,899,905,10,10,0.001,1804,8
0.564,0.001,954,950,10,10,0.001,1904,8
0.564,0.001,1002,1002,10,10,0.001,2004,8
0.53,0.001,45,59,10,10,0.001,104,9
0.532,0.001,98,106,10,10,0.001,204,9
0.534,0.001,141,163,10,10,0.001,304,9
0.534,0.001,189,215,10,10,0.001,404,9
0.532,0.001,241,263,10,10,0.001,504,9
0.538,0.001,293,311,10,10,0.001,604,9
0.538,0.001,342,362,10,10,0.001,704,9
0.536,0.001,395,409,10,10,0.001,804,9
0.54,0.001,446,458,10,10,0.001,904,9
0.552,0.001,494,510,10,10,0.001,1004,9
0.562,0.001,541,563,10,10,0.001,1104,9
0.57,0.001,583,621,10,10,0.001,1204,9
0.574,0.001,631,673,10,10,0.001,1304,9
0.574,0.001,674,730,10,10,0.001,1404,9
0.572,0.001,727,777,10,10,0.001,1504,9
0.578,0.001,771,833,10,10,0.001,1604,9
0.588,0.001,822,882,10,10,0.001,1704,9
0.596,0.001,878,926,10,10,0.001,1804,9
0.604,0.001,932,972,10,10,0.001,1904,9
0.61,0.001,992,1012,10,10,0.001,2004,9
0.502,0.001,48,56,10,10,0.001,104,10
0.502,0.001,107,97,10,10,0.001,204,10
0.504,0.001,157,147,10,10,0.001,304,10
0.504,0.001,199,205,10,10,0.001,404,10
0.504,0.001,256,248,10,10,0.001,504,10
0.506,0.001,300,304,10,10,0.001,604,10
0.506,0.001,348,356,10,10,0.001,704,10
0.508,0.001,399,405,10,10,0.001,804,10
0.51,0.001,447,457,10,10,0.001,904,10
0.516,0.001,493,511,10,10,0.001,1004,10
0.524,0.001,541,563,10,10,0.001,1104,10
0.534,0.001,592,612,10,10,0.001,1204,10
0.536,0.001,643,661,10,10,0.001,1304,10
0.542,0.001,690,714,10,10,0.001,1404,10
0.55,0.001,745,759,10,10,0.001,1504,10
0.55,0.001,790,814,10,10,0.001,1604,10
0.55,0.001,837,867,10,10,0.001,1704,10
0.568,0.001,883,921,10,10,0.001,1804,10
0.578,0.001,932,972,10,10,0.001,1904,10
0.584,0.001,984,1020,10,10,0.001,2004,10
0.496,0.001,49,55,10,10,0.001,104,11
0.496,0.001,101,103,10,10,0.001,204,11
0.496,0.001,153,151,10,10,0.001,304,11
0.496,0.001,197,207,10,10,0.001,404,11
0.496,0.001,246,258,10,10,0.001,504,11
0.496,0.001,293,311,10,10,0.001,604,11
0.496,0.001,346,358,10,10,0.001,704,11
0.498,0.001,391,413,10,10,0.001,804,11
0.5,0.001,439,465,10,10,0.001,904,11
0.504,0.001,484,520,10,10,0.001,1004,11
0.508,0.001,535,569,10,10,0.001,1104,11
0.506,0.001,585,619,10,10,0.001,1204,11
0.512,0.001,638,666,10,10,0.001,1304,11
0.51,0.001,687,717,10,10,0.001,1404,11
0.508,0.001,734,770,10,10,0.001,1504,11
0.508,0.001,775,829,10,10,0.001,1604,11
0.514,0.001,827,877,10,10,0.001,1704,11
0.516,0.001,883,921,10,10,0.001,1804,11
0.522,0.001,938,966,10,10,0.001,1904,11
0.522,0.001,998,1006,10,10,0.001,2004,11
0.494,0.001,57,47,10,10,0.001,104,12
0.49,0.001,103,101,10,10,0.001,204,12
0.49,0.001,149,155,10,10,0.001,304,12
0.492,0.001,201,203,10,10,0.001,404,12
0.494,0.001,252,252,10,10,0.001,504,12
0.486,0.001,308,296,10,10,0.001,604,12
0.48,0.001,369,335,10,10,0.001,704,12
0.472,0.001,413,391,10,10,0.001,804,12
0.474,0.001,467,437,10,10,0.001,904,12
0.472,0.001,505,499,10,10,0.001,1004,12
0.476,0.001,555,549,10,10,0.001,1104,12
0.474,0.001,603,601,10,10,0.001,1204,12
0.466,0.001,648,656,10,10,0.001,1304,12
0.458,0.001,695,709,10,10,0.001,1404,12
0.47,0.001,744,760,10,10,0.001,1504,12
0.488,0.001,790,814,10,10,0.001,1604,12
0.498,0.001,839,865,10,10,0.001,1704,12
0.5,0.001,889,915,10,10,0.001,1804,12
0.514,0.001,945,959,10,10,0.001,1904,12
0.526,0.001,997,1007,10,10,0.001,2004,12
0.5,0.001,58,46,10,10,0.001,104,13
0.5,0.001,110,94,10,10,0.001,204,13
0.5,0.001,162,142,10,10,0.001,304,13
0.504,0.001,207,197,10,10,0.001,404,13
0.506,0.001,258,246,10,10,0.001,504,13
0.504,0.001,309,295,10,10,0.001,604,13
0.51,0.001,357,347,10,10,0.001,704,13
0.512,0.001,407,397,10,10,0.001,804,13
0.516,0.001,460,444,10,10,0.001,904,13
0.514,0.001,511,493,10,10,0.001,1004,13
0.514,0.001,554,550,10,10,0.001,1104,13
0.514,0.001,608,596,10,10,0.001,1204,13
0.51,0.001,661,643,10,10,0.001,1304,13
0.512,0.001,716,688,10,10,0.001,1404,13
0.518,0.001,771,733,10,10,0.001,1504,13
0.52,0.001,816,788,10,10,0.001,1604,13
0.52,0.001,868,836,10,10,0.001,1704,13
0.522,0.001,910,894,10,10,0.001,1804,13
0.524,0.001,967,937,10,10,0.001,1904,13
0.532,0.001,1012,992,10,10,0.001,2004,13
0.512,0.001,53,51,10,10,0.001,104,14
0.512,0.001,99,105,10,10,0.001,204,14
0.512,0.001,144,160,10,10,0.001,304,14
0.512,0.001,190,214,10,10,0.001,404,14
0.512,0.001,240,264,10,10,0.001,504,14
0.512,0.001,286,318,10,10,0.001,604,14
0.512,0.001,350,354,10,10,0.001,704,14
0.512,0.001,401,403,10,10,0.001,804,14
0.512,0.001,460,444,10,10,0.001,904,14
0.512,0.001,518,486,10,10,0.001,1004,14
0.512,0.001,559,545,10,10,0.001,1104,14
0.512,0.001,615,589,10,10,0.001,1204,14
0.514,0.001,678,626,10,10,0.001,1304,14
0.52,0.001,731,673,10,10,0.001,1404,14
0.518,0.001,780,724,10,10,0.001,1504,14
0.522,0.001,828,776,10,10,0.001,1604,14
0.524,0.001,876,828,10,10,0.001,1704,14
0.534,0.001,925,879,10,10,0.001,1804,14
0.538,0.001,961,943,10,10,0.001,1904,14
0.548,0.001,1008,996,10,10,0.001,2004,14
0.532,0.001,51,53,10,10,0.001,104,15
0.532,0.001,104,100,10,10,0.001,204,15
0.53,0.001,159,145,10,10,0.001,304,15
0.528,0.001,213,191,10,10,0.001,404,15
0.528,0.001,264,240,10,10,0.001,504,15
0.532,0.001,311,293,10,10,0.001,604,15
0.534,0.001,351,353,10,10,0.001,704,15
0.534,0.001,391,413,10,10,0.001,804,15
0.538,0.001,445,459,10,10,0.001,904,15
0.538,0.001,494,510,10,10,0.001,1004,15
0.54,0.001,544,560,10,10,0.001,1104,15
0.54,0.001,596,608,10,10,0.001,1204,15
0.544,0.001,653,651,10,10,0.001,1304,15
0.548,0.001,697,707,10,10,0.001,1404,15
0.55,0.001,747,757,10,10,0.001,1504,15
0.548,0.001,788,816,10,10,0.001,1604,15
0.562,0.001,845,859,10,10,0.001,1704,15
0.574,0.001,902,902,10,10,0.001,1804,15
0.588,0.001,953,951,10,10,0.001,1904,15
0.592,0.001,997,1007,10,10,0.001,2004,15
0.494,0.001,46,58,10,10,0.001,104,16
0.494,0.001,92,112,10,10,0.001,204,16
0.498,0.001,129,175,10,10,0.001,304,16
0.496,0.001,177,227,10,10,0.001,404,16
0.486,0.001,228,276,10,10,0.001,504,16
0.48,0.001,273,331,10,10,0.001,604,16
0.476,0.001,324,380,10,10,0.001,704,16
0.472,0.001,376,428,10,10,0.001,804,16
0.482,0.001,424,480,10,10,0.001,904,16
0.482,0.001,472,532,10,10,0.001,1004,16
0.492,0.001,528,576,10,10,0.001,1104,16
0.494,0.001,581,623,10,10,0.001,1204,16
0.496,0.001,632,672,10,10,0.001,1304,16
0.49,0.001,672,732,10,10,0.001,1404,16
0.488,0.001,716,788,10,10,0.001,1504,16
0.478,0.001,766,838,10,10,0.001,1604,16
0.484,0.001,823,881,10,10,0.001,1704,16
0.498,0.001,876,928,10,10,0.001,1804,16
0.508,0.001,927,977,10,10,0.001,1904,16
0.524,0.001,972,1032,10,10,0.001,2004,16
0.5,0.001,51,53,10,10,0.001,104,17
0.502,0.001,102,102,10,10,0.001,204,17
0.5,0.001,153,151,10,10,0.001,304,17
0.502,0.001,202,202,10,10,0.001,404,17
0.496,0.001,257,247,10,10,0.001,504,17
0.494,0.001,309,295,10,10,0.001,604,17
0.49,0.001,362,342,10,10,0.001,704,17
0.496,0.001,410,394,10,10,0.001,804,17
0.498,0.001,459,445,10,10,0.001,904,17
0.498,0.001,508,496,10,10,0.001,1004,17
0.5,0.001,565,539,10,10,0.001,1104,17
0.498,0.001,620,584,10,10,0.001,1204,17
0.496,0.001,669,635,10,10,0.001,1304,17
0.496,0.001,713,691,10,10,0.001,1404,17
0.498,0.001,763,741,10,10,0.001,1504,17
0.498,0.001,806,798,10,10,0.001,1604,17
0.504,0.001,859,845,10,10,0.001,1704,17
0.498,0.001,905,899,10,10,0.001,1804,17
0.498,0.001,953,951,10,10,0.001,1904,17
0.5,0.001,1005,999,10,10,0.001,2004,17
0.47,0.001,51,53,10,10,0.001,104,18
0.476,0.001,107,97,10,10,0.001,204,18
0.484,0.001,152,152,10,10,0.001,304,18
0.48,0.001,203,201,10,10,0.001,404,18
0.478,0.001,265,239,10,10,0.001,504,18
0.476,0.001,318,286,10,10,0.001,604,18
0.48,0.001,370,334,10,10,0.001,704,18
0.484,0.001,432,372,10,10,0.001,804,18
0.486,0.001,483,421,10,10,0.001,904,18
0.494,0.001,529,475,10,10,0.001,1004,18
0.5,0.001,572,532,10,10,0.001,1104,18
0.506,0.001,630,574,10,10,0.001,1204,18
0.514,0.001,679,625,10,10,0.001,1304,18
0.522,0.001,730,674,10,10,0.001,1404,18
0.538,0.001,777,727,10,10,0.001,1504,18
0.548,0.001,827,777,10,10,0.001,1604,18
0.582,0.001,882,822,10,10,0.001,1704,18
0.6,0.001,927,877,10,10,0.001,1804,18
0.608,0.001,974,930,10,10,0.001,1904,18
0.628,0.001,1022,982,10,10,0.001,2004,18
0.522,0.001,42,62,10,10,0.001,104,19
0.516,0.001,94,110,10,10,0.001,204,19
0.518,0.001,144,160,10,10,0.001,304,19
0.52,0.001,200,204,10,10,0.001,404,19
0.522,0.001,245,259,10,10,0.001,504,19
0.528,0.001,293,311,10,10,0.001,604,19
0.528,0.001,348,356,10,10,0.001,704,19
0.53,0.001,401,403,10,10,0.001,804,19
0.532,0.001,460,444,10,10,0.001,904,19
0.532,0.001,510,494,10,10,0.001,1004,19
0.534,0.001,563,541,10,10,0.001,1104,19
0.544,0.001,613,591,10,10,0.001,1204,19
0.548,0.001,657,647,10,10,0.001,1304,19
0.568,0.001,710,694,10,10,0.001,1404,19
0.568,0.001,755,749,10,10,0.001,1504,19
0.574,0.001,800,804,10,10,0.001,1604,19
0.582,0.001,847,857,10,10,0.001,1704,19
0.598,0.001,901,903,10,10,0.001,1804,19
0.602,0.001,953,951,10,10,0.001,1904,19
0.622,0.001,1002,1002,10,10,0.001,2004,19
0.522,0.001,48,56,10,10,0.001,104,20
0.524,0.001,98,106,10,10,0.001,204,20
0.528,0.001,154,150,10,10,0.001,304,20
0.53,0.001,199,205,10,10,0.001,404,20
0.53,0.001,245,259,10,10,0.001,504,20
0.532,0.001,291,313,10,10,0.001,604,20
0.538,0.001,343,361,10,10,0.001,704,20
0.542,0.001,390,414,10,10,0.001,804,20
0.552,0.001,441,463,10,10,0.001,904,20
0.556,0.001,496,508,10,10,0.001,1004,20
0.56,0.001,545,559,10,10,0.001,1104,20
0.582,0.001,590,614,10,10,0.001,1204,20
0.594,0.001,649,655,10,10,0.001,1304,20
0.602,0.001,696,708,10,10,0.001,1404,20
0.614,0.001,749,755,10,10,0.001,1504,20
0.63,0.001,792,812,10,10,0.001,1604,20
0.634,0.001,836,868,10,10,0.001,1704,20
0.65,0.001,886,918,10,10,0.001,1804,20
0.662,0.001,933,971,10,10,0.001,1904,20
0.674,0.001,985,1019,10,10,0.001,2004,20
0.498,0.001,46,58,10,10,0.01,104,1
0.51,0.001,100,104,10,10,0.01,204,1
0.516,0.001,146,158,10,10,0.01,304,1
0.554,0.001,200,204,10,10,0.01,404,1
0.566,0.001,242,262,10,10,0.01,504,1
0.592,0.001,292,312,10,10,0.01,604,1
0.616,0.001,337,367,10,10,0.01,704,1
0.632,0.001,386,418,10,10,0.01,804,1
0.64,0.001,432,472,10,10,0.01,904,1
0.656,0.001,490,514,10,10,0.01,1004,1
0.688,0.001,541,563,10,10,0.01,1104,1
0.704,0.001,590,614,10,10,0.01,1204,1
0.726,0.001,643,661,10,10,0.01,1304,1
0.764,0.001,688,716,10,10,0.01,1404,1
0.786,0.001,743,761,10,10,0.01,1504,1
0.824,0.001,793,811,10,10,0.01,1604,1
0.856,0.001,843,861,10,10,0.01,1704,1
0.876,0.001,895,909,10,10,0.01,1804,1
0.878,0.001,949,955,10,10,0.01,1904,1
0.894,0.001,1005,999,10,10,0.01,2004,1
0.492,0.001,53,51,10,10,0.01,104,2
0.528,0.001,95,109,10,10,0.01,204,2
0.55,0.001,147,157,10,10,0.01,304,2
0.574,0.001,199,205,10,10,0.01,404,2
0.572,0.001,261,243,10,10,0.01,504,2
0.586,0.001,315,289,10,10,0.01,604,2
0.608,0.001,364,340,10,10,0.01,704,2
0.638,0.001,412,392,10,10,0.01,804,2
0.644,0.001,478,426,10,10,0.01,904,2
0.698,0.001,524,480,10,10,0.01,1004,2
0.768,0.001,570,534,10,10,0.01,1104,2
0.814,0.001,615,589,10,10,0.01,1204,2
0.848,0.001,666,638,10,10,0.01,1304,2
0.876,0.001,721,683,10,10,0.01,1404,2
0.894,0.001,771,733,10,10,0.01,1504,2
0.91,0.001,821,783,10,10,0.01,1604,2
0.924,0.001,870,834,10,10,0.01,1704,2
0.928,0.001,910,894,10,10,0.01,1804,2
0.938,0.001,960,944,10,10,0.01,1904,2
0.946,0.001,1009,995,10,10,0.01,2004,2
0.442,0.001,49,55,10,10,0.01,104,3
0.448,0.001,96,108,10,10,0.01,204,3
0.456,0.001,142,162,10,10,0.01,304,3
0.514,0.001,193,211,10,10,0.01,404,3
0.592,0.001,243,261,10,10,0.01,504,3
0.636,0.001,298,306,10,10,0.01,604,3
0.668,0.001,344,360,10,10,0.01,704,3
0.68,0.001,395,409,10,10,0.01,804,3
0.696,0.001,457,447,10,10,0.01,904,3
0.724,0.001,515,489,10,10,0.01,1004,3
0.758,0.001,563,541,10,10,0.01,1104,3
0.816,0.001,608,596,10,10,0.01,1204,3
0.84,0.001,657,647,10,10,0.01,1304,3
0.864,0.001,705,699,10,10,0.01,1404,3
0.882,0.001,755,749,10,10,0.01,1504,3
0.92,0.001,800,804,10,10,0.01,1604,3
0.936,0.001,841,863,10,10,0.01,1704,3
0.952,0.001,897,907,10,10,0.01,1804,3
0.96,0.001,945,959,10,10,0.01,1904,3
0.972,0.001,1009,995,10,10,0.01,2004,3
0.408,0.001,54,50,10,10,0.01,104,4
0.42,0.001,103,101,10,10,0.01,204,4
0.438,0.001,151,153,10,10,0.01,304,4
0.49,0.001,196,208,10,10,0.01,404,4
0.526,0.001,246,258,10,10,0.01,504,4
0.554,0.001,298,306,10,10,0.01,604,4
0.612,0.001,347,357,10,10,0.01,704,4
0.66,0.001,393,411,10,10,0.01,804,4
0.716,0.001,442,462,10,10,0.01,904,4
0.78,0.001,491,513,10,10,0.01,1004,4
0.832,0.001,541,563,10,10,0.01,1104,4
0.864,0.001,595,609,10,10,0.01,1204,4
0.902,0.001,646,658,10,10,0.01,1304,4
0.922,0.001,704,700,10,10,0.01,1404,4
0.934,0.001,751,753,10,10,0.01,1504,4
0.94,0.001,801,803,10,10,0.01,1604,4
0.936,0.001,854,850,10,10,0.01,1704,4
0.952,0.001,897,907,10,10,0.01,1804,4
0.96,0.001,953,951,10,10,0.01,1904,4
0.96,0.001,990,1014,10,10,0.01,2004,4
0.476,0.001,53,51,10,10,0.01,104,5
0.47,0.001,105,99,10,10,0.01,204,5
0.49,0.001,158,146,10,10,0.01,304,5
0.514,0.001,207,197,10,10,0.01,404,5
0.528,0.001,244,260,10,10,0.01,504,5
0.554,0.001,295,309,10,10,0.01,604,5
0.582,0.001,342,362,10,10,0.01,704,5
0.638,0.001,395,409,10,10,0.01,804,5
0.668,0.001,448,456,10,10,0.01,904,5
0.708,0.001,498,506,10,10,0.01,1004,5
0.744,0.001,550,554,10,10,0.01,1104,5
0.81,0.001,603,601,10,10,0.01,1204,5
0.866,0.001,645,659,10,10,0.01,1304,5
0.906,0.001,695,709,10,10,0.01,1404,5
0.918,0.001,744,760,10,10,0.01,1504,5
0.934,0.001,793,811,10,10,0.01,1604,5
0.934,0.001,836,868,10,10,0.01,1704,5
0.936,0.001,893,911,10,10,0.01,1804,5
0.946,0.001,947,957,10,10,0.01,1904,5
0.96,0.001,996,1008,10,10,0.01,2004,5
0.542,0.001,45,59,10,10,0.01,104,6
0.538,0.001,98,106,10,10,0.01,204,6
0.564,0.001,150,154,10,10,0.01,304,6
0.592,0.001,197,207,10,10,0.01,404,6
0.61,0.001,254,250,10,10,0.01,504,6
0.634,0.001,306,298,10,10,0.01,604,6
0.68,0.001,360,344,10,10,0.01,704,6
0.714,0.001,401,403,10,10,0.01,804,6
0.732,0.001,453,451,10,10,0.01,904,6
0.76,0.001,503,501,10,10,0.01,1004,6
0.782,0.001,554,550,10,10,0.01,1104,6
0.822,0.001,599,605,10,10,0.01,1204,6
0.852,0.001,650,654,10,10,0.01,1304,6
0.894,0.001,695,709,10,10,0.01,1404,6
0.926,0.001,750,754,10,10,0.01,1504,6
0.92,0.001,802,802,10,10,0.01,1604,6
0.924,0.001,855,849,10,10,0.01,1704,6
0.93,0.001,901,903,10,10,0.01,1804,6
0.94,0.001,943,961,10,10,0.01,1904,6
0.95,0.001,996,1008,10,10,0.01,2004,6
0.512,0.001,57,47,10,10,0.01,104,7
0.538,0.001,103,101,10,10,0.01,204,7
0.562,0.001,152,152,10,10,0.01,304,7
0.592,0.001,202,202,10,10,0.01,404,7
0.598,0.001,247,257,10,10,0.01,504,7
0.588,0.001,305,299,10,10,0.01,604,7
0.584,0.001,357,347,10,10,0.01,704,7
0.648,0.001,411,393,10,10,0.01,804,7
0.68,0.001,460,444,10,10,0.01,904,7
0.754,0.001,508,496,10,10,0.01,1004,7
0.826,0.001,554,550,10,10,0.01,1104,7
0.886,0.001,596,608,10,10,0.01,1204,7
0.916,0.001,648,656,10,10,0.01,1304,7
0.926,0.001,695,709,10,10,0.01,1404,7
0.928,0.001,747,757,10,10,0.01,1504,7
0.926,0.001,795,809,10,10,0.01,1604,7
0.928,0.001,850,854,10,10,0.01,1704,7
0.942,0.001,897,907,10,10,0.01,1804,7
0.948,0.001,939,965,10,10,0.01,1904,7
0.956,0.001,982,1022,10,10,0.01,2004,7
0.458,0.001,58,46,10,10,0.01,104,8
0.472,0.001,102,102,10,10,0.01,204,8
0.504,0.001,149,155,10,10,0.01,304,8
0.528,0.001,204,200,10,10,0.01,404,8
0.52,0.001,262,242,10,10,0.01,504,8
0.556,0.001,307,297,10,10,0.01,604,8
0.584,0.001,360,344,10,10,0.01,704,8
0.634,0.001,404,400,10,10,0.01,804,8
0.718,0.001,451,453,10,10,0.01,904,8
0.762,0.001,507,497,10,10,0.01,1004,8
0.798,0.001,552,552,10,10,0.01,1104,8
0.866,0.001,600,604,10,10,0.01,1204,8
0.902,0.001,658,646,10,10,0.01,1304,8
0.92,0.001,709,695,10,10,0.01,1404,8
0.91,0.001,766,738,10,10,0.01,1504,8
0.918,0.001,823,781,10,10,0.01,1604,8
0.93,0.001,872,832,10,10,0.01,1704,8
0.95,0.001,925,879,10,10,0.01,1804,8
0.956,0.001,970,934,10,10,0.01,1904,8
0.958,0.001,1022,982,10,10,0.01,2004,8
0.51,0.001,46,58,10,10,0.01,104,9
0.51,0.001,95,109,10,10,0.01,204,9
0.51,0.001,141,163,10,10,0.01,304,9
0.51,0.001,181,223,10,10,0.01,404,9
0.51,0.001,237,267,10,10,0.01,504,9
0.506,0.001,287,317,10,10,0.01,604,9
0.528,0.001,336,368,10,10,0.01,704,9
0.616,0.001,394,410,10,10,0.01,804,9
0.686,0.001,439,465,10,10,0.01,904,9
0.738,0.001,481,523,10,10,0.01,1004,9
0.752,0.001,527,577,10,10,0.01,1104,9
0.772,0.001,582,622,10,10,0.01,1204,9
0.82,0.001,629,675,10,10,0.01,1304,9
0.85,0.001,691,713,10,10,0.01,1404,9
0.88,0.001,748,756,10,10,0.01,1504,9
0.896,0.001,802,802,10,10,0.01,1604,9
0.9,0.001,848,856,10,10,0.01,1704,9
0.92,0.001,900,904,10,10,0.01,1804,9
0.924,0.001,945,959,10,10,0.01,1904,9
0.932,0.001,997,1007,10,10,0.01,2004,9
0.476,0.001,50,54,10,10,0.01,104,10
0.474,0.001,96,108,10,10,0.01,204,10
0.476,0.001,143,161,10,10,0.01,304,10
0.488,0.001,202,202,10,10,0.01,404,10
0.5,0.001,253,251,10,10,0.01,504,10
0.544,0.001,309,295,10,10,0.01,604,10
0.572,0.001,355,349,10,10,0.01,704,10
0.626,0.001,409,395,10,10,0.01,804,10
0.656,0.001,461,443,10,10,0.01,904,10
0.67,0.001,516,488,10,10,0.01,1004,10
0.706,0.001,567,537,10,10,0.01,1104,10
0.726,0.001,608,596,10,10,0.01,1204,10
0.75,0.001,660,644,10,10,0.01,1304,10
0.772,0.001,711,693,10,10,0.01,1404,10
0.798,0.001,757,747,10,10,0.01,1504,10
0.826,0.001,802,802,10,10,0.01,1604,10
0.844,0.001,851,853,10,10,0.01,1704,10
0.864,0.001,900,904,10,10,0.01,1804,10
0.874,0.001,946,958,10,10,0.01,1904,10
0.876,0.001,989,1015,10,10,0.01,2004,10
0.466,0.001,57,47,10,10,0.01,104,11
0.454,0.001,116,88,10,10,0.01,204,11
0.464,0.001,167,137,10,10,0.01,304,11
0.462,0.001,218,186,10,10,0.01,404,11
0.476,0.001,265,239,10,10,0.01,504,11
0.498,0.001,306,298,10,10,0.01,604,11
0.522,0.001,349,355,10,10,0.01,704,11
0.538,0.001,392,412,10,10,0.01,804,11
0.538,0.001,445,459,10,10,0.01,904,11
0.572,0.001,494,510,10,10,0.01,1004,11
0.614,0.001,546,558,10,10,0.01,1104,11
0.628,0.001,599,605,10,10,0.01,1204,11
0.654,0.001,649,655,10,10,0.01,1304,11
0.69,0.001,703,701,10,10,0.01,1404,11
0.728,0.001,755,749,10,10,0.01,1504,11
0.776,0.001,799,805,10,10,0.01,1604,11
0.81,0.001,842,862,10,10,0.01,1704,11
0.844,0.001,894,910,10,10,0.01,1804,11
0.88,0.001,935,969,10,10,0.01,1904,11
0.896,0.001,988,1016,10,10,0.01,2004,11
0.502,0.001,54,50,10,10,0.01,104,12
0.514,0.001,98,106,10,10,0.01,204,12
0.528,0.001,146,158,10,10,0.01,304,12
0.538,0.001,196,208,10,10,0.01,404,12
0.544,0.001,245,259,10,10,0.01,504,12
0.578,0.001,292,312,10,10,0.01,604,12
0.6,0.001,352,352,10,10,0.01,704,12
0.616,0.001,401,403,10,10,0.01,804,12
0.628,0.001,455,449,10,10,0.01,904,12
0.65,0.001,493,511,10,10,0.01,1004,12
0.67,0.001,543,561,10,10,0.01,1104,12
0.678,0.001,603,601,10,10,0.01,1204,12
0.696,0.001,654,650,10,10,0.01,1304,12
0.722,0.001,696,708,10,10,0.01,1404,12
0.756,0.001,752,752,10,10,0.01,1504,12
0.812,0.001,799,805,10,10,0.01,1604,12
0.854,0.001,851,853,10,10,0.01,1704,12
0.882,0.001,897,907,10,10,0.01,1804,12
0.896,0.001,946,958,10,10,0.01,1904,12
0.922,0.001,997,1007,10,10,0.01,2004,12
0.518,0.001,58,46,10,10,0.01,104,13
0.554,0.001,113,91,10,10,0.01,204,13
0.57,0.001,164,140,10,10,0.01,304,13
0.576,0.001,214,190,10,10,0.01,404,13
0.604,0.001,268,236,10,10,0.01,504,13
0.64,0.001,318,286,10,10,0.01,604,13
0.674,0.001,370,334,10,10,0.01,704,13
0.728,0.001,425,379,10,10,0.01,804,13
0.754,0.001,474,430,10,10,0.01,904,13
0.802,0.001,529,475,10,10,0.01,1004,13
0.864,0.001,583,521,10,10,0.01,1104,13
0.922,0.001,633,571,10,10,0.01,1204,13
0.924,0.001,682,622,10,10,0.01,1304,13
0.928,0.001,728,676,10,10,0.01,1404,13
0.94,0.001,781,723,10,10,0.01,1504,13
0.94,0.001,838,766,10,10,0.01,1604,13
0.944,0.001,891,813,10,10,0.01,1704,13
0.948,0.001,949,855,10,10,0.01,1804,13
0.962,0.001,1001,903,10,10,0.01,1904,13
0.962,0.001,1041,963,10,10,0.01,2004,13
0.492,0.001,61,43,10,10,0.01,104,14
0.496,0.001,112,92,10,10,0.01,204,14
0.502,0.001,162,142,10,10,0.01,304,14
0.528,0.001,210,194,10,10,0.01,404,14
0.554,0.001,255,249,10,10,0.01,504,14
0.616,0.001,307,297,10,10,0.01,604,14
0.65,0.001,356,348,10,10,0.01,704,14
0.702,0.001,398,406,10,10,0.01,804,14
0.75,0.001,451,453,10,10,0.01,904,14
0.796,0.001,497,507,10,10,0.01,1004,14
0.832,0.001,551,553,10,10,0.01,1104,14
0.856,0.001,606,598,10,10,0.01,1204,14
0.882,0.001,645,659,10,10,0.01,1304,14
0.906,0.001,706,698,10,10,0.01,1404,14
0.93,0.001,759,745,10,10,0.01,1504,14
0.936,0.001,808,796,10,10,0.01,1604,14
0.94,0.001,854,850,10,10,0.01,1704,14
0.948,0.001,896,908,10,10,0.01,1804,14
0.95,0.001,943,961,10,10,0.01,1904,14
0.966,0.001,997,1007,10,10,0.01,2004,14
0.506,0.001,52,52,10,10,0.01,104,15
0.53,0.001,99,105,10,10,0.01,204,15
0.534,0.001,155,149,10,10,0.01,304,15
0.578,0.001,205,199,10,10,0.01,404,15
0.622,0.001,262,242,10,10,0.01,504,15
0.652,0.001,318,286,10,10,0.01,604,15
0.664,0.001,367,337,10,10,0.01,704,15
0.706,0.001,415,389,10,10,0.01,804,15
0.732,0.001,464,440,10,10,0.01,904,15
0.744,0.001,513,491,10,10,0.01,1004,15
0.758,0.001,560,544,10,10,0.01,1104,15
0.794,0.001,609,595,10,10,0.01,1204,15
0.83,0.001,658,646,10,10,0.01,1304,15
0.876,0.001,704,700,10,10,0.01,1404,15
0.91,0.001,756,748,10,10,0.01,1504,15
0.93,0.001,807,797,10,10,0.01,1604,15
0.944,0.001,861,843,10,10,0.01,1704,15
0.958,0.001,905,899,10,10,0.01,1804,15
0.96,0.001,945,959,10,10,0.01,1904,15
0.966,0.001,1002,1002,10,10,0.01,2004,15
0.49,0.001,50,54,10,10,0.01,104,16
0.5,0.001,101,103,10,10,0.01,204,16
0.51,0.001,151,153,10,10,0.01,304,16
0.528,0.001,198,206,10,10,0.01,404,16
0.544,0.001,243,261,10,10,0.01,504,16
0.59,0.001,290,314,10,10,0.01,604,16
0.6,0.001,343,361,10,10,0.01,704,16
0.642,0.001,387,417,10,10,0.01,804,16
0.672,0.001,435,469,10,10,0.01,904,16
0.704,0.001,490,514,10,10,0.01,1004,16
0.742,0.001,539,565,10,10,0.01,1104,16
0.782,0.001,592,612,10,10,0.01,1204,16
0.794,0.001,645,659,10,10,0.01,1304,16
0.882,0.001,709,695,10,10,0.01,1404,16
0.936,0.001,757,747,10,10,0.01,1504,16
0.95,0.001,807,797,10,10,0.01,1604,16
0.956,0.001,853,851,10,10,0.01,1704,16
0.964,0.001,905,899,10,10,0.01,1804,16
0.966,0.001,964,940,10,10,0.01,1904,16
0.968,0.001,1007,997,10,10,0.01,2004,16
0.504,0.001,46,58,10,10,0.01,104,17
0.548,0.001,93,111,10,10,0.01,204,17
0.55,0.001,135,169,10,10,0.01,304,17
0.566,0.001,184,220,10,10,0.01,404,17
0.58,0.001,245,259,10,10,0.01,504,17
0.596,0.001,297,307,10,10,0.01,604,17
0.606,0.001,347,357,10,10,0.01,704,17
0.636,0.001,397,407,10,10,0.01,804,17
0.67,0.001,445,459,10,10,0.01,904,17
0.706,0.001,495,509,10,10,0.01,1004,17
0.754,0.001,541,563,10,10,0.01,1104,17
0.776,0.001,590,614,10,10,0.01,1204,17
0.81,0.001,641,663,10,10,0.01,1304,17
0.848,0.001,697,707,10,10,0.01,1404,17
0.87,0.001,748,756,10,10,0.01,1504,17
0.9,0.001,795,809,10,10,0.01,1604,17
0.918,0.001,846,858,10,10,0.01,1704,17
0.94,0.001,900,904,10,10,0.01,1804,17
0.95,0.001,945,959,10,10,0.01,1904,17
0.958,0.001,996,1008,10,10,0.01,2004,17
0.538,0.001,53,51,10,10,0.01,104,18
0.536,0.001,102,102,10,10,0.01,204,18
0.512,0.001,146,158,10,10,0.01,304,18
0.522,0.001,197,207,10,10,0.01,404,18
0.53,0.001,247,257,10,10,0.01,504,18
0.564,0.001,298,306,10,10,0.01,604,18
0.608,0.001,350,354,10,10,0.01,704,18
0.654,0.001,401,403,10,10,0.01,804,18
0.68,0.001,452,452,10,10,0.01,904,18
0.712,0.001,499,505,10,10,0.01,1004,18
0.73,0.001,556,548,10,10,0.01,1104,18
0.776,0.001,610,594,10,10,0.01,1204,18
0.82,0.001,660,644,10,10,0.01,1304,18
0.836,0.001,709,695,10,10,0.01,1404,18
0.864,0.001,758,746,10,10,0.01,1504,18
0.872,0.001,801,803,10,10,0.01,1604,18
0.882,0.001,859,845,10,10,0.01,1704,18
0.91,0.001,912,892,10,10,0.01,1804,18
0.906,0.001,955,949,10,10,0.01,1904,18
0.92,0.001,1006,998,10,10,0.01,2004,18
0.524,0.001,56,48,10,10,0.01,104,19
0.518,0.001,106,98,10,10,0.01,204,19
0.51,0.001,149,155,10,10,0.01,304,19
0.532,0.001,204,200,10,10,0.01,404,19
0.534,0.001,251,253,10,10,0.01,504,19
0.558,0.001,303,301,10,10,0.01,604,19
0.564,0.001,351,353,10,10,0.01,704,19
0.584,0.001,405,399,10,10,0.01,804,19
0.612,0.001,461,443,10,10,0.01,904,19
0.634,0.001,504,500,10,10,0.01,1004,19
0.646,0.001,553,551,10,10,0.01,1104,19
0.678,0.001,600,604,10,10,0.01,1204,19
0.712,0.001,650,654,10,10,0.01,1304,19
0.744,0.001,700,704,10,10,0.01,1404,19
0.768,0.001,754,750,10,10,0.01,1504,19
0.798,0.001,811,793,10,10,0.01,1604,19
0.82,0.001,867,837,10,10,0.01,1704,19
0.866,0.001,916,888,10,10,0.01,1804,19
0.886,0.001,960,944,10,10,0.01,1904,19
0.908,0.001,1008,996,10,10,0.01,2004,19
0.546,0.001,59,45,10,10,0.01,104,20
0.524,0.001,107,97,10,10,0.01,204,20
0.516,0.001,150,154,10,10,0.01,304,20
0.522,0.001,197,207,10,10,0.01,404,20
0.556,0.001,250,254,10,10,0.01,504,20
0.576,0.001,289,315,10,10,0.01,604,20
0.608,0.001,327,377,10,10,0.01,704,20
0.652,0.001,386,418,10,10,0.01,804,20
0.678,0.001,442,462,10,10,0.01,904,20
0.754,0.001,489,515,10,10,0.01,1004,20
0.808,0.001,539,565,10,10,0.01,1104,20
0.836,0.001,585,619,10,10,0.01,1204,20
0.852,0.001,627,677,10,10,0.01,1304,20
0.878,0.001,678,726,10,10,0.01,1404,20
0.89,0.001,737,767,10,10,0.01,1504,20
0.904,0.001,795,809,10,10,0.01,1604,20
0.912,0.001,841,863,10,10,0.01,1704,20
0.93,0.001,889,915,10,10,0.01,1804,20
0.95,0.001,943,961,10,10,0.01,1904,20
0.958,0.001,998,1006,10,10,0.01,2004,20
0.508,1e-05,45,59,10,25,0.0001,104,1
0.508,1e-05,91,113,10,25,0.0001,204,1
0.51,1e-05,137,167,10,25,0.0001,304,1
0.51,1e-05,189,215,10,25,0.0001,404,1
0.51,1e-05,239,265,10,25,0.0001,504,1
0.51,1e-05,291,313,10,25,0.0001,604,1
0.51,1e-05,340,364,10,25,0.0001,704,1
0.51,1e-05,390,414,10,25,0.0001,804,1
0.512,1e-05,441,463,10,25,0.0001,904,1
0.512,1e-05,495,509,10,25,0.0001,1004,1
0.512,1e-05,535,569,10,25,0.0001,1104,1
0.518,1e-05,587,617,10,25,0.0001,1204,1
0.518,1e-05,639,665,10,25,0.0001,1304,1
0.52,1e-05,688,716,10,25,0.0001,1404,1
0.522,1e-05,742,762,10,25,0.0001,1504,1
0.526,1e-05,781,823,10,25,0.0001,1604,1
0.526,1e-05,823,881,10,25,0.0001,1704,1
0.526,1e-05,885,919,10,25,0.0001,1804,1
0.524,1e-05,940,964,10,25,0.0001,1904,1
0.528,1e-05,994,1010,10,25,0.0001,2004,1
0.45,1e-05,53,51,10,25,0.0001,104,2
0.448,1e-05,104,100,10,25,0.0001,204,2
0.446,1e-05,146,158,10,25,0.0001,304,2
0.446,1e-05,198,206,10,25,0.0001,404,2
0.446,1e-05,250,254,10,25,0.0001,504,2
0.446,1e-05,304,300,10,25,0.0001,604,2
0.448,1e-05,351,353,10,25,0.0001,704,2
0.45,1e-05,397,407,10,25,0.0001,804,2
0.45,1e-05,449,455,10,25,0.0001,904,2
0.448,1e-05,505,499,10,25,0.0001,1004,2
0.444,1e-05,551,553,10,25,0.0001,1104,2
0.444,1e-05,598,606,10,25,0.0001,1204,2
0.446,1e-05,641,663,10,25,0.0001,1304,2
0.444,1e-05,686,718,10,25,0.0001,1404,2
0.448,1e-05,735,769,10,25,0.0001,1504,2
0.448,1e-05,786,818,10,25,0.0001,1604,2
0.446,1e-05,834,870,10,25,0.0001,1704,2
0.454,1e-05,879,925,10,25,0.0001,1804,2
0.452,1e-05,934,970,10,25,0.0001,1904,2
0.454,1e-05,992,1012,10,25,0.0001,2004,2
0.42,1e-05,49,55,10,25,0.0001,104,3
0.42,1e-05,98,106,10,25,0.0001,204,3
0.422,1e-05,151,153,10,25,0.0001,304,3
0.418,1e-05,208,196,10,25,0.0001,404,3
0.42,1e-05,260,244,10,25,0.0001,504,3
0.42,1e-05,310,294,10,25,0.0001,604,3
0.42,1e-05,356,348,10,25,0.0001,704,3
0.42,1e-05,404,400,10,25,0.0001,804,3
0.42,1e-05,456,448,10,25,0.0001,904,3
0.422,1e-05,497,507,10,25,0.0001,1004,3
0.42,1e-05,567,537,10,25,0.0001,1104,3
0.42,1e-05,616,588,10,25,0.0001,1204,3
0.418,1e-05,668,636,10,25,0.0001,1304,3
0.42,1e-05,711,693,10,25,0.0001,1404,3
0.424,1e-05,763,741,10,25,0.0001,1504,3
0.426,1e-05,815,789,10,25,0.0001,1604,3
0.426,1e-05,864,840,10,25,0.0001,1704,3
0.426,1e-05,922,882,10,25,0.0001,1804,3
0.426,1e-05,961,943,10,25,0.0001,1904,3
0.428,1e-05,1005,999,10,25,0.0001,2004,3
0.466,1e-05,57,47,10,25,0.0001,104,4
0.466,1e-05,108,96,10,25,0.0001,204,4
0.466,1e-05,163,141,10,25,0.0001,304,4
0.466,1e-05,212,192,10,25,0.0001,404,4
0.466,1e-05,264,240,10,25,0.0001,504,4
0.466,1e-05,312,292,10,25,0.0001,604,4
0.468,1e-05,360,344,10,25,0.0001,704,4
0.468,1e-05,403,401,10,25,0.0001,804,4
0.472,1e-05,459,445,10,25,0.0001,904,4
0.47,1e-05,513,491,10,25,0.0001,1004,4
0.468,1e-05,567,537,10,25,0.0001,1104,4
0.468,1e-05,618,586,10,25,0.0001,1204,4
0.468,1e-05,663,641,10,25,0.0001,1304,4
0.468,1e-05,710,694,10,25,0.0001,1404,4
0.47,1e-05,760,744,10,25,0.0001,1504,4
0.47,1e-05,813,791,10,25,0.0001,1604,4
0.47,1e-05,869,835,10,25,0.0001,1704,4
0.47,1e-05,919,885,10,25,0.0001,1804,4
0.47,1e-05,968,936,10,25,0.0001,1904,4
0.47,1e-05,1024,980,10,25,0.0001,2004,4
0.51,1e-05,61,43,10,25,0.0001,104,5
0.51,1e-05,110,94,10,25,0.0001,204,5
0.51,1e-05,156,148,10,25,0.0001,304,5
0.51,1e-05,204,200,10,25,0.0001,404,5
0.51,1e-05,253,251,10,25,0.0001,504,5
0.51,1e-05,304,300,10,25,0.0001,604,5
0.51,1e-05,360,344,10,25,0.0001,704,5
0.51,1e-05,402,402,10,25,0.0001,804,5
0.51,1e-05,458,446,10,25,0.0001,904,5
0.51,1e-05,512,492,10,25,0.0001,1004,5
0.51,1e-05,562,542,10,25,0.0001,1104,5
0.51,1e-05,608,596,10,25,0.0001,1204,5
0.51,1e-05,656,648,10,25,0.0001,1304,5
0.51,1e-05,703,701,10,25,0.0001,1404,5
0.51,1e-05,749,755,10,25,0.0001,1504,5
0.51,1e-05,805,799,10,25,0.0001,1604,5
0.51,1e-05,853,851,10,25,0.0001,1704,5
0.51,1e-05,903,901,10,25,0.0001,1804,5
0.51,1e-05,950,954,10,25,0.0001,1904,5
0.51,1e-05,997,1007,10,25,0.0001,2004,5
0.52,1e-05,55,49,10,25,0.0001,104,6
0.52,1e-05,101,103,10,25,0.0001,204,6
0.522,1e-05,147,157,10,25,0.0001,304,6
0.522,1e-05,192,212,10,25,0.0001,404,6
0.522,1e-05,244,260,10,25,0.0001,504,6
0.524,1e-05,304,300,10,25,0.0001,604,6
0.524,1e-05,349,355,10,25,0.0001,704,6
0.522,1e-05,396,408,10,25,0.0001,804,6
0.522,1e-05,446,458,10,25,0.0001,904,6
0.522,1e-05,498,506,10,25,0.0001,1004,6
0.522,1e-05,549,555,10,25,0.0001,1104,6
0.52,1e-05,599,605,10,25,0.0001,1204,6
0.522,1e-05,651,653,10,25,0.0001,1304,6
0.522,1e-05,693,711,10,25,0.0001,1404,6
0.52,1e-05,748,756,10,25,0.0001,1504,6
0.52,1e-05,802,802,10,25,0.0001,1604,6
0.518,1e-05,848,856,10,25,0.0001,1704,6
0.518,1e-05,901,903,10,25,0.0001,1804,6
0.52,1e-05,955,949,10,25,0.0001,1904,6
0.524,1e-05,1009,995,10,25,0.0001,2004,6
0.478,1e-05,57,47,10,25,0.0001,104,7
0.478,1e-05,102,102,10,25,0.0001,204,7
0.478,1e-05,158,146,10,25,0.0001,304,7
0.48,1e-05,204,200,10,25,0.0001,404,7
0.48,1e-05,257,247,10,25,0.0001,504,7
0.48,1e-05,313,291,10,25,0.0001,604,7
0.48,1e-05,363,341,10,25,0.0001,704,7
0.482,1e-05,408,396,10,25,0.0001,804,7
0.482,1e-05,456,448,10,25,0.0001,904,7
0.484,1e-05,496,508,10,25,0.0001,1004,7
0.486,1e-05,543,561,10,25,0.0001,1104,7
0.49,1e-05,586,618,10,25,0.0001,1204,7
0.49,1e-05,636,668,10,25,0.0001,1304,7
0.49,1e-05,686,718,10,25,0.0001,1404,7
0.492,1e-05,738,766,10,25,0.0001,1504,7
0.492,1e-05,794,810,10,25,0.0001,1604,7
0.492,1e-05,836,868,10,25,0.0001,1704,7
0.492,1e-05,891,913,10,25,0.0001,1804,7
0.492,1e-05,937,967,10,25,0.0001,1904,7
0.496,1e-05,999,1005,10,25,0.0001,2004,7
0.538,1e-05,54,50,10,25,0.0001,104,8
0.538,1e-05,102,102,10,25,0.0001,204,8
0.538,1e-05,151,153,10,25,0.0001,304,8
0.538,1e-05,201,203,10,25,0.0001,404,8
0.54,1e-05,253,251,10,25,0.0001,504,8
0.54,1e-05,299,305,10,25,0.0001,604,8
0.54,1e-05,339,365,10,25,0.0001,704,8
0.54,1e-05,387,417,10,25,0.0001,804,8
0.54,1e-05,434,470,10,25,0.0001,904,8
0.54,1e-05,485,519,10,25,0.0001,1004,8
0.544,1e-05,532,572,10,25,0.0001,1104,8
0.544,1e-05,577,627,10,25,0.0001,1204,8
0.544,1e-05,626,678,10,25,0.0001,1304,8
0.544,1e-05,684,720,10,25,0.0001,1404,8
0.544,1e-05,730,774,10,25,0.0001,1504,8
0.544,1e-05,783,821,10,25,0.0001,1604,8
0.542,1e-05,830,874,10,25,0.0001,1704,8
0.544,1e-05,880,924,10,25,0.0001,1804,8
0.544,1e-05,928,976,10,25,0.0001,1904,8
0.544,1e-05,984,1020,10,25,0.0001,2004,8
0.422,1e-05,56,48,10,25,0.0001,104,9
0.422,1e-05,101,103,10,25,0.0001,204,9
0.422,1e-05,151,153,10,25,0.0001,304,9
0.422,1e-05,220,184,10,25,0.0001,404,9
0.422,1e-05,263,241,10,25,0.0001,504,9
0.422,1e-05,319,285,10,25,0.0001,604,9
0.422,1e-05,367,337,10,25,0.0001,704,9
0.422,1e-05,417,387,10,25,0.0001,804,9
0.422,1e-05,463,441,10,25,0.0001,904,9
0.42,1e-05,508,496,10,25,0.0001,1004,9
0.418,1e-05,555,549,10,25,0.0001,1104,9
0.416,1e-05,608,596,10,25,0.0001,1204,9
0.418,1e-05,661,643,10,25,0.0001,1304,9
0.418,1e-05,714,690,10,25,0.0001,1404,9
0.416,1e-05,757,747,10,25,0.0001,1504,9
0.42,1e-05,808,796,10,25,0.0001,1604,9
0.422,1e-05,862,842,10,25,0.0001,1704,9
0.422,1e-05,923,881,10,25,0.0001,1804,9
0.42,1e-05,972,932,10,25,0.0001,1904,9
0.424,1e-05,1025,979,10,25,0.0001,2004,9
0.568,1e-05,51,53,10,25,0.0001,104,10
0.566,1e-05,105,99,10,25,0.0001,204,10
0.566,1e-05,152,152,10,25,0.0001,304,10
0.568,1e-05,208,196,10,25,0.0001,404,10
0.566,1e-05,254,250,10,25,0.0001,504,10
0.566,1e-05,308,296,10,25,0.0001,604,10
0.568,1e-05,361,343,10,25,0.0001,704,10
0.57,1e-05,410,394,10,25,0.0001,804,10
0.568,1e-05,458,446,10,25,0.0001,904,10
0.568,1e-05,513,491,10,25,0.0001,1004,10
0.568,1e-05,562,542,10,25,0.0001,1104,10
0.57,1e-05,618,586,10,25,0.0001,1204,10
0.57,1e-05,666,638,10,25,0.0001,1304,10
0.572,1e-05,714,690,10,25,0.0001,1404,10
0.57,1e-05,766,738,10,25,0.0001,1504,10
0.566,1e-05,817,787,10,25,0.0001,1604,10
0.564,1e-05,863,841,10,25,0.0001,1704,10
0.568,1e-05,914,890,10,25,0.0001,1804,10
0.564,1e-05,958,946,10,25,0.0001,1904,10
0.566,1e-05,1011,993,10,25,0.0001,2004,10
0.476,1e-05,38,66,10,25,0.0001,104,11
0.476,1e-05,78,126,10,25,0.0001,204,11
0.476,1e-05,136,168,10,25,0.0001,304,11
0.476,1e-05,180,224,10,25,0.0001,404,11
0.476,1e-05,231,273,10,25,0.0001,504,11
0.476,1e-05,283,321,10,25,0.0001,604,11
0.476,1e-05,334,370,10,25,0.0001,704,11
0.476,1e-05,389,415,10,25,0.0001,804,11
0.476,1e-05,445,459,10,25,0.0001,904,11
0.476,1e-05,492,512,10,25,0.0001,1004,11
0.476,1e-05,543,561,10,25,0.0001,1104,11
0.476,1e-05,590,614,10,25,0.0001,1204,11
0.476,1e-05,634,670,10,25,0.0001,1304,11
0.476,1e-05,677,727,10,25,0.0001,1404,11
0.476,1e-05,727,777,10,25,0.0001,1504,11
0.476,1e-05,774,830,10,25,0.0001,1604,11
0.478,1e-05,829,875,10,25,0.0001,1704,11
0.478,1e-05,880,924,10,25,0.0001,1804,11
0.478,1e-05,938,966,10,25,0.0001,1904,11
0.48,1e-05,989,1015,10,25,0.0001,2004,11
0.488,1e-05,46,58,10,25,0.0001,104,12
0.488,1e-05,95,109,10,25,0.0001,204,12
0.488,1e-05,142,162,10,25,0.0001,304,12
0.488,1e-05,186,218,10,25,0.0001,404,12
0.488,1e-05,244,260,10,25,0.0001,504,12
0.488,1e-05,298,306,10,25,0.0001,604,12
0.488,1e-05,351,353,10,25,0.0001,704,12
0.488,1e-05,401,403,10,25,0.0001,804,12
0.488,1e-05,453,451,10,25,0.0001,904,12
0.488,1e-05,501,503,10,25,0.0001,1004,12
0.486,1e-05,560,544,10,25,0.0001,1104,12
0.486,1e-05,615,589,10,25,0.0001,1204,12
0.486,1e-05,663,641,10,25,0.0001,1304,12
0.486,1e-05,709,695,10,25,0.0001,1404,12
0.486,1e-05,758,746,10,25,0.0001,1504,12
0.486,1e-05,810,794,10,25,0.0001,1604,12
0.486,1e-05,858,846,10,25,0.0001,1704,12
0.486,1e-05,905,899,10,25,0.0001,1804,12
0.488,1e-05,961,943,10,25,0.0001,1904,12
0.488,1e-05,1009,995,10,25,0.0001,2004,12
0.504,1e-05,57,47,10,25,0.0001,104,13
0.504,1e-05,111,93,10,25,0.0001,204,13
0.504,1e-05,156,148,10,25,0.0001,304,13
0.504,1e-05,198,206,10,25,0.0001,404,13
0.504,1e-05,257,247,10,25,0.0001,504,13
0.504,1e-05,305,299,10,25,0.0001,604,13
0.504,1e-05,357,347,10,25,0.0001,704,13
0.504,1e-05,408,396,10,25,0.0001,804,13
0.504,1e-05,450,454,10,25,0.0001,904,13
0.504,1e-05,500,504,10,25,0.0001,1004,13
0.504,1e-05,553,551,10,25,0.0001,1104,13
0.504,1e-05,598,606,10,25,0.0001,1204,13
0.504,1e-05,646,658,10,25,0.0001,1304,13
0.502,1e-05,698,706,10,25,0.0001,1404,13
0.502,1e-05,744,760,10,25,0.0001,1504,13
0.502,1e-05,794,810,10,25,0.0001,1604,13
0.502,1e-05,848,856,10,25,0.0001,1704,13
0.502,1e-05,901,903,10,25,0.0001,1804,13
0.502,1e-05,953,951,10,25,0.0001,1904,13
0.502,1e-05,999,1005,10,25,0.0001,2004,13
0.488,1e-05,57,47,10,25,0.0001,104,14
0.488,1e-05,100,104,10,25,0.0001,204,14
0.488,1e-05,153,151,10,25,0.0001,304,14
0.488,1e-05,210,194,10,25,0.0001,404,14
0.488,1e-05,261,243,10,25,0.0001,504,14
0.488,1e-05,320,284,10,25,0.0001,604,14
0.486,1e-05,363,341,10,25,0.0001,704,14
0.486,1e-05,408,396,10,25,0.0001,804,14
0.488,1e-05,457,447,10,25,0.0001,904,14
0.488,1e-05,510,494,10,25,0.0001,1004,14
0.488,1e-05,559,545,10,25,0.0001,1104,14
0.49,1e-05,605,599,10,25,0.0001,1204,14
0.488,1e-05,661,643,10,25,0.0001,1304,14
0.488,1e-05,713,691,10,25,0.0001,1404,14
0.49,1e-05,767,737,10,25,0.0001,1504,14
0.49,1e-05,824,780,10,25,0.0001,1604,14
0.494,1e-05,864,840,10,25,0.0001,1704,14
0.494,1e-05,908,896,10,25,0.0001,1804,14
0.494,1e-05,957,947,10,25,0.0001,1904,14
0.494,1e-05,1008,996,10,25,0.0001,2004,14
0.476,1e-05,51,53,10,25,0.0001,104,15
0.476,1e-05,107,97,10,25,0.0001,204,15
0.474,1e-05,170,134,10,25,0.0001,304,15
0.474,1e-05,216,188,10,25,0.0001,404,15
0.474,1e-05,266,238,10,25,0.0001,504,15
0.474,1e-05,312,292,10,25,0.0001,604,15
0.476,1e-05,364,340,10,25,0.0001,704,15
0.476,1e-05,414,390,10,25,0.0001,804,15
0.476,1e-05,463,441,10,25,0.0001,904,15
0.474,1e-05,506,498,10,25,0.0001,1004,15
0.474,1e-05,563,541,10,25,0.0001,1104,15
0.474,1e-05,613,591,10,25,0.0001,1204,15
0.474,1e-05,664,640,10,25,0.0001,1304,15
0.476,1e-05,710,694,10,25,0.0001,1404,15
0.476,1e-05,758,746,10,25,0.0001,1504,15
0.476,1e-05,804,800,10,25,0.0001,1604,15
0.478,1e-05,851,853,10,25,0.0001,1704,15
0.478,1e-05,903,901,10,25,0.0001,1804,15
0.478,1e-05,963,941,10,25,0.0001,1904,15
0.48,1e-05,1007,997,10,25,0.0001,2004,15
0.43,1e-05,51,53,10,25,0.0001,104,16
0.434,1e-05,104,100,10,25,0.0001,204,16
0.434,1e-05,155,149,10,25,0.0001,304,16
0.434,1e-05,202,202,10,25,0.0001,404,16
0.438,1e-05,253,251,10,25,0.0001,504,16
0.434,1e-05,308,296,10,25,0.0001,604,16
0.436,1e-05,359,345,10,25,0.0001,704,16
0.438,1e-05,413,391,10,25,0.0001,804,16
0.438,1e-05,467,437,10,25,0.0001,904,16
0.438,1e-05,513,491,10,25,0.0001,1004,16
0.44,1e-05,562,542,10,25,0.0001,1104,16
0.436,1e-05,611,593,10,25,0.0001,1204,16
0.438,1e-05,655,649,10,25,0.0001,1304,16
0.442,1e-05,709,695,10,25,0.0001,1404,16
0.444,1e-05,752,752,10,25,0.0001,1504,16
0.446,1e-05,807,797,10,25,0.0001,1604,16
0.448,1e-05,855,849,10,25,0.0001,1704,16
0.446,1e-05,900,904,10,25,0.0001,1804,16
0.448,1e-05,950,954,10,25,0.0001,1904,16
0.452,1e-05,996,1008,10,25,0.0001,2004,16
0.44,1e-05,48,56,10,25,0.0001,104,17
0.44,1e-05,101,103,10,25,0.0001,204,17
0.44,1e-05,154,150,10,25,0.0001,304,17
0.438,1e-05,208,196,10,25,0.0001,404,17
0.438,1e-05,260,244,10,25,0.0001,504,17
0.438,1e-05,306,298,10,25,0.0001,604,17
0.44,1e-05,354,350,10,25,0.0001,704,17
0.44,1e-05,407,397,10,25,0.0001,804,17
0.44,1e-05,459,445,10,25,0.0001,904,17
0.44,1e-05,505,499,10,25,0.0001,1004,17
0.44,1e-05,560,544,10,25,0.0001,1104,17
0.438,1e-05,616,588,10,25,0.0001,1204,17
0.44,1e-05,676,628,10,25,0.0001,1304,17
0.44,1e-05,729,675,10,25,0.0001,1404,17
0.444,1e-05,782,722,10,25,0.0001,1504,17
0.446,1e-05,835,769,10,25,0.0001,1604,17
0.446,1e-05,883,821,10,25,0.0001,1704,17
0.444,1e-05,928,876,10,25,0.0001,1804,17
0.444,1e-05,976,928,10,25,0.0001,1904,17
0.448,1e-05,1023,981,10,25,0.0001,2004,17
0.54,1e-05,50,54,10,25,0.0001,104,18
0.54,1e-05,106,98,10,25,0.0001,204,18
0.538,1e-05,163,141,10,25,0.0001,304,18
0.54,1e-05,218,186,10,25,0.0001,404,18
0.54,1e-05,267,237,10,25,0.0001,504,18
0.542,1e-05,326,278,10,25,0.0001,604,18
0.542,1e-05,370,334,10,25,0.0001,704,18
0.544,1e-05,419,385,10,25,0.0001,804,18
0.546,1e-05,466,438,10,25,0.0001,904,18
0.546,1e-05,519,485,10,25,0.0001,1004,18
0.548,1e-05,566,538,10,25,0.0001,1104,18
0.548,1e-05,609,595,10,25,0.0001,1204,18
0.548,1e-05,653,651,10,25,0.0001,1304,18
0.548,1e-05,704,700,10,25,0.0001,1404,18
0.548,1e-05,751,753,10,25,0.0001,1504,18
0.548,1e-05,799,805,10,25,0.0001,1604,18
0.548,1e-05,848,856,10,25,0.0001,1704,18
0.55,1e-05,903,901,10,25,0.0001,1804,18
0.55,1e-05,950,954,10,25,0.0001,1904,18
0.552,1e-05,997,1007,10,25,0.0001,2004,18
0.518,1e-05,44,60,10,25,0.0001,104,19
0.518,1e-05,92,112,10,25,0.0001,204,19
0.518,1e-05,139,165,10,25,0.0001,304,19
0.518,1e-05,192,212,10,25,0.0001,404,19
0.518,1e-05,239,265,10,25,0.0001,504,19
0.518,1e-05,287,317,10,25,0.0001,604,19
0.518,1e-05,340,364,10,25,0.0001,704,19
0.52,1e-05,392,412,10,25,0.0001,804,19
0.52,1e-05,451,453,10,25,0.0001,904,19
0.52,1e-05,501,503,10,25,0.0001,1004,19
0.518,1e-05,550,554,10,25,0.0001,1104,19
0.518,1e-05,590,614,10,25,0.0001,1204,19
0.518,1e-05,632,672,10,25,0.0001,1304,19
0.52,1e-05,684,720,10,25,0.0001,1404,19
0.524,1e-05,729,775,10,25,0.0001,1504,19
0.526,1e-05,775,829,10,25,0.0001,1604,19
0.524,1e-05,835,869,10,25,0.0001,1704,19
0.522,1e-05,887,917,10,25,0.0001,1804,19
0.522,1e-05,943,961,10,25,0.0001,1904,19
0.52,1e-05,998,1006,10,25,0.0001,2004,19
0.486,1e-05,50,54,10,25,0.0001,104,20
0.486,1e-05,108,96,10,25,0.0001,204,20
0.484,1e-05,157,147,10,25,0.0001,304,20
0.484,1e-05,217,187,10,25,0.0001,404,20
0.484,1e-05,259,245,10,25,0.0001,504,20
0.484,1e-05,305,299,10,25,0.0001,604,20
0.484,1e-05,361,343,10,25,0.0001,704,20
0.484,1e-05,408,396,10,25,0.0001,804,20
0.486,1e-05,461,443,10,25,0.0001,904,20
0.486,1e-05,509,495,10,25,0.0001,1004,20
0.486,1e-05,558,546,10,25,0.0001,1104,20
0.486,1e-05,607,597,10,25,0.0001,1204,20
0.488,1e-05,654,650,10,25,0.0001,1304,20
0.484,1e-05,702,702,10,25,0.0001,1404,20
0.484,1e-05,746,758,10,25,0.0001,1504,20
0.486,1e-05,801,803,10,25,0.0001,1604,20
0.488,1e-05,846,858,10,25,0.0001,1704,20
0.49,1e-05,902,902,10,25,0.0001,1804,20
0.49,1e-05,960,944,10,25,0.0001,1904,20
0.492,1e-05,1011,993,10,25,0.0001,2004,20
0.518,1e-05,42,62,10,25,0.001,104,1
0.522,1e-05,90,114,10,25,0.001,204,1
0.524,1e-05,148,156,10,25,0.001,304,1
0.528,1e-05,198,206,10,25,0.001,404,1
0.524,1e-05,243,261,10,25,0.001,504,1
0.53,1e-05,292,312,10,25,0.001,604,1
0.526,1e-05,342,362,10,25,0.001,704,1
0.54,1e-05,394,410,10,25,0.001,804,1
0.546,1e-05,450,454,10,25,0.001,904,1
0.552,1e-05,499,505,10,25,0.001,1004,1
0.558,1e-05,549,555,10,25,0.001,1104,1
0.564,1e-05,604,600,10,25,0.001,1204,1
0.578,1e-05,660,644,10,25,0.001,1304,1
0.604,1e-05,714,690,10,25,0.001,1404,1
0.614,1e-05,768,736,10,25,0.001,1504,1
0.644,1e-05,822,782,10,25,0.001,1604,1
0.654,1e-05,868,836,10,25,0.001,1704,1
0.674,1e-05,908,896,10,25,0.001,1804,1
0.694,1e-05,946,958,10,25,0.001,1904,1
0.728,1e-05,993,1011,10,25,0.001,2004,1
0.536,1e-05,57,47,10,25,0.001,104,2
0.532,1e-05,106,98,10,25,0.001,204,2
0.528,1e-05,155,149,10,25,0.001,304,2
0.528,1e-05,205,199,10,25,0.001,404,2
0.53,1e-05,258,246,10,25,0.001,504,2
0.528,1e-05,299,305,10,25,0.001,604,2
0.518,1e-05,353,351,10,25,0.001,704,2
0.522,1e-05,400,404,10,25,0.001,804,2
0.528,1e-05,459,445,10,25,0.001,904,2
0.532,1e-05,514,490,10,25,0.001,1004,2
0.536,1e-05,568,536,10,25,0.001,1104,2
0.544,1e-05,620,584,10,25,0.001,1204,2
0.544,1e-05,665,639,10,25,0.001,1304,2
0.556,1e-05,720,684,10,25,0.001,1404,2
0.566,1e-05,771,733,10,25,0.001,1504,2
0.58,1e-05,816,788,10,25,0.001,1604,2
0.602,1e-05,871,833,10,25,0.001,1704,2
0.626,1e-05,922,882,10,25,0.001,1804,2
0.65,1e-05,968,936,10,25,0.001,1904,2
0.68,1e-05,1016,988,10,25,0.001,2004,2
0.546,1e-05,47,57,10,25,0.001,104,3
0.542,1e-05,107,97,10,25,0.001,204,3
0.54,1e-05,151,153,10,25,0.001,304,3
0.534,1e-05,201,203,10,25,0.001,404,3
0.536,1e-05,249,255,10,25,0.001,504,3
0.538,1e-05,299,305,10,25,0.001,604,3
0.544,1e-05,349,355,10,25,0.001,704,3
0.546,1e-05,402,402,10,25,0.001,804,3
0.546,1e-05,455,449,10,25,0.001,904,3
0.556,1e-05,512,492,10,25,0.001,1004,3
0.566,1e-05,567,537,10,25,0.001,1104,3
0.572,1e-05,617,587,10,25,0.001,1204,3
0.58,1e-05,664,640,10,25,0.001,1304,3
0.592,1e-05,711,693,10,25,0.001,1404,3
0.6,1e-05,757,747,10,25,0.001,1504,3
0.61,1e-05,810,794,10,25,0.001,1604,3
0.628,1e-05,859,845,10,25,0.001,1704,3
0.636,1e-05,914,890,10,25,0.001,1804,3
0.642,1e-05,969,935,10,25,0.001,1904,3
0.65,1e-05,1019,985,10,25,0.001,2004,3
0.536,1e-05,60,44,10,25,0.001,104,4
0.536,1e-05,106,98,10,25,0.001,204,4
0.536,1e-05,155,149,10,25,0.001,304,4
0.536,1e-05,205,199,10,25,0.001,404,4
0.538,1e-05,253,251,10,25,0.001,504,4
0.542,1e-05,302,302,10,25,0.001,604,4
0.542,1e-05,347,357,10,25,0.001,704,4
0.552,1e-05,392,412,10,25,0.001,804,4
0.55,1e-05,436,468,10,25,0.001,904,4
0.56,1e-05,485,519,10,25,0.001,1004,4
0.568,1e-05,539,565,10,25,0.001,1104,4
0.586,1e-05,579,625,10,25,0.001,1204,4
0.598,1e-05,638,666,10,25,0.001,1304,4
0.604,1e-05,688,716,10,25,0.001,1404,4
0.606,1e-05,741,763,10,25,0.001,1504,4
0.616,1e-05,785,819,10,25,0.001,1604,4
0.648,1e-05,842,862,10,25,0.001,1704,4
0.658,1e-05,893,911,10,25,0.001,1804,4
0.69,1e-05,942,962,10,25,0.001,1904,4
0.696,1e-05,985,1019,10,25,0.001,2004,4
0.462,1e-05,43,61,10,25,0.001,104,5
0.462,1e-05,84,120,10,25,0.001,204,5
0.462,1e-05,129,175,10,25,0.001,304,5
0.466,1e-05,177,227,10,25,0.001,404,5
0.476,1e-05,223,281,10,25,0.001,504,5
0.478,1e-05,268,336,10,25,0.001,604,5
0.482,1e-05,322,382,10,25,0.001,704,5
0.49,1e-05,382,422,10,25,0.001,804,5
0.498,1e-05,431,473,10,25,0.001,904,5
0.504,1e-05,483,521,10,25,0.001,1004,5
0.512,1e-05,530,574,10,25,0.001,1104,5
0.518,1e-05,570,634,10,25,0.001,1204,5
0.528,1e-05,626,678,10,25,0.001,1304,5
0.546,1e-05,672,732,10,25,0.001,1404,5
0.564,1e-05,716,788,10,25,0.001,1504,5
0.58,1e-05,768,836,10,25,0.001,1604,5
0.59,1e-05,821,883,10,25,0.001,1704,5
0.624,1e-05,876,928,10,25,0.001,1804,5
0.638,1e-05,928,976,10,25,0.001,1904,5
0.664,1e-05,977,1027,10,25,0.001,2004,5
0.506,1e-05,54,50,10,25,0.001,104,6
0.506,1e-05,103,101,10,25,0.001,204,6
0.506,1e-05,156,148,10,25,0.001,304,6
0.506,1e-05,212,192,10,25,0.001,404,6
0.506,1e-05,264,240,10,25,0.001,504,6
0.506,1e-05,307,297,10,25,0.001,604,6
0.51,1e-05,347,357,10,25,0.001,704,6
0.512,1e-05,395,409,10,25,0.001,804,6
0.516,1e-05,448,456,10,25,0.001,904,6
0.518,1e-05,502,502,10,25,0.001,1004,6
0.52,1e-05,554,550,10,25,0.001,1104,6
0.526,1e-05,600,604,10,25,0.001,1204,6
0.538,1e-05,647,657,10,25,0.001,1304,6
0.55,1e-05,692,712,10,25,0.001,1404,6
0.564,1e-05,739,765,10,25,0.001,1504,6
0.576,1e-05,798,806,10,25,0.001,1604,6
0.612,1e-05,848,856,10,25,0.001,1704,6
0.646,1e-05,895,909,10,25,0.001,1804,6
0.678,1e-05,946,958,10,25,0.001,1904,6
0.714,1e-05,999,1005,10,25,0.001,2004,6
0.484,1e-05,48,56,10,25,0.001,104,7
0.486,1e-05,97,107,10,25,0.001,204,7
0.486,1e-05,144,160,10,25,0.001,304,7
0.486,1e-05,200,204,10,25,0.001,404,7
0.486,1e-05,244,260,10,25,0.001,504,7
0.488,1e-05,291,313,10,25,0.001,604,7
0.492,1e-05,343,361,10,25,0.001,704,7
0.498,1e-05,391,413,10,25,0.001,804,7
0.5,1e-05,448,456,10,25,0.001,904,7
0.5,1e-05,502,502,10,25,0.001,1004,7
0.504,1e-05,555,549,10,25,0.001,1104,7
0.52,1e-05,609,595,10,25,0.001,1204,7
0.534,1e-05,656,648,10,25,0.001,1304,7
0.542,1e-05,698,706,10,25,0.001,1404,7
0.554,1e-05,743,761,10,25,0.001,1504,7
0.564,1e-05,794,810,10,25,0.001,1604,7
0.578,1e-05,848,856,10,25,0.001,1704,7
0.606,1e-05,902,902,10,25,0.001,1804,7
0.624,1e-05,953,951,10,25,0.001,1904,7
0.642,1e-05,992,1012,10,25,0.001,2004,7
0.442,1e-05,56,48,10,25,0.001,104,8
0.436,1e-05,114,90,10,25,0.001,204,8
0.438,1e-05,160,144,10,25,0.001,304,8
0.44,1e-05,208,196,10,25,0.001,404,8
0.448,1e-05,256,248,10,25,0.001,504,8
0.454,1e-05,307,297,10,25,0.001,604,8
0.456,1e-05,360,344,10,25,0.001,704,8
0.46,1e-05,416,388,10,25,0.001,804,8
0.468,1e-05,463,441,10,25,0.001,904,8
0.462,1e-05,513,491,10,25,0.001,1004,8
0.468,1e-05,562,542,10,25,0.001,1104,8
0.488,1e-05,604,600,10,25,0.001,1204,8
0.518,1e-05,652,652,10,25,0.001,1304,8
0.566,1e-05,709,695,10,25,0.001,1404,8
0.588,1e-05,763,741,10,25,0.001,1504,8
0.612,1e-05,813,791,10,25,0.001,1604,8
0.632,1e-05,856,848,10,25,0.001,1704,8
0.652,1e-05,908,896,10,25,0.001,1804,8
0.668,1e-05,954,950,10,25,0.001,1904,8
0.682,1e-05,1001,1003,10,25,0.001,2004,8
0.554,1e-05,56,48,10,25,0.001,104,9
0.56,1e-05,108,96,10,25,0.001,204,9
0.56,1e-05,162,142,10,25,0.001,304,9
0.574,1e-05,207,197,10,25,0.001,404,9
0.574,1e-05,259,245,10,25,0.001,504,9
0.57,1e-05,318,286,10,25,0.001,604,9
0.582,1e-05,369,335,10,25,0.001,704,9
0.588,1e-05,419,385,10,25,0.001,804,9
0.584,1e-05,476,428,10,25,0.001,904,9
0.594,1e-05,524,480,10,25,0.001,1004,9
0.602,1e-05,581,523,10,25,0.001,1104,9
0.624,1e-05,629,575,10,25,0.001,1204,9
0.642,1e-05,677,627,10,25,0.001,1304,9
0.648,1e-05,725,679,10,25,0.001,1404,9
0.672,1e-05,771,733,10,25,0.001,1504,9
0.694,1e-05,817,787,10,25,0.001,1604,9
0.71,1e-05,862,842,10,25,0.001,1704,9
0.716,1e-05,913,891,10,25,0.001,1804,9
0.736,1e-05,950,954,10,25,0.001,1904,9
0.76,1e-05,1003,1001,10,25,0.001,2004,9
0.508,1e-05,55,49,10,25,0.001,104,10
0.512,1e-05,109,95,10,25,0.001,204,10
0.516,1e-05,152,152,10,25,0.001,304,10
0.512,1e-05,200,204,10,25,0.001,404,10
0.516,1e-05,253,251,10,25,0.001,504,10
0.516,1e-05,310,294,10,25,0.001,604,10
0.53,1e-05,370,334,10,25,0.001,704,10
0.548,1e-05,422,382,10,25,0.001,804,10
0.558,1e-05,464,440,10,25,0.001,904,10
0.572,1e-05,505,499,10,25,0.001,1004,10
0.582,1e-05,553,551,10,25,0.001,1104,10
0.58,1e-05,610,594,10,25,0.001,1204,10
0.592,1e-05,666,638,10,25,0.001,1304,10
0.606,1e-05,713,691,10,25,0.001,1404,10
0.612,1e-05,755,749,10,25,0.001,1504,10
0.628,1e-05,811,793,10,25,0.001,1604,10
0.638,1e-05,865,839,10,25,0.001,1704,10
0.656,1e-05,912,892,10,25,0.001,1804,10
0.664,1e-05,961,943,10,25,0.001,1904,10
0.7,1e-05,1001,1003,10,25,0.001,2004,10
0.478,1e-05,47,57,10,25,0.001,104,11
0.486,1e-05,95,109,10,25,0.001,204,11
0.488,1e-05,147,157,10,25,0.001,304,11
0.492,1e-05,197,207,10,25,0.001,404,11
0.494,1e-05,241,263,10,25,0.001,504,11
0.498,1e-05,289,315,10,25,0.001,604,11
0.502,1e-05,340,364,10,25,0.001,704,11
0.504,1e-05,383,421,10,25,0.001,804,11
0.5,1e-05,432,472,10,25,0.001,904,11
0.516,1e-05,488,516,10,25,0.001,1004,11
0.522,1e-05,536,568,10,25,0.001,1104,11
0.528,1e-05,588,616,10,25,0.001,1204,11
0.548,1e-05,644,660,10,25,0.001,1304,11
0.554,1e-05,694,710,10,25,0.001,1404,11
0.56,1e-05,738,766,10,25,0.001,1504,11
0.568,1e-05,783,821,10,25,0.001,1604,11
0.574,1e-05,836,868,10,25,0.001,1704,11
0.582,1e-05,883,921,10,25,0.001,1804,11
0.586,1e-05,936,968,10,25,0.001,1904,11
0.604,1e-05,994,1010,10,25,0.001,2004,11
0.558,1e-05,53,51,10,25,0.001,104,12
0.554,1e-05,98,106,10,25,0.001,204,12
0.556,1e-05,141,163,10,25,0.001,304,12
0.56,1e-05,190,214,10,25,0.001,404,12
0.556,1e-05,235,269,10,25,0.001,504,12
0.558,1e-05,282,322,10,25,0.001,604,12
0.568,1e-05,329,375,10,25,0.001,704,12
0.578,1e-05,377,427,10,25,0.001,804,12
0.572,1e-05,418,486,10,25,0.001,904,12
0.588,1e-05,472,532,10,25,0.001,1004,12
0.594,1e-05,529,575,10,25,0.001,1104,12
0.592,1e-05,577,627,10,25,0.001,1204,12
0.582,1e-05,619,685,10,25,0.001,1304,12
0.58,1e-05,675,729,10,25,0.001,1404,12
0.578,1e-05,723,781,10,25,0.001,1504,12
0.602,1e-05,784,820,10,25,0.001,1604,12
0.608,1e-05,829,875,10,25,0.001,1704,12
0.612,1e-05,876,928,10,25,0.001,1804,12
0.624,1e-05,929,975,10,25,0.001,1904,12
0.632,1e-05,982,1022,10,25,0.001,2004,12
0.546,1e-05,54,50,10,25,0.001,104,13
0.55,1e-05,101,103,10,25,0.001,204,13
0.546,1e-05,153,151,10,25,0.001,304,13
0.556,1e-05,203,201,10,25,0.001,404,13
0.558,1e-05,254,250,10,25,0.001,504,13
0.562,1e-05,299,305,10,25,0.001,604,13
0.562,1e-05,352,352,10,25,0.001,704,13
0.57,1e-05,405,399,10,25,0.001,804,13
0.568,1e-05,451,453,10,25,0.001,904,13
0.584,1e-05,497,507,10,25,0.001,1004,13
0.588,1e-05,551,553,10,25,0.001,1104,13
0.6,1e-05,602,602,10,25,0.001,1204,13
0.616,1e-05,654,650,10,25,0.001,1304,13
0.628,1e-05,711,693,10,25,0.001,1404,13
0.662,1e-05,760,744,10,25,0.001,1504,13
0.68,1e-05,805,799,10,25,0.001,1604,13
0.716,1e-05,859,845,10,25,0.001,1704,13
0.736,1e-05,911,893,10,25,0.001,1804,13
0.738,1e-05,964,940,10,25,0.001,1904,13
0.746,1e-05,1015,989,10,25,0.001,2004,13
0.508,1e-05,57,47,10,25,0.001,104,14
0.514,1e-05,110,94,10,25,0.001,204,14
0.518,1e-05,165,139,10,25,0.001,304,14
0.516,1e-05,213,191,10,25,0.001,404,14
0.518,1e-05,255,249,10,25,0.001,504,14
0.53,1e-05,301,303,10,25,0.001,604,14
0.524,1e-05,349,355,10,25,0.001,704,14
0.528,1e-05,406,398,10,25,0.001,804,14
0.53,1e-05,459,445,10,25,0.001,904,14
0.562,1e-05,504,500,10,25,0.001,1004,14
0.574,1e-05,551,553,10,25,0.001,1104,14
0.59,1e-05,603,601,10,25,0.001,1204,14
0.622,1e-05,653,651,10,25,0.001,1304,14
0.638,1e-05,693,711,10,25,0.001,1404,14
0.65,1e-05,750,754,10,25,0.001,1504,14
0.668,1e-05,808,796,10,25,0.001,1604,14
0.672,1e-05,859,845,10,25,0.001,1704,14
0.696,1e-05,909,895,10,25,0.001,1804,14
0.714,1e-05,959,945,10,25,0.001,1904,14
0.724,1e-05,1017,987,10,25,0.001,2004,14
0.508,1e-05,49,55,10,25,0.001,104,15
0.508,1e-05,98,106,10,25,0.001,204,15
0.508,1e-05,146,158,10,25,0.001,304,15
0.508,1e-05,195,209,10,25,0.001,404,15
0.51,1e-05,246,258,10,25,0.001,504,15
0.512,1e-05,295,309,10,25,0.001,604,15
0.512,1e-05,348,356,10,25,0.001,704,15
0.518,1e-05,400,404,10,25,0.001,804,15
0.52,1e-05,451,453,10,25,0.001,904,15
0.528,1e-05,516,488,10,25,0.001,1004,15
0.524,1e-05,562,542,10,25,0.001,1104,15
0.538,1e-05,605,599,10,25,0.001,1204,15
0.542,1e-05,653,651,10,25,0.001,1304,15
0.546,1e-05,700,704,10,25,0.001,1404,15
0.562,1e-05,756,748,10,25,0.001,1504,15
0.58,1e-05,802,802,10,25,0.001,1604,15
0.592,1e-05,862,842,10,25,0.001,1704,15
0.61,1e-05,903,901,10,25,0.001,1804,15
0.616,1e-05,951,953,10,25,0.001,1904,15
0.636,1e-05,1000,1004,10,25,0.001,2004,15
0.486,1e-05,55,49,10,25,0.001,104,16
0.486,1e-05,91,113,10,25,0.001,204,16
0.49,1e-05,155,149,10,25,0.001,304,16
0.49,1e-05,211,193,10,25,0.001,404,16
0.486,1e-05,252,252,10,25,0.001,504,16
0.486,1e-05,299,305,10,25,0.001,604,16
0.49,1e-05,355,349,10,25,0.001,704,16
0.496,1e-05,403,401,10,25,0.001,804,16
0.502,1e-05,453,451,10,25,0.001,904,16
0.51,1e-05,502,502,10,25,0.001,1004,16
0.526,1e-05,549,555,10,25,0.001,1104,16
0.54,1e-05,603,601,10,25,0.001,1204,16
0.554,1e-05,654,650,10,25,0.001,1304,16
0.566,1e-05,707,697,10,25,0.001,1404,16
0.574,1e-05,751,753,10,25,0.001,1504,16
0.584,1e-05,800,804,10,25,0.001,1604,16
0.6,1e-05,847,857,10,25,0.001,1704,16
0.62,1e-05,897,907,10,25,0.001,1804,16
0.626,1e-05,946,958,10,25,0.001,1904,16
0.648,1e-05,996,1008,10,25,0.001,2004,16
0.532,1e-05,45,59,10,25,0.001,104,17
0.538,1e-05,104,100,10,25,0.001,204,17
0.534,1e-05,152,152,10,25,0.001,304,17
0.54,1e-05,207,197,10,25,0.001,404,17
0.544,1e-05,251,253,10,25,0.001,504,17
0.544,1e-05,298,306,10,25,0.001,604,17
0.552,1e-05,344,360,10,25,0.001,704,17
0.56,1e-05,396,408,10,25,0.001,804,17
0.566,1e-05,441,463,10,25,0.001,904,17
0.57,1e-05,490,514,10,25,0.001,1004,17
0.582,1e-05,542,562,10,25,0.001,1104,17
0.586,1e-05,592,612,10,25,0.001,1204,17
0.588,1e-05,638,666,10,25,0.001,1304,17
0.598,1e-05,687,717,10,25,0.001,1404,17
0.598,1e-05,731,773,10,25,0.001,1504,17
0.598,1e-05,778,826,10,25,0.001,1604,17
0.61,1e-05,831,873,10,25,0.001,1704,17
0.612,1e-05,882,922,10,25,0.001,1804,17
0.634,1e-05,940,964,10,25,0.001,1904,17
0.65,1e-05,997,1007,10,25,0.001,2004,17
0.526,1e-05,61,43,10,25,0.001,104,18
0.532,1e-05,104,100,10,25,0.001,204,18
0.53,1e-05,153,151,10,25,0.001,304,18
0.538,1e-05,198,206,10,25,0.001,404,18
0.532,1e-05,250,254,10,25,0.001,504,18
0.534,1e-05,297,307,10,25,0.001,604,18
0.542,1e-05,340,364,10,25,0.001,704,18
0.546,1e-05,388,416,10,25,0.001,804,18
0.554,1e-05,436,468,10,25,0.001,904,18
0.566,1e-05,487,517,10,25,0.001,1004,18
0.58,1e-05,545,559,10,25,0.001,1104,18
0.582,1e-05,590,614,10,25,0.001,1204,18
0.596,1e-05,639,665,10,25,0.001,1304,18
0.616,1e-05,693,711,10,25,0.001,1404,18
0.64,1e-05,744,760,10,25,0.001,1504,18
0.654,1e-05,788,816,10,25,0.001,1604,18
0.664,1e-05,840,864,10,25,0.001,1704,18
0.69,1e-05,886,918,10,25,0.001,1804,18
0.71,1e-05,936,968,10,25,0.001,1904,18
0.738,1e-05,994,1010,10,25,0.001,2004,18
0.51,1e-05,41,63,10,25,0.001,104,19
0.516,1e-05,95,109,10,25,0.001,204,19
0.526,1e-05,141,163,10,25,0.001,304,19
0.532,1e-05,186,218,10,25,0.001,404,19
0.522,1e-05,241,263,10,25,0.001,504,19
0.526,1e-05,300,304,10,25,0.001,604,19
0.536,1e-05,359,345,10,25,0.001,704,19
0.532,1e-05,417,387,10,25,0.001,804,19
0.534,1e-05,468,436,10,25,0.001,904,19
0.552,1e-05,512,492,10,25,0.001,1004,19
0.578,1e-05,560,544,10,25,0.001,1104,19
0.608,1e-05,617,587,10,25,0.001,1204,19
0.622,1e-05,661,643,10,25,0.001,1304,19
0.644,1e-05,701,703,10,25,0.001,1404,19
0.662,1e-05,748,756,10,25,0.001,1504,19
0.668,1e-05,793,811,10,25,0.001,1604,19
0.694,1e-05,841,863,10,25,0.001,1704,19
0.704,1e-05,890,914,10,25,0.001,1804,19
0.704,1e-05,941,963,10,25,0.001,1904,19
0.708,1e-05,994,1010,10,25,0.001,2004,19
0.498,1e-05,49,55,10,25,0.001,104,20
0.502,1e-05,97,107,10,25,0.001,204,20
0.506,1e-05,139,165,10,25,0.001,304,20
0.512,1e-05,187,217,10,25,0.001,404,20
0.518,1e-05,247,257,10,25,0.001,504,20
0.52,1e-05,303,301,10,25,0.001,604,20
0.518,1e-05,352,352,10,25,0.001,704,20
0.518,1e-05,399,405,10,25,0.001,804,20
0.518,1e-05,452,452,10,25,0.001,904,20
0.52,1e-05,514,490,10,25,0.001,1004,20
0.518,1e-05,557,547,10,25,0.001,1104,20
0.536,1e-05,604,600,10,25,0.001,1204,20
0.552,1e-05,656,648,10,25,0.001,1304,20
0.566,1e-05,709,695,10,25,0.001,1404,20
0.586,1e-05,760,744,10,25,0.001,1504,20
0.596,1e-05,806,798,10,25,0.001,1604,20
0.61,1e-05,855,849,10,25,0.001,1704,20
0.632,1e-05,897,907,10,25,0.001,1804,20
0.644,1e-05,952,952,10,25,0.001,1904,20
0.666,1e-05,1006,998,10,25,0.001,2004,20
0.492,1e-05,52,52,10,25,0.01,104,1
0.522,1e-05,109,95,10,25,0.01,204,1
0.546,1e-05,164,140,10,25,0.01,304,1
0.692,1e-05,209,195,10,25,0.01,404,1
0.69,1e-05,254,250,10,25,0.01,504,1
0.71,1e-05,301,303,10,25,0.01,604,1
0.74,1e-05,342,362,10,25,0.01,704,1
0.798,1e-05,399,405,10,25,0.01,804,1
0.868,1e-05,451,453,10,25,0.01,904,1
0.91,1e-05,501,503,10,25,0.01,1004,1
0.92,1e-05,555,549,10,25,0.01,1104,1
0.934,1e-05,598,606,10,25,0.01,1204,1
0.946,1e-05,644,660,10,25,0.01,1304,1
0.94,1e-05,690,714,10,25,0.01,1404,1
0.95,1e-05,744,760,10,25,0.01,1504,1
0.958,1e-05,791,813,10,25,0.01,1604,1
0.962,1e-05,840,864,10,25,0.01,1704,1
0.964,1e-05,894,910,10,25,0.01,1804,1
0.964,1e-05,945,959,10,25,0.01,1904,1
0.966,1e-05,995,1009,10,25,0.01,2004,1
0.526,1e-05,54,50,10,25,0.01,104,2
0.532,1e-05,102,102,10,25,0.01,204,2
0.536,1e-05,156,148,10,25,0.01,304,2
0.546,1e-05,198,206,10,25,0.01,404,2
0.556,1e-05,248,256,10,25,0.01,504,2
0.592,1e-05,300,304,10,25,0.01,604,2
0.616,1e-05,342,362,10,25,0.01,704,2
0.69,1e-05,390,414,10,25,0.01,804,2
0.764,1e-05,449,455,10,25,0.01,904,2
0.828,1e-05,504,500,10,25,0.01,1004,2
0.856,1e-05,555,549,10,25,0.01,1104,2
0.91,1e-05,606,598,10,25,0.01,1204,2
0.946,1e-05,654,650,10,25,0.01,1304,2
0.95,1e-05,705,699,10,25,0.01,1404,2
0.956,1e-05,757,747,10,25,0.01,1504,2
0.964,1e-05,805,799,10,25,0.01,1604,2
0.968,1e-05,856,848,10,25,0.01,1704,2
0.972,1e-05,908,896,10,25,0.01,1804,2
0.974,1e-05,958,946,10,25,0.01,1904,2
0.97,1e-05,1004,1000,10,25,0.01,2004,2
0.544,1e-05,52,52,10,25,0.01,104,3
0.568,1e-05,106,98,10,25,0.01,204,3
0.592,1e-05,165,139,10,25,0.01,304,3
0.636,1e-05,219,185,10,25,0.01,404,3
0.638,1e-05,278,226,10,25,0.01,504,3
0.646,1e-05,327,277,10,25,0.01,604,3
0.714,1e-05,382,322,10,25,0.01,704,3
0.782,1e-05,428,376,10,25,0.01,804,3
0.824,1e-05,478,426,10,25,0.01,904,3
0.898,1e-05,526,478,10,25,0.01,1004,3
0.938,1e-05,573,531,10,25,0.01,1104,3
0.964,1e-05,622,582,10,25,0.01,1204,3
0.968,1e-05,669,635,10,25,0.01,1304,3
0.968,1e-05,709,695,10,25,0.01,1404,3
0.972,1e-05,761,743,10,25,0.01,1504,3
0.972,1e-05,808,796,10,25,0.01,1604,3
0.976,1e-05,863,841,10,25,0.01,1704,3
0.98,1e-05,909,895,10,25,0.01,1804,3
0.98,1e-05,960,944,10,25,0.01,1904,3
0.978,1e-05,1015,989,10,25,0.01,2004,3
0.564,1e-05,55,49,10,25,0.01,104,4
0.59,1e-05,116,88,10,25,0.01,204,4
0.568,1e-05,169,135,10,25,0.01,304,4
0.594,1e-05,213,191,10,25,0.01,404,4
0.604,1e-05,257,247,10,25,0.01,504,4
0.664,1e-05,306,298,10,25,0.01,604,4
0.716,1e-05,356,348,10,25,0.01,704,4
0.756,1e-05,403,401,10,25,0.01,804,4
0.806,1e-05,448,456,10,25,0.01,904,4
0.86,1e-05,495,509,10,25,0.01,1004,4
0.896,1e-05,543,561,10,25,0.01,1104,4
0.918,1e-05,595,609,10,25,0.01,1204,4
0.922,1e-05,654,650,10,25,0.01,1304,4
0.946,1e-05,700,704,10,25,0.01,1404,4
0.948,1e-05,747,757,10,25,0.01,1504,4
0.958,1e-05,797,807,10,25,0.01,1604,4
0.966,1e-05,839,865,10,25,0.01,1704,4
0.962,1e-05,904,900,10,25,0.01,1804,4
0.968,1e-05,948,956,10,25,0.01,1904,4
0.966,1e-05,1006,998,10,25,0.01,2004,4
0.508,1e-05,50,54,10,25,0.01,104,5
0.516,1e-05,97,107,10,25,0.01,204,5
0.516,1e-05,153,151,10,25,0.01,304,5
0.518,1e-05,207,197,10,25,0.01,404,5
0.542,1e-05,260,244,10,25,0.01,504,5
0.588,1e-05,295,309,10,25,0.01,604,5
0.62,1e-05,350,354,10,25,0.01,704,5
0.684,1e-05,397,407,10,25,0.01,804,5
0.746,1e-05,454,450,10,25,0.01,904,5
0.79,1e-05,486,518,10,25,0.01,1004,5
0.816,1e-05,537,567,10,25,0.01,1104,5
0.864,1e-05,586,618,10,25,0.01,1204,5
0.902,1e-05,642,662,10,25,0.01,1304,5
0.914,1e-05,690,714,10,25,0.01,1404,5
0.93,1e-05,742,762,10,25,0.01,1504,5
0.952,1e-05,798,806,10,25,0.01,1604,5
0.964,1e-05,847,857,10,25,0.01,1704,5
0.966,1e-05,895,909,10,25,0.01,1804,5
0.966,1e-05,946,958,10,25,0.01,1904,5
0.974,1e-05,999,1005,10,25,0.01,2004,5
0.524,1e-05,50,54,10,25,0.01,104,6
0.556,1e-05,97,107,10,25,0.01,204,6
0.572,1e-05,144,160,10,25,0.01,304,6
0.574,1e-05,192,212,10,25,0.01,404,6
0.596,1e-05,249,255,10,25,0.01,504,6
0.656,1e-05,292,312,10,25,0.01,604,6
0.708,1e-05,343,361,10,25,0.01,704,6
0.74,1e-05,393,411,10,25,0.01,804,6
0.78,1e-05,442,462,10,25,0.01,904,6
0.816,1e-05,496,508,10,25,0.01,1004,6
0.872,1e-05,545,559,10,25,0.01,1104,6
0.912,1e-05,588,616,10,25,0.01,1204,6
0.93,1e-05,646,658,10,25,0.01,1304,6
0.948,1e-05,693,711,10,25,0.01,1404,6
0.95,1e-05,742,762,10,25,0.01,1504,6
0.958,1e-05,788,816,10,25,0.01,1604,6
0.968,1e-05,846,858,10,25,0.01,1704,6
0.97,1e-05,900,904,10,25,0.01,1804,6
0.97,1e-05,963,941,10,25,0.01,1904,6
0.97,1e-05,1012,992,10,25,0.01,2004,6
0.49,1e-05,44,60,10,25,0.01,104,7
0.514,1e-05,92,112,10,25,0.01,204,7
0.536,1e-05,139,165,10,25,0.01,304,7
0.582,1e-05,176,228,10,25,0.01,404,7
0.602,1e-05,228,276,10,25,0.01,504,7
0.65,1e-05,278,326,10,25,0.01,604,7
0.694,1e-05,321,383,10,25,0.01,704,7
0.738,1e-05,366,438,10,25,0.01,804,7
0.786,1e-05,417,487,10,25,0.01,904,7
0.836,1e-05,470,534,10,25,0.01,1004,7
0.862,1e-05,532,572,10,25,0.01,1104,7
0.902,1e-05,586,618,10,25,0.01,1204,7
0.926,1e-05,640,664,10,25,0.01,1304,7
0.946,1e-05,693,711,10,25,0.01,1404,7
0.948,1e-05,747,757,10,25,0.01,1504,7
0.962,1e-05,790,814,10,25,0.01,1604,7
0.962,1e-05,838,866,10,25,0.01,1704,7
0.966,1e-05,900,904,10,25,0.01,1804,7
0.972,1e-05,954,950,10,25,0.01,1904,7
0.978,1e-05,999,1005,10,25,0.01,2004,7
0.578,1e-05,53,51,10,25,0.01,104,8
0.596,1e-05,98,106,10,25,0.01,204,8
0.604,1e-05,147,157,10,25,0.01,304,8
0.668,1e-05,187,217,10,25,0.01,404,8
0.694,1e-05,241,263,10,25,0.01,504,8
0.75,1e-05,294,310,10,25,0.01,604,8
0.762,1e-05,350,354,10,25,0.01,704,8
0.81,1e-05,395,409,10,25,0.01,804,8
0.838,1e-05,436,468,10,25,0.01,904,8
0.884,1e-05,487,517,10,25,0.01,1004,8
0.89,1e-05,538,566,10,25,0.01,1104,8
0.91,1e-05,594,610,10,25,0.01,1204,8
0.912,1e-05,649,655,10,25,0.01,1304,8
0.944,1e-05,696,708,10,25,0.01,1404,8
0.946,1e-05,750,754,10,25,0.01,1504,8
0.952,1e-05,798,806,10,25,0.01,1604,8
0.962,1e-05,846,858,10,25,0.01,1704,8
0.968,1e-05,899,905,10,25,0.01,1804,8
0.97,1e-05,945,959,10,25,0.01,1904,8
0.974,1e-05,992,1012,10,25,0.01,2004,8
0.604,1e-05,50,54,10,25,0.01,104,9
0.634,1e-05,109,95,10,25,0.01,204,9
0.646,1e-05,163,141,10,25,0.01,304,9
0.664,1e-05,213,191,10,25,0.01,404,9
0.724,1e-05,265,239,10,25,0.01,504,9
0.74,1e-05,318,286,10,25,0.01,604,9
0.72,1e-05,363,341,10,25,0.01,704,9
0.748,1e-05,412,392,10,25,0.01,804,9
0.782,1e-05,461,443,10,25,0.01,904,9
0.826,1e-05,512,492,10,25,0.01,1004,9
0.898,1e-05,564,540,10,25,0.01,1104,9
0.922,1e-05,610,594,10,25,0.01,1204,9
0.944,1e-05,659,645,10,25,0.01,1304,9
0.952,1e-05,708,696,10,25,0.01,1404,9
0.958,1e-05,768,736,10,25,0.01,1504,9
0.96,1e-05,820,784,10,25,0.01,1604,9
0.956,1e-05,866,838,10,25,0.01,1704,9
0.964,1e-05,915,889,10,25,0.01,1804,9
0.972,1e-05,965,939,10,25,0.01,1904,9
0.972,1e-05,1006,998,10,25,0.01,2004,9
0.502,1e-05,44,60,10,25,0.01,104,10
0.494,1e-05,91,113,10,25,0.01,204,10
0.562,1e-05,140,164,10,25,0.01,304,10
0.652,1e-05,190,214,10,25,0.01,404,10
0.676,1e-05,246,258,10,25,0.01,504,10
0.678,1e-05,294,310,10,25,0.01,604,10
0.712,1e-05,345,359,10,25,0.01,704,10
0.772,1e-05,390,414,10,25,0.01,804,10
0.814,1e-05,440,464,10,25,0.01,904,10
0.844,1e-05,500,504,10,25,0.01,1004,10
0.876,1e-05,554,550,10,25,0.01,1104,10
0.912,1e-05,602,602,10,25,0.01,1204,10
0.932,1e-05,653,651,10,25,0.01,1304,10
0.948,1e-05,702,702,10,25,0.01,1404,10
0.95,1e-05,760,744,10,25,0.01,1504,10
0.952,1e-05,808,796,10,25,0.01,1604,10
0.954,1e-05,857,847,10,25,0.01,1704,10
0.958,1e-05,911,893,10,25,0.01,1804,10
0.96,1e-05,957,947,10,25,0.01,1904,10
0.962,1e-05,992,1012,10,25,0.01,2004,10
0.544,1e-05,52,52,10,25,0.01,104,11
0.604,1e-05,104,100,10,25,0.01,204,11
0.638,1e-05,153,151,10,25,0.01,304,11
0.668,1e-05,210,194,10,25,0.01,404,11
0.672,1e-05,259,245,10,25,0.01,504,11
0.682,1e-05,306,298,10,25,0.01,604,11
0.71,1e-05,366,338,10,25,0.01,704,11
0.818,1e-05,408,396,10,25,0.01,804,11
0.854,1e-05,456,448,10,25,0.01,904,11
0.89,1e-05,501,503,10,25,0.01,1004,11
0.92,1e-05,541,563,10,25,0.01,1104,11
0.952,1e-05,594,610,10,25,0.01,1204,11
0.962,1e-05,642,662,10,25,0.01,1304,11
0.974,1e-05,691,713,10,25,0.01,1404,11
0.972,1e-05,740,764,10,25,0.01,1504,11
0.972,1e-05,797,807,10,25,0.01,1604,11
0.97,1e-05,846,858,10,25,0.01,1704,11
0.97,1e-05,894,910,10,25,0.01,1804,11
0.968,1e-05,939,965,10,25,0.01,1904,11
0.97,1e-05,990,1014,10,25,0.01,2004,11
0.474,1e-05,53,51,10,25,0.01,104,12
0.492,1e-05,108,96,10,25,0.01,204,12
0.5,1e-05,154,150,10,25,0.01,304,12
0.546,1e-05,202,202,10,25,0.01,404,12
0.564,1e-05,249,255,10,25,0.01,504,12
0.592,1e-05,307,297,10,25,0.01,604,12
0.618,1e-05,361,343,10,25,0.01,704,12
0.638,1e-05,410,394,10,25,0.01,804,12
0.668,1e-05,465,439,10,25,0.01,904,12
0.722,1e-05,503,501,10,25,0.01,1004,12
0.756,1e-05,555,549,10,25,0.01,1104,12
0.814,1e-05,605,599,10,25,0.01,1204,12
0.874,1e-05,659,645,10,25,0.01,1304,12
0.93,1e-05,707,697,10,25,0.01,1404,12
0.95,1e-05,756,748,10,25,0.01,1504,12
0.95,1e-05,815,789,10,25,0.01,1604,12
0.958,1e-05,858,846,10,25,0.01,1704,12
0.96,1e-05,904,900,10,25,0.01,1804,12
0.96,1e-05,960,944,10,25,0.01,1904,12
0.966,1e-05,1014,990,10,25,0.01,2004,12
0.5,1e-05,49,55,10,25,0.01,104,13
0.526,1e-05,102,102,10,25,0.01,204,13
0.552,1e-05,150,154,10,25,0.01,304,13
0.592,1e-05,200,204,10,25,0.01,404,13
0.626,1e-05,247,257,10,25,0.01,504,13
0.692,1e-05,299,305,10,25,0.01,604,13
0.76,1e-05,346,358,10,25,0.01,704,13
0.806,1e-05,400,404,10,25,0.01,804,13
0.814,1e-05,442,462,10,25,0.01,904,13
0.868,1e-05,504,500,10,25,0.01,1004,13
0.89,1e-05,552,552,10,25,0.01,1104,13
0.91,1e-05,606,598,10,25,0.01,1204,13
0.92,1e-05,658,646,10,25,0.01,1304,13
0.944,1e-05,718,686,10,25,0.01,1404,13
0.952,1e-05,764,740,10,25,0.01,1504,13
0.962,1e-05,811,793,10,25,0.01,1604,13
0.976,1e-05,862,842,10,25,0.01,1704,13
0.98,1e-05,913,891,10,25,0.01,1804,13
0.98,1e-05,960,944,10,25,0.01,1904,13
0.986,1e-05,1009,995,10,25,0.01,2004,13
0.558,1e-05,50,54,10,25,0.01,104,14
0.576,1e-05,96,108,10,25,0.01,204,14
0.58,1e-05,146,158,10,25,0.01,304,14
0.572,1e-05,200,204,10,25,0.01,404,14
0.594,1e-05,250,254,10,25,0.01,504,14
0.616,1e-05,294,310,10,25,0.01,604,14
0.69,1e-05,347,357,10,25,0.01,704,14
0.782,1e-05,391,413,10,25,0.01,804,14
0.798,1e-05,452,452,10,25,0.01,904,14
0.834,1e-05,500,504,10,25,0.01,1004,14
0.854,1e-05,544,560,10,25,0.01,1104,14
0.912,1e-05,603,601,10,25,0.01,1204,14
0.93,1e-05,645,659,10,25,0.01,1304,14
0.944,1e-05,693,711,10,25,0.01,1404,14
0.954,1e-05,746,758,10,25,0.01,1504,14
0.964,1e-05,804,800,10,25,0.01,1604,14
0.972,1e-05,852,852,10,25,0.01,1704,14
0.968,1e-05,910,894,10,25,0.01,1804,14
0.974,1e-05,952,952,10,25,0.01,1904,14
0.974,1e-05,1001,1003,10,25,0.01,2004,14
0.524,1e-05,57,47,10,25,0.01,104,15
0.57,1e-05,107,97,10,25,0.01,204,15
0.584,1e-05,157,147,10,25,0.01,304,15
0.666,1e-05,208,196,10,25,0.01,404,15
0.7,1e-05,248,256,10,25,0.01,504,15
0.738,1e-05,290,314,10,25,0.01,604,15
0.758,1e-05,330,374,10,25,0.01,704,15
0.816,1e-05,376,428,10,25,0.01,804,15
0.818,1e-05,432,472,10,25,0.01,904,15
0.888,1e-05,488,516,10,25,0.01,1004,15
0.888,1e-05,537,567,10,25,0.01,1104,15
0.914,1e-05,588,616,10,25,0.01,1204,15
0.932,1e-05,643,661,10,25,0.01,1304,15
0.942,1e-05,700,704,10,25,0.01,1404,15
0.944,1e-05,748,756,10,25,0.01,1504,15
0.958,1e-05,807,797,10,25,0.01,1604,15
0.96,1e-05,853,851,10,25,0.01,1704,15
0.97,1e-05,901,903,10,25,0.01,1804,15
0.972,1e-05,948,956,10,25,0.01,1904,15
0.974,1e-05,1003,1001,10,25,0.01,2004,15
0.508,1e-05,55,49,10,25,0.01,104,16
0.51,1e-05,100,104,10,25,0.01,204,16
0.526,1e-05,144,160,10,25,0.01,304,16
0.52,1e-05,199,205,10,25,0.01,404,16
0.536,1e-05,248,256,10,25,0.01,504,16
0.568,1e-05,299,305,10,25,0.01,604,16
0.586,1e-05,341,363,10,25,0.01,704,16
0.642,1e-05,393,411,10,25,0.01,804,16
0.668,1e-05,429,475,10,25,0.01,904,16
0.714,1e-05,478,526,10,25,0.01,1004,16
0.786,1e-05,518,586,10,25,0.01,1104,16
0.858,1e-05,574,630,10,25,0.01,1204,16
0.896,1e-05,624,680,10,25,0.01,1304,16
0.928,1e-05,667,737,10,25,0.01,1404,16
0.934,1e-05,723,781,10,25,0.01,1504,16
0.95,1e-05,785,819,10,25,0.01,1604,16
0.962,1e-05,838,866,10,25,0.01,1704,16
0.966,1e-05,893,911,10,25,0.01,1804,16
0.968,1e-05,948,956,10,25,0.01,1904,16
0.976,1e-05,1007,997,10,25,0.01,2004,16
0.576,1e-05,48,56,10,25,0.01,104,17
0.628,1e-05,90,114,10,25,0.01,204,17
0.63,1e-05,140,164,10,25,0.01,304,17
0.64,1e-05,190,214,10,25,0.01,404,17
0.654,1e-05,241,263,10,25,0.01,504,17
0.698,1e-05,289,315,10,25,0.01,604,17
0.754,1e-05,345,359,10,25,0.01,704,17
0.814,1e-05,398,406,10,25,0.01,804,17
0.832,1e-05,443,461,10,25,0.01,904,17
0.862,1e-05,496,508,10,25,0.01,1004,17
0.902,1e-05,552,552,10,25,0.01,1104,17
0.912,1e-05,600,604,10,25,0.01,1204,17
0.926,1e-05,649,655,10,25,0.01,1304,17
0.938,1e-05,702,702,10,25,0.01,1404,17
0.95,1e-05,748,756,10,25,0.01,1504,17
0.956,1e-05,793,811,10,25,0.01,1604,17
0.958,1e-05,847,857,10,25,0.01,1704,17
0.966,1e-05,910,894,10,25,0.01,1804,17
0.964,1e-05,959,945,10,25,0.01,1904,17
0.966,1e-05,1007,997,10,25,0.01,2004,17
0.524,1e-05,53,51,10,25,0.01,104,18
0.554,1e-05,103,101,10,25,0.01,204,18
0.578,1e-05,157,147,10,25,0.01,304,18
0.602,1e-05,204,200,10,25,0.01,404,18
0.616,1e-05,252,252,10,25,0.01,504,18
0.646,1e-05,298,306,10,25,0.01,604,18
0.678,1e-05,345,359,10,25,0.01,704,18
0.726,1e-05,392,412,10,25,0.01,804,18
0.744,1e-05,435,469,10,25,0.01,904,18
0.796,1e-05,490,514,10,25,0.01,1004,18
0.826,1e-05,542,562,10,25,0.01,1104,18
0.886,1e-05,589,615,10,25,0.01,1204,18
0.92,1e-05,643,661,10,25,0.01,1304,18
0.938,1e-05,692,712,10,25,0.01,1404,18
0.956,1e-05,745,759,10,25,0.01,1504,18
0.952,1e-05,803,801,10,25,0.01,1604,18
0.952,1e-05,855,849,10,25,0.01,1704,18
0.956,1e-05,897,907,10,25,0.01,1804,18
0.96,1e-05,947,957,10,25,0.01,1904,18
0.966,1e-05,1001,1003,10,25,0.01,2004,18
0.538,1e-05,53,51,10,25,0.01,104,19
0.546,1e-05,106,98,10,25,0.01,204,19
0.55,1e-05,153,151,10,25,0.01,304,19
0.604,1e-05,204,200,10,25,0.01,404,19
0.638,1e-05,255,249,10,25,0.01,504,19
0.644,1e-05,304,300,10,25,0.01,604,19
0.666,1e-05,347,357,10,25,0.01,704,19
0.722,1e-05,400,404,10,25,0.01,804,19
0.74,1e-05,444,460,10,25,0.01,904,19
0.766,1e-05,490,514,10,25,0.01,1004,19
0.784,1e-05,547,557,10,25,0.01,1104,19
0.836,1e-05,590,614,10,25,0.01,1204,19
0.872,1e-05,648,656,10,25,0.01,1304,19
0.892,1e-05,701,703,10,25,0.01,1404,19
0.926,1e-05,756,748,10,25,0.01,1504,19
0.922,1e-05,805,799,10,25,0.01,1604,19
0.936,1e-05,860,844,10,25,0.01,1704,19
0.94,1e-05,909,895,10,25,0.01,1804,19
0.944,1e-05,956,948,10,25,0.01,1904,19
0.948,1e-05,1007,997,10,25,0.01,2004,19
0.512,1e-05,53,51,10,25,0.01,104,20
0.586,1e-05,99,105,10,25,0.01,204,20
0.608,1e-05,142,162,10,25,0.01,304,20
0.648,1e-05,191,213,10,25,0.01,404,20
0.65,1e-05,236,268,10,25,0.01,504,20
0.708,1e-05,283,321,10,25,0.01,604,20
0.73,1e-05,333,371,10,25,0.01,704,20
0.772,1e-05,383,421,10,25,0.01,804,20
0.824,1e-05,439,465,10,25,0.01,904,20
0.866,1e-05,490,514,10,25,0.01,1004,20
0.892,1e-05,542,562,10,25,0.01,1104,20
0.928,1e-05,594,610,10,25,0.01,1204,20
0.932,1e-05,637,667,10,25,0.01,1304,20
0.93,1e-05,692,712,10,25,0.01,1404,20
0.942,1e-05,742,762,10,25,0.01,1504,20
0.96,1e-05,798,806,10,25,0.01,1604,20
0.964,1e-05,847,857,10,25,0.01,1704,20
0.964,1e-05,908,896,10,25,0.01,1804,20
0.97,1e-05,960,944,10,25,0.01,1904,20
0.974,1e-05,1003,1001,10,25,0.01,2004,20
0.48,0.0001,57,47,10,25,0.0001,104,1
0.48,0.0001,100,104,10,25,0.0001,204,1
0.478,0.0001,151,153,10,25,0.0001,304,1
0.478,0.0001,203,201,10,25,0.0001,404,1
0.478,0.0001,250,254,10,25,0.0001,504,1
0.476,0.0001,309,295,10,25,0.0001,604,1
0.474,0.0001,357,347,10,25,0.0001,704,1
0.476,0.0001,402,402,10,25,0.0001,804,1
0.476,0.0001,462,442,10,25,0.0001,904,1
0.474,0.0001,516,488,10,25,0.0001,1004,1
0.47,0.0001,556,548,10,25,0.0001,1104,1
0.468,0.0001,602,602,10,25,0.0001,1204,1
0.47,0.0001,651,653,10,25,0.0001,1304,1
0.472,0.0001,701,703,10,25,0.0001,1404,1
0.474,0.0001,745,759,10,25,0.0001,1504,1
0.474,0.0001,784,820,10,25,0.0001,1604,1
0.474,0.0001,838,866,10,25,0.0001,1704,1
0.476,0.0001,898,906,10,25,0.0001,1804,1
0.472,0.0001,946,958,10,25,0.0001,1904,1
0.47,0.0001,1001,1003,10,25,0.0001,2004,1
0.486,0.0001,44,60,10,25,0.0001,104,2
0.486,0.0001,87,117,10,25,0.0001,204,2
0.486,0.0001,139,165,10,25,0.0001,304,2
0.486,0.0001,191,213,10,25,0.0001,404,2
0.486,0.0001,240,264,10,25,0.0001,504,2
0.488,0.0001,301,303,10,25,0.0001,604,2
0.488,0.0001,343,361,10,25,0.0001,704,2
0.486,0.0001,398,406,10,25,0.0001,804,2
0.486,0.0001,449,455,10,25,0.0001,904,2
0.488,0.0001,498,506,10,25,0.0001,1004,2
0.492,0.0001,561,543,10,25,0.0001,1104,2
0.49,0.0001,613,591,10,25,0.0001,1204,2
0.492,0.0001,654,650,10,25,0.0001,1304,2
0.494,0.0001,699,705,10,25,0.0001,1404,2
0.496,0.0001,759,745,10,25,0.0001,1504,2
0.5,0.0001,808,796,10,25,0.0001,1604,2
0.502,0.0001,857,847,10,25,0.0001,1704,2
0.5,0.0001,912,892,10,25,0.0001,1804,2
0.496,0.0001,963,941,10,25,0.0001,1904,2
0.494,0.0001,1013,991,10,25,0.0001,2004,2
0.514,0.0001,46,58,10,25,0.0001,104,3
0.518,0.0001,89,115,10,25,0.0001,204,3
0.52,0.0001,140,164,10,25,0.0001,304,3
0.52,0.0001,191,213,10,25,0.0001,404,3
0.52,0.0001,240,264,10,25,0.0001,504,3
0.522,0.0001,292,312,10,25,0.0001,604,3
0.524,0.0001,341,363,10,25,0.0001,704,3
0.524,0.0001,389,415,10,25,0.0001,804,3
0.524,0.0001,433,471,10,25,0.0001,904,3
0.524,0.0001,476,528,10,25,0.0001,1004,3
0.526,0.0001,516,588,10,25,0.0001,1104,3
0.526,0.0001,568,636,10,25,0.0001,1204,3
0.528,0.0001,620,684,10,25,0.0001,1304,3
0.528,0.0001,661,743,10,25,0.0001,1404,3
0.532,0.0001,714,790,10,25,0.0001,1504,3
0.532,0.0001,768,836,10,25,0.0001,1604,3
0.528,0.0001,819,885,10,25,0.0001,1704,3
0.526,0.0001,878,926,10,25,0.0001,1804,3
0.53,0.0001,934,970,10,25,0.0001,1904,3
0.532,0.0001,987,1017,10,25,0.0001,2004,3
0.492,0.0001,56,48,10,25,0.0001,104,4
0.492,0.0001,111,93,10,25,0.0001,204,4
0.49,0.0001,157,147,10,25,0.0001,304,4
0.49,0.0001,201,203,10,25,0.0001,404,4
0.49,0.0001,245,259,10,25,0.0001,504,4
0.492,0.0001,297,307,10,25,0.0001,604,4
0.492,0.0001,349,355,10,25,0.0001,704,4
0.492,0.0001,400,404,10,25,0.0001,804,4
0.496,0.0001,448,456,10,25,0.0001,904,4
0.498,0.0001,499,505,10,25,0.0001,1004,4
0.496,0.0001,549,555,10,25,0.0001,1104,4
0.496,0.0001,608,596,10,25,0.0001,1204,4
0.492,0.0001,662,642,10,25,0.0001,1304,4
0.494,0.0001,713,691,10,25,0.0001,1404,4
0.496,0.0001,763,741,10,25,0.0001,1504,4
0.498,0.0001,804,800,10,25,0.0001,1604,4
0.5,0.0001,851,853,10,25,0.0001,1704,4
0.498,0.0001,907,897,10,25,0.0001,1804,4
0.498,0.0001,946,958,10,25,0.0001,1904,4
0.502,0.0001,999,1005,10,25,0.0001,2004,4
0.506,0.0001,54,50,10,25,0.0001,104,5
0.508,0.0001,101,103,10,25,0.0001,204,5
0.508,0.0001,151,153,10,25,0.0001,304,5
0.508,0.0001,203,201,10,25,0.0001,404,5
0.508,0.0001,247,257,10,25,0.0001,504,5
0.51,0.0001,294,310,10,25,0.0001,604,5
0.508,0.0001,348,356,10,25,0.0001,704,5
0.508,0.0001,392,412,10,25,0.0001,804,5
0.508,0.0001,447,457,10,25,0.0001,904,5
0.506,0.0001,502,502,10,25,0.0001,1004,5
0.506,0.0001,547,557,10,25,0.0001,1104,5
0.504,0.0001,600,604,10,25,0.0001,1204,5
0.5,0.0001,658,646,10,25,0.0001,1304,5
0.508,0.0001,707,697,10,25,0.0001,1404,5
0.51,0.0001,762,742,10,25,0.0001,1504,5
0.506,0.0001,820,784,10,25,0.0001,1604,5
0.508,0.0001,865,839,10,25,0.0001,1704,5
0.508,0.0001,909,895,10,25,0.0001,1804,5
0.506,0.0001,954,950,10,25,0.0001,1904,5
0.508,0.0001,1005,999,10,25,0.0001,2004,5
0.494,0.0001,49,55,10,25,0.0001,104,6
0.494,0.0001,95,109,10,25,0.0001,204,6
0.492,0.0001,141,163,10,25,0.0001,304,6
0.492,0.0001,185,219,10,25,0.0001,404,6
0.492,0.0001,233,271,10,25,0.0001,504,6
0.492,0.0001,287,317,10,25,0.0001,604,6
0.492,0.0001,344,360,10,25,0.0001,704,6
0.492,0.0001,394,410,10,25,0.0001,804,6
0.492,0.0001,455,449,10,25,0.0001,904,6
0.492,0.0001,505,499,10,25,0.0001,1004,6
0.492,0.0001,552,552,10,25,0.0001,1104,6
0.492,0.0001,591,613,10,25,0.0001,1204,6
0.492,0.0001,645,659,10,25,0.0001,1304,6
0.492,0.0001,686,718,10,25,0.0001,1404,6
0.494,0.0001,733,771,10,25,0.0001,1504,6
0.494,0.0001,780,824,10,25,0.0001,1604,6
0.494,0.0001,841,863,10,25,0.0001,1704,6
0.494,0.0001,894,910,10,25,0.0001,1804,6
0.498,0.0001,950,954,10,25,0.0001,1904,6
0.496,0.0001,1001,1003,10,25,0.0001,2004,6
0.458,0.0001,48,56,10,25,0.0001,104,7
0.458,0.0001,101,103,10,25,0.0001,204,7
0.458,0.0001,154,150,10,25,0.0001,304,7
0.456,0.0001,218,186,10,25,0.0001,404,7
0.454,0.0001,275,229,10,25,0.0001,504,7
0.452,0.0001,321,283,10,25,0.0001,604,7
0.454,0.0001,362,342,10,25,0.0001,704,7
0.452,0.0001,415,389,10,25,0.0001,804,7
0.448,0.0001,463,441,10,25,0.0001,904,7
0.446,0.0001,508,496,10,25,0.0001,1004,7
0.448,0.0001,546,558,10,25,0.0001,1104,7
0.448,0.0001,594,610,10,25,0.0001,1204,7
0.45,0.0001,644,660,10,25,0.0001,1304,7
0.448,0.0001,692,712,10,25,0.0001,1404,7
0.45,0.0001,748,756,10,25,0.0001,1504,7
0.45,0.0001,797,807,10,25,0.0001,1604,7
0.452,0.0001,847,857,10,25,0.0001,1704,7
0.454,0.0001,908,896,10,25,0.0001,1804,7
0.456,0.0001,961,943,10,25,0.0001,1904,7
0.46,0.0001,1006,998,10,25,0.0001,2004,7
0.51,0.0001,47,57,10,25,0.0001,104,8
0.51,0.0001,100,104,10,25,0.0001,204,8
0.51,0.0001,151,153,10,25,0.0001,304,8
0.512,0.0001,201,203,10,25,0.0001,404,8
0.514,0.0001,249,255,10,25,0.0001,504,8
0.514,0.0001,299,305,10,25,0.0001,604,8
0.514,0.0001,343,361,10,25,0.0001,704,8
0.514,0.0001,394,410,10,25,0.0001,804,8
0.514,0.0001,449,455,10,25,0.0001,904,8
0.514,0.0001,499,505,10,25,0.0001,1004,8
0.514,0.0001,547,557,10,25,0.0001,1104,8
0.514,0.0001,596,608,10,25,0.0001,1204,8
0.514,0.0001,647,657,10,25,0.0001,1304,8
0.514,0.0001,693,711,10,25,0.0001,1404,8
0.514,0.0001,745,759,10,25,0.0001,1504,8
0.514,0.0001,801,803,10,25,0.0001,1604,8
0.518,0.0001,855,849,10,25,0.0001,1704,8
0.52,0.0001,908,896,10,25,0.0001,1804,8
0.526,0.0001,956,948,10,25,0.0001,1904,8
0.528,0.0001,999,1005,10,25,0.0001,2004,8
0.586,0.0001,54,50,10,25,0.0001,104,9
0.584,0.0001,109,95,10,25,0.0001,204,9
0.586,0.0001,164,140,10,25,0.0001,304,9
0.584,0.0001,217,187,10,25,0.0001,404,9
0.586,0.0001,274,230,10,25,0.0001,504,9
0.588,0.0001,318,286,10,25,0.0001,604,9
0.588,0.0001,369,335,10,25,0.0001,704,9
0.588,0.0001,416,388,10,25,0.0001,804,9
0.588,0.0001,470,434,10,25,0.0001,904,9
0.586,0.0001,523,481,10,25,0.0001,1004,9
0.584,0.0001,572,532,10,25,0.0001,1104,9
0.584,0.0001,624,580,10,25,0.0001,1204,9
0.584,0.0001,669,635,10,25,0.0001,1304,9
0.582,0.0001,722,682,10,25,0.0001,1404,9
0.584,0.0001,772,732,10,25,0.0001,1504,9
0.58,0.0001,820,784,10,25,0.0001,1604,9
0.58,0.0001,861,843,10,25,0.0001,1704,9
0.582,0.0001,908,896,10,25,0.0001,1804,9
0.58,0.0001,950,954,10,25,0.0001,1904,9
0.576,0.0001,1007,997,10,25,0.0001,2004,9
0.474,0.0001,56,48,10,25,0.0001,104,10
0.468,0.0001,103,101,10,25,0.0001,204,10
0.466,0.0001,149,155,10,25,0.0001,304,10
0.466,0.0001,191,213,10,25,0.0001,404,10
0.466,0.0001,250,254,10,25,0.0001,504,10
0.464,0.0001,297,307,10,25,0.0001,604,10
0.462,0.0001,343,361,10,25,0.0001,704,10
0.462,0.0001,383,421,10,25,0.0001,804,10
0.464,0.0001,423,481,10,25,0.0001,904,10
0.466,0.0001,470,534,10,25,0.0001,1004,10
0.468,0.0001,510,594,10,25,0.0001,1104,10
0.472,0.0001,561,643,10,25,0.0001,1204,10
0.478,0.0001,617,687,10,25,0.0001,1304,10
0.48,0.0001,673,731,10,25,0.0001,1404,10
0.48,0.0001,720,784,10,25,0.0001,1504,10
0.48,0.0001,774,830,10,25,0.0001,1604,10
0.482,0.0001,826,878,10,25,0.0001,1704,10
0.484,0.0001,885,919,10,25,0.0001,1804,10
0.482,0.0001,937,967,10,25,0.0001,1904,10
0.484,0.0001,988,1016,10,25,0.0001,2004,10
0.534,0.0001,49,55,10,25,0.0001,104,11
0.534,0.0001,104,100,10,25,0.0001,204,11
0.534,0.0001,153,151,10,25,0.0001,304,11
0.534,0.0001,206,198,10,25,0.0001,404,11
0.532,0.0001,257,247,10,25,0.0001,504,11
0.532,0.0001,307,297,10,25,0.0001,604,11
0.532,0.0001,365,339,10,25,0.0001,704,11
0.534,0.0001,420,384,10,25,0.0001,804,11
0.536,0.0001,471,433,10,25,0.0001,904,11
0.536,0.0001,522,482,10,25,0.0001,1004,11
0.538,0.0001,573,531,10,25,0.0001,1104,11
0.54,0.0001,614,590,10,25,0.0001,1204,11
0.542,0.0001,665,639,10,25,0.0001,1304,11
0.542,0.0001,719,685,10,25,0.0001,1404,11
0.544,0.0001,769,735,10,25,0.0001,1504,11
0.546,0.0001,816,788,10,25,0.0001,1604,11
0.548,0.0001,863,841,10,25,0.0001,1704,11
0.548,0.0001,916,888,10,25,0.0001,1804,11
0.55,0.0001,960,944,10,25,0.0001,1904,11
0.55,0.0001,1009,995,10,25,0.0001,2004,11
0.474,0.0001,52,52,10,25,0.0001,104,12
0.474,0.0001,108,96,10,25,0.0001,204,12
0.47,0.0001,159,145,10,25,0.0001,304,12
0.47,0.0001,211,193,10,25,0.0001,404,12
0.47,0.0001,259,245,10,25,0.0001,504,12
0.47,0.0001,309,295,10,25,0.0001,604,12
0.472,0.0001,352,352,10,25,0.0001,704,12
0.474,0.0001,399,405,10,25,0.0001,804,12
0.478,0.0001,455,449,10,25,0.0001,904,12
0.484,0.0001,514,490,10,25,0.0001,1004,12
0.484,0.0001,554,550,10,25,0.0001,1104,12
0.488,0.0001,592,612,10,25,0.0001,1204,12
0.49,0.0001,643,661,10,25,0.0001,1304,12
0.488,0.0001,694,710,10,25,0.0001,1404,12
0.49,0.0001,747,757,10,25,0.0001,1504,12
0.49,0.0001,801,803,10,25,0.0001,1604,12
0.49,0.0001,845,859,10,25,0.0001,1704,12
0.49,0.0001,893,911,10,25,0.0001,1804,12
0.49,0.0001,942,962,10,25,0.0001,1904,12
0.486,0.0001,991,1013,10,25,0.0001,2004,12
0.454,0.0001,47,57,10,25,0.0001,104,13
0.454,0.0001,91,113,10,25,0.0001,204,13
0.454,0.0001,145,159,10,25,0.0001,304,13
0.458,0.0001,192,212,10,25,0.0001,404,13
0.46,0.0001,235,269,10,25,0.0001,504,13
0.46,0.0001,273,331,10,25,0.0001,604,13
0.458,0.0001,327,377,10,25,0.0001,704,13
0.458,0.0001,382,422,10,25,0.0001,804,13
0.456,0.0001,431,473,10,25,0.0001,904,13
0.46,0.0001,476,528,10,25,0.0001,1004,13
0.466,0.0001,531,573,10,25,0.0001,1104,13
0.468,0.0001,579,625,10,25,0.0001,1204,13
0.466,0.0001,627,677,10,25,0.0001,1304,13
0.464,0.0001,682,722,10,25,0.0001,1404,13
0.466,0.0001,729,775,10,25,0.0001,1504,13
0.468,0.0001,775,829,10,25,0.0001,1604,13
0.476,0.0001,831,873,10,25,0.0001,1704,13
0.476,0.0001,880,924,10,25,0.0001,1804,13
0.474,0.0001,928,976,10,25,0.0001,1904,13
0.472,0.0001,984,1020,10,25,0.0001,2004,13
0.398,0.0001,46,58,10,25,0.0001,104,14
0.396,0.0001,90,114,10,25,0.0001,204,14
0.394,0.0001,146,158,10,25,0.0001,304,14
0.394,0.0001,197,207,10,25,0.0001,404,14
0.394,0.0001,253,251,10,25,0.0001,504,14
0.394,0.0001,302,302,10,25,0.0001,604,14
0.396,0.0001,352,352,10,25,0.0001,704,14
0.398,0.0001,400,404,10,25,0.0001,804,14
0.396,0.0001,448,456,10,25,0.0001,904,14
0.396,0.0001,493,511,10,25,0.0001,1004,14
0.398,0.0001,553,551,10,25,0.0001,1104,14
0.402,0.0001,608,596,10,25,0.0001,1204,14
0.402,0.0001,657,647,10,25,0.0001,1304,14
0.404,0.0001,703,701,10,25,0.0001,1404,14
0.406,0.0001,751,753,10,25,0.0001,1504,14
0.406,0.0001,807,797,10,25,0.0001,1604,14
0.41,0.0001,855,849,10,25,0.0001,1704,14
0.408,0.0001,908,896,10,25,0.0001,1804,14
0.408,0.0001,957,947,10,25,0.0001,1904,14
0.414,0.0001,1001,1003,10,25,0.0001,2004,14
0.484,0.0001,50,54,10,25,0.0001,104,15
0.484,0.0001,102,102,10,25,0.0001,204,15
0.484,0.0001,151,153,10,25,0.0001,304,15
0.484,0.0001,195,209,10,25,0.0001,404,15
0.484,0.0001,246,258,10,25,0.0001,504,15
0.486,0.0001,302,302,10,25,0.0001,604,15
0.484,0.0001,354,350,10,25,0.0001,704,15
0.484,0.0001,404,400,10,25,0.0001,804,15
0.492,0.0001,451,453,10,25,0.0001,904,15
0.49,0.0001,501,503,10,25,0.0001,1004,15
0.488,0.0001,557,547,10,25,0.0001,1104,15
0.49,0.0001,608,596,10,25,0.0001,1204,15
0.492,0.0001,650,654,10,25,0.0001,1304,15
0.496,0.0001,705,699,10,25,0.0001,1404,15
0.5,0.0001,749,755,10,25,0.0001,1504,15
0.506,0.0001,803,801,10,25,0.0001,1604,15
0.508,0.0001,859,845,10,25,0.0001,1704,15
0.508,0.0001,909,895,10,25,0.0001,1804,15
0.508,0.0001,947,957,10,25,0.0001,1904,15
0.512,0.0001,998,1006,10,25,0.0001,2004,15
0.528,0.0001,55,49,10,25,0.0001,104,16
0.532,0.0001,110,94,10,25,0.0001,204,16
0.532,0.0001,157,147,10,25,0.0001,304,16
0.532,0.0001,215,189,10,25,0.0001,404,16
0.532,0.0001,263,241,10,25,0.0001,504,16
0.53,0.0001,311,293,10,25,0.0001,604,16
0.53,0.0001,364,340,10,25,0.0001,704,16
0.532,0.0001,415,389,10,25,0.0001,804,16
0.532,0.0001,461,443,10,25,0.0001,904,16
0.532,0.0001,512,492,10,25,0.0001,1004,16
0.532,0.0001,569,535,10,25,0.0001,1104,16
0.534,0.0001,619,585,10,25,0.0001,1204,16
0.538,0.0001,669,635,10,25,0.0001,1304,16
0.536,0.0001,721,683,10,25,0.0001,1404,16
0.536,0.0001,764,740,10,25,0.0001,1504,16
0.538,0.0001,815,789,10,25,0.0001,1604,16
0.538,0.0001,859,845,10,25,0.0001,1704,16
0.538,0.0001,911,893,10,25,0.0001,1804,16
0.538,0.0001,960,944,10,25,0.0001,1904,16
0.54,0.0001,1011,993,10,25,0.0001,2004,16
0.47,0.0001,51,53,10,25,0.0001,104,17
0.47,0.0001,102,102,10,25,0.0001,204,17
0.47,0.0001,153,151,10,25,0.0001,304,17
0.47,0.0001,202,202,10,25,0.0001,404,17
0.468,0.0001,253,251,10,25,0.0001,504,17
0.47,0.0001,305,299,10,25,0.0001,604,17
0.47,0.0001,366,338,10,25,0.0001,704,17
0.468,0.0001,408,396,10,25,0.0001,804,17
0.47,0.0001,458,446,10,25,0.0001,904,17
0.47,0.0001,512,492,10,25,0.0001,1004,17
0.474,0.0001,559,545,10,25,0.0001,1104,17
0.472,0.0001,612,592,10,25,0.0001,1204,17
0.47,0.0001,665,639,10,25,0.0001,1304,17
0.472,0.0001,719,685,10,25,0.0001,1404,17
0.472,0.0001,762,742,10,25,0.0001,1504,17
0.472,0.0001,804,800,10,25,0.0001,1604,17
0.474,0.0001,853,851,10,25,0.0001,1704,17
0.474,0.0001,905,899,10,25,0.0001,1804,17
0.48,0.0001,961,943,10,25,0.0001,1904,17
0.484,0.0001,1011,993,10,25,0.0001,2004,17
0.484,0.0001,43,61,10,25,0.0001,104,18
0.484,0.0001,92,112,10,25,0.0001,204,18
0.484,0.0001,139,165,10,25,0.0001,304,18
0.484,0.0001,181,223,10,25,0.0001,404,18
0.486,0.0001,227,277,10,25,0.0001,504,18
0.486,0.0001,282,322,10,25,0.0001,604,18
0.488,0.0001,333,371,10,25,0.0001,704,18
0.49,0.0001,379,425,10,25,0.0001,804,18
0.49,0.0001,437,467,10,25,0.0001,904,18
0.494,0.0001,496,508,10,25,0.0001,1004,18
0.492,0.0001,553,551,10,25,0.0001,1104,18
0.492,0.0001,596,608,10,25,0.0001,1204,18
0.496,0.0001,646,658,10,25,0.0001,1304,18
0.502,0.0001,701,703,10,25,0.0001,1404,18
0.502,0.0001,756,748,10,25,0.0001,1504,18
0.508,0.0001,801,803,10,25,0.0001,1604,18
0.512,0.0001,857,847,10,25,0.0001,1704,18
0.512,0.0001,910,894,10,25,0.0001,1804,18
0.514,0.0001,960,944,10,25,0.0001,1904,18
0.514,0.0001,1008,996,10,25,0.0001,2004,18
0.52,0.0001,51,53,10,25,0.0001,104,19
0.52,0.0001,113,91,10,25,0.0001,204,19
0.52,0.0001,157,147,10,25,0.0001,304,19
0.52,0.0001,216,188,10,25,0.0001,404,19
0.52,0.0001,267,237,10,25,0.0001,504,19
0.52,0.0001,319,285,10,25,0.0001,604,19
0.52,0.0001,371,333,10,25,0.0001,704,19
0.52,0.0001,424,380,10,25,0.0001,804,19
0.52,0.0001,465,439,10,25,0.0001,904,19
0.522,0.0001,512,492,10,25,0.0001,1004,19
0.522,0.0001,566,538,10,25,0.0001,1104,19
0.522,0.0001,615,589,10,25,0.0001,1204,19
0.524,0.0001,665,639,10,25,0.0001,1304,19
0.528,0.0001,712,692,10,25,0.0001,1404,19
0.53,0.0001,758,746,10,25,0.0001,1504,19
0.53,0.0001,805,799,10,25,0.0001,1604,19
0.53,0.0001,854,850,10,25,0.0001,1704,19
0.524,0.0001,910,894,10,25,0.0001,1804,19
0.526,0.0001,962,942,10,25,0.0001,1904,19
0.53,0.0001,1009,995,10,25,0.0001,2004,19
0.472,0.0001,50,54,10,25,0.0001,104,20
0.472,0.0001,100,104,10,25,0.0001,204,20
0.47,0.0001,151,153,10,25,0.0001,304,20
0.47,0.0001,199,205,10,25,0.0001,404,20
0.472,0.0001,258,246,10,25,0.0001,504,20
0.472,0.0001,310,294,10,25,0.0001,604,20
0.472,0.0001,364,340,10,25,0.0001,704,20
0.472,0.0001,418,386,10,25,0.0001,804,20
0.468,0.0001,467,437,10,25,0.0001,904,20
0.468,0.0001,520,484,10,25,0.0001,1004,20
0.468,0.0001,566,538,10,25,0.0001,1104,20
0.468,0.0001,614,590,10,25,0.0001,1204,20
0.468,0.0001,674,630,10,25,0.0001,1304,20
0.472,0.0001,721,683,10,25,0.0001,1404,20
0.474,0.0001,770,734,10,25,0.0001,1504,20
0.474,0.0001,815,789,10,25,0.0001,1604,20
0.474,0.0001,860,844,10,25,0.0001,1704,20
0.478,0.0001,905,899,10,25,0.0001,1804,20
0.478,0.0001,958,946,10,25,0.0001,1904,20
0.48,0.0001,1004,1000,10,25,0.0001,2004,20
0.488,0.0001,52,52,10,25,0.001,104,1
0.488,0.0001,95,109,10,25,0.001,204,1
0.488,0.0001,144,160,10,25,0.001,304,1
0.486,0.0001,198,206,10,25,0.001,404,1
0.49,0.0001,247,257,10,25,0.001,504,1
0.488,0.0001,292,312,10,25,0.001,604,1
0.486,0.0001,347,357,10,25,0.001,704,1
0.49,0.0001,399,405,10,25,0.001,804,1
0.492,0.0001,446,458,10,25,0.001,904,1
0.5,0.0001,490,514,10,25,0.001,1004,1
0.502,0.0001,539,565,10,25,0.001,1104,1
0.52,0.0001,594,610,10,25,0.001,1204,1
0.538,0.0001,646,658,10,25,0.001,1304,1
0.556,0.0001,692,712,10,25,0.001,1404,1
0.558,0.0001,743,761,10,25,0.001,1504,1
0.56,0.0001,800,804,10,25,0.001,1604,1
0.566,0.0001,855,849,10,25,0.001,1704,1
0.592,0.0001,906,898,10,25,0.001,1804,1
0.61,0.0001,946,958,10,25,0.001,1904,1
0.618,0.0001,996,1008,10,25,0.001,2004,1
0.49,0.0001,49,55,10,25,0.001,104,2
0.492,0.0001,94,110,10,25,0.001,204,2
0.5,0.0001,145,159,10,25,0.001,304,2
0.5,0.0001,189,215,10,25,0.001,404,2
0.5,0.0001,247,257,10,25,0.001,504,2
0.502,0.0001,305,299,10,25,0.001,604,2
0.506,0.0001,344,360,10,25,0.001,704,2
0.518,0.0001,398,406,10,25,0.001,804,2
0.526,0.0001,445,459,10,25,0.001,904,2
0.53,0.0001,501,503,10,25,0.001,1004,2
0.536,0.0001,557,547,10,25,0.001,1104,2
0.554,0.0001,609,595,10,25,0.001,1204,2
0.564,0.0001,658,646,10,25,0.001,1304,2
0.584,0.0001,710,694,10,25,0.001,1404,2
0.596,0.0001,761,743,10,25,0.001,1504,2
0.614,0.0001,807,797,10,25,0.001,1604,2
0.628,0.0001,858,846,10,25,0.001,1704,2
0.652,0.0001,914,890,10,25,0.001,1804,2
0.696,0.0001,961,943,10,25,0.001,1904,2
0.724,0.0001,1017,987,10,25,0.001,2004,2
0.52,0.0001,48,56,10,25,0.001,104,3
0.518,0.0001,94,110,10,25,0.001,204,3
0.524,0.0001,146,158,10,25,0.001,304,3
0.522,0.0001,202,202,10,25,0.001,404,3
0.524,0.0001,250,254,10,25,0.001,504,3
0.528,0.0001,301,303,10,25,0.001,604,3
0.53,0.0001,348,356,10,25,0.001,704,3
0.53,0.0001,397,407,10,25,0.001,804,3
0.532,0.0001,444,460,10,25,0.001,904,3
0.536,0.0001,504,500,10,25,0.001,1004,3
0.542,0.0001,559,545,10,25,0.001,1104,3
0.546,0.0001,612,592,10,25,0.001,1204,3
0.556,0.0001,659,645,10,25,0.001,1304,3
0.572,0.0001,701,703,10,25,0.001,1404,3
0.584,0.0001,757,747,10,25,0.001,1504,3
0.604,0.0001,799,805,10,25,0.001,1604,3
0.622,0.0001,849,855,10,25,0.001,1704,3
0.642,0.0001,898,906,10,25,0.001,1804,3
0.662,0.0001,955,949,10,25,0.001,1904,3
0.702,0.0001,1007,997,10,25,0.001,2004,3
0.488,0.0001,54,50,10,25,0.001,104,4
0.494,0.0001,106,98,10,25,0.001,204,4
0.5,0.0001,159,145,10,25,0.001,304,4
0.506,0.0001,205,199,10,25,0.001,404,4
0.518,0.0001,249,255,10,25,0.001,504,4
0.522,0.0001,295,309,10,25,0.001,604,4
0.522,0.0001,344,360,10,25,0.001,704,4
0.526,0.0001,394,410,10,25,0.001,804,4
0.528,0.0001,439,465,10,25,0.001,904,4
0.534,0.0001,482,522,10,25,0.001,1004,4
0.544,0.0001,538,566,10,25,0.001,1104,4
0.558,0.0001,588,616,10,25,0.001,1204,4
0.57,0.0001,630,674,10,25,0.001,1304,4
0.584,0.0001,687,717,10,25,0.001,1404,4
0.586,0.0001,739,765,10,25,0.001,1504,4
0.602,0.0001,794,810,10,25,0.001,1604,4
0.616,0.0001,841,863,10,25,0.001,1704,4
0.63,0.0001,890,914,10,25,0.001,1804,4
0.654,0.0001,944,960,10,25,0.001,1904,4
0.668,0.0001,997,1007,10,25,0.001,2004,4
0.5,0.0001,56,48,10,25,0.001,104,5
0.5,0.0001,103,101,10,25,0.001,204,5
0.51,0.0001,155,149,10,25,0.001,304,5
0.512,0.0001,209,195,10,25,0.001,404,5
0.514,0.0001,262,242,10,25,0.001,504,5
0.522,0.0001,306,298,10,25,0.001,604,5
0.53,0.0001,352,352,10,25,0.001,704,5
0.54,0.0001,402,402,10,25,0.001,804,5
0.544,0.0001,449,455,10,25,0.001,904,5
0.554,0.0001,501,503,10,25,0.001,1004,5
0.566,0.0001,549,555,10,25,0.001,1104,5
0.586,0.0001,594,610,10,25,0.001,1204,5
0.596,0.0001,646,658,10,25,0.001,1304,5
0.618,0.0001,701,703,10,25,0.001,1404,5
0.638,0.0001,747,757,10,25,0.001,1504,5
0.65,0.0001,806,798,10,25,0.001,1604,5
0.646,0.0001,852,852,10,25,0.001,1704,5
0.66,0.0001,894,910,10,25,0.001,1804,5
0.674,0.0001,939,965,10,25,0.001,1904,5
0.7,0.0001,991,1013,10,25,0.001,2004,5
0.508,0.0001,53,51,10,25,0.001,104,6
0.508,0.0001,99,105,10,25,0.001,204,6
0.51,0.0001,143,161,10,25,0.001,304,6
0.51,0.0001,197,207,10,25,0.001,404,6
0.51,0.0001,248,256,10,25,0.001,504,6
0.514,0.0001,301,303,10,25,0.001,604,6
0.526,0.0001,345,359,10,25,0.001,704,6
0.53,0.0001,390,414,10,25,0.001,804,6
0.546,0.0001,440,464,10,25,0.001,904,6
0.554,0.0001,485,519,10,25,0.001,1004,6
0.566,0.0001,532,572,10,25,0.001,1104,6
0.572,0.0001,587,617,10,25,0.001,1204,6
0.59,0.0001,648,656,10,25,0.001,1304,6
0.632,0.0001,699,705,10,25,0.001,1404,6
0.648,0.0001,750,754,10,25,0.001,1504,6
0.666,0.0001,803,801,10,25,0.001,1604,6
0.704,0.0001,853,851,10,25,0.001,1704,6
0.732,0.0001,908,896,10,25,0.001,1804,6
0.754,0.0001,964,940,10,25,0.001,1904,6
0.79,0.0001,1014,990,10,25,0.001,2004,6
0.49,0.0001,58,46,10,25,0.001,104,7
0.494,0.0001,108,96,10,25,0.001,204,7
0.494,0.0001,149,155,10,25,0.001,304,7
0.492,0.0001,191,213,10,25,0.001,404,7
0.496,0.0001,241,263,10,25,0.001,504,7
0.486,0.0001,294,310,10,25,0.001,604,7
0.488,0.0001,345,359,10,25,0.001,704,7
0.49,0.0001,397,407,10,25,0.001,804,7
0.49,0.0001,447,457,10,25,0.001,904,7
0.506,0.0001,500,504,10,25,0.001,1004,7
0.506,0.0001,543,561,10,25,0.001,1104,7
0.508,0.0001,603,601,10,25,0.001,1204,7
0.512,0.0001,648,656,10,25,0.001,1304,7
0.522,0.0001,703,701,10,25,0.001,1404,7
0.558,0.0001,754,750,10,25,0.001,1504,7
0.594,0.0001,807,797,10,25,0.001,1604,7
0.638,0.0001,847,857,10,25,0.001,1704,7
0.682,0.0001,897,907,10,25,0.001,1804,7
0.704,0.0001,948,956,10,25,0.001,1904,7
0.748,0.0001,998,1006,10,25,0.001,2004,7
0.5,0.0001,54,50,10,25,0.001,104,8
0.51,0.0001,101,103,10,25,0.001,204,8
0.518,0.0001,150,154,10,25,0.001,304,8
0.518,0.0001,197,207,10,25,0.001,404,8
0.53,0.0001,243,261,10,25,0.001,504,8
0.536,0.0001,295,309,10,25,0.001,604,8
0.542,0.0001,342,362,10,25,0.001,704,8
0.546,0.0001,393,411,10,25,0.001,804,8
0.562,0.0001,443,461,10,25,0.001,904,8
0.582,0.0001,490,514,10,25,0.001,1004,8
0.604,0.0001,545,559,10,25,0.001,1104,8
0.614,0.0001,593,611,10,25,0.001,1204,8
0.622,0.0001,640,664,10,25,0.001,1304,8
0.63,0.0001,693,711,10,25,0.001,1404,8
0.646,0.0001,737,767,10,25,0.001,1504,8
0.656,0.0001,788,816,10,25,0.001,1604,8
0.662,0.0001,827,877,10,25,0.001,1704,8
0.678,0.0001,878,926,10,25,0.001,1804,8
0.698,0.0001,929,975,10,25,0.001,1904,8
0.716,0.0001,993,1011,10,25,0.001,2004,8
0.49,0.0001,51,53,10,25,0.001,104,9
0.49,0.0001,97,107,10,25,0.001,204,9
0.494,0.0001,143,161,10,25,0.001,304,9
0.504,0.0001,192,212,10,25,0.001,404,9
0.512,0.0001,240,264,10,25,0.001,504,9
0.518,0.0001,291,313,10,25,0.001,604,9
0.522,0.0001,342,362,10,25,0.001,704,9
0.522,0.0001,390,414,10,25,0.001,804,9
0.544,0.0001,432,472,10,25,0.001,904,9
0.546,0.0001,471,533,10,25,0.001,1004,9
0.548,0.0001,522,582,10,25,0.001,1104,9
0.558,0.0001,568,636,10,25,0.001,1204,9
0.574,0.0001,623,681,10,25,0.001,1304,9
0.59,0.0001,678,726,10,25,0.001,1404,9
0.596,0.0001,727,777,10,25,0.001,1504,9
0.614,0.0001,778,826,10,25,0.001,1604,9
0.632,0.0001,835,869,10,25,0.001,1704,9
0.648,0.0001,892,912,10,25,0.001,1804,9
0.666,0.0001,944,960,10,25,0.001,1904,9
0.694,0.0001,992,1012,10,25,0.001,2004,9
0.472,0.0001,51,53,10,25,0.001,104,10
0.474,0.0001,101,103,10,25,0.001,204,10
0.47,0.0001,151,153,10,25,0.001,304,10
0.474,0.0001,202,202,10,25,0.001,404,10
0.472,0.0001,258,246,10,25,0.001,504,10
0.482,0.0001,301,303,10,25,0.001,604,10
0.484,0.0001,347,357,10,25,0.001,704,10
0.484,0.0001,398,406,10,25,0.001,804,10
0.482,0.0001,451,453,10,25,0.001,904,10
0.486,0.0001,504,500,10,25,0.001,1004,10
0.498,0.0001,551,553,10,25,0.001,1104,10
0.506,0.0001,594,610,10,25,0.001,1204,10
0.518,0.0001,649,655,10,25,0.001,1304,10
0.542,0.0001,706,698,10,25,0.001,1404,10
0.554,0.0001,749,755,10,25,0.001,1504,10
0.564,0.0001,802,802,10,25,0.001,1604,10
0.592,0.0001,849,855,10,25,0.001,1704,10
0.61,0.0001,901,903,10,25,0.001,1804,10
0.632,0.0001,953,951,10,25,0.001,1904,10
0.658,0.0001,1006,998,10,25,0.001,2004,10
0.464,0.0001,52,52,10,25,0.001,104,11
0.464,0.0001,107,97,10,25,0.001,204,11
0.466,0.0001,147,157,10,25,0.001,304,11
0.47,0.0001,193,211,10,25,0.001,404,11
0.482,0.0001,242,262,10,25,0.001,504,11
0.498,0.0001,292,312,10,25,0.001,604,11
0.502,0.0001,335,369,10,25,0.001,704,11
0.514,0.0001,388,416,10,25,0.001,804,11
0.534,0.0001,442,462,10,25,0.001,904,11
0.542,0.0001,508,496,10,25,0.001,1004,11
0.558,0.0001,559,545,10,25,0.001,1104,11
0.564,0.0001,606,598,10,25,0.001,1204,11
0.582,0.0001,658,646,10,25,0.001,1304,11
0.598,0.0001,699,705,10,25,0.001,1404,11
0.608,0.0001,745,759,10,25,0.001,1504,11
0.63,0.0001,790,814,10,25,0.001,1604,11
0.662,0.0001,836,868,10,25,0.001,1704,11
0.682,0.0001,894,910,10,25,0.001,1804,11
0.698,0.0001,944,960,10,25,0.001,1904,11
0.708,0.0001,998,1006,10,25,0.001,2004,11
0.464,0.0001,54,50,10,25,0.001,104,12
0.472,0.0001,108,96,10,25,0.001,204,12
0.47,0.0001,152,152,10,25,0.001,304,12
0.47,0.0001,196,208,10,25,0.001,404,12
0.474,0.0001,246,258,10,25,0.001,504,12
0.484,0.0001,297,307,10,25,0.001,604,12
0.482,0.0001,348,356,10,25,0.001,704,12
0.488,0.0001,399,405,10,25,0.001,804,12
0.496,0.0001,444,460,10,25,0.001,904,12
0.498,0.0001,492,512,10,25,0.001,1004,12
0.504,0.0001,549,555,10,25,0.001,1104,12
0.518,0.0001,598,606,10,25,0.001,1204,12
0.55,0.0001,639,665,10,25,0.001,1304,12
0.57,0.0001,693,711,10,25,0.001,1404,12
0.58,0.0001,744,760,10,25,0.001,1504,12
0.602,0.0001,800,804,10,25,0.001,1604,12
0.624,0.0001,846,858,10,25,0.001,1704,12
0.648,0.0001,886,918,10,25,0.001,1804,12
0.658,0.0001,938,966,10,25,0.001,1904,12
0.682,0.0001,995,1009,10,25,0.001,2004,12
0.486,0.0001,52,52,10,25,0.001,104,13
0.482,0.0001,105,99,10,25,0.001,204,13
0.48,0.0001,158,146,10,25,0.001,304,13
0.484,0.0001,214,190,10,25,0.001,404,13
0.484,0.0001,260,244,10,25,0.001,504,13
0.492,0.0001,314,290,10,25,0.001,604,13
0.496,0.0001,357,347,10,25,0.001,704,13
0.496,0.0001,404,400,10,25,0.001,804,13
0.51,0.0001,461,443,10,25,0.001,904,13
0.516,0.0001,518,486,10,25,0.001,1004,13
0.528,0.0001,564,540,10,25,0.001,1104,13
0.538,0.0001,617,587,10,25,0.001,1204,13
0.548,0.0001,664,640,10,25,0.001,1304,13
0.566,0.0001,710,694,10,25,0.001,1404,13
0.582,0.0001,761,743,10,25,0.001,1504,13
0.598,0.0001,808,796,10,25,0.001,1604,13
0.608,0.0001,864,840,10,25,0.001,1704,13
0.632,0.0001,908,896,10,25,0.001,1804,13
0.652,0.0001,961,943,10,25,0.001,1904,13
0.664,0.0001,1012,992,10,25,0.001,2004,13
0.504,0.0001,43,61,10,25,0.001,104,14
0.512,0.0001,97,107,10,25,0.001,204,14
0.51,0.0001,139,165,10,25,0.001,304,14
0.514,0.0001,199,205,10,25,0.001,404,14
0.508,0.0001,249,255,10,25,0.001,504,14
0.506,0.0001,301,303,10,25,0.001,604,14
0.52,0.0001,349,355,10,25,0.001,704,14
0.53,0.0001,396,408,10,25,0.001,804,14
0.544,0.0001,445,459,10,25,0.001,904,14
0.56,0.0001,489,515,10,25,0.001,1004,14
0.568,0.0001,546,558,10,25,0.001,1104,14
0.58,0.0001,602,602,10,25,0.001,1204,14
0.584,0.0001,645,659,10,25,0.001,1304,14
0.59,0.0001,704,700,10,25,0.001,1404,14
0.6,0.0001,751,753,10,25,0.001,1504,14
0.608,0.0001,805,799,10,25,0.001,1604,14
0.616,0.0001,851,853,10,25,0.001,1704,14
0.638,0.0001,894,910,10,25,0.001,1804,14
0.65,0.0001,939,965,10,25,0.001,1904,14
0.654,0.0001,995,1009,10,25,0.001,2004,14
0.494,0.0001,49,55,10,25,0.001,104,15
0.498,0.0001,100,104,10,25,0.001,204,15
0.496,0.0001,154,150,10,25,0.001,304,15
0.502,0.0001,197,207,10,25,0.001,404,15
0.508,0.0001,244,260,10,25,0.001,504,15
0.52,0.0001,296,308,10,25,0.001,604,15
0.53,0.0001,352,352,10,25,0.001,704,15
0.536,0.0001,404,400,10,25,0.001,804,15
0.54,0.0001,459,445,10,25,0.001,904,15
0.558,0.0001,511,493,10,25,0.001,1004,15
0.578,0.0001,554,550,10,25,0.001,1104,15
0.592,0.0001,603,601,10,25,0.001,1204,15
0.6,0.0001,658,646,10,25,0.001,1304,15
0.592,0.0001,712,692,10,25,0.001,1404,15
0.616,0.0001,751,753,10,25,0.001,1504,15
0.622,0.0001,797,807,10,25,0.001,1604,15
0.648,0.0001,850,854,10,25,0.001,1704,15
0.664,0.0001,909,895,10,25,0.001,1804,15
0.678,0.0001,956,948,10,25,0.001,1904,15
0.676,0.0001,1004,1000,10,25,0.001,2004,15
0.496,0.0001,51,53,10,25,0.001,104,16
0.494,0.0001,101,103,10,25,0.001,204,16
0.496,0.0001,153,151,10,25,0.001,304,16
0.496,0.0001,201,203,10,25,0.001,404,16
0.496,0.0001,255,249,10,25,0.001,504,16
0.492,0.0001,302,302,10,25,0.001,604,16
0.494,0.0001,353,351,10,25,0.001,704,16
0.516,0.0001,406,398,10,25,0.001,804,16
0.518,0.0001,459,445,10,25,0.001,904,16
0.526,0.0001,503,501,10,25,0.001,1004,16
0.538,0.0001,558,546,10,25,0.001,1104,16
0.552,0.0001,608,596,10,25,0.001,1204,16
0.554,0.0001,654,650,10,25,0.001,1304,16
0.576,0.0001,704,700,10,25,0.001,1404,16
0.586,0.0001,756,748,10,25,0.001,1504,16
0.6,0.0001,807,797,10,25,0.001,1604,16
0.612,0.0001,854,850,10,25,0.001,1704,16
0.634,0.0001,908,896,10,25,0.001,1804,16
0.642,0.0001,965,939,10,25,0.001,1904,16
0.674,0.0001,1015,989,10,25,0.001,2004,16
0.556,0.0001,52,52,10,25,0.001,104,17
0.558,0.0001,101,103,10,25,0.001,204,17
0.558,0.0001,151,153,10,25,0.001,304,17
0.566,0.0001,203,201,10,25,0.001,404,17
0.566,0.0001,245,259,10,25,0.001,504,17
0.576,0.0001,288,316,10,25,0.001,604,17
0.586,0.0001,342,362,10,25,0.001,704,17
0.596,0.0001,385,419,10,25,0.001,804,17
0.606,0.0001,427,477,10,25,0.001,904,17
0.614,0.0001,480,524,10,25,0.001,1004,17
0.614,0.0001,530,574,10,25,0.001,1104,17
0.648,0.0001,583,621,10,25,0.001,1204,17
0.666,0.0001,637,667,10,25,0.001,1304,17
0.68,0.0001,688,716,10,25,0.001,1404,17
0.688,0.0001,741,763,10,25,0.001,1504,17
0.7,0.0001,791,813,10,25,0.001,1604,17
0.726,0.0001,847,857,10,25,0.001,1704,17
0.744,0.0001,898,906,10,25,0.001,1804,17
0.76,0.0001,951,953,10,25,0.001,1904,17
0.772,0.0001,1007,997,10,25,0.001,2004,17
0.468,0.0001,50,54,10,25,0.001,104,18
0.474,0.0001,99,105,10,25,0.001,204,18
0.47,0.0001,148,156,10,25,0.001,304,18
0.464,0.0001,190,214,10,25,0.001,404,18
0.47,0.0001,236,268,10,25,0.001,504,18
0.464,0.0001,295,309,10,25,0.001,604,18
0.47,0.0001,347,357,10,25,0.001,704,18
0.478,0.0001,400,404,10,25,0.001,804,18
0.484,0.0001,448,456,10,25,0.001,904,18
0.496,0.0001,502,502,10,25,0.001,1004,18
0.506,0.0001,550,554,10,25,0.001,1104,18
0.524,0.0001,599,605,10,25,0.001,1204,18
0.528,0.0001,649,655,10,25,0.001,1304,18
0.532,0.0001,697,707,10,25,0.001,1404,18
0.548,0.0001,749,755,10,25,0.001,1504,18
0.568,0.0001,803,801,10,25,0.001,1604,18
0.572,0.0001,857,847,10,25,0.001,1704,18
0.588,0.0001,909,895,10,25,0.001,1804,18
0.598,0.0001,966,938,10,25,0.001,1904,18
0.618,0.0001,1014,990,10,25,0.001,2004,18
0.462,0.0001,60,44,10,25,0.001,104,19
0.468,0.0001,122,82,10,25,0.001,204,19
0.468,0.0001,179,125,10,25,0.001,304,19
0.466,0.0001,227,177,10,25,0.001,404,19
0.468,0.0001,270,234,10,25,0.001,504,19
0.464,0.0001,321,283,10,25,0.001,604,19
0.47,0.0001,378,326,10,25,0.001,704,19
0.472,0.0001,424,380,10,25,0.001,804,19
0.478,0.0001,472,432,10,25,0.001,904,19
0.492,0.0001,519,485,10,25,0.001,1004,19
0.498,0.0001,571,533,10,25,0.001,1104,19
0.502,0.0001,612,592,10,25,0.001,1204,19
0.518,0.0001,664,640,10,25,0.001,1304,19
0.54,0.0001,707,697,10,25,0.001,1404,19
0.55,0.0001,760,744,10,25,0.001,1504,19
0.572,0.0001,806,798,10,25,0.001,1604,19
0.576,0.0001,858,846,10,25,0.001,1704,19
0.6,0.0001,911,893,10,25,0.001,1804,19
0.616,0.0001,956,948,10,25,0.001,1904,19
0.634,0.0001,1001,1003,10,25,0.001,2004,19
0.49,0.0001,56,48,10,25,0.001,104,20
0.49,0.0001,107,97,10,25,0.001,204,20
0.486,0.0001,158,146,10,25,0.001,304,20
0.49,0.0001,212,192,10,25,0.001,404,20
0.494,0.0001,262,242,10,25,0.001,504,20
0.504,0.0001,305,299,10,25,0.001,604,20
0.506,0.0001,351,353,10,25,0.001,704,20
0.512,0.0001,396,408,10,25,0.001,804,20
0.518,0.0001,452,452,10,25,0.001,904,20
0.526,0.0001,502,502,10,25,0.001,1004,20
0.534,0.0001,554,550,10,25,0.001,1104,20
0.554,0.0001,606,598,10,25,0.001,1204,20
0.562,0.0001,655,649,10,25,0.001,1304,20
0.574,0.0001,713,691,10,25,0.001,1404,20
0.586,0.0001,766,738,10,25,0.001,1504,20
0.602,0.0001,818,786,10,25,0.001,1604,20
0.63,0.0001,870,834,10,25,0.001,1704,20
0.644,0.0001,916,888,10,25,0.001,1804,20
0.662,0.0001,964,940,10,25,0.001,1904,20
0.702,0.0001,1007,997,10,25,0.001,2004,20
0.456,0.0001,59,45,10,25,0.01,104,1
0.478,0.0001,111,93,10,25,0.01,204,1
0.502,0.0001,162,142,10,25,0.01,304,1
0.572,0.0001,213,191,10,25,0.01,404,1
0.606,0.0001,266,238,10,25,0.01,504,1
0.652,0.0001,313,291,10,25,0.01,604,1
0.686,0.0001,353,351,10,25,0.01,704,1
0.734,0.0001,398,406,10,25,0.01,804,1
0.778,0.0001,456,448,10,25,0.01,904,1
0.822,0.0001,508,496,10,25,0.01,1004,1
0.858,0.0001,561,543,10,25,0.01,1104,1
0.882,0.0001,606,598,10,25,0.01,1204,1
0.902,0.0001,661,643,10,25,0.01,1304,1
0.944,0.0001,711,693,10,25,0.01,1404,1
0.95,0.0001,758,746,10,25,0.01,1504,1
0.962,0.0001,805,799,10,25,0.01,1604,1
0.964,0.0001,852,852,10,25,0.01,1704,1
0.964,0.0001,902,902,10,25,0.01,1804,1
0.97,0.0001,956,948,10,25,0.01,1904,1
0.976,0.0001,1008,996,10,25,0.01,2004,1
0.564,0.0001,60,44,10,25,0.01,104,2
0.572,0.0001,103,101,10,25,0.01,204,2
0.558,0.0001,145,159,10,25,0.01,304,2
0.552,0.0001,196,208,10,25,0.01,404,2
0.584,0.0001,247,257,10,25,0.01,504,2
0.626,0.0001,289,315,10,25,0.01,604,2
0.658,0.0001,344,360,10,25,0.01,704,2
0.708,0.0001,395,409,10,25,0.01,804,2
0.73,0.0001,445,459,10,25,0.01,904,2
0.74,0.0001,492,512,10,25,0.01,1004,2
0.774,0.0001,538,566,10,25,0.01,1104,2
0.83,0.0001,587,617,10,25,0.01,1204,2
0.848,0.0001,640,664,10,25,0.01,1304,2
0.894,0.0001,702,702,10,25,0.01,1404,2
0.938,0.0001,748,756,10,25,0.01,1504,2
0.95,0.0001,794,810,10,25,0.01,1604,2
0.954,0.0001,845,859,10,25,0.01,1704,2
0.958,0.0001,892,912,10,25,0.01,1804,2
0.966,0.0001,945,959,10,25,0.01,1904,2
0.972,0.0001,1000,1004,10,25,0.01,2004,2
0.538,0.0001,51,53,10,25,0.01,104,3
0.562,0.0001,104,100,10,25,0.01,204,3
0.586,0.0001,161,143,10,25,0.01,304,3
0.61,0.0001,205,199,10,25,0.01,404,3
0.652,0.0001,254,250,10,25,0.01,504,3
0.668,0.0001,301,303,10,25,0.01,604,3
0.726,0.0001,345,359,10,25,0.01,704,3
0.774,0.0001,396,408,10,25,0.01,804,3
0.828,0.0001,442,462,10,25,0.01,904,3
0.886,0.0001,492,512,10,25,0.01,1004,3
0.916,0.0001,546,558,10,25,0.01,1104,3
0.938,0.0001,587,617,10,25,0.01,1204,3
0.948,0.0001,632,672,10,25,0.01,1304,3
0.964,0.0001,678,726,10,25,0.01,1404,3
0.97,0.0001,736,768,10,25,0.01,1504,3
0.976,0.0001,797,807,10,25,0.01,1604,3
0.978,0.0001,844,860,10,25,0.01,1704,3
0.984,0.0001,890,914,10,25,0.01,1804,3
0.99,0.0001,938,966,10,25,0.01,1904,3
0.988,0.0001,997,1007,10,25,0.01,2004,3
0.526,0.0001,45,59,10,25,0.01,104,4
0.57,0.0001,98,106,10,25,0.01,204,4
0.586,0.0001,141,163,10,25,0.01,304,4
0.574,0.0001,189,215,10,25,0.01,404,4
0.568,0.0001,239,265,10,25,0.01,504,4
0.612,0.0001,295,309,10,25,0.01,604,4
0.72,0.0001,349,355,10,25,0.01,704,4
0.784,0.0001,407,397,10,25,0.01,804,4
0.792,0.0001,455,449,10,25,0.01,904,4
0.838,0.0001,506,498,10,25,0.01,1004,4
0.868,0.0001,555,549,10,25,0.01,1104,4
0.884,0.0001,607,597,10,25,0.01,1204,4
0.91,0.0001,655,649,10,25,0.01,1304,4
0.928,0.0001,703,701,10,25,0.01,1404,4
0.938,0.0001,750,754,10,25,0.01,1504,4
0.956,0.0001,801,803,10,25,0.01,1604,4
0.962,0.0001,844,860,10,25,0.01,1704,4
0.97,0.0001,890,914,10,25,0.01,1804,4
0.972,0.0001,940,964,10,25,0.01,1904,4
0.978,0.0001,986,1018,10,25,0.01,2004,4
0.528,0.0001,57,47,10,25,0.01,104,5
0.548,0.0001,98,106,10,25,0.01,204,5
0.534,0.0001,160,144,10,25,0.01,304,5
0.568,0.0001,218,186,10,25,0.01,404,5
0.656,0.0001,262,242,10,25,0.01,504,5
0.708,0.0001,317,287,10,25,0.01,604,5
0.736,0.0001,363,341,10,25,0.01,704,5
0.748,0.0001,419,385,10,25,0.01,804,5
0.78,0.0001,472,432,10,25,0.01,904,5
0.818,0.0001,524,480,10,25,0.01,1004,5
0.854,0.0001,576,528,10,25,0.01,1104,5
0.892,0.0001,629,575,10,25,0.01,1204,5
0.918,0.0001,688,616,10,25,0.01,1304,5
0.942,0.0001,731,673,10,25,0.01,1404,5
0.928,0.0001,779,725,10,25,0.01,1504,5
0.942,0.0001,825,779,10,25,0.01,1604,5
0.944,0.0001,876,828,10,25,0.01,1704,5
0.952,0.0001,926,878,10,25,0.01,1804,5
0.96,0.0001,979,925,10,25,0.01,1904,5
0.964,0.0001,1031,973,10,25,0.01,2004,5
0.554,0.0001,48,56,10,25,0.01,104,6
0.578,0.0001,99,105,10,25,0.01,204,6
0.558,0.0001,155,149,10,25,0.01,304,6
0.574,0.0001,207,197,10,25,0.01,404,6
0.596,0.0001,267,237,10,25,0.01,504,6
0.636,0.0001,309,295,10,25,0.01,604,6
0.716,0.0001,359,345,10,25,0.01,704,6
0.796,0.0001,411,393,10,25,0.01,804,6
0.834,0.0001,451,453,10,25,0.01,904,6
0.892,0.0001,499,505,10,25,0.01,1004,6
0.922,0.0001,556,548,10,25,0.01,1104,6
0.952,0.0001,601,603,10,25,0.01,1204,6
0.972,0.0001,656,648,10,25,0.01,1304,6
0.97,0.0001,706,698,10,25,0.01,1404,6
0.974,0.0001,761,743,10,25,0.01,1504,6
0.976,0.0001,824,780,10,25,0.01,1604,6
0.974,0.0001,872,832,10,25,0.01,1704,6
0.98,0.0001,916,888,10,25,0.01,1804,6
0.986,0.0001,972,932,10,25,0.01,1904,6
0.982,0.0001,1021,983,10,25,0.01,2004,6
0.536,0.0001,61,43,10,25,0.01,104,7
0.588,0.0001,105,99,10,25,0.01,204,7
0.616,0.0001,152,152,10,25,0.01,304,7
0.63,0.0001,203,201,10,25,0.01,404,7
0.662,0.0001,258,246,10,25,0.01,504,7
0.704,0.0001,307,297,10,25,0.01,604,7
0.738,0.0001,350,354,10,25,0.01,704,7
0.804,0.0001,401,403,10,25,0.01,804,7
0.872,0.0001,454,450,10,25,0.01,904,7
0.914,0.0001,512,492,10,25,0.01,1004,7
0.926,0.0001,569,535,10,25,0.01,1104,7
0.934,0.0001,609,595,10,25,0.01,1204,7
0.938,0.0001,654,650,10,25,0.01,1304,7
0.938,0.0001,705,699,10,25,0.01,1404,7
0.932,0.0001,753,751,10,25,0.01,1504,7
0.94,0.0001,801,803,10,25,0.01,1604,7
0.946,0.0001,854,850,10,25,0.01,1704,7
0.95,0.0001,904,900,10,25,0.01,1804,7
0.956,0.0001,954,950,10,25,0.01,1904,7
0.958,0.0001,1014,990,10,25,0.01,2004,7
0.502,0.0001,53,51,10,25,0.01,104,8
0.526,0.0001,103,101,10,25,0.01,204,8
0.57,0.0001,161,143,10,25,0.01,304,8
0.598,0.0001,217,187,10,25,0.01,404,8
0.608,0.0001,267,237,10,25,0.01,504,8
0.616,0.0001,309,295,10,25,0.01,604,8
0.622,0.0001,360,344,10,25,0.01,704,8
0.652,0.0001,421,383,10,25,0.01,804,8
0.67,0.0001,466,438,10,25,0.01,904,8
0.706,0.0001,519,485,10,25,0.01,1004,8
0.756,0.0001,573,531,10,25,0.01,1104,8
0.816,0.0001,620,584,10,25,0.01,1204,8
0.88,0.0001,679,625,10,25,0.01,1304,8
0.928,0.0001,721,683,10,25,0.01,1404,8
0.93,0.0001,767,737,10,25,0.01,1504,8
0.954,0.0001,814,790,10,25,0.01,1604,8
0.958,0.0001,865,839,10,25,0.01,1704,8
0.962,0.0001,915,889,10,25,0.01,1804,8
0.972,0.0001,962,942,10,25,0.01,1904,8
0.976,0.0001,1015,989,10,25,0.01,2004,8
0.492,0.0001,48,56,10,25,0.01,104,9
0.522,0.0001,93,111,10,25,0.01,204,9
0.586,0.0001,143,161,10,25,0.01,304,9
0.656,0.0001,190,214,10,25,0.01,404,9
0.648,0.0001,236,268,10,25,0.01,504,9
0.662,0.0001,285,319,10,25,0.01,604,9
0.65,0.0001,337,367,10,25,0.01,704,9
0.678,0.0001,399,405,10,25,0.01,804,9
0.732,0.0001,446,458,10,25,0.01,904,9
0.81,0.0001,496,508,10,25,0.01,1004,9
0.852,0.0001,540,564,10,25,0.01,1104,9
0.88,0.0001,593,611,10,25,0.01,1204,9
0.918,0.0001,640,664,10,25,0.01,1304,9
0.928,0.0001,696,708,10,25,0.01,1404,9
0.94,0.0001,754,750,10,25,0.01,1504,9
0.96,0.0001,807,797,10,25,0.01,1604,9
0.966,0.0001,860,844,10,25,0.01,1704,9
0.97,0.0001,911,893,10,25,0.01,1804,9
0.968,0.0001,959,945,10,25,0.01,1904,9
0.974,0.0001,1005,999,10,25,0.01,2004,9
0.524,0.0001,48,56,10,25,0.01,104,10
0.568,0.0001,92,112,10,25,0.01,204,10
0.582,0.0001,134,170,10,25,0.01,304,10
0.586,0.0001,187,217,10,25,0.01,404,10
0.576,0.0001,240,264,10,25,0.01,504,10
0.58,0.0001,292,312,10,25,0.01,604,10
0.612,0.0001,342,362,10,25,0.01,704,10
0.64,0.0001,389,415,10,25,0.01,804,10
0.638,0.0001,439,465,10,25,0.01,904,10
0.694,0.0001,487,517,10,25,0.01,1004,10
0.744,0.0001,541,563,10,25,0.01,1104,10
0.784,0.0001,587,617,10,25,0.01,1204,10
0.824,0.0001,639,665,10,25,0.01,1304,10
0.866,0.0001,689,715,10,25,0.01,1404,10
0.884,0.0001,741,763,10,25,0.01,1504,10
0.902,0.0001,784,820,10,25,0.01,1604,10
0.922,0.0001,839,865,10,25,0.01,1704,10
0.942,0.0001,895,909,10,25,0.01,1804,10
0.95,0.0001,945,959,10,25,0.01,1904,10
0.954,0.0001,989,1015,10,25,0.01,2004,10
0.49,0.0001,55,49,10,25,0.01,104,11
0.522,0.0001,104,100,10,25,0.01,204,11
0.56,0.0001,157,147,10,25,0.01,304,11
0.592,0.0001,208,196,10,25,0.01,404,11
0.598,0.0001,258,246,10,25,0.01,504,11
0.604,0.0001,305,299,10,25,0.01,604,11
0.632,0.0001,358,346,10,25,0.01,704,11
0.686,0.0001,407,397,10,25,0.01,804,11
0.742,0.0001,453,451,10,25,0.01,904,11
0.808,0.0001,502,502,10,25,0.01,1004,11
0.852,0.0001,553,551,10,25,0.01,1104,11
0.9,0.0001,597,607,10,25,0.01,1204,11
0.928,0.0001,642,662,10,25,0.01,1304,11
0.934,0.0001,692,712,10,25,0.01,1404,11
0.94,0.0001,752,752,10,25,0.01,1504,11
0.956,0.0001,813,791,10,25,0.01,1604,11
0.958,0.0001,867,837,10,25,0.01,1704,11
0.97,0.0001,903,901,10,25,0.01,1804,11
0.97,0.0001,944,960,10,25,0.01,1904,11
0.978,0.0001,989,1015,10,25,0.01,2004,11
0.59,0.0001,43,61,10,25,0.01,104,12
0.566,0.0001,84,120,10,25,0.01,204,12
0.566,0.0001,135,169,10,25,0.01,304,12
0.586,0.0001,185,219,10,25,0.01,404,12
0.562,0.0001,236,268,10,25,0.01,504,12
0.56,0.0001,293,311,10,25,0.01,604,12
0.604,0.0001,334,370,10,25,0.01,704,12
0.666,0.0001,375,429,10,25,0.01,804,12
0.702,0.0001,434,470,10,25,0.01,904,12
0.736,0.0001,488,516,10,25,0.01,1004,12
0.758,0.0001,536,568,10,25,0.01,1104,12
0.81,0.0001,592,612,10,25,0.01,1204,12
0.86,0.0001,647,657,10,25,0.01,1304,12
0.914,0.0001,696,708,10,25,0.01,1404,12
0.936,0.0001,750,754,10,25,0.01,1504,12
0.948,0.0001,791,813,10,25,0.01,1604,12
0.952,0.0001,840,864,10,25,0.01,1704,12
0.95,0.0001,897,907,10,25,0.01,1804,12
0.968,0.0001,947,957,10,25,0.01,1904,12
0.968,0.0001,990,1014,10,25,0.01,2004,12
0.516,0.0001,51,53,10,25,0.01,104,13
0.514,0.0001,97,107,10,25,0.01,204,13
0.554,0.0001,150,154,10,25,0.01,304,13
0.58,0.0001,206,198,10,25,0.01,404,13
0.612,0.0001,250,254,10,25,0.01,504,13
0.642,0.0001,292,312,10,25,0.01,604,13
0.67,0.0001,346,358,10,25,0.01,704,13
0.696,0.0001,402,402,10,25,0.01,804,13
0.752,0.0001,449,455,10,25,0.01,904,13
0.808,0.0001,505,499,10,25,0.01,1004,13
0.85,0.0001,557,547,10,25,0.01,1104,13
0.896,0.0001,608,596,10,25,0.01,1204,13
0.922,0.0001,663,641,10,25,0.01,1304,13
0.938,0.0001,714,690,10,25,0.01,1404,13
0.934,0.0001,758,746,10,25,0.01,1504,13
0.962,0.0001,808,796,10,25,0.01,1604,13
0.966,0.0001,862,842,10,25,0.01,1704,13
0.966,0.0001,911,893,10,25,0.01,1804,13
0.968,0.0001,966,938,10,25,0.01,1904,13
0.97,0.0001,1009,995,10,25,0.01,2004,13
0.482,0.0001,48,56,10,25,0.01,104,14
0.48,0.0001,108,96,10,25,0.01,204,14
0.512,0.0001,164,140,10,25,0.01,304,14
0.596,0.0001,212,192,10,25,0.01,404,14
0.62,0.0001,261,243,10,25,0.01,504,14
0.682,0.0001,307,297,10,25,0.01,604,14
0.764,0.0001,351,353,10,25,0.01,704,14
0.828,0.0001,404,400,10,25,0.01,804,14
0.848,0.0001,445,459,10,25,0.01,904,14
0.886,0.0001,495,509,10,25,0.01,1004,14
0.92,0.0001,547,557,10,25,0.01,1104,14
0.944,0.0001,606,598,10,25,0.01,1204,14
0.958,0.0001,656,648,10,25,0.01,1304,14
0.952,0.0001,704,700,10,25,0.01,1404,14
0.946,0.0001,752,752,10,25,0.01,1504,14
0.96,0.0001,804,800,10,25,0.01,1604,14
0.972,0.0001,859,845,10,25,0.01,1704,14
0.972,0.0001,903,901,10,25,0.01,1804,14
0.976,0.0001,948,956,10,25,0.01,1904,14
0.974,0.0001,1001,1003,10,25,0.01,2004,14
0.484,0.0001,46,58,10,25,0.01,104,15
0.512,0.0001,97,107,10,25,0.01,204,15
0.556,0.0001,147,157,10,25,0.01,304,15
0.588,0.0001,195,209,10,25,0.01,404,15
0.606,0.0001,251,253,10,25,0.01,504,15
0.648,0.0001,302,302,10,25,0.01,604,15
0.67,0.0001,352,352,10,25,0.01,704,15
0.714,0.0001,405,399,10,25,0.01,804,15
0.756,0.0001,452,452,10,25,0.01,904,15
0.786,0.0001,505,499,10,25,0.01,1004,15
0.81,0.0001,557,547,10,25,0.01,1104,15
0.834,0.0001,608,596,10,25,0.01,1204,15
0.872,0.0001,660,644,10,25,0.01,1304,15
0.886,0.0001,709,695,10,25,0.01,1404,15
0.922,0.0001,761,743,10,25,0.01,1504,15
0.94,0.0001,811,793,10,25,0.01,1604,15
0.946,0.0001,863,841,10,25,0.01,1704,15
0.954,0.0001,914,890,10,25,0.01,1804,15
0.956,0.0001,958,946,10,25,0.01,1904,15
0.962,0.0001,997,1007,10,25,0.01,2004,15
0.494,0.0001,54,50,10,25,0.01,104,16
0.534,0.0001,98,106,10,25,0.01,204,16
0.574,0.0001,142,162,10,25,0.01,304,16
0.59,0.0001,193,211,10,25,0.01,404,16
0.63,0.0001,249,255,10,25,0.01,504,16
0.682,0.0001,302,302,10,25,0.01,604,16
0.724,0.0001,349,355,10,25,0.01,704,16
0.758,0.0001,400,404,10,25,0.01,804,16
0.782,0.0001,444,460,10,25,0.01,904,16
0.828,0.0001,500,504,10,25,0.01,1004,16
0.854,0.0001,555,549,10,25,0.01,1104,16
0.888,0.0001,605,599,10,25,0.01,1204,16
0.922,0.0001,656,648,10,25,0.01,1304,16
0.93,0.0001,701,703,10,25,0.01,1404,16
0.934,0.0001,759,745,10,25,0.01,1504,16
0.946,0.0001,809,795,10,25,0.01,1604,16
0.956,0.0001,862,842,10,25,0.01,1704,16
0.966,0.0001,908,896,10,25,0.01,1804,16
0.966,0.0001,959,945,10,25,0.01,1904,16
0.972,0.0001,996,1008,10,25,0.01,2004,16
0.524,0.0001,52,52,10,25,0.01,104,17
0.554,0.0001,112,92,10,25,0.01,204,17
0.57,0.0001,160,144,10,25,0.01,304,17
0.556,0.0001,212,192,10,25,0.01,404,17
0.542,0.0001,256,248,10,25,0.01,504,17
0.59,0.0001,311,293,10,25,0.01,604,17
0.652,0.0001,362,342,10,25,0.01,704,17
0.72,0.0001,404,400,10,25,0.01,804,17
0.762,0.0001,447,457,10,25,0.01,904,17
0.794,0.0001,503,501,10,25,0.01,1004,17
0.818,0.0001,555,549,10,25,0.01,1104,17
0.888,0.0001,606,598,10,25,0.01,1204,17
0.936,0.0001,653,651,10,25,0.01,1304,17
0.944,0.0001,700,704,10,25,0.01,1404,17
0.954,0.0001,751,753,10,25,0.01,1504,17
0.964,0.0001,800,804,10,25,0.01,1604,17
0.974,0.0001,850,854,10,25,0.01,1704,17
0.976,0.0001,904,900,10,25,0.01,1804,17
0.978,0.0001,958,946,10,25,0.01,1904,17
0.98,0.0001,1005,999,10,25,0.01,2004,17
0.57,0.0001,59,45,10,25,0.01,104,18
0.604,0.0001,103,101,10,25,0.01,204,18
0.616,0.0001,152,152,10,25,0.01,304,18
0.642,0.0001,195,209,10,25,0.01,404,18
0.696,0.0001,244,260,10,25,0.01,504,18
0.754,0.0001,293,311,10,25,0.01,604,18
0.778,0.0001,345,359,10,25,0.01,704,18
0.82,0.0001,403,401,10,25,0.01,804,18
0.85,0.0001,447,457,10,25,0.01,904,18
0.884,0.0001,494,510,10,25,0.01,1004,18
0.912,0.0001,545,559,10,25,0.01,1104,18
0.936,0.0001,602,602,10,25,0.01,1204,18
0.956,0.0001,649,655,10,25,0.01,1304,18
0.954,0.0001,696,708,10,25,0.01,1404,18
0.952,0.0001,741,763,10,25,0.01,1504,18
0.964,0.0001,786,818,10,25,0.01,1604,18
0.97,0.0001,841,863,10,25,0.01,1704,18
0.97,0.0001,892,912,10,25,0.01,1804,18
0.974,0.0001,943,961,10,25,0.01,1904,18
0.974,0.0001,985,1019,10,25,0.01,2004,18
0.488,0.0001,56,48,10,25,0.01,104,19
0.518,0.0001,111,93,10,25,0.01,204,19
0.514,0.0001,170,134,10,25,0.01,304,19
0.538,0.0001,225,179,10,25,0.01,404,19
0.582,0.0001,272,232,10,25,0.01,504,19
0.612,0.0001,325,279,10,25,0.01,604,19
0.66,0.0001,377,327,10,25,0.01,704,19
0.712,0.0001,421,383,10,25,0.01,804,19
0.776,0.0001,471,433,10,25,0.01,904,19
0.818,0.0001,506,498,10,25,0.01,1004,19
0.846,0.0001,548,556,10,25,0.01,1104,19
0.87,0.0001,597,607,10,25,0.01,1204,19
0.89,0.0001,657,647,10,25,0.01,1304,19
0.92,0.0001,711,693,10,25,0.01,1404,19
0.944,0.0001,755,749,10,25,0.01,1504,19
0.942,0.0001,802,802,10,25,0.01,1604,19
0.952,0.0001,855,849,10,25,0.01,1704,19
0.952,0.0001,899,905,10,25,0.01,1804,19
0.95,0.0001,943,961,10,25,0.01,1904,19
0.96,0.0001,995,1009,10,25,0.01,2004,19
0.55,0.0001,52,52,10,25,0.01,104,20
0.588,0.0001,105,99,10,25,0.01,204,20
0.558,0.0001,162,142,10,25,0.01,304,20
0.576,0.0001,211,193,10,25,0.01,404,20
0.624,0.0001,260,244,10,25,0.01,504,20
0.652,0.0001,307,297,10,25,0.01,604,20
0.732,0.0001,355,349,10,25,0.01,704,20
0.806,0.0001,403,401,10,25,0.01,804,20
0.836,0.0001,456,448,10,25,0.01,904,20
0.89,0.0001,512,492,10,25,0.01,1004,20
0.91,0.0001,557,547,10,25,0.01,1104,20
0.912,0.0001,609,595,10,25,0.01,1204,20
0.914,0.0001,665,639,10,25,0.01,1304,20
0.918,0.0001,702,702,10,25,0.01,1404,20
0.926,0.0001,748,756,10,25,0.01,1504,20
0.934,0.0001,802,802,10,25,0.01,1604,20
0.946,0.0001,857,847,10,25,0.01,1704,20
0.952,0.0001,906,898,10,25,0.01,1804,20
0.954,0.0001,958,946,10,25,0.01,1904,20
0.956,0.0001,1003,1001,10,25,0.01,2004,20
0.49,0.001,51,53,10,25,0.0001,104,1
0.49,0.001,101,103,10,25,0.0001,204,1
0.49,0.001,154,150,10,25,0.0001,304,1
0.49,0.001,211,193,10,25,0.0001,404,1
0.49,0.001,255,249,10,25,0.0001,504,1
0.49,0.001,311,293,10,25,0.0001,604,1
0.49,0.001,369,335,10,25,0.0001,704,1
0.492,0.001,411,393,10,25,0.0001,804,1
0.492,0.001,453,451,10,25,0.0001,904,1
0.492,0.001,492,512,10,25,0.0001,1004,1
0.496,0.001,535,569,10,25,0.0001,1104,1
0.494,0.001,597,607,10,25,0.0001,1204,1
0.494,0.001,652,652,10,25,0.0001,1304,1
0.494,0.001,699,705,10,25,0.0001,1404,1
0.494,0.001,751,753,10,25,0.0001,1504,1
0.494,0.001,805,799,10,25,0.0001,1604,1
0.496,0.001,853,851,10,25,0.0001,1704,1
0.496,0.001,899,905,10,25,0.0001,1804,1
0.494,0.001,950,954,10,25,0.0001,1904,1
0.494,0.001,999,1005,10,25,0.0001,2004,1
0.542,0.001,51,53,10,25,0.0001,104,2
0.542,0.001,96,108,10,25,0.0001,204,2
0.542,0.001,145,159,10,25,0.0001,304,2
0.542,0.001,198,206,10,25,0.0001,404,2
0.542,0.001,242,262,10,25,0.0001,504,2
0.542,0.001,281,323,10,25,0.0001,604,2
0.542,0.001,335,369,10,25,0.0001,704,2
0.542,0.001,384,420,10,25,0.0001,804,2
0.542,0.001,438,466,10,25,0.0001,904,2
0.542,0.001,486,518,10,25,0.0001,1004,2
0.544,0.001,534,570,10,25,0.0001,1104,2
0.544,0.001,583,621,10,25,0.0001,1204,2
0.544,0.001,633,671,10,25,0.0001,1304,2
0.546,0.001,689,715,10,25,0.0001,1404,2
0.546,0.001,743,761,10,25,0.0001,1504,2
0.55,0.001,799,805,10,25,0.0001,1604,2
0.55,0.001,849,855,10,25,0.0001,1704,2
0.55,0.001,907,897,10,25,0.0001,1804,2
0.55,0.001,967,937,10,25,0.0001,1904,2
0.552,0.001,1023,981,10,25,0.0001,2004,2
0.526,0.001,49,55,10,25,0.0001,104,3
0.526,0.001,104,100,10,25,0.0001,204,3
0.526,0.001,159,145,10,25,0.0001,304,3
0.526,0.001,213,191,10,25,0.0001,404,3
0.526,0.001,267,237,10,25,0.0001,504,3
0.526,0.001,318,286,10,25,0.0001,604,3
0.526,0.001,369,335,10,25,0.0001,704,3
0.526,0.001,411,393,10,25,0.0001,804,3
0.526,0.001,463,441,10,25,0.0001,904,3
0.526,0.001,518,486,10,25,0.0001,1004,3
0.526,0.001,564,540,10,25,0.0001,1104,3
0.526,0.001,608,596,10,25,0.0001,1204,3
0.526,0.001,658,646,10,25,0.0001,1304,3
0.526,0.001,705,699,10,25,0.0001,1404,3
0.526,0.001,758,746,10,25,0.0001,1504,3
0.524,0.001,803,801,10,25,0.0001,1604,3
0.524,0.001,861,843,10,25,0.0001,1704,3
0.524,0.001,913,891,10,25,0.0001,1804,3
0.524,0.001,966,938,10,25,0.0001,1904,3
0.524,0.001,1018,986,10,25,0.0001,2004,3
0.544,0.001,61,43,10,25,0.0001,104,4
0.542,0.001,114,90,10,25,0.0001,204,4
0.542,0.001,168,136,10,25,0.0001,304,4
0.542,0.001,223,181,10,25,0.0001,404,4
0.542,0.001,268,236,10,25,0.0001,504,4
0.542,0.001,312,292,10,25,0.0001,604,4
0.542,0.001,355,349,10,25,0.0001,704,4
0.542,0.001,409,395,10,25,0.0001,804,4
0.544,0.001,457,447,10,25,0.0001,904,4
0.546,0.001,503,501,10,25,0.0001,1004,4
0.546,0.001,546,558,10,25,0.0001,1104,4
0.546,0.001,604,600,10,25,0.0001,1204,4
0.546,0.001,649,655,10,25,0.0001,1304,4
0.542,0.001,690,714,10,25,0.0001,1404,4
0.544,0.001,748,756,10,25,0.0001,1504,4
0.546,0.001,796,808,10,25,0.0001,1604,4
0.548,0.001,849,855,10,25,0.0001,1704,4
0.552,0.001,899,905,10,25,0.0001,1804,4
0.554,0.001,951,953,10,25,0.0001,1904,4
0.554,0.001,1004,1000,10,25,0.0001,2004,4
0.55,0.001,51,53,10,25,0.0001,104,5
0.55,0.001,102,102,10,25,0.0001,204,5
0.55,0.001,162,142,10,25,0.0001,304,5
0.55,0.001,218,186,10,25,0.0001,404,5
0.55,0.001,259,245,10,25,0.0001,504,5
0.55,0.001,314,290,10,25,0.0001,604,5
0.55,0.001,356,348,10,25,0.0001,704,5
0.552,0.001,404,400,10,25,0.0001,804,5
0.552,0.001,451,453,10,25,0.0001,904,5
0.552,0.001,506,498,10,25,0.0001,1004,5
0.554,0.001,551,553,10,25,0.0001,1104,5
0.552,0.001,606,598,10,25,0.0001,1204,5
0.552,0.001,656,648,10,25,0.0001,1304,5
0.552,0.001,703,701,10,25,0.0001,1404,5
0.552,0.001,761,743,10,25,0.0001,1504,5
0.55,0.001,812,792,10,25,0.0001,1604,5
0.548,0.001,850,854,10,25,0.0001,1704,5
0.552,0.001,898,906,10,25,0.0001,1804,5
0.55,0.001,936,968,10,25,0.0001,1904,5
0.552,0.001,989,1015,10,25,0.0001,2004,5
0.494,0.001,44,60,10,25,0.0001,104,6
0.494,0.001,93,111,10,25,0.0001,204,6
0.494,0.001,138,166,10,25,0.0001,304,6
0.494,0.001,192,212,10,25,0.0001,404,6
0.494,0.001,237,267,10,25,0.0001,504,6
0.494,0.001,293,311,10,25,0.0001,604,6
0.494,0.001,346,358,10,25,0.0001,704,6
0.494,0.001,393,411,10,25,0.0001,804,6
0.494,0.001,444,460,10,25,0.0001,904,6
0.494,0.001,496,508,10,25,0.0001,1004,6
0.494,0.001,543,561,10,25,0.0001,1104,6
0.496,0.001,597,607,10,25,0.0001,1204,6
0.496,0.001,644,660,10,25,0.0001,1304,6
0.494,0.001,694,710,10,25,0.0001,1404,6
0.494,0.001,757,747,10,25,0.0001,1504,6
0.498,0.001,809,795,10,25,0.0001,1604,6
0.496,0.001,861,843,10,25,0.0001,1704,6
0.496,0.001,913,891,10,25,0.0001,1804,6
0.498,0.001,954,950,10,25,0.0001,1904,6
0.498,0.001,1003,1001,10,25,0.0001,2004,6
0.492,0.001,50,54,10,25,0.0001,104,7
0.492,0.001,99,105,10,25,0.0001,204,7
0.492,0.001,158,146,10,25,0.0001,304,7
0.492,0.001,206,198,10,25,0.0001,404,7
0.492,0.001,256,248,10,25,0.0001,504,7
0.492,0.001,308,296,10,25,0.0001,604,7
0.492,0.001,352,352,10,25,0.0001,704,7
0.492,0.001,400,404,10,25,0.0001,804,7
0.492,0.001,448,456,10,25,0.0001,904,7
0.492,0.001,499,505,10,25,0.0001,1004,7
0.492,0.001,545,559,10,25,0.0001,1104,7
0.492,0.001,597,607,10,25,0.0001,1204,7
0.492,0.001,647,657,10,25,0.0001,1304,7
0.492,0.001,708,696,10,25,0.0001,1404,7
0.492,0.001,759,745,10,25,0.0001,1504,7
0.492,0.001,806,798,10,25,0.0001,1604,7
0.492,0.001,859,845,10,25,0.0001,1704,7
0.492,0.001,909,895,10,25,0.0001,1804,7
0.492,0.001,952,952,10,25,0.0001,1904,7
0.492,0.001,1006,998,10,25,0.0001,2004,7
0.526,0.001,52,52,10,25,0.0001,104,8
0.524,0.001,97,107,10,25,0.0001,204,8
0.526,0.001,144,160,10,25,0.0001,304,8
0.524,0.001,195,209,10,25,0.0001,404,8
0.522,0.001,251,253,10,25,0.0001,504,8
0.522,0.001,297,307,10,25,0.0001,604,8
0.522,0.001,349,355,10,25,0.0001,704,8
0.522,0.001,396,408,10,25,0.0001,804,8
0.524,0.001,443,461,10,25,0.0001,904,8
0.526,0.001,491,513,10,25,0.0001,1004,8
0.53,0.001,532,572,10,25,0.0001,1104,8
0.532,0.001,575,629,10,25,0.0001,1204,8
0.534,0.001,630,674,10,25,0.0001,1304,8
0.536,0.001,679,725,10,25,0.0001,1404,8
0.54,0.001,727,777,10,25,0.0001,1504,8
0.542,0.001,776,828,10,25,0.0001,1604,8
0.546,0.001,830,874,10,25,0.0001,1704,8
0.55,0.001,883,921,10,25,0.0001,1804,8
0.554,0.001,938,966,10,25,0.0001,1904,8
0.55,0.001,995,1009,10,25,0.0001,2004,8
0.492,0.001,43,61,10,25,0.0001,104,9
0.496,0.001,94,110,10,25,0.0001,204,9
0.496,0.001,147,157,10,25,0.0001,304,9
0.498,0.001,196,208,10,25,0.0001,404,9
0.498,0.001,243,261,10,25,0.0001,504,9
0.498,0.001,290,314,10,25,0.0001,604,9
0.5,0.001,339,365,10,25,0.0001,704,9
0.5,0.001,394,410,10,25,0.0001,804,9
0.496,0.001,449,455,10,25,0.0001,904,9
0.498,0.001,496,508,10,25,0.0001,1004,9
0.498,0.001,544,560,10,25,0.0001,1104,9
0.498,0.001,606,598,10,25,0.0001,1204,9
0.498,0.001,656,648,10,25,0.0001,1304,9
0.498,0.001,701,703,10,25,0.0001,1404,9
0.496,0.001,751,753,10,25,0.0001,1504,9
0.496,0.001,808,796,10,25,0.0001,1604,9
0.492,0.001,863,841,10,25,0.0001,1704,9
0.496,0.001,906,898,10,25,0.0001,1804,9
0.496,0.001,955,949,10,25,0.0001,1904,9
0.496,0.001,1004,1000,10,25,0.0001,2004,9
0.486,0.001,50,54,10,25,0.0001,104,10
0.49,0.001,101,103,10,25,0.0001,204,10
0.49,0.001,159,145,10,25,0.0001,304,10
0.49,0.001,212,192,10,25,0.0001,404,10
0.49,0.001,267,237,10,25,0.0001,504,10
0.49,0.001,318,286,10,25,0.0001,604,10
0.488,0.001,367,337,10,25,0.0001,704,10
0.494,0.001,413,391,10,25,0.0001,804,10
0.494,0.001,463,441,10,25,0.0001,904,10
0.494,0.001,521,483,10,25,0.0001,1004,10
0.494,0.001,569,535,10,25,0.0001,1104,10
0.494,0.001,622,582,10,25,0.0001,1204,10
0.496,0.001,664,640,10,25,0.0001,1304,10
0.502,0.001,715,689,10,25,0.0001,1404,10
0.504,0.001,764,740,10,25,0.0001,1504,10
0.504,0.001,812,792,10,25,0.0001,1604,10
0.504,0.001,856,848,10,25,0.0001,1704,10
0.506,0.001,900,904,10,25,0.0001,1804,10
0.512,0.001,951,953,10,25,0.0001,1904,10
0.518,0.001,997,1007,10,25,0.0001,2004,10
0.542,0.001,53,51,10,25,0.0001,104,11
0.54,0.001,105,99,10,25,0.0001,204,11
0.54,0.001,148,156,10,25,0.0001,304,11
0.54,0.001,201,203,10,25,0.0001,404,11
0.542,0.001,245,259,10,25,0.0001,504,11
0.542,0.001,298,306,10,25,0.0001,604,11
0.544,0.001,352,352,10,25,0.0001,704,11
0.546,0.001,400,404,10,25,0.0001,804,11
0.546,0.001,452,452,10,25,0.0001,904,11
0.546,0.001,510,494,10,25,0.0001,1004,11
0.546,0.001,564,540,10,25,0.0001,1104,11
0.548,0.001,615,589,10,25,0.0001,1204,11
0.55,0.001,661,643,10,25,0.0001,1304,11
0.55,0.001,708,696,10,25,0.0001,1404,11
0.552,0.001,762,742,10,25,0.0001,1504,11
0.552,0.001,820,784,10,25,0.0001,1604,11
0.552,0.001,866,838,10,25,0.0001,1704,11
0.55,0.001,913,891,10,25,0.0001,1804,11
0.552,0.001,972,932,10,25,0.0001,1904,11
0.556,0.001,1024,980,10,25,0.0001,2004,11
0.518,0.001,58,46,10,25,0.0001,104,12
0.518,0.001,111,93,10,25,0.0001,204,12
0.518,0.001,172,132,10,25,0.0001,304,12
0.518,0.001,221,183,10,25,0.0001,404,12
0.518,0.001,260,244,10,25,0.0001,504,12
0.518,0.001,306,298,10,25,0.0001,604,12
0.518,0.001,361,343,10,25,0.0001,704,12
0.516,0.001,409,395,10,25,0.0001,804,12
0.518,0.001,461,443,10,25,0.0001,904,12
0.518,0.001,512,492,10,25,0.0001,1004,12
0.516,0.001,566,538,10,25,0.0001,1104,12
0.514,0.001,610,594,10,25,0.0001,1204,12
0.516,0.001,654,650,10,25,0.0001,1304,12
0.518,0.001,708,696,10,25,0.0001,1404,12
0.52,0.001,761,743,10,25,0.0001,1504,12
0.522,0.001,813,791,10,25,0.0001,1604,12
0.522,0.001,860,844,10,25,0.0001,1704,12
0.524,0.001,909,895,10,25,0.0001,1804,12
0.526,0.001,958,946,10,25,0.0001,1904,12
0.53,0.001,1001,1003,10,25,0.0001,2004,12
0.508,0.001,50,54,10,25,0.0001,104,13
0.508,0.001,108,96,10,25,0.0001,204,13
0.508,0.001,160,144,10,25,0.0001,304,13
0.508,0.001,201,203,10,25,0.0001,404,13
0.508,0.001,245,259,10,25,0.0001,504,13
0.508,0.001,298,306,10,25,0.0001,604,13
0.506,0.001,338,366,10,25,0.0001,704,13
0.504,0.001,393,411,10,25,0.0001,804,13
0.506,0.001,442,462,10,25,0.0001,904,13
0.506,0.001,490,514,10,25,0.0001,1004,13
0.506,0.001,538,566,10,25,0.0001,1104,13
0.506,0.001,588,616,10,25,0.0001,1204,13
0.508,0.001,644,660,10,25,0.0001,1304,13
0.506,0.001,698,706,10,25,0.0001,1404,13
0.508,0.001,744,760,10,25,0.0001,1504,13
0.512,0.001,795,809,10,25,0.0001,1604,13
0.512,0.001,843,861,10,25,0.0001,1704,13
0.508,0.001,886,918,10,25,0.0001,1804,13
0.512,0.001,943,961,10,25,0.0001,1904,13
0.512,0.001,994,1010,10,25,0.0001,2004,13
0.484,0.001,57,47,10,25,0.0001,104,14
0.484,0.001,103,101,10,25,0.0001,204,14
0.484,0.001,154,150,10,25,0.0001,304,14
0.484,0.001,206,198,10,25,0.0001,404,14
0.484,0.001,259,245,10,25,0.0001,504,14
0.484,0.001,317,287,10,25,0.0001,604,14
0.484,0.001,360,344,10,25,0.0001,704,14
0.484,0.001,411,393,10,25,0.0001,804,14
0.482,0.001,457,447,10,25,0.0001,904,14
0.482,0.001,509,495,10,25,0.0001,1004,14
0.482,0.001,564,540,10,25,0.0001,1104,14
0.482,0.001,617,587,10,25,0.0001,1204,14
0.478,0.001,665,639,10,25,0.0001,1304,14
0.48,0.001,712,692,10,25,0.0001,1404,14
0.48,0.001,760,744,10,25,0.0001,1504,14
0.48,0.001,821,783,10,25,0.0001,1604,14
0.48,0.001,868,836,10,25,0.0001,1704,14
0.48,0.001,915,889,10,25,0.0001,1804,14
0.48,0.001,963,941,10,25,0.0001,1904,14
0.48,0.001,1010,994,10,25,0.0001,2004,14
0.472,0.001,58,46,10,25,0.0001,104,15
0.472,0.001,122,82,10,25,0.0001,204,15
0.472,0.001,177,127,10,25,0.0001,304,15
0.472,0.001,227,177,10,25,0.0001,404,15
0.472,0.001,270,234,10,25,0.0001,504,15
0.472,0.001,320,284,10,25,0.0001,604,15
0.472,0.001,366,338,10,25,0.0001,704,15
0.472,0.001,414,390,10,25,0.0001,804,15
0.472,0.001,468,436,10,25,0.0001,904,15
0.472,0.001,520,484,10,25,0.0001,1004,15
0.472,0.001,579,525,10,25,0.0001,1104,15
0.476,0.001,625,579,10,25,0.0001,1204,15
0.478,0.001,671,633,10,25,0.0001,1304,15
0.476,0.001,722,682,10,25,0.0001,1404,15
0.48,0.001,774,730,10,25,0.0001,1504,15
0.482,0.001,837,767,10,25,0.0001,1604,15
0.482,0.001,877,827,10,25,0.0001,1704,15
0.486,0.001,930,874,10,25,0.0001,1804,15
0.49,0.001,976,928,10,25,0.0001,1904,15
0.488,0.001,1024,980,10,25,0.0001,2004,15
0.496,0.001,53,51,10,25,0.0001,104,16
0.496,0.001,106,98,10,25,0.0001,204,16
0.496,0.001,161,143,10,25,0.0001,304,16
0.496,0.001,213,191,10,25,0.0001,404,16
0.496,0.001,265,239,10,25,0.0001,504,16
0.496,0.001,307,297,10,25,0.0001,604,16
0.498,0.001,359,345,10,25,0.0001,704,16
0.498,0.001,404,400,10,25,0.0001,804,16
0.5,0.001,438,466,10,25,0.0001,904,16
0.504,0.001,492,512,10,25,0.0001,1004,16
0.506,0.001,538,566,10,25,0.0001,1104,16
0.504,0.001,589,615,10,25,0.0001,1204,16
0.502,0.001,650,654,10,25,0.0001,1304,16
0.508,0.001,701,703,10,25,0.0001,1404,16
0.51,0.001,761,743,10,25,0.0001,1504,16
0.51,0.001,814,790,10,25,0.0001,1604,16
0.51,0.001,863,841,10,25,0.0001,1704,16
0.518,0.001,919,885,10,25,0.0001,1804,16
0.52,0.001,962,942,10,25,0.0001,1904,16
0.522,0.001,1008,996,10,25,0.0001,2004,16
0.454,0.001,58,46,10,25,0.0001,104,17
0.454,0.001,108,96,10,25,0.0001,204,17
0.454,0.001,155,149,10,25,0.0001,304,17
0.454,0.001,197,207,10,25,0.0001,404,17
0.454,0.001,243,261,10,25,0.0001,504,17
0.454,0.001,294,310,10,25,0.0001,604,17
0.454,0.001,344,360,10,25,0.0001,704,17
0.454,0.001,393,411,10,25,0.0001,804,17
0.454,0.001,442,462,10,25,0.0001,904,17
0.454,0.001,492,512,10,25,0.0001,1004,17
0.456,0.001,544,560,10,25,0.0001,1104,17
0.456,0.001,597,607,10,25,0.0001,1204,17
0.46,0.001,660,644,10,25,0.0001,1304,17
0.46,0.001,717,687,10,25,0.0001,1404,17
0.46,0.001,769,735,10,25,0.0001,1504,17
0.464,0.001,819,785,10,25,0.0001,1604,17
0.464,0.001,863,841,10,25,0.0001,1704,17
0.466,0.001,911,893,10,25,0.0001,1804,17
0.468,0.001,963,941,10,25,0.0001,1904,17
0.47,0.001,1018,986,10,25,0.0001,2004,17
0.55,0.001,57,47,10,25,0.0001,104,18
0.55,0.001,105,99,10,25,0.0001,204,18
0.55,0.001,152,152,10,25,0.0001,304,18
0.55,0.001,210,194,10,25,0.0001,404,18
0.55,0.001,259,245,10,25,0.0001,504,18
0.55,0.001,311,293,10,25,0.0001,604,18
0.548,0.001,359,345,10,25,0.0001,704,18
0.546,0.001,421,383,10,25,0.0001,804,18
0.546,0.001,482,422,10,25,0.0001,904,18
0.546,0.001,532,472,10,25,0.0001,1004,18
0.55,0.001,578,526,10,25,0.0001,1104,18
0.554,0.001,620,584,10,25,0.0001,1204,18
0.554,0.001,670,634,10,25,0.0001,1304,18
0.552,0.001,721,683,10,25,0.0001,1404,18
0.552,0.001,764,740,10,25,0.0001,1504,18
0.552,0.001,815,789,10,25,0.0001,1604,18
0.558,0.001,877,827,10,25,0.0001,1704,18
0.562,0.001,929,875,10,25,0.0001,1804,18
0.566,0.001,977,927,10,25,0.0001,1904,18
0.572,0.001,1027,977,10,25,0.0001,2004,18
0.486,0.001,52,52,10,25,0.0001,104,19
0.486,0.001,101,103,10,25,0.0001,204,19
0.486,0.001,155,149,10,25,0.0001,304,19
0.486,0.001,213,191,10,25,0.0001,404,19
0.486,0.001,260,244,10,25,0.0001,504,19
0.488,0.001,301,303,10,25,0.0001,604,19
0.486,0.001,349,355,10,25,0.0001,704,19
0.486,0.001,402,402,10,25,0.0001,804,19
0.488,0.001,448,456,10,25,0.0001,904,19
0.492,0.001,500,504,10,25,0.0001,1004,19
0.494,0.001,557,547,10,25,0.0001,1104,19
0.496,0.001,603,601,10,25,0.0001,1204,19
0.496,0.001,648,656,10,25,0.0001,1304,19
0.5,0.001,700,704,10,25,0.0001,1404,19
0.506,0.001,742,762,10,25,0.0001,1504,19
0.506,0.001,793,811,10,25,0.0001,1604,19
0.508,0.001,840,864,10,25,0.0001,1704,19
0.518,0.001,888,916,10,25,0.0001,1804,19
0.518,0.001,941,963,10,25,0.0001,1904,19
0.52,0.001,989,1015,10,25,0.0001,2004,19
0.424,0.001,46,58,10,25,0.0001,104,20
0.426,0.001,99,105,10,25,0.0001,204,20
0.426,0.001,151,153,10,25,0.0001,304,20
0.428,0.001,200,204,10,25,0.0001,404,20
0.426,0.001,246,258,10,25,0.0001,504,20
0.426,0.001,291,313,10,25,0.0001,604,20
0.426,0.001,343,361,10,25,0.0001,704,20
0.428,0.001,400,404,10,25,0.0001,804,20
0.424,0.001,452,452,10,25,0.0001,904,20
0.424,0.001,507,497,10,25,0.0001,1004,20
0.426,0.001,561,543,10,25,0.0001,1104,20
0.426,0.001,612,592,10,25,0.0001,1204,20
0.43,0.001,662,642,10,25,0.0001,1304,20
0.43,0.001,710,694,10,25,0.0001,1404,20
0.432,0.001,761,743,10,25,0.0001,1504,20
0.43,0.001,816,788,10,25,0.0001,1604,20
0.428,0.001,868,836,10,25,0.0001,1704,20
0.436,0.001,920,884,10,25,0.0001,1804,20
0.436,0.001,965,939,10,25,0.0001,1904,20
0.436,0.001,1013,991,10,25,0.0001,2004,20
0.466,0.001,53,51,10,25,0.001,104,1
0.46,0.001,100,104,10,25,0.001,204,1
0.46,0.001,152,152,10,25,0.001,304,1
0.476,0.001,203,201,10,25,0.001,404,1
0.48,0.001,253,251,10,25,0.001,504,1
0.486,0.001,304,300,10,25,0.001,604,1
0.492,0.001,369,335,10,25,0.001,704,1
0.492,0.001,421,383,10,25,0.001,804,1
0.5,0.001,461,443,10,25,0.001,904,1
0.512,0.001,516,488,10,25,0.001,1004,1
0.508,0.001,567,537,10,25,0.001,1104,1
0.522,0.001,616,588,10,25,0.001,1204,1
0.536,0.001,666,638,10,25,0.001,1304,1
0.546,0.001,717,687,10,25,0.001,1404,1
0.554,0.001,763,741,10,25,0.001,1504,1
0.558,0.001,816,788,10,25,0.001,1604,1
0.576,0.001,861,843,10,25,0.001,1704,1
0.574,0.001,917,887,10,25,0.001,1804,1
0.594,0.001,970,934,10,25,0.001,1904,1
0.622,0.001,1011,993,10,25,0.001,2004,1
0.542,0.001,46,58,10,25,0.001,104,2
0.544,0.001,93,111,10,25,0.001,204,2
0.54,0.001,147,157,10,25,0.001,304,2
0.536,0.001,192,212,10,25,0.001,404,2
0.54,0.001,235,269,10,25,0.001,504,2
0.534,0.001,293,311,10,25,0.001,604,2
0.528,0.001,336,368,10,25,0.001,704,2
0.528,0.001,392,412,10,25,0.001,804,2
0.532,0.001,442,462,10,25,0.001,904,2
0.536,0.001,494,510,10,25,0.001,1004,2
0.526,0.001,547,557,10,25,0.001,1104,2
0.546,0.001,593,611,10,25,0.001,1204,2
0.542,0.001,638,666,10,25,0.001,1304,2
0.566,0.001,694,710,10,25,0.001,1404,2
0.586,0.001,745,759,10,25,0.001,1504,2
0.6,0.001,790,814,10,25,0.001,1604,2
0.622,0.001,845,859,10,25,0.001,1704,2
0.634,0.001,895,909,10,25,0.001,1804,2
0.66,0.001,950,954,10,25,0.001,1904,2
0.68,0.001,998,1006,10,25,0.001,2004,2
0.456,0.001,52,52,10,25,0.001,104,3
0.456,0.001,104,100,10,25,0.001,204,3
0.456,0.001,159,145,10,25,0.001,304,3
0.452,0.001,208,196,10,25,0.001,404,3
0.452,0.001,254,250,10,25,0.001,504,3
0.452,0.001,303,301,10,25,0.001,604,3
0.454,0.001,358,346,10,25,0.001,704,3
0.454,0.001,404,400,10,25,0.001,804,3
0.45,0.001,452,452,10,25,0.001,904,3
0.458,0.001,502,502,10,25,0.001,1004,3
0.468,0.001,551,553,10,25,0.001,1104,3
0.478,0.001,607,597,10,25,0.001,1204,3
0.492,0.001,655,649,10,25,0.001,1304,3
0.53,0.001,707,697,10,25,0.001,1404,3
0.536,0.001,770,734,10,25,0.001,1504,3
0.55,0.001,822,782,10,25,0.001,1604,3
0.564,0.001,871,833,10,25,0.001,1704,3
0.594,0.001,925,879,10,25,0.001,1804,3
0.616,0.001,970,934,10,25,0.001,1904,3
0.65,0.001,1022,982,10,25,0.001,2004,3
0.484,0.001,50,54,10,25,0.001,104,4
0.488,0.001,102,102,10,25,0.001,204,4
0.488,0.001,141,163,10,25,0.001,304,4
0.496,0.001,185,219,10,25,0.001,404,4
0.496,0.001,231,273,10,25,0.001,504,4
0.498,0.001,282,322,10,25,0.001,604,4
0.5,0.001,338,366,10,25,0.001,704,4
0.51,0.001,386,418,10,25,0.001,804,4
0.508,0.001,439,465,10,25,0.001,904,4
0.518,0.001,490,514,10,25,0.001,1004,4
0.516,0.001,544,560,10,25,0.001,1104,4
0.532,0.001,593,611,10,25,0.001,1204,4
0.544,0.001,649,655,10,25,0.001,1304,4
0.562,0.001,703,701,10,25,0.001,1404,4
0.586,0.001,752,752,10,25,0.001,1504,4
0.61,0.001,811,793,10,25,0.001,1604,4
0.622,0.001,863,841,10,25,0.001,1704,4
0.642,0.001,925,879,10,25,0.001,1804,4
0.666,0.001,974,930,10,25,0.001,1904,4
0.684,0.001,1021,983,10,25,0.001,2004,4
0.424,0.001,47,57,10,25,0.001,104,5
0.428,0.001,95,109,10,25,0.001,204,5
0.426,0.001,140,164,10,25,0.001,304,5
0.434,0.001,191,213,10,25,0.001,404,5
0.434,0.001,239,265,10,25,0.001,504,5
0.426,0.001,294,310,10,25,0.001,604,5
0.438,0.001,347,357,10,25,0.001,704,5
0.448,0.001,401,403,10,25,0.001,804,5
0.458,0.001,447,457,10,25,0.001,904,5
0.49,0.001,492,512,10,25,0.001,1004,5
0.512,0.001,548,556,10,25,0.001,1104,5
0.538,0.001,600,604,10,25,0.001,1204,5
0.556,0.001,655,649,10,25,0.001,1304,5
0.568,0.001,698,706,10,25,0.001,1404,5
0.58,0.001,755,749,10,25,0.001,1504,5
0.588,0.001,807,797,10,25,0.001,1604,5
0.6,0.001,860,844,10,25,0.001,1704,5
0.61,0.001,911,893,10,25,0.001,1804,5
0.622,0.001,948,956,10,25,0.001,1904,5
0.64,0.001,999,1005,10,25,0.001,2004,5
0.506,0.001,49,55,10,25,0.001,104,6
0.506,0.001,93,111,10,25,0.001,204,6
0.52,0.001,143,161,10,25,0.001,304,6
0.518,0.001,199,205,10,25,0.001,404,6
0.524,0.001,245,259,10,25,0.001,504,6
0.53,0.001,301,303,10,25,0.001,604,6
0.548,0.001,350,354,10,25,0.001,704,6
0.554,0.001,406,398,10,25,0.001,804,6
0.566,0.001,444,460,10,25,0.001,904,6
0.586,0.001,499,505,10,25,0.001,1004,6
0.572,0.001,549,555,10,25,0.001,1104,6
0.576,0.001,592,612,10,25,0.001,1204,6
0.594,0.001,636,668,10,25,0.001,1304,6
0.6,0.001,690,714,10,25,0.001,1404,6
0.606,0.001,752,752,10,25,0.001,1504,6
0.612,0.001,808,796,10,25,0.001,1604,6
0.636,0.001,854,850,10,25,0.001,1704,6
0.652,0.001,901,903,10,25,0.001,1804,6
0.674,0.001,955,949,10,25,0.001,1904,6
0.688,0.001,1007,997,10,25,0.001,2004,6
0.49,0.001,54,50,10,25,0.001,104,7
0.49,0.001,108,96,10,25,0.001,204,7
0.488,0.001,162,142,10,25,0.001,304,7
0.49,0.001,219,185,10,25,0.001,404,7
0.492,0.001,272,232,10,25,0.001,504,7
0.502,0.001,325,279,10,25,0.001,604,7
0.504,0.001,369,335,10,25,0.001,704,7
0.506,0.001,413,391,10,25,0.001,804,7
0.516,0.001,467,437,10,25,0.001,904,7
0.526,0.001,514,490,10,25,0.001,1004,7
0.534,0.001,565,539,10,25,0.001,1104,7
0.54,0.001,614,590,10,25,0.001,1204,7
0.558,0.001,674,630,10,25,0.001,1304,7
0.558,0.001,727,677,10,25,0.001,1404,7
0.59,0.001,776,728,10,25,0.001,1504,7
0.622,0.001,828,776,10,25,0.001,1604,7
0.64,0.001,886,818,10,25,0.001,1704,7
0.654,0.001,929,875,10,25,0.001,1804,7
0.672,0.001,969,935,10,25,0.001,1904,7
0.69,0.001,1012,992,10,25,0.001,2004,7
0.51,0.001,58,46,10,25,0.001,104,8
0.518,0.001,109,95,10,25,0.001,204,8
0.52,0.001,156,148,10,25,0.001,304,8
0.526,0.001,206,198,10,25,0.001,404,8
0.53,0.001,261,243,10,25,0.001,504,8
0.532,0.001,314,290,10,25,0.001,604,8
0.536,0.001,351,353,10,25,0.001,704,8
0.55,0.001,406,398,10,25,0.001,804,8
0.552,0.001,455,449,10,25,0.001,904,8
0.564,0.001,496,508,10,25,0.001,1004,8
0.574,0.001,547,557,10,25,0.001,1104,8
0.586,0.001,603,601,10,25,0.001,1204,8
0.594,0.001,657,647,10,25,0.001,1304,8
0.606,0.001,701,703,10,25,0.001,1404,8
0.61,0.001,762,742,10,25,0.001,1504,8
0.624,0.001,808,796,10,25,0.001,1604,8
0.638,0.001,853,851,10,25,0.001,1704,8
0.662,0.001,899,905,10,25,0.001,1804,8
0.688,0.001,950,954,10,25,0.001,1904,8
0.698,0.001,1006,998,10,25,0.001,2004,8
0.482,0.001,54,50,10,25,0.001,104,9
0.486,0.001,102,102,10,25,0.001,204,9
0.492,0.001,150,154,10,25,0.001,304,9
0.49,0.001,203,201,10,25,0.001,404,9
0.492,0.001,250,254,10,25,0.001,504,9
0.494,0.001,294,310,10,25,0.001,604,9
0.516,0.001,342,362,10,25,0.001,704,9
0.534,0.001,394,410,10,25,0.001,804,9
0.554,0.001,445,459,10,25,0.001,904,9
0.572,0.001,500,504,10,25,0.001,1004,9
0.576,0.001,547,557,10,25,0.001,1104,9
0.568,0.001,596,608,10,25,0.001,1204,9
0.586,0.001,652,652,10,25,0.001,1304,9
0.6,0.001,711,693,10,25,0.001,1404,9
0.612,0.001,757,747,10,25,0.001,1504,9
0.632,0.001,808,796,10,25,0.001,1604,9
0.648,0.001,858,846,10,25,0.001,1704,9
0.672,0.001,908,896,10,25,0.001,1804,9
0.69,0.001,961,943,10,25,0.001,1904,9
0.722,0.001,1014,990,10,25,0.001,2004,9
0.5,0.001,51,53,10,25,0.001,104,10
0.5,0.001,99,105,10,25,0.001,204,10
0.5,0.001,154,150,10,25,0.001,304,10
0.5,0.001,212,192,10,25,0.001,404,10
0.504,0.001,261,243,10,25,0.001,504,10
0.506,0.001,315,289,10,25,0.001,604,10
0.498,0.001,379,325,10,25,0.001,704,10
0.496,0.001,426,378,10,25,0.001,804,10
0.496,0.001,475,429,10,25,0.001,904,10
0.504,0.001,528,476,10,25,0.001,1004,10
0.504,0.001,578,526,10,25,0.001,1104,10
0.518,0.001,627,577,10,25,0.001,1204,10
0.526,0.001,673,631,10,25,0.001,1304,10
0.532,0.001,719,685,10,25,0.001,1404,10
0.568,0.001,760,744,10,25,0.001,1504,10
0.588,0.001,811,793,10,25,0.001,1604,10
0.61,0.001,865,839,10,25,0.001,1704,10
0.612,0.001,909,895,10,25,0.001,1804,10
0.638,0.001,957,947,10,25,0.001,1904,10
0.658,0.001,1001,1003,10,25,0.001,2004,10
0.532,0.001,41,63,10,25,0.001,104,11
0.54,0.001,89,115,10,25,0.001,204,11
0.538,0.001,143,161,10,25,0.001,304,11
0.546,0.001,191,213,10,25,0.001,404,11
0.552,0.001,242,262,10,25,0.001,504,11
0.556,0.001,294,310,10,25,0.001,604,11
0.556,0.001,336,368,10,25,0.001,704,11
0.56,0.001,387,417,10,25,0.001,804,11
0.556,0.001,433,471,10,25,0.001,904,11
0.564,0.001,483,521,10,25,0.001,1004,11
0.57,0.001,527,577,10,25,0.001,1104,11
0.568,0.001,581,623,10,25,0.001,1204,11
0.572,0.001,625,679,10,25,0.001,1304,11
0.582,0.001,673,731,10,25,0.001,1404,11
0.592,0.001,726,778,10,25,0.001,1504,11
0.594,0.001,779,825,10,25,0.001,1604,11
0.61,0.001,837,867,10,25,0.001,1704,11
0.618,0.001,896,908,10,25,0.001,1804,11
0.628,0.001,953,951,10,25,0.001,1904,11
0.644,0.001,1000,1004,10,25,0.001,2004,11
0.48,0.001,51,53,10,25,0.001,104,12
0.48,0.001,100,104,10,25,0.001,204,12
0.48,0.001,155,149,10,25,0.001,304,12
0.48,0.001,201,203,10,25,0.001,404,12
0.486,0.001,256,248,10,25,0.001,504,12
0.486,0.001,296,308,10,25,0.001,604,12
0.488,0.001,348,356,10,25,0.001,704,12
0.49,0.001,400,404,10,25,0.001,804,12
0.494,0.001,445,459,10,25,0.001,904,12
0.5,0.001,494,510,10,25,0.001,1004,12
0.498,0.001,542,562,10,25,0.001,1104,12
0.504,0.001,589,615,10,25,0.001,1204,12
0.52,0.001,636,668,10,25,0.001,1304,12
0.53,0.001,689,715,10,25,0.001,1404,12
0.54,0.001,742,762,10,25,0.001,1504,12
0.552,0.001,796,808,10,25,0.001,1604,12
0.566,0.001,842,862,10,25,0.001,1704,12
0.582,0.001,892,912,10,25,0.001,1804,12
0.586,0.001,941,963,10,25,0.001,1904,12
0.606,0.001,991,1013,10,25,0.001,2004,12
0.492,0.001,50,54,10,25,0.001,104,13
0.492,0.001,100,104,10,25,0.001,204,13
0.5,0.001,161,143,10,25,0.001,304,13
0.504,0.001,213,191,10,25,0.001,404,13
0.508,0.001,269,235,10,25,0.001,504,13
0.528,0.001,312,292,10,25,0.001,604,13
0.536,0.001,362,342,10,25,0.001,704,13
0.55,0.001,409,395,10,25,0.001,804,13
0.568,0.001,461,443,10,25,0.001,904,13
0.574,0.001,508,496,10,25,0.001,1004,13
0.59,0.001,544,560,10,25,0.001,1104,13
0.594,0.001,594,610,10,25,0.001,1204,13
0.602,0.001,634,670,10,25,0.001,1304,13
0.618,0.001,681,723,10,25,0.001,1404,13
0.622,0.001,730,774,10,25,0.001,1504,13
0.64,0.001,775,829,10,25,0.001,1604,13
0.652,0.001,823,881,10,25,0.001,1704,13
0.672,0.001,877,927,10,25,0.001,1804,13
0.688,0.001,927,977,10,25,0.001,1904,13
0.694,0.001,979,1025,10,25,0.001,2004,13
0.542,0.001,55,49,10,25,0.001,104,14
0.542,0.001,106,98,10,25,0.001,204,14
0.548,0.001,163,141,10,25,0.001,304,14
0.552,0.001,207,197,10,25,0.001,404,14
0.558,0.001,262,242,10,25,0.001,504,14
0.56,0.001,311,293,10,25,0.001,604,14
0.564,0.001,368,336,10,25,0.001,704,14
0.558,0.001,412,392,10,25,0.001,804,14
0.57,0.001,457,447,10,25,0.001,904,14
0.572,0.001,507,497,10,25,0.001,1004,14
0.584,0.001,551,553,10,25,0.001,1104,14
0.58,0.001,601,603,10,25,0.001,1204,14
0.582,0.001,654,650,10,25,0.001,1304,14
0.594,0.001,704,700,10,25,0.001,1404,14
0.604,0.001,762,742,10,25,0.001,1504,14
0.614,0.001,816,788,10,25,0.001,1604,14
0.628,0.001,862,842,10,25,0.001,1704,14
0.658,0.001,922,882,10,25,0.001,1804,14
0.674,0.001,975,929,10,25,0.001,1904,14
0.676,0.001,1023,981,10,25,0.001,2004,14
0.456,0.001,62,42,10,25,0.001,104,15
0.466,0.001,115,89,10,25,0.001,204,15
0.468,0.001,164,140,10,25,0.001,304,15
0.474,0.001,214,190,10,25,0.001,404,15
0.468,0.001,265,239,10,25,0.001,504,15
0.466,0.001,314,290,10,25,0.001,604,15
0.46,0.001,365,339,10,25,0.001,704,15
0.464,0.001,413,391,10,25,0.001,804,15
0.468,0.001,459,445,10,25,0.001,904,15
0.474,0.001,519,485,10,25,0.001,1004,15
0.496,0.001,576,528,10,25,0.001,1104,15
0.51,0.001,637,567,10,25,0.001,1204,15
0.528,0.001,689,615,10,25,0.001,1304,15
0.544,0.001,736,668,10,25,0.001,1404,15
0.552,0.001,778,726,10,25,0.001,1504,15
0.57,0.001,824,780,10,25,0.001,1604,15
0.582,0.001,875,829,10,25,0.001,1704,15
0.59,0.001,928,876,10,25,0.001,1804,15
0.59,0.001,969,935,10,25,0.001,1904,15
0.608,0.001,1018,986,10,25,0.001,2004,15
0.468,0.001,48,56,10,25,0.001,104,16
0.468,0.001,106,98,10,25,0.001,204,16
0.468,0.001,153,151,10,25,0.001,304,16
0.468,0.001,208,196,10,25,0.001,404,16
0.472,0.001,265,239,10,25,0.001,504,16
0.472,0.001,313,291,10,25,0.001,604,16
0.468,0.001,361,343,10,25,0.001,704,16
0.464,0.001,404,400,10,25,0.001,804,16
0.474,0.001,456,448,10,25,0.001,904,16
0.478,0.001,499,505,10,25,0.001,1004,16
0.474,0.001,546,558,10,25,0.001,1104,16
0.502,0.001,587,617,10,25,0.001,1204,16
0.52,0.001,636,668,10,25,0.001,1304,16
0.542,0.001,682,722,10,25,0.001,1404,16
0.552,0.001,735,769,10,25,0.001,1504,16
0.588,0.001,780,824,10,25,0.001,1604,16
0.62,0.001,822,882,10,25,0.001,1704,16
0.636,0.001,880,924,10,25,0.001,1804,16
0.662,0.001,931,973,10,25,0.001,1904,16
0.678,0.001,989,1015,10,25,0.001,2004,16
0.51,0.001,59,45,10,25,0.001,104,17
0.508,0.001,110,94,10,25,0.001,204,17
0.508,0.001,162,142,10,25,0.001,304,17
0.514,0.001,213,191,10,25,0.001,404,17
0.518,0.001,273,231,10,25,0.001,504,17
0.512,0.001,319,285,10,25,0.001,604,17
0.512,0.001,373,331,10,25,0.001,704,17
0.516,0.001,422,382,10,25,0.001,804,17
0.522,0.001,456,448,10,25,0.001,904,17
0.528,0.001,510,494,10,25,0.001,1004,17
0.516,0.001,571,533,10,25,0.001,1104,17
0.526,0.001,618,586,10,25,0.001,1204,17
0.536,0.001,668,636,10,25,0.001,1304,17
0.548,0.001,715,689,10,25,0.001,1404,17
0.56,0.001,758,746,10,25,0.001,1504,17
0.568,0.001,808,796,10,25,0.001,1604,17
0.578,0.001,863,841,10,25,0.001,1704,17
0.596,0.001,915,889,10,25,0.001,1804,17
0.614,0.001,969,935,10,25,0.001,1904,17
0.632,0.001,1009,995,10,25,0.001,2004,17
0.472,0.001,54,50,10,25,0.001,104,18
0.474,0.001,105,99,10,25,0.001,204,18
0.472,0.001,155,149,10,25,0.001,304,18
0.472,0.001,204,200,10,25,0.001,404,18
0.474,0.001,261,243,10,25,0.001,504,18
0.476,0.001,313,291,10,25,0.001,604,18
0.478,0.001,367,337,10,25,0.001,704,18
0.468,0.001,424,380,10,25,0.001,804,18
0.47,0.001,474,430,10,25,0.001,904,18
0.478,0.001,532,472,10,25,0.001,1004,18
0.49,0.001,585,519,10,25,0.001,1104,18
0.502,0.001,632,572,10,25,0.001,1204,18
0.516,0.001,672,632,10,25,0.001,1304,18
0.53,0.001,722,682,10,25,0.001,1404,18
0.576,0.001,768,736,10,25,0.001,1504,18
0.59,0.001,824,780,10,25,0.001,1604,18
0.604,0.001,871,833,10,25,0.001,1704,18
0.622,0.001,920,884,10,25,0.001,1804,18
0.646,0.001,969,935,10,25,0.001,1904,18
0.67,0.001,1009,995,10,25,0.001,2004,18
0.532,0.001,61,43,10,25,0.001,104,19
0.532,0.001,114,90,10,25,0.001,204,19
0.532,0.001,167,137,10,25,0.001,304,19
0.54,0.001,219,185,10,25,0.001,404,19
0.542,0.001,265,239,10,25,0.001,504,19
0.554,0.001,317,287,10,25,0.001,604,19
0.558,0.001,361,343,10,25,0.001,704,19
0.564,0.001,410,394,10,25,0.001,804,19
0.568,0.001,466,438,10,25,0.001,904,19
0.572,0.001,508,496,10,25,0.001,1004,19
0.588,0.001,560,544,10,25,0.001,1104,19
0.602,0.001,613,591,10,25,0.001,1204,19
0.608,0.001,650,654,10,25,0.001,1304,19
0.624,0.001,699,705,10,25,0.001,1404,19
0.638,0.001,748,756,10,25,0.001,1504,19
0.644,0.001,802,802,10,25,0.001,1604,19
0.666,0.001,852,852,10,25,0.001,1704,19
0.676,0.001,914,890,10,25,0.001,1804,19
0.686,0.001,968,936,10,25,0.001,1904,19
0.706,0.001,1013,991,10,25,0.001,2004,19
0.512,0.001,52,52,10,25,0.001,104,20
0.514,0.001,100,104,10,25,0.001,204,20
0.51,0.001,157,147,10,25,0.001,304,20
0.512,0.001,209,195,10,25,0.001,404,20
0.516,0.001,258,246,10,25,0.001,504,20
0.52,0.001,300,304,10,25,0.001,604,20
0.524,0.001,358,346,10,25,0.001,704,20
0.524,0.001,397,407,10,25,0.001,804,20
0.54,0.001,453,451,10,25,0.001,904,20
0.542,0.001,506,498,10,25,0.001,1004,20
0.562,0.001,554,550,10,25,0.001,1104,20
0.572,0.001,611,593,10,25,0.001,1204,20
0.584,0.001,662,642,10,25,0.001,1304,20
0.596,0.001,711,693,10,25,0.001,1404,20
0.596,0.001,761,743,10,25,0.001,1504,20
0.622,0.001,810,794,10,25,0.001,1604,20
0.642,0.001,858,846,10,25,0.001,1704,20
0.672,0.001,910,894,10,25,0.001,1804,20
0.688,0.001,965,939,10,25,0.001,1904,20
0.724,0.001,1015,989,10,25,0.001,2004,20
0.528,0.001,47,57,10,25,0.01,104,1
0.556,0.001,92,112,10,25,0.01,204,1
0.576,0.001,141,163,10,25,0.01,304,1
0.608,0.001,186,218,10,25,0.01,404,1
0.64,0.001,246,258,10,25,0.01,504,1
0.69,0.001,288,316,10,25,0.01,604,1
0.718,0.001,336,368,10,25,0.01,704,1
0.778,0.001,389,415,10,25,0.01,804,1
0.824,0.001,443,461,10,25,0.01,904,1
0.846,0.001,489,515,10,25,0.01,1004,1
0.872,0.001,531,573,10,25,0.01,1104,1
0.89,0.001,580,624,10,25,0.01,1204,1
0.908,0.001,629,675,10,25,0.01,1304,1
0.92,0.001,686,718,10,25,0.01,1404,1
0.942,0.001,732,772,10,25,0.01,1504,1
0.946,0.001,791,813,10,25,0.01,1604,1
0.954,0.001,838,866,10,25,0.01,1704,1
0.962,0.001,888,916,10,25,0.01,1804,1
0.966,0.001,938,966,10,25,0.01,1904,1
0.97,0.001,987,1017,10,25,0.01,2004,1
0.554,0.001,56,48,10,25,0.01,104,2
0.59,0.001,97,107,10,25,0.01,204,2
0.612,0.001,147,157,10,25,0.01,304,2
0.612,0.001,198,206,10,25,0.01,404,2
0.65,0.001,253,251,10,25,0.01,504,2
0.694,0.001,303,301,10,25,0.01,604,2
0.734,0.001,356,348,10,25,0.01,704,2
0.788,0.001,403,401,10,25,0.01,804,2
0.834,0.001,448,456,10,25,0.01,904,2
0.858,0.001,496,508,10,25,0.01,1004,2
0.868,0.001,551,553,10,25,0.01,1104,2
0.9,0.001,607,597,10,25,0.01,1204,2
0.928,0.001,655,649,10,25,0.01,1304,2
0.934,0.001,703,701,10,25,0.01,1404,2
0.938,0.001,751,753,10,25,0.01,1504,2
0.946,0.001,798,806,10,25,0.01,1604,2
0.956,0.001,849,855,10,25,0.01,1704,2
0.956,0.001,895,909,10,25,0.01,1804,2
0.958,0.001,950,954,10,25,0.01,1904,2
0.966,0.001,1004,1000,10,25,0.01,2004,2
0.522,0.001,54,50,10,25,0.01,104,3
0.532,0.001,104,100,10,25,0.01,204,3
0.566,0.001,154,150,10,25,0.01,304,3
0.614,0.001,205,199,10,25,0.01,404,3
0.648,0.001,260,244,10,25,0.01,504,3
0.654,0.001,311,293,10,25,0.01,604,3
0.716,0.001,364,340,10,25,0.01,704,3
0.754,0.001,417,387,10,25,0.01,804,3
0.77,0.001,469,435,10,25,0.01,904,3
0.84,0.001,520,484,10,25,0.01,1004,3
0.852,0.001,571,533,10,25,0.01,1104,3
0.85,0.001,618,586,10,25,0.01,1204,3
0.866,0.001,665,639,10,25,0.01,1304,3
0.9,0.001,721,683,10,25,0.01,1404,3
0.912,0.001,778,726,10,25,0.01,1504,3
0.932,0.001,817,787,10,25,0.01,1604,3
0.94,0.001,877,827,10,25,0.01,1704,3
0.934,0.001,917,887,10,25,0.01,1804,3
0.934,0.001,961,943,10,25,0.01,1904,3
0.942,0.001,1012,992,10,25,0.01,2004,3
0.514,0.001,63,41,10,25,0.01,104,4
0.554,0.001,118,86,10,25,0.01,204,4
0.562,0.001,170,134,10,25,0.01,304,4
0.588,0.001,220,184,10,25,0.01,404,4
0.606,0.001,281,223,10,25,0.01,504,4
0.67,0.001,327,277,10,25,0.01,604,4
0.674,0.001,365,339,10,25,0.01,704,4
0.712,0.001,422,382,10,25,0.01,804,4
0.746,0.001,474,430,10,25,0.01,904,4
0.81,0.001,523,481,10,25,0.01,1004,4
0.852,0.001,566,538,10,25,0.01,1104,4
0.89,0.001,618,586,10,25,0.01,1204,4
0.922,0.001,669,635,10,25,0.01,1304,4
0.93,0.001,717,687,10,25,0.01,1404,4
0.938,0.001,763,741,10,25,0.01,1504,4
0.948,0.001,809,795,10,25,0.01,1604,4
0.952,0.001,864,840,10,25,0.01,1704,4
0.95,0.001,905,899,10,25,0.01,1804,4
0.952,0.001,954,950,10,25,0.01,1904,4
0.958,0.001,1003,1001,10,25,0.01,2004,4
0.534,0.001,52,52,10,25,0.01,104,5
0.552,0.001,98,106,10,25,0.01,204,5
0.552,0.001,147,157,10,25,0.01,304,5
0.57,0.001,200,204,10,25,0.01,404,5
0.598,0.001,254,250,10,25,0.01,504,5
0.664,0.001,306,298,10,25,0.01,604,5
0.712,0.001,352,352,10,25,0.01,704,5
0.744,0.001,403,401,10,25,0.01,804,5
0.776,0.001,455,449,10,25,0.01,904,5
0.816,0.001,508,496,10,25,0.01,1004,5
0.876,0.001,559,545,10,25,0.01,1104,5
0.91,0.001,608,596,10,25,0.01,1204,5
0.922,0.001,661,643,10,25,0.01,1304,5
0.94,0.001,706,698,10,25,0.01,1404,5
0.95,0.001,753,751,10,25,0.01,1504,5
0.948,0.001,805,799,10,25,0.01,1604,5
0.954,0.001,850,854,10,25,0.01,1704,5
0.964,0.001,903,901,10,25,0.01,1804,5
0.964,0.001,948,956,10,25,0.01,1904,5
0.962,0.001,1000,1004,10,25,0.01,2004,5
0.476,0.001,54,50,10,25,0.01,104,6
0.514,0.001,104,100,10,25,0.01,204,6
0.54,0.001,153,151,10,25,0.01,304,6
0.59,0.001,206,198,10,25,0.01,404,6
0.632,0.001,255,249,10,25,0.01,504,6
0.694,0.001,313,291,10,25,0.01,604,6
0.75,0.001,363,341,10,25,0.01,704,6
0.818,0.001,413,391,10,25,0.01,804,6
0.86,0.001,457,447,10,25,0.01,904,6
0.898,0.001,506,498,10,25,0.01,1004,6
0.902,0.001,557,547,10,25,0.01,1104,6
0.934,0.001,606,598,10,25,0.01,1204,6
0.956,0.001,655,649,10,25,0.01,1304,6
0.966,0.001,696,708,10,25,0.01,1404,6
0.966,0.001,759,745,10,25,0.01,1504,6
0.97,0.001,816,788,10,25,0.01,1604,6
0.972,0.001,860,844,10,25,0.01,1704,6
0.972,0.001,915,889,10,25,0.01,1804,6
0.978,0.001,959,945,10,25,0.01,1904,6
0.98,0.001,1018,986,10,25,0.01,2004,6
0.5,0.001,44,60,10,25,0.01,104,7
0.516,0.001,92,112,10,25,0.01,204,7
0.526,0.001,147,157,10,25,0.01,304,7
0.582,0.001,196,208,10,25,0.01,404,7
0.61,0.001,245,259,10,25,0.01,504,7
0.656,0.001,298,306,10,25,0.01,604,7
0.724,0.001,343,361,10,25,0.01,704,7
0.792,0.001,390,414,10,25,0.01,804,7
0.824,0.001,437,467,10,25,0.01,904,7
0.85,0.001,493,511,10,25,0.01,1004,7
0.888,0.001,550,554,10,25,0.01,1104,7
0.932,0.001,604,600,10,25,0.01,1204,7
0.936,0.001,651,653,10,25,0.01,1304,7
0.96,0.001,696,708,10,25,0.01,1404,7
0.968,0.001,750,754,10,25,0.01,1504,7
0.97,0.001,798,806,10,25,0.01,1604,7
0.974,0.001,846,858,10,25,0.01,1704,7
0.976,0.001,898,906,10,25,0.01,1804,7
0.972,0.001,956,948,10,25,0.01,1904,7
0.976,0.001,1004,1000,10,25,0.01,2004,7
0.526,0.001,56,48,10,25,0.01,104,8
0.492,0.001,120,84,10,25,0.01,204,8
0.492,0.001,175,129,10,25,0.01,304,8
0.532,0.001,226,178,10,25,0.01,404,8
0.57,0.001,267,237,10,25,0.01,504,8
0.59,0.001,320,284,10,25,0.01,604,8
0.592,0.001,363,341,10,25,0.01,704,8
0.62,0.001,412,392,10,25,0.01,804,8
0.702,0.001,470,434,10,25,0.01,904,8
0.774,0.001,527,477,10,25,0.01,1004,8
0.808,0.001,574,530,10,25,0.01,1104,8
0.862,0.001,614,590,10,25,0.01,1204,8
0.88,0.001,659,645,10,25,0.01,1304,8
0.906,0.001,711,693,10,25,0.01,1404,8
0.906,0.001,766,738,10,25,0.01,1504,8
0.922,0.001,812,792,10,25,0.01,1604,8
0.932,0.001,861,843,10,25,0.01,1704,8
0.944,0.001,908,896,10,25,0.01,1804,8
0.964,0.001,957,947,10,25,0.01,1904,8
0.958,0.001,1011,993,10,25,0.01,2004,8
0.52,0.001,54,50,10,25,0.01,104,9
0.542,0.001,101,103,10,25,0.01,204,9
0.578,0.001,149,155,10,25,0.01,304,9
0.614,0.001,198,206,10,25,0.01,404,9
0.622,0.001,250,254,10,25,0.01,504,9
0.654,0.001,302,302,10,25,0.01,604,9
0.698,0.001,350,354,10,25,0.01,704,9
0.744,0.001,397,407,10,25,0.01,804,9
0.74,0.001,443,461,10,25,0.01,904,9
0.798,0.001,500,504,10,25,0.01,1004,9
0.862,0.001,545,559,10,25,0.01,1104,9
0.884,0.001,597,607,10,25,0.01,1204,9
0.902,0.001,646,658,10,25,0.01,1304,9
0.92,0.001,692,712,10,25,0.01,1404,9
0.918,0.001,747,757,10,25,0.01,1504,9
0.93,0.001,796,808,10,25,0.01,1604,9
0.936,0.001,851,853,10,25,0.01,1704,9
0.944,0.001,901,903,10,25,0.01,1804,9
0.946,0.001,944,960,10,25,0.01,1904,9
0.95,0.001,996,1008,10,25,0.01,2004,9
0.536,0.001,45,59,10,25,0.01,104,10
0.57,0.001,98,106,10,25,0.01,204,10
0.576,0.001,139,165,10,25,0.01,304,10
0.594,0.001,191,213,10,25,0.01,404,10
0.624,0.001,244,260,10,25,0.01,504,10
0.686,0.001,292,312,10,25,0.01,604,10
0.708,0.001,340,364,10,25,0.01,704,10
0.766,0.001,394,410,10,25,0.01,804,10
0.81,0.001,447,457,10,25,0.01,904,10
0.898,0.001,498,506,10,25,0.01,1004,10
0.928,0.001,546,558,10,25,0.01,1104,10
0.94,0.001,592,612,10,25,0.01,1204,10
0.942,0.001,649,655,10,25,0.01,1304,10
0.958,0.001,698,706,10,25,0.01,1404,10
0.968,0.001,750,754,10,25,0.01,1504,10
0.97,0.001,804,800,10,25,0.01,1604,10
0.972,0.001,861,843,10,25,0.01,1704,10
0.97,0.001,911,893,10,25,0.01,1804,10
0.972,0.001,958,946,10,25,0.01,1904,10
0.98,0.001,1007,997,10,25,0.01,2004,10
0.508,0.001,59,45,10,25,0.01,104,11
0.502,0.001,113,91,10,25,0.01,204,11
0.514,0.001,162,142,10,25,0.01,304,11
0.522,0.001,207,197,10,25,0.01,404,11
0.534,0.001,247,257,10,25,0.01,504,11
0.578,0.001,299,305,10,25,0.01,604,11
0.598,0.001,360,344,10,25,0.01,704,11
0.644,0.001,408,396,10,25,0.01,804,11
0.702,0.001,458,446,10,25,0.01,904,11
0.77,0.001,516,488,10,25,0.01,1004,11
0.842,0.001,560,544,10,25,0.01,1104,11
0.882,0.001,610,594,10,25,0.01,1204,11
0.912,0.001,664,640,10,25,0.01,1304,11
0.934,0.001,709,695,10,25,0.01,1404,11
0.956,0.001,761,743,10,25,0.01,1504,11
0.972,0.001,818,786,10,25,0.01,1604,11
0.976,0.001,864,840,10,25,0.01,1704,11
0.976,0.001,914,890,10,25,0.01,1804,11
0.976,0.001,958,946,10,25,0.01,1904,11
0.982,0.001,1008,996,10,25,0.01,2004,11
0.506,0.001,54,50,10,25,0.01,104,12
0.522,0.001,105,99,10,25,0.01,204,12
0.548,0.001,143,161,10,25,0.01,304,12
0.56,0.001,191,213,10,25,0.01,404,12
0.59,0.001,236,268,10,25,0.01,504,12
0.628,0.001,281,323,10,25,0.01,604,12
0.668,0.001,321,383,10,25,0.01,704,12
0.722,0.001,367,437,10,25,0.01,804,12
0.762,0.001,419,485,10,25,0.01,904,12
0.814,0.001,472,532,10,25,0.01,1004,12
0.878,0.001,526,578,10,25,0.01,1104,12
0.924,0.001,575,629,10,25,0.01,1204,12
0.928,0.001,629,675,10,25,0.01,1304,12
0.936,0.001,688,716,10,25,0.01,1404,12
0.94,0.001,746,758,10,25,0.01,1504,12
0.952,0.001,809,795,10,25,0.01,1604,12
0.948,0.001,858,846,10,25,0.01,1704,12
0.952,0.001,906,898,10,25,0.01,1804,12
0.962,0.001,964,940,10,25,0.01,1904,12
0.962,0.001,1004,1000,10,25,0.01,2004,12
0.508,0.001,54,50,10,25,0.01,104,13
0.538,0.001,105,99,10,25,0.01,204,13
0.54,0.001,155,149,10,25,0.01,304,13
0.558,0.001,202,202,10,25,0.01,404,13
0.588,0.001,257,247,10,25,0.01,504,13
0.63,0.001,300,304,10,25,0.01,604,13
0.692,0.001,349,355,10,25,0.01,704,13
0.75,0.001,408,396,10,25,0.01,804,13
0.784,0.001,453,451,10,25,0.01,904,13
0.834,0.001,505,499,10,25,0.01,1004,13
0.844,0.001,558,546,10,25,0.01,1104,13
0.884,0.001,612,592,10,25,0.01,1204,13
0.894,0.001,665,639,10,25,0.01,1304,13
0.932,0.001,715,689,10,25,0.01,1404,13
0.948,0.001,762,742,10,25,0.01,1504,13
0.954,0.001,814,790,10,25,0.01,1604,13
0.96,0.001,865,839,10,25,0.01,1704,13
0.964,0.001,910,894,10,25,0.01,1804,13
0.966,0.001,952,952,10,25,0.01,1904,13
0.964,0.001,1005,999,10,25,0.01,2004,13
0.54,0.001,56,48,10,25,0.01,104,14
0.54,0.001,106,98,10,25,0.01,204,14
0.56,0.001,155,149,10,25,0.01,304,14
0.59,0.001,206,198,10,25,0.01,404,14
0.608,0.001,259,245,10,25,0.01,504,14
0.62,0.001,306,298,10,25,0.01,604,14
0.646,0.001,357,347,10,25,0.01,704,14
0.714,0.001,407,397,10,25,0.01,804,14
0.758,0.001,450,454,10,25,0.01,904,14
0.822,0.001,497,507,10,25,0.01,1004,14
0.874,0.001,549,555,10,25,0.01,1104,14
0.902,0.001,600,604,10,25,0.01,1204,14
0.912,0.001,661,643,10,25,0.01,1304,14
0.922,0.001,721,683,10,25,0.01,1404,14
0.918,0.001,767,737,10,25,0.01,1504,14
0.922,0.001,824,780,10,25,0.01,1604,14
0.93,0.001,867,837,10,25,0.01,1704,14
0.934,0.001,906,898,10,25,0.01,1804,14
0.94,0.001,952,952,10,25,0.01,1904,14
0.948,0.001,1004,1000,10,25,0.01,2004,14
0.518,0.001,49,55,10,25,0.01,104,15
0.536,0.001,109,95,10,25,0.01,204,15
0.58,0.001,153,151,10,25,0.01,304,15
0.606,0.001,195,209,10,25,0.01,404,15
0.624,0.001,247,257,10,25,0.01,504,15
0.66,0.001,308,296,10,25,0.01,604,15
0.72,0.001,357,347,10,25,0.01,704,15
0.766,0.001,406,398,10,25,0.01,804,15
0.82,0.001,452,452,10,25,0.01,904,15
0.872,0.001,498,506,10,25,0.01,1004,15
0.894,0.001,546,558,10,25,0.01,1104,15
0.916,0.001,598,606,10,25,0.01,1204,15
0.932,0.001,649,655,10,25,0.01,1304,15
0.94,0.001,702,702,10,25,0.01,1404,15
0.946,0.001,749,755,10,25,0.01,1504,15
0.954,0.001,802,802,10,25,0.01,1604,15
0.956,0.001,851,853,10,25,0.01,1704,15
0.966,0.001,897,907,10,25,0.01,1804,15
0.97,0.001,946,958,10,25,0.01,1904,15
0.968,0.001,995,1009,10,25,0.01,2004,15
0.466,0.001,49,55,10,25,0.01,104,16
0.488,0.001,96,108,10,25,0.01,204,16
0.534,0.001,140,164,10,25,0.01,304,16
0.574,0.001,187,217,10,25,0.01,404,16
0.588,0.001,233,271,10,25,0.01,504,16
0.654,0.001,287,317,10,25,0.01,604,16
0.69,0.001,329,375,10,25,0.01,704,16
0.738,0.001,377,427,10,25,0.01,804,16
0.812,0.001,419,485,10,25,0.01,904,16
0.864,0.001,458,546,10,25,0.01,1004,16
0.886,0.001,508,596,10,25,0.01,1104,16
0.914,0.001,567,637,10,25,0.01,1204,16
0.912,0.001,624,680,10,25,0.01,1304,16
0.932,0.001,677,727,10,25,0.01,1404,16
0.944,0.001,732,772,10,25,0.01,1504,16
0.956,0.001,787,817,10,25,0.01,1604,16
0.96,0.001,840,864,10,25,0.01,1704,16
0.962,0.001,893,911,10,25,0.01,1804,16
0.966,0.001,944,960,10,25,0.01,1904,16
0.972,0.001,997,1007,10,25,0.01,2004,16
0.462,0.001,55,49,10,25,0.01,104,17
0.468,0.001,101,103,10,25,0.01,204,17
0.504,0.001,160,144,10,25,0.01,304,17
0.542,0.001,214,190,10,25,0.01,404,17
0.562,0.001,266,238,10,25,0.01,504,17
0.578,0.001,313,291,10,25,0.01,604,17
0.6,0.001,365,339,10,25,0.01,704,17
0.65,0.001,413,391,10,25,0.01,804,17
0.696,0.001,470,434,10,25,0.01,904,17
0.75,0.001,528,476,10,25,0.01,1004,17
0.794,0.001,580,524,10,25,0.01,1104,17
0.846,0.001,627,577,10,25,0.01,1204,17
0.864,0.001,670,634,10,25,0.01,1304,17
0.926,0.001,724,680,10,25,0.01,1404,17
0.938,0.001,772,732,10,25,0.01,1504,17
0.954,0.001,815,789,10,25,0.01,1604,17
0.952,0.001,871,833,10,25,0.01,1704,17
0.968,0.001,924,880,10,25,0.01,1804,17
0.968,0.001,972,932,10,25,0.01,1904,17
0.974,0.001,1014,990,10,25,0.01,2004,17
0.526,0.001,46,58,10,25,0.01,104,18
0.544,0.001,99,105,10,25,0.01,204,18
0.56,0.001,152,152,10,25,0.01,304,18
0.584,0.001,207,197,10,25,0.01,404,18
0.618,0.001,255,249,10,25,0.01,504,18
0.702,0.001,302,302,10,25,0.01,604,18
0.744,0.001,350,354,10,25,0.01,704,18
0.802,0.001,399,405,10,25,0.01,804,18
0.828,0.001,457,447,10,25,0.01,904,18
0.872,0.001,512,492,10,25,0.01,1004,18
0.902,0.001,562,542,10,25,0.01,1104,18
0.918,0.001,611,593,10,25,0.01,1204,18
0.946,0.001,658,646,10,25,0.01,1304,18
0.944,0.001,705,699,10,25,0.01,1404,18
0.944,0.001,756,748,10,25,0.01,1504,18
0.952,0.001,807,797,10,25,0.01,1604,18
0.954,0.001,861,843,10,25,0.01,1704,18
0.966,0.001,912,892,10,25,0.01,1804,18
0.972,0.001,959,945,10,25,0.01,1904,18
0.974,0.001,1002,1002,10,25,0.01,2004,18
0.518,0.001,56,48,10,25,0.01,104,19
0.55,0.001,102,102,10,25,0.01,204,19
0.566,0.001,154,150,10,25,0.01,304,19
0.588,0.001,206,198,10,25,0.01,404,19
0.604,0.001,259,245,10,25,0.01,504,19
0.634,0.001,312,292,10,25,0.01,604,19
0.662,0.001,359,345,10,25,0.01,704,19
0.714,0.001,409,395,10,25,0.01,804,19
0.774,0.001,459,445,10,25,0.01,904,19
0.802,0.001,500,504,10,25,0.01,1004,19
0.836,0.001,550,554,10,25,0.01,1104,19
0.876,0.001,601,603,10,25,0.01,1204,19
0.9,0.001,651,653,10,25,0.01,1304,19
0.93,0.001,698,706,10,25,0.01,1404,19
0.958,0.001,749,755,10,25,0.01,1504,19
0.954,0.001,803,801,10,25,0.01,1604,19
0.954,0.001,859,845,10,25,0.01,1704,19
0.956,0.001,897,907,10,25,0.01,1804,19
0.956,0.001,949,955,10,25,0.01,1904,19
0.962,0.001,1005,999,10,25,0.01,2004,19
0.516,0.001,45,59,10,25,0.01,104,20
0.57,0.001,97,107,10,25,0.01,204,20
0.596,0.001,151,153,10,25,0.01,304,20
0.608,0.001,196,208,10,25,0.01,404,20
0.632,0.001,251,253,10,25,0.01,504,20
0.642,0.001,309,295,10,25,0.01,604,20
0.664,0.001,361,343,10,25,0.01,704,20
0.732,0.001,401,403,10,25,0.01,804,20
0.788,0.001,455,449,10,25,0.01,904,20
0.828,0.001,511,493,10,25,0.01,1004,20
0.87,0.001,562,542,10,25,0.01,1104,20
0.914,0.001,616,588,10,25,0.01,1204,20
0.922,0.001,665,639,10,25,0.01,1304,20
0.938,0.001,716,688,10,25,0.01,1404,20
0.948,0.001,770,734,10,25,0.01,1504,20
0.944,0.001,812,792,10,25,0.01,1604,20
0.96,0.001,860,844,10,25,0.01,1704,20
0.96,0.001,910,894,10,25,0.01,1804,20
0.958,0.001,958,946,10,25,0.01,1904,20
0.966,0.001,1006,998,10,25,0.01,2004,20
0.484,1e-05,56,48,10,50,0.0001,104,1
0.484,1e-05,107,97,10,50,0.0001,204,1
0.484,1e-05,151,153,10,50,0.0001,304,1
0.482,1e-05,200,204,10,50,0.0001,404,1
0.482,1e-05,253,251,10,50,0.0001,504,1
0.482,1e-05,307,297,10,50,0.0001,604,1
0.482,1e-05,355,349,10,50,0.0001,704,1
0.482,1e-05,400,404,10,50,0.0001,804,1
0.484,1e-05,450,454,10,50,0.0001,904,1
0.484,1e-05,501,503,10,50,0.0001,1004,1
0.484,1e-05,557,547,10,50,0.0001,1104,1
0.486,1e-05,606,598,10,50,0.0001,1204,1
0.486,1e-05,642,662,10,50,0.0001,1304,1
0.486,1e-05,687,717,10,50,0.0001,1404,1
0.49,1e-05,743,761,10,50,0.0001,1504,1
0.49,1e-05,790,814,10,50,0.0001,1604,1
0.492,1e-05,840,864,10,50,0.0001,1704,1
0.496,1e-05,897,907,10,50,0.0001,1804,1
0.498,1e-05,955,949,10,50,0.0001,1904,1
0.498,1e-05,1009,995,10,50,0.0001,2004,1
0.458,1e-05,47,57,10,50,0.0001,104,2
0.46,1e-05,98,106,10,50,0.0001,204,2
0.46,1e-05,142,162,10,50,0.0001,304,2
0.46,1e-05,193,211,10,50,0.0001,404,2
0.462,1e-05,238,266,10,50,0.0001,504,2
0.46,1e-05,285,319,10,50,0.0001,604,2
0.464,1e-05,326,378,10,50,0.0001,704,2
0.464,1e-05,381,423,10,50,0.0001,804,2
0.464,1e-05,438,466,10,50,0.0001,904,2
0.462,1e-05,490,514,10,50,0.0001,1004,2
0.468,1e-05,543,561,10,50,0.0001,1104,2
0.466,1e-05,592,612,10,50,0.0001,1204,2
0.468,1e-05,643,661,10,50,0.0001,1304,2
0.47,1e-05,694,710,10,50,0.0001,1404,2
0.474,1e-05,743,761,10,50,0.0001,1504,2
0.476,1e-05,791,813,10,50,0.0001,1604,2
0.476,1e-05,843,861,10,50,0.0001,1704,2
0.474,1e-05,898,906,10,50,0.0001,1804,2
0.474,1e-05,943,961,10,50,0.0001,1904,2
0.476,1e-05,1002,1002,10,50,0.0001,2004,2
0.512,1e-05,60,44,10,50,0.0001,104,3
0.512,1e-05,113,91,10,50,0.0001,204,3
0.512,1e-05,161,143,10,50,0.0001,304,3
0.512,1e-05,208,196,10,50,0.0001,404,3
0.514,1e-05,257,247,10,50,0.0001,504,3
0.512,1e-05,302,302,10,50,0.0001,604,3
0.514,1e-05,356,348,10,50,0.0001,704,3
0.516,1e-05,399,405,10,50,0.0001,804,3
0.516,1e-05,447,457,10,50,0.0001,904,3
0.514,1e-05,498,506,10,50,0.0001,1004,3
0.516,1e-05,555,549,10,50,0.0001,1104,3
0.516,1e-05,604,600,10,50,0.0001,1204,3
0.514,1e-05,656,648,10,50,0.0001,1304,3
0.514,1e-05,705,699,10,50,0.0001,1404,3
0.516,1e-05,765,739,10,50,0.0001,1504,3
0.516,1e-05,823,781,10,50,0.0001,1604,3
0.516,1e-05,873,831,10,50,0.0001,1704,3
0.516,1e-05,916,888,10,50,0.0001,1804,3
0.518,1e-05,961,943,10,50,0.0001,1904,3
0.52,1e-05,1012,992,10,50,0.0001,2004,3
0.53,1e-05,43,61,10,50,0.0001,104,4
0.53,1e-05,97,107,10,50,0.0001,204,4
0.532,1e-05,155,149,10,50,0.0001,304,4
0.532,1e-05,197,207,10,50,0.0001,404,4
0.534,1e-05,251,253,10,50,0.0001,504,4
0.536,1e-05,299,305,10,50,0.0001,604,4
0.532,1e-05,361,343,10,50,0.0001,704,4
0.532,1e-05,415,389,10,50,0.0001,804,4
0.532,1e-05,460,444,10,50,0.0001,904,4
0.53,1e-05,508,496,10,50,0.0001,1004,4
0.528,1e-05,558,546,10,50,0.0001,1104,4
0.524,1e-05,610,594,10,50,0.0001,1204,4
0.526,1e-05,662,642,10,50,0.0001,1304,4
0.53,1e-05,709,695,10,50,0.0001,1404,4
0.532,1e-05,762,742,10,50,0.0001,1504,4
0.534,1e-05,813,791,10,50,0.0001,1604,4
0.536,1e-05,853,851,10,50,0.0001,1704,4
0.538,1e-05,900,904,10,50,0.0001,1804,4
0.542,1e-05,956,948,10,50,0.0001,1904,4
0.55,1e-05,994,1010,10,50,0.0001,2004,4
0.484,1e-05,47,57,10,50,0.0001,104,5
0.488,1e-05,103,101,10,50,0.0001,204,5
0.492,1e-05,158,146,10,50,0.0001,304,5
0.49,1e-05,206,198,10,50,0.0001,404,5
0.492,1e-05,261,243,10,50,0.0001,504,5
0.492,1e-05,311,293,10,50,0.0001,604,5
0.492,1e-05,360,344,10,50,0.0001,704,5
0.492,1e-05,415,389,10,50,0.0001,804,5
0.494,1e-05,468,436,10,50,0.0001,904,5
0.494,1e-05,513,491,10,50,0.0001,1004,5
0.498,1e-05,556,548,10,50,0.0001,1104,5
0.502,1e-05,608,596,10,50,0.0001,1204,5
0.506,1e-05,655,649,10,50,0.0001,1304,5
0.506,1e-05,710,694,10,50,0.0001,1404,5
0.51,1e-05,767,737,10,50,0.0001,1504,5
0.516,1e-05,818,786,10,50,0.0001,1604,5
0.526,1e-05,858,846,10,50,0.0001,1704,5
0.536,1e-05,907,897,10,50,0.0001,1804,5
0.546,1e-05,959,945,10,50,0.0001,1904,5
0.554,1e-05,1014,990,10,50,0.0001,2004,5
0.504,1e-05,52,52,10,50,0.0001,104,6
0.502,1e-05,106,98,10,50,0.0001,204,6
0.504,1e-05,161,143,10,50,0.0001,304,6
0.506,1e-05,215,189,10,50,0.0001,404,6
0.504,1e-05,261,243,10,50,0.0001,504,6
0.502,1e-05,307,297,10,50,0.0001,604,6
0.504,1e-05,364,340,10,50,0.0001,704,6
0.506,1e-05,410,394,10,50,0.0001,804,6
0.506,1e-05,469,435,10,50,0.0001,904,6
0.512,1e-05,512,492,10,50,0.0001,1004,6
0.518,1e-05,561,543,10,50,0.0001,1104,6
0.518,1e-05,606,598,10,50,0.0001,1204,6
0.524,1e-05,660,644,10,50,0.0001,1304,6
0.526,1e-05,706,698,10,50,0.0001,1404,6
0.534,1e-05,758,746,10,50,0.0001,1504,6
0.54,1e-05,804,800,10,50,0.0001,1604,6
0.542,1e-05,857,847,10,50,0.0001,1704,6
0.542,1e-05,905,899,10,50,0.0001,1804,6
0.542,1e-05,949,955,10,50,0.0001,1904,6
0.542,1e-05,1001,1003,10,50,0.0001,2004,6
0.484,1e-05,57,47,10,50,0.0001,104,7
0.486,1e-05,105,99,10,50,0.0001,204,7
0.486,1e-05,148,156,10,50,0.0001,304,7
0.48,1e-05,209,195,10,50,0.0001,404,7
0.48,1e-05,257,247,10,50,0.0001,504,7
0.484,1e-05,312,292,10,50,0.0001,604,7
0.49,1e-05,372,332,10,50,0.0001,704,7
0.49,1e-05,433,371,10,50,0.0001,804,7
0.49,1e-05,484,420,10,50,0.0001,904,7
0.488,1e-05,538,466,10,50,0.0001,1004,7
0.488,1e-05,580,524,10,50,0.0001,1104,7
0.494,1e-05,625,579,10,50,0.0001,1204,7
0.494,1e-05,674,630,10,50,0.0001,1304,7
0.496,1e-05,714,690,10,50,0.0001,1404,7
0.498,1e-05,764,740,10,50,0.0001,1504,7
0.498,1e-05,816,788,10,50,0.0001,1604,7
0.504,1e-05,860,844,10,50,0.0001,1704,7
0.504,1e-05,913,891,10,50,0.0001,1804,7
0.506,1e-05,960,944,10,50,0.0001,1904,7
0.51,1e-05,1004,1000,10,50,0.0001,2004,7
0.494,1e-05,57,47,10,50,0.0001,104,8
0.492,1e-05,99,105,10,50,0.0001,204,8
0.492,1e-05,154,150,10,50,0.0001,304,8
0.494,1e-05,197,207,10,50,0.0001,404,8
0.494,1e-05,243,261,10,50,0.0001,504,8
0.496,1e-05,280,324,10,50,0.0001,604,8
0.498,1e-05,338,366,10,50,0.0001,704,8
0.504,1e-05,389,415,10,50,0.0001,804,8
0.506,1e-05,439,465,10,50,0.0001,904,8
0.508,1e-05,496,508,10,50,0.0001,1004,8
0.508,1e-05,538,566,10,50,0.0001,1104,8
0.51,1e-05,590,614,10,50,0.0001,1204,8
0.51,1e-05,639,665,10,50,0.0001,1304,8
0.51,1e-05,685,719,10,50,0.0001,1404,8
0.516,1e-05,738,766,10,50,0.0001,1504,8
0.518,1e-05,792,812,10,50,0.0001,1604,8
0.522,1e-05,837,867,10,50,0.0001,1704,8
0.524,1e-05,888,916,10,50,0.0001,1804,8
0.522,1e-05,935,969,10,50,0.0001,1904,8
0.524,1e-05,988,1016,10,50,0.0001,2004,8
0.472,1e-05,48,56,10,50,0.0001,104,9
0.472,1e-05,102,102,10,50,0.0001,204,9
0.474,1e-05,148,156,10,50,0.0001,304,9
0.474,1e-05,189,215,10,50,0.0001,404,9
0.476,1e-05,244,260,10,50,0.0001,504,9
0.476,1e-05,289,315,10,50,0.0001,604,9
0.478,1e-05,337,367,10,50,0.0001,704,9
0.476,1e-05,391,413,10,50,0.0001,804,9
0.478,1e-05,443,461,10,50,0.0001,904,9
0.486,1e-05,492,512,10,50,0.0001,1004,9
0.49,1e-05,541,563,10,50,0.0001,1104,9
0.486,1e-05,593,611,10,50,0.0001,1204,9
0.488,1e-05,645,659,10,50,0.0001,1304,9
0.492,1e-05,691,713,10,50,0.0001,1404,9
0.496,1e-05,745,759,10,50,0.0001,1504,9
0.498,1e-05,800,804,10,50,0.0001,1604,9
0.5,1e-05,852,852,10,50,0.0001,1704,9
0.504,1e-05,897,907,10,50,0.0001,1804,9
0.502,1e-05,948,956,10,50,0.0001,1904,9
0.502,1e-05,997,1007,10,50,0.0001,2004,9
0.516,1e-05,56,48,10,50,0.0001,104,10
0.516,1e-05,115,89,10,50,0.0001,204,10
0.518,1e-05,160,144,10,50,0.0001,304,10
0.518,1e-05,216,188,10,50,0.0001,404,10
0.52,1e-05,265,239,10,50,0.0001,504,10
0.518,1e-05,319,285,10,50,0.0001,604,10
0.518,1e-05,372,332,10,50,0.0001,704,10
0.518,1e-05,419,385,10,50,0.0001,804,10
0.518,1e-05,466,438,10,50,0.0001,904,10
0.518,1e-05,518,486,10,50,0.0001,1004,10
0.516,1e-05,577,527,10,50,0.0001,1104,10
0.516,1e-05,628,576,10,50,0.0001,1204,10
0.516,1e-05,686,618,10,50,0.0001,1304,10
0.516,1e-05,733,671,10,50,0.0001,1404,10
0.518,1e-05,776,728,10,50,0.0001,1504,10
0.526,1e-05,825,779,10,50,0.0001,1604,10
0.53,1e-05,874,830,10,50,0.0001,1704,10
0.53,1e-05,916,888,10,50,0.0001,1804,10
0.532,1e-05,976,928,10,50,0.0001,1904,10
0.532,1e-05,1023,981,10,50,0.0001,2004,10
0.472,1e-05,56,48,10,50,0.0001,104,11
0.474,1e-05,110,94,10,50,0.0001,204,11
0.474,1e-05,157,147,10,50,0.0001,304,11
0.472,1e-05,201,203,10,50,0.0001,404,11
0.474,1e-05,252,252,10,50,0.0001,504,11
0.476,1e-05,300,304,10,50,0.0001,604,11
0.476,1e-05,357,347,10,50,0.0001,704,11
0.48,1e-05,403,401,10,50,0.0001,804,11
0.48,1e-05,457,447,10,50,0.0001,904,11
0.48,1e-05,511,493,10,50,0.0001,1004,11
0.48,1e-05,557,547,10,50,0.0001,1104,11
0.48,1e-05,598,606,10,50,0.0001,1204,11
0.476,1e-05,647,657,10,50,0.0001,1304,11
0.478,1e-05,696,708,10,50,0.0001,1404,11
0.478,1e-05,747,757,10,50,0.0001,1504,11
0.48,1e-05,798,806,10,50,0.0001,1604,11
0.486,1e-05,858,846,10,50,0.0001,1704,11
0.484,1e-05,907,897,10,50,0.0001,1804,11
0.49,1e-05,964,940,10,50,0.0001,1904,11
0.498,1e-05,1010,994,10,50,0.0001,2004,11
0.528,1e-05,48,56,10,50,0.0001,104,12
0.53,1e-05,97,107,10,50,0.0001,204,12
0.532,1e-05,142,162,10,50,0.0001,304,12
0.532,1e-05,196,208,10,50,0.0001,404,12
0.532,1e-05,242,262,10,50,0.0001,504,12
0.532,1e-05,295,309,10,50,0.0001,604,12
0.53,1e-05,350,354,10,50,0.0001,704,12
0.53,1e-05,398,406,10,50,0.0001,804,12
0.538,1e-05,442,462,10,50,0.0001,904,12
0.54,1e-05,494,510,10,50,0.0001,1004,12
0.542,1e-05,552,552,10,50,0.0001,1104,12
0.544,1e-05,600,604,10,50,0.0001,1204,12
0.542,1e-05,653,651,10,50,0.0001,1304,12
0.554,1e-05,698,706,10,50,0.0001,1404,12
0.554,1e-05,745,759,10,50,0.0001,1504,12
0.558,1e-05,804,800,10,50,0.0001,1604,12
0.56,1e-05,861,843,10,50,0.0001,1704,12
0.564,1e-05,912,892,10,50,0.0001,1804,12
0.568,1e-05,959,945,10,50,0.0001,1904,12
0.568,1e-05,1010,994,10,50,0.0001,2004,12
0.498,1e-05,54,50,10,50,0.0001,104,13
0.498,1e-05,100,104,10,50,0.0001,204,13
0.498,1e-05,152,152,10,50,0.0001,304,13
0.498,1e-05,205,199,10,50,0.0001,404,13
0.498,1e-05,251,253,10,50,0.0001,504,13
0.498,1e-05,298,306,10,50,0.0001,604,13
0.498,1e-05,348,356,10,50,0.0001,704,13
0.498,1e-05,392,412,10,50,0.0001,804,13
0.498,1e-05,453,451,10,50,0.0001,904,13
0.498,1e-05,496,508,10,50,0.0001,1004,13
0.498,1e-05,546,558,10,50,0.0001,1104,13
0.498,1e-05,608,596,10,50,0.0001,1204,13
0.498,1e-05,659,645,10,50,0.0001,1304,13
0.498,1e-05,711,693,10,50,0.0001,1404,13
0.498,1e-05,753,751,10,50,0.0001,1504,13
0.498,1e-05,802,802,10,50,0.0001,1604,13
0.498,1e-05,851,853,10,50,0.0001,1704,13
0.498,1e-05,906,898,10,50,0.0001,1804,13
0.498,1e-05,951,953,10,50,0.0001,1904,13
0.498,1e-05,1001,1003,10,50,0.0001,2004,13
0.476,1e-05,56,48,10,50,0.0001,104,14
0.476,1e-05,104,100,10,50,0.0001,204,14
0.476,1e-05,155,149,10,50,0.0001,304,14
0.476,1e-05,204,200,10,50,0.0001,404,14
0.476,1e-05,261,243,10,50,0.0001,504,14
0.478,1e-05,306,298,10,50,0.0001,604,14
0.478,1e-05,353,351,10,50,0.0001,704,14
0.48,1e-05,407,397,10,50,0.0001,804,14
0.48,1e-05,452,452,10,50,0.0001,904,14
0.478,1e-05,509,495,10,50,0.0001,1004,14
0.478,1e-05,556,548,10,50,0.0001,1104,14
0.482,1e-05,604,600,10,50,0.0001,1204,14
0.486,1e-05,658,646,10,50,0.0001,1304,14
0.488,1e-05,713,691,10,50,0.0001,1404,14
0.49,1e-05,767,737,10,50,0.0001,1504,14
0.492,1e-05,815,789,10,50,0.0001,1604,14
0.494,1e-05,872,832,10,50,0.0001,1704,14
0.492,1e-05,920,884,10,50,0.0001,1804,14
0.504,1e-05,967,937,10,50,0.0001,1904,14
0.504,1e-05,1019,985,10,50,0.0001,2004,14
0.508,1e-05,45,59,10,50,0.0001,104,15
0.51,1e-05,98,106,10,50,0.0001,204,15
0.51,1e-05,147,157,10,50,0.0001,304,15
0.51,1e-05,207,197,10,50,0.0001,404,15
0.512,1e-05,264,240,10,50,0.0001,504,15
0.512,1e-05,307,297,10,50,0.0001,604,15
0.51,1e-05,363,341,10,50,0.0001,704,15
0.51,1e-05,410,394,10,50,0.0001,804,15
0.51,1e-05,455,449,10,50,0.0001,904,15
0.512,1e-05,507,497,10,50,0.0001,1004,15
0.516,1e-05,557,547,10,50,0.0001,1104,15
0.516,1e-05,608,596,10,50,0.0001,1204,15
0.522,1e-05,662,642,10,50,0.0001,1304,15
0.522,1e-05,708,696,10,50,0.0001,1404,15
0.526,1e-05,754,750,10,50,0.0001,1504,15
0.524,1e-05,808,796,10,50,0.0001,1604,15
0.526,1e-05,856,848,10,50,0.0001,1704,15
0.528,1e-05,902,902,10,50,0.0001,1804,15
0.532,1e-05,941,963,10,50,0.0001,1904,15
0.546,1e-05,995,1009,10,50,0.0001,2004,15
0.498,1e-05,54,50,10,50,0.0001,104,16
0.498,1e-05,103,101,10,50,0.0001,204,16
0.5,1e-05,159,145,10,50,0.0001,304,16
0.502,1e-05,203,201,10,50,0.0001,404,16
0.502,1e-05,251,253,10,50,0.0001,504,16
0.502,1e-05,299,305,10,50,0.0001,604,16
0.498,1e-05,349,355,10,50,0.0001,704,16
0.498,1e-05,398,406,10,50,0.0001,804,16
0.498,1e-05,448,456,10,50,0.0001,904,16
0.498,1e-05,506,498,10,50,0.0001,1004,16
0.498,1e-05,550,554,10,50,0.0001,1104,16
0.504,1e-05,605,599,10,50,0.0001,1204,16
0.506,1e-05,656,648,10,50,0.0001,1304,16
0.508,1e-05,716,688,10,50,0.0001,1404,16
0.51,1e-05,764,740,10,50,0.0001,1504,16
0.514,1e-05,812,792,10,50,0.0001,1604,16
0.52,1e-05,859,845,10,50,0.0001,1704,16
0.52,1e-05,915,889,10,50,0.0001,1804,16
0.52,1e-05,956,948,10,50,0.0001,1904,16
0.528,1e-05,1003,1001,10,50,0.0001,2004,16
0.482,1e-05,47,57,10,50,0.0001,104,17
0.482,1e-05,101,103,10,50,0.0001,204,17
0.482,1e-05,151,153,10,50,0.0001,304,17
0.482,1e-05,201,203,10,50,0.0001,404,17
0.482,1e-05,244,260,10,50,0.0001,504,17
0.482,1e-05,286,318,10,50,0.0001,604,17
0.482,1e-05,335,369,10,50,0.0001,704,17
0.48,1e-05,392,412,10,50,0.0001,804,17
0.482,1e-05,448,456,10,50,0.0001,904,17
0.484,1e-05,500,504,10,50,0.0001,1004,17
0.492,1e-05,547,557,10,50,0.0001,1104,17
0.492,1e-05,600,604,10,50,0.0001,1204,17
0.494,1e-05,652,652,10,50,0.0001,1304,17
0.5,1e-05,695,709,10,50,0.0001,1404,17
0.496,1e-05,752,752,10,50,0.0001,1504,17
0.498,1e-05,805,799,10,50,0.0001,1604,17
0.498,1e-05,854,850,10,50,0.0001,1704,17
0.5,1e-05,905,899,10,50,0.0001,1804,17
0.506,1e-05,953,951,10,50,0.0001,1904,17
0.51,1e-05,1005,999,10,50,0.0001,2004,17
0.466,1e-05,43,61,10,50,0.0001,104,18
0.466,1e-05,86,118,10,50,0.0001,204,18
0.47,1e-05,140,164,10,50,0.0001,304,18
0.47,1e-05,195,209,10,50,0.0001,404,18
0.47,1e-05,241,263,10,50,0.0001,504,18
0.472,1e-05,290,314,10,50,0.0001,604,18
0.474,1e-05,333,371,10,50,0.0001,704,18
0.474,1e-05,377,427,10,50,0.0001,804,18
0.47,1e-05,425,479,10,50,0.0001,904,18
0.468,1e-05,472,532,10,50,0.0001,1004,18
0.47,1e-05,521,583,10,50,0.0001,1104,18
0.47,1e-05,576,628,10,50,0.0001,1204,18
0.474,1e-05,630,674,10,50,0.0001,1304,18
0.476,1e-05,683,721,10,50,0.0001,1404,18
0.48,1e-05,737,767,10,50,0.0001,1504,18
0.484,1e-05,789,815,10,50,0.0001,1604,18
0.484,1e-05,833,871,10,50,0.0001,1704,18
0.484,1e-05,885,919,10,50,0.0001,1804,18
0.482,1e-05,930,974,10,50,0.0001,1904,18
0.484,1e-05,985,1019,10,50,0.0001,2004,18
0.51,1e-05,39,65,10,50,0.0001,104,19
0.51,1e-05,89,115,10,50,0.0001,204,19
0.51,1e-05,139,165,10,50,0.0001,304,19
0.51,1e-05,190,214,10,50,0.0001,404,19
0.51,1e-05,241,263,10,50,0.0001,504,19
0.51,1e-05,295,309,10,50,0.0001,604,19
0.512,1e-05,333,371,10,50,0.0001,704,19
0.512,1e-05,382,422,10,50,0.0001,804,19
0.512,1e-05,435,469,10,50,0.0001,904,19
0.512,1e-05,483,521,10,50,0.0001,1004,19
0.514,1e-05,544,560,10,50,0.0001,1104,19
0.516,1e-05,595,609,10,50,0.0001,1204,19
0.518,1e-05,650,654,10,50,0.0001,1304,19
0.518,1e-05,708,696,10,50,0.0001,1404,19
0.522,1e-05,762,742,10,50,0.0001,1504,19
0.522,1e-05,816,788,10,50,0.0001,1604,19
0.526,1e-05,869,835,10,50,0.0001,1704,19
0.528,1e-05,915,889,10,50,0.0001,1804,19
0.528,1e-05,967,937,10,50,0.0001,1904,19
0.528,1e-05,1016,988,10,50,0.0001,2004,19
0.558,1e-05,53,51,10,50,0.0001,104,20
0.56,1e-05,108,96,10,50,0.0001,204,20
0.56,1e-05,165,139,10,50,0.0001,304,20
0.56,1e-05,213,191,10,50,0.0001,404,20
0.56,1e-05,261,243,10,50,0.0001,504,20
0.56,1e-05,308,296,10,50,0.0001,604,20
0.562,1e-05,362,342,10,50,0.0001,704,20
0.56,1e-05,413,391,10,50,0.0001,804,20
0.558,1e-05,461,443,10,50,0.0001,904,20
0.558,1e-05,512,492,10,50,0.0001,1004,20
0.558,1e-05,560,544,10,50,0.0001,1104,20
0.56,1e-05,599,605,10,50,0.0001,1204,20
0.562,1e-05,648,656,10,50,0.0001,1304,20
0.564,1e-05,703,701,10,50,0.0001,1404,20
0.566,1e-05,751,753,10,50,0.0001,1504,20
0.566,1e-05,799,805,10,50,0.0001,1604,20
0.572,1e-05,849,855,10,50,0.0001,1704,20
0.574,1e-05,910,894,10,50,0.0001,1804,20
0.578,1e-05,960,944,10,50,0.0001,1904,20
0.578,1e-05,1012,992,10,50,0.0001,2004,20
0.552,1e-05,63,41,10,50,0.001,104,1
0.56,1e-05,112,92,10,50,0.001,204,1
0.56,1e-05,149,155,10,50,0.001,304,1
0.574,1e-05,207,197,10,50,0.001,404,1
0.584,1e-05,253,251,10,50,0.001,504,1
0.59,1e-05,310,294,10,50,0.001,604,1
0.6,1e-05,366,338,10,50,0.001,704,1
0.612,1e-05,402,402,10,50,0.001,804,1
0.628,1e-05,452,452,10,50,0.001,904,1
0.648,1e-05,492,512,10,50,0.001,1004,1
0.658,1e-05,546,558,10,50,0.001,1104,1
0.68,1e-05,596,608,10,50,0.001,1204,1
0.69,1e-05,651,653,10,50,0.001,1304,1
0.702,1e-05,709,695,10,50,0.001,1404,1
0.718,1e-05,756,748,10,50,0.001,1504,1
0.736,1e-05,809,795,10,50,0.001,1604,1
0.756,1e-05,861,843,10,50,0.001,1704,1
0.778,1e-05,911,893,10,50,0.001,1804,1
0.802,1e-05,960,944,10,50,0.001,1904,1
0.826,1e-05,1014,990,10,50,0.001,2004,1
0.564,1e-05,53,51,10,50,0.001,104,2
0.574,1e-05,96,108,10,50,0.001,204,2
0.576,1e-05,153,151,10,50,0.001,304,2
0.59,1e-05,206,198,10,50,0.001,404,2
0.588,1e-05,252,252,10,50,0.001,504,2
0.602,1e-05,301,303,10,50,0.001,604,2
0.606,1e-05,353,351,10,50,0.001,704,2
0.618,1e-05,399,405,10,50,0.001,804,2
0.624,1e-05,440,464,10,50,0.001,904,2
0.628,1e-05,490,514,10,50,0.001,1004,2
0.636,1e-05,542,562,10,50,0.001,1104,2
0.654,1e-05,603,601,10,50,0.001,1204,2
0.658,1e-05,648,656,10,50,0.001,1304,2
0.68,1e-05,702,702,10,50,0.001,1404,2
0.702,1e-05,748,756,10,50,0.001,1504,2
0.73,1e-05,794,810,10,50,0.001,1604,2
0.758,1e-05,853,851,10,50,0.001,1704,2
0.79,1e-05,910,894,10,50,0.001,1804,2
0.814,1e-05,957,947,10,50,0.001,1904,2
0.83,1e-05,1008,996,10,50,0.001,2004,2
0.51,1e-05,65,39,10,50,0.001,104,3
0.518,1e-05,110,94,10,50,0.001,204,3
0.52,1e-05,158,146,10,50,0.001,304,3
0.528,1e-05,216,188,10,50,0.001,404,3
0.53,1e-05,265,239,10,50,0.001,504,3
0.532,1e-05,317,287,10,50,0.001,604,3
0.546,1e-05,369,335,10,50,0.001,704,3
0.544,1e-05,415,389,10,50,0.001,804,3
0.546,1e-05,468,436,10,50,0.001,904,3
0.576,1e-05,522,482,10,50,0.001,1004,3
0.596,1e-05,568,536,10,50,0.001,1104,3
0.61,1e-05,613,591,10,50,0.001,1204,3
0.63,1e-05,663,641,10,50,0.001,1304,3
0.662,1e-05,721,683,10,50,0.001,1404,3
0.694,1e-05,770,734,10,50,0.001,1504,3
0.732,1e-05,814,790,10,50,0.001,1604,3
0.758,1e-05,858,846,10,50,0.001,1704,3
0.78,1e-05,908,896,10,50,0.001,1804,3
0.804,1e-05,953,951,10,50,0.001,1904,3
0.822,1e-05,1005,999,10,50,0.001,2004,3
0.492,1e-05,55,49,10,50,0.001,104,4
0.5,1e-05,109,95,10,50,0.001,204,4
0.504,1e-05,161,143,10,50,0.001,304,4
0.508,1e-05,204,200,10,50,0.001,404,4
0.51,1e-05,255,249,10,50,0.001,504,4
0.532,1e-05,302,302,10,50,0.001,604,4
0.54,1e-05,356,348,10,50,0.001,704,4
0.564,1e-05,404,400,10,50,0.001,804,4
0.578,1e-05,460,444,10,50,0.001,904,4
0.61,1e-05,515,489,10,50,0.001,1004,4
0.628,1e-05,570,534,10,50,0.001,1104,4
0.64,1e-05,622,582,10,50,0.001,1204,4
0.65,1e-05,663,641,10,50,0.001,1304,4
0.682,1e-05,712,692,10,50,0.001,1404,4
0.706,1e-05,762,742,10,50,0.001,1504,4
0.732,1e-05,802,802,10,50,0.001,1604,4
0.752,1e-05,847,857,10,50,0.001,1704,4
0.778,1e-05,886,918,10,50,0.001,1804,4
0.78,1e-05,932,972,10,50,0.001,1904,4
0.802,1e-05,983,1021,10,50,0.001,2004,4
0.528,1e-05,52,52,10,50,0.001,104,5
0.532,1e-05,96,108,10,50,0.001,204,5
0.552,1e-05,138,166,10,50,0.001,304,5
0.55,1e-05,190,214,10,50,0.001,404,5
0.55,1e-05,242,262,10,50,0.001,504,5
0.574,1e-05,285,319,10,50,0.001,604,5
0.584,1e-05,345,359,10,50,0.001,704,5
0.604,1e-05,393,411,10,50,0.001,804,5
0.62,1e-05,441,463,10,50,0.001,904,5
0.64,1e-05,495,509,10,50,0.001,1004,5
0.656,1e-05,541,563,10,50,0.001,1104,5
0.676,1e-05,600,604,10,50,0.001,1204,5
0.692,1e-05,649,655,10,50,0.001,1304,5
0.702,1e-05,710,694,10,50,0.001,1404,5
0.724,1e-05,760,744,10,50,0.001,1504,5
0.746,1e-05,813,791,10,50,0.001,1604,5
0.758,1e-05,859,845,10,50,0.001,1704,5
0.77,1e-05,910,894,10,50,0.001,1804,5
0.774,1e-05,948,956,10,50,0.001,1904,5
0.796,1e-05,999,1005,10,50,0.001,2004,5
0.496,1e-05,61,43,10,50,0.001,104,6
0.502,1e-05,115,89,10,50,0.001,204,6
0.508,1e-05,172,132,10,50,0.001,304,6
0.512,1e-05,220,184,10,50,0.001,404,6
0.526,1e-05,280,224,10,50,0.001,504,6
0.53,1e-05,321,283,10,50,0.001,604,6
0.54,1e-05,366,338,10,50,0.001,704,6
0.534,1e-05,413,391,10,50,0.001,804,6
0.536,1e-05,453,451,10,50,0.001,904,6
0.544,1e-05,506,498,10,50,0.001,1004,6
0.548,1e-05,548,556,10,50,0.001,1104,6
0.558,1e-05,598,606,10,50,0.001,1204,6
0.572,1e-05,648,656,10,50,0.001,1304,6
0.606,1e-05,694,710,10,50,0.001,1404,6
0.626,1e-05,732,772,10,50,0.001,1504,6
0.636,1e-05,778,826,10,50,0.001,1604,6
0.666,1e-05,837,867,10,50,0.001,1704,6
0.692,1e-05,894,910,10,50,0.001,1804,6
0.714,1e-05,949,955,10,50,0.001,1904,6
0.734,1e-05,991,1013,10,50,0.001,2004,6
0.546,1e-05,53,51,10,50,0.001,104,7
0.554,1e-05,101,103,10,50,0.001,204,7
0.566,1e-05,151,153,10,50,0.001,304,7
0.574,1e-05,194,210,10,50,0.001,404,7
0.586,1e-05,241,263,10,50,0.001,504,7
0.602,1e-05,292,312,10,50,0.001,604,7
0.618,1e-05,341,363,10,50,0.001,704,7
0.626,1e-05,390,414,10,50,0.001,804,7
0.636,1e-05,444,460,10,50,0.001,904,7
0.642,1e-05,485,519,10,50,0.001,1004,7
0.65,1e-05,535,569,10,50,0.001,1104,7
0.662,1e-05,583,621,10,50,0.001,1204,7
0.686,1e-05,634,670,10,50,0.001,1304,7
0.702,1e-05,683,721,10,50,0.001,1404,7
0.716,1e-05,735,769,10,50,0.001,1504,7
0.728,1e-05,779,825,10,50,0.001,1604,7
0.74,1e-05,832,872,10,50,0.001,1704,7
0.77,1e-05,886,918,10,50,0.001,1804,7
0.788,1e-05,942,962,10,50,0.001,1904,7
0.804,1e-05,992,1012,10,50,0.001,2004,7
0.456,1e-05,64,40,10,50,0.001,104,8
0.464,1e-05,111,93,10,50,0.001,204,8
0.464,1e-05,156,148,10,50,0.001,304,8
0.476,1e-05,207,197,10,50,0.001,404,8
0.484,1e-05,257,247,10,50,0.001,504,8
0.494,1e-05,308,296,10,50,0.001,604,8
0.506,1e-05,368,336,10,50,0.001,704,8
0.524,1e-05,422,382,10,50,0.001,804,8
0.544,1e-05,470,434,10,50,0.001,904,8
0.566,1e-05,516,488,10,50,0.001,1004,8
0.57,1e-05,561,543,10,50,0.001,1104,8
0.596,1e-05,615,589,10,50,0.001,1204,8
0.612,1e-05,669,635,10,50,0.001,1304,8
0.626,1e-05,718,686,10,50,0.001,1404,8
0.626,1e-05,772,732,10,50,0.001,1504,8
0.646,1e-05,812,792,10,50,0.001,1604,8
0.674,1e-05,858,846,10,50,0.001,1704,8
0.71,1e-05,916,888,10,50,0.001,1804,8
0.738,1e-05,962,942,10,50,0.001,1904,8
0.774,1e-05,1006,998,10,50,0.001,2004,8
0.51,1e-05,57,47,10,50,0.001,104,9
0.512,1e-05,115,89,10,50,0.001,204,9
0.512,1e-05,162,142,10,50,0.001,304,9
0.52,1e-05,206,198,10,50,0.001,404,9
0.518,1e-05,256,248,10,50,0.001,504,9
0.524,1e-05,311,293,10,50,0.001,604,9
0.534,1e-05,369,335,10,50,0.001,704,9
0.538,1e-05,416,388,10,50,0.001,804,9
0.56,1e-05,466,438,10,50,0.001,904,9
0.574,1e-05,520,484,10,50,0.001,1004,9
0.59,1e-05,567,537,10,50,0.001,1104,9
0.6,1e-05,616,588,10,50,0.001,1204,9
0.614,1e-05,675,629,10,50,0.001,1304,9
0.628,1e-05,719,685,10,50,0.001,1404,9
0.652,1e-05,759,745,10,50,0.001,1504,9
0.69,1e-05,807,797,10,50,0.001,1604,9
0.706,1e-05,853,851,10,50,0.001,1704,9
0.73,1e-05,904,900,10,50,0.001,1804,9
0.742,1e-05,961,943,10,50,0.001,1904,9
0.77,1e-05,1006,998,10,50,0.001,2004,9
0.522,1e-05,50,54,10,50,0.001,104,10
0.504,1e-05,93,111,10,50,0.001,204,10
0.49,1e-05,128,176,10,50,0.001,304,10
0.48,1e-05,182,222,10,50,0.001,404,10
0.476,1e-05,234,270,10,50,0.001,504,10
0.504,1e-05,284,320,10,50,0.001,604,10
0.53,1e-05,331,373,10,50,0.001,704,10
0.536,1e-05,381,423,10,50,0.001,804,10
0.556,1e-05,425,479,10,50,0.001,904,10
0.572,1e-05,475,529,10,50,0.001,1004,10
0.592,1e-05,527,577,10,50,0.001,1104,10
0.624,1e-05,582,622,10,50,0.001,1204,10
0.648,1e-05,635,669,10,50,0.001,1304,10
0.662,1e-05,688,716,10,50,0.001,1404,10
0.686,1e-05,743,761,10,50,0.001,1504,10
0.698,1e-05,790,814,10,50,0.001,1604,10
0.722,1e-05,841,863,10,50,0.001,1704,10
0.74,1e-05,888,916,10,50,0.001,1804,10
0.744,1e-05,939,965,10,50,0.001,1904,10
0.764,1e-05,983,1021,10,50,0.001,2004,10
0.482,1e-05,60,44,10,50,0.001,104,11
0.478,1e-05,117,87,10,50,0.001,204,11
0.478,1e-05,168,136,10,50,0.001,304,11
0.49,1e-05,227,177,10,50,0.001,404,11
0.494,1e-05,272,232,10,50,0.001,504,11
0.498,1e-05,316,288,10,50,0.001,604,11
0.502,1e-05,367,337,10,50,0.001,704,11
0.508,1e-05,421,383,10,50,0.001,804,11
0.518,1e-05,471,433,10,50,0.001,904,11
0.522,1e-05,529,475,10,50,0.001,1004,11
0.54,1e-05,572,532,10,50,0.001,1104,11
0.552,1e-05,623,581,10,50,0.001,1204,11
0.568,1e-05,674,630,10,50,0.001,1304,11
0.586,1e-05,719,685,10,50,0.001,1404,11
0.602,1e-05,764,740,10,50,0.001,1504,11
0.636,1e-05,807,797,10,50,0.001,1604,11
0.664,1e-05,861,843,10,50,0.001,1704,11
0.672,1e-05,904,900,10,50,0.001,1804,11
0.696,1e-05,958,946,10,50,0.001,1904,11
0.726,1e-05,1013,991,10,50,0.001,2004,11
0.452,1e-05,53,51,10,50,0.001,104,12
0.464,1e-05,95,109,10,50,0.001,204,12
0.464,1e-05,147,157,10,50,0.001,304,12
0.478,1e-05,199,205,10,50,0.001,404,12
0.496,1e-05,244,260,10,50,0.001,504,12
0.508,1e-05,297,307,10,50,0.001,604,12
0.52,1e-05,350,354,10,50,0.001,704,12
0.554,1e-05,397,407,10,50,0.001,804,12
0.568,1e-05,451,453,10,50,0.001,904,12
0.59,1e-05,501,503,10,50,0.001,1004,12
0.602,1e-05,548,556,10,50,0.001,1104,12
0.626,1e-05,595,609,10,50,0.001,1204,12
0.662,1e-05,640,664,10,50,0.001,1304,12
0.686,1e-05,692,712,10,50,0.001,1404,12
0.712,1e-05,743,761,10,50,0.001,1504,12
0.724,1e-05,797,807,10,50,0.001,1604,12
0.754,1e-05,848,856,10,50,0.001,1704,12
0.79,1e-05,896,908,10,50,0.001,1804,12
0.806,1e-05,949,955,10,50,0.001,1904,12
0.834,1e-05,996,1008,10,50,0.001,2004,12
0.518,1e-05,58,46,10,50,0.001,104,13
0.52,1e-05,107,97,10,50,0.001,204,13
0.536,1e-05,155,149,10,50,0.001,304,13
0.542,1e-05,205,199,10,50,0.001,404,13
0.548,1e-05,256,248,10,50,0.001,504,13
0.56,1e-05,300,304,10,50,0.001,604,13
0.574,1e-05,348,356,10,50,0.001,704,13
0.598,1e-05,391,413,10,50,0.001,804,13
0.612,1e-05,445,459,10,50,0.001,904,13
0.622,1e-05,502,502,10,50,0.001,1004,13
0.632,1e-05,554,550,10,50,0.001,1104,13
0.638,1e-05,601,603,10,50,0.001,1204,13
0.636,1e-05,658,646,10,50,0.001,1304,13
0.65,1e-05,710,694,10,50,0.001,1404,13
0.666,1e-05,755,749,10,50,0.001,1504,13
0.678,1e-05,806,798,10,50,0.001,1604,13
0.688,1e-05,860,844,10,50,0.001,1704,13
0.71,1e-05,910,894,10,50,0.001,1804,13
0.736,1e-05,964,940,10,50,0.001,1904,13
0.762,1e-05,1009,995,10,50,0.001,2004,13
0.55,1e-05,52,52,10,50,0.001,104,14
0.548,1e-05,104,100,10,50,0.001,204,14
0.552,1e-05,159,145,10,50,0.001,304,14
0.556,1e-05,208,196,10,50,0.001,404,14
0.556,1e-05,257,247,10,50,0.001,504,14
0.564,1e-05,308,296,10,50,0.001,604,14
0.58,1e-05,362,342,10,50,0.001,704,14
0.592,1e-05,410,394,10,50,0.001,804,14
0.606,1e-05,462,442,10,50,0.001,904,14
0.61,1e-05,509,495,10,50,0.001,1004,14
0.624,1e-05,562,542,10,50,0.001,1104,14
0.634,1e-05,605,599,10,50,0.001,1204,14
0.648,1e-05,656,648,10,50,0.001,1304,14
0.662,1e-05,708,696,10,50,0.001,1404,14
0.684,1e-05,750,754,10,50,0.001,1504,14
0.698,1e-05,808,796,10,50,0.001,1604,14
0.716,1e-05,865,839,10,50,0.001,1704,14
0.732,1e-05,920,884,10,50,0.001,1804,14
0.752,1e-05,961,943,10,50,0.001,1904,14
0.768,1e-05,1008,996,10,50,0.001,2004,14
0.456,1e-05,51,53,10,50,0.001,104,15
0.462,1e-05,104,100,10,50,0.001,204,15
0.474,1e-05,155,149,10,50,0.001,304,15
0.472,1e-05,206,198,10,50,0.001,404,15
0.474,1e-05,259,245,10,50,0.001,504,15
0.48,1e-05,311,293,10,50,0.001,604,15
0.482,1e-05,355,349,10,50,0.001,704,15
0.498,1e-05,395,409,10,50,0.001,804,15
0.514,1e-05,442,462,10,50,0.001,904,15
0.536,1e-05,486,518,10,50,0.001,1004,15
0.54,1e-05,540,564,10,50,0.001,1104,15
0.564,1e-05,590,614,10,50,0.001,1204,15
0.59,1e-05,645,659,10,50,0.001,1304,15
0.61,1e-05,699,705,10,50,0.001,1404,15
0.626,1e-05,749,755,10,50,0.001,1504,15
0.654,1e-05,794,810,10,50,0.001,1604,15
0.694,1e-05,846,858,10,50,0.001,1704,15
0.708,1e-05,904,900,10,50,0.001,1804,15
0.738,1e-05,945,959,10,50,0.001,1904,15
0.762,1e-05,1001,1003,10,50,0.001,2004,15
0.558,1e-05,54,50,10,50,0.001,104,16
0.556,1e-05,112,92,10,50,0.001,204,16
0.558,1e-05,169,135,10,50,0.001,304,16
0.572,1e-05,220,184,10,50,0.001,404,16
0.57,1e-05,263,241,10,50,0.001,504,16
0.56,1e-05,308,296,10,50,0.001,604,16
0.54,1e-05,362,342,10,50,0.001,704,16
0.542,1e-05,407,397,10,50,0.001,804,16
0.558,1e-05,461,443,10,50,0.001,904,16
0.568,1e-05,518,486,10,50,0.001,1004,16
0.588,1e-05,571,533,10,50,0.001,1104,16
0.626,1e-05,626,578,10,50,0.001,1204,16
0.646,1e-05,670,634,10,50,0.001,1304,16
0.672,1e-05,713,691,10,50,0.001,1404,16
0.688,1e-05,761,743,10,50,0.001,1504,16
0.716,1e-05,811,793,10,50,0.001,1604,16
0.736,1e-05,853,851,10,50,0.001,1704,16
0.772,1e-05,902,902,10,50,0.001,1804,16
0.786,1e-05,960,944,10,50,0.001,1904,16
0.806,1e-05,1011,993,10,50,0.001,2004,16
0.526,1e-05,51,53,10,50,0.001,104,17
0.532,1e-05,95,109,10,50,0.001,204,17
0.534,1e-05,146,158,10,50,0.001,304,17
0.544,1e-05,194,210,10,50,0.001,404,17
0.562,1e-05,240,264,10,50,0.001,504,17
0.578,1e-05,292,312,10,50,0.001,604,17
0.592,1e-05,337,367,10,50,0.001,704,17
0.594,1e-05,390,414,10,50,0.001,804,17
0.606,1e-05,437,467,10,50,0.001,904,17
0.62,1e-05,482,522,10,50,0.001,1004,17
0.636,1e-05,529,575,10,50,0.001,1104,17
0.654,1e-05,572,632,10,50,0.001,1204,17
0.672,1e-05,619,685,10,50,0.001,1304,17
0.688,1e-05,671,733,10,50,0.001,1404,17
0.696,1e-05,714,790,10,50,0.001,1504,17
0.714,1e-05,772,832,10,50,0.001,1604,17
0.726,1e-05,831,873,10,50,0.001,1704,17
0.748,1e-05,883,921,10,50,0.001,1804,17
0.78,1e-05,934,970,10,50,0.001,1904,17
0.814,1e-05,992,1012,10,50,0.001,2004,17
0.526,1e-05,60,44,10,50,0.001,104,18
0.522,1e-05,114,90,10,50,0.001,204,18
0.532,1e-05,162,142,10,50,0.001,304,18
0.536,1e-05,212,192,10,50,0.001,404,18
0.55,1e-05,255,249,10,50,0.001,504,18
0.564,1e-05,302,302,10,50,0.001,604,18
0.56,1e-05,356,348,10,50,0.001,704,18
0.57,1e-05,399,405,10,50,0.001,804,18
0.578,1e-05,453,451,10,50,0.001,904,18
0.604,1e-05,504,500,10,50,0.001,1004,18
0.622,1e-05,556,548,10,50,0.001,1104,18
0.634,1e-05,600,604,10,50,0.001,1204,18
0.652,1e-05,650,654,10,50,0.001,1304,18
0.676,1e-05,707,697,10,50,0.001,1404,18
0.698,1e-05,758,746,10,50,0.001,1504,18
0.714,1e-05,810,794,10,50,0.001,1604,18
0.718,1e-05,865,839,10,50,0.001,1704,18
0.74,1e-05,908,896,10,50,0.001,1804,18
0.764,1e-05,952,952,10,50,0.001,1904,18
0.786,1e-05,1006,998,10,50,0.001,2004,18
0.484,1e-05,55,49,10,50,0.001,104,19
0.484,1e-05,107,97,10,50,0.001,204,19
0.486,1e-05,155,149,10,50,0.001,304,19
0.486,1e-05,203,201,10,50,0.001,404,19
0.49,1e-05,255,249,10,50,0.001,504,19
0.494,1e-05,310,294,10,50,0.001,604,19
0.486,1e-05,364,340,10,50,0.001,704,19
0.486,1e-05,418,386,10,50,0.001,804,19
0.494,1e-05,466,438,10,50,0.001,904,19
0.492,1e-05,514,490,10,50,0.001,1004,19
0.502,1e-05,555,549,10,50,0.001,1104,19
0.524,1e-05,610,594,10,50,0.001,1204,19
0.554,1e-05,655,649,10,50,0.001,1304,19
0.582,1e-05,710,694,10,50,0.001,1404,19
0.614,1e-05,761,743,10,50,0.001,1504,19
0.634,1e-05,812,792,10,50,0.001,1604,19
0.666,1e-05,859,845,10,50,0.001,1704,19
0.69,1e-05,905,899,10,50,0.001,1804,19
0.714,1e-05,951,953,10,50,0.001,1904,19
0.76,1e-05,998,1006,10,50,0.001,2004,19
0.476,1e-05,52,52,10,50,0.001,104,20
0.484,1e-05,98,106,10,50,0.001,204,20
0.49,1e-05,149,155,10,50,0.001,304,20
0.5,1e-05,200,204,10,50,0.001,404,20
0.5,1e-05,256,248,10,50,0.001,504,20
0.502,1e-05,297,307,10,50,0.001,604,20
0.51,1e-05,340,364,10,50,0.001,704,20
0.53,1e-05,400,404,10,50,0.001,804,20
0.528,1e-05,450,454,10,50,0.001,904,20
0.54,1e-05,504,500,10,50,0.001,1004,20
0.564,1e-05,550,554,10,50,0.001,1104,20
0.574,1e-05,596,608,10,50,0.001,1204,20
0.588,1e-05,645,659,10,50,0.001,1304,20
0.606,1e-05,695,709,10,50,0.001,1404,20
0.644,1e-05,745,759,10,50,0.001,1504,20
0.66,1e-05,800,804,10,50,0.001,1604,20
0.696,1e-05,847,857,10,50,0.001,1704,20
0.73,1e-05,903,901,10,50,0.001,1804,20
0.754,1e-05,955,949,10,50,0.001,1904,20
0.796,1e-05,1007,997,10,50,0.001,2004,20
0.534,1e-05,47,57,10,50,0.01,104,1
0.57,1e-05,100,104,10,50,0.01,204,1
0.608,1e-05,153,151,10,50,0.01,304,1
0.646,1e-05,209,195,10,50,0.01,404,1
0.694,1e-05,253,251,10,50,0.01,504,1
0.73,1e-05,301,303,10,50,0.01,604,1
0.768,1e-05,352,352,10,50,0.01,704,1
0.802,1e-05,394,410,10,50,0.01,804,1
0.852,1e-05,447,457,10,50,0.01,904,1
0.906,1e-05,496,508,10,50,0.01,1004,1
0.932,1e-05,542,562,10,50,0.01,1104,1
0.954,1e-05,593,611,10,50,0.01,1204,1
0.958,1e-05,646,658,10,50,0.01,1304,1
0.962,1e-05,694,710,10,50,0.01,1404,1
0.962,1e-05,742,762,10,50,0.01,1504,1
0.97,1e-05,792,812,10,50,0.01,1604,1
0.976,1e-05,851,853,10,50,0.01,1704,1
0.978,1e-05,901,903,10,50,0.01,1804,1
0.978,1e-05,946,958,10,50,0.01,1904,1
0.984,1e-05,992,1012,10,50,0.01,2004,1
0.524,1e-05,46,58,10,50,0.01,104,2
0.568,1e-05,99,105,10,50,0.01,204,2
0.596,1e-05,149,155,10,50,0.01,304,2
0.632,1e-05,201,203,10,50,0.01,404,2
0.68,1e-05,243,261,10,50,0.01,504,2
0.752,1e-05,292,312,10,50,0.01,604,2
0.802,1e-05,342,362,10,50,0.01,704,2
0.836,1e-05,397,407,10,50,0.01,804,2
0.846,1e-05,444,460,10,50,0.01,904,2
0.892,1e-05,491,513,10,50,0.01,1004,2
0.936,1e-05,541,563,10,50,0.01,1104,2
0.946,1e-05,595,609,10,50,0.01,1204,2
0.952,1e-05,648,656,10,50,0.01,1304,2
0.956,1e-05,698,706,10,50,0.01,1404,2
0.958,1e-05,753,751,10,50,0.01,1504,2
0.958,1e-05,810,794,10,50,0.01,1604,2
0.96,1e-05,850,854,10,50,0.01,1704,2
0.964,1e-05,905,899,10,50,0.01,1804,2
0.97,1e-05,961,943,10,50,0.01,1904,2
0.97,1e-05,1008,996,10,50,0.01,2004,2
0.49,1e-05,62,42,10,50,0.01,104,3
0.53,1e-05,107,97,10,50,0.01,204,3
0.554,1e-05,155,149,10,50,0.01,304,3
0.602,1e-05,203,201,10,50,0.01,404,3
0.626,1e-05,253,251,10,50,0.01,504,3
0.644,1e-05,296,308,10,50,0.01,604,3
0.692,1e-05,345,359,10,50,0.01,704,3
0.754,1e-05,396,408,10,50,0.01,804,3
0.816,1e-05,446,458,10,50,0.01,904,3
0.856,1e-05,494,510,10,50,0.01,1004,3
0.892,1e-05,548,556,10,50,0.01,1104,3
0.93,1e-05,605,599,10,50,0.01,1204,3
0.94,1e-05,656,648,10,50,0.01,1304,3
0.946,1e-05,708,696,10,50,0.01,1404,3
0.95,1e-05,759,745,10,50,0.01,1504,3
0.95,1e-05,807,797,10,50,0.01,1604,3
0.962,1e-05,858,846,10,50,0.01,1704,3
0.958,1e-05,903,901,10,50,0.01,1804,3
0.962,1e-05,961,943,10,50,0.01,1904,3
0.966,1e-05,1003,1001,10,50,0.01,2004,3
0.528,1e-05,51,53,10,50,0.01,104,4
0.556,1e-05,97,107,10,50,0.01,204,4
0.556,1e-05,149,155,10,50,0.01,304,4
0.58,1e-05,202,202,10,50,0.01,404,4
0.618,1e-05,261,243,10,50,0.01,504,4
0.664,1e-05,307,297,10,50,0.01,604,4
0.716,1e-05,356,348,10,50,0.01,704,4
0.802,1e-05,400,404,10,50,0.01,804,4
0.838,1e-05,456,448,10,50,0.01,904,4
0.876,1e-05,505,499,10,50,0.01,1004,4
0.9,1e-05,560,544,10,50,0.01,1104,4
0.926,1e-05,611,593,10,50,0.01,1204,4
0.884,1e-05,653,651,10,50,0.01,1304,4
0.954,1e-05,710,694,10,50,0.01,1404,4
0.96,1e-05,759,745,10,50,0.01,1504,4
0.964,1e-05,806,798,10,50,0.01,1604,4
0.966,1e-05,861,843,10,50,0.01,1704,4
0.97,1e-05,916,888,10,50,0.01,1804,4
0.97,1e-05,965,939,10,50,0.01,1904,4
0.978,1e-05,1017,987,10,50,0.01,2004,4
0.504,1e-05,47,57,10,50,0.01,104,5
0.538,1e-05,93,111,10,50,0.01,204,5
0.58,1e-05,148,156,10,50,0.01,304,5
0.606,1e-05,195,209,10,50,0.01,404,5
0.612,1e-05,251,253,10,50,0.01,504,5
0.682,1e-05,301,303,10,50,0.01,604,5
0.734,1e-05,355,349,10,50,0.01,704,5
0.766,1e-05,407,397,10,50,0.01,804,5
0.832,1e-05,458,446,10,50,0.01,904,5
0.9,1e-05,514,490,10,50,0.01,1004,5
0.92,1e-05,564,540,10,50,0.01,1104,5
0.934,1e-05,612,592,10,50,0.01,1204,5
0.948,1e-05,659,645,10,50,0.01,1304,5
0.956,1e-05,705,699,10,50,0.01,1404,5
0.958,1e-05,759,745,10,50,0.01,1504,5
0.956,1e-05,807,797,10,50,0.01,1604,5
0.958,1e-05,857,847,10,50,0.01,1704,5
0.972,1e-05,900,904,10,50,0.01,1804,5
0.976,1e-05,945,959,10,50,0.01,1904,5
0.976,1e-05,997,1007,10,50,0.01,2004,5
0.502,1e-05,50,54,10,50,0.01,104,6
0.542,1e-05,87,117,10,50,0.01,204,6
0.534,1e-05,133,171,10,50,0.01,304,6
0.528,1e-05,181,223,10,50,0.01,404,6
0.542,1e-05,232,272,10,50,0.01,504,6
0.582,1e-05,276,328,10,50,0.01,604,6
0.628,1e-05,327,377,10,50,0.01,704,6
0.744,1e-05,373,431,10,50,0.01,804,6
0.83,1e-05,421,483,10,50,0.01,904,6
0.878,1e-05,468,536,10,50,0.01,1004,6
0.9,1e-05,520,584,10,50,0.01,1104,6
0.92,1e-05,569,635,10,50,0.01,1204,6
0.95,1e-05,632,672,10,50,0.01,1304,6
0.96,1e-05,689,715,10,50,0.01,1404,6
0.966,1e-05,738,766,10,50,0.01,1504,6
0.976,1e-05,783,821,10,50,0.01,1604,6
0.978,1e-05,838,866,10,50,0.01,1704,6
0.986,1e-05,890,914,10,50,0.01,1804,6
0.988,1e-05,938,966,10,50,0.01,1904,6
0.988,1e-05,994,1010,10,50,0.01,2004,6
0.504,1e-05,47,57,10,50,0.01,104,7
0.502,1e-05,91,113,10,50,0.01,204,7
0.558,1e-05,140,164,10,50,0.01,304,7
0.578,1e-05,186,218,10,50,0.01,404,7
0.596,1e-05,232,272,10,50,0.01,504,7
0.678,1e-05,288,316,10,50,0.01,604,7
0.77,1e-05,344,360,10,50,0.01,704,7
0.816,1e-05,399,405,10,50,0.01,804,7
0.838,1e-05,438,466,10,50,0.01,904,7
0.882,1e-05,489,515,10,50,0.01,1004,7
0.894,1e-05,542,562,10,50,0.01,1104,7
0.912,1e-05,591,613,10,50,0.01,1204,7
0.936,1e-05,638,666,10,50,0.01,1304,7
0.942,1e-05,686,718,10,50,0.01,1404,7
0.938,1e-05,743,761,10,50,0.01,1504,7
0.944,1e-05,791,813,10,50,0.01,1604,7
0.946,1e-05,851,853,10,50,0.01,1704,7
0.954,1e-05,907,897,10,50,0.01,1804,7
0.958,1e-05,955,949,10,50,0.01,1904,7
0.964,1e-05,1005,999,10,50,0.01,2004,7
0.5,1e-05,52,52,10,50,0.01,104,8
0.518,1e-05,101,103,10,50,0.01,204,8
0.56,1e-05,154,150,10,50,0.01,304,8
0.608,1e-05,203,201,10,50,0.01,404,8
0.636,1e-05,255,249,10,50,0.01,504,8
0.692,1e-05,309,295,10,50,0.01,604,8
0.74,1e-05,361,343,10,50,0.01,704,8
0.78,1e-05,406,398,10,50,0.01,804,8
0.822,1e-05,456,448,10,50,0.01,904,8
0.884,1e-05,510,494,10,50,0.01,1004,8
0.926,1e-05,570,534,10,50,0.01,1104,8
0.95,1e-05,616,588,10,50,0.01,1204,8
0.948,1e-05,663,641,10,50,0.01,1304,8
0.966,1e-05,710,694,10,50,0.01,1404,8
0.974,1e-05,759,745,10,50,0.01,1504,8
0.972,1e-05,814,790,10,50,0.01,1604,8
0.976,1e-05,875,829,10,50,0.01,1704,8
0.98,1e-05,915,889,10,50,0.01,1804,8
0.982,1e-05,960,944,10,50,0.01,1904,8
0.988,1e-05,1011,993,10,50,0.01,2004,8
0.548,1e-05,53,51,10,50,0.01,104,9
0.55,1e-05,104,100,10,50,0.01,204,9
0.542,1e-05,153,151,10,50,0.01,304,9
0.61,1e-05,209,195,10,50,0.01,404,9
0.692,1e-05,256,248,10,50,0.01,504,9
0.738,1e-05,305,299,10,50,0.01,604,9
0.79,1e-05,359,345,10,50,0.01,704,9
0.834,1e-05,401,403,10,50,0.01,804,9
0.886,1e-05,448,456,10,50,0.01,904,9
0.934,1e-05,498,506,10,50,0.01,1004,9
0.944,1e-05,549,555,10,50,0.01,1104,9
0.954,1e-05,599,605,10,50,0.01,1204,9
0.964,1e-05,652,652,10,50,0.01,1304,9
0.966,1e-05,705,699,10,50,0.01,1404,9
0.97,1e-05,759,745,10,50,0.01,1504,9
0.976,1e-05,810,794,10,50,0.01,1604,9
0.976,1e-05,858,846,10,50,0.01,1704,9
0.978,1e-05,906,898,10,50,0.01,1804,9
0.984,1e-05,957,947,10,50,0.01,1904,9
0.988,1e-05,1014,990,10,50,0.01,2004,9
0.562,1e-05,49,55,10,50,0.01,104,10
0.624,1e-05,96,108,10,50,0.01,204,10
0.636,1e-05,145,159,10,50,0.01,304,10
0.654,1e-05,193,211,10,50,0.01,404,10
0.7,1e-05,233,271,10,50,0.01,504,10
0.768,1e-05,286,318,10,50,0.01,604,10
0.808,1e-05,334,370,10,50,0.01,704,10
0.856,1e-05,382,422,10,50,0.01,804,10
0.866,1e-05,429,475,10,50,0.01,904,10
0.894,1e-05,489,515,10,50,0.01,1004,10
0.928,1e-05,533,571,10,50,0.01,1104,10
0.94,1e-05,582,622,10,50,0.01,1204,10
0.942,1e-05,626,678,10,50,0.01,1304,10
0.948,1e-05,679,725,10,50,0.01,1404,10
0.954,1e-05,733,771,10,50,0.01,1504,10
0.964,1e-05,778,826,10,50,0.01,1604,10
0.97,1e-05,829,875,10,50,0.01,1704,10
0.974,1e-05,884,920,10,50,0.01,1804,10
0.978,1e-05,936,968,10,50,0.01,1904,10
0.978,1e-05,994,1010,10,50,0.01,2004,10
0.576,1e-05,52,52,10,50,0.01,104,11
0.64,1e-05,93,111,10,50,0.01,204,11
0.658,1e-05,143,161,10,50,0.01,304,11
0.678,1e-05,190,214,10,50,0.01,404,11
0.738,1e-05,250,254,10,50,0.01,504,11
0.762,1e-05,295,309,10,50,0.01,604,11
0.758,1e-05,345,359,10,50,0.01,704,11
0.808,1e-05,394,410,10,50,0.01,804,11
0.85,1e-05,437,467,10,50,0.01,904,11
0.908,1e-05,493,511,10,50,0.01,1004,11
0.914,1e-05,542,562,10,50,0.01,1104,11
0.932,1e-05,602,602,10,50,0.01,1204,11
0.942,1e-05,649,655,10,50,0.01,1304,11
0.958,1e-05,704,700,10,50,0.01,1404,11
0.958,1e-05,754,750,10,50,0.01,1504,11
0.96,1e-05,796,808,10,50,0.01,1604,11
0.964,1e-05,846,858,10,50,0.01,1704,11
0.968,1e-05,901,903,10,50,0.01,1804,11
0.968,1e-05,953,951,10,50,0.01,1904,11
0.974,1e-05,1012,992,10,50,0.01,2004,11
0.462,1e-05,52,52,10,50,0.01,104,12
0.492,1e-05,105,99,10,50,0.01,204,12
0.53,1e-05,157,147,10,50,0.01,304,12
0.556,1e-05,201,203,10,50,0.01,404,12
0.628,1e-05,258,246,10,50,0.01,504,12
0.68,1e-05,307,297,10,50,0.01,604,12
0.724,1e-05,354,350,10,50,0.01,704,12
0.78,1e-05,407,397,10,50,0.01,804,12
0.828,1e-05,451,453,10,50,0.01,904,12
0.908,1e-05,501,503,10,50,0.01,1004,12
0.928,1e-05,552,552,10,50,0.01,1104,12
0.944,1e-05,606,598,10,50,0.01,1204,12
0.954,1e-05,653,651,10,50,0.01,1304,12
0.954,1e-05,710,694,10,50,0.01,1404,12
0.954,1e-05,758,746,10,50,0.01,1504,12
0.964,1e-05,803,801,10,50,0.01,1604,12
0.962,1e-05,855,849,10,50,0.01,1704,12
0.966,1e-05,905,899,10,50,0.01,1804,12
0.972,1e-05,948,956,10,50,0.01,1904,12
0.978,1e-05,1000,1004,10,50,0.01,2004,12
0.464,1e-05,60,44,10,50,0.01,104,13
0.504,1e-05,107,97,10,50,0.01,204,13
0.518,1e-05,159,145,10,50,0.01,304,13
0.558,1e-05,203,201,10,50,0.01,404,13
0.6,1e-05,260,244,10,50,0.01,504,13
0.688,1e-05,311,293,10,50,0.01,604,13
0.746,1e-05,348,356,10,50,0.01,704,13
0.8,1e-05,396,408,10,50,0.01,804,13
0.848,1e-05,448,456,10,50,0.01,904,13
0.896,1e-05,491,513,10,50,0.01,1004,13
0.912,1e-05,541,563,10,50,0.01,1104,13
0.94,1e-05,591,613,10,50,0.01,1204,13
0.952,1e-05,644,660,10,50,0.01,1304,13
0.972,1e-05,695,709,10,50,0.01,1404,13
0.978,1e-05,747,757,10,50,0.01,1504,13
0.974,1e-05,802,802,10,50,0.01,1604,13
0.974,1e-05,859,845,10,50,0.01,1704,13
0.98,1e-05,902,902,10,50,0.01,1804,13
0.98,1e-05,947,957,10,50,0.01,1904,13
0.99,1e-05,993,1011,10,50,0.01,2004,13
0.586,1e-05,51,53,10,50,0.01,104,14
0.606,1e-05,100,104,10,50,0.01,204,14
0.636,1e-05,149,155,10,50,0.01,304,14
0.664,1e-05,194,210,10,50,0.01,404,14
0.682,1e-05,250,254,10,50,0.01,504,14
0.742,1e-05,303,301,10,50,0.01,604,14
0.792,1e-05,357,347,10,50,0.01,704,14
0.818,1e-05,409,395,10,50,0.01,804,14
0.826,1e-05,467,437,10,50,0.01,904,14
0.87,1e-05,515,489,10,50,0.01,1004,14
0.908,1e-05,566,538,10,50,0.01,1104,14
0.936,1e-05,607,597,10,50,0.01,1204,14
0.948,1e-05,656,648,10,50,0.01,1304,14
0.956,1e-05,712,692,10,50,0.01,1404,14
0.96,1e-05,774,730,10,50,0.01,1504,14
0.962,1e-05,816,788,10,50,0.01,1604,14
0.968,1e-05,865,839,10,50,0.01,1704,14
0.964,1e-05,914,890,10,50,0.01,1804,14
0.968,1e-05,966,938,10,50,0.01,1904,14
0.976,1e-05,1016,988,10,50,0.01,2004,14
0.512,1e-05,55,49,10,50,0.01,104,15
0.534,1e-05,105,99,10,50,0.01,204,15
0.556,1e-05,149,155,10,50,0.01,304,15
0.616,1e-05,204,200,10,50,0.01,404,15
0.654,1e-05,255,249,10,50,0.01,504,15
0.692,1e-05,303,301,10,50,0.01,604,15
0.746,1e-05,356,348,10,50,0.01,704,15
0.826,1e-05,398,406,10,50,0.01,804,15
0.88,1e-05,446,458,10,50,0.01,904,15
0.914,1e-05,510,494,10,50,0.01,1004,15
0.926,1e-05,556,548,10,50,0.01,1104,15
0.938,1e-05,595,609,10,50,0.01,1204,15
0.936,1e-05,649,655,10,50,0.01,1304,15
0.956,1e-05,699,705,10,50,0.01,1404,15
0.962,1e-05,757,747,10,50,0.01,1504,15
0.958,1e-05,807,797,10,50,0.01,1604,15
0.962,1e-05,858,846,10,50,0.01,1704,15
0.97,1e-05,915,889,10,50,0.01,1804,15
0.972,1e-05,962,942,10,50,0.01,1904,15
0.972,1e-05,1007,997,10,50,0.01,2004,15
0.53,1e-05,44,60,10,50,0.01,104,16
0.55,1e-05,95,109,10,50,0.01,204,16
0.572,1e-05,149,155,10,50,0.01,304,16
0.602,1e-05,203,201,10,50,0.01,404,16
0.606,1e-05,247,257,10,50,0.01,504,16
0.644,1e-05,296,308,10,50,0.01,604,16
0.686,1e-05,354,350,10,50,0.01,704,16
0.754,1e-05,394,410,10,50,0.01,804,16
0.806,1e-05,449,455,10,50,0.01,904,16
0.892,1e-05,496,508,10,50,0.01,1004,16
0.904,1e-05,546,558,10,50,0.01,1104,16
0.928,1e-05,587,617,10,50,0.01,1204,16
0.94,1e-05,637,667,10,50,0.01,1304,16
0.954,1e-05,679,725,10,50,0.01,1404,16
0.958,1e-05,730,774,10,50,0.01,1504,16
0.962,1e-05,791,813,10,50,0.01,1604,16
0.966,1e-05,850,854,10,50,0.01,1704,16
0.966,1e-05,907,897,10,50,0.01,1804,16
0.968,1e-05,963,941,10,50,0.01,1904,16
0.968,1e-05,1013,991,10,50,0.01,2004,16
0.562,1e-05,51,53,10,50,0.01,104,17
0.578,1e-05,104,100,10,50,0.01,204,17
0.582,1e-05,150,154,10,50,0.01,304,17
0.586,1e-05,201,203,10,50,0.01,404,17
0.612,1e-05,259,245,10,50,0.01,504,17
0.692,1e-05,311,293,10,50,0.01,604,17
0.712,1e-05,357,347,10,50,0.01,704,17
0.774,1e-05,398,406,10,50,0.01,804,17
0.842,1e-05,446,458,10,50,0.01,904,17
0.884,1e-05,487,517,10,50,0.01,1004,17
0.912,1e-05,534,570,10,50,0.01,1104,17
0.94,1e-05,585,619,10,50,0.01,1204,17
0.964,1e-05,633,671,10,50,0.01,1304,17
0.966,1e-05,682,722,10,50,0.01,1404,17
0.972,1e-05,741,763,10,50,0.01,1504,17
0.974,1e-05,795,809,10,50,0.01,1604,17
0.974,1e-05,844,860,10,50,0.01,1704,17
0.974,1e-05,895,909,10,50,0.01,1804,17
0.976,1e-05,950,954,10,50,0.01,1904,17
0.976,1e-05,995,1009,10,50,0.01,2004,17
0.534,1e-05,54,50,10,50,0.01,104,18
0.56,1e-05,108,96,10,50,0.01,204,18
0.566,1e-05,158,146,10,50,0.01,304,18
0.612,1e-05,211,193,10,50,0.01,404,18
0.65,1e-05,266,238,10,50,0.01,504,18
0.74,1e-05,315,289,10,50,0.01,604,18
0.814,1e-05,363,341,10,50,0.01,704,18
0.86,1e-05,421,383,10,50,0.01,804,18
0.89,1e-05,466,438,10,50,0.01,904,18
0.902,1e-05,515,489,10,50,0.01,1004,18
0.912,1e-05,564,540,10,50,0.01,1104,18
0.934,1e-05,608,596,10,50,0.01,1204,18
0.936,1e-05,658,646,10,50,0.01,1304,18
0.946,1e-05,711,693,10,50,0.01,1404,18
0.956,1e-05,767,737,10,50,0.01,1504,18
0.956,1e-05,813,791,10,50,0.01,1604,18
0.954,1e-05,863,841,10,50,0.01,1704,18
0.966,1e-05,911,893,10,50,0.01,1804,18
0.974,1e-05,955,949,10,50,0.01,1904,18
0.978,1e-05,1006,998,10,50,0.01,2004,18
0.492,1e-05,55,49,10,50,0.01,104,19
0.558,1e-05,110,94,10,50,0.01,204,19
0.6,1e-05,159,145,10,50,0.01,304,19
0.68,1e-05,218,186,10,50,0.01,404,19
0.7,1e-05,270,234,10,50,0.01,504,19
0.738,1e-05,320,284,10,50,0.01,604,19
0.756,1e-05,373,331,10,50,0.01,704,19
0.808,1e-05,424,380,10,50,0.01,804,19
0.852,1e-05,470,434,10,50,0.01,904,19
0.93,1e-05,521,483,10,50,0.01,1004,19
0.952,1e-05,577,527,10,50,0.01,1104,19
0.952,1e-05,621,583,10,50,0.01,1204,19
0.952,1e-05,669,635,10,50,0.01,1304,19
0.962,1e-05,720,684,10,50,0.01,1404,19
0.964,1e-05,775,729,10,50,0.01,1504,19
0.976,1e-05,827,777,10,50,0.01,1604,19
0.978,1e-05,870,834,10,50,0.01,1704,19
0.98,1e-05,916,888,10,50,0.01,1804,19
0.982,1e-05,969,935,10,50,0.01,1904,19
0.984,1e-05,1016,988,10,50,0.01,2004,19
0.58,1e-05,52,52,10,50,0.01,104,20
0.646,1e-05,98,106,10,50,0.01,204,20
0.66,1e-05,150,154,10,50,0.01,304,20
0.656,1e-05,204,200,10,50,0.01,404,20
0.662,1e-05,258,246,10,50,0.01,504,20
0.72,1e-05,305,299,10,50,0.01,604,20
0.764,1e-05,356,348,10,50,0.01,704,20
0.798,1e-05,415,389,10,50,0.01,804,20
0.84,1e-05,467,437,10,50,0.01,904,20
0.9,1e-05,507,497,10,50,0.01,1004,20
0.928,1e-05,560,544,10,50,0.01,1104,20
0.95,1e-05,615,589,10,50,0.01,1204,20
0.964,1e-05,666,638,10,50,0.01,1304,20
0.962,1e-05,724,680,10,50,0.01,1404,20
0.972,1e-05,768,736,10,50,0.01,1504,20
0.974,1e-05,818,786,10,50,0.01,1604,20
0.978,1e-05,872,832,10,50,0.01,1704,20
0.98,1e-05,923,881,10,50,0.01,1804,20
0.98,1e-05,970,934,10,50,0.01,1904,20
0.98,1e-05,1016,988,10,50,0.01,2004,20
0.534,0.0001,48,56,10,50,0.0001,104,1
0.534,0.0001,98,106,10,50,0.0001,204,1
0.536,0.0001,146,158,10,50,0.0001,304,1
0.536,0.0001,199,205,10,50,0.0001,404,1
0.536,0.0001,247,257,10,50,0.0001,504,1
0.54,0.0001,288,316,10,50,0.0001,604,1
0.54,0.0001,335,369,10,50,0.0001,704,1
0.54,0.0001,385,419,10,50,0.0001,804,1
0.54,0.0001,434,470,10,50,0.0001,904,1
0.542,0.0001,481,523,10,50,0.0001,1004,1
0.542,0.0001,538,566,10,50,0.0001,1104,1
0.542,0.0001,584,620,10,50,0.0001,1204,1
0.542,0.0001,632,672,10,50,0.0001,1304,1
0.54,0.0001,677,727,10,50,0.0001,1404,1
0.54,0.0001,731,773,10,50,0.0001,1504,1
0.54,0.0001,790,814,10,50,0.0001,1604,1
0.54,0.0001,840,864,10,50,0.0001,1704,1
0.538,0.0001,886,918,10,50,0.0001,1804,1
0.54,0.0001,933,971,10,50,0.0001,1904,1
0.54,0.0001,985,1019,10,50,0.0001,2004,1
0.532,0.0001,47,57,10,50,0.0001,104,2
0.532,0.0001,102,102,10,50,0.0001,204,2
0.532,0.0001,156,148,10,50,0.0001,304,2
0.53,0.0001,204,200,10,50,0.0001,404,2
0.53,0.0001,254,250,10,50,0.0001,504,2
0.53,0.0001,307,297,10,50,0.0001,604,2
0.526,0.0001,357,347,10,50,0.0001,704,2
0.526,0.0001,405,399,10,50,0.0001,804,2
0.524,0.0001,454,450,10,50,0.0001,904,2
0.524,0.0001,503,501,10,50,0.0001,1004,2
0.522,0.0001,548,556,10,50,0.0001,1104,2
0.528,0.0001,594,610,10,50,0.0001,1204,2
0.528,0.0001,644,660,10,50,0.0001,1304,2
0.53,0.0001,695,709,10,50,0.0001,1404,2
0.53,0.0001,746,758,10,50,0.0001,1504,2
0.532,0.0001,797,807,10,50,0.0001,1604,2
0.532,0.0001,841,863,10,50,0.0001,1704,2
0.53,0.0001,886,918,10,50,0.0001,1804,2
0.534,0.0001,941,963,10,50,0.0001,1904,2
0.532,0.0001,996,1008,10,50,0.0001,2004,2
0.54,0.0001,46,58,10,50,0.0001,104,3
0.542,0.0001,93,111,10,50,0.0001,204,3
0.548,0.0001,144,160,10,50,0.0001,304,3
0.55,0.0001,194,210,10,50,0.0001,404,3
0.55,0.0001,248,256,10,50,0.0001,504,3
0.554,0.0001,304,300,10,50,0.0001,604,3
0.554,0.0001,352,352,10,50,0.0001,704,3
0.554,0.0001,402,402,10,50,0.0001,804,3
0.554,0.0001,445,459,10,50,0.0001,904,3
0.56,0.0001,496,508,10,50,0.0001,1004,3
0.558,0.0001,551,553,10,50,0.0001,1104,3
0.56,0.0001,604,600,10,50,0.0001,1204,3
0.558,0.0001,658,646,10,50,0.0001,1304,3
0.556,0.0001,701,703,10,50,0.0001,1404,3
0.556,0.0001,746,758,10,50,0.0001,1504,3
0.56,0.0001,806,798,10,50,0.0001,1604,3
0.56,0.0001,853,851,10,50,0.0001,1704,3
0.562,0.0001,901,903,10,50,0.0001,1804,3
0.564,0.0001,959,945,10,50,0.0001,1904,3
0.564,0.0001,1011,993,10,50,0.0001,2004,3
0.49,0.0001,52,52,10,50,0.0001,104,4
0.49,0.0001,109,95,10,50,0.0001,204,4
0.492,0.0001,161,143,10,50,0.0001,304,4
0.492,0.0001,201,203,10,50,0.0001,404,4
0.492,0.0001,254,250,10,50,0.0001,504,4
0.49,0.0001,303,301,10,50,0.0001,604,4
0.486,0.0001,357,347,10,50,0.0001,704,4
0.486,0.0001,416,388,10,50,0.0001,804,4
0.486,0.0001,470,434,10,50,0.0001,904,4
0.486,0.0001,527,477,10,50,0.0001,1004,4
0.486,0.0001,586,518,10,50,0.0001,1104,4
0.49,0.0001,635,569,10,50,0.0001,1204,4
0.488,0.0001,679,625,10,50,0.0001,1304,4
0.494,0.0001,732,672,10,50,0.0001,1404,4
0.498,0.0001,775,729,10,50,0.0001,1504,4
0.504,0.0001,832,772,10,50,0.0001,1604,4
0.502,0.0001,874,830,10,50,0.0001,1704,4
0.508,0.0001,914,890,10,50,0.0001,1804,4
0.512,0.0001,966,938,10,50,0.0001,1904,4
0.522,0.0001,1012,992,10,50,0.0001,2004,4
0.496,0.0001,55,49,10,50,0.0001,104,5
0.496,0.0001,110,94,10,50,0.0001,204,5
0.496,0.0001,160,144,10,50,0.0001,304,5
0.496,0.0001,209,195,10,50,0.0001,404,5
0.498,0.0001,259,245,10,50,0.0001,504,5
0.496,0.0001,302,302,10,50,0.0001,604,5
0.496,0.0001,353,351,10,50,0.0001,704,5
0.496,0.0001,408,396,10,50,0.0001,804,5
0.498,0.0001,468,436,10,50,0.0001,904,5
0.5,0.0001,522,482,10,50,0.0001,1004,5
0.5,0.0001,566,538,10,50,0.0001,1104,5
0.502,0.0001,615,589,10,50,0.0001,1204,5
0.502,0.0001,665,639,10,50,0.0001,1304,5
0.504,0.0001,708,696,10,50,0.0001,1404,5
0.504,0.0001,756,748,10,50,0.0001,1504,5
0.508,0.0001,806,798,10,50,0.0001,1604,5
0.508,0.0001,861,843,10,50,0.0001,1704,5
0.514,0.0001,905,899,10,50,0.0001,1804,5
0.516,0.0001,960,944,10,50,0.0001,1904,5
0.514,0.0001,1008,996,10,50,0.0001,2004,5
0.562,0.0001,56,48,10,50,0.0001,104,6
0.564,0.0001,113,91,10,50,0.0001,204,6
0.566,0.0001,166,138,10,50,0.0001,304,6
0.566,0.0001,208,196,10,50,0.0001,404,6
0.568,0.0001,263,241,10,50,0.0001,504,6
0.57,0.0001,316,288,10,50,0.0001,604,6
0.57,0.0001,364,340,10,50,0.0001,704,6
0.57,0.0001,401,403,10,50,0.0001,804,6
0.57,0.0001,450,454,10,50,0.0001,904,6
0.574,0.0001,506,498,10,50,0.0001,1004,6
0.574,0.0001,550,554,10,50,0.0001,1104,6
0.576,0.0001,604,600,10,50,0.0001,1204,6
0.574,0.0001,663,641,10,50,0.0001,1304,6
0.574,0.0001,719,685,10,50,0.0001,1404,6
0.576,0.0001,760,744,10,50,0.0001,1504,6
0.576,0.0001,810,794,10,50,0.0001,1604,6
0.58,0.0001,861,843,10,50,0.0001,1704,6
0.588,0.0001,914,890,10,50,0.0001,1804,6
0.586,0.0001,961,943,10,50,0.0001,1904,6
0.59,0.0001,1012,992,10,50,0.0001,2004,6
0.488,0.0001,44,60,10,50,0.0001,104,7
0.488,0.0001,97,107,10,50,0.0001,204,7
0.488,0.0001,146,158,10,50,0.0001,304,7
0.486,0.0001,198,206,10,50,0.0001,404,7
0.488,0.0001,251,253,10,50,0.0001,504,7
0.488,0.0001,304,300,10,50,0.0001,604,7
0.486,0.0001,353,351,10,50,0.0001,704,7
0.488,0.0001,408,396,10,50,0.0001,804,7
0.488,0.0001,465,439,10,50,0.0001,904,7
0.488,0.0001,519,485,10,50,0.0001,1004,7
0.488,0.0001,566,538,10,50,0.0001,1104,7
0.488,0.0001,618,586,10,50,0.0001,1204,7
0.488,0.0001,673,631,10,50,0.0001,1304,7
0.484,0.0001,716,688,10,50,0.0001,1404,7
0.488,0.0001,764,740,10,50,0.0001,1504,7
0.486,0.0001,811,793,10,50,0.0001,1604,7
0.49,0.0001,855,849,10,50,0.0001,1704,7
0.494,0.0001,897,907,10,50,0.0001,1804,7
0.492,0.0001,955,949,10,50,0.0001,1904,7
0.494,0.0001,1014,990,10,50,0.0001,2004,7
0.51,0.0001,56,48,10,50,0.0001,104,8
0.51,0.0001,93,111,10,50,0.0001,204,8
0.512,0.0001,143,161,10,50,0.0001,304,8
0.518,0.0001,191,213,10,50,0.0001,404,8
0.522,0.0001,236,268,10,50,0.0001,504,8
0.526,0.0001,283,321,10,50,0.0001,604,8
0.524,0.0001,330,374,10,50,0.0001,704,8
0.524,0.0001,389,415,10,50,0.0001,804,8
0.526,0.0001,432,472,10,50,0.0001,904,8
0.522,0.0001,475,529,10,50,0.0001,1004,8
0.522,0.0001,530,574,10,50,0.0001,1104,8
0.522,0.0001,580,624,10,50,0.0001,1204,8
0.524,0.0001,629,675,10,50,0.0001,1304,8
0.526,0.0001,681,723,10,50,0.0001,1404,8
0.526,0.0001,725,779,10,50,0.0001,1504,8
0.53,0.0001,782,822,10,50,0.0001,1604,8
0.53,0.0001,833,871,10,50,0.0001,1704,8
0.53,0.0001,885,919,10,50,0.0001,1804,8
0.532,0.0001,942,962,10,50,0.0001,1904,8
0.534,0.0001,990,1014,10,50,0.0001,2004,8
0.47,0.0001,44,60,10,50,0.0001,104,9
0.468,0.0001,93,111,10,50,0.0001,204,9
0.466,0.0001,151,153,10,50,0.0001,304,9
0.466,0.0001,200,204,10,50,0.0001,404,9
0.468,0.0001,250,254,10,50,0.0001,504,9
0.466,0.0001,298,306,10,50,0.0001,604,9
0.47,0.0001,344,360,10,50,0.0001,704,9
0.468,0.0001,390,414,10,50,0.0001,804,9
0.47,0.0001,446,458,10,50,0.0001,904,9
0.478,0.0001,496,508,10,50,0.0001,1004,9
0.482,0.0001,546,558,10,50,0.0001,1104,9
0.484,0.0001,597,607,10,50,0.0001,1204,9
0.484,0.0001,642,662,10,50,0.0001,1304,9
0.482,0.0001,692,712,10,50,0.0001,1404,9
0.484,0.0001,745,759,10,50,0.0001,1504,9
0.492,0.0001,795,809,10,50,0.0001,1604,9
0.49,0.0001,846,858,10,50,0.0001,1704,9
0.498,0.0001,889,915,10,50,0.0001,1804,9
0.502,0.0001,939,965,10,50,0.0001,1904,9
0.504,0.0001,1001,1003,10,50,0.0001,2004,9
0.532,0.0001,51,53,10,50,0.0001,104,10
0.532,0.0001,107,97,10,50,0.0001,204,10
0.532,0.0001,153,151,10,50,0.0001,304,10
0.534,0.0001,202,202,10,50,0.0001,404,10
0.534,0.0001,255,249,10,50,0.0001,504,10
0.534,0.0001,304,300,10,50,0.0001,604,10
0.534,0.0001,347,357,10,50,0.0001,704,10
0.532,0.0001,392,412,10,50,0.0001,804,10
0.532,0.0001,446,458,10,50,0.0001,904,10
0.532,0.0001,503,501,10,50,0.0001,1004,10
0.532,0.0001,560,544,10,50,0.0001,1104,10
0.534,0.0001,613,591,10,50,0.0001,1204,10
0.534,0.0001,659,645,10,50,0.0001,1304,10
0.538,0.0001,712,692,10,50,0.0001,1404,10
0.54,0.0001,771,733,10,50,0.0001,1504,10
0.542,0.0001,814,790,10,50,0.0001,1604,10
0.54,0.0001,861,843,10,50,0.0001,1704,10
0.54,0.0001,907,897,10,50,0.0001,1804,10
0.548,0.0001,956,948,10,50,0.0001,1904,10
0.55,0.0001,1007,997,10,50,0.0001,2004,10
0.546,0.0001,55,49,10,50,0.0001,104,11
0.548,0.0001,103,101,10,50,0.0001,204,11
0.548,0.0001,153,151,10,50,0.0001,304,11
0.548,0.0001,202,202,10,50,0.0001,404,11
0.548,0.0001,252,252,10,50,0.0001,504,11
0.548,0.0001,292,312,10,50,0.0001,604,11
0.55,0.0001,348,356,10,50,0.0001,704,11
0.548,0.0001,400,404,10,50,0.0001,804,11
0.55,0.0001,450,454,10,50,0.0001,904,11
0.552,0.0001,507,497,10,50,0.0001,1004,11
0.552,0.0001,555,549,10,50,0.0001,1104,11
0.556,0.0001,605,599,10,50,0.0001,1204,11
0.558,0.0001,654,650,10,50,0.0001,1304,11
0.558,0.0001,702,702,10,50,0.0001,1404,11
0.56,0.0001,753,751,10,50,0.0001,1504,11
0.562,0.0001,802,802,10,50,0.0001,1604,11
0.564,0.0001,848,856,10,50,0.0001,1704,11
0.562,0.0001,892,912,10,50,0.0001,1804,11
0.568,0.0001,940,964,10,50,0.0001,1904,11
0.57,0.0001,1001,1003,10,50,0.0001,2004,11
0.476,0.0001,48,56,10,50,0.0001,104,12
0.476,0.0001,100,104,10,50,0.0001,204,12
0.478,0.0001,152,152,10,50,0.0001,304,12
0.478,0.0001,202,202,10,50,0.0001,404,12
0.48,0.0001,251,253,10,50,0.0001,504,12
0.478,0.0001,300,304,10,50,0.0001,604,12
0.48,0.0001,352,352,10,50,0.0001,704,12
0.478,0.0001,412,392,10,50,0.0001,804,12
0.478,0.0001,459,445,10,50,0.0001,904,12
0.478,0.0001,510,494,10,50,0.0001,1004,12
0.486,0.0001,566,538,10,50,0.0001,1104,12
0.49,0.0001,618,586,10,50,0.0001,1204,12
0.492,0.0001,657,647,10,50,0.0001,1304,12
0.494,0.0001,704,700,10,50,0.0001,1404,12
0.496,0.0001,749,755,10,50,0.0001,1504,12
0.498,0.0001,794,810,10,50,0.0001,1604,12
0.5,0.0001,844,860,10,50,0.0001,1704,12
0.496,0.0001,884,920,10,50,0.0001,1804,12
0.498,0.0001,940,964,10,50,0.0001,1904,12
0.498,0.0001,994,1010,10,50,0.0001,2004,12
0.536,0.0001,51,53,10,50,0.0001,104,13
0.536,0.0001,101,103,10,50,0.0001,204,13
0.536,0.0001,152,152,10,50,0.0001,304,13
0.536,0.0001,206,198,10,50,0.0001,404,13
0.536,0.0001,252,252,10,50,0.0001,504,13
0.54,0.0001,303,301,10,50,0.0001,604,13
0.54,0.0001,355,349,10,50,0.0001,704,13
0.544,0.0001,404,400,10,50,0.0001,804,13
0.542,0.0001,454,450,10,50,0.0001,904,13
0.542,0.0001,506,498,10,50,0.0001,1004,13
0.544,0.0001,562,542,10,50,0.0001,1104,13
0.544,0.0001,613,591,10,50,0.0001,1204,13
0.544,0.0001,662,642,10,50,0.0001,1304,13
0.548,0.0001,708,696,10,50,0.0001,1404,13
0.544,0.0001,758,746,10,50,0.0001,1504,13
0.548,0.0001,801,803,10,50,0.0001,1604,13
0.552,0.0001,849,855,10,50,0.0001,1704,13
0.554,0.0001,897,907,10,50,0.0001,1804,13
0.554,0.0001,942,962,10,50,0.0001,1904,13
0.558,0.0001,983,1021,10,50,0.0001,2004,13
0.498,0.0001,57,47,10,50,0.0001,104,14
0.496,0.0001,108,96,10,50,0.0001,204,14
0.498,0.0001,153,151,10,50,0.0001,304,14
0.5,0.0001,203,201,10,50,0.0001,404,14
0.502,0.0001,256,248,10,50,0.0001,504,14
0.502,0.0001,305,299,10,50,0.0001,604,14
0.5,0.0001,352,352,10,50,0.0001,704,14
0.5,0.0001,410,394,10,50,0.0001,804,14
0.496,0.0001,457,447,10,50,0.0001,904,14
0.494,0.0001,509,495,10,50,0.0001,1004,14
0.494,0.0001,560,544,10,50,0.0001,1104,14
0.494,0.0001,615,589,10,50,0.0001,1204,14
0.494,0.0001,661,643,10,50,0.0001,1304,14
0.498,0.0001,703,701,10,50,0.0001,1404,14
0.498,0.0001,757,747,10,50,0.0001,1504,14
0.502,0.0001,800,804,10,50,0.0001,1604,14
0.504,0.0001,861,843,10,50,0.0001,1704,14
0.508,0.0001,911,893,10,50,0.0001,1804,14
0.508,0.0001,956,948,10,50,0.0001,1904,14
0.506,0.0001,1006,998,10,50,0.0001,2004,14
0.452,0.0001,51,53,10,50,0.0001,104,15
0.452,0.0001,99,105,10,50,0.0001,204,15
0.452,0.0001,153,151,10,50,0.0001,304,15
0.45,0.0001,198,206,10,50,0.0001,404,15
0.452,0.0001,243,261,10,50,0.0001,504,15
0.452,0.0001,294,310,10,50,0.0001,604,15
0.452,0.0001,340,364,10,50,0.0001,704,15
0.452,0.0001,392,412,10,50,0.0001,804,15
0.45,0.0001,442,462,10,50,0.0001,904,15
0.45,0.0001,494,510,10,50,0.0001,1004,15
0.45,0.0001,547,557,10,50,0.0001,1104,15
0.452,0.0001,606,598,10,50,0.0001,1204,15
0.456,0.0001,646,658,10,50,0.0001,1304,15
0.458,0.0001,700,704,10,50,0.0001,1404,15
0.46,0.0001,762,742,10,50,0.0001,1504,15
0.462,0.0001,810,794,10,50,0.0001,1604,15
0.468,0.0001,864,840,10,50,0.0001,1704,15
0.478,0.0001,908,896,10,50,0.0001,1804,15
0.484,0.0001,963,941,10,50,0.0001,1904,15
0.492,0.0001,1006,998,10,50,0.0001,2004,15
0.516,0.0001,56,48,10,50,0.0001,104,16
0.518,0.0001,111,93,10,50,0.0001,204,16
0.518,0.0001,155,149,10,50,0.0001,304,16
0.518,0.0001,208,196,10,50,0.0001,404,16
0.518,0.0001,255,249,10,50,0.0001,504,16
0.518,0.0001,303,301,10,50,0.0001,604,16
0.52,0.0001,350,354,10,50,0.0001,704,16
0.52,0.0001,399,405,10,50,0.0001,804,16
0.52,0.0001,450,454,10,50,0.0001,904,16
0.52,0.0001,503,501,10,50,0.0001,1004,16
0.52,0.0001,561,543,10,50,0.0001,1104,16
0.52,0.0001,613,591,10,50,0.0001,1204,16
0.518,0.0001,660,644,10,50,0.0001,1304,16
0.52,0.0001,704,700,10,50,0.0001,1404,16
0.518,0.0001,747,757,10,50,0.0001,1504,16
0.518,0.0001,800,804,10,50,0.0001,1604,16
0.518,0.0001,851,853,10,50,0.0001,1704,16
0.518,0.0001,893,911,10,50,0.0001,1804,16
0.52,0.0001,942,962,10,50,0.0001,1904,16
0.522,0.0001,991,1013,10,50,0.0001,2004,16
0.494,0.0001,57,47,10,50,0.0001,104,17
0.496,0.0001,106,98,10,50,0.0001,204,17
0.496,0.0001,158,146,10,50,0.0001,304,17
0.5,0.0001,214,190,10,50,0.0001,404,17
0.502,0.0001,261,243,10,50,0.0001,504,17
0.502,0.0001,305,299,10,50,0.0001,604,17
0.5,0.0001,342,362,10,50,0.0001,704,17
0.5,0.0001,386,418,10,50,0.0001,804,17
0.5,0.0001,429,475,10,50,0.0001,904,17
0.504,0.0001,491,513,10,50,0.0001,1004,17
0.504,0.0001,549,555,10,50,0.0001,1104,17
0.504,0.0001,595,609,10,50,0.0001,1204,17
0.508,0.0001,647,657,10,50,0.0001,1304,17
0.508,0.0001,699,705,10,50,0.0001,1404,17
0.506,0.0001,749,755,10,50,0.0001,1504,17
0.51,0.0001,795,809,10,50,0.0001,1604,17
0.51,0.0001,850,854,10,50,0.0001,1704,17
0.512,0.0001,900,904,10,50,0.0001,1804,17
0.514,0.0001,954,950,10,50,0.0001,1904,17
0.52,0.0001,1001,1003,10,50,0.0001,2004,17
0.5,0.0001,52,52,10,50,0.0001,104,18
0.5,0.0001,101,103,10,50,0.0001,204,18
0.498,0.0001,159,145,10,50,0.0001,304,18
0.498,0.0001,209,195,10,50,0.0001,404,18
0.5,0.0001,266,238,10,50,0.0001,504,18
0.502,0.0001,309,295,10,50,0.0001,604,18
0.504,0.0001,357,347,10,50,0.0001,704,18
0.504,0.0001,399,405,10,50,0.0001,804,18
0.508,0.0001,444,460,10,50,0.0001,904,18
0.508,0.0001,498,506,10,50,0.0001,1004,18
0.506,0.0001,544,560,10,50,0.0001,1104,18
0.506,0.0001,594,610,10,50,0.0001,1204,18
0.506,0.0001,640,664,10,50,0.0001,1304,18
0.506,0.0001,698,706,10,50,0.0001,1404,18
0.506,0.0001,744,760,10,50,0.0001,1504,18
0.502,0.0001,794,810,10,50,0.0001,1604,18
0.506,0.0001,835,869,10,50,0.0001,1704,18
0.508,0.0001,886,918,10,50,0.0001,1804,18
0.512,0.0001,936,968,10,50,0.0001,1904,18
0.52,0.0001,989,1015,10,50,0.0001,2004,18
0.506,0.0001,53,51,10,50,0.0001,104,19
0.506,0.0001,96,108,10,50,0.0001,204,19
0.506,0.0001,149,155,10,50,0.0001,304,19
0.506,0.0001,200,204,10,50,0.0001,404,19
0.506,0.0001,253,251,10,50,0.0001,504,19
0.506,0.0001,301,303,10,50,0.0001,604,19
0.506,0.0001,356,348,10,50,0.0001,704,19
0.506,0.0001,412,392,10,50,0.0001,804,19
0.506,0.0001,467,437,10,50,0.0001,904,19
0.508,0.0001,520,484,10,50,0.0001,1004,19
0.508,0.0001,566,538,10,50,0.0001,1104,19
0.508,0.0001,616,588,10,50,0.0001,1204,19
0.508,0.0001,667,637,10,50,0.0001,1304,19
0.51,0.0001,711,693,10,50,0.0001,1404,19
0.512,0.0001,767,737,10,50,0.0001,1504,19
0.514,0.0001,817,787,10,50,0.0001,1604,19
0.514,0.0001,861,843,10,50,0.0001,1704,19
0.514,0.0001,905,899,10,50,0.0001,1804,19
0.514,0.0001,952,952,10,50,0.0001,1904,19
0.518,0.0001,998,1006,10,50,0.0001,2004,19
0.492,0.0001,52,52,10,50,0.0001,104,20
0.492,0.0001,100,104,10,50,0.0001,204,20
0.492,0.0001,153,151,10,50,0.0001,304,20
0.492,0.0001,193,211,10,50,0.0001,404,20
0.492,0.0001,235,269,10,50,0.0001,504,20
0.494,0.0001,285,319,10,50,0.0001,604,20
0.496,0.0001,337,367,10,50,0.0001,704,20
0.496,0.0001,382,422,10,50,0.0001,804,20
0.498,0.0001,433,471,10,50,0.0001,904,20
0.5,0.0001,485,519,10,50,0.0001,1004,20
0.502,0.0001,538,566,10,50,0.0001,1104,20
0.504,0.0001,588,616,10,50,0.0001,1204,20
0.502,0.0001,646,658,10,50,0.0001,1304,20
0.502,0.0001,697,707,10,50,0.0001,1404,20
0.504,0.0001,755,749,10,50,0.0001,1504,20
0.5,0.0001,801,803,10,50,0.0001,1604,20
0.502,0.0001,848,856,10,50,0.0001,1704,20
0.504,0.0001,905,899,10,50,0.0001,1804,20
0.512,0.0001,947,957,10,50,0.0001,1904,20
0.512,0.0001,1001,1003,10,50,0.0001,2004,20
0.548,0.0001,56,48,10,50,0.001,104,1
0.552,0.0001,111,93,10,50,0.001,204,1
0.548,0.0001,165,139,10,50,0.001,304,1
0.546,0.0001,216,188,10,50,0.001,404,1
0.556,0.0001,265,239,10,50,0.001,504,1
0.572,0.0001,313,291,10,50,0.001,604,1
0.564,0.0001,365,339,10,50,0.001,704,1
0.566,0.0001,405,399,10,50,0.001,804,1
0.572,0.0001,450,454,10,50,0.001,904,1
0.582,0.0001,495,509,10,50,0.001,1004,1
0.612,0.0001,540,564,10,50,0.001,1104,1
0.632,0.0001,593,611,10,50,0.001,1204,1
0.646,0.0001,644,660,10,50,0.001,1304,1
0.664,0.0001,690,714,10,50,0.001,1404,1
0.676,0.0001,740,764,10,50,0.001,1504,1
0.698,0.0001,794,810,10,50,0.001,1604,1
0.728,0.0001,844,860,10,50,0.001,1704,1
0.746,0.0001,893,911,10,50,0.001,1804,1
0.764,0.0001,942,962,10,50,0.001,1904,1
0.79,0.0001,994,1010,10,50,0.001,2004,1
0.532,0.0001,53,51,10,50,0.001,104,2
0.536,0.0001,99,105,10,50,0.001,204,2
0.546,0.0001,151,153,10,50,0.001,304,2
0.556,0.0001,207,197,10,50,0.001,404,2
0.556,0.0001,262,242,10,50,0.001,504,2
0.566,0.0001,317,287,10,50,0.001,604,2
0.574,0.0001,367,337,10,50,0.001,704,2
0.594,0.0001,406,398,10,50,0.001,804,2
0.608,0.0001,459,445,10,50,0.001,904,2
0.634,0.0001,510,494,10,50,0.001,1004,2
0.642,0.0001,564,540,10,50,0.001,1104,2
0.682,0.0001,622,582,10,50,0.001,1204,2
0.696,0.0001,672,632,10,50,0.001,1304,2
0.706,0.0001,717,687,10,50,0.001,1404,2
0.72,0.0001,767,737,10,50,0.001,1504,2
0.732,0.0001,812,792,10,50,0.001,1604,2
0.756,0.0001,854,850,10,50,0.001,1704,2
0.788,0.0001,906,898,10,50,0.001,1804,2
0.808,0.0001,956,948,10,50,0.001,1904,2
0.822,0.0001,1002,1002,10,50,0.001,2004,2
0.568,0.0001,52,52,10,50,0.001,104,3
0.57,0.0001,98,106,10,50,0.001,204,3
0.578,0.0001,145,159,10,50,0.001,304,3
0.584,0.0001,195,209,10,50,0.001,404,3
0.57,0.0001,239,265,10,50,0.001,504,3
0.58,0.0001,293,311,10,50,0.001,604,3
0.59,0.0001,348,356,10,50,0.001,704,3
0.594,0.0001,397,407,10,50,0.001,804,3
0.606,0.0001,446,458,10,50,0.001,904,3
0.61,0.0001,494,510,10,50,0.001,1004,3
0.624,0.0001,542,562,10,50,0.001,1104,3
0.642,0.0001,589,615,10,50,0.001,1204,3
0.66,0.0001,646,658,10,50,0.001,1304,3
0.674,0.0001,702,702,10,50,0.001,1404,3
0.688,0.0001,750,754,10,50,0.001,1504,3
0.72,0.0001,803,801,10,50,0.001,1604,3
0.752,0.0001,856,848,10,50,0.001,1704,3
0.78,0.0001,910,894,10,50,0.001,1804,3
0.788,0.0001,957,947,10,50,0.001,1904,3
0.81,0.0001,1007,997,10,50,0.001,2004,3
0.518,0.0001,50,54,10,50,0.001,104,4
0.52,0.0001,102,102,10,50,0.001,204,4
0.524,0.0001,150,154,10,50,0.001,304,4
0.53,0.0001,207,197,10,50,0.001,404,4
0.526,0.0001,265,239,10,50,0.001,504,4
0.518,0.0001,308,296,10,50,0.001,604,4
0.526,0.0001,362,342,10,50,0.001,704,4
0.524,0.0001,410,394,10,50,0.001,804,4
0.53,0.0001,461,443,10,50,0.001,904,4
0.556,0.0001,512,492,10,50,0.001,1004,4
0.566,0.0001,568,536,10,50,0.001,1104,4
0.576,0.0001,628,576,10,50,0.001,1204,4
0.586,0.0001,680,624,10,50,0.001,1304,4
0.602,0.0001,735,669,10,50,0.001,1404,4
0.628,0.0001,781,723,10,50,0.001,1504,4
0.648,0.0001,821,783,10,50,0.001,1604,4
0.684,0.0001,864,840,10,50,0.001,1704,4
0.706,0.0001,908,896,10,50,0.001,1804,4
0.73,0.0001,960,944,10,50,0.001,1904,4
0.756,0.0001,1006,998,10,50,0.001,2004,4
0.468,0.0001,52,52,10,50,0.001,104,5
0.474,0.0001,103,101,10,50,0.001,204,5
0.478,0.0001,150,154,10,50,0.001,304,5
0.486,0.0001,192,212,10,50,0.001,404,5
0.49,0.0001,244,260,10,50,0.001,504,5
0.494,0.0001,299,305,10,50,0.001,604,5
0.512,0.0001,350,354,10,50,0.001,704,5
0.53,0.0001,404,400,10,50,0.001,804,5
0.55,0.0001,446,458,10,50,0.001,904,5
0.566,0.0001,492,512,10,50,0.001,1004,5
0.586,0.0001,543,561,10,50,0.001,1104,5
0.592,0.0001,588,616,10,50,0.001,1204,5
0.61,0.0001,639,665,10,50,0.001,1304,5
0.632,0.0001,699,705,10,50,0.001,1404,5
0.658,0.0001,744,760,10,50,0.001,1504,5
0.694,0.0001,802,802,10,50,0.001,1604,5
0.718,0.0001,852,852,10,50,0.001,1704,5
0.758,0.0001,901,903,10,50,0.001,1804,5
0.766,0.0001,951,953,10,50,0.001,1904,5
0.778,0.0001,999,1005,10,50,0.001,2004,5
0.552,0.0001,50,54,10,50,0.001,104,6
0.56,0.0001,96,108,10,50,0.001,204,6
0.554,0.0001,143,161,10,50,0.001,304,6
0.552,0.0001,194,210,10,50,0.001,404,6
0.558,0.0001,245,259,10,50,0.001,504,6
0.576,0.0001,292,312,10,50,0.001,604,6
0.58,0.0001,343,361,10,50,0.001,704,6
0.578,0.0001,392,412,10,50,0.001,804,6
0.588,0.0001,439,465,10,50,0.001,904,6
0.604,0.0001,481,523,10,50,0.001,1004,6
0.608,0.0001,525,579,10,50,0.001,1104,6
0.628,0.0001,573,631,10,50,0.001,1204,6
0.624,0.0001,624,680,10,50,0.001,1304,6
0.624,0.0001,670,734,10,50,0.001,1404,6
0.624,0.0001,716,788,10,50,0.001,1504,6
0.636,0.0001,755,849,10,50,0.001,1604,6
0.65,0.0001,809,895,10,50,0.001,1704,6
0.678,0.0001,865,939,10,50,0.001,1804,6
0.696,0.0001,917,987,10,50,0.001,1904,6
0.712,0.0001,977,1027,10,50,0.001,2004,6
0.498,0.0001,52,52,10,50,0.001,104,7
0.494,0.0001,105,99,10,50,0.001,204,7
0.486,0.0001,150,154,10,50,0.001,304,7
0.49,0.0001,198,206,10,50,0.001,404,7
0.494,0.0001,252,252,10,50,0.001,504,7
0.488,0.0001,301,303,10,50,0.001,604,7
0.5,0.0001,350,354,10,50,0.001,704,7
0.502,0.0001,395,409,10,50,0.001,804,7
0.512,0.0001,436,468,10,50,0.001,904,7
0.518,0.0001,489,515,10,50,0.001,1004,7
0.54,0.0001,526,578,10,50,0.001,1104,7
0.552,0.0001,585,619,10,50,0.001,1204,7
0.576,0.0001,646,658,10,50,0.001,1304,7
0.614,0.0001,700,704,10,50,0.001,1404,7
0.65,0.0001,755,749,10,50,0.001,1504,7
0.678,0.0001,799,805,10,50,0.001,1604,7
0.694,0.0001,853,851,10,50,0.001,1704,7
0.722,0.0001,900,904,10,50,0.001,1804,7
0.752,0.0001,951,953,10,50,0.001,1904,7
0.78,0.0001,1006,998,10,50,0.001,2004,7
0.514,0.0001,49,55,10,50,0.001,104,8
0.526,0.0001,100,104,10,50,0.001,204,8
0.526,0.0001,141,163,10,50,0.001,304,8
0.552,0.0001,191,213,10,50,0.001,404,8
0.568,0.0001,246,258,10,50,0.001,504,8
0.582,0.0001,299,305,10,50,0.001,604,8
0.602,0.0001,354,350,10,50,0.001,704,8
0.61,0.0001,403,401,10,50,0.001,804,8
0.618,0.0001,450,454,10,50,0.001,904,8
0.632,0.0001,508,496,10,50,0.001,1004,8
0.652,0.0001,553,551,10,50,0.001,1104,8
0.672,0.0001,606,598,10,50,0.001,1204,8
0.68,0.0001,662,642,10,50,0.001,1304,8
0.694,0.0001,710,694,10,50,0.001,1404,8
0.712,0.0001,760,744,10,50,0.001,1504,8
0.736,0.0001,808,796,10,50,0.001,1604,8
0.752,0.0001,861,843,10,50,0.001,1704,8
0.778,0.0001,915,889,10,50,0.001,1804,8
0.794,0.0001,955,949,10,50,0.001,1904,8
0.81,0.0001,1013,991,10,50,0.001,2004,8
0.512,0.0001,50,54,10,50,0.001,104,9
0.512,0.0001,104,100,10,50,0.001,204,9
0.526,0.0001,146,158,10,50,0.001,304,9
0.534,0.0001,196,208,10,50,0.001,404,9
0.55,0.0001,252,252,10,50,0.001,504,9
0.554,0.0001,295,309,10,50,0.001,604,9
0.57,0.0001,342,362,10,50,0.001,704,9
0.584,0.0001,385,419,10,50,0.001,804,9
0.594,0.0001,436,468,10,50,0.001,904,9
0.628,0.0001,490,514,10,50,0.001,1004,9
0.644,0.0001,544,560,10,50,0.001,1104,9
0.662,0.0001,595,609,10,50,0.001,1204,9
0.662,0.0001,646,658,10,50,0.001,1304,9
0.672,0.0001,693,711,10,50,0.001,1404,9
0.69,0.0001,750,754,10,50,0.001,1504,9
0.71,0.0001,800,804,10,50,0.001,1604,9
0.722,0.0001,847,857,10,50,0.001,1704,9
0.736,0.0001,900,904,10,50,0.001,1804,9
0.76,0.0001,950,954,10,50,0.001,1904,9
0.77,0.0001,1002,1002,10,50,0.001,2004,9
0.478,0.0001,66,38,10,50,0.001,104,10
0.47,0.0001,116,88,10,50,0.001,204,10
0.472,0.0001,165,139,10,50,0.001,304,10
0.464,0.0001,217,187,10,50,0.001,404,10
0.474,0.0001,263,241,10,50,0.001,504,10
0.48,0.0001,312,292,10,50,0.001,604,10
0.488,0.0001,358,346,10,50,0.001,704,10
0.502,0.0001,408,396,10,50,0.001,804,10
0.514,0.0001,459,445,10,50,0.001,904,10
0.526,0.0001,506,498,10,50,0.001,1004,10
0.544,0.0001,558,546,10,50,0.001,1104,10
0.564,0.0001,615,589,10,50,0.001,1204,10
0.584,0.0001,663,641,10,50,0.001,1304,10
0.608,0.0001,716,688,10,50,0.001,1404,10
0.632,0.0001,764,740,10,50,0.001,1504,10
0.662,0.0001,813,791,10,50,0.001,1604,10
0.666,0.0001,864,840,10,50,0.001,1704,10
0.694,0.0001,916,888,10,50,0.001,1804,10
0.708,0.0001,961,943,10,50,0.001,1904,10
0.736,0.0001,1009,995,10,50,0.001,2004,10
0.468,0.0001,52,52,10,50,0.001,104,11
0.468,0.0001,98,106,10,50,0.001,204,11
0.464,0.0001,150,154,10,50,0.001,304,11
0.472,0.0001,193,211,10,50,0.001,404,11
0.476,0.0001,245,259,10,50,0.001,504,11
0.49,0.0001,296,308,10,50,0.001,604,11
0.5,0.0001,341,363,10,50,0.001,704,11
0.51,0.0001,391,413,10,50,0.001,804,11
0.512,0.0001,440,464,10,50,0.001,904,11
0.534,0.0001,490,514,10,50,0.001,1004,11
0.544,0.0001,538,566,10,50,0.001,1104,11
0.572,0.0001,581,623,10,50,0.001,1204,11
0.598,0.0001,638,666,10,50,0.001,1304,11
0.614,0.0001,690,714,10,50,0.001,1404,11
0.632,0.0001,739,765,10,50,0.001,1504,11
0.642,0.0001,790,814,10,50,0.001,1604,11
0.662,0.0001,843,861,10,50,0.001,1704,11
0.692,0.0001,893,911,10,50,0.001,1804,11
0.706,0.0001,942,962,10,50,0.001,1904,11
0.734,0.0001,997,1007,10,50,0.001,2004,11
0.524,0.0001,53,51,10,50,0.001,104,12
0.54,0.0001,93,111,10,50,0.001,204,12
0.546,0.0001,149,155,10,50,0.001,304,12
0.55,0.0001,197,207,10,50,0.001,404,12
0.566,0.0001,242,262,10,50,0.001,504,12
0.59,0.0001,292,312,10,50,0.001,604,12
0.608,0.0001,340,364,10,50,0.001,704,12
0.628,0.0001,388,416,10,50,0.001,804,12
0.658,0.0001,448,456,10,50,0.001,904,12
0.674,0.0001,502,502,10,50,0.001,1004,12
0.69,0.0001,557,547,10,50,0.001,1104,12
0.72,0.0001,600,604,10,50,0.001,1204,12
0.746,0.0001,656,648,10,50,0.001,1304,12
0.774,0.0001,710,694,10,50,0.001,1404,12
0.784,0.0001,764,740,10,50,0.001,1504,12
0.806,0.0001,805,799,10,50,0.001,1604,12
0.832,0.0001,856,848,10,50,0.001,1704,12
0.844,0.0001,906,898,10,50,0.001,1804,12
0.854,0.0001,949,955,10,50,0.001,1904,12
0.862,0.0001,999,1005,10,50,0.001,2004,12
0.48,0.0001,55,49,10,50,0.001,104,13
0.48,0.0001,104,100,10,50,0.001,204,13
0.478,0.0001,155,149,10,50,0.001,304,13
0.478,0.0001,205,199,10,50,0.001,404,13
0.48,0.0001,255,249,10,50,0.001,504,13
0.478,0.0001,299,305,10,50,0.001,604,13
0.482,0.0001,350,354,10,50,0.001,704,13
0.49,0.0001,406,398,10,50,0.001,804,13
0.51,0.0001,460,444,10,50,0.001,904,13
0.526,0.0001,499,505,10,50,0.001,1004,13
0.534,0.0001,547,557,10,50,0.001,1104,13
0.558,0.0001,598,606,10,50,0.001,1204,13
0.58,0.0001,652,652,10,50,0.001,1304,13
0.594,0.0001,701,703,10,50,0.001,1404,13
0.612,0.0001,747,757,10,50,0.001,1504,13
0.63,0.0001,794,810,10,50,0.001,1604,13
0.664,0.0001,843,861,10,50,0.001,1704,13
0.7,0.0001,889,915,10,50,0.001,1804,13
0.72,0.0001,940,964,10,50,0.001,1904,13
0.748,0.0001,992,1012,10,50,0.001,2004,13
0.53,0.0001,49,55,10,50,0.001,104,14
0.538,0.0001,91,113,10,50,0.001,204,14
0.538,0.0001,129,175,10,50,0.001,304,14
0.554,0.0001,182,222,10,50,0.001,404,14
0.574,0.0001,235,269,10,50,0.001,504,14
0.588,0.0001,291,313,10,50,0.001,604,14
0.602,0.0001,340,364,10,50,0.001,704,14
0.606,0.0001,392,412,10,50,0.001,804,14
0.626,0.0001,441,463,10,50,0.001,904,14
0.632,0.0001,494,510,10,50,0.001,1004,14
0.65,0.0001,548,556,10,50,0.001,1104,14
0.668,0.0001,594,610,10,50,0.001,1204,14
0.686,0.0001,641,663,10,50,0.001,1304,14
0.704,0.0001,703,701,10,50,0.001,1404,14
0.71,0.0001,755,749,10,50,0.001,1504,14
0.746,0.0001,807,797,10,50,0.001,1604,14
0.776,0.0001,856,848,10,50,0.001,1704,14
0.798,0.0001,913,891,10,50,0.001,1804,14
0.82,0.0001,956,948,10,50,0.001,1904,14
0.83,0.0001,1003,1001,10,50,0.001,2004,14
0.51,0.0001,50,54,10,50,0.001,104,15
0.512,0.0001,94,110,10,50,0.001,204,15
0.518,0.0001,144,160,10,50,0.001,304,15
0.524,0.0001,192,212,10,50,0.001,404,15
0.526,0.0001,244,260,10,50,0.001,504,15
0.538,0.0001,287,317,10,50,0.001,604,15
0.55,0.0001,333,371,10,50,0.001,704,15
0.58,0.0001,381,423,10,50,0.001,804,15
0.626,0.0001,423,481,10,50,0.001,904,15
0.648,0.0001,479,525,10,50,0.001,1004,15
0.678,0.0001,532,572,10,50,0.001,1104,15
0.692,0.0001,588,616,10,50,0.001,1204,15
0.704,0.0001,633,671,10,50,0.001,1304,15
0.708,0.0001,685,719,10,50,0.001,1404,15
0.73,0.0001,737,767,10,50,0.001,1504,15
0.758,0.0001,784,820,10,50,0.001,1604,15
0.772,0.0001,832,872,10,50,0.001,1704,15
0.772,0.0001,887,917,10,50,0.001,1804,15
0.786,0.0001,937,967,10,50,0.001,1904,15
0.8,0.0001,989,1015,10,50,0.001,2004,15
0.47,0.0001,56,48,10,50,0.001,104,16
0.466,0.0001,101,103,10,50,0.001,204,16
0.464,0.0001,158,146,10,50,0.001,304,16
0.456,0.0001,209,195,10,50,0.001,404,16
0.462,0.0001,261,243,10,50,0.001,504,16
0.454,0.0001,304,300,10,50,0.001,604,16
0.462,0.0001,354,350,10,50,0.001,704,16
0.462,0.0001,403,401,10,50,0.001,804,16
0.472,0.0001,458,446,10,50,0.001,904,16
0.496,0.0001,509,495,10,50,0.001,1004,16
0.514,0.0001,551,553,10,50,0.001,1104,16
0.524,0.0001,600,604,10,50,0.001,1204,16
0.552,0.0001,656,648,10,50,0.001,1304,16
0.578,0.0001,704,700,10,50,0.001,1404,16
0.61,0.0001,755,749,10,50,0.001,1504,16
0.644,0.0001,816,788,10,50,0.001,1604,16
0.648,0.0001,877,827,10,50,0.001,1704,16
0.668,0.0001,917,887,10,50,0.001,1804,16
0.698,0.0001,968,936,10,50,0.001,1904,16
0.742,0.0001,1011,993,10,50,0.001,2004,16
0.506,0.0001,52,52,10,50,0.001,104,17
0.514,0.0001,104,100,10,50,0.001,204,17
0.514,0.0001,156,148,10,50,0.001,304,17
0.522,0.0001,207,197,10,50,0.001,404,17
0.518,0.0001,251,253,10,50,0.001,504,17
0.528,0.0001,306,298,10,50,0.001,604,17
0.536,0.0001,353,351,10,50,0.001,704,17
0.548,0.0001,398,406,10,50,0.001,804,17
0.562,0.0001,450,454,10,50,0.001,904,17
0.574,0.0001,497,507,10,50,0.001,1004,17
0.578,0.0001,548,556,10,50,0.001,1104,17
0.602,0.0001,600,604,10,50,0.001,1204,17
0.626,0.0001,658,646,10,50,0.001,1304,17
0.636,0.0001,706,698,10,50,0.001,1404,17
0.658,0.0001,758,746,10,50,0.001,1504,17
0.682,0.0001,807,797,10,50,0.001,1604,17
0.714,0.0001,859,845,10,50,0.001,1704,17
0.746,0.0001,910,894,10,50,0.001,1804,17
0.762,0.0001,953,951,10,50,0.001,1904,17
0.8,0.0001,997,1007,10,50,0.001,2004,17
0.53,0.0001,48,56,10,50,0.001,104,18
0.528,0.0001,99,105,10,50,0.001,204,18
0.524,0.0001,141,163,10,50,0.001,304,18
0.532,0.0001,199,205,10,50,0.001,404,18
0.54,0.0001,246,258,10,50,0.001,504,18
0.542,0.0001,280,324,10,50,0.001,604,18
0.54,0.0001,336,368,10,50,0.001,704,18
0.532,0.0001,387,417,10,50,0.001,804,18
0.538,0.0001,438,466,10,50,0.001,904,18
0.55,0.0001,488,516,10,50,0.001,1004,18
0.548,0.0001,534,570,10,50,0.001,1104,18
0.55,0.0001,583,621,10,50,0.001,1204,18
0.564,0.0001,639,665,10,50,0.001,1304,18
0.588,0.0001,694,710,10,50,0.001,1404,18
0.602,0.0001,744,760,10,50,0.001,1504,18
0.626,0.0001,788,816,10,50,0.001,1604,18
0.642,0.0001,835,869,10,50,0.001,1704,18
0.66,0.0001,890,914,10,50,0.001,1804,18
0.684,0.0001,932,972,10,50,0.001,1904,18
0.71,0.0001,988,1016,10,50,0.001,2004,18
0.51,0.0001,58,46,10,50,0.001,104,19
0.512,0.0001,114,90,10,50,0.001,204,19
0.518,0.0001,162,142,10,50,0.001,304,19
0.53,0.0001,208,196,10,50,0.001,404,19
0.536,0.0001,254,250,10,50,0.001,504,19
0.546,0.0001,311,293,10,50,0.001,604,19
0.55,0.0001,365,339,10,50,0.001,704,19
0.554,0.0001,411,393,10,50,0.001,804,19
0.57,0.0001,463,441,10,50,0.001,904,19
0.576,0.0001,511,493,10,50,0.001,1004,19
0.598,0.0001,559,545,10,50,0.001,1104,19
0.612,0.0001,605,599,10,50,0.001,1204,19
0.628,0.0001,657,647,10,50,0.001,1304,19
0.64,0.0001,709,695,10,50,0.001,1404,19
0.654,0.0001,753,751,10,50,0.001,1504,19
0.676,0.0001,801,803,10,50,0.001,1604,19
0.698,0.0001,851,853,10,50,0.001,1704,19
0.712,0.0001,905,899,10,50,0.001,1804,19
0.752,0.0001,960,944,10,50,0.001,1904,19
0.766,0.0001,1006,998,10,50,0.001,2004,19
0.524,0.0001,54,50,10,50,0.001,104,20
0.528,0.0001,104,100,10,50,0.001,204,20
0.532,0.0001,145,159,10,50,0.001,304,20
0.55,0.0001,204,200,10,50,0.001,404,20
0.562,0.0001,242,262,10,50,0.001,504,20
0.576,0.0001,298,306,10,50,0.001,604,20
0.596,0.0001,349,355,10,50,0.001,704,20
0.606,0.0001,401,403,10,50,0.001,804,20
0.626,0.0001,451,453,10,50,0.001,904,20
0.634,0.0001,509,495,10,50,0.001,1004,20
0.652,0.0001,558,546,10,50,0.001,1104,20
0.67,0.0001,605,599,10,50,0.001,1204,20
0.68,0.0001,651,653,10,50,0.001,1304,20
0.692,0.0001,694,710,10,50,0.001,1404,20
0.708,0.0001,749,755,10,50,0.001,1504,20
0.726,0.0001,794,810,10,50,0.001,1604,20
0.738,0.0001,847,857,10,50,0.001,1704,20
0.756,0.0001,891,913,10,50,0.001,1804,20
0.774,0.0001,942,962,10,50,0.001,1904,20
0.79,0.0001,984,1020,10,50,0.001,2004,20
0.5,0.0001,59,45,10,50,0.01,104,1
0.532,0.0001,116,88,10,50,0.01,204,1
0.584,0.0001,167,137,10,50,0.01,304,1
0.6,0.0001,215,189,10,50,0.01,404,1
0.626,0.0001,268,236,10,50,0.01,504,1
0.682,0.0001,321,283,10,50,0.01,604,1
0.712,0.0001,365,339,10,50,0.01,704,1
0.766,0.0001,408,396,10,50,0.01,804,1
0.8,0.0001,466,438,10,50,0.01,904,1
0.836,0.0001,518,486,10,50,0.01,1004,1
0.862,0.0001,565,539,10,50,0.01,1104,1
0.906,0.0001,610,594,10,50,0.01,1204,1
0.936,0.0001,660,644,10,50,0.01,1304,1
0.942,0.0001,711,693,10,50,0.01,1404,1
0.944,0.0001,765,739,10,50,0.01,1504,1
0.956,0.0001,813,791,10,50,0.01,1604,1
0.958,0.0001,863,841,10,50,0.01,1704,1
0.96,0.0001,916,888,10,50,0.01,1804,1
0.962,0.0001,963,941,10,50,0.01,1904,1
0.97,0.0001,1001,1003,10,50,0.01,2004,1
0.582,0.0001,47,57,10,50,0.01,104,2
0.606,0.0001,92,112,10,50,0.01,204,2
0.63,0.0001,143,161,10,50,0.01,304,2
0.676,0.0001,188,216,10,50,0.01,404,2
0.69,0.0001,244,260,10,50,0.01,504,2
0.73,0.0001,297,307,10,50,0.01,604,2
0.756,0.0001,354,350,10,50,0.01,704,2
0.81,0.0001,405,399,10,50,0.01,804,2
0.892,0.0001,454,450,10,50,0.01,904,2
0.932,0.0001,492,512,10,50,0.01,1004,2
0.938,0.0001,543,561,10,50,0.01,1104,2
0.954,0.0001,600,604,10,50,0.01,1204,2
0.966,0.0001,652,652,10,50,0.01,1304,2
0.968,0.0001,701,703,10,50,0.01,1404,2
0.972,0.0001,748,756,10,50,0.01,1504,2
0.972,0.0001,804,800,10,50,0.01,1604,2
0.976,0.0001,854,850,10,50,0.01,1704,2
0.976,0.0001,907,897,10,50,0.01,1804,2
0.976,0.0001,958,946,10,50,0.01,1904,2
0.98,0.0001,1005,999,10,50,0.01,2004,2
0.472,0.0001,58,46,10,50,0.01,104,3
0.518,0.0001,106,98,10,50,0.01,204,3
0.574,0.0001,150,154,10,50,0.01,304,3
0.624,0.0001,204,200,10,50,0.01,404,3
0.662,0.0001,259,245,10,50,0.01,504,3
0.702,0.0001,319,285,10,50,0.01,604,3
0.75,0.0001,361,343,10,50,0.01,704,3
0.798,0.0001,414,390,10,50,0.01,804,3
0.882,0.0001,465,439,10,50,0.01,904,3
0.914,0.0001,512,492,10,50,0.01,1004,3
0.906,0.0001,563,541,10,50,0.01,1104,3
0.928,0.0001,616,588,10,50,0.01,1204,3
0.944,0.0001,665,639,10,50,0.01,1304,3
0.954,0.0001,717,687,10,50,0.01,1404,3
0.958,0.0001,768,736,10,50,0.01,1504,3
0.964,0.0001,819,785,10,50,0.01,1604,3
0.968,0.0001,864,840,10,50,0.01,1704,3
0.976,0.0001,921,883,10,50,0.01,1804,3
0.974,0.0001,964,940,10,50,0.01,1904,3
0.98,0.0001,1017,987,10,50,0.01,2004,3
0.562,0.0001,51,53,10,50,0.01,104,4
0.61,0.0001,96,108,10,50,0.01,204,4
0.602,0.0001,140,164,10,50,0.01,304,4
0.604,0.0001,189,215,10,50,0.01,404,4
0.628,0.0001,251,253,10,50,0.01,504,4
0.69,0.0001,299,305,10,50,0.01,604,4
0.784,0.0001,343,361,10,50,0.01,704,4
0.816,0.0001,389,415,10,50,0.01,804,4
0.874,0.0001,438,466,10,50,0.01,904,4
0.93,0.0001,494,510,10,50,0.01,1004,4
0.936,0.0001,549,555,10,50,0.01,1104,4
0.946,0.0001,599,605,10,50,0.01,1204,4
0.952,0.0001,649,655,10,50,0.01,1304,4
0.956,0.0001,702,702,10,50,0.01,1404,4
0.952,0.0001,752,752,10,50,0.01,1504,4
0.966,0.0001,801,803,10,50,0.01,1604,4
0.97,0.0001,851,853,10,50,0.01,1704,4
0.974,0.0001,896,908,10,50,0.01,1804,4
0.972,0.0001,950,954,10,50,0.01,1904,4
0.978,0.0001,1000,1004,10,50,0.01,2004,4
0.508,0.0001,43,61,10,50,0.01,104,5
0.602,0.0001,98,106,10,50,0.01,204,5
0.586,0.0001,145,159,10,50,0.01,304,5
0.62,0.0001,199,205,10,50,0.01,404,5
0.658,0.0001,249,255,10,50,0.01,504,5
0.692,0.0001,296,308,10,50,0.01,604,5
0.716,0.0001,346,358,10,50,0.01,704,5
0.812,0.0001,399,405,10,50,0.01,804,5
0.902,0.0001,454,450,10,50,0.01,904,5
0.92,0.0001,518,486,10,50,0.01,1004,5
0.936,0.0001,566,538,10,50,0.01,1104,5
0.952,0.0001,615,589,10,50,0.01,1204,5
0.952,0.0001,676,628,10,50,0.01,1304,5
0.966,0.0001,727,677,10,50,0.01,1404,5
0.968,0.0001,772,732,10,50,0.01,1504,5
0.974,0.0001,821,783,10,50,0.01,1604,5
0.978,0.0001,869,835,10,50,0.01,1704,5
0.968,0.0001,919,885,10,50,0.01,1804,5
0.972,0.0001,967,937,10,50,0.01,1904,5
0.98,0.0001,1013,991,10,50,0.01,2004,5
0.542,0.0001,52,52,10,50,0.01,104,6
0.574,0.0001,119,85,10,50,0.01,204,6
0.592,0.0001,163,141,10,50,0.01,304,6
0.65,0.0001,211,193,10,50,0.01,404,6
0.654,0.0001,264,240,10,50,0.01,504,6
0.662,0.0001,313,291,10,50,0.01,604,6
0.688,0.0001,363,341,10,50,0.01,704,6
0.702,0.0001,412,392,10,50,0.01,804,6
0.714,0.0001,458,446,10,50,0.01,904,6
0.764,0.0001,509,495,10,50,0.01,1004,6
0.834,0.0001,557,547,10,50,0.01,1104,6
0.916,0.0001,604,600,10,50,0.01,1204,6
0.932,0.0001,647,657,10,50,0.01,1304,6
0.954,0.0001,698,706,10,50,0.01,1404,6
0.962,0.0001,746,758,10,50,0.01,1504,6
0.968,0.0001,805,799,10,50,0.01,1604,6
0.97,0.0001,849,855,10,50,0.01,1704,6
0.976,0.0001,908,896,10,50,0.01,1804,6
0.978,0.0001,964,940,10,50,0.01,1904,6
0.978,0.0001,1015,989,10,50,0.01,2004,6
0.522,0.0001,56,48,10,50,0.01,104,7
0.544,0.0001,110,94,10,50,0.01,204,7
0.554,0.0001,161,143,10,50,0.01,304,7
0.602,0.0001,205,199,10,50,0.01,404,7
0.656,0.0001,259,245,10,50,0.01,504,7
0.696,0.0001,312,292,10,50,0.01,604,7
0.75,0.0001,365,339,10,50,0.01,704,7
0.776,0.0001,409,395,10,50,0.01,804,7
0.824,0.0001,460,444,10,50,0.01,904,7
0.892,0.0001,513,491,10,50,0.01,1004,7
0.92,0.0001,561,543,10,50,0.01,1104,7
0.954,0.0001,614,590,10,50,0.01,1204,7
0.974,0.0001,657,647,10,50,0.01,1304,7
0.974,0.0001,709,695,10,50,0.01,1404,7
0.976,0.0001,752,752,10,50,0.01,1504,7
0.986,0.0001,800,804,10,50,0.01,1604,7
0.988,0.0001,838,866,10,50,0.01,1704,7
0.988,0.0001,890,914,10,50,0.01,1804,7
0.988,0.0001,943,961,10,50,0.01,1904,7
0.994,0.0001,998,1006,10,50,0.01,2004,7
0.522,0.0001,50,54,10,50,0.01,104,8
0.574,0.0001,95,109,10,50,0.01,204,8
0.612,0.0001,159,145,10,50,0.01,304,8
0.64,0.0001,205,199,10,50,0.01,404,8
0.648,0.0001,256,248,10,50,0.01,504,8
0.676,0.0001,315,289,10,50,0.01,604,8
0.776,0.0001,367,337,10,50,0.01,704,8
0.828,0.0001,420,384,10,50,0.01,804,8
0.896,0.0001,470,434,10,50,0.01,904,8
0.942,0.0001,512,492,10,50,0.01,1004,8
0.954,0.0001,564,540,10,50,0.01,1104,8
0.956,0.0001,609,595,10,50,0.01,1204,8
0.956,0.0001,652,652,10,50,0.01,1304,8
0.956,0.0001,699,705,10,50,0.01,1404,8
0.96,0.0001,752,752,10,50,0.01,1504,8
0.968,0.0001,806,798,10,50,0.01,1604,8
0.972,0.0001,857,847,10,50,0.01,1704,8
0.976,0.0001,905,899,10,50,0.01,1804,8
0.974,0.0001,954,950,10,50,0.01,1904,8
0.98,0.0001,1006,998,10,50,0.01,2004,8
0.542,0.0001,49,55,10,50,0.01,104,9
0.55,0.0001,99,105,10,50,0.01,204,9
0.598,0.0001,150,154,10,50,0.01,304,9
0.632,0.0001,206,198,10,50,0.01,404,9
0.646,0.0001,257,247,10,50,0.01,504,9
0.682,0.0001,307,297,10,50,0.01,604,9
0.716,0.0001,357,347,10,50,0.01,704,9
0.808,0.0001,397,407,10,50,0.01,804,9
0.878,0.0001,444,460,10,50,0.01,904,9
0.912,0.0001,492,512,10,50,0.01,1004,9
0.914,0.0001,541,563,10,50,0.01,1104,9
0.94,0.0001,590,614,10,50,0.01,1204,9
0.944,0.0001,644,660,10,50,0.01,1304,9
0.94,0.0001,697,707,10,50,0.01,1404,9
0.948,0.0001,743,761,10,50,0.01,1504,9
0.954,0.0001,790,814,10,50,0.01,1604,9
0.96,0.0001,842,862,10,50,0.01,1704,9
0.962,0.0001,896,908,10,50,0.01,1804,9
0.964,0.0001,951,953,10,50,0.01,1904,9
0.968,0.0001,995,1009,10,50,0.01,2004,9
0.524,0.0001,52,52,10,50,0.01,104,10
0.584,0.0001,103,101,10,50,0.01,204,10
0.668,0.0001,152,152,10,50,0.01,304,10
0.72,0.0001,213,191,10,50,0.01,404,10
0.696,0.0001,263,241,10,50,0.01,504,10
0.714,0.0001,318,286,10,50,0.01,604,10
0.724,0.0001,364,340,10,50,0.01,704,10
0.794,0.0001,408,396,10,50,0.01,804,10
0.866,0.0001,458,446,10,50,0.01,904,10
0.908,0.0001,509,495,10,50,0.01,1004,10
0.922,0.0001,557,547,10,50,0.01,1104,10
0.95,0.0001,610,594,10,50,0.01,1204,10
0.962,0.0001,659,645,10,50,0.01,1304,10
0.96,0.0001,709,695,10,50,0.01,1404,10
0.964,0.0001,760,744,10,50,0.01,1504,10
0.972,0.0001,809,795,10,50,0.01,1604,10
0.972,0.0001,855,849,10,50,0.01,1704,10
0.976,0.0001,909,895,10,50,0.01,1804,10
0.978,0.0001,955,949,10,50,0.01,1904,10
0.98,0.0001,1004,1000,10,50,0.01,2004,10
0.496,0.0001,49,55,10,50,0.01,104,11
0.492,0.0001,100,104,10,50,0.01,204,11
0.518,0.0001,147,157,10,50,0.01,304,11
0.59,0.0001,203,201,10,50,0.01,404,11
0.632,0.0001,253,251,10,50,0.01,504,11
0.644,0.0001,307,297,10,50,0.01,604,11
0.662,0.0001,350,354,10,50,0.01,704,11
0.744,0.0001,402,402,10,50,0.01,804,11
0.786,0.0001,450,454,10,50,0.01,904,11
0.806,0.0001,497,507,10,50,0.01,1004,11
0.864,0.0001,553,551,10,50,0.01,1104,11
0.906,0.0001,602,602,10,50,0.01,1204,11
0.916,0.0001,650,654,10,50,0.01,1304,11
0.93,0.0001,698,706,10,50,0.01,1404,11
0.938,0.0001,743,761,10,50,0.01,1504,11
0.956,0.0001,796,808,10,50,0.01,1604,11
0.96,0.0001,856,848,10,50,0.01,1704,11
0.962,0.0001,910,894,10,50,0.01,1804,11
0.964,0.0001,954,950,10,50,0.01,1904,11
0.974,0.0001,1000,1004,10,50,0.01,2004,11
0.53,0.0001,51,53,10,50,0.01,104,12
0.552,0.0001,105,99,10,50,0.01,204,12
0.568,0.0001,158,146,10,50,0.01,304,12
0.626,0.0001,220,184,10,50,0.01,404,12
0.664,0.0001,266,238,10,50,0.01,504,12
0.71,0.0001,316,288,10,50,0.01,604,12
0.73,0.0001,368,336,10,50,0.01,704,12
0.792,0.0001,413,391,10,50,0.01,804,12
0.838,0.0001,466,438,10,50,0.01,904,12
0.88,0.0001,509,495,10,50,0.01,1004,12
0.906,0.0001,564,540,10,50,0.01,1104,12
0.922,0.0001,619,585,10,50,0.01,1204,12
0.93,0.0001,674,630,10,50,0.01,1304,12
0.938,0.0001,720,684,10,50,0.01,1404,12
0.944,0.0001,771,733,10,50,0.01,1504,12
0.946,0.0001,821,783,10,50,0.01,1604,12
0.954,0.0001,869,835,10,50,0.01,1704,12
0.96,0.0001,920,884,10,50,0.01,1804,12
0.964,0.0001,969,935,10,50,0.01,1904,12
0.968,0.0001,1009,995,10,50,0.01,2004,12
0.492,0.0001,49,55,10,50,0.01,104,13
0.57,0.0001,95,109,10,50,0.01,204,13
0.566,0.0001,137,167,10,50,0.01,304,13
0.562,0.0001,178,226,10,50,0.01,404,13
0.582,0.0001,229,275,10,50,0.01,504,13
0.64,0.0001,281,323,10,50,0.01,604,13
0.708,0.0001,338,366,10,50,0.01,704,13
0.762,0.0001,387,417,10,50,0.01,804,13
0.78,0.0001,440,464,10,50,0.01,904,13
0.852,0.0001,488,516,10,50,0.01,1004,13
0.914,0.0001,540,564,10,50,0.01,1104,13
0.948,0.0001,595,609,10,50,0.01,1204,13
0.964,0.0001,647,657,10,50,0.01,1304,13
0.97,0.0001,699,705,10,50,0.01,1404,13
0.974,0.0001,748,756,10,50,0.01,1504,13
0.978,0.0001,801,803,10,50,0.01,1604,13
0.984,0.0001,860,844,10,50,0.01,1704,13
0.984,0.0001,910,894,10,50,0.01,1804,13
0.982,0.0001,949,955,10,50,0.01,1904,13
0.986,0.0001,1000,1004,10,50,0.01,2004,13
0.532,0.0001,53,51,10,50,0.01,104,14
0.55,0.0001,105,99,10,50,0.01,204,14
0.59,0.0001,153,151,10,50,0.01,304,14
0.636,0.0001,201,203,10,50,0.01,404,14
0.674,0.0001,248,256,10,50,0.01,504,14
0.728,0.0001,299,305,10,50,0.01,604,14
0.77,0.0001,346,358,10,50,0.01,704,14
0.83,0.0001,390,414,10,50,0.01,804,14
0.846,0.0001,432,472,10,50,0.01,904,14
0.882,0.0001,482,522,10,50,0.01,1004,14
0.912,0.0001,538,566,10,50,0.01,1104,14
0.936,0.0001,583,621,10,50,0.01,1204,14
0.938,0.0001,635,669,10,50,0.01,1304,14
0.938,0.0001,691,713,10,50,0.01,1404,14
0.956,0.0001,741,763,10,50,0.01,1504,14
0.954,0.0001,799,805,10,50,0.01,1604,14
0.96,0.0001,854,850,10,50,0.01,1704,14
0.962,0.0001,899,905,10,50,0.01,1804,14
0.968,0.0001,952,952,10,50,0.01,1904,14
0.978,0.0001,1006,998,10,50,0.01,2004,14
0.572,0.0001,42,62,10,50,0.01,104,15
0.572,0.0001,94,110,10,50,0.01,204,15
0.59,0.0001,140,164,10,50,0.01,304,15
0.642,0.0001,195,209,10,50,0.01,404,15
0.67,0.0001,247,257,10,50,0.01,504,15
0.72,0.0001,300,304,10,50,0.01,604,15
0.752,0.0001,352,352,10,50,0.01,704,15
0.818,0.0001,402,402,10,50,0.01,804,15
0.864,0.0001,454,450,10,50,0.01,904,15
0.904,0.0001,502,502,10,50,0.01,1004,15
0.906,0.0001,553,551,10,50,0.01,1104,15
0.918,0.0001,600,604,10,50,0.01,1204,15
0.938,0.0001,645,659,10,50,0.01,1304,15
0.95,0.0001,698,706,10,50,0.01,1404,15
0.954,0.0001,743,761,10,50,0.01,1504,15
0.96,0.0001,795,809,10,50,0.01,1604,15
0.96,0.0001,839,865,10,50,0.01,1704,15
0.966,0.0001,892,912,10,50,0.01,1804,15
0.97,0.0001,943,961,10,50,0.01,1904,15
0.972,0.0001,995,1009,10,50,0.01,2004,15
0.53,0.0001,46,58,10,50,0.01,104,16
0.574,0.0001,96,108,10,50,0.01,204,16
0.6,0.0001,156,148,10,50,0.01,304,16
0.65,0.0001,203,201,10,50,0.01,404,16
0.634,0.0001,246,258,10,50,0.01,504,16
0.694,0.0001,299,305,10,50,0.01,604,16
0.762,0.0001,360,344,10,50,0.01,704,16
0.846,0.0001,412,392,10,50,0.01,804,16
0.858,0.0001,455,449,10,50,0.01,904,16
0.886,0.0001,507,497,10,50,0.01,1004,16
0.922,0.0001,559,545,10,50,0.01,1104,16
0.946,0.0001,603,601,10,50,0.01,1204,16
0.944,0.0001,655,649,10,50,0.01,1304,16
0.952,0.0001,701,703,10,50,0.01,1404,16
0.958,0.0001,748,756,10,50,0.01,1504,16
0.974,0.0001,792,812,10,50,0.01,1604,16
0.982,0.0001,841,863,10,50,0.01,1704,16
0.98,0.0001,894,910,10,50,0.01,1804,16
0.98,0.0001,936,968,10,50,0.01,1904,16
0.982,0.0001,992,1012,10,50,0.01,2004,16
0.548,0.0001,51,53,10,50,0.01,104,17
0.596,0.0001,101,103,10,50,0.01,204,17
0.62,0.0001,150,154,10,50,0.01,304,17
0.668,0.0001,200,204,10,50,0.01,404,17
0.702,0.0001,252,252,10,50,0.01,504,17
0.748,0.0001,310,294,10,50,0.01,604,17
0.822,0.0001,359,345,10,50,0.01,704,17
0.864,0.0001,407,397,10,50,0.01,804,17
0.892,0.0001,454,450,10,50,0.01,904,17
0.916,0.0001,502,502,10,50,0.01,1004,17
0.932,0.0001,547,557,10,50,0.01,1104,17
0.942,0.0001,593,611,10,50,0.01,1204,17
0.956,0.0001,640,664,10,50,0.01,1304,17
0.968,0.0001,694,710,10,50,0.01,1404,17
0.974,0.0001,745,759,10,50,0.01,1504,17
0.974,0.0001,796,808,10,50,0.01,1604,17
0.974,0.0001,842,862,10,50,0.01,1704,17
0.974,0.0001,890,914,10,50,0.01,1804,17
0.976,0.0001,935,969,10,50,0.01,1904,17
0.976,0.0001,987,1017,10,50,0.01,2004,17
0.47,0.0001,59,45,10,50,0.01,104,18
0.51,0.0001,121,83,10,50,0.01,204,18
0.62,0.0001,173,131,10,50,0.01,304,18
0.698,0.0001,228,176,10,50,0.01,404,18
0.744,0.0001,281,223,10,50,0.01,504,18
0.768,0.0001,327,277,10,50,0.01,604,18
0.796,0.0001,375,329,10,50,0.01,704,18
0.842,0.0001,421,383,10,50,0.01,804,18
0.89,0.0001,473,431,10,50,0.01,904,18
0.928,0.0001,520,484,10,50,0.01,1004,18
0.948,0.0001,573,531,10,50,0.01,1104,18
0.952,0.0001,619,585,10,50,0.01,1204,18
0.95,0.0001,674,630,10,50,0.01,1304,18
0.954,0.0001,722,682,10,50,0.01,1404,18
0.96,0.0001,770,734,10,50,0.01,1504,18
0.966,0.0001,821,783,10,50,0.01,1604,18
0.976,0.0001,877,827,10,50,0.01,1704,18
0.974,0.0001,921,883,10,50,0.01,1804,18
0.976,0.0001,963,941,10,50,0.01,1904,18
0.988,0.0001,1015,989,10,50,0.01,2004,18
0.506,0.0001,54,50,10,50,0.01,104,19
0.544,0.0001,105,99,10,50,0.01,204,19
0.59,0.0001,152,152,10,50,0.01,304,19
0.604,0.0001,204,200,10,50,0.01,404,19
0.65,0.0001,253,251,10,50,0.01,504,19
0.714,0.0001,300,304,10,50,0.01,604,19
0.762,0.0001,352,352,10,50,0.01,704,19
0.832,0.0001,402,402,10,50,0.01,804,19
0.872,0.0001,448,456,10,50,0.01,904,19
0.912,0.0001,499,505,10,50,0.01,1004,19
0.938,0.0001,554,550,10,50,0.01,1104,19
0.95,0.0001,598,606,10,50,0.01,1204,19
0.95,0.0001,640,664,10,50,0.01,1304,19
0.96,0.0001,698,706,10,50,0.01,1404,19
0.962,0.0001,751,753,10,50,0.01,1504,19
0.968,0.0001,804,800,10,50,0.01,1604,19
0.966,0.0001,855,849,10,50,0.01,1704,19
0.976,0.0001,907,897,10,50,0.01,1804,19
0.972,0.0001,961,943,10,50,0.01,1904,19
0.976,0.0001,1012,992,10,50,0.01,2004,19
0.548,0.0001,58,46,10,50,0.01,104,20
0.56,0.0001,106,98,10,50,0.01,204,20
0.566,0.0001,162,142,10,50,0.01,304,20
0.574,0.0001,207,197,10,50,0.01,404,20
0.612,0.0001,258,246,10,50,0.01,504,20
0.692,0.0001,304,300,10,50,0.01,604,20
0.762,0.0001,359,345,10,50,0.01,704,20
0.822,0.0001,409,395,10,50,0.01,804,20
0.868,0.0001,451,453,10,50,0.01,904,20
0.91,0.0001,502,502,10,50,0.01,1004,20
0.926,0.0001,546,558,10,50,0.01,1104,20
0.948,0.0001,597,607,10,50,0.01,1204,20
0.958,0.0001,649,655,10,50,0.01,1304,20
0.968,0.0001,697,707,10,50,0.01,1404,20
0.97,0.0001,751,753,10,50,0.01,1504,20
0.978,0.0001,807,797,10,50,0.01,1604,20
0.982,0.0001,857,847,10,50,0.01,1704,20
0.98,0.0001,907,897,10,50,0.01,1804,20
0.982,0.0001,954,950,10,50,0.01,1904,20
0.984,0.0001,1004,1000,10,50,0.01,2004,20
0.55,0.001,50,54,10,50,0.0001,104,1
0.55,0.001,97,107,10,50,0.0001,204,1
0.55,0.001,146,158,10,50,0.0001,304,1
0.55,0.001,194,210,10,50,0.0001,404,1
0.548,0.001,240,264,10,50,0.0001,504,1
0.546,0.001,293,311,10,50,0.0001,604,1
0.546,0.001,343,361,10,50,0.0001,704,1
0.546,0.001,396,408,10,50,0.0001,804,1
0.544,0.001,445,459,10,50,0.0001,904,1
0.544,0.001,498,506,10,50,0.0001,1004,1
0.544,0.001,545,559,10,50,0.0001,1104,1
0.55,0.001,597,607,10,50,0.0001,1204,1
0.558,0.001,641,663,10,50,0.0001,1304,1
0.556,0.001,695,709,10,50,0.0001,1404,1
0.558,0.001,750,754,10,50,0.0001,1504,1
0.558,0.001,801,803,10,50,0.0001,1604,1
0.56,0.001,848,856,10,50,0.0001,1704,1
0.564,0.001,895,909,10,50,0.0001,1804,1
0.564,0.001,949,955,10,50,0.0001,1904,1
0.566,0.001,999,1005,10,50,0.0001,2004,1
0.518,0.001,55,49,10,50,0.0001,104,2
0.52,0.001,95,109,10,50,0.0001,204,2
0.52,0.001,146,158,10,50,0.0001,304,2
0.526,0.001,200,204,10,50,0.0001,404,2
0.526,0.001,254,250,10,50,0.0001,504,2
0.526,0.001,306,298,10,50,0.0001,604,2
0.526,0.001,350,354,10,50,0.0001,704,2
0.528,0.001,403,401,10,50,0.0001,804,2
0.528,0.001,458,446,10,50,0.0001,904,2
0.526,0.001,509,495,10,50,0.0001,1004,2
0.528,0.001,568,536,10,50,0.0001,1104,2
0.532,0.001,618,586,10,50,0.0001,1204,2
0.534,0.001,667,637,10,50,0.0001,1304,2
0.534,0.001,717,687,10,50,0.0001,1404,2
0.538,0.001,767,737,10,50,0.0001,1504,2
0.542,0.001,823,781,10,50,0.0001,1604,2
0.544,0.001,877,827,10,50,0.0001,1704,2
0.546,0.001,924,880,10,50,0.0001,1804,2
0.544,0.001,984,920,10,50,0.0001,1904,2
0.546,0.001,1028,976,10,50,0.0001,2004,2
0.498,0.001,43,61,10,50,0.0001,104,3
0.498,0.001,103,101,10,50,0.0001,204,3
0.498,0.001,159,145,10,50,0.0001,304,3
0.498,0.001,207,197,10,50,0.0001,404,3
0.498,0.001,255,249,10,50,0.0001,504,3
0.496,0.001,311,293,10,50,0.0001,604,3
0.498,0.001,368,336,10,50,0.0001,704,3
0.498,0.001,417,387,10,50,0.0001,804,3
0.5,0.001,471,433,10,50,0.0001,904,3
0.498,0.001,506,498,10,50,0.0001,1004,3
0.496,0.001,555,549,10,50,0.0001,1104,3
0.498,0.001,603,601,10,50,0.0001,1204,3
0.502,0.001,652,652,10,50,0.0001,1304,3
0.5,0.001,705,699,10,50,0.0001,1404,3
0.5,0.001,755,749,10,50,0.0001,1504,3
0.504,0.001,805,799,10,50,0.0001,1604,3
0.504,0.001,860,844,10,50,0.0001,1704,3
0.504,0.001,913,891,10,50,0.0001,1804,3
0.506,0.001,964,940,10,50,0.0001,1904,3
0.506,0.001,1015,989,10,50,0.0001,2004,3
0.458,0.001,49,55,10,50,0.0001,104,4
0.458,0.001,93,111,10,50,0.0001,204,4
0.458,0.001,146,158,10,50,0.0001,304,4
0.458,0.001,191,213,10,50,0.0001,404,4
0.458,0.001,254,250,10,50,0.0001,504,4
0.456,0.001,306,298,10,50,0.0001,604,4
0.456,0.001,357,347,10,50,0.0001,704,4
0.456,0.001,406,398,10,50,0.0001,804,4
0.456,0.001,460,444,10,50,0.0001,904,4
0.456,0.001,505,499,10,50,0.0001,1004,4
0.454,0.001,563,541,10,50,0.0001,1104,4
0.454,0.001,611,593,10,50,0.0001,1204,4
0.458,0.001,657,647,10,50,0.0001,1304,4
0.458,0.001,710,694,10,50,0.0001,1404,4
0.456,0.001,758,746,10,50,0.0001,1504,4
0.456,0.001,808,796,10,50,0.0001,1604,4
0.454,0.001,861,843,10,50,0.0001,1704,4
0.452,0.001,915,889,10,50,0.0001,1804,4
0.452,0.001,969,935,10,50,0.0001,1904,4
0.454,0.001,1015,989,10,50,0.0001,2004,4
0.482,0.001,52,52,10,50,0.0001,104,5
0.48,0.001,108,96,10,50,0.0001,204,5
0.482,0.001,166,138,10,50,0.0001,304,5
0.482,0.001,210,194,10,50,0.0001,404,5
0.486,0.001,264,240,10,50,0.0001,504,5
0.486,0.001,307,297,10,50,0.0001,604,5
0.488,0.001,356,348,10,50,0.0001,704,5
0.49,0.001,408,396,10,50,0.0001,804,5
0.49,0.001,453,451,10,50,0.0001,904,5
0.496,0.001,498,506,10,50,0.0001,1004,5
0.502,0.001,539,565,10,50,0.0001,1104,5
0.504,0.001,597,607,10,50,0.0001,1204,5
0.504,0.001,644,660,10,50,0.0001,1304,5
0.506,0.001,696,708,10,50,0.0001,1404,5
0.51,0.001,748,756,10,50,0.0001,1504,5
0.508,0.001,791,813,10,50,0.0001,1604,5
0.51,0.001,841,863,10,50,0.0001,1704,5
0.516,0.001,890,914,10,50,0.0001,1804,5
0.516,0.001,943,961,10,50,0.0001,1904,5
0.518,0.001,993,1011,10,50,0.0001,2004,5
0.524,0.001,48,56,10,50,0.0001,104,6
0.524,0.001,110,94,10,50,0.0001,204,6
0.524,0.001,158,146,10,50,0.0001,304,6
0.524,0.001,203,201,10,50,0.0001,404,6
0.522,0.001,241,263,10,50,0.0001,504,6
0.522,0.001,285,319,10,50,0.0001,604,6
0.524,0.001,333,371,10,50,0.0001,704,6
0.526,0.001,382,422,10,50,0.0001,804,6
0.526,0.001,433,471,10,50,0.0001,904,6
0.53,0.001,481,523,10,50,0.0001,1004,6
0.532,0.001,530,574,10,50,0.0001,1104,6
0.534,0.001,572,632,10,50,0.0001,1204,6
0.536,0.001,616,688,10,50,0.0001,1304,6
0.538,0.001,673,731,10,50,0.0001,1404,6
0.538,0.001,718,786,10,50,0.0001,1504,6
0.54,0.001,767,837,10,50,0.0001,1604,6
0.544,0.001,822,882,10,50,0.0001,1704,6
0.546,0.001,886,918,10,50,0.0001,1804,6
0.546,0.001,938,966,10,50,0.0001,1904,6
0.548,0.001,990,1014,10,50,0.0001,2004,6
0.492,0.001,52,52,10,50,0.0001,104,7
0.49,0.001,103,101,10,50,0.0001,204,7
0.492,0.001,155,149,10,50,0.0001,304,7
0.492,0.001,208,196,10,50,0.0001,404,7
0.494,0.001,252,252,10,50,0.0001,504,7
0.496,0.001,292,312,10,50,0.0001,604,7
0.496,0.001,340,364,10,50,0.0001,704,7
0.496,0.001,389,415,10,50,0.0001,804,7
0.496,0.001,429,475,10,50,0.0001,904,7
0.496,0.001,475,529,10,50,0.0001,1004,7
0.496,0.001,526,578,10,50,0.0001,1104,7
0.494,0.001,573,631,10,50,0.0001,1204,7
0.496,0.001,629,675,10,50,0.0001,1304,7
0.496,0.001,684,720,10,50,0.0001,1404,7
0.504,0.001,740,764,10,50,0.0001,1504,7
0.508,0.001,784,820,10,50,0.0001,1604,7
0.506,0.001,840,864,10,50,0.0001,1704,7
0.506,0.001,894,910,10,50,0.0001,1804,7
0.51,0.001,945,959,10,50,0.0001,1904,7
0.51,0.001,1005,999,10,50,0.0001,2004,7
0.462,0.001,53,51,10,50,0.0001,104,8
0.462,0.001,98,106,10,50,0.0001,204,8
0.462,0.001,148,156,10,50,0.0001,304,8
0.462,0.001,199,205,10,50,0.0001,404,8
0.468,0.001,245,259,10,50,0.0001,504,8
0.466,0.001,296,308,10,50,0.0001,604,8
0.47,0.001,345,359,10,50,0.0001,704,8
0.472,0.001,396,408,10,50,0.0001,804,8
0.472,0.001,443,461,10,50,0.0001,904,8
0.474,0.001,499,505,10,50,0.0001,1004,8
0.474,0.001,548,556,10,50,0.0001,1104,8
0.474,0.001,596,608,10,50,0.0001,1204,8
0.472,0.001,644,660,10,50,0.0001,1304,8
0.472,0.001,695,709,10,50,0.0001,1404,8
0.478,0.001,748,756,10,50,0.0001,1504,8
0.476,0.001,808,796,10,50,0.0001,1604,8
0.478,0.001,856,848,10,50,0.0001,1704,8
0.482,0.001,903,901,10,50,0.0001,1804,8
0.484,0.001,952,952,10,50,0.0001,1904,8
0.488,0.001,1009,995,10,50,0.0001,2004,8
0.51,0.001,50,54,10,50,0.0001,104,9
0.51,0.001,110,94,10,50,0.0001,204,9
0.51,0.001,162,142,10,50,0.0001,304,9
0.51,0.001,219,185,10,50,0.0001,404,9
0.51,0.001,269,235,10,50,0.0001,504,9
0.51,0.001,324,280,10,50,0.0001,604,9
0.51,0.001,374,330,10,50,0.0001,704,9
0.51,0.001,426,378,10,50,0.0001,804,9
0.51,0.001,477,427,10,50,0.0001,904,9
0.512,0.001,524,480,10,50,0.0001,1004,9
0.512,0.001,579,525,10,50,0.0001,1104,9
0.512,0.001,635,569,10,50,0.0001,1204,9
0.514,0.001,677,627,10,50,0.0001,1304,9
0.514,0.001,730,674,10,50,0.0001,1404,9
0.514,0.001,770,734,10,50,0.0001,1504,9
0.514,0.001,819,785,10,50,0.0001,1604,9
0.514,0.001,858,846,10,50,0.0001,1704,9
0.514,0.001,906,898,10,50,0.0001,1804,9
0.514,0.001,950,954,10,50,0.0001,1904,9
0.518,0.001,1008,996,10,50,0.0001,2004,9
0.44,0.001,38,66,10,50,0.0001,104,10
0.44,0.001,93,111,10,50,0.0001,204,10
0.44,0.001,138,166,10,50,0.0001,304,10
0.44,0.001,193,211,10,50,0.0001,404,10
0.44,0.001,253,251,10,50,0.0001,504,10
0.44,0.001,305,299,10,50,0.0001,604,10
0.438,0.001,358,346,10,50,0.0001,704,10
0.434,0.001,410,394,10,50,0.0001,804,10
0.438,0.001,460,444,10,50,0.0001,904,10
0.44,0.001,509,495,10,50,0.0001,1004,10
0.438,0.001,555,549,10,50,0.0001,1104,10
0.434,0.001,605,599,10,50,0.0001,1204,10
0.432,0.001,651,653,10,50,0.0001,1304,10
0.43,0.001,703,701,10,50,0.0001,1404,10
0.432,0.001,757,747,10,50,0.0001,1504,10
0.426,0.001,803,801,10,50,0.0001,1604,10
0.426,0.001,852,852,10,50,0.0001,1704,10
0.424,0.001,903,901,10,50,0.0001,1804,10
0.424,0.001,953,951,10,50,0.0001,1904,10
0.424,0.001,1002,1002,10,50,0.0001,2004,10
0.504,0.001,54,50,10,50,0.0001,104,11
0.502,0.001,103,101,10,50,0.0001,204,11
0.502,0.001,152,152,10,50,0.0001,304,11
0.504,0.001,198,206,10,50,0.0001,404,11
0.506,0.001,241,263,10,50,0.0001,504,11
0.502,0.001,289,315,10,50,0.0001,604,11
0.502,0.001,346,358,10,50,0.0001,704,11
0.506,0.001,400,404,10,50,0.0001,804,11
0.51,0.001,459,445,10,50,0.0001,904,11
0.51,0.001,514,490,10,50,0.0001,1004,11
0.512,0.001,562,542,10,50,0.0001,1104,11
0.514,0.001,617,587,10,50,0.0001,1204,11
0.512,0.001,656,648,10,50,0.0001,1304,11
0.518,0.001,704,700,10,50,0.0001,1404,11
0.518,0.001,754,750,10,50,0.0001,1504,11
0.516,0.001,809,795,10,50,0.0001,1604,11
0.516,0.001,855,849,10,50,0.0001,1704,11
0.522,0.001,903,901,10,50,0.0001,1804,11
0.52,0.001,947,957,10,50,0.0001,1904,11
0.522,0.001,1005,999,10,50,0.0001,2004,11
0.492,0.001,53,51,10,50,0.0001,104,12
0.492,0.001,107,97,10,50,0.0001,204,12
0.492,0.001,156,148,10,50,0.0001,304,12
0.494,0.001,214,190,10,50,0.0001,404,12
0.494,0.001,269,235,10,50,0.0001,504,12
0.494,0.001,314,290,10,50,0.0001,604,12
0.494,0.001,354,350,10,50,0.0001,704,12
0.494,0.001,400,404,10,50,0.0001,804,12
0.494,0.001,444,460,10,50,0.0001,904,12
0.494,0.001,500,504,10,50,0.0001,1004,12
0.494,0.001,551,553,10,50,0.0001,1104,12
0.494,0.001,610,594,10,50,0.0001,1204,12
0.494,0.001,659,645,10,50,0.0001,1304,12
0.494,0.001,710,694,10,50,0.0001,1404,12
0.494,0.001,763,741,10,50,0.0001,1504,12
0.496,0.001,816,788,10,50,0.0001,1604,12
0.496,0.001,854,850,10,50,0.0001,1704,12
0.5,0.001,902,902,10,50,0.0001,1804,12
0.5,0.001,947,957,10,50,0.0001,1904,12
0.5,0.001,993,1011,10,50,0.0001,2004,12
0.456,0.001,52,52,10,50,0.0001,104,13
0.456,0.001,97,107,10,50,0.0001,204,13
0.458,0.001,141,163,10,50,0.0001,304,13
0.458,0.001,189,215,10,50,0.0001,404,13
0.456,0.001,239,265,10,50,0.0001,504,13
0.456,0.001,287,317,10,50,0.0001,604,13
0.458,0.001,333,371,10,50,0.0001,704,13
0.458,0.001,388,416,10,50,0.0001,804,13
0.46,0.001,440,464,10,50,0.0001,904,13
0.462,0.001,490,514,10,50,0.0001,1004,13
0.462,0.001,541,563,10,50,0.0001,1104,13
0.464,0.001,598,606,10,50,0.0001,1204,13
0.466,0.001,637,667,10,50,0.0001,1304,13
0.468,0.001,686,718,10,50,0.0001,1404,13
0.47,0.001,739,765,10,50,0.0001,1504,13
0.47,0.001,795,809,10,50,0.0001,1604,13
0.472,0.001,841,863,10,50,0.0001,1704,13
0.472,0.001,887,917,10,50,0.0001,1804,13
0.472,0.001,937,967,10,50,0.0001,1904,13
0.476,0.001,981,1023,10,50,0.0001,2004,13
0.478,0.001,51,53,10,50,0.0001,104,14
0.478,0.001,103,101,10,50,0.0001,204,14
0.478,0.001,150,154,10,50,0.0001,304,14
0.478,0.001,198,206,10,50,0.0001,404,14
0.48,0.001,254,250,10,50,0.0001,504,14
0.48,0.001,314,290,10,50,0.0001,604,14
0.48,0.001,361,343,10,50,0.0001,704,14
0.482,0.001,408,396,10,50,0.0001,804,14
0.482,0.001,453,451,10,50,0.0001,904,14
0.482,0.001,497,507,10,50,0.0001,1004,14
0.486,0.001,547,557,10,50,0.0001,1104,14
0.486,0.001,595,609,10,50,0.0001,1204,14
0.49,0.001,652,652,10,50,0.0001,1304,14
0.49,0.001,707,697,10,50,0.0001,1404,14
0.494,0.001,755,749,10,50,0.0001,1504,14
0.498,0.001,804,800,10,50,0.0001,1604,14
0.496,0.001,846,858,10,50,0.0001,1704,14
0.496,0.001,897,907,10,50,0.0001,1804,14
0.496,0.001,943,961,10,50,0.0001,1904,14
0.496,0.001,986,1018,10,50,0.0001,2004,14
0.484,0.001,51,53,10,50,0.0001,104,15
0.484,0.001,99,105,10,50,0.0001,204,15
0.484,0.001,145,159,10,50,0.0001,304,15
0.484,0.001,197,207,10,50,0.0001,404,15
0.484,0.001,247,257,10,50,0.0001,504,15
0.486,0.001,303,301,10,50,0.0001,604,15
0.488,0.001,347,357,10,50,0.0001,704,15
0.486,0.001,399,405,10,50,0.0001,804,15
0.486,0.001,446,458,10,50,0.0001,904,15
0.486,0.001,495,509,10,50,0.0001,1004,15
0.486,0.001,539,565,10,50,0.0001,1104,15
0.488,0.001,586,618,10,50,0.0001,1204,15
0.49,0.001,648,656,10,50,0.0001,1304,15
0.488,0.001,695,709,10,50,0.0001,1404,15
0.49,0.001,736,768,10,50,0.0001,1504,15
0.488,0.001,786,818,10,50,0.0001,1604,15
0.488,0.001,842,862,10,50,0.0001,1704,15
0.484,0.001,894,910,10,50,0.0001,1804,15
0.482,0.001,953,951,10,50,0.0001,1904,15
0.482,0.001,1006,998,10,50,0.0001,2004,15
0.508,0.001,46,58,10,50,0.0001,104,16
0.51,0.001,96,108,10,50,0.0001,204,16
0.51,0.001,144,160,10,50,0.0001,304,16
0.506,0.001,191,213,10,50,0.0001,404,16
0.504,0.001,239,265,10,50,0.0001,504,16
0.504,0.001,282,322,10,50,0.0001,604,16
0.504,0.001,327,377,10,50,0.0001,704,16
0.504,0.001,371,433,10,50,0.0001,804,16
0.506,0.001,430,474,10,50,0.0001,904,16
0.51,0.001,472,532,10,50,0.0001,1004,16
0.512,0.001,524,580,10,50,0.0001,1104,16
0.514,0.001,586,618,10,50,0.0001,1204,16
0.518,0.001,639,665,10,50,0.0001,1304,16
0.524,0.001,690,714,10,50,0.0001,1404,16
0.528,0.001,746,758,10,50,0.0001,1504,16
0.53,0.001,799,805,10,50,0.0001,1604,16
0.534,0.001,848,856,10,50,0.0001,1704,16
0.54,0.001,889,915,10,50,0.0001,1804,16
0.55,0.001,942,962,10,50,0.0001,1904,16
0.564,0.001,997,1007,10,50,0.0001,2004,16
0.536,0.001,45,59,10,50,0.0001,104,17
0.54,0.001,93,111,10,50,0.0001,204,17
0.54,0.001,146,158,10,50,0.0001,304,17
0.538,0.001,199,205,10,50,0.0001,404,17
0.538,0.001,253,251,10,50,0.0001,504,17
0.544,0.001,307,297,10,50,0.0001,604,17
0.544,0.001,346,358,10,50,0.0001,704,17
0.542,0.001,403,401,10,50,0.0001,804,17
0.542,0.001,450,454,10,50,0.0001,904,17
0.546,0.001,504,500,10,50,0.0001,1004,17
0.552,0.001,560,544,10,50,0.0001,1104,17
0.552,0.001,605,599,10,50,0.0001,1204,17
0.554,0.001,655,649,10,50,0.0001,1304,17
0.554,0.001,701,703,10,50,0.0001,1404,17
0.558,0.001,760,744,10,50,0.0001,1504,17
0.562,0.001,806,798,10,50,0.0001,1604,17
0.562,0.001,854,850,10,50,0.0001,1704,17
0.568,0.001,903,901,10,50,0.0001,1804,17
0.566,0.001,961,943,10,50,0.0001,1904,17
0.568,0.001,1012,992,10,50,0.0001,2004,17
0.536,0.001,55,49,10,50,0.0001,104,18
0.538,0.001,106,98,10,50,0.0001,204,18
0.538,0.001,155,149,10,50,0.0001,304,18
0.538,0.001,205,199,10,50,0.0001,404,18
0.54,0.001,259,245,10,50,0.0001,504,18
0.542,0.001,309,295,10,50,0.0001,604,18
0.542,0.001,353,351,10,50,0.0001,704,18
0.544,0.001,406,398,10,50,0.0001,804,18
0.544,0.001,460,444,10,50,0.0001,904,18
0.542,0.001,510,494,10,50,0.0001,1004,18
0.546,0.001,556,548,10,50,0.0001,1104,18
0.544,0.001,605,599,10,50,0.0001,1204,18
0.548,0.001,650,654,10,50,0.0001,1304,18
0.554,0.001,701,703,10,50,0.0001,1404,18
0.554,0.001,754,750,10,50,0.0001,1504,18
0.554,0.001,805,799,10,50,0.0001,1604,18
0.556,0.001,859,845,10,50,0.0001,1704,18
0.556,0.001,914,890,10,50,0.0001,1804,18
0.556,0.001,963,941,10,50,0.0001,1904,18
0.558,0.001,1009,995,10,50,0.0001,2004,18
0.572,0.001,54,50,10,50,0.0001,104,19
0.572,0.001,111,93,10,50,0.0001,204,19
0.572,0.001,162,142,10,50,0.0001,304,19
0.572,0.001,210,194,10,50,0.0001,404,19
0.572,0.001,262,242,10,50,0.0001,504,19
0.572,0.001,311,293,10,50,0.0001,604,19
0.576,0.001,369,335,10,50,0.0001,704,19
0.578,0.001,417,387,10,50,0.0001,804,19
0.578,0.001,461,443,10,50,0.0001,904,19
0.578,0.001,505,499,10,50,0.0001,1004,19
0.582,0.001,551,553,10,50,0.0001,1104,19
0.586,0.001,596,608,10,50,0.0001,1204,19
0.584,0.001,647,657,10,50,0.0001,1304,19
0.59,0.001,696,708,10,50,0.0001,1404,19
0.594,0.001,752,752,10,50,0.0001,1504,19
0.594,0.001,808,796,10,50,0.0001,1604,19
0.594,0.001,851,853,10,50,0.0001,1704,19
0.598,0.001,898,906,10,50,0.0001,1804,19
0.602,0.001,946,958,10,50,0.0001,1904,19
0.606,0.001,1001,1003,10,50,0.0001,2004,19
0.46,0.001,50,54,10,50,0.0001,104,20
0.46,0.001,103,101,10,50,0.0001,204,20
0.46,0.001,158,146,10,50,0.0001,304,20
0.456,0.001,215,189,10,50,0.0001,404,20
0.456,0.001,264,240,10,50,0.0001,504,20
0.454,0.001,318,286,10,50,0.0001,604,20
0.45,0.001,358,346,10,50,0.0001,704,20
0.45,0.001,402,402,10,50,0.0001,804,20
0.45,0.001,447,457,10,50,0.0001,904,20
0.45,0.001,490,514,10,50,0.0001,1004,20
0.448,0.001,541,563,10,50,0.0001,1104,20
0.45,0.001,590,614,10,50,0.0001,1204,20
0.448,0.001,647,657,10,50,0.0001,1304,20
0.45,0.001,697,707,10,50,0.0001,1404,20
0.45,0.001,759,745,10,50,0.0001,1504,20
0.448,0.001,807,797,10,50,0.0001,1604,20
0.448,0.001,856,848,10,50,0.0001,1704,20
0.45,0.001,912,892,10,50,0.0001,1804,20
0.45,0.001,962,942,10,50,0.0001,1904,20
0.45,0.001,1012,992,10,50,0.0001,2004,20
0.444,0.001,56,48,10,50,0.001,104,1
0.448,0.001,102,102,10,50,0.001,204,1
0.464,0.001,159,145,10,50,0.001,304,1
0.476,0.001,207,197,10,50,0.001,404,1
0.478,0.001,260,244,10,50,0.001,504,1
0.492,0.001,318,286,10,50,0.001,604,1
0.5,0.001,362,342,10,50,0.001,704,1
0.524,0.001,409,395,10,50,0.001,804,1
0.54,0.001,462,442,10,50,0.001,904,1
0.562,0.001,515,489,10,50,0.001,1004,1
0.59,0.001,567,537,10,50,0.001,1104,1
0.642,0.001,620,584,10,50,0.001,1204,1
0.656,0.001,684,620,10,50,0.001,1304,1
0.678,0.001,732,672,10,50,0.001,1404,1
0.714,0.001,774,730,10,50,0.001,1504,1
0.734,0.001,828,776,10,50,0.001,1604,1
0.754,0.001,880,824,10,50,0.001,1704,1
0.774,0.001,929,875,10,50,0.001,1804,1
0.812,0.001,975,929,10,50,0.001,1904,1
0.834,0.001,1022,982,10,50,0.001,2004,1
0.488,0.001,55,49,10,50,0.001,104,2
0.482,0.001,98,106,10,50,0.001,204,2
0.478,0.001,150,154,10,50,0.001,304,2
0.476,0.001,204,200,10,50,0.001,404,2
0.482,0.001,250,254,10,50,0.001,504,2
0.492,0.001,301,303,10,50,0.001,604,2
0.494,0.001,350,354,10,50,0.001,704,2
0.504,0.001,407,397,10,50,0.001,804,2
0.52,0.001,458,446,10,50,0.001,904,2
0.552,0.001,511,493,10,50,0.001,1004,2
0.572,0.001,555,549,10,50,0.001,1104,2
0.606,0.001,605,599,10,50,0.001,1204,2
0.644,0.001,655,649,10,50,0.001,1304,2
0.654,0.001,705,699,10,50,0.001,1404,2
0.674,0.001,756,748,10,50,0.001,1504,2
0.692,0.001,801,803,10,50,0.001,1604,2
0.71,0.001,856,848,10,50,0.001,1704,2
0.742,0.001,904,900,10,50,0.001,1804,2
0.776,0.001,947,957,10,50,0.001,1904,2
0.81,0.001,1003,1001,10,50,0.001,2004,2
0.512,0.001,64,40,10,50,0.001,104,3
0.512,0.001,109,95,10,50,0.001,204,3
0.516,0.001,160,144,10,50,0.001,304,3
0.518,0.001,212,192,10,50,0.001,404,3
0.526,0.001,258,246,10,50,0.001,504,3
0.53,0.001,309,295,10,50,0.001,604,3
0.526,0.001,361,343,10,50,0.001,704,3
0.53,0.001,405,399,10,50,0.001,804,3
0.554,0.001,449,455,10,50,0.001,904,3
0.58,0.001,496,508,10,50,0.001,1004,3
0.584,0.001,554,550,10,50,0.001,1104,3
0.598,0.001,606,598,10,50,0.001,1204,3
0.62,0.001,655,649,10,50,0.001,1304,3
0.65,0.001,706,698,10,50,0.001,1404,3
0.674,0.001,753,751,10,50,0.001,1504,3
0.724,0.001,799,805,10,50,0.001,1604,3
0.748,0.001,851,853,10,50,0.001,1704,3
0.77,0.001,907,897,10,50,0.001,1804,3
0.796,0.001,948,956,10,50,0.001,1904,3
0.81,0.001,1002,1002,10,50,0.001,2004,3
0.466,0.001,56,48,10,50,0.001,104,4
0.466,0.001,110,94,10,50,0.001,204,4
0.484,0.001,155,149,10,50,0.001,304,4
0.492,0.001,216,188,10,50,0.001,404,4
0.504,0.001,268,236,10,50,0.001,504,4
0.518,0.001,310,294,10,50,0.001,604,4
0.522,0.001,364,340,10,50,0.001,704,4
0.53,0.001,415,389,10,50,0.001,804,4
0.55,0.001,462,442,10,50,0.001,904,4
0.566,0.001,515,489,10,50,0.001,1004,4
0.602,0.001,566,538,10,50,0.001,1104,4
0.62,0.001,615,589,10,50,0.001,1204,4
0.634,0.001,672,632,10,50,0.001,1304,4
0.646,0.001,722,682,10,50,0.001,1404,4
0.664,0.001,778,726,10,50,0.001,1504,4
0.696,0.001,817,787,10,50,0.001,1604,4
0.732,0.001,863,841,10,50,0.001,1704,4
0.758,0.001,921,883,10,50,0.001,1804,4
0.764,0.001,962,942,10,50,0.001,1904,4
0.782,0.001,1010,994,10,50,0.001,2004,4
0.506,0.001,56,48,10,50,0.001,104,5
0.512,0.001,107,97,10,50,0.001,204,5
0.516,0.001,159,145,10,50,0.001,304,5
0.524,0.001,215,189,10,50,0.001,404,5
0.532,0.001,265,239,10,50,0.001,504,5
0.546,0.001,308,296,10,50,0.001,604,5
0.57,0.001,361,343,10,50,0.001,704,5
0.59,0.001,409,395,10,50,0.001,804,5
0.6,0.001,465,439,10,50,0.001,904,5
0.61,0.001,515,489,10,50,0.001,1004,5
0.634,0.001,564,540,10,50,0.001,1104,5
0.672,0.001,615,589,10,50,0.001,1204,5
0.71,0.001,667,637,10,50,0.001,1304,5
0.734,0.001,717,687,10,50,0.001,1404,5
0.752,0.001,758,746,10,50,0.001,1504,5
0.772,0.001,808,796,10,50,0.001,1604,5
0.794,0.001,856,848,10,50,0.001,1704,5
0.808,0.001,908,896,10,50,0.001,1804,5
0.824,0.001,951,953,10,50,0.001,1904,5
0.852,0.001,1001,1003,10,50,0.001,2004,5
0.534,0.001,49,55,10,50,0.001,104,6
0.534,0.001,105,99,10,50,0.001,204,6
0.534,0.001,155,149,10,50,0.001,304,6
0.534,0.001,203,201,10,50,0.001,404,6
0.538,0.001,252,252,10,50,0.001,504,6
0.536,0.001,302,302,10,50,0.001,604,6
0.536,0.001,354,350,10,50,0.001,704,6
0.528,0.001,413,391,10,50,0.001,804,6
0.53,0.001,460,444,10,50,0.001,904,6
0.542,0.001,516,488,10,50,0.001,1004,6
0.546,0.001,562,542,10,50,0.001,1104,6
0.57,0.001,616,588,10,50,0.001,1204,6
0.6,0.001,673,631,10,50,0.001,1304,6
0.624,0.001,726,678,10,50,0.001,1404,6
0.654,0.001,769,735,10,50,0.001,1504,6
0.676,0.001,813,791,10,50,0.001,1604,6
0.694,0.001,857,847,10,50,0.001,1704,6
0.718,0.001,910,894,10,50,0.001,1804,6
0.736,0.001,962,942,10,50,0.001,1904,6
0.766,0.001,1013,991,10,50,0.001,2004,6
0.554,0.001,52,52,10,50,0.001,104,7
0.566,0.001,99,105,10,50,0.001,204,7
0.574,0.001,149,155,10,50,0.001,304,7
0.568,0.001,194,210,10,50,0.001,404,7
0.576,0.001,235,269,10,50,0.001,504,7
0.59,0.001,292,312,10,50,0.001,604,7
0.598,0.001,341,363,10,50,0.001,704,7
0.604,0.001,393,411,10,50,0.001,804,7
0.6,0.001,447,457,10,50,0.001,904,7
0.614,0.001,497,507,10,50,0.001,1004,7
0.632,0.001,549,555,10,50,0.001,1104,7
0.644,0.001,593,611,10,50,0.001,1204,7
0.662,0.001,648,656,10,50,0.001,1304,7
0.682,0.001,693,711,10,50,0.001,1404,7
0.718,0.001,744,760,10,50,0.001,1504,7
0.73,0.001,794,810,10,50,0.001,1604,7
0.738,0.001,850,854,10,50,0.001,1704,7
0.776,0.001,895,909,10,50,0.001,1804,7
0.784,0.001,936,968,10,50,0.001,1904,7
0.816,0.001,982,1022,10,50,0.001,2004,7
0.516,0.001,55,49,10,50,0.001,104,8
0.514,0.001,98,106,10,50,0.001,204,8
0.516,0.001,150,154,10,50,0.001,304,8
0.516,0.001,199,205,10,50,0.001,404,8
0.512,0.001,248,256,10,50,0.001,504,8
0.524,0.001,294,310,10,50,0.001,604,8
0.528,0.001,344,360,10,50,0.001,704,8
0.534,0.001,395,409,10,50,0.001,804,8
0.546,0.001,440,464,10,50,0.001,904,8
0.564,0.001,494,510,10,50,0.001,1004,8
0.578,0.001,545,559,10,50,0.001,1104,8
0.59,0.001,591,613,10,50,0.001,1204,8
0.606,0.001,642,662,10,50,0.001,1304,8
0.644,0.001,688,716,10,50,0.001,1404,8
0.666,0.001,736,768,10,50,0.001,1504,8
0.706,0.001,790,814,10,50,0.001,1604,8
0.72,0.001,844,860,10,50,0.001,1704,8
0.744,0.001,895,909,10,50,0.001,1804,8
0.776,0.001,947,957,10,50,0.001,1904,8
0.8,0.001,988,1016,10,50,0.001,2004,8
0.476,0.001,54,50,10,50,0.001,104,9
0.476,0.001,105,99,10,50,0.001,204,9
0.484,0.001,150,154,10,50,0.001,304,9
0.488,0.001,195,209,10,50,0.001,404,9
0.496,0.001,251,253,10,50,0.001,504,9
0.514,0.001,308,296,10,50,0.001,604,9
0.514,0.001,352,352,10,50,0.001,704,9
0.53,0.001,399,405,10,50,0.001,804,9
0.542,0.001,452,452,10,50,0.001,904,9
0.564,0.001,499,505,10,50,0.001,1004,9
0.568,0.001,549,555,10,50,0.001,1104,9
0.586,0.001,596,608,10,50,0.001,1204,9
0.62,0.001,652,652,10,50,0.001,1304,9
0.646,0.001,702,702,10,50,0.001,1404,9
0.67,0.001,754,750,10,50,0.001,1504,9
0.692,0.001,811,793,10,50,0.001,1604,9
0.712,0.001,857,847,10,50,0.001,1704,9
0.734,0.001,913,891,10,50,0.001,1804,9
0.77,0.001,966,938,10,50,0.001,1904,9
0.788,0.001,1021,983,10,50,0.001,2004,9
0.528,0.001,55,49,10,50,0.001,104,10
0.516,0.001,101,103,10,50,0.001,204,10
0.526,0.001,148,156,10,50,0.001,304,10
0.532,0.001,192,212,10,50,0.001,404,10
0.54,0.001,237,267,10,50,0.001,504,10
0.552,0.001,296,308,10,50,0.001,604,10
0.564,0.001,343,361,10,50,0.001,704,10
0.58,0.001,394,410,10,50,0.001,804,10
0.594,0.001,448,456,10,50,0.001,904,10
0.612,0.001,509,495,10,50,0.001,1004,10
0.618,0.001,561,543,10,50,0.001,1104,10
0.626,0.001,607,597,10,50,0.001,1204,10
0.63,0.001,659,645,10,50,0.001,1304,10
0.65,0.001,709,695,10,50,0.001,1404,10
0.668,0.001,768,736,10,50,0.001,1504,10
0.682,0.001,817,787,10,50,0.001,1604,10
0.69,0.001,860,844,10,50,0.001,1704,10
0.716,0.001,907,897,10,50,0.001,1804,10
0.728,0.001,953,951,10,50,0.001,1904,10
0.744,0.001,999,1005,10,50,0.001,2004,10
0.492,0.001,50,54,10,50,0.001,104,11
0.482,0.001,101,103,10,50,0.001,204,11
0.486,0.001,156,148,10,50,0.001,304,11
0.49,0.001,205,199,10,50,0.001,404,11
0.492,0.001,256,248,10,50,0.001,504,11
0.504,0.001,313,291,10,50,0.001,604,11
0.51,0.001,364,340,10,50,0.001,704,11
0.51,0.001,414,390,10,50,0.001,804,11
0.53,0.001,465,439,10,50,0.001,904,11
0.546,0.001,519,485,10,50,0.001,1004,11
0.572,0.001,567,537,10,50,0.001,1104,11
0.606,0.001,617,587,10,50,0.001,1204,11
0.618,0.001,673,631,10,50,0.001,1304,11
0.642,0.001,728,676,10,50,0.001,1404,11
0.66,0.001,776,728,10,50,0.001,1504,11
0.68,0.001,828,776,10,50,0.001,1604,11
0.698,0.001,871,833,10,50,0.001,1704,11
0.724,0.001,921,883,10,50,0.001,1804,11
0.74,0.001,966,938,10,50,0.001,1904,11
0.762,0.001,1015,989,10,50,0.001,2004,11
0.474,0.001,53,51,10,50,0.001,104,12
0.482,0.001,103,101,10,50,0.001,204,12
0.476,0.001,151,153,10,50,0.001,304,12
0.478,0.001,204,200,10,50,0.001,404,12
0.48,0.001,253,251,10,50,0.001,504,12
0.496,0.001,301,303,10,50,0.001,604,12
0.51,0.001,344,360,10,50,0.001,704,12
0.528,0.001,402,402,10,50,0.001,804,12
0.55,0.001,450,454,10,50,0.001,904,12
0.56,0.001,502,502,10,50,0.001,1004,12
0.568,0.001,557,547,10,50,0.001,1104,12
0.584,0.001,611,593,10,50,0.001,1204,12
0.604,0.001,663,641,10,50,0.001,1304,12
0.636,0.001,706,698,10,50,0.001,1404,12
0.65,0.001,758,746,10,50,0.001,1504,12
0.662,0.001,813,791,10,50,0.001,1604,12
0.688,0.001,862,842,10,50,0.001,1704,12
0.728,0.001,911,893,10,50,0.001,1804,12
0.734,0.001,958,946,10,50,0.001,1904,12
0.754,0.001,1005,999,10,50,0.001,2004,12
0.512,0.001,51,53,10,50,0.001,104,13
0.514,0.001,99,105,10,50,0.001,204,13
0.52,0.001,154,150,10,50,0.001,304,13
0.524,0.001,202,202,10,50,0.001,404,13
0.524,0.001,245,259,10,50,0.001,504,13
0.53,0.001,292,312,10,50,0.001,604,13
0.536,0.001,337,367,10,50,0.001,704,13
0.538,0.001,388,416,10,50,0.001,804,13
0.548,0.001,448,456,10,50,0.001,904,13
0.564,0.001,498,506,10,50,0.001,1004,13
0.584,0.001,548,556,10,50,0.001,1104,13
0.612,0.001,604,600,10,50,0.001,1204,13
0.636,0.001,647,657,10,50,0.001,1304,13
0.684,0.001,693,711,10,50,0.001,1404,13
0.72,0.001,743,761,10,50,0.001,1504,13
0.742,0.001,793,811,10,50,0.001,1604,13
0.768,0.001,845,859,10,50,0.001,1704,13
0.788,0.001,900,904,10,50,0.001,1804,13
0.804,0.001,946,958,10,50,0.001,1904,13
0.812,0.001,999,1005,10,50,0.001,2004,13
0.514,0.001,51,53,10,50,0.001,104,14
0.516,0.001,98,106,10,50,0.001,204,14
0.52,0.001,149,155,10,50,0.001,304,14
0.538,0.001,200,204,10,50,0.001,404,14
0.552,0.001,249,255,10,50,0.001,504,14
0.564,0.001,312,292,10,50,0.001,604,14
0.572,0.001,358,346,10,50,0.001,704,14
0.59,0.001,413,391,10,50,0.001,804,14
0.604,0.001,464,440,10,50,0.001,904,14
0.618,0.001,509,495,10,50,0.001,1004,14
0.628,0.001,557,547,10,50,0.001,1104,14
0.64,0.001,602,602,10,50,0.001,1204,14
0.668,0.001,655,649,10,50,0.001,1304,14
0.696,0.001,716,688,10,50,0.001,1404,14
0.698,0.001,761,743,10,50,0.001,1504,14
0.706,0.001,811,793,10,50,0.001,1604,14
0.716,0.001,850,854,10,50,0.001,1704,14
0.738,0.001,909,895,10,50,0.001,1804,14
0.748,0.001,957,947,10,50,0.001,1904,14
0.78,0.001,1009,995,10,50,0.001,2004,14
0.43,0.001,57,47,10,50,0.001,104,15
0.426,0.001,107,97,10,50,0.001,204,15
0.422,0.001,158,146,10,50,0.001,304,15
0.418,0.001,204,200,10,50,0.001,404,15
0.418,0.001,260,244,10,50,0.001,504,15
0.418,0.001,309,295,10,50,0.001,604,15
0.414,0.001,367,337,10,50,0.001,704,15
0.428,0.001,414,390,10,50,0.001,804,15
0.428,0.001,460,444,10,50,0.001,904,15
0.442,0.001,507,497,10,50,0.001,1004,15
0.458,0.001,564,540,10,50,0.001,1104,15
0.48,0.001,618,586,10,50,0.001,1204,15
0.516,0.001,674,630,10,50,0.001,1304,15
0.568,0.001,726,678,10,50,0.001,1404,15
0.584,0.001,776,728,10,50,0.001,1504,15
0.622,0.001,819,785,10,50,0.001,1604,15
0.646,0.001,871,833,10,50,0.001,1704,15
0.684,0.001,918,886,10,50,0.001,1804,15
0.714,0.001,963,941,10,50,0.001,1904,15
0.742,0.001,1007,997,10,50,0.001,2004,15
0.53,0.001,47,57,10,50,0.001,104,16
0.538,0.001,94,110,10,50,0.001,204,16
0.536,0.001,145,159,10,50,0.001,304,16
0.536,0.001,197,207,10,50,0.001,404,16
0.544,0.001,248,256,10,50,0.001,504,16
0.562,0.001,299,305,10,50,0.001,604,16
0.564,0.001,350,354,10,50,0.001,704,16
0.59,0.001,395,409,10,50,0.001,804,16
0.608,0.001,442,462,10,50,0.001,904,16
0.626,0.001,497,507,10,50,0.001,1004,16
0.638,0.001,550,554,10,50,0.001,1104,16
0.654,0.001,598,606,10,50,0.001,1204,16
0.674,0.001,641,663,10,50,0.001,1304,16
0.686,0.001,691,713,10,50,0.001,1404,16
0.714,0.001,736,768,10,50,0.001,1504,16
0.714,0.001,780,824,10,50,0.001,1604,16
0.724,0.001,838,866,10,50,0.001,1704,16
0.746,0.001,890,914,10,50,0.001,1804,16
0.742,0.001,941,963,10,50,0.001,1904,16
0.774,0.001,992,1012,10,50,0.001,2004,16
0.528,0.001,54,50,10,50,0.001,104,17
0.532,0.001,112,92,10,50,0.001,204,17
0.534,0.001,167,137,10,50,0.001,304,17
0.542,0.001,214,190,10,50,0.001,404,17
0.552,0.001,260,244,10,50,0.001,504,17
0.56,0.001,310,294,10,50,0.001,604,17
0.582,0.001,352,352,10,50,0.001,704,17
0.592,0.001,402,402,10,50,0.001,804,17
0.61,0.001,463,441,10,50,0.001,904,17
0.64,0.001,514,490,10,50,0.001,1004,17
0.65,0.001,556,548,10,50,0.001,1104,17
0.664,0.001,604,600,10,50,0.001,1204,17
0.684,0.001,652,652,10,50,0.001,1304,17
0.702,0.001,708,696,10,50,0.001,1404,17
0.718,0.001,754,750,10,50,0.001,1504,17
0.756,0.001,800,804,10,50,0.001,1604,17
0.766,0.001,858,846,10,50,0.001,1704,17
0.79,0.001,915,889,10,50,0.001,1804,17
0.804,0.001,959,945,10,50,0.001,1904,17
0.826,0.001,1009,995,10,50,0.001,2004,17
0.532,0.001,52,52,10,50,0.001,104,18
0.532,0.001,101,103,10,50,0.001,204,18
0.528,0.001,146,158,10,50,0.001,304,18
0.54,0.001,185,219,10,50,0.001,404,18
0.556,0.001,232,272,10,50,0.001,504,18
0.562,0.001,283,321,10,50,0.001,604,18
0.568,0.001,330,374,10,50,0.001,704,18
0.572,0.001,380,424,10,50,0.001,804,18
0.588,0.001,439,465,10,50,0.001,904,18
0.616,0.001,487,517,10,50,0.001,1004,18
0.63,0.001,531,573,10,50,0.001,1104,18
0.638,0.001,593,611,10,50,0.001,1204,18
0.646,0.001,653,651,10,50,0.001,1304,18
0.672,0.001,704,700,10,50,0.001,1404,18
0.696,0.001,751,753,10,50,0.001,1504,18
0.724,0.001,801,803,10,50,0.001,1604,18
0.74,0.001,845,859,10,50,0.001,1704,18
0.752,0.001,902,902,10,50,0.001,1804,18
0.768,0.001,951,953,10,50,0.001,1904,18
0.788,0.001,1003,1001,10,50,0.001,2004,18
0.488,0.001,65,39,10,50,0.001,104,19
0.49,0.001,110,94,10,50,0.001,204,19
0.49,0.001,160,144,10,50,0.001,304,19
0.492,0.001,209,195,10,50,0.001,404,19
0.488,0.001,264,240,10,50,0.001,504,19
0.486,0.001,308,296,10,50,0.001,604,19
0.492,0.001,364,340,10,50,0.001,704,19
0.496,0.001,413,391,10,50,0.001,804,19
0.506,0.001,462,442,10,50,0.001,904,19
0.512,0.001,514,490,10,50,0.001,1004,19
0.5,0.001,558,546,10,50,0.001,1104,19
0.516,0.001,614,590,10,50,0.001,1204,19
0.546,0.001,662,642,10,50,0.001,1304,19
0.598,0.001,712,692,10,50,0.001,1404,19
0.654,0.001,760,744,10,50,0.001,1504,19
0.692,0.001,811,793,10,50,0.001,1604,19
0.714,0.001,863,841,10,50,0.001,1704,19
0.736,0.001,913,891,10,50,0.001,1804,19
0.76,0.001,955,949,10,50,0.001,1904,19
0.786,0.001,1007,997,10,50,0.001,2004,19
0.526,0.001,52,52,10,50,0.001,104,20
0.526,0.001,104,100,10,50,0.001,204,20
0.536,0.001,160,144,10,50,0.001,304,20
0.558,0.001,207,197,10,50,0.001,404,20
0.558,0.001,248,256,10,50,0.001,504,20
0.576,0.001,296,308,10,50,0.001,604,20
0.594,0.001,346,358,10,50,0.001,704,20
0.612,0.001,395,409,10,50,0.001,804,20
0.642,0.001,442,462,10,50,0.001,904,20
0.664,0.001,489,515,10,50,0.001,1004,20
0.678,0.001,533,571,10,50,0.001,1104,20
0.68,0.001,578,626,10,50,0.001,1204,20
0.686,0.001,637,667,10,50,0.001,1304,20
0.724,0.001,696,708,10,50,0.001,1404,20
0.728,0.001,748,756,10,50,0.001,1504,20
0.762,0.001,806,798,10,50,0.001,1604,20
0.788,0.001,853,851,10,50,0.001,1704,20
0.814,0.001,909,895,10,50,0.001,1804,20
0.832,0.001,952,952,10,50,0.001,1904,20
0.844,0.001,996,1008,10,50,0.001,2004,20
0.53,0.001,50,54,10,50,0.01,104,1
0.56,0.001,98,106,10,50,0.01,204,1
0.6,0.001,148,156,10,50,0.01,304,1
0.62,0.001,198,206,10,50,0.01,404,1
0.624,0.001,252,252,10,50,0.01,504,1
0.642,0.001,302,302,10,50,0.01,604,1
0.712,0.001,348,356,10,50,0.01,704,1
0.788,0.001,404,400,10,50,0.01,804,1
0.842,0.001,451,453,10,50,0.01,904,1
0.886,0.001,501,503,10,50,0.01,1004,1
0.934,0.001,540,564,10,50,0.01,1104,1
0.944,0.001,597,607,10,50,0.01,1204,1
0.93,0.001,637,667,10,50,0.01,1304,1
0.944,0.001,691,713,10,50,0.01,1404,1
0.948,0.001,743,761,10,50,0.01,1504,1
0.956,0.001,794,810,10,50,0.01,1604,1
0.958,0.001,839,865,10,50,0.01,1704,1
0.964,0.001,888,916,10,50,0.01,1804,1
0.966,0.001,939,965,10,50,0.01,1904,1
0.968,0.001,996,1008,10,50,0.01,2004,1
0.544,0.001,56,48,10,50,0.01,104,2
0.598,0.001,105,99,10,50,0.01,204,2
0.596,0.001,147,157,10,50,0.01,304,2
0.622,0.001,202,202,10,50,0.01,404,2
0.658,0.001,253,251,10,50,0.01,504,2
0.75,0.001,311,293,10,50,0.01,604,2
0.824,0.001,360,344,10,50,0.01,704,2
0.836,0.001,402,402,10,50,0.01,804,2
0.856,0.001,451,453,10,50,0.01,904,2
0.894,0.001,495,509,10,50,0.01,1004,2
0.884,0.001,549,555,10,50,0.01,1104,2
0.912,0.001,595,609,10,50,0.01,1204,2
0.93,0.001,650,654,10,50,0.01,1304,2
0.948,0.001,699,705,10,50,0.01,1404,2
0.954,0.001,749,755,10,50,0.01,1504,2
0.97,0.001,801,803,10,50,0.01,1604,2
0.968,0.001,853,851,10,50,0.01,1704,2
0.972,0.001,893,911,10,50,0.01,1804,2
0.97,0.001,939,965,10,50,0.01,1904,2
0.974,0.001,990,1014,10,50,0.01,2004,2
0.564,0.001,47,57,10,50,0.01,104,3
0.63,0.001,95,109,10,50,0.01,204,3
0.64,0.001,146,158,10,50,0.01,304,3
0.656,0.001,195,209,10,50,0.01,404,3
0.66,0.001,242,262,10,50,0.01,504,3
0.706,0.001,291,313,10,50,0.01,604,3
0.762,0.001,335,369,10,50,0.01,704,3
0.814,0.001,386,418,10,50,0.01,804,3
0.844,0.001,444,460,10,50,0.01,904,3
0.918,0.001,492,512,10,50,0.01,1004,3
0.944,0.001,552,552,10,50,0.01,1104,3
0.962,0.001,609,595,10,50,0.01,1204,3
0.972,0.001,655,649,10,50,0.01,1304,3
0.976,0.001,706,698,10,50,0.01,1404,3
0.982,0.001,762,742,10,50,0.01,1504,3
0.984,0.001,809,795,10,50,0.01,1604,3
0.984,0.001,851,853,10,50,0.01,1704,3
0.986,0.001,903,901,10,50,0.01,1804,3
0.988,0.001,950,954,10,50,0.01,1904,3
0.99,0.001,999,1005,10,50,0.01,2004,3
0.54,0.001,43,61,10,50,0.01,104,4
0.572,0.001,96,108,10,50,0.01,204,4
0.65,0.001,145,159,10,50,0.01,304,4
0.696,0.001,195,209,10,50,0.01,404,4
0.704,0.001,247,257,10,50,0.01,504,4
0.726,0.001,294,310,10,50,0.01,604,4
0.75,0.001,338,366,10,50,0.01,704,4
0.816,0.001,390,414,10,50,0.01,804,4
0.85,0.001,445,459,10,50,0.01,904,4
0.89,0.001,500,504,10,50,0.01,1004,4
0.922,0.001,550,554,10,50,0.01,1104,4
0.932,0.001,596,608,10,50,0.01,1204,4
0.94,0.001,640,664,10,50,0.01,1304,4
0.944,0.001,690,714,10,50,0.01,1404,4
0.952,0.001,737,767,10,50,0.01,1504,4
0.96,0.001,787,817,10,50,0.01,1604,4
0.962,0.001,839,865,10,50,0.01,1704,4
0.958,0.001,888,916,10,50,0.01,1804,4
0.968,0.001,940,964,10,50,0.01,1904,4
0.972,0.001,994,1010,10,50,0.01,2004,4
0.488,0.001,41,63,10,50,0.01,104,5
0.538,0.001,102,102,10,50,0.01,204,5
0.586,0.001,153,151,10,50,0.01,304,5
0.602,0.001,201,203,10,50,0.01,404,5
0.614,0.001,259,245,10,50,0.01,504,5
0.65,0.001,312,292,10,50,0.01,604,5
0.666,0.001,364,340,10,50,0.01,704,5
0.722,0.001,408,396,10,50,0.01,804,5
0.786,0.001,456,448,10,50,0.01,904,5
0.838,0.001,503,501,10,50,0.01,1004,5
0.876,0.001,554,550,10,50,0.01,1104,5
0.93,0.001,604,600,10,50,0.01,1204,5
0.94,0.001,648,656,10,50,0.01,1304,5
0.946,0.001,699,705,10,50,0.01,1404,5
0.95,0.001,743,761,10,50,0.01,1504,5
0.958,0.001,795,809,10,50,0.01,1604,5
0.96,0.001,836,868,10,50,0.01,1704,5
0.964,0.001,893,911,10,50,0.01,1804,5
0.966,0.001,946,958,10,50,0.01,1904,5
0.97,0.001,993,1011,10,50,0.01,2004,5
0.554,0.001,45,59,10,50,0.01,104,6
0.606,0.001,95,109,10,50,0.01,204,6
0.642,0.001,146,158,10,50,0.01,304,6
0.656,0.001,197,207,10,50,0.01,404,6
0.644,0.001,252,252,10,50,0.01,504,6
0.676,0.001,312,292,10,50,0.01,604,6
0.738,0.001,353,351,10,50,0.01,704,6
0.834,0.001,408,396,10,50,0.01,804,6
0.882,0.001,466,438,10,50,0.01,904,6
0.938,0.001,520,484,10,50,0.01,1004,6
0.956,0.001,573,531,10,50,0.01,1104,6
0.968,0.001,618,586,10,50,0.01,1204,6
0.966,0.001,665,639,10,50,0.01,1304,6
0.964,0.001,711,693,10,50,0.01,1404,6
0.964,0.001,760,744,10,50,0.01,1504,6
0.966,0.001,808,796,10,50,0.01,1604,6
0.964,0.001,854,850,10,50,0.01,1704,6
0.97,0.001,900,904,10,50,0.01,1804,6
0.964,0.001,942,962,10,50,0.01,1904,6
0.968,0.001,1001,1003,10,50,0.01,2004,6
0.472,0.001,58,46,10,50,0.01,104,7
0.498,0.001,102,102,10,50,0.01,204,7
0.52,0.001,151,153,10,50,0.01,304,7
0.59,0.001,203,201,10,50,0.01,404,7
0.654,0.001,246,258,10,50,0.01,504,7
0.698,0.001,307,297,10,50,0.01,604,7
0.706,0.001,353,351,10,50,0.01,704,7
0.748,0.001,407,397,10,50,0.01,804,7
0.812,0.001,455,449,10,50,0.01,904,7
0.876,0.001,505,499,10,50,0.01,1004,7
0.89,0.001,545,559,10,50,0.01,1104,7
0.92,0.001,599,605,10,50,0.01,1204,7
0.93,0.001,649,655,10,50,0.01,1304,7
0.95,0.001,701,703,10,50,0.01,1404,7
0.954,0.001,746,758,10,50,0.01,1504,7
0.946,0.001,801,803,10,50,0.01,1604,7
0.95,0.001,850,854,10,50,0.01,1704,7
0.954,0.001,894,910,10,50,0.01,1804,7
0.954,0.001,944,960,10,50,0.01,1904,7
0.962,0.001,993,1011,10,50,0.01,2004,7
0.526,0.001,42,62,10,50,0.01,104,8
0.562,0.001,95,109,10,50,0.01,204,8
0.55,0.001,141,163,10,50,0.01,304,8
0.59,0.001,181,223,10,50,0.01,404,8
0.624,0.001,233,271,10,50,0.01,504,8
0.692,0.001,274,330,10,50,0.01,604,8
0.746,0.001,328,376,10,50,0.01,704,8
0.84,0.001,374,430,10,50,0.01,804,8
0.89,0.001,421,483,10,50,0.01,904,8
0.912,0.001,477,527,10,50,0.01,1004,8
0.922,0.001,522,582,10,50,0.01,1104,8
0.93,0.001,563,641,10,50,0.01,1204,8
0.94,0.001,622,682,10,50,0.01,1304,8
0.958,0.001,673,731,10,50,0.01,1404,8
0.962,0.001,726,778,10,50,0.01,1504,8
0.962,0.001,777,827,10,50,0.01,1604,8
0.966,0.001,827,877,10,50,0.01,1704,8
0.968,0.001,880,924,10,50,0.01,1804,8
0.974,0.001,933,971,10,50,0.01,1904,8
0.976,0.001,991,1013,10,50,0.01,2004,8
0.514,0.001,55,49,10,50,0.01,104,9
0.584,0.001,100,104,10,50,0.01,204,9
0.59,0.001,154,150,10,50,0.01,304,9
0.622,0.001,207,197,10,50,0.01,404,9
0.634,0.001,253,251,10,50,0.01,504,9
0.722,0.001,304,300,10,50,0.01,604,9
0.752,0.001,362,342,10,50,0.01,704,9
0.812,0.001,412,392,10,50,0.01,804,9
0.854,0.001,464,440,10,50,0.01,904,9
0.884,0.001,516,488,10,50,0.01,1004,9
0.912,0.001,569,535,10,50,0.01,1104,9
0.938,0.001,613,591,10,50,0.01,1204,9
0.94,0.001,662,642,10,50,0.01,1304,9
0.946,0.001,708,696,10,50,0.01,1404,9
0.952,0.001,771,733,10,50,0.01,1504,9
0.962,0.001,817,787,10,50,0.01,1604,9
0.98,0.001,867,837,10,50,0.01,1704,9
0.978,0.001,913,891,10,50,0.01,1804,9
0.982,0.001,959,945,10,50,0.01,1904,9
0.982,0.001,1002,1002,10,50,0.01,2004,9
0.506,0.001,52,52,10,50,0.01,104,10
0.578,0.001,106,98,10,50,0.01,204,10
0.61,0.001,161,143,10,50,0.01,304,10
0.658,0.001,205,199,10,50,0.01,404,10
0.71,0.001,257,247,10,50,0.01,504,10
0.75,0.001,305,299,10,50,0.01,604,10
0.806,0.001,353,351,10,50,0.01,704,10
0.866,0.001,403,401,10,50,0.01,804,10
0.884,0.001,460,444,10,50,0.01,904,10
0.934,0.001,508,496,10,50,0.01,1004,10
0.944,0.001,558,546,10,50,0.01,1104,10
0.944,0.001,608,596,10,50,0.01,1204,10
0.94,0.001,655,649,10,50,0.01,1304,10
0.956,0.001,703,701,10,50,0.01,1404,10
0.958,0.001,746,758,10,50,0.01,1504,10
0.96,0.001,797,807,10,50,0.01,1604,10
0.96,0.001,846,858,10,50,0.01,1704,10
0.968,0.001,899,905,10,50,0.01,1804,10
0.972,0.001,953,951,10,50,0.01,1904,10
0.962,0.001,1004,1000,10,50,0.01,2004,10
0.556,0.001,58,46,10,50,0.01,104,11
0.552,0.001,108,96,10,50,0.01,204,11
0.574,0.001,147,157,10,50,0.01,304,11
0.636,0.001,199,205,10,50,0.01,404,11
0.662,0.001,238,266,10,50,0.01,504,11
0.71,0.001,288,316,10,50,0.01,604,11
0.752,0.001,340,364,10,50,0.01,704,11
0.818,0.001,384,420,10,50,0.01,804,11
0.854,0.001,435,469,10,50,0.01,904,11
0.894,0.001,491,513,10,50,0.01,1004,11
0.918,0.001,535,569,10,50,0.01,1104,11
0.954,0.001,595,609,10,50,0.01,1204,11
0.96,0.001,650,654,10,50,0.01,1304,11
0.96,0.001,700,704,10,50,0.01,1404,11
0.964,0.001,756,748,10,50,0.01,1504,11
0.972,0.001,803,801,10,50,0.01,1604,11
0.978,0.001,855,849,10,50,0.01,1704,11
0.974,0.001,905,899,10,50,0.01,1804,11
0.978,0.001,953,951,10,50,0.01,1904,11
0.978,0.001,995,1009,10,50,0.01,2004,11
0.506,0.001,49,55,10,50,0.01,104,12
0.518,0.001,102,102,10,50,0.01,204,12
0.504,0.001,164,140,10,50,0.01,304,12
0.488,0.001,217,187,10,50,0.01,404,12
0.486,0.001,271,233,10,50,0.01,504,12
0.544,0.001,313,291,10,50,0.01,604,12
0.684,0.001,359,345,10,50,0.01,704,12
0.86,0.001,403,401,10,50,0.01,804,12
0.868,0.001,456,448,10,50,0.01,904,12
0.904,0.001,509,495,10,50,0.01,1004,12
0.95,0.001,557,547,10,50,0.01,1104,12
0.968,0.001,615,589,10,50,0.01,1204,12
0.958,0.001,670,634,10,50,0.01,1304,12
0.966,0.001,726,678,10,50,0.01,1404,12
0.968,0.001,777,727,10,50,0.01,1504,12
0.984,0.001,832,772,10,50,0.01,1604,12
0.984,0.001,886,818,10,50,0.01,1704,12
0.982,0.001,923,881,10,50,0.01,1804,12
0.984,0.001,970,934,10,50,0.01,1904,12
0.982,0.001,1013,991,10,50,0.01,2004,12
0.54,0.001,60,44,10,50,0.01,104,13
0.558,0.001,114,90,10,50,0.01,204,13
0.564,0.001,166,138,10,50,0.01,304,13
0.572,0.001,212,192,10,50,0.01,404,13
0.61,0.001,262,242,10,50,0.01,504,13
0.698,0.001,310,294,10,50,0.01,604,13
0.778,0.001,368,336,10,50,0.01,704,13
0.86,0.001,410,394,10,50,0.01,804,13
0.88,0.001,454,450,10,50,0.01,904,13
0.914,0.001,502,502,10,50,0.01,1004,13
0.932,0.001,554,550,10,50,0.01,1104,13
0.944,0.001,599,605,10,50,0.01,1204,13
0.95,0.001,651,653,10,50,0.01,1304,13
0.946,0.001,705,699,10,50,0.01,1404,13
0.95,0.001,760,744,10,50,0.01,1504,13
0.964,0.001,811,793,10,50,0.01,1604,13
0.966,0.001,858,846,10,50,0.01,1704,13
0.972,0.001,904,900,10,50,0.01,1804,13
0.976,0.001,952,952,10,50,0.01,1904,13
0.97,0.001,998,1006,10,50,0.01,2004,13
0.534,0.001,44,60,10,50,0.01,104,14
0.556,0.001,95,109,10,50,0.01,204,14
0.588,0.001,137,167,10,50,0.01,304,14
0.632,0.001,183,221,10,50,0.01,404,14
0.66,0.001,229,275,10,50,0.01,504,14
0.716,0.001,275,329,10,50,0.01,604,14
0.758,0.001,323,381,10,50,0.01,704,14
0.792,0.001,373,431,10,50,0.01,804,14
0.82,0.001,427,477,10,50,0.01,904,14
0.872,0.001,486,518,10,50,0.01,1004,14
0.928,0.001,532,572,10,50,0.01,1104,14
0.936,0.001,579,625,10,50,0.01,1204,14
0.94,0.001,632,672,10,50,0.01,1304,14
0.948,0.001,686,718,10,50,0.01,1404,14
0.958,0.001,741,763,10,50,0.01,1504,14
0.962,0.001,795,809,10,50,0.01,1604,14
0.966,0.001,845,859,10,50,0.01,1704,14
0.972,0.001,904,900,10,50,0.01,1804,14
0.968,0.001,957,947,10,50,0.01,1904,14
0.974,0.001,1004,1000,10,50,0.01,2004,14
0.548,0.001,51,53,10,50,0.01,104,15
0.582,0.001,95,109,10,50,0.01,204,15
0.586,0.001,153,151,10,50,0.01,304,15
0.638,0.001,190,214,10,50,0.01,404,15
0.672,0.001,238,266,10,50,0.01,504,15
0.724,0.001,284,320,10,50,0.01,604,15
0.75,0.001,330,374,10,50,0.01,704,15
0.798,0.001,384,420,10,50,0.01,804,15
0.866,0.001,436,468,10,50,0.01,904,15
0.892,0.001,483,521,10,50,0.01,1004,15
0.918,0.001,536,568,10,50,0.01,1104,15
0.948,0.001,587,617,10,50,0.01,1204,15
0.962,0.001,643,661,10,50,0.01,1304,15
0.964,0.001,689,715,10,50,0.01,1404,15
0.964,0.001,735,769,10,50,0.01,1504,15
0.97,0.001,790,814,10,50,0.01,1604,15
0.972,0.001,852,852,10,50,0.01,1704,15
0.972,0.001,903,901,10,50,0.01,1804,15
0.976,0.001,953,951,10,50,0.01,1904,15
0.978,0.001,1004,1000,10,50,0.01,2004,15
0.556,0.001,54,50,10,50,0.01,104,16
0.564,0.001,95,109,10,50,0.01,204,16
0.556,0.001,147,157,10,50,0.01,304,16
0.596,0.001,200,204,10,50,0.01,404,16
0.652,0.001,247,257,10,50,0.01,504,16
0.748,0.001,300,304,10,50,0.01,604,16
0.78,0.001,352,352,10,50,0.01,704,16
0.844,0.001,407,397,10,50,0.01,804,16
0.88,0.001,455,449,10,50,0.01,904,16
0.916,0.001,515,489,10,50,0.01,1004,16
0.93,0.001,566,538,10,50,0.01,1104,16
0.96,0.001,620,584,10,50,0.01,1204,16
0.972,0.001,666,638,10,50,0.01,1304,16
0.962,0.001,716,688,10,50,0.01,1404,16
0.964,0.001,767,737,10,50,0.01,1504,16
0.972,0.001,814,790,10,50,0.01,1604,16
0.976,0.001,872,832,10,50,0.01,1704,16
0.98,0.001,921,883,10,50,0.01,1804,16
0.978,0.001,971,933,10,50,0.01,1904,16
0.982,0.001,1021,983,10,50,0.01,2004,16
0.536,0.001,48,56,10,50,0.01,104,17
0.63,0.001,96,108,10,50,0.01,204,17
0.662,0.001,153,151,10,50,0.01,304,17
0.696,0.001,204,200,10,50,0.01,404,17
0.732,0.001,249,255,10,50,0.01,504,17
0.776,0.001,300,304,10,50,0.01,604,17
0.8,0.001,354,350,10,50,0.01,704,17
0.854,0.001,408,396,10,50,0.01,804,17
0.892,0.001,461,443,10,50,0.01,904,17
0.932,0.001,503,501,10,50,0.01,1004,17
0.94,0.001,553,551,10,50,0.01,1104,17
0.958,0.001,600,604,10,50,0.01,1204,17
0.976,0.001,649,655,10,50,0.01,1304,17
0.978,0.001,699,705,10,50,0.01,1404,17
0.98,0.001,749,755,10,50,0.01,1504,17
0.982,0.001,802,802,10,50,0.01,1604,17
0.984,0.001,847,857,10,50,0.01,1704,17
0.982,0.001,905,899,10,50,0.01,1804,17
0.986,0.001,966,938,10,50,0.01,1904,17
0.992,0.001,1013,991,10,50,0.01,2004,17
0.564,0.001,65,39,10,50,0.01,104,18
0.574,0.001,118,86,10,50,0.01,204,18
0.544,0.001,173,131,10,50,0.01,304,18
0.558,0.001,215,189,10,50,0.01,404,18
0.608,0.001,267,237,10,50,0.01,504,18
0.686,0.001,315,289,10,50,0.01,604,18
0.808,0.001,368,336,10,50,0.01,704,18
0.856,0.001,419,385,10,50,0.01,804,18
0.856,0.001,471,433,10,50,0.01,904,18
0.914,0.001,511,493,10,50,0.01,1004,18
0.938,0.001,560,544,10,50,0.01,1104,18
0.956,0.001,608,596,10,50,0.01,1204,18
0.958,0.001,655,649,10,50,0.01,1304,18
0.962,0.001,704,700,10,50,0.01,1404,18
0.964,0.001,761,743,10,50,0.01,1504,18
0.962,0.001,816,788,10,50,0.01,1604,18
0.968,0.001,868,836,10,50,0.01,1704,18
0.972,0.001,912,892,10,50,0.01,1804,18
0.97,0.001,964,940,10,50,0.01,1904,18
0.982,0.001,1013,991,10,50,0.01,2004,18
0.554,0.001,49,55,10,50,0.01,104,19
0.574,0.001,89,115,10,50,0.01,204,19
0.578,0.001,138,166,10,50,0.01,304,19
0.578,0.001,186,218,10,50,0.01,404,19
0.62,0.001,235,269,10,50,0.01,504,19
0.676,0.001,278,326,10,50,0.01,604,19
0.7,0.001,327,377,10,50,0.01,704,19
0.764,0.001,377,427,10,50,0.01,804,19
0.832,0.001,433,471,10,50,0.01,904,19
0.88,0.001,478,526,10,50,0.01,1004,19
0.89,0.001,526,578,10,50,0.01,1104,19
0.916,0.001,579,625,10,50,0.01,1204,19
0.944,0.001,626,678,10,50,0.01,1304,19
0.952,0.001,675,729,10,50,0.01,1404,19
0.964,0.001,726,778,10,50,0.01,1504,19
0.97,0.001,777,827,10,50,0.01,1604,19
0.976,0.001,827,877,10,50,0.01,1704,19
0.978,0.001,872,932,10,50,0.01,1804,19
0.98,0.001,930,974,10,50,0.01,1904,19
0.982,0.001,985,1019,10,50,0.01,2004,19
0.52,0.001,52,52,10,50,0.01,104,20
0.568,0.001,104,100,10,50,0.01,204,20
0.594,0.001,150,154,10,50,0.01,304,20
0.622,0.001,205,199,10,50,0.01,404,20
0.64,0.001,254,250,10,50,0.01,504,20
0.682,0.001,312,292,10,50,0.01,604,20
0.74,0.001,361,343,10,50,0.01,704,20
0.802,0.001,403,401,10,50,0.01,804,20
0.872,0.001,453,451,10,50,0.01,904,20
0.936,0.001,502,502,10,50,0.01,1004,20
0.948,0.001,562,542,10,50,0.01,1104,20
0.962,0.001,622,582,10,50,0.01,1204,20
0.972,0.001,660,644,10,50,0.01,1304,20
0.976,0.001,716,688,10,50,0.01,1404,20
0.974,0.001,764,740,10,50,0.01,1504,20
0.974,0.001,810,794,10,50,0.01,1604,20
0.976,0.001,853,851,10,50,0.01,1704,20
0.98,0.001,907,897,10,50,0.01,1804,20
0.98,0.001,962,942,10,50,0.01,1904,20
0.984,0.001,1015,989,10,50,0.01,2004,20
0.462,1e-05,60,44,10,100,0.0001,104,1
0.464,1e-05,111,93,10,100,0.0001,204,1
0.466,1e-05,165,139,10,100,0.0001,304,1
0.464,1e-05,207,197,10,100,0.0001,404,1
0.468,1e-05,261,243,10,100,0.0001,504,1
0.47,1e-05,308,296,10,100,0.0001,604,1
0.474,1e-05,358,346,10,100,0.0001,704,1
0.472,1e-05,408,396,10,100,0.0001,804,1
0.472,1e-05,454,450,10,100,0.0001,904,1
0.474,1e-05,502,502,10,100,0.0001,1004,1
0.472,1e-05,547,557,10,100,0.0001,1104,1
0.474,1e-05,603,601,10,100,0.0001,1204,1
0.474,1e-05,661,643,10,100,0.0001,1304,1
0.472,1e-05,710,694,10,100,0.0001,1404,1
0.466,1e-05,755,749,10,100,0.0001,1504,1
0.464,1e-05,802,802,10,100,0.0001,1604,1
0.462,1e-05,856,848,10,100,0.0001,1704,1
0.464,1e-05,906,898,10,100,0.0001,1804,1
0.474,1e-05,956,948,10,100,0.0001,1904,1
0.494,1e-05,1002,1002,10,100,0.0001,2004,1
0.498,1e-05,56,48,10,100,0.0001,104,2
0.498,1e-05,107,97,10,100,0.0001,204,2
0.496,1e-05,159,145,10,100,0.0001,304,2
0.496,1e-05,204,200,10,100,0.0001,404,2
0.494,1e-05,256,248,10,100,0.0001,504,2
0.496,1e-05,306,298,10,100,0.0001,604,2
0.498,1e-05,360,344,10,100,0.0001,704,2
0.498,1e-05,407,397,10,100,0.0001,804,2
0.502,1e-05,458,446,10,100,0.0001,904,2
0.504,1e-05,516,488,10,100,0.0001,1004,2
0.504,1e-05,562,542,10,100,0.0001,1104,2
0.506,1e-05,614,590,10,100,0.0001,1204,2
0.508,1e-05,667,637,10,100,0.0001,1304,2
0.508,1e-05,721,683,10,100,0.0001,1404,2
0.51,1e-05,773,731,10,100,0.0001,1504,2
0.512,1e-05,824,780,10,100,0.0001,1604,2
0.51,1e-05,875,829,10,100,0.0001,1704,2
0.508,1e-05,917,887,10,100,0.0001,1804,2
0.518,1e-05,963,941,10,100,0.0001,1904,2
0.526,1e-05,1006,998,10,100,0.0001,2004,2
0.494,1e-05,49,55,10,100,0.0001,104,3
0.496,1e-05,101,103,10,100,0.0001,204,3
0.496,1e-05,144,160,10,100,0.0001,304,3
0.494,1e-05,198,206,10,100,0.0001,404,3
0.496,1e-05,245,259,10,100,0.0001,504,3
0.498,1e-05,289,315,10,100,0.0001,604,3
0.504,1e-05,338,366,10,100,0.0001,704,3
0.504,1e-05,395,409,10,100,0.0001,804,3
0.502,1e-05,437,467,10,100,0.0001,904,3
0.504,1e-05,496,508,10,100,0.0001,1004,3
0.512,1e-05,545,559,10,100,0.0001,1104,3
0.516,1e-05,605,599,10,100,0.0001,1204,3
0.522,1e-05,659,645,10,100,0.0001,1304,3
0.524,1e-05,701,703,10,100,0.0001,1404,3
0.532,1e-05,743,761,10,100,0.0001,1504,3
0.542,1e-05,794,810,10,100,0.0001,1604,3
0.544,1e-05,839,865,10,100,0.0001,1704,3
0.548,1e-05,892,912,10,100,0.0001,1804,3
0.552,1e-05,948,956,10,100,0.0001,1904,3
0.564,1e-05,1002,1002,10,100,0.0001,2004,3
0.522,1e-05,48,56,10,100,0.0001,104,4
0.524,1e-05,95,109,10,100,0.0001,204,4
0.52,1e-05,138,166,10,100,0.0001,304,4
0.518,1e-05,194,210,10,100,0.0001,404,4
0.52,1e-05,243,261,10,100,0.0001,504,4
0.52,1e-05,301,303,10,100,0.0001,604,4
0.524,1e-05,348,356,10,100,0.0001,704,4
0.528,1e-05,398,406,10,100,0.0001,804,4
0.532,1e-05,448,456,10,100,0.0001,904,4
0.534,1e-05,504,500,10,100,0.0001,1004,4
0.534,1e-05,559,545,10,100,0.0001,1104,4
0.532,1e-05,605,599,10,100,0.0001,1204,4
0.534,1e-05,650,654,10,100,0.0001,1304,4
0.538,1e-05,700,704,10,100,0.0001,1404,4
0.544,1e-05,754,750,10,100,0.0001,1504,4
0.546,1e-05,800,804,10,100,0.0001,1604,4
0.556,1e-05,857,847,10,100,0.0001,1704,4
0.562,1e-05,910,894,10,100,0.0001,1804,4
0.568,1e-05,962,942,10,100,0.0001,1904,4
0.572,1e-05,1008,996,10,100,0.0001,2004,4
0.488,1e-05,49,55,10,100,0.0001,104,5
0.49,1e-05,100,104,10,100,0.0001,204,5
0.492,1e-05,152,152,10,100,0.0001,304,5
0.496,1e-05,197,207,10,100,0.0001,404,5
0.492,1e-05,249,255,10,100,0.0001,504,5
0.494,1e-05,295,309,10,100,0.0001,604,5
0.492,1e-05,351,353,10,100,0.0001,704,5
0.488,1e-05,406,398,10,100,0.0001,804,5
0.488,1e-05,456,448,10,100,0.0001,904,5
0.488,1e-05,505,499,10,100,0.0001,1004,5
0.492,1e-05,551,553,10,100,0.0001,1104,5
0.492,1e-05,600,604,10,100,0.0001,1204,5
0.496,1e-05,653,651,10,100,0.0001,1304,5
0.506,1e-05,713,691,10,100,0.0001,1404,5
0.508,1e-05,754,750,10,100,0.0001,1504,5
0.514,1e-05,794,810,10,100,0.0001,1604,5
0.518,1e-05,847,857,10,100,0.0001,1704,5
0.518,1e-05,892,912,10,100,0.0001,1804,5
0.528,1e-05,945,959,10,100,0.0001,1904,5
0.528,1e-05,1001,1003,10,100,0.0001,2004,5
0.5,1e-05,54,50,10,100,0.0001,104,6
0.502,1e-05,100,104,10,100,0.0001,204,6
0.502,1e-05,141,163,10,100,0.0001,304,6
0.5,1e-05,188,216,10,100,0.0001,404,6
0.5,1e-05,242,262,10,100,0.0001,504,6
0.5,1e-05,296,308,10,100,0.0001,604,6
0.506,1e-05,347,357,10,100,0.0001,704,6
0.512,1e-05,396,408,10,100,0.0001,804,6
0.514,1e-05,450,454,10,100,0.0001,904,6
0.512,1e-05,496,508,10,100,0.0001,1004,6
0.512,1e-05,546,558,10,100,0.0001,1104,6
0.51,1e-05,593,611,10,100,0.0001,1204,6
0.518,1e-05,643,661,10,100,0.0001,1304,6
0.526,1e-05,692,712,10,100,0.0001,1404,6
0.536,1e-05,748,756,10,100,0.0001,1504,6
0.54,1e-05,794,810,10,100,0.0001,1604,6
0.544,1e-05,849,855,10,100,0.0001,1704,6
0.554,1e-05,906,898,10,100,0.0001,1804,6
0.56,1e-05,962,942,10,100,0.0001,1904,6
0.566,1e-05,1007,997,10,100,0.0001,2004,6
0.456,1e-05,49,55,10,100,0.0001,104,7
0.456,1e-05,105,99,10,100,0.0001,204,7
0.456,1e-05,156,148,10,100,0.0001,304,7
0.456,1e-05,198,206,10,100,0.0001,404,7
0.454,1e-05,252,252,10,100,0.0001,504,7
0.456,1e-05,295,309,10,100,0.0001,604,7
0.454,1e-05,348,356,10,100,0.0001,704,7
0.456,1e-05,390,414,10,100,0.0001,804,7
0.456,1e-05,434,470,10,100,0.0001,904,7
0.456,1e-05,489,515,10,100,0.0001,1004,7
0.462,1e-05,541,563,10,100,0.0001,1104,7
0.462,1e-05,593,611,10,100,0.0001,1204,7
0.464,1e-05,645,659,10,100,0.0001,1304,7
0.47,1e-05,693,711,10,100,0.0001,1404,7
0.472,1e-05,735,769,10,100,0.0001,1504,7
0.476,1e-05,791,813,10,100,0.0001,1604,7
0.48,1e-05,841,863,10,100,0.0001,1704,7
0.482,1e-05,897,907,10,100,0.0001,1804,7
0.488,1e-05,943,961,10,100,0.0001,1904,7
0.488,1e-05,991,1013,10,100,0.0001,2004,7
0.438,1e-05,45,59,10,100,0.0001,104,8
0.434,1e-05,92,112,10,100,0.0001,204,8
0.432,1e-05,146,158,10,100,0.0001,304,8
0.432,1e-05,190,214,10,100,0.0001,404,8
0.432,1e-05,244,260,10,100,0.0001,504,8
0.434,1e-05,300,304,10,100,0.0001,604,8
0.432,1e-05,344,360,10,100,0.0001,704,8
0.432,1e-05,388,416,10,100,0.0001,804,8
0.428,1e-05,434,470,10,100,0.0001,904,8
0.428,1e-05,492,512,10,100,0.0001,1004,8
0.428,1e-05,547,557,10,100,0.0001,1104,8
0.426,1e-05,599,605,10,100,0.0001,1204,8
0.424,1e-05,656,648,10,100,0.0001,1304,8
0.43,1e-05,702,702,10,100,0.0001,1404,8
0.444,1e-05,752,752,10,100,0.0001,1504,8
0.442,1e-05,804,800,10,100,0.0001,1604,8
0.45,1e-05,850,854,10,100,0.0001,1704,8
0.452,1e-05,897,907,10,100,0.0001,1804,8
0.462,1e-05,949,955,10,100,0.0001,1904,8
0.468,1e-05,1003,1001,10,100,0.0001,2004,8
0.542,1e-05,65,39,10,100,0.0001,104,9
0.542,1e-05,111,93,10,100,0.0001,204,9
0.542,1e-05,154,150,10,100,0.0001,304,9
0.542,1e-05,200,204,10,100,0.0001,404,9
0.54,1e-05,248,256,10,100,0.0001,504,9
0.54,1e-05,300,304,10,100,0.0001,604,9
0.538,1e-05,350,354,10,100,0.0001,704,9
0.542,1e-05,396,408,10,100,0.0001,804,9
0.542,1e-05,440,464,10,100,0.0001,904,9
0.55,1e-05,483,521,10,100,0.0001,1004,9
0.548,1e-05,534,570,10,100,0.0001,1104,9
0.55,1e-05,579,625,10,100,0.0001,1204,9
0.552,1e-05,627,677,10,100,0.0001,1304,9
0.548,1e-05,678,726,10,100,0.0001,1404,9
0.55,1e-05,733,771,10,100,0.0001,1504,9
0.548,1e-05,788,816,10,100,0.0001,1604,9
0.548,1e-05,850,854,10,100,0.0001,1704,9
0.554,1e-05,897,907,10,100,0.0001,1804,9
0.558,1e-05,948,956,10,100,0.0001,1904,9
0.566,1e-05,1002,1002,10,100,0.0001,2004,9
0.438,1e-05,56,48,10,100,0.0001,104,10
0.44,1e-05,109,95,10,100,0.0001,204,10
0.438,1e-05,170,134,10,100,0.0001,304,10
0.434,1e-05,223,181,10,100,0.0001,404,10
0.434,1e-05,272,232,10,100,0.0001,504,10
0.436,1e-05,322,282,10,100,0.0001,604,10
0.442,1e-05,371,333,10,100,0.0001,704,10
0.44,1e-05,423,381,10,100,0.0001,804,10
0.442,1e-05,461,443,10,100,0.0001,904,10
0.444,1e-05,505,499,10,100,0.0001,1004,10
0.446,1e-05,555,549,10,100,0.0001,1104,10
0.442,1e-05,607,597,10,100,0.0001,1204,10
0.448,1e-05,659,645,10,100,0.0001,1304,10
0.46,1e-05,723,681,10,100,0.0001,1404,10
0.45,1e-05,776,728,10,100,0.0001,1504,10
0.454,1e-05,830,774,10,100,0.0001,1604,10
0.466,1e-05,876,828,10,100,0.0001,1704,10
0.474,1e-05,927,877,10,100,0.0001,1804,10
0.472,1e-05,970,934,10,100,0.0001,1904,10
0.48,1e-05,1008,996,10,100,0.0001,2004,10
0.48,1e-05,44,60,10,100,0.0001,104,11
0.478,1e-05,97,107,10,100,0.0001,204,11
0.478,1e-05,148,156,10,100,0.0001,304,11
0.482,1e-05,193,211,10,100,0.0001,404,11
0.482,1e-05,238,266,10,100,0.0001,504,11
0.482,1e-05,281,323,10,100,0.0001,604,11
0.482,1e-05,330,374,10,100,0.0001,704,11
0.478,1e-05,375,429,10,100,0.0001,804,11
0.486,1e-05,424,480,10,100,0.0001,904,11
0.49,1e-05,479,525,10,100,0.0001,1004,11
0.492,1e-05,523,581,10,100,0.0001,1104,11
0.498,1e-05,576,628,10,100,0.0001,1204,11
0.494,1e-05,627,677,10,100,0.0001,1304,11
0.5,1e-05,678,726,10,100,0.0001,1404,11
0.5,1e-05,727,777,10,100,0.0001,1504,11
0.498,1e-05,784,820,10,100,0.0001,1604,11
0.498,1e-05,829,875,10,100,0.0001,1704,11
0.5,1e-05,876,928,10,100,0.0001,1804,11
0.502,1e-05,933,971,10,100,0.0001,1904,11
0.508,1e-05,985,1019,10,100,0.0001,2004,11
0.434,1e-05,51,53,10,100,0.0001,104,12
0.43,1e-05,103,101,10,100,0.0001,204,12
0.43,1e-05,154,150,10,100,0.0001,304,12
0.434,1e-05,206,198,10,100,0.0001,404,12
0.44,1e-05,253,251,10,100,0.0001,504,12
0.438,1e-05,295,309,10,100,0.0001,604,12
0.442,1e-05,350,354,10,100,0.0001,704,12
0.44,1e-05,388,416,10,100,0.0001,804,12
0.44,1e-05,442,462,10,100,0.0001,904,12
0.44,1e-05,497,507,10,100,0.0001,1004,12
0.448,1e-05,551,553,10,100,0.0001,1104,12
0.454,1e-05,596,608,10,100,0.0001,1204,12
0.458,1e-05,649,655,10,100,0.0001,1304,12
0.456,1e-05,693,711,10,100,0.0001,1404,12
0.462,1e-05,748,756,10,100,0.0001,1504,12
0.474,1e-05,793,811,10,100,0.0001,1604,12
0.472,1e-05,841,863,10,100,0.0001,1704,12
0.482,1e-05,885,919,10,100,0.0001,1804,12
0.49,1e-05,929,975,10,100,0.0001,1904,12
0.494,1e-05,978,1026,10,100,0.0001,2004,12
0.532,1e-05,58,46,10,100,0.0001,104,13
0.536,1e-05,106,98,10,100,0.0001,204,13
0.538,1e-05,154,150,10,100,0.0001,304,13
0.542,1e-05,203,201,10,100,0.0001,404,13
0.542,1e-05,254,250,10,100,0.0001,504,13
0.546,1e-05,304,300,10,100,0.0001,604,13
0.544,1e-05,354,350,10,100,0.0001,704,13
0.546,1e-05,405,399,10,100,0.0001,804,13
0.546,1e-05,452,452,10,100,0.0001,904,13
0.542,1e-05,495,509,10,100,0.0001,1004,13
0.544,1e-05,551,553,10,100,0.0001,1104,13
0.542,1e-05,597,607,10,100,0.0001,1204,13
0.55,1e-05,651,653,10,100,0.0001,1304,13
0.552,1e-05,705,699,10,100,0.0001,1404,13
0.55,1e-05,759,745,10,100,0.0001,1504,13
0.548,1e-05,807,797,10,100,0.0001,1604,13
0.556,1e-05,857,847,10,100,0.0001,1704,13
0.564,1e-05,900,904,10,100,0.0001,1804,13
0.566,1e-05,945,959,10,100,0.0001,1904,13
0.572,1e-05,1004,1000,10,100,0.0001,2004,13
0.456,1e-05,53,51,10,100,0.0001,104,14
0.456,1e-05,99,105,10,100,0.0001,204,14
0.46,1e-05,138,166,10,100,0.0001,304,14
0.464,1e-05,183,221,10,100,0.0001,404,14
0.464,1e-05,232,272,10,100,0.0001,504,14
0.47,1e-05,285,319,10,100,0.0001,604,14
0.47,1e-05,337,367,10,100,0.0001,704,14
0.472,1e-05,389,415,10,100,0.0001,804,14
0.476,1e-05,440,464,10,100,0.0001,904,14
0.478,1e-05,488,516,10,100,0.0001,1004,14
0.476,1e-05,537,567,10,100,0.0001,1104,14
0.476,1e-05,593,611,10,100,0.0001,1204,14
0.474,1e-05,641,663,10,100,0.0001,1304,14
0.476,1e-05,701,703,10,100,0.0001,1404,14
0.476,1e-05,751,753,10,100,0.0001,1504,14
0.478,1e-05,803,801,10,100,0.0001,1604,14
0.482,1e-05,850,854,10,100,0.0001,1704,14
0.486,1e-05,904,900,10,100,0.0001,1804,14
0.498,1e-05,960,944,10,100,0.0001,1904,14
0.502,1e-05,1011,993,10,100,0.0001,2004,14
0.484,1e-05,62,42,10,100,0.0001,104,15
0.482,1e-05,121,83,10,100,0.0001,204,15
0.482,1e-05,175,129,10,100,0.0001,304,15
0.486,1e-05,219,185,10,100,0.0001,404,15
0.488,1e-05,269,235,10,100,0.0001,504,15
0.486,1e-05,321,283,10,100,0.0001,604,15
0.486,1e-05,375,329,10,100,0.0001,704,15
0.49,1e-05,417,387,10,100,0.0001,804,15
0.488,1e-05,464,440,10,100,0.0001,904,15
0.494,1e-05,522,482,10,100,0.0001,1004,15
0.488,1e-05,572,532,10,100,0.0001,1104,15
0.492,1e-05,617,587,10,100,0.0001,1204,15
0.488,1e-05,667,637,10,100,0.0001,1304,15
0.49,1e-05,723,681,10,100,0.0001,1404,15
0.49,1e-05,773,731,10,100,0.0001,1504,15
0.494,1e-05,831,773,10,100,0.0001,1604,15
0.488,1e-05,879,825,10,100,0.0001,1704,15
0.49,1e-05,921,883,10,100,0.0001,1804,15
0.49,1e-05,971,933,10,100,0.0001,1904,15
0.486,1e-05,1012,992,10,100,0.0001,2004,15
0.476,1e-05,50,54,10,100,0.0001,104,16
0.478,1e-05,99,105,10,100,0.0001,204,16
0.482,1e-05,150,154,10,100,0.0001,304,16
0.48,1e-05,209,195,10,100,0.0001,404,16
0.478,1e-05,261,243,10,100,0.0001,504,16
0.474,1e-05,305,299,10,100,0.0001,604,16
0.48,1e-05,345,359,10,100,0.0001,704,16
0.484,1e-05,400,404,10,100,0.0001,804,16
0.486,1e-05,448,456,10,100,0.0001,904,16
0.492,1e-05,494,510,10,100,0.0001,1004,16
0.496,1e-05,543,561,10,100,0.0001,1104,16
0.5,1e-05,596,608,10,100,0.0001,1204,16
0.51,1e-05,646,658,10,100,0.0001,1304,16
0.508,1e-05,695,709,10,100,0.0001,1404,16
0.51,1e-05,745,759,10,100,0.0001,1504,16
0.512,1e-05,796,808,10,100,0.0001,1604,16
0.518,1e-05,844,860,10,100,0.0001,1704,16
0.52,1e-05,895,909,10,100,0.0001,1804,16
0.524,1e-05,943,961,10,100,0.0001,1904,16
0.53,1e-05,993,1011,10,100,0.0001,2004,16
0.476,1e-05,55,49,10,100,0.0001,104,17
0.474,1e-05,113,91,10,100,0.0001,204,17
0.474,1e-05,153,151,10,100,0.0001,304,17
0.476,1e-05,211,193,10,100,0.0001,404,17
0.478,1e-05,257,247,10,100,0.0001,504,17
0.482,1e-05,291,313,10,100,0.0001,604,17
0.484,1e-05,352,352,10,100,0.0001,704,17
0.488,1e-05,398,406,10,100,0.0001,804,17
0.49,1e-05,447,457,10,100,0.0001,904,17
0.492,1e-05,499,505,10,100,0.0001,1004,17
0.504,1e-05,554,550,10,100,0.0001,1104,17
0.512,1e-05,597,607,10,100,0.0001,1204,17
0.512,1e-05,651,653,10,100,0.0001,1304,17
0.516,1e-05,706,698,10,100,0.0001,1404,17
0.52,1e-05,760,744,10,100,0.0001,1504,17
0.522,1e-05,801,803,10,100,0.0001,1604,17
0.524,1e-05,857,847,10,100,0.0001,1704,17
0.528,1e-05,907,897,10,100,0.0001,1804,17
0.526,1e-05,954,950,10,100,0.0001,1904,17
0.532,1e-05,1003,1001,10,100,0.0001,2004,17
0.468,1e-05,49,55,10,100,0.0001,104,18
0.47,1e-05,89,115,10,100,0.0001,204,18
0.474,1e-05,141,163,10,100,0.0001,304,18
0.48,1e-05,184,220,10,100,0.0001,404,18
0.486,1e-05,235,269,10,100,0.0001,504,18
0.492,1e-05,280,324,10,100,0.0001,604,18
0.496,1e-05,327,377,10,100,0.0001,704,18
0.498,1e-05,389,415,10,100,0.0001,804,18
0.498,1e-05,442,462,10,100,0.0001,904,18
0.502,1e-05,490,514,10,100,0.0001,1004,18
0.508,1e-05,543,561,10,100,0.0001,1104,18
0.512,1e-05,595,609,10,100,0.0001,1204,18
0.524,1e-05,641,663,10,100,0.0001,1304,18
0.53,1e-05,699,705,10,100,0.0001,1404,18
0.528,1e-05,754,750,10,100,0.0001,1504,18
0.534,1e-05,806,798,10,100,0.0001,1604,18
0.542,1e-05,854,850,10,100,0.0001,1704,18
0.546,1e-05,905,899,10,100,0.0001,1804,18
0.558,1e-05,958,946,10,100,0.0001,1904,18
0.568,1e-05,1004,1000,10,100,0.0001,2004,18
0.554,1e-05,56,48,10,100,0.0001,104,19
0.554,1e-05,101,103,10,100,0.0001,204,19
0.554,1e-05,151,153,10,100,0.0001,304,19
0.556,1e-05,192,212,10,100,0.0001,404,19
0.558,1e-05,248,256,10,100,0.0001,504,19
0.566,1e-05,299,305,10,100,0.0001,604,19
0.566,1e-05,354,350,10,100,0.0001,704,19
0.562,1e-05,407,397,10,100,0.0001,804,19
0.562,1e-05,452,452,10,100,0.0001,904,19
0.566,1e-05,505,499,10,100,0.0001,1004,19
0.574,1e-05,551,553,10,100,0.0001,1104,19
0.578,1e-05,598,606,10,100,0.0001,1204,19
0.574,1e-05,647,657,10,100,0.0001,1304,19
0.578,1e-05,699,705,10,100,0.0001,1404,19
0.582,1e-05,746,758,10,100,0.0001,1504,19
0.586,1e-05,797,807,10,100,0.0001,1604,19
0.582,1e-05,849,855,10,100,0.0001,1704,19
0.59,1e-05,893,911,10,100,0.0001,1804,19
0.594,1e-05,943,961,10,100,0.0001,1904,19
0.598,1e-05,990,1014,10,100,0.0001,2004,19
0.458,1e-05,52,52,10,100,0.0001,104,20
0.456,1e-05,97,107,10,100,0.0001,204,20
0.456,1e-05,146,158,10,100,0.0001,304,20
0.46,1e-05,191,213,10,100,0.0001,404,20
0.458,1e-05,245,259,10,100,0.0001,504,20
0.46,1e-05,289,315,10,100,0.0001,604,20
0.46,1e-05,341,363,10,100,0.0001,704,20
0.462,1e-05,398,406,10,100,0.0001,804,20
0.458,1e-05,447,457,10,100,0.0001,904,20
0.46,1e-05,492,512,10,100,0.0001,1004,20
0.458,1e-05,547,557,10,100,0.0001,1104,20
0.458,1e-05,599,605,10,100,0.0001,1204,20
0.458,1e-05,647,657,10,100,0.0001,1304,20
0.456,1e-05,692,712,10,100,0.0001,1404,20
0.452,1e-05,748,756,10,100,0.0001,1504,20
0.448,1e-05,800,804,10,100,0.0001,1604,20
0.456,1e-05,848,856,10,100,0.0001,1704,20
0.458,1e-05,904,900,10,100,0.0001,1804,20
0.458,1e-05,951,953,10,100,0.0001,1904,20
0.46,1e-05,997,1007,10,100,0.0001,2004,20
0.478,1e-05,53,51,10,100,0.001,104,1
0.488,1e-05,93,111,10,100,0.001,204,1
0.498,1e-05,150,154,10,100,0.001,304,1
0.516,1e-05,203,201,10,100,0.001,404,1
0.538,1e-05,252,252,10,100,0.001,504,1
0.548,1e-05,301,303,10,100,0.001,604,1
0.56,1e-05,349,355,10,100,0.001,704,1
0.578,1e-05,406,398,10,100,0.001,804,1
0.594,1e-05,457,447,10,100,0.001,904,1
0.616,1e-05,503,501,10,100,0.001,1004,1
0.64,1e-05,554,550,10,100,0.001,1104,1
0.686,1e-05,597,607,10,100,0.001,1204,1
0.706,1e-05,642,662,10,100,0.001,1304,1
0.726,1e-05,692,712,10,100,0.001,1404,1
0.752,1e-05,746,758,10,100,0.001,1504,1
0.772,1e-05,803,801,10,100,0.001,1604,1
0.796,1e-05,850,854,10,100,0.001,1704,1
0.814,1e-05,897,907,10,100,0.001,1804,1
0.826,1e-05,944,960,10,100,0.001,1904,1
0.846,1e-05,990,1014,10,100,0.001,2004,1
0.486,1e-05,55,49,10,100,0.001,104,2
0.492,1e-05,109,95,10,100,0.001,204,2
0.49,1e-05,160,144,10,100,0.001,304,2
0.496,1e-05,211,193,10,100,0.001,404,2
0.504,1e-05,260,244,10,100,0.001,504,2
0.518,1e-05,302,302,10,100,0.001,604,2
0.546,1e-05,358,346,10,100,0.001,704,2
0.59,1e-05,408,396,10,100,0.001,804,2
0.646,1e-05,458,446,10,100,0.001,904,2
0.69,1e-05,511,493,10,100,0.001,1004,2
0.712,1e-05,556,548,10,100,0.001,1104,2
0.724,1e-05,607,597,10,100,0.001,1204,2
0.754,1e-05,653,651,10,100,0.001,1304,2
0.768,1e-05,699,705,10,100,0.001,1404,2
0.782,1e-05,749,755,10,100,0.001,1504,2
0.79,1e-05,800,804,10,100,0.001,1604,2
0.808,1e-05,850,854,10,100,0.001,1704,2
0.82,1e-05,893,911,10,100,0.001,1804,2
0.85,1e-05,943,961,10,100,0.001,1904,2
0.872,1e-05,990,1014,10,100,0.001,2004,2
0.496,1e-05,53,51,10,100,0.001,104,3
0.496,1e-05,102,102,10,100,0.001,204,3
0.498,1e-05,145,159,10,100,0.001,304,3
0.512,1e-05,193,211,10,100,0.001,404,3
0.518,1e-05,240,264,10,100,0.001,504,3
0.52,1e-05,289,315,10,100,0.001,604,3
0.536,1e-05,347,357,10,100,0.001,704,3
0.546,1e-05,390,414,10,100,0.001,804,3
0.548,1e-05,446,458,10,100,0.001,904,3
0.578,1e-05,513,491,10,100,0.001,1004,3
0.604,1e-05,564,540,10,100,0.001,1104,3
0.644,1e-05,605,599,10,100,0.001,1204,3
0.668,1e-05,657,647,10,100,0.001,1304,3
0.698,1e-05,706,698,10,100,0.001,1404,3
0.732,1e-05,761,743,10,100,0.001,1504,3
0.752,1e-05,819,785,10,100,0.001,1604,3
0.79,1e-05,868,836,10,100,0.001,1704,3
0.816,1e-05,916,888,10,100,0.001,1804,3
0.846,1e-05,967,937,10,100,0.001,1904,3
0.872,1e-05,1014,990,10,100,0.001,2004,3
0.5,1e-05,45,59,10,100,0.001,104,4
0.506,1e-05,104,100,10,100,0.001,204,4
0.508,1e-05,153,151,10,100,0.001,304,4
0.512,1e-05,200,204,10,100,0.001,404,4
0.534,1e-05,257,247,10,100,0.001,504,4
0.56,1e-05,307,297,10,100,0.001,604,4
0.566,1e-05,357,347,10,100,0.001,704,4
0.586,1e-05,410,394,10,100,0.001,804,4
0.598,1e-05,457,447,10,100,0.001,904,4
0.61,1e-05,508,496,10,100,0.001,1004,4
0.65,1e-05,571,533,10,100,0.001,1104,4
0.668,1e-05,614,590,10,100,0.001,1204,4
0.688,1e-05,664,640,10,100,0.001,1304,4
0.71,1e-05,714,690,10,100,0.001,1404,4
0.726,1e-05,768,736,10,100,0.001,1504,4
0.776,1e-05,813,791,10,100,0.001,1604,4
0.816,1e-05,865,839,10,100,0.001,1704,4
0.848,1e-05,914,890,10,100,0.001,1804,4
0.882,1e-05,963,941,10,100,0.001,1904,4
0.902,1e-05,1014,990,10,100,0.001,2004,4
0.484,1e-05,56,48,10,100,0.001,104,5
0.49,1e-05,112,92,10,100,0.001,204,5
0.488,1e-05,171,133,10,100,0.001,304,5
0.502,1e-05,218,186,10,100,0.001,404,5
0.518,1e-05,265,239,10,100,0.001,504,5
0.538,1e-05,314,290,10,100,0.001,604,5
0.55,1e-05,360,344,10,100,0.001,704,5
0.562,1e-05,403,401,10,100,0.001,804,5
0.59,1e-05,444,460,10,100,0.001,904,5
0.598,1e-05,494,510,10,100,0.001,1004,5
0.63,1e-05,541,563,10,100,0.001,1104,5
0.652,1e-05,590,614,10,100,0.001,1204,5
0.696,1e-05,634,670,10,100,0.001,1304,5
0.71,1e-05,685,719,10,100,0.001,1404,5
0.732,1e-05,737,767,10,100,0.001,1504,5
0.778,1e-05,791,813,10,100,0.001,1604,5
0.806,1e-05,846,858,10,100,0.001,1704,5
0.83,1e-05,900,904,10,100,0.001,1804,5
0.852,1e-05,951,953,10,100,0.001,1904,5
0.87,1e-05,1005,999,10,100,0.001,2004,5
0.506,1e-05,53,51,10,100,0.001,104,6
0.514,1e-05,106,98,10,100,0.001,204,6
0.536,1e-05,155,149,10,100,0.001,304,6
0.546,1e-05,201,203,10,100,0.001,404,6
0.562,1e-05,257,247,10,100,0.001,504,6
0.566,1e-05,308,296,10,100,0.001,604,6
0.582,1e-05,366,338,10,100,0.001,704,6
0.596,1e-05,428,376,10,100,0.001,804,6
0.628,1e-05,484,420,10,100,0.001,904,6
0.652,1e-05,537,467,10,100,0.001,1004,6
0.676,1e-05,580,524,10,100,0.001,1104,6
0.692,1e-05,629,575,10,100,0.001,1204,6
0.7,1e-05,677,627,10,100,0.001,1304,6
0.72,1e-05,727,677,10,100,0.001,1404,6
0.756,1e-05,769,735,10,100,0.001,1504,6
0.79,1e-05,826,778,10,100,0.001,1604,6
0.828,1e-05,872,832,10,100,0.001,1704,6
0.858,1e-05,923,881,10,100,0.001,1804,6
0.874,1e-05,967,937,10,100,0.001,1904,6
0.914,1e-05,1010,994,10,100,0.001,2004,6
0.504,1e-05,58,46,10,100,0.001,104,7
0.512,1e-05,107,97,10,100,0.001,204,7
0.512,1e-05,152,152,10,100,0.001,304,7
0.508,1e-05,201,203,10,100,0.001,404,7
0.52,1e-05,248,256,10,100,0.001,504,7
0.534,1e-05,299,305,10,100,0.001,604,7
0.55,1e-05,349,355,10,100,0.001,704,7
0.564,1e-05,398,406,10,100,0.001,804,7
0.586,1e-05,448,456,10,100,0.001,904,7
0.606,1e-05,496,508,10,100,0.001,1004,7
0.632,1e-05,545,559,10,100,0.001,1104,7
0.658,1e-05,591,613,10,100,0.001,1204,7
0.68,1e-05,639,665,10,100,0.001,1304,7
0.71,1e-05,685,719,10,100,0.001,1404,7
0.768,1e-05,736,768,10,100,0.001,1504,7
0.806,1e-05,786,818,10,100,0.001,1604,7
0.814,1e-05,846,858,10,100,0.001,1704,7
0.84,1e-05,894,910,10,100,0.001,1804,7
0.878,1e-05,947,957,10,100,0.001,1904,7
0.896,1e-05,994,1010,10,100,0.001,2004,7
0.484,1e-05,50,54,10,100,0.001,104,8
0.478,1e-05,107,97,10,100,0.001,204,8
0.484,1e-05,151,153,10,100,0.001,304,8
0.488,1e-05,210,194,10,100,0.001,404,8
0.506,1e-05,259,245,10,100,0.001,504,8
0.524,1e-05,312,292,10,100,0.001,604,8
0.538,1e-05,365,339,10,100,0.001,704,8
0.556,1e-05,418,386,10,100,0.001,804,8
0.59,1e-05,467,437,10,100,0.001,904,8
0.634,1e-05,514,490,10,100,0.001,1004,8
0.642,1e-05,562,542,10,100,0.001,1104,8
0.686,1e-05,601,603,10,100,0.001,1204,8
0.706,1e-05,658,646,10,100,0.001,1304,8
0.736,1e-05,708,696,10,100,0.001,1404,8
0.758,1e-05,754,750,10,100,0.001,1504,8
0.768,1e-05,801,803,10,100,0.001,1604,8
0.784,1e-05,856,848,10,100,0.001,1704,8
0.822,1e-05,913,891,10,100,0.001,1804,8
0.84,1e-05,965,939,10,100,0.001,1904,8
0.858,1e-05,1005,999,10,100,0.001,2004,8
0.504,1e-05,57,47,10,100,0.001,104,9
0.486,1e-05,103,101,10,100,0.001,204,9
0.482,1e-05,151,153,10,100,0.001,304,9
0.47,1e-05,200,204,10,100,0.001,404,9
0.48,1e-05,248,256,10,100,0.001,504,9
0.484,1e-05,286,318,10,100,0.001,604,9
0.498,1e-05,332,372,10,100,0.001,704,9
0.532,1e-05,388,416,10,100,0.001,804,9
0.556,1e-05,438,466,10,100,0.001,904,9
0.586,1e-05,494,510,10,100,0.001,1004,9
0.608,1e-05,546,558,10,100,0.001,1104,9
0.632,1e-05,595,609,10,100,0.001,1204,9
0.654,1e-05,644,660,10,100,0.001,1304,9
0.688,1e-05,685,719,10,100,0.001,1404,9
0.744,1e-05,733,771,10,100,0.001,1504,9
0.772,1e-05,780,824,10,100,0.001,1604,9
0.804,1e-05,832,872,10,100,0.001,1704,9
0.828,1e-05,880,924,10,100,0.001,1804,9
0.846,1e-05,940,964,10,100,0.001,1904,9
0.876,1e-05,996,1008,10,100,0.001,2004,9
0.496,1e-05,46,58,10,100,0.001,104,10
0.51,1e-05,97,107,10,100,0.001,204,10
0.524,1e-05,147,157,10,100,0.001,304,10
0.532,1e-05,202,202,10,100,0.001,404,10
0.564,1e-05,258,246,10,100,0.001,504,10
0.578,1e-05,307,297,10,100,0.001,604,10
0.602,1e-05,355,349,10,100,0.001,704,10
0.63,1e-05,405,399,10,100,0.001,804,10
0.668,1e-05,455,449,10,100,0.001,904,10
0.688,1e-05,501,503,10,100,0.001,1004,10
0.694,1e-05,548,556,10,100,0.001,1104,10
0.696,1e-05,596,608,10,100,0.001,1204,10
0.712,1e-05,653,651,10,100,0.001,1304,10
0.73,1e-05,702,702,10,100,0.001,1404,10
0.742,1e-05,752,752,10,100,0.001,1504,10
0.758,1e-05,803,801,10,100,0.001,1604,10
0.782,1e-05,853,851,10,100,0.001,1704,10
0.794,1e-05,904,900,10,100,0.001,1804,10
0.808,1e-05,951,953,10,100,0.001,1904,10
0.828,1e-05,1007,997,10,100,0.001,2004,10
0.476,1e-05,54,50,10,100,0.001,104,11
0.486,1e-05,111,93,10,100,0.001,204,11
0.49,1e-05,152,152,10,100,0.001,304,11
0.506,1e-05,196,208,10,100,0.001,404,11
0.518,1e-05,241,263,10,100,0.001,504,11
0.54,1e-05,291,313,10,100,0.001,604,11
0.544,1e-05,342,362,10,100,0.001,704,11
0.564,1e-05,392,412,10,100,0.001,804,11
0.58,1e-05,442,462,10,100,0.001,904,11
0.604,1e-05,495,509,10,100,0.001,1004,11
0.624,1e-05,533,571,10,100,0.001,1104,11
0.63,1e-05,590,614,10,100,0.001,1204,11
0.636,1e-05,644,660,10,100,0.001,1304,11
0.67,1e-05,696,708,10,100,0.001,1404,11
0.696,1e-05,742,762,10,100,0.001,1504,11
0.74,1e-05,785,819,10,100,0.001,1604,11
0.758,1e-05,833,871,10,100,0.001,1704,11
0.79,1e-05,885,919,10,100,0.001,1804,11
0.804,1e-05,935,969,10,100,0.001,1904,11
0.828,1e-05,981,1023,10,100,0.001,2004,11
0.518,1e-05,52,52,10,100,0.001,104,12
0.538,1e-05,102,102,10,100,0.001,204,12
0.554,1e-05,153,151,10,100,0.001,304,12
0.57,1e-05,208,196,10,100,0.001,404,12
0.584,1e-05,259,245,10,100,0.001,504,12
0.59,1e-05,318,286,10,100,0.001,604,12
0.588,1e-05,360,344,10,100,0.001,704,12
0.61,1e-05,408,396,10,100,0.001,804,12
0.628,1e-05,462,442,10,100,0.001,904,12
0.638,1e-05,508,496,10,100,0.001,1004,12
0.644,1e-05,568,536,10,100,0.001,1104,12
0.676,1e-05,611,593,10,100,0.001,1204,12
0.69,1e-05,658,646,10,100,0.001,1304,12
0.724,1e-05,713,691,10,100,0.001,1404,12
0.766,1e-05,757,747,10,100,0.001,1504,12
0.802,1e-05,801,803,10,100,0.001,1604,12
0.814,1e-05,849,855,10,100,0.001,1704,12
0.85,1e-05,897,907,10,100,0.001,1804,12
0.87,1e-05,944,960,10,100,0.001,1904,12
0.882,1e-05,993,1011,10,100,0.001,2004,12
0.492,1e-05,46,58,10,100,0.001,104,13
0.492,1e-05,100,104,10,100,0.001,204,13
0.498,1e-05,150,154,10,100,0.001,304,13
0.514,1e-05,201,203,10,100,0.001,404,13
0.522,1e-05,255,249,10,100,0.001,504,13
0.532,1e-05,300,304,10,100,0.001,604,13
0.552,1e-05,347,357,10,100,0.001,704,13
0.576,1e-05,399,405,10,100,0.001,804,13
0.588,1e-05,448,456,10,100,0.001,904,13
0.608,1e-05,492,512,10,100,0.001,1004,13
0.614,1e-05,540,564,10,100,0.001,1104,13
0.624,1e-05,584,620,10,100,0.001,1204,13
0.648,1e-05,633,671,10,100,0.001,1304,13
0.674,1e-05,679,725,10,100,0.001,1404,13
0.698,1e-05,731,773,10,100,0.001,1504,13
0.738,1e-05,781,823,10,100,0.001,1604,13
0.772,1e-05,832,872,10,100,0.001,1704,13
0.8,1e-05,891,913,10,100,0.001,1804,13
0.816,1e-05,942,962,10,100,0.001,1904,13
0.83,1e-05,992,1012,10,100,0.001,2004,13
0.486,1e-05,56,48,10,100,0.001,104,14
0.49,1e-05,115,89,10,100,0.001,204,14
0.5,1e-05,166,138,10,100,0.001,304,14
0.508,1e-05,208,196,10,100,0.001,404,14
0.518,1e-05,261,243,10,100,0.001,504,14
0.53,1e-05,309,295,10,100,0.001,604,14
0.534,1e-05,357,347,10,100,0.001,704,14
0.542,1e-05,409,395,10,100,0.001,804,14
0.556,1e-05,464,440,10,100,0.001,904,14
0.576,1e-05,520,484,10,100,0.001,1004,14
0.604,1e-05,569,535,10,100,0.001,1104,14
0.624,1e-05,627,577,10,100,0.001,1204,14
0.626,1e-05,673,631,10,100,0.001,1304,14
0.654,1e-05,721,683,10,100,0.001,1404,14
0.688,1e-05,772,732,10,100,0.001,1504,14
0.734,1e-05,818,786,10,100,0.001,1604,14
0.772,1e-05,869,835,10,100,0.001,1704,14
0.806,1e-05,919,885,10,100,0.001,1804,14
0.856,1e-05,959,945,10,100,0.001,1904,14
0.88,1e-05,1010,994,10,100,0.001,2004,14
0.494,1e-05,55,49,10,100,0.001,104,15
0.498,1e-05,94,110,10,100,0.001,204,15
0.5,1e-05,147,157,10,100,0.001,304,15
0.502,1e-05,195,209,10,100,0.001,404,15
0.536,1e-05,251,253,10,100,0.001,504,15
0.564,1e-05,312,292,10,100,0.001,604,15
0.572,1e-05,359,345,10,100,0.001,704,15
0.586,1e-05,421,383,10,100,0.001,804,15
0.608,1e-05,474,430,10,100,0.001,904,15
0.628,1e-05,520,484,10,100,0.001,1004,15
0.65,1e-05,571,533,10,100,0.001,1104,15
0.684,1e-05,625,579,10,100,0.001,1204,15
0.718,1e-05,659,645,10,100,0.001,1304,15
0.744,1e-05,715,689,10,100,0.001,1404,15
0.746,1e-05,769,735,10,100,0.001,1504,15
0.772,1e-05,821,783,10,100,0.001,1604,15
0.782,1e-05,869,835,10,100,0.001,1704,15
0.812,1e-05,928,876,10,100,0.001,1804,15
0.82,1e-05,975,929,10,100,0.001,1904,15
0.854,1e-05,1014,990,10,100,0.001,2004,15
0.454,1e-05,58,46,10,100,0.001,104,16
0.454,1e-05,114,90,10,100,0.001,204,16
0.456,1e-05,168,136,10,100,0.001,304,16
0.48,1e-05,213,191,10,100,0.001,404,16
0.482,1e-05,261,243,10,100,0.001,504,16
0.498,1e-05,318,286,10,100,0.001,604,16
0.526,1e-05,364,340,10,100,0.001,704,16
0.548,1e-05,415,389,10,100,0.001,804,16
0.578,1e-05,467,437,10,100,0.001,904,16
0.6,1e-05,515,489,10,100,0.001,1004,16
0.64,1e-05,553,551,10,100,0.001,1104,16
0.688,1e-05,597,607,10,100,0.001,1204,16
0.726,1e-05,650,654,10,100,0.001,1304,16
0.746,1e-05,701,703,10,100,0.001,1404,16
0.76,1e-05,748,756,10,100,0.001,1504,16
0.776,1e-05,791,813,10,100,0.001,1604,16
0.81,1e-05,844,860,10,100,0.001,1704,16
0.832,1e-05,891,913,10,100,0.001,1804,16
0.848,1e-05,939,965,10,100,0.001,1904,16
0.862,1e-05,995,1009,10,100,0.001,2004,16
0.396,1e-05,58,46,10,100,0.001,104,17
0.4,1e-05,108,96,10,100,0.001,204,17
0.414,1e-05,167,137,10,100,0.001,304,17
0.426,1e-05,209,195,10,100,0.001,404,17
0.436,1e-05,257,247,10,100,0.001,504,17
0.432,1e-05,303,301,10,100,0.001,604,17
0.458,1e-05,359,345,10,100,0.001,704,17
0.486,1e-05,400,404,10,100,0.001,804,17
0.492,1e-05,448,456,10,100,0.001,904,17
0.514,1e-05,498,506,10,100,0.001,1004,17
0.54,1e-05,538,566,10,100,0.001,1104,17
0.566,1e-05,589,615,10,100,0.001,1204,17
0.586,1e-05,640,664,10,100,0.001,1304,17
0.642,1e-05,698,706,10,100,0.001,1404,17
0.686,1e-05,745,759,10,100,0.001,1504,17
0.748,1e-05,790,814,10,100,0.001,1604,17
0.754,1e-05,830,874,10,100,0.001,1704,17
0.794,1e-05,879,925,10,100,0.001,1804,17
0.816,1e-05,935,969,10,100,0.001,1904,17
0.854,1e-05,993,1011,10,100,0.001,2004,17
0.536,1e-05,60,44,10,100,0.001,104,18
0.57,1e-05,116,88,10,100,0.001,204,18
0.568,1e-05,164,140,10,100,0.001,304,18
0.576,1e-05,211,193,10,100,0.001,404,18
0.584,1e-05,253,251,10,100,0.001,504,18
0.606,1e-05,309,295,10,100,0.001,604,18
0.598,1e-05,357,347,10,100,0.001,704,18
0.624,1e-05,405,399,10,100,0.001,804,18
0.628,1e-05,455,449,10,100,0.001,904,18
0.642,1e-05,503,501,10,100,0.001,1004,18
0.68,1e-05,550,554,10,100,0.001,1104,18
0.708,1e-05,596,608,10,100,0.001,1204,18
0.714,1e-05,648,656,10,100,0.001,1304,18
0.742,1e-05,697,707,10,100,0.001,1404,18
0.758,1e-05,749,755,10,100,0.001,1504,18
0.804,1e-05,796,808,10,100,0.001,1604,18
0.824,1e-05,851,853,10,100,0.001,1704,18
0.85,1e-05,902,902,10,100,0.001,1804,18
0.872,1e-05,943,961,10,100,0.001,1904,18
0.886,1e-05,1000,1004,10,100,0.001,2004,18
0.484,1e-05,48,56,10,100,0.001,104,19
0.482,1e-05,100,104,10,100,0.001,204,19
0.504,1e-05,151,153,10,100,0.001,304,19
0.52,1e-05,199,205,10,100,0.001,404,19
0.542,1e-05,242,262,10,100,0.001,504,19
0.58,1e-05,301,303,10,100,0.001,604,19
0.588,1e-05,347,357,10,100,0.001,704,19
0.63,1e-05,394,410,10,100,0.001,804,19
0.66,1e-05,447,457,10,100,0.001,904,19
0.684,1e-05,500,504,10,100,0.001,1004,19
0.7,1e-05,548,556,10,100,0.001,1104,19
0.718,1e-05,605,599,10,100,0.001,1204,19
0.736,1e-05,650,654,10,100,0.001,1304,19
0.754,1e-05,694,710,10,100,0.001,1404,19
0.776,1e-05,749,755,10,100,0.001,1504,19
0.794,1e-05,804,800,10,100,0.001,1604,19
0.812,1e-05,850,854,10,100,0.001,1704,19
0.828,1e-05,893,911,10,100,0.001,1804,19
0.856,1e-05,938,966,10,100,0.001,1904,19
0.858,1e-05,983,1021,10,100,0.001,2004,19
0.498,1e-05,56,48,10,100,0.001,104,20
0.496,1e-05,104,100,10,100,0.001,204,20
0.5,1e-05,147,157,10,100,0.001,304,20
0.508,1e-05,207,197,10,100,0.001,404,20
0.514,1e-05,263,241,10,100,0.001,504,20
0.516,1e-05,315,289,10,100,0.001,604,20
0.528,1e-05,360,344,10,100,0.001,704,20
0.53,1e-05,397,407,10,100,0.001,804,20
0.562,1e-05,448,456,10,100,0.001,904,20
0.59,1e-05,500,504,10,100,0.001,1004,20
0.61,1e-05,551,553,10,100,0.001,1104,20
0.658,1e-05,600,604,10,100,0.001,1204,20
0.696,1e-05,645,659,10,100,0.001,1304,20
0.736,1e-05,701,703,10,100,0.001,1404,20
0.748,1e-05,754,750,10,100,0.001,1504,20
0.78,1e-05,803,801,10,100,0.001,1604,20
0.822,1e-05,851,853,10,100,0.001,1704,20
0.84,1e-05,906,898,10,100,0.001,1804,20
0.854,1e-05,955,949,10,100,0.001,1904,20
0.866,1e-05,998,1006,10,100,0.001,2004,20
0.538,1e-05,57,47,10,100,0.01,104,1
0.568,1e-05,107,97,10,100,0.01,204,1
0.582,1e-05,154,150,10,100,0.01,304,1
0.612,1e-05,200,204,10,100,0.01,404,1
0.652,1e-05,256,248,10,100,0.01,504,1
0.782,1e-05,297,307,10,100,0.01,604,1
0.86,1e-05,348,356,10,100,0.01,704,1
0.914,1e-05,405,399,10,100,0.01,804,1
0.912,1e-05,448,456,10,100,0.01,904,1
0.926,1e-05,502,502,10,100,0.01,1004,1
0.942,1e-05,557,547,10,100,0.01,1104,1
0.952,1e-05,607,597,10,100,0.01,1204,1
0.956,1e-05,663,641,10,100,0.01,1304,1
0.962,1e-05,709,695,10,100,0.01,1404,1
0.968,1e-05,765,739,10,100,0.01,1504,1
0.98,1e-05,809,795,10,100,0.01,1604,1
0.986,1e-05,867,837,10,100,0.01,1704,1
0.986,1e-05,913,891,10,100,0.01,1804,1
0.986,1e-05,959,945,10,100,0.01,1904,1
0.992,1e-05,1005,999,10,100,0.01,2004,1
0.594,1e-05,45,59,10,100,0.01,104,2
0.648,1e-05,93,111,10,100,0.01,204,2
0.66,1e-05,152,152,10,100,0.01,304,2
0.734,1e-05,205,199,10,100,0.01,404,2
0.762,1e-05,251,253,10,100,0.01,504,2
0.822,1e-05,306,298,10,100,0.01,604,2
0.87,1e-05,355,349,10,100,0.01,704,2
0.906,1e-05,411,393,10,100,0.01,804,2
0.928,1e-05,456,448,10,100,0.01,904,2
0.946,1e-05,508,496,10,100,0.01,1004,2
0.96,1e-05,563,541,10,100,0.01,1104,2
0.968,1e-05,609,595,10,100,0.01,1204,2
0.968,1e-05,659,645,10,100,0.01,1304,2
0.972,1e-05,709,695,10,100,0.01,1404,2
0.976,1e-05,757,747,10,100,0.01,1504,2
0.972,1e-05,808,796,10,100,0.01,1604,2
0.978,1e-05,865,839,10,100,0.01,1704,2
0.98,1e-05,907,897,10,100,0.01,1804,2
0.98,1e-05,957,947,10,100,0.01,1904,2
0.98,1e-05,1005,999,10,100,0.01,2004,2
0.548,1e-05,56,48,10,100,0.01,104,3
0.608,1e-05,107,97,10,100,0.01,204,3
0.634,1e-05,160,144,10,100,0.01,304,3
0.678,1e-05,206,198,10,100,0.01,404,3
0.74,1e-05,255,249,10,100,0.01,504,3
0.77,1e-05,309,295,10,100,0.01,604,3
0.796,1e-05,358,346,10,100,0.01,704,3
0.846,1e-05,409,395,10,100,0.01,804,3
0.878,1e-05,467,437,10,100,0.01,904,3
0.93,1e-05,520,484,10,100,0.01,1004,3
0.952,1e-05,570,534,10,100,0.01,1104,3
0.96,1e-05,620,584,10,100,0.01,1204,3
0.968,1e-05,666,638,10,100,0.01,1304,3
0.968,1e-05,719,685,10,100,0.01,1404,3
0.968,1e-05,773,731,10,100,0.01,1504,3
0.972,1e-05,820,784,10,100,0.01,1604,3
0.976,1e-05,872,832,10,100,0.01,1704,3
0.98,1e-05,919,885,10,100,0.01,1804,3
0.984,1e-05,959,945,10,100,0.01,1904,3
0.986,1e-05,1018,986,10,100,0.01,2004,3
0.502,1e-05,47,57,10,100,0.01,104,4
0.536,1e-05,94,110,10,100,0.01,204,4
0.546,1e-05,139,165,10,100,0.01,304,4
0.574,1e-05,183,221,10,100,0.01,404,4
0.618,1e-05,226,278,10,100,0.01,504,4
0.686,1e-05,278,326,10,100,0.01,604,4
0.718,1e-05,331,373,10,100,0.01,704,4
0.792,1e-05,385,419,10,100,0.01,804,4
0.85,1e-05,437,467,10,100,0.01,904,4
0.892,1e-05,488,516,10,100,0.01,1004,4
0.924,1e-05,538,566,10,100,0.01,1104,4
0.94,1e-05,588,616,10,100,0.01,1204,4
0.952,1e-05,647,657,10,100,0.01,1304,4
0.97,1e-05,699,705,10,100,0.01,1404,4
0.978,1e-05,748,756,10,100,0.01,1504,4
0.98,1e-05,793,811,10,100,0.01,1604,4
0.98,1e-05,847,857,10,100,0.01,1704,4
0.98,1e-05,898,906,10,100,0.01,1804,4
0.982,1e-05,952,952,10,100,0.01,1904,4
0.98,1e-05,991,1013,10,100,0.01,2004,4
0.502,1e-05,57,47,10,100,0.01,104,5
0.582,1e-05,101,103,10,100,0.01,204,5
0.608,1e-05,148,156,10,100,0.01,304,5
0.624,1e-05,198,206,10,100,0.01,404,5
0.654,1e-05,254,250,10,100,0.01,504,5
0.736,1e-05,309,295,10,100,0.01,604,5
0.788,1e-05,349,355,10,100,0.01,704,5
0.864,1e-05,400,404,10,100,0.01,804,5
0.894,1e-05,446,458,10,100,0.01,904,5
0.95,1e-05,501,503,10,100,0.01,1004,5
0.96,1e-05,547,557,10,100,0.01,1104,5
0.96,1e-05,595,609,10,100,0.01,1204,5
0.966,1e-05,648,656,10,100,0.01,1304,5
0.972,1e-05,696,708,10,100,0.01,1404,5
0.974,1e-05,744,760,10,100,0.01,1504,5
0.98,1e-05,798,806,10,100,0.01,1604,5
0.986,1e-05,853,851,10,100,0.01,1704,5
0.986,1e-05,904,900,10,100,0.01,1804,5
0.986,1e-05,951,953,10,100,0.01,1904,5
0.986,1e-05,1001,1003,10,100,0.01,2004,5
0.552,1e-05,50,54,10,100,0.01,104,6
0.578,1e-05,106,98,10,100,0.01,204,6
0.618,1e-05,159,145,10,100,0.01,304,6
0.654,1e-05,209,195,10,100,0.01,404,6
0.706,1e-05,258,246,10,100,0.01,504,6
0.734,1e-05,306,298,10,100,0.01,604,6
0.758,1e-05,352,352,10,100,0.01,704,6
0.828,1e-05,401,403,10,100,0.01,804,6
0.852,1e-05,444,460,10,100,0.01,904,6
0.904,1e-05,503,501,10,100,0.01,1004,6
0.914,1e-05,552,552,10,100,0.01,1104,6
0.926,1e-05,600,604,10,100,0.01,1204,6
0.948,1e-05,648,656,10,100,0.01,1304,6
0.966,1e-05,701,703,10,100,0.01,1404,6
0.968,1e-05,746,758,10,100,0.01,1504,6
0.984,1e-05,795,809,10,100,0.01,1604,6
0.986,1e-05,850,854,10,100,0.01,1704,6
0.986,1e-05,903,901,10,100,0.01,1804,6
0.99,1e-05,959,945,10,100,0.01,1904,6
0.99,1e-05,1010,994,10,100,0.01,2004,6
0.494,1e-05,53,51,10,100,0.01,104,7
0.664,1e-05,94,110,10,100,0.01,204,7
0.688,1e-05,145,159,10,100,0.01,304,7
0.666,1e-05,196,208,10,100,0.01,404,7
0.672,1e-05,244,260,10,100,0.01,504,7
0.776,1e-05,290,314,10,100,0.01,604,7
0.836,1e-05,330,374,10,100,0.01,704,7
0.884,1e-05,389,415,10,100,0.01,804,7
0.906,1e-05,443,461,10,100,0.01,904,7
0.942,1e-05,498,506,10,100,0.01,1004,7
0.952,1e-05,550,554,10,100,0.01,1104,7
0.96,1e-05,599,605,10,100,0.01,1204,7
0.966,1e-05,659,645,10,100,0.01,1304,7
0.962,1e-05,702,702,10,100,0.01,1404,7
0.962,1e-05,752,752,10,100,0.01,1504,7
0.97,1e-05,796,808,10,100,0.01,1604,7
0.974,1e-05,850,854,10,100,0.01,1704,7
0.984,1e-05,898,906,10,100,0.01,1804,7
0.984,1e-05,954,950,10,100,0.01,1904,7
0.984,1e-05,1011,993,10,100,0.01,2004,7
0.58,1e-05,44,60,10,100,0.01,104,8
0.61,1e-05,100,104,10,100,0.01,204,8
0.63,1e-05,148,156,10,100,0.01,304,8
0.658,1e-05,199,205,10,100,0.01,404,8
0.676,1e-05,251,253,10,100,0.01,504,8
0.738,1e-05,302,302,10,100,0.01,604,8
0.808,1e-05,346,358,10,100,0.01,704,8
0.862,1e-05,401,403,10,100,0.01,804,8
0.886,1e-05,454,450,10,100,0.01,904,8
0.922,1e-05,501,503,10,100,0.01,1004,8
0.942,1e-05,557,547,10,100,0.01,1104,8
0.946,1e-05,608,596,10,100,0.01,1204,8
0.954,1e-05,658,646,10,100,0.01,1304,8
0.966,1e-05,702,702,10,100,0.01,1404,8
0.97,1e-05,755,749,10,100,0.01,1504,8
0.97,1e-05,807,797,10,100,0.01,1604,8
0.97,1e-05,860,844,10,100,0.01,1704,8
0.978,1e-05,899,905,10,100,0.01,1804,8
0.978,1e-05,942,962,10,100,0.01,1904,8
0.984,1e-05,1002,1002,10,100,0.01,2004,8
0.584,1e-05,51,53,10,100,0.01,104,9
0.612,1e-05,91,113,10,100,0.01,204,9
0.626,1e-05,142,162,10,100,0.01,304,9
0.644,1e-05,193,211,10,100,0.01,404,9
0.714,1e-05,236,268,10,100,0.01,504,9
0.82,1e-05,285,319,10,100,0.01,604,9
0.82,1e-05,340,364,10,100,0.01,704,9
0.882,1e-05,392,412,10,100,0.01,804,9
0.936,1e-05,450,454,10,100,0.01,904,9
0.956,1e-05,501,503,10,100,0.01,1004,9
0.97,1e-05,545,559,10,100,0.01,1104,9
0.966,1e-05,596,608,10,100,0.01,1204,9
0.974,1e-05,645,659,10,100,0.01,1304,9
0.974,1e-05,691,713,10,100,0.01,1404,9
0.974,1e-05,744,760,10,100,0.01,1504,9
0.98,1e-05,791,813,10,100,0.01,1604,9
0.984,1e-05,842,862,10,100,0.01,1704,9
0.984,1e-05,886,918,10,100,0.01,1804,9
0.984,1e-05,934,970,10,100,0.01,1904,9
0.984,1e-05,984,1020,10,100,0.01,2004,9
0.492,1e-05,45,59,10,100,0.01,104,10
0.526,1e-05,101,103,10,100,0.01,204,10
0.57,1e-05,155,149,10,100,0.01,304,10
0.646,1e-05,202,202,10,100,0.01,404,10
0.702,1e-05,254,250,10,100,0.01,504,10
0.74,1e-05,297,307,10,100,0.01,604,10
0.77,1e-05,341,363,10,100,0.01,704,10
0.854,1e-05,385,419,10,100,0.01,804,10
0.91,1e-05,435,469,10,100,0.01,904,10
0.946,1e-05,489,515,10,100,0.01,1004,10
0.958,1e-05,541,563,10,100,0.01,1104,10
0.968,1e-05,598,606,10,100,0.01,1204,10
0.978,1e-05,651,653,10,100,0.01,1304,10
0.976,1e-05,699,705,10,100,0.01,1404,10
0.978,1e-05,752,752,10,100,0.01,1504,10
0.98,1e-05,807,797,10,100,0.01,1604,10
0.984,1e-05,857,847,10,100,0.01,1704,10
0.99,1e-05,913,891,10,100,0.01,1804,10
0.98,1e-05,955,949,10,100,0.01,1904,10
0.982,1e-05,1004,1000,10,100,0.01,2004,10
0.584,1e-05,53,51,10,100,0.01,104,11
0.602,1e-05,104,100,10,100,0.01,204,11
0.59,1e-05,145,159,10,100,0.01,304,11
0.646,1e-05,189,215,10,100,0.01,404,11
0.706,1e-05,243,261,10,100,0.01,504,11
0.75,1e-05,292,312,10,100,0.01,604,11
0.778,1e-05,341,363,10,100,0.01,704,11
0.858,1e-05,387,417,10,100,0.01,804,11
0.904,1e-05,438,466,10,100,0.01,904,11
0.924,1e-05,495,509,10,100,0.01,1004,11
0.922,1e-05,544,560,10,100,0.01,1104,11
0.952,1e-05,592,612,10,100,0.01,1204,11
0.956,1e-05,645,659,10,100,0.01,1304,11
0.962,1e-05,692,712,10,100,0.01,1404,11
0.974,1e-05,739,765,10,100,0.01,1504,11
0.97,1e-05,787,817,10,100,0.01,1604,11
0.98,1e-05,844,860,10,100,0.01,1704,11
0.982,1e-05,894,910,10,100,0.01,1804,11
0.984,1e-05,945,959,10,100,0.01,1904,11
0.986,1e-05,996,1008,10,100,0.01,2004,11
0.544,1e-05,54,50,10,100,0.01,104,12
0.616,1e-05,97,107,10,100,0.01,204,12
0.622,1e-05,149,155,10,100,0.01,304,12
0.676,1e-05,202,202,10,100,0.01,404,12
0.714,1e-05,252,252,10,100,0.01,504,12
0.782,1e-05,305,299,10,100,0.01,604,12
0.784,1e-05,351,353,10,100,0.01,704,12
0.876,1e-05,400,404,10,100,0.01,804,12
0.902,1e-05,457,447,10,100,0.01,904,12
0.958,1e-05,507,497,10,100,0.01,1004,12
0.958,1e-05,563,541,10,100,0.01,1104,12
0.974,1e-05,615,589,10,100,0.01,1204,12
0.956,1e-05,667,637,10,100,0.01,1304,12
0.972,1e-05,709,695,10,100,0.01,1404,12
0.974,1e-05,768,736,10,100,0.01,1504,12
0.98,1e-05,825,779,10,100,0.01,1604,12
0.982,1e-05,864,840,10,100,0.01,1704,12
0.988,1e-05,910,894,10,100,0.01,1804,12
0.99,1e-05,959,945,10,100,0.01,1904,12
0.994,1e-05,1009,995,10,100,0.01,2004,12
0.594,1e-05,56,48,10,100,0.01,104,13
0.618,1e-05,106,98,10,100,0.01,204,13
0.646,1e-05,144,160,10,100,0.01,304,13
0.676,1e-05,193,211,10,100,0.01,404,13
0.712,1e-05,242,262,10,100,0.01,504,13
0.78,1e-05,292,312,10,100,0.01,604,13
0.834,1e-05,349,355,10,100,0.01,704,13
0.872,1e-05,405,399,10,100,0.01,804,13
0.896,1e-05,459,445,10,100,0.01,904,13
0.92,1e-05,510,494,10,100,0.01,1004,13
0.926,1e-05,559,545,10,100,0.01,1104,13
0.946,1e-05,605,599,10,100,0.01,1204,13
0.95,1e-05,655,649,10,100,0.01,1304,13
0.954,1e-05,696,708,10,100,0.01,1404,13
0.96,1e-05,744,760,10,100,0.01,1504,13
0.962,1e-05,789,815,10,100,0.01,1604,13
0.966,1e-05,831,873,10,100,0.01,1704,13
0.97,1e-05,883,921,10,100,0.01,1804,13
0.976,1e-05,932,972,10,100,0.01,1904,13
0.982,1e-05,989,1015,10,100,0.01,2004,13
0.598,1e-05,45,59,10,100,0.01,104,14
0.6,1e-05,96,108,10,100,0.01,204,14
0.634,1e-05,150,154,10,100,0.01,304,14
0.71,1e-05,213,191,10,100,0.01,404,14
0.782,1e-05,264,240,10,100,0.01,504,14
0.812,1e-05,310,294,10,100,0.01,604,14
0.848,1e-05,361,343,10,100,0.01,704,14
0.9,1e-05,413,391,10,100,0.01,804,14
0.92,1e-05,460,444,10,100,0.01,904,14
0.932,1e-05,517,487,10,100,0.01,1004,14
0.934,1e-05,564,540,10,100,0.01,1104,14
0.942,1e-05,613,591,10,100,0.01,1204,14
0.954,1e-05,663,641,10,100,0.01,1304,14
0.966,1e-05,710,694,10,100,0.01,1404,14
0.964,1e-05,752,752,10,100,0.01,1504,14
0.974,1e-05,807,797,10,100,0.01,1604,14
0.972,1e-05,859,845,10,100,0.01,1704,14
0.976,1e-05,908,896,10,100,0.01,1804,14
0.982,1e-05,959,945,10,100,0.01,1904,14
0.986,1e-05,1007,997,10,100,0.01,2004,14
0.56,1e-05,61,43,10,100,0.01,104,15
0.618,1e-05,103,101,10,100,0.01,204,15
0.648,1e-05,142,162,10,100,0.01,304,15
0.706,1e-05,195,209,10,100,0.01,404,15
0.706,1e-05,252,252,10,100,0.01,504,15
0.75,1e-05,305,299,10,100,0.01,604,15
0.828,1e-05,358,346,10,100,0.01,704,15
0.9,1e-05,408,396,10,100,0.01,804,15
0.93,1e-05,457,447,10,100,0.01,904,15
0.952,1e-05,512,492,10,100,0.01,1004,15
0.954,1e-05,561,543,10,100,0.01,1104,15
0.968,1e-05,617,587,10,100,0.01,1204,15
0.98,1e-05,670,634,10,100,0.01,1304,15
0.97,1e-05,716,688,10,100,0.01,1404,15
0.98,1e-05,763,741,10,100,0.01,1504,15
0.972,1e-05,814,790,10,100,0.01,1604,15
0.982,1e-05,859,845,10,100,0.01,1704,15
0.984,1e-05,914,890,10,100,0.01,1804,15
0.986,1e-05,960,944,10,100,0.01,1904,15
0.99,1e-05,1009,995,10,100,0.01,2004,15
0.514,1e-05,60,44,10,100,0.01,104,16
0.522,1e-05,114,90,10,100,0.01,204,16
0.508,1e-05,167,137,10,100,0.01,304,16
0.576,1e-05,224,180,10,100,0.01,404,16
0.65,1e-05,276,228,10,100,0.01,504,16
0.75,1e-05,327,277,10,100,0.01,604,16
0.806,1e-05,375,329,10,100,0.01,704,16
0.864,1e-05,424,380,10,100,0.01,804,16
0.886,1e-05,470,434,10,100,0.01,904,16
0.92,1e-05,524,480,10,100,0.01,1004,16
0.938,1e-05,575,529,10,100,0.01,1104,16
0.954,1e-05,619,585,10,100,0.01,1204,16
0.958,1e-05,672,632,10,100,0.01,1304,16
0.968,1e-05,717,687,10,100,0.01,1404,16
0.964,1e-05,766,738,10,100,0.01,1504,16
0.97,1e-05,813,791,10,100,0.01,1604,16
0.976,1e-05,870,834,10,100,0.01,1704,16
0.98,1e-05,924,880,10,100,0.01,1804,16
0.984,1e-05,969,935,10,100,0.01,1904,16
0.984,1e-05,1014,990,10,100,0.01,2004,16
0.564,1e-05,53,51,10,100,0.01,104,17
0.654,1e-05,105,99,10,100,0.01,204,17
0.66,1e-05,153,151,10,100,0.01,304,17
0.65,1e-05,203,201,10,100,0.01,404,17
0.664,1e-05,253,251,10,100,0.01,504,17
0.774,1e-05,303,301,10,100,0.01,604,17
0.878,1e-05,362,342,10,100,0.01,704,17
0.912,1e-05,414,390,10,100,0.01,804,17
0.924,1e-05,465,439,10,100,0.01,904,17
0.94,1e-05,512,492,10,100,0.01,1004,17
0.956,1e-05,558,546,10,100,0.01,1104,17
0.966,1e-05,613,591,10,100,0.01,1204,17
0.966,1e-05,664,640,10,100,0.01,1304,17
0.966,1e-05,720,684,10,100,0.01,1404,17
0.98,1e-05,771,733,10,100,0.01,1504,17
0.978,1e-05,828,776,10,100,0.01,1604,17
0.98,1e-05,877,827,10,100,0.01,1704,17
0.98,1e-05,918,886,10,100,0.01,1804,17
0.982,1e-05,962,942,10,100,0.01,1904,17
0.982,1e-05,1011,993,10,100,0.01,2004,17
0.586,1e-05,48,56,10,100,0.01,104,18
0.566,1e-05,97,107,10,100,0.01,204,18
0.612,1e-05,147,157,10,100,0.01,304,18
0.654,1e-05,196,208,10,100,0.01,404,18
0.678,1e-05,249,255,10,100,0.01,504,18
0.744,1e-05,300,304,10,100,0.01,604,18
0.788,1e-05,349,355,10,100,0.01,704,18
0.876,1e-05,393,411,10,100,0.01,804,18
0.894,1e-05,438,466,10,100,0.01,904,18
0.944,1e-05,481,523,10,100,0.01,1004,18
0.954,1e-05,530,574,10,100,0.01,1104,18
0.964,1e-05,582,622,10,100,0.01,1204,18
0.968,1e-05,632,672,10,100,0.01,1304,18
0.968,1e-05,688,716,10,100,0.01,1404,18
0.972,1e-05,745,759,10,100,0.01,1504,18
0.974,1e-05,795,809,10,100,0.01,1604,18
0.972,1e-05,848,856,10,100,0.01,1704,18
0.98,1e-05,901,903,10,100,0.01,1804,18
0.98,1e-05,948,956,10,100,0.01,1904,18
0.982,1e-05,992,1012,10,100,0.01,2004,18
0.564,1e-05,51,53,10,100,0.01,104,19
0.596,1e-05,95,109,10,100,0.01,204,19
0.606,1e-05,147,157,10,100,0.01,304,19
0.644,1e-05,208,196,10,100,0.01,404,19
0.658,1e-05,258,246,10,100,0.01,504,19
0.706,1e-05,301,303,10,100,0.01,604,19
0.73,1e-05,339,365,10,100,0.01,704,19
0.806,1e-05,393,411,10,100,0.01,804,19
0.864,1e-05,444,460,10,100,0.01,904,19
0.91,1e-05,502,502,10,100,0.01,1004,19
0.936,1e-05,554,550,10,100,0.01,1104,19
0.954,1e-05,614,590,10,100,0.01,1204,19
0.954,1e-05,658,646,10,100,0.01,1304,19
0.968,1e-05,706,698,10,100,0.01,1404,19
0.972,1e-05,748,756,10,100,0.01,1504,19
0.964,1e-05,801,803,10,100,0.01,1604,19
0.97,1e-05,854,850,10,100,0.01,1704,19
0.976,1e-05,906,898,10,100,0.01,1804,19
0.974,1e-05,949,955,10,100,0.01,1904,19
0.986,1e-05,1004,1000,10,100,0.01,2004,19
0.518,1e-05,62,42,10,100,0.01,104,20
0.566,1e-05,116,88,10,100,0.01,204,20
0.588,1e-05,164,140,10,100,0.01,304,20
0.652,1e-05,212,192,10,100,0.01,404,20
0.71,1e-05,258,246,10,100,0.01,504,20
0.758,1e-05,308,296,10,100,0.01,604,20
0.826,1e-05,349,355,10,100,0.01,704,20
0.884,1e-05,394,410,10,100,0.01,804,20
0.928,1e-05,446,458,10,100,0.01,904,20
0.956,1e-05,496,508,10,100,0.01,1004,20
0.974,1e-05,547,557,10,100,0.01,1104,20
0.968,1e-05,599,605,10,100,0.01,1204,20
0.976,1e-05,648,656,10,100,0.01,1304,20
0.976,1e-05,696,708,10,100,0.01,1404,20
0.978,1e-05,743,761,10,100,0.01,1504,20
0.986,1e-05,797,807,10,100,0.01,1604,20
0.982,1e-05,850,854,10,100,0.01,1704,20
0.986,1e-05,898,906,10,100,0.01,1804,20
0.984,1e-05,955,949,10,100,0.01,1904,20
0.99,1e-05,1004,1000,10,100,0.01,2004,20
0.48,0.0001,46,58,10,100,0.0001,104,1
0.48,0.0001,89,115,10,100,0.0001,204,1
0.48,0.0001,129,175,10,100,0.0001,304,1
0.48,0.0001,176,228,10,100,0.0001,404,1
0.488,0.0001,230,274,10,100,0.0001,504,1
0.494,0.0001,272,332,10,100,0.0001,604,1
0.494,0.0001,327,377,10,100,0.0001,704,1
0.498,0.0001,373,431,10,100,0.0001,804,1
0.498,0.0001,427,477,10,100,0.0001,904,1
0.502,0.0001,476,528,10,100,0.0001,1004,1
0.502,0.0001,525,579,10,100,0.0001,1104,1
0.51,0.0001,566,638,10,100,0.0001,1204,1
0.508,0.0001,617,687,10,100,0.0001,1304,1
0.51,0.0001,662,742,10,100,0.0001,1404,1
0.512,0.0001,716,788,10,100,0.0001,1504,1
0.516,0.0001,767,837,10,100,0.0001,1604,1
0.524,0.0001,825,879,10,100,0.0001,1704,1
0.528,0.0001,875,929,10,100,0.0001,1804,1
0.532,0.0001,930,974,10,100,0.0001,1904,1
0.54,0.0001,987,1017,10,100,0.0001,2004,1
0.486,0.0001,51,53,10,100,0.0001,104,2
0.486,0.0001,100,104,10,100,0.0001,204,2
0.486,0.0001,152,152,10,100,0.0001,304,2
0.486,0.0001,203,201,10,100,0.0001,404,2
0.488,0.0001,251,253,10,100,0.0001,504,2
0.488,0.0001,296,308,10,100,0.0001,604,2
0.488,0.0001,339,365,10,100,0.0001,704,2
0.49,0.0001,390,414,10,100,0.0001,804,2
0.492,0.0001,446,458,10,100,0.0001,904,2
0.492,0.0001,496,508,10,100,0.0001,1004,2
0.496,0.0001,550,554,10,100,0.0001,1104,2
0.5,0.0001,597,607,10,100,0.0001,1204,2
0.492,0.0001,654,650,10,100,0.0001,1304,2
0.498,0.0001,711,693,10,100,0.0001,1404,2
0.5,0.0001,752,752,10,100,0.0001,1504,2
0.496,0.0001,799,805,10,100,0.0001,1604,2
0.5,0.0001,846,858,10,100,0.0001,1704,2
0.502,0.0001,898,906,10,100,0.0001,1804,2
0.506,0.0001,951,953,10,100,0.0001,1904,2
0.514,0.0001,995,1009,10,100,0.0001,2004,2
0.486,0.0001,56,48,10,100,0.0001,104,3
0.486,0.0001,110,94,10,100,0.0001,204,3
0.486,0.0001,164,140,10,100,0.0001,304,3
0.484,0.0001,217,187,10,100,0.0001,404,3
0.484,0.0001,266,238,10,100,0.0001,504,3
0.484,0.0001,304,300,10,100,0.0001,604,3
0.484,0.0001,362,342,10,100,0.0001,704,3
0.484,0.0001,402,402,10,100,0.0001,804,3
0.484,0.0001,458,446,10,100,0.0001,904,3
0.482,0.0001,509,495,10,100,0.0001,1004,3
0.486,0.0001,558,546,10,100,0.0001,1104,3
0.488,0.0001,608,596,10,100,0.0001,1204,3
0.484,0.0001,658,646,10,100,0.0001,1304,3
0.478,0.0001,710,694,10,100,0.0001,1404,3
0.476,0.0001,755,749,10,100,0.0001,1504,3
0.482,0.0001,801,803,10,100,0.0001,1604,3
0.486,0.0001,851,853,10,100,0.0001,1704,3
0.49,0.0001,901,903,10,100,0.0001,1804,3
0.494,0.0001,959,945,10,100,0.0001,1904,3
0.494,0.0001,1007,997,10,100,0.0001,2004,3
0.502,0.0001,57,47,10,100,0.0001,104,4
0.502,0.0001,107,97,10,100,0.0001,204,4
0.502,0.0001,155,149,10,100,0.0001,304,4
0.502,0.0001,200,204,10,100,0.0001,404,4
0.502,0.0001,243,261,10,100,0.0001,504,4
0.504,0.0001,297,307,10,100,0.0001,604,4
0.504,0.0001,341,363,10,100,0.0001,704,4
0.506,0.0001,390,414,10,100,0.0001,804,4
0.506,0.0001,443,461,10,100,0.0001,904,4
0.51,0.0001,494,510,10,100,0.0001,1004,4
0.512,0.0001,538,566,10,100,0.0001,1104,4
0.514,0.0001,591,613,10,100,0.0001,1204,4
0.52,0.0001,642,662,10,100,0.0001,1304,4
0.52,0.0001,692,712,10,100,0.0001,1404,4
0.522,0.0001,747,757,10,100,0.0001,1504,4
0.52,0.0001,798,806,10,100,0.0001,1604,4
0.522,0.0001,841,863,10,100,0.0001,1704,4
0.524,0.0001,892,912,10,100,0.0001,1804,4
0.528,0.0001,950,954,10,100,0.0001,1904,4
0.54,0.0001,999,1005,10,100,0.0001,2004,4
0.516,0.0001,61,43,10,100,0.0001,104,5
0.52,0.0001,118,86,10,100,0.0001,204,5
0.51,0.0001,171,133,10,100,0.0001,304,5
0.516,0.0001,227,177,10,100,0.0001,404,5
0.518,0.0001,285,219,10,100,0.0001,504,5
0.512,0.0001,341,263,10,100,0.0001,604,5
0.514,0.0001,385,319,10,100,0.0001,704,5
0.52,0.0001,432,372,10,100,0.0001,804,5
0.522,0.0001,482,422,10,100,0.0001,904,5
0.526,0.0001,528,476,10,100,0.0001,1004,5
0.53,0.0001,569,535,10,100,0.0001,1104,5
0.538,0.0001,621,583,10,100,0.0001,1204,5
0.54,0.0001,665,639,10,100,0.0001,1304,5
0.54,0.0001,708,696,10,100,0.0001,1404,5
0.54,0.0001,761,743,10,100,0.0001,1504,5
0.548,0.0001,804,800,10,100,0.0001,1604,5
0.556,0.0001,850,854,10,100,0.0001,1704,5
0.56,0.0001,904,900,10,100,0.0001,1804,5
0.584,0.0001,953,951,10,100,0.0001,1904,5
0.592,0.0001,998,1006,10,100,0.0001,2004,5
0.518,0.0001,54,50,10,100,0.0001,104,6
0.524,0.0001,110,94,10,100,0.0001,204,6
0.532,0.0001,158,146,10,100,0.0001,304,6
0.53,0.0001,222,182,10,100,0.0001,404,6
0.53,0.0001,274,230,10,100,0.0001,504,6
0.53,0.0001,326,278,10,100,0.0001,604,6
0.53,0.0001,380,324,10,100,0.0001,704,6
0.528,0.0001,437,367,10,100,0.0001,804,6
0.528,0.0001,491,413,10,100,0.0001,904,6
0.534,0.0001,537,467,10,100,0.0001,1004,6
0.536,0.0001,584,520,10,100,0.0001,1104,6
0.546,0.0001,635,569,10,100,0.0001,1204,6
0.548,0.0001,674,630,10,100,0.0001,1304,6
0.55,0.0001,722,682,10,100,0.0001,1404,6
0.558,0.0001,775,729,10,100,0.0001,1504,6
0.566,0.0001,821,783,10,100,0.0001,1604,6
0.572,0.0001,864,840,10,100,0.0001,1704,6
0.578,0.0001,910,894,10,100,0.0001,1804,6
0.582,0.0001,965,939,10,100,0.0001,1904,6
0.578,0.0001,1005,999,10,100,0.0001,2004,6
0.498,0.0001,53,51,10,100,0.0001,104,7
0.498,0.0001,100,104,10,100,0.0001,204,7
0.496,0.0001,144,160,10,100,0.0001,304,7
0.498,0.0001,193,211,10,100,0.0001,404,7
0.498,0.0001,248,256,10,100,0.0001,504,7
0.498,0.0001,286,318,10,100,0.0001,604,7
0.498,0.0001,328,376,10,100,0.0001,704,7
0.5,0.0001,383,421,10,100,0.0001,804,7
0.508,0.0001,431,473,10,100,0.0001,904,7
0.522,0.0001,486,518,10,100,0.0001,1004,7
0.522,0.0001,544,560,10,100,0.0001,1104,7
0.522,0.0001,591,613,10,100,0.0001,1204,7
0.516,0.0001,637,667,10,100,0.0001,1304,7
0.518,0.0001,691,713,10,100,0.0001,1404,7
0.52,0.0001,750,754,10,100,0.0001,1504,7
0.526,0.0001,801,803,10,100,0.0001,1604,7
0.528,0.0001,856,848,10,100,0.0001,1704,7
0.532,0.0001,906,898,10,100,0.0001,1804,7
0.532,0.0001,954,950,10,100,0.0001,1904,7
0.54,0.0001,1008,996,10,100,0.0001,2004,7
0.54,0.0001,42,62,10,100,0.0001,104,8
0.542,0.0001,91,113,10,100,0.0001,204,8
0.542,0.0001,133,171,10,100,0.0001,304,8
0.544,0.0001,187,217,10,100,0.0001,404,8
0.546,0.0001,239,265,10,100,0.0001,504,8
0.552,0.0001,292,312,10,100,0.0001,604,8
0.556,0.0001,345,359,10,100,0.0001,704,8
0.564,0.0001,398,406,10,100,0.0001,804,8
0.57,0.0001,451,453,10,100,0.0001,904,8
0.57,0.0001,497,507,10,100,0.0001,1004,8
0.572,0.0001,550,554,10,100,0.0001,1104,8
0.574,0.0001,596,608,10,100,0.0001,1204,8
0.582,0.0001,648,656,10,100,0.0001,1304,8
0.584,0.0001,705,699,10,100,0.0001,1404,8
0.586,0.0001,762,742,10,100,0.0001,1504,8
0.59,0.0001,818,786,10,100,0.0001,1604,8
0.588,0.0001,874,830,10,100,0.0001,1704,8
0.59,0.0001,931,873,10,100,0.0001,1804,8
0.594,0.0001,979,925,10,100,0.0001,1904,8
0.612,0.0001,1026,978,10,100,0.0001,2004,8
0.508,0.0001,49,55,10,100,0.0001,104,9
0.508,0.0001,99,105,10,100,0.0001,204,9
0.508,0.0001,147,157,10,100,0.0001,304,9
0.508,0.0001,185,219,10,100,0.0001,404,9
0.51,0.0001,242,262,10,100,0.0001,504,9
0.504,0.0001,288,316,10,100,0.0001,604,9
0.506,0.0001,340,364,10,100,0.0001,704,9
0.504,0.0001,399,405,10,100,0.0001,804,9
0.506,0.0001,447,457,10,100,0.0001,904,9
0.514,0.0001,491,513,10,100,0.0001,1004,9
0.516,0.0001,541,563,10,100,0.0001,1104,9
0.524,0.0001,587,617,10,100,0.0001,1204,9
0.526,0.0001,643,661,10,100,0.0001,1304,9
0.53,0.0001,695,709,10,100,0.0001,1404,9
0.528,0.0001,745,759,10,100,0.0001,1504,9
0.532,0.0001,791,813,10,100,0.0001,1604,9
0.536,0.0001,830,874,10,100,0.0001,1704,9
0.544,0.0001,882,922,10,100,0.0001,1804,9
0.544,0.0001,934,970,10,100,0.0001,1904,9
0.548,0.0001,980,1024,10,100,0.0001,2004,9
0.484,0.0001,49,55,10,100,0.0001,104,10
0.482,0.0001,103,101,10,100,0.0001,204,10
0.482,0.0001,151,153,10,100,0.0001,304,10
0.484,0.0001,194,210,10,100,0.0001,404,10
0.484,0.0001,250,254,10,100,0.0001,504,10
0.484,0.0001,299,305,10,100,0.0001,604,10
0.482,0.0001,346,358,10,100,0.0001,704,10
0.496,0.0001,399,405,10,100,0.0001,804,10
0.496,0.0001,447,457,10,100,0.0001,904,10
0.51,0.0001,498,506,10,100,0.0001,1004,10
0.512,0.0001,549,555,10,100,0.0001,1104,10
0.52,0.0001,605,599,10,100,0.0001,1204,10
0.524,0.0001,652,652,10,100,0.0001,1304,10
0.524,0.0001,691,713,10,100,0.0001,1404,10
0.524,0.0001,752,752,10,100,0.0001,1504,10
0.532,0.0001,802,802,10,100,0.0001,1604,10
0.54,0.0001,860,844,10,100,0.0001,1704,10
0.546,0.0001,908,896,10,100,0.0001,1804,10
0.55,0.0001,950,954,10,100,0.0001,1904,10
0.558,0.0001,1000,1004,10,100,0.0001,2004,10
0.508,0.0001,63,41,10,100,0.0001,104,11
0.508,0.0001,108,96,10,100,0.0001,204,11
0.508,0.0001,153,151,10,100,0.0001,304,11
0.508,0.0001,209,195,10,100,0.0001,404,11
0.508,0.0001,261,243,10,100,0.0001,504,11
0.508,0.0001,312,292,10,100,0.0001,604,11
0.51,0.0001,373,331,10,100,0.0001,704,11
0.512,0.0001,419,385,10,100,0.0001,804,11
0.514,0.0001,470,434,10,100,0.0001,904,11
0.514,0.0001,514,490,10,100,0.0001,1004,11
0.514,0.0001,565,539,10,100,0.0001,1104,11
0.514,0.0001,603,601,10,100,0.0001,1204,11
0.516,0.0001,656,648,10,100,0.0001,1304,11
0.52,0.0001,707,697,10,100,0.0001,1404,11
0.524,0.0001,759,745,10,100,0.0001,1504,11
0.528,0.0001,807,797,10,100,0.0001,1604,11
0.528,0.0001,849,855,10,100,0.0001,1704,11
0.53,0.0001,896,908,10,100,0.0001,1804,11
0.53,0.0001,952,952,10,100,0.0001,1904,11
0.528,0.0001,1004,1000,10,100,0.0001,2004,11
0.502,0.0001,47,57,10,100,0.0001,104,12
0.502,0.0001,98,106,10,100,0.0001,204,12
0.5,0.0001,142,162,10,100,0.0001,304,12
0.5,0.0001,191,213,10,100,0.0001,404,12
0.502,0.0001,243,261,10,100,0.0001,504,12
0.5,0.0001,301,303,10,100,0.0001,604,12
0.5,0.0001,345,359,10,100,0.0001,704,12
0.5,0.0001,394,410,10,100,0.0001,804,12
0.502,0.0001,447,457,10,100,0.0001,904,12
0.504,0.0001,500,504,10,100,0.0001,1004,12
0.506,0.0001,548,556,10,100,0.0001,1104,12
0.504,0.0001,594,610,10,100,0.0001,1204,12
0.504,0.0001,641,663,10,100,0.0001,1304,12
0.506,0.0001,687,717,10,100,0.0001,1404,12
0.508,0.0001,752,752,10,100,0.0001,1504,12
0.508,0.0001,795,809,10,100,0.0001,1604,12
0.508,0.0001,842,862,10,100,0.0001,1704,12
0.508,0.0001,887,917,10,100,0.0001,1804,12
0.512,0.0001,940,964,10,100,0.0001,1904,12
0.514,0.0001,987,1017,10,100,0.0001,2004,12
0.518,0.0001,49,55,10,100,0.0001,104,13
0.518,0.0001,97,107,10,100,0.0001,204,13
0.516,0.0001,144,160,10,100,0.0001,304,13
0.52,0.0001,197,207,10,100,0.0001,404,13
0.518,0.0001,251,253,10,100,0.0001,504,13
0.52,0.0001,301,303,10,100,0.0001,604,13
0.52,0.0001,357,347,10,100,0.0001,704,13
0.518,0.0001,400,404,10,100,0.0001,804,13
0.516,0.0001,448,456,10,100,0.0001,904,13
0.522,0.0001,493,511,10,100,0.0001,1004,13
0.528,0.0001,544,560,10,100,0.0001,1104,13
0.528,0.0001,584,620,10,100,0.0001,1204,13
0.53,0.0001,628,676,10,100,0.0001,1304,13
0.53,0.0001,680,724,10,100,0.0001,1404,13
0.53,0.0001,732,772,10,100,0.0001,1504,13
0.54,0.0001,785,819,10,100,0.0001,1604,13
0.538,0.0001,839,865,10,100,0.0001,1704,13
0.54,0.0001,882,922,10,100,0.0001,1804,13
0.546,0.0001,938,966,10,100,0.0001,1904,13
0.546,0.0001,989,1015,10,100,0.0001,2004,13
0.538,0.0001,49,55,10,100,0.0001,104,14
0.536,0.0001,101,103,10,100,0.0001,204,14
0.542,0.0001,144,160,10,100,0.0001,304,14
0.542,0.0001,196,208,10,100,0.0001,404,14
0.542,0.0001,244,260,10,100,0.0001,504,14
0.538,0.0001,289,315,10,100,0.0001,604,14
0.54,0.0001,342,362,10,100,0.0001,704,14
0.542,0.0001,407,397,10,100,0.0001,804,14
0.542,0.0001,450,454,10,100,0.0001,904,14
0.544,0.0001,492,512,10,100,0.0001,1004,14
0.544,0.0001,537,567,10,100,0.0001,1104,14
0.54,0.0001,591,613,10,100,0.0001,1204,14
0.546,0.0001,646,658,10,100,0.0001,1304,14
0.546,0.0001,696,708,10,100,0.0001,1404,14
0.554,0.0001,740,764,10,100,0.0001,1504,14
0.564,0.0001,795,809,10,100,0.0001,1604,14
0.56,0.0001,844,860,10,100,0.0001,1704,14
0.568,0.0001,884,920,10,100,0.0001,1804,14
0.572,0.0001,932,972,10,100,0.0001,1904,14
0.574,0.0001,992,1012,10,100,0.0001,2004,14
0.466,0.0001,60,44,10,100,0.0001,104,15
0.466,0.0001,105,99,10,100,0.0001,204,15
0.466,0.0001,162,142,10,100,0.0001,304,15
0.466,0.0001,204,200,10,100,0.0001,404,15
0.464,0.0001,258,246,10,100,0.0001,504,15
0.466,0.0001,300,304,10,100,0.0001,604,15
0.462,0.0001,348,356,10,100,0.0001,704,15
0.464,0.0001,392,412,10,100,0.0001,804,15
0.47,0.0001,438,466,10,100,0.0001,904,15
0.476,0.0001,488,516,10,100,0.0001,1004,15
0.476,0.0001,534,570,10,100,0.0001,1104,15
0.476,0.0001,593,611,10,100,0.0001,1204,15
0.48,0.0001,648,656,10,100,0.0001,1304,15
0.49,0.0001,694,710,10,100,0.0001,1404,15
0.494,0.0001,745,759,10,100,0.0001,1504,15
0.496,0.0001,792,812,10,100,0.0001,1604,15
0.494,0.0001,852,852,10,100,0.0001,1704,15
0.498,0.0001,896,908,10,100,0.0001,1804,15
0.508,0.0001,943,961,10,100,0.0001,1904,15
0.514,0.0001,995,1009,10,100,0.0001,2004,15
0.484,0.0001,50,54,10,100,0.0001,104,16
0.486,0.0001,105,99,10,100,0.0001,204,16
0.484,0.0001,162,142,10,100,0.0001,304,16
0.486,0.0001,214,190,10,100,0.0001,404,16
0.486,0.0001,267,237,10,100,0.0001,504,16
0.488,0.0001,320,284,10,100,0.0001,604,16
0.492,0.0001,373,331,10,100,0.0001,704,16
0.492,0.0001,418,386,10,100,0.0001,804,16
0.496,0.0001,463,441,10,100,0.0001,904,16
0.496,0.0001,515,489,10,100,0.0001,1004,16
0.496,0.0001,560,544,10,100,0.0001,1104,16
0.504,0.0001,610,594,10,100,0.0001,1204,16
0.506,0.0001,652,652,10,100,0.0001,1304,16
0.508,0.0001,700,704,10,100,0.0001,1404,16
0.52,0.0001,757,747,10,100,0.0001,1504,16
0.526,0.0001,804,800,10,100,0.0001,1604,16
0.534,0.0001,853,851,10,100,0.0001,1704,16
0.538,0.0001,908,896,10,100,0.0001,1804,16
0.542,0.0001,956,948,10,100,0.0001,1904,16
0.548,0.0001,1008,996,10,100,0.0001,2004,16
0.534,0.0001,49,55,10,100,0.0001,104,17
0.532,0.0001,93,111,10,100,0.0001,204,17
0.532,0.0001,137,167,10,100,0.0001,304,17
0.534,0.0001,192,212,10,100,0.0001,404,17
0.534,0.0001,246,258,10,100,0.0001,504,17
0.536,0.0001,294,310,10,100,0.0001,604,17
0.536,0.0001,341,363,10,100,0.0001,704,17
0.538,0.0001,398,406,10,100,0.0001,804,17
0.54,0.0001,452,452,10,100,0.0001,904,17
0.544,0.0001,506,498,10,100,0.0001,1004,17
0.546,0.0001,563,541,10,100,0.0001,1104,17
0.548,0.0001,615,589,10,100,0.0001,1204,17
0.55,0.0001,666,638,10,100,0.0001,1304,17
0.552,0.0001,712,692,10,100,0.0001,1404,17
0.558,0.0001,761,743,10,100,0.0001,1504,17
0.558,0.0001,811,793,10,100,0.0001,1604,17
0.566,0.0001,862,842,10,100,0.0001,1704,17
0.568,0.0001,906,898,10,100,0.0001,1804,17
0.566,0.0001,957,947,10,100,0.0001,1904,17
0.57,0.0001,1003,1001,10,100,0.0001,2004,17
0.502,0.0001,51,53,10,100,0.0001,104,18
0.502,0.0001,98,106,10,100,0.0001,204,18
0.502,0.0001,149,155,10,100,0.0001,304,18
0.502,0.0001,200,204,10,100,0.0001,404,18
0.502,0.0001,249,255,10,100,0.0001,504,18
0.506,0.0001,287,317,10,100,0.0001,604,18
0.506,0.0001,338,366,10,100,0.0001,704,18
0.506,0.0001,387,417,10,100,0.0001,804,18
0.508,0.0001,444,460,10,100,0.0001,904,18
0.51,0.0001,488,516,10,100,0.0001,1004,18
0.51,0.0001,541,563,10,100,0.0001,1104,18
0.512,0.0001,591,613,10,100,0.0001,1204,18
0.514,0.0001,645,659,10,100,0.0001,1304,18
0.522,0.0001,698,706,10,100,0.0001,1404,18
0.526,0.0001,754,750,10,100,0.0001,1504,18
0.53,0.0001,806,798,10,100,0.0001,1604,18
0.534,0.0001,849,855,10,100,0.0001,1704,18
0.53,0.0001,904,900,10,100,0.0001,1804,18
0.528,0.0001,951,953,10,100,0.0001,1904,18
0.534,0.0001,1001,1003,10,100,0.0001,2004,18
0.48,0.0001,47,57,10,100,0.0001,104,19
0.478,0.0001,97,107,10,100,0.0001,204,19
0.478,0.0001,149,155,10,100,0.0001,304,19
0.48,0.0001,189,215,10,100,0.0001,404,19
0.48,0.0001,230,274,10,100,0.0001,504,19
0.484,0.0001,289,315,10,100,0.0001,604,19
0.49,0.0001,337,367,10,100,0.0001,704,19
0.492,0.0001,383,421,10,100,0.0001,804,19
0.494,0.0001,442,462,10,100,0.0001,904,19
0.496,0.0001,487,517,10,100,0.0001,1004,19
0.502,0.0001,542,562,10,100,0.0001,1104,19
0.502,0.0001,594,610,10,100,0.0001,1204,19
0.5,0.0001,648,656,10,100,0.0001,1304,19
0.502,0.0001,696,708,10,100,0.0001,1404,19
0.506,0.0001,752,752,10,100,0.0001,1504,19
0.508,0.0001,797,807,10,100,0.0001,1604,19
0.514,0.0001,846,858,10,100,0.0001,1704,19
0.518,0.0001,894,910,10,100,0.0001,1804,19
0.516,0.0001,946,958,10,100,0.0001,1904,19
0.526,0.0001,998,1006,10,100,0.0001,2004,19
0.464,0.0001,51,53,10,100,0.0001,104,20
0.464,0.0001,98,106,10,100,0.0001,204,20
0.464,0.0001,154,150,10,100,0.0001,304,20
0.464,0.0001,199,205,10,100,0.0001,404,20
0.466,0.0001,242,262,10,100,0.0001,504,20
0.462,0.0001,294,310,10,100,0.0001,604,20
0.462,0.0001,348,356,10,100,0.0001,704,20
0.46,0.0001,402,402,10,100,0.0001,804,20
0.456,0.0001,453,451,10,100,0.0001,904,20
0.456,0.0001,510,494,10,100,0.0001,1004,20
0.454,0.0001,556,548,10,100,0.0001,1104,20
0.452,0.0001,610,594,10,100,0.0001,1204,20
0.456,0.0001,662,642,10,100,0.0001,1304,20
0.454,0.0001,709,695,10,100,0.0001,1404,20
0.458,0.0001,763,741,10,100,0.0001,1504,20
0.46,0.0001,803,801,10,100,0.0001,1604,20
0.462,0.0001,845,859,10,100,0.0001,1704,20
0.466,0.0001,898,906,10,100,0.0001,1804,20
0.468,0.0001,945,959,10,100,0.0001,1904,20
0.478,0.0001,1004,1000,10,100,0.0001,2004,20
0.472,0.0001,49,55,10,100,0.001,104,1
0.466,0.0001,97,107,10,100,0.001,204,1
0.47,0.0001,141,163,10,100,0.001,304,1
0.48,0.0001,195,209,10,100,0.001,404,1
0.484,0.0001,243,261,10,100,0.001,504,1
0.5,0.0001,297,307,10,100,0.001,604,1
0.508,0.0001,347,357,10,100,0.001,704,1
0.512,0.0001,396,408,10,100,0.001,804,1
0.526,0.0001,448,456,10,100,0.001,904,1
0.552,0.0001,498,506,10,100,0.001,1004,1
0.586,0.0001,544,560,10,100,0.001,1104,1
0.622,0.0001,598,606,10,100,0.001,1204,1
0.664,0.0001,651,653,10,100,0.001,1304,1
0.702,0.0001,700,704,10,100,0.001,1404,1
0.728,0.0001,753,751,10,100,0.001,1504,1
0.776,0.0001,801,803,10,100,0.001,1604,1
0.794,0.0001,849,855,10,100,0.001,1704,1
0.828,0.0001,896,908,10,100,0.001,1804,1
0.866,0.0001,944,960,10,100,0.001,1904,1
0.87,0.0001,994,1010,10,100,0.001,2004,1
0.532,0.0001,54,50,10,100,0.001,104,2
0.532,0.0001,105,99,10,100,0.001,204,2
0.538,0.0001,158,146,10,100,0.001,304,2
0.558,0.0001,208,196,10,100,0.001,404,2
0.58,0.0001,254,250,10,100,0.001,504,2
0.588,0.0001,304,300,10,100,0.001,604,2
0.588,0.0001,355,349,10,100,0.001,704,2
0.632,0.0001,412,392,10,100,0.001,804,2
0.67,0.0001,463,441,10,100,0.001,904,2
0.682,0.0001,507,497,10,100,0.001,1004,2
0.702,0.0001,552,552,10,100,0.001,1104,2
0.726,0.0001,603,601,10,100,0.001,1204,2
0.74,0.0001,658,646,10,100,0.001,1304,2
0.77,0.0001,712,692,10,100,0.001,1404,2
0.804,0.0001,752,752,10,100,0.001,1504,2
0.83,0.0001,800,804,10,100,0.001,1604,2
0.862,0.0001,853,851,10,100,0.001,1704,2
0.876,0.0001,901,903,10,100,0.001,1804,2
0.864,0.0001,953,951,10,100,0.001,1904,2
0.888,0.0001,999,1005,10,100,0.001,2004,2
0.51,0.0001,53,51,10,100,0.001,104,3
0.512,0.0001,110,94,10,100,0.001,204,3
0.51,0.0001,148,156,10,100,0.001,304,3
0.524,0.0001,195,209,10,100,0.001,404,3
0.534,0.0001,244,260,10,100,0.001,504,3
0.55,0.0001,287,317,10,100,0.001,604,3
0.59,0.0001,330,374,10,100,0.001,704,3
0.604,0.0001,378,426,10,100,0.001,804,3
0.604,0.0001,437,467,10,100,0.001,904,3
0.622,0.0001,491,513,10,100,0.001,1004,3
0.62,0.0001,542,562,10,100,0.001,1104,3
0.616,0.0001,589,615,10,100,0.001,1204,3
0.632,0.0001,637,667,10,100,0.001,1304,3
0.672,0.0001,695,709,10,100,0.001,1404,3
0.7,0.0001,753,751,10,100,0.001,1504,3
0.73,0.0001,795,809,10,100,0.001,1604,3
0.762,0.0001,842,862,10,100,0.001,1704,3
0.794,0.0001,891,913,10,100,0.001,1804,3
0.848,0.0001,938,966,10,100,0.001,1904,3
0.87,0.0001,997,1007,10,100,0.001,2004,3
0.534,0.0001,59,45,10,100,0.001,104,4
0.542,0.0001,99,105,10,100,0.001,204,4
0.556,0.0001,151,153,10,100,0.001,304,4
0.56,0.0001,197,207,10,100,0.001,404,4
0.56,0.0001,246,258,10,100,0.001,504,4
0.598,0.0001,296,308,10,100,0.001,604,4
0.6,0.0001,346,358,10,100,0.001,704,4
0.602,0.0001,401,403,10,100,0.001,804,4
0.606,0.0001,453,451,10,100,0.001,904,4
0.614,0.0001,499,505,10,100,0.001,1004,4
0.634,0.0001,541,563,10,100,0.001,1104,4
0.66,0.0001,601,603,10,100,0.001,1204,4
0.686,0.0001,655,649,10,100,0.001,1304,4
0.722,0.0001,701,703,10,100,0.001,1404,4
0.746,0.0001,745,759,10,100,0.001,1504,4
0.768,0.0001,797,807,10,100,0.001,1604,4
0.784,0.0001,843,861,10,100,0.001,1704,4
0.812,0.0001,881,923,10,100,0.001,1804,4
0.824,0.0001,933,971,10,100,0.001,1904,4
0.85,0.0001,987,1017,10,100,0.001,2004,4
0.496,0.0001,43,61,10,100,0.001,104,5
0.508,0.0001,95,109,10,100,0.001,204,5
0.508,0.0001,152,152,10,100,0.001,304,5
0.512,0.0001,208,196,10,100,0.001,404,5
0.53,0.0001,259,245,10,100,0.001,504,5
0.554,0.0001,307,297,10,100,0.001,604,5
0.566,0.0001,357,347,10,100,0.001,704,5
0.576,0.0001,412,392,10,100,0.001,804,5
0.598,0.0001,460,444,10,100,0.001,904,5
0.622,0.0001,503,501,10,100,0.001,1004,5
0.656,0.0001,549,555,10,100,0.001,1104,5
0.71,0.0001,598,606,10,100,0.001,1204,5
0.734,0.0001,647,657,10,100,0.001,1304,5
0.75,0.0001,689,715,10,100,0.001,1404,5
0.77,0.0001,739,765,10,100,0.001,1504,5
0.786,0.0001,785,819,10,100,0.001,1604,5
0.782,0.0001,837,867,10,100,0.001,1704,5
0.812,0.0001,888,916,10,100,0.001,1804,5
0.838,0.0001,940,964,10,100,0.001,1904,5
0.856,0.0001,990,1014,10,100,0.001,2004,5
0.518,0.0001,46,58,10,100,0.001,104,6
0.514,0.0001,92,112,10,100,0.001,204,6
0.514,0.0001,139,165,10,100,0.001,304,6
0.518,0.0001,185,219,10,100,0.001,404,6
0.516,0.0001,234,270,10,100,0.001,504,6
0.524,0.0001,282,322,10,100,0.001,604,6
0.536,0.0001,330,374,10,100,0.001,704,6
0.558,0.0001,386,418,10,100,0.001,804,6
0.568,0.0001,438,466,10,100,0.001,904,6
0.596,0.0001,502,502,10,100,0.001,1004,6
0.642,0.0001,554,550,10,100,0.001,1104,6
0.664,0.0001,599,605,10,100,0.001,1204,6
0.7,0.0001,643,661,10,100,0.001,1304,6
0.726,0.0001,691,713,10,100,0.001,1404,6
0.746,0.0001,747,757,10,100,0.001,1504,6
0.778,0.0001,800,804,10,100,0.001,1604,6
0.814,0.0001,858,846,10,100,0.001,1704,6
0.84,0.0001,908,896,10,100,0.001,1804,6
0.87,0.0001,959,945,10,100,0.001,1904,6
0.896,0.0001,1007,997,10,100,0.001,2004,6
0.462,0.0001,58,46,10,100,0.001,104,7
0.47,0.0001,104,100,10,100,0.001,204,7
0.478,0.0001,162,142,10,100,0.001,304,7
0.5,0.0001,215,189,10,100,0.001,404,7
0.512,0.0001,271,233,10,100,0.001,504,7
0.538,0.0001,310,294,10,100,0.001,604,7
0.55,0.0001,368,336,10,100,0.001,704,7
0.568,0.0001,411,393,10,100,0.001,804,7
0.586,0.0001,460,444,10,100,0.001,904,7
0.61,0.0001,516,488,10,100,0.001,1004,7
0.614,0.0001,565,539,10,100,0.001,1104,7
0.644,0.0001,613,591,10,100,0.001,1204,7
0.67,0.0001,668,636,10,100,0.001,1304,7
0.702,0.0001,723,681,10,100,0.001,1404,7
0.72,0.0001,768,736,10,100,0.001,1504,7
0.754,0.0001,813,791,10,100,0.001,1604,7
0.78,0.0001,861,843,10,100,0.001,1704,7
0.796,0.0001,908,896,10,100,0.001,1804,7
0.82,0.0001,960,944,10,100,0.001,1904,7
0.848,0.0001,1012,992,10,100,0.001,2004,7
0.516,0.0001,37,67,10,100,0.001,104,8
0.55,0.0001,94,110,10,100,0.001,204,8
0.556,0.0001,154,150,10,100,0.001,304,8
0.562,0.0001,202,202,10,100,0.001,404,8
0.57,0.0001,253,251,10,100,0.001,504,8
0.574,0.0001,302,302,10,100,0.001,604,8
0.602,0.0001,355,349,10,100,0.001,704,8
0.626,0.0001,404,400,10,100,0.001,804,8
0.64,0.0001,461,443,10,100,0.001,904,8
0.656,0.0001,508,496,10,100,0.001,1004,8
0.688,0.0001,553,551,10,100,0.001,1104,8
0.712,0.0001,609,595,10,100,0.001,1204,8
0.74,0.0001,664,640,10,100,0.001,1304,8
0.772,0.0001,709,695,10,100,0.001,1404,8
0.802,0.0001,766,738,10,100,0.001,1504,8
0.828,0.0001,806,798,10,100,0.001,1604,8
0.856,0.0001,845,859,10,100,0.001,1704,8
0.874,0.0001,895,909,10,100,0.001,1804,8
0.9,0.0001,944,960,10,100,0.001,1904,8
0.916,0.0001,996,1008,10,100,0.001,2004,8
0.476,0.0001,51,53,10,100,0.001,104,9
0.486,0.0001,93,111,10,100,0.001,204,9
0.496,0.0001,144,160,10,100,0.001,304,9
0.506,0.0001,192,212,10,100,0.001,404,9
0.51,0.0001,235,269,10,100,0.001,504,9
0.504,0.0001,283,321,10,100,0.001,604,9
0.51,0.0001,328,376,10,100,0.001,704,9
0.518,0.0001,383,421,10,100,0.001,804,9
0.542,0.0001,437,467,10,100,0.001,904,9
0.578,0.0001,480,524,10,100,0.001,1004,9
0.616,0.0001,532,572,10,100,0.001,1104,9
0.644,0.0001,583,621,10,100,0.001,1204,9
0.666,0.0001,634,670,10,100,0.001,1304,9
0.69,0.0001,673,731,10,100,0.001,1404,9
0.694,0.0001,727,777,10,100,0.001,1504,9
0.736,0.0001,771,833,10,100,0.001,1604,9
0.786,0.0001,830,874,10,100,0.001,1704,9
0.824,0.0001,879,925,10,100,0.001,1804,9
0.838,0.0001,928,976,10,100,0.001,1904,9
0.864,0.0001,976,1028,10,100,0.001,2004,9
0.482,0.0001,51,53,10,100,0.001,104,10
0.476,0.0001,96,108,10,100,0.001,204,10
0.488,0.0001,153,151,10,100,0.001,304,10
0.502,0.0001,200,204,10,100,0.001,404,10
0.508,0.0001,248,256,10,100,0.001,504,10
0.52,0.0001,297,307,10,100,0.001,604,10
0.532,0.0001,361,343,10,100,0.001,704,10
0.562,0.0001,407,397,10,100,0.001,804,10
0.588,0.0001,456,448,10,100,0.001,904,10
0.628,0.0001,505,499,10,100,0.001,1004,10
0.67,0.0001,552,552,10,100,0.001,1104,10
0.716,0.0001,603,601,10,100,0.001,1204,10
0.726,0.0001,651,653,10,100,0.001,1304,10
0.748,0.0001,694,710,10,100,0.001,1404,10
0.762,0.0001,745,759,10,100,0.001,1504,10
0.784,0.0001,800,804,10,100,0.001,1604,10
0.792,0.0001,852,852,10,100,0.001,1704,10
0.824,0.0001,902,902,10,100,0.001,1804,10
0.848,0.0001,956,948,10,100,0.001,1904,10
0.858,0.0001,1010,994,10,100,0.001,2004,10
0.542,0.0001,53,51,10,100,0.001,104,11
0.552,0.0001,96,108,10,100,0.001,204,11
0.562,0.0001,141,163,10,100,0.001,304,11
0.582,0.0001,189,215,10,100,0.001,404,11
0.578,0.0001,244,260,10,100,0.001,504,11
0.576,0.0001,304,300,10,100,0.001,604,11
0.58,0.0001,356,348,10,100,0.001,704,11
0.604,0.0001,401,403,10,100,0.001,804,11
0.626,0.0001,465,439,10,100,0.001,904,11
0.66,0.0001,525,479,10,100,0.001,1004,11
0.682,0.0001,582,522,10,100,0.001,1104,11
0.702,0.0001,633,571,10,100,0.001,1204,11
0.718,0.0001,680,624,10,100,0.001,1304,11
0.754,0.0001,728,676,10,100,0.001,1404,11
0.734,0.0001,782,722,10,100,0.001,1504,11
0.774,0.0001,827,777,10,100,0.001,1604,11
0.792,0.0001,883,821,10,100,0.001,1704,11
0.882,0.0001,923,881,10,100,0.001,1804,11
0.922,0.0001,972,932,10,100,0.001,1904,11
0.932,0.0001,1011,993,10,100,0.001,2004,11
0.454,0.0001,46,58,10,100,0.001,104,12
0.456,0.0001,91,113,10,100,0.001,204,12
0.466,0.0001,143,161,10,100,0.001,304,12
0.478,0.0001,203,201,10,100,0.001,404,12
0.478,0.0001,249,255,10,100,0.001,504,12
0.498,0.0001,302,302,10,100,0.001,604,12
0.506,0.0001,348,356,10,100,0.001,704,12
0.524,0.0001,392,412,10,100,0.001,804,12
0.546,0.0001,443,461,10,100,0.001,904,12
0.588,0.0001,496,508,10,100,0.001,1004,12
0.618,0.0001,554,550,10,100,0.001,1104,12
0.642,0.0001,594,610,10,100,0.001,1204,12
0.654,0.0001,643,661,10,100,0.001,1304,12
0.682,0.0001,695,709,10,100,0.001,1404,12
0.706,0.0001,750,754,10,100,0.001,1504,12
0.73,0.0001,802,802,10,100,0.001,1604,12
0.768,0.0001,847,857,10,100,0.001,1704,12
0.8,0.0001,898,906,10,100,0.001,1804,12
0.822,0.0001,950,954,10,100,0.001,1904,12
0.84,0.0001,993,1011,10,100,0.001,2004,12
0.442,0.0001,43,61,10,100,0.001,104,13
0.446,0.0001,89,115,10,100,0.001,204,13
0.448,0.0001,138,166,10,100,0.001,304,13
0.452,0.0001,187,217,10,100,0.001,404,13
0.466,0.0001,233,271,10,100,0.001,504,13
0.48,0.0001,279,325,10,100,0.001,604,13
0.498,0.0001,330,374,10,100,0.001,704,13
0.524,0.0001,381,423,10,100,0.001,804,13
0.556,0.0001,438,466,10,100,0.001,904,13
0.59,0.0001,490,514,10,100,0.001,1004,13
0.622,0.0001,535,569,10,100,0.001,1104,13
0.66,0.0001,586,618,10,100,0.001,1204,13
0.676,0.0001,632,672,10,100,0.001,1304,13
0.702,0.0001,677,727,10,100,0.001,1404,13
0.73,0.0001,728,776,10,100,0.001,1504,13
0.776,0.0001,776,828,10,100,0.001,1604,13
0.792,0.0001,825,879,10,100,0.001,1704,13
0.83,0.0001,882,922,10,100,0.001,1804,13
0.826,0.0001,931,973,10,100,0.001,1904,13
0.856,0.0001,983,1021,10,100,0.001,2004,13
0.532,0.0001,49,55,10,100,0.001,104,14
0.554,0.0001,100,104,10,100,0.001,204,14
0.57,0.0001,149,155,10,100,0.001,304,14
0.566,0.0001,197,207,10,100,0.001,404,14
0.578,0.0001,253,251,10,100,0.001,504,14
0.594,0.0001,295,309,10,100,0.001,604,14
0.586,0.0001,349,355,10,100,0.001,704,14
0.602,0.0001,391,413,10,100,0.001,804,14
0.624,0.0001,443,461,10,100,0.001,904,14
0.66,0.0001,489,515,10,100,0.001,1004,14
0.682,0.0001,535,569,10,100,0.001,1104,14
0.722,0.0001,590,614,10,100,0.001,1204,14
0.748,0.0001,650,654,10,100,0.001,1304,14
0.784,0.0001,705,699,10,100,0.001,1404,14
0.798,0.0001,748,756,10,100,0.001,1504,14
0.808,0.0001,806,798,10,100,0.001,1604,14
0.828,0.0001,861,843,10,100,0.001,1704,14
0.846,0.0001,917,887,10,100,0.001,1804,14
0.86,0.0001,966,938,10,100,0.001,1904,14
0.874,0.0001,1007,997,10,100,0.001,2004,14
0.51,0.0001,45,59,10,100,0.001,104,15
0.508,0.0001,95,109,10,100,0.001,204,15
0.516,0.0001,147,157,10,100,0.001,304,15
0.518,0.0001,198,206,10,100,0.001,404,15
0.532,0.0001,242,262,10,100,0.001,504,15
0.57,0.0001,287,317,10,100,0.001,604,15
0.572,0.0001,340,364,10,100,0.001,704,15
0.592,0.0001,381,423,10,100,0.001,804,15
0.644,0.0001,426,478,10,100,0.001,904,15
0.676,0.0001,478,526,10,100,0.001,1004,15
0.698,0.0001,529,575,10,100,0.001,1104,15
0.696,0.0001,572,632,10,100,0.001,1204,15
0.71,0.0001,627,677,10,100,0.001,1304,15
0.732,0.0001,684,720,10,100,0.001,1404,15
0.772,0.0001,741,763,10,100,0.001,1504,15
0.8,0.0001,790,814,10,100,0.001,1604,15
0.808,0.0001,845,859,10,100,0.001,1704,15
0.826,0.0001,895,909,10,100,0.001,1804,15
0.828,0.0001,948,956,10,100,0.001,1904,15
0.854,0.0001,994,1010,10,100,0.001,2004,15
0.528,0.0001,52,52,10,100,0.001,104,16
0.53,0.0001,107,97,10,100,0.001,204,16
0.53,0.0001,158,146,10,100,0.001,304,16
0.524,0.0001,208,196,10,100,0.001,404,16
0.53,0.0001,261,243,10,100,0.001,504,16
0.538,0.0001,307,297,10,100,0.001,604,16
0.55,0.0001,356,348,10,100,0.001,704,16
0.564,0.0001,408,396,10,100,0.001,804,16
0.582,0.0001,455,449,10,100,0.001,904,16
0.624,0.0001,512,492,10,100,0.001,1004,16
0.642,0.0001,561,543,10,100,0.001,1104,16
0.668,0.0001,610,594,10,100,0.001,1204,16
0.696,0.0001,664,640,10,100,0.001,1304,16
0.734,0.0001,708,696,10,100,0.001,1404,16
0.784,0.0001,759,745,10,100,0.001,1504,16
0.826,0.0001,812,792,10,100,0.001,1604,16
0.87,0.0001,857,847,10,100,0.001,1704,16
0.9,0.0001,903,901,10,100,0.001,1804,16
0.9,0.0001,957,947,10,100,0.001,1904,16
0.92,0.0001,1007,997,10,100,0.001,2004,16
0.532,0.0001,51,53,10,100,0.001,104,17
0.538,0.0001,102,102,10,100,0.001,204,17
0.542,0.0001,142,162,10,100,0.001,304,17
0.548,0.0001,191,213,10,100,0.001,404,17
0.552,0.0001,238,266,10,100,0.001,504,17
0.56,0.0001,292,312,10,100,0.001,604,17
0.564,0.0001,343,361,10,100,0.001,704,17
0.58,0.0001,388,416,10,100,0.001,804,17
0.602,0.0001,442,462,10,100,0.001,904,17
0.628,0.0001,497,507,10,100,0.001,1004,17
0.666,0.0001,550,554,10,100,0.001,1104,17
0.736,0.0001,608,596,10,100,0.001,1204,17
0.754,0.0001,652,652,10,100,0.001,1304,17
0.766,0.0001,712,692,10,100,0.001,1404,17
0.784,0.0001,764,740,10,100,0.001,1504,17
0.804,0.0001,809,795,10,100,0.001,1604,17
0.826,0.0001,851,853,10,100,0.001,1704,17
0.852,0.0001,905,899,10,100,0.001,1804,17
0.864,0.0001,956,948,10,100,0.001,1904,17
0.884,0.0001,1006,998,10,100,0.001,2004,17
0.45,0.0001,50,54,10,100,0.001,104,18
0.454,0.0001,103,101,10,100,0.001,204,18
0.464,0.0001,155,149,10,100,0.001,304,18
0.478,0.0001,208,196,10,100,0.001,404,18
0.482,0.0001,262,242,10,100,0.001,504,18
0.49,0.0001,311,293,10,100,0.001,604,18
0.498,0.0001,358,346,10,100,0.001,704,18
0.506,0.0001,406,398,10,100,0.001,804,18
0.538,0.0001,453,451,10,100,0.001,904,18
0.562,0.0001,500,504,10,100,0.001,1004,18
0.578,0.0001,546,558,10,100,0.001,1104,18
0.62,0.0001,604,600,10,100,0.001,1204,18
0.666,0.0001,661,643,10,100,0.001,1304,18
0.734,0.0001,715,689,10,100,0.001,1404,18
0.774,0.0001,759,745,10,100,0.001,1504,18
0.808,0.0001,815,789,10,100,0.001,1604,18
0.836,0.0001,864,840,10,100,0.001,1704,18
0.85,0.0001,915,889,10,100,0.001,1804,18
0.862,0.0001,968,936,10,100,0.001,1904,18
0.88,0.0001,1022,982,10,100,0.001,2004,18
0.496,0.0001,49,55,10,100,0.001,104,19
0.5,0.0001,103,101,10,100,0.001,204,19
0.512,0.0001,149,155,10,100,0.001,304,19
0.524,0.0001,201,203,10,100,0.001,404,19
0.528,0.0001,255,249,10,100,0.001,504,19
0.552,0.0001,306,298,10,100,0.001,604,19
0.58,0.0001,358,346,10,100,0.001,704,19
0.616,0.0001,408,396,10,100,0.001,804,19
0.634,0.0001,464,440,10,100,0.001,904,19
0.666,0.0001,514,490,10,100,0.001,1004,19
0.706,0.0001,564,540,10,100,0.001,1104,19
0.75,0.0001,620,584,10,100,0.001,1204,19
0.758,0.0001,664,640,10,100,0.001,1304,19
0.786,0.0001,712,692,10,100,0.001,1404,19
0.822,0.0001,759,745,10,100,0.001,1504,19
0.83,0.0001,818,786,10,100,0.001,1604,19
0.848,0.0001,866,838,10,100,0.001,1704,19
0.862,0.0001,920,884,10,100,0.001,1804,19
0.876,0.0001,968,936,10,100,0.001,1904,19
0.896,0.0001,1009,995,10,100,0.001,2004,19
0.532,0.0001,56,48,10,100,0.001,104,20
0.53,0.0001,110,94,10,100,0.001,204,20
0.534,0.0001,159,145,10,100,0.001,304,20
0.538,0.0001,209,195,10,100,0.001,404,20
0.542,0.0001,265,239,10,100,0.001,504,20
0.558,0.0001,313,291,10,100,0.001,604,20
0.568,0.0001,365,339,10,100,0.001,704,20
0.592,0.0001,413,391,10,100,0.001,804,20
0.614,0.0001,464,440,10,100,0.001,904,20
0.624,0.0001,511,493,10,100,0.001,1004,20
0.658,0.0001,564,540,10,100,0.001,1104,20
0.69,0.0001,616,588,10,100,0.001,1204,20
0.71,0.0001,666,638,10,100,0.001,1304,20
0.752,0.0001,717,687,10,100,0.001,1404,20
0.782,0.0001,765,739,10,100,0.001,1504,20
0.816,0.0001,818,786,10,100,0.001,1604,20
0.846,0.0001,868,836,10,100,0.001,1704,20
0.874,0.0001,918,886,10,100,0.001,1804,20
0.882,0.0001,967,937,10,100,0.001,1904,20
0.896,0.0001,1018,986,10,100,0.001,2004,20
0.532,0.0001,59,45,10,100,0.01,104,1
0.556,0.0001,118,86,10,100,0.01,204,1
0.558,0.0001,158,146,10,100,0.01,304,1
0.61,0.0001,213,191,10,100,0.01,404,1
0.666,0.0001,260,244,10,100,0.01,504,1
0.766,0.0001,307,297,10,100,0.01,604,1
0.858,0.0001,355,349,10,100,0.01,704,1
0.902,0.0001,393,411,10,100,0.01,804,1
0.916,0.0001,449,455,10,100,0.01,904,1
0.954,0.0001,508,496,10,100,0.01,1004,1
0.978,0.0001,560,544,10,100,0.01,1104,1
0.978,0.0001,618,586,10,100,0.01,1204,1
0.976,0.0001,662,642,10,100,0.01,1304,1
0.98,0.0001,707,697,10,100,0.01,1404,1
0.98,0.0001,756,748,10,100,0.01,1504,1
0.98,0.0001,803,801,10,100,0.01,1604,1
0.98,0.0001,848,856,10,100,0.01,1704,1
0.982,0.0001,893,911,10,100,0.01,1804,1
0.984,0.0001,945,959,10,100,0.01,1904,1
0.988,0.0001,990,1014,10,100,0.01,2004,1
0.584,0.0001,41,63,10,100,0.01,104,2
0.564,0.0001,90,114,10,100,0.01,204,2
0.616,0.0001,146,158,10,100,0.01,304,2
0.68,0.0001,194,210,10,100,0.01,404,2
0.736,0.0001,240,264,10,100,0.01,504,2
0.772,0.0001,296,308,10,100,0.01,604,2
0.814,0.0001,345,359,10,100,0.01,704,2
0.9,0.0001,388,416,10,100,0.01,804,2
0.904,0.0001,435,469,10,100,0.01,904,2
0.942,0.0001,487,517,10,100,0.01,1004,2
0.952,0.0001,534,570,10,100,0.01,1104,2
0.95,0.0001,587,617,10,100,0.01,1204,2
0.95,0.0001,633,671,10,100,0.01,1304,2
0.966,0.0001,685,719,10,100,0.01,1404,2
0.968,0.0001,734,770,10,100,0.01,1504,2
0.962,0.0001,780,824,10,100,0.01,1604,2
0.968,0.0001,832,872,10,100,0.01,1704,2
0.974,0.0001,885,919,10,100,0.01,1804,2
0.974,0.0001,939,965,10,100,0.01,1904,2
0.974,0.0001,989,1015,10,100,0.01,2004,2
0.646,0.0001,58,46,10,100,0.01,104,3
0.65,0.0001,107,97,10,100,0.01,204,3
0.566,0.0001,159,145,10,100,0.01,304,3
0.61,0.0001,213,191,10,100,0.01,404,3
0.676,0.0001,264,240,10,100,0.01,504,3
0.73,0.0001,319,285,10,100,0.01,604,3
0.814,0.0001,373,331,10,100,0.01,704,3
0.884,0.0001,426,378,10,100,0.01,804,3
0.874,0.0001,476,428,10,100,0.01,904,3
0.95,0.0001,524,480,10,100,0.01,1004,3
0.946,0.0001,575,529,10,100,0.01,1104,3
0.958,0.0001,624,580,10,100,0.01,1204,3
0.972,0.0001,671,633,10,100,0.01,1304,3
0.982,0.0001,724,680,10,100,0.01,1404,3
0.982,0.0001,778,726,10,100,0.01,1504,3
0.986,0.0001,836,768,10,100,0.01,1604,3
0.986,0.0001,885,819,10,100,0.01,1704,3
0.99,0.0001,931,873,10,100,0.01,1804,3
0.988,0.0001,983,921,10,100,0.01,1904,3
0.99,0.0001,1033,971,10,100,0.01,2004,3
0.588,0.0001,49,55,10,100,0.01,104,4
0.666,0.0001,98,106,10,100,0.01,204,4
0.716,0.0001,148,156,10,100,0.01,304,4
0.742,0.0001,195,209,10,100,0.01,404,4
0.754,0.0001,244,260,10,100,0.01,504,4
0.824,0.0001,295,309,10,100,0.01,604,4
0.868,0.0001,348,356,10,100,0.01,704,4
0.896,0.0001,396,408,10,100,0.01,804,4
0.898,0.0001,443,461,10,100,0.01,904,4
0.954,0.0001,492,512,10,100,0.01,1004,4
0.962,0.0001,539,565,10,100,0.01,1104,4
0.97,0.0001,588,616,10,100,0.01,1204,4
0.974,0.0001,639,665,10,100,0.01,1304,4
0.98,0.0001,693,711,10,100,0.01,1404,4
0.982,0.0001,748,756,10,100,0.01,1504,4
0.98,0.0001,803,801,10,100,0.01,1604,4
0.986,0.0001,851,853,10,100,0.01,1704,4
0.988,0.0001,909,895,10,100,0.01,1804,4
0.986,0.0001,958,946,10,100,0.01,1904,4
0.988,0.0001,1007,997,10,100,0.01,2004,4
0.552,0.0001,55,49,10,100,0.01,104,5
0.608,0.0001,115,89,10,100,0.01,204,5
0.636,0.0001,155,149,10,100,0.01,304,5
0.67,0.0001,207,197,10,100,0.01,404,5
0.676,0.0001,260,244,10,100,0.01,504,5
0.744,0.0001,311,293,10,100,0.01,604,5
0.8,0.0001,365,339,10,100,0.01,704,5
0.868,0.0001,413,391,10,100,0.01,804,5
0.938,0.0001,469,435,10,100,0.01,904,5
0.962,0.0001,516,488,10,100,0.01,1004,5
0.966,0.0001,560,544,10,100,0.01,1104,5
0.97,0.0001,618,586,10,100,0.01,1204,5
0.978,0.0001,669,635,10,100,0.01,1304,5
0.982,0.0001,714,690,10,100,0.01,1404,5
0.982,0.0001,756,748,10,100,0.01,1504,5
0.984,0.0001,809,795,10,100,0.01,1604,5
0.986,0.0001,860,844,10,100,0.01,1704,5
0.986,0.0001,899,905,10,100,0.01,1804,5
0.986,0.0001,943,961,10,100,0.01,1904,5
0.986,0.0001,995,1009,10,100,0.01,2004,5
0.55,0.0001,59,45,10,100,0.01,104,6
0.558,0.0001,109,95,10,100,0.01,204,6
0.568,0.0001,158,146,10,100,0.01,304,6
0.634,0.0001,205,199,10,100,0.01,404,6
0.696,0.0001,251,253,10,100,0.01,504,6
0.778,0.0001,295,309,10,100,0.01,604,6
0.788,0.0001,343,361,10,100,0.01,704,6
0.85,0.0001,396,408,10,100,0.01,804,6
0.918,0.0001,448,456,10,100,0.01,904,6
0.942,0.0001,501,503,10,100,0.01,1004,6
0.932,0.0001,561,543,10,100,0.01,1104,6
0.954,0.0001,599,605,10,100,0.01,1204,6
0.954,0.0001,649,655,10,100,0.01,1304,6
0.962,0.0001,700,704,10,100,0.01,1404,6
0.97,0.0001,747,757,10,100,0.01,1504,6
0.97,0.0001,799,805,10,100,0.01,1604,6
0.974,0.0001,855,849,10,100,0.01,1704,6
0.976,0.0001,900,904,10,100,0.01,1804,6
0.98,0.0001,950,954,10,100,0.01,1904,6
0.98,0.0001,1005,999,10,100,0.01,2004,6
0.516,0.0001,51,53,10,100,0.01,104,7
0.592,0.0001,101,103,10,100,0.01,204,7
0.632,0.0001,148,156,10,100,0.01,304,7
0.676,0.0001,193,211,10,100,0.01,404,7
0.692,0.0001,241,263,10,100,0.01,504,7
0.772,0.0001,287,317,10,100,0.01,604,7
0.822,0.0001,336,368,10,100,0.01,704,7
0.896,0.0001,378,426,10,100,0.01,804,7
0.922,0.0001,425,479,10,100,0.01,904,7
0.93,0.0001,475,529,10,100,0.01,1004,7
0.934,0.0001,529,575,10,100,0.01,1104,7
0.962,0.0001,585,619,10,100,0.01,1204,7
0.972,0.0001,637,667,10,100,0.01,1304,7
0.97,0.0001,684,720,10,100,0.01,1404,7
0.97,0.0001,741,763,10,100,0.01,1504,7
0.974,0.0001,797,807,10,100,0.01,1604,7
0.972,0.0001,850,854,10,100,0.01,1704,7
0.98,0.0001,901,903,10,100,0.01,1804,7
0.98,0.0001,947,957,10,100,0.01,1904,7
0.984,0.0001,996,1008,10,100,0.01,2004,7
0.524,0.0001,48,56,10,100,0.01,104,8
0.548,0.0001,100,104,10,100,0.01,204,8
0.586,0.0001,150,154,10,100,0.01,304,8
0.658,0.0001,196,208,10,100,0.01,404,8
0.696,0.0001,242,262,10,100,0.01,504,8
0.77,0.0001,289,315,10,100,0.01,604,8
0.826,0.0001,344,360,10,100,0.01,704,8
0.87,0.0001,397,407,10,100,0.01,804,8
0.896,0.0001,445,459,10,100,0.01,904,8
0.916,0.0001,495,509,10,100,0.01,1004,8
0.94,0.0001,553,551,10,100,0.01,1104,8
0.952,0.0001,600,604,10,100,0.01,1204,8
0.952,0.0001,650,654,10,100,0.01,1304,8
0.958,0.0001,700,704,10,100,0.01,1404,8
0.966,0.0001,754,750,10,100,0.01,1504,8
0.972,0.0001,797,807,10,100,0.01,1604,8
0.972,0.0001,851,853,10,100,0.01,1704,8
0.982,0.0001,899,905,10,100,0.01,1804,8
0.982,0.0001,943,961,10,100,0.01,1904,8
0.986,0.0001,989,1015,10,100,0.01,2004,8
0.662,0.0001,48,56,10,100,0.01,104,9
0.62,0.0001,93,111,10,100,0.01,204,9
0.61,0.0001,149,155,10,100,0.01,304,9
0.65,0.0001,205,199,10,100,0.01,404,9
0.724,0.0001,261,243,10,100,0.01,504,9
0.764,0.0001,325,279,10,100,0.01,604,9
0.75,0.0001,370,334,10,100,0.01,704,9
0.874,0.0001,410,394,10,100,0.01,804,9
0.926,0.0001,457,447,10,100,0.01,904,9
0.93,0.0001,510,494,10,100,0.01,1004,9
0.942,0.0001,564,540,10,100,0.01,1104,9
0.956,0.0001,610,594,10,100,0.01,1204,9
0.946,0.0001,655,649,10,100,0.01,1304,9
0.96,0.0001,709,695,10,100,0.01,1404,9
0.966,0.0001,762,742,10,100,0.01,1504,9
0.972,0.0001,814,790,10,100,0.01,1604,9
0.976,0.0001,867,837,10,100,0.01,1704,9
0.982,0.0001,916,888,10,100,0.01,1804,9
0.988,0.0001,964,940,10,100,0.01,1904,9
0.984,0.0001,1011,993,10,100,0.01,2004,9
0.484,0.0001,51,53,10,100,0.01,104,10
0.558,0.0001,101,103,10,100,0.01,204,10
0.578,0.0001,150,154,10,100,0.01,304,10
0.634,0.0001,198,206,10,100,0.01,404,10
0.678,0.0001,246,258,10,100,0.01,504,10
0.74,0.0001,298,306,10,100,0.01,604,10
0.8,0.0001,343,361,10,100,0.01,704,10
0.848,0.0001,392,412,10,100,0.01,804,10
0.892,0.0001,446,458,10,100,0.01,904,10
0.93,0.0001,500,504,10,100,0.01,1004,10
0.954,0.0001,545,559,10,100,0.01,1104,10
0.972,0.0001,591,613,10,100,0.01,1204,10
0.98,0.0001,647,657,10,100,0.01,1304,10
0.982,0.0001,695,709,10,100,0.01,1404,10
0.986,0.0001,752,752,10,100,0.01,1504,10
0.99,0.0001,806,798,10,100,0.01,1604,10
0.992,0.0001,857,847,10,100,0.01,1704,10
0.996,0.0001,904,900,10,100,0.01,1804,10
0.996,0.0001,949,955,10,100,0.01,1904,10
0.996,0.0001,1000,1004,10,100,0.01,2004,10
0.59,0.0001,55,49,10,100,0.01,104,11
0.61,0.0001,109,95,10,100,0.01,204,11
0.612,0.0001,159,145,10,100,0.01,304,11
0.646,0.0001,209,195,10,100,0.01,404,11
0.648,0.0001,255,249,10,100,0.01,504,11
0.746,0.0001,305,299,10,100,0.01,604,11
0.81,0.0001,357,347,10,100,0.01,704,11
0.848,0.0001,406,398,10,100,0.01,804,11
0.888,0.0001,447,457,10,100,0.01,904,11
0.928,0.0001,494,510,10,100,0.01,1004,11
0.932,0.0001,543,561,10,100,0.01,1104,11
0.952,0.0001,599,605,10,100,0.01,1204,11
0.97,0.0001,657,647,10,100,0.01,1304,11
0.962,0.0001,710,694,10,100,0.01,1404,11
0.966,0.0001,768,736,10,100,0.01,1504,11
0.968,0.0001,813,791,10,100,0.01,1604,11
0.978,0.0001,857,847,10,100,0.01,1704,11
0.98,0.0001,909,895,10,100,0.01,1804,11
0.98,0.0001,959,945,10,100,0.01,1904,11
0.986,0.0001,1016,988,10,100,0.01,2004,11
0.546,0.0001,51,53,10,100,0.01,104,12
0.576,0.0001,103,101,10,100,0.01,204,12
0.598,0.0001,150,154,10,100,0.01,304,12
0.638,0.0001,201,203,10,100,0.01,404,12
0.654,0.0001,256,248,10,100,0.01,504,12
0.684,0.0001,311,293,10,100,0.01,604,12
0.718,0.0001,355,349,10,100,0.01,704,12
0.818,0.0001,400,404,10,100,0.01,804,12
0.868,0.0001,449,455,10,100,0.01,904,12
0.912,0.0001,494,510,10,100,0.01,1004,12
0.95,0.0001,540,564,10,100,0.01,1104,12
0.948,0.0001,584,620,10,100,0.01,1204,12
0.944,0.0001,635,669,10,100,0.01,1304,12
0.97,0.0001,695,709,10,100,0.01,1404,12
0.976,0.0001,744,760,10,100,0.01,1504,12
0.954,0.0001,795,809,10,100,0.01,1604,12
0.964,0.0001,850,854,10,100,0.01,1704,12
0.974,0.0001,903,901,10,100,0.01,1804,12
0.98,0.0001,945,959,10,100,0.01,1904,12
0.98,0.0001,1000,1004,10,100,0.01,2004,12
0.602,0.0001,46,58,10,100,0.01,104,13
0.566,0.0001,103,101,10,100,0.01,204,13
0.56,0.0001,153,151,10,100,0.01,304,13
0.602,0.0001,208,196,10,100,0.01,404,13
0.654,0.0001,247,257,10,100,0.01,504,13
0.686,0.0001,300,304,10,100,0.01,604,13
0.718,0.0001,356,348,10,100,0.01,704,13
0.778,0.0001,402,402,10,100,0.01,804,13
0.858,0.0001,453,451,10,100,0.01,904,13
0.902,0.0001,497,507,10,100,0.01,1004,13
0.932,0.0001,547,557,10,100,0.01,1104,13
0.958,0.0001,601,603,10,100,0.01,1204,13
0.956,0.0001,657,647,10,100,0.01,1304,13
0.97,0.0001,706,698,10,100,0.01,1404,13
0.97,0.0001,752,752,10,100,0.01,1504,13
0.976,0.0001,809,795,10,100,0.01,1604,13
0.98,0.0001,860,844,10,100,0.01,1704,13
0.982,0.0001,919,885,10,100,0.01,1804,13
0.982,0.0001,969,935,10,100,0.01,1904,13
0.982,0.0001,1013,991,10,100,0.01,2004,13
0.542,0.0001,57,47,10,100,0.01,104,14
0.564,0.0001,100,104,10,100,0.01,204,14
0.638,0.0001,154,150,10,100,0.01,304,14
0.702,0.0001,208,196,10,100,0.01,404,14
0.722,0.0001,253,251,10,100,0.01,504,14
0.804,0.0001,314,290,10,100,0.01,604,14
0.83,0.0001,368,336,10,100,0.01,704,14
0.9,0.0001,417,387,10,100,0.01,804,14
0.918,0.0001,475,429,10,100,0.01,904,14
0.94,0.0001,521,483,10,100,0.01,1004,14
0.954,0.0001,571,533,10,100,0.01,1104,14
0.96,0.0001,624,580,10,100,0.01,1204,14
0.964,0.0001,667,637,10,100,0.01,1304,14
0.974,0.0001,718,686,10,100,0.01,1404,14
0.974,0.0001,763,741,10,100,0.01,1504,14
0.974,0.0001,818,786,10,100,0.01,1604,14
0.976,0.0001,860,844,10,100,0.01,1704,14
0.978,0.0001,907,897,10,100,0.01,1804,14
0.982,0.0001,957,947,10,100,0.01,1904,14
0.986,0.0001,1004,1000,10,100,0.01,2004,14
0.52,0.0001,52,52,10,100,0.01,104,15
0.636,0.0001,105,99,10,100,0.01,204,15
0.64,0.0001,158,146,10,100,0.01,304,15
0.672,0.0001,211,193,10,100,0.01,404,15
0.674,0.0001,259,245,10,100,0.01,504,15
0.754,0.0001,313,291,10,100,0.01,604,15
0.8,0.0001,367,337,10,100,0.01,704,15
0.88,0.0001,421,383,10,100,0.01,804,15
0.914,0.0001,471,433,10,100,0.01,904,15
0.934,0.0001,512,492,10,100,0.01,1004,15
0.94,0.0001,568,536,10,100,0.01,1104,15
0.96,0.0001,620,584,10,100,0.01,1204,15
0.96,0.0001,669,635,10,100,0.01,1304,15
0.966,0.0001,716,688,10,100,0.01,1404,15
0.968,0.0001,765,739,10,100,0.01,1504,15
0.964,0.0001,813,791,10,100,0.01,1604,15
0.97,0.0001,866,838,10,100,0.01,1704,15
0.972,0.0001,919,885,10,100,0.01,1804,15
0.972,0.0001,960,944,10,100,0.01,1904,15
0.974,0.0001,1012,992,10,100,0.01,2004,15
0.522,0.0001,57,47,10,100,0.01,104,16
0.658,0.0001,101,103,10,100,0.01,204,16
0.634,0.0001,154,150,10,100,0.01,304,16
0.672,0.0001,201,203,10,100,0.01,404,16
0.75,0.0001,247,257,10,100,0.01,504,16
0.798,0.0001,298,306,10,100,0.01,604,16
0.818,0.0001,345,359,10,100,0.01,704,16
0.876,0.0001,395,409,10,100,0.01,804,16
0.882,0.0001,448,456,10,100,0.01,904,16
0.934,0.0001,495,509,10,100,0.01,1004,16
0.954,0.0001,545,559,10,100,0.01,1104,16
0.946,0.0001,597,607,10,100,0.01,1204,16
0.966,0.0001,650,654,10,100,0.01,1304,16
0.964,0.0001,704,700,10,100,0.01,1404,16
0.962,0.0001,748,756,10,100,0.01,1504,16
0.966,0.0001,798,806,10,100,0.01,1604,16
0.982,0.0001,854,850,10,100,0.01,1704,16
0.986,0.0001,907,897,10,100,0.01,1804,16
0.99,0.0001,958,946,10,100,0.01,1904,16
0.994,0.0001,1003,1001,10,100,0.01,2004,16
0.518,0.0001,50,54,10,100,0.01,104,17
0.636,0.0001,106,98,10,100,0.01,204,17
0.646,0.0001,159,145,10,100,0.01,304,17
0.742,0.0001,199,205,10,100,0.01,404,17
0.772,0.0001,251,253,10,100,0.01,504,17
0.754,0.0001,302,302,10,100,0.01,604,17
0.7,0.0001,346,358,10,100,0.01,704,17
0.88,0.0001,397,407,10,100,0.01,804,17
0.892,0.0001,449,455,10,100,0.01,904,17
0.902,0.0001,498,506,10,100,0.01,1004,17
0.924,0.0001,553,551,10,100,0.01,1104,17
0.952,0.0001,599,605,10,100,0.01,1204,17
0.954,0.0001,656,648,10,100,0.01,1304,17
0.96,0.0001,713,691,10,100,0.01,1404,17
0.958,0.0001,767,737,10,100,0.01,1504,17
0.976,0.0001,810,794,10,100,0.01,1604,17
0.968,0.0001,858,846,10,100,0.01,1704,17
0.968,0.0001,905,899,10,100,0.01,1804,17
0.978,0.0001,949,955,10,100,0.01,1904,17
0.986,0.0001,1001,1003,10,100,0.01,2004,17
0.47,0.0001,49,55,10,100,0.01,104,18
0.652,0.0001,99,105,10,100,0.01,204,18
0.646,0.0001,151,153,10,100,0.01,304,18
0.658,0.0001,198,206,10,100,0.01,404,18
0.652,0.0001,253,251,10,100,0.01,504,18
0.69,0.0001,302,302,10,100,0.01,604,18
0.706,0.0001,352,352,10,100,0.01,704,18
0.824,0.0001,398,406,10,100,0.01,804,18
0.842,0.0001,452,452,10,100,0.01,904,18
0.892,0.0001,504,500,10,100,0.01,1004,18
0.932,0.0001,551,553,10,100,0.01,1104,18
0.946,0.0001,607,597,10,100,0.01,1204,18
0.95,0.0001,654,650,10,100,0.01,1304,18
0.954,0.0001,705,699,10,100,0.01,1404,18
0.954,0.0001,756,748,10,100,0.01,1504,18
0.972,0.0001,815,789,10,100,0.01,1604,18
0.97,0.0001,861,843,10,100,0.01,1704,18
0.982,0.0001,911,893,10,100,0.01,1804,18
0.982,0.0001,960,944,10,100,0.01,1904,18
0.974,0.0001,1018,986,10,100,0.01,2004,18
0.5,0.0001,52,52,10,100,0.01,104,19
0.584,0.0001,106,98,10,100,0.01,204,19
0.588,0.0001,160,144,10,100,0.01,304,19
0.636,0.0001,203,201,10,100,0.01,404,19
0.64,0.0001,252,252,10,100,0.01,504,19
0.692,0.0001,305,299,10,100,0.01,604,19
0.754,0.0001,352,352,10,100,0.01,704,19
0.876,0.0001,389,415,10,100,0.01,804,19
0.904,0.0001,426,478,10,100,0.01,904,19
0.922,0.0001,484,520,10,100,0.01,1004,19
0.928,0.0001,530,574,10,100,0.01,1104,19
0.952,0.0001,578,626,10,100,0.01,1204,19
0.97,0.0001,633,671,10,100,0.01,1304,19
0.968,0.0001,679,725,10,100,0.01,1404,19
0.98,0.0001,727,777,10,100,0.01,1504,19
0.986,0.0001,779,825,10,100,0.01,1604,19
0.986,0.0001,829,875,10,100,0.01,1704,19
0.992,0.0001,890,914,10,100,0.01,1804,19
0.994,0.0001,947,957,10,100,0.01,1904,19
0.994,0.0001,999,1005,10,100,0.01,2004,19
0.51,0.0001,50,54,10,100,0.01,104,20
0.592,0.0001,105,99,10,100,0.01,204,20
0.656,0.0001,156,148,10,100,0.01,304,20
0.718,0.0001,206,198,10,100,0.01,404,20
0.728,0.0001,256,248,10,100,0.01,504,20
0.778,0.0001,301,303,10,100,0.01,604,20
0.816,0.0001,348,356,10,100,0.01,704,20
0.868,0.0001,399,405,10,100,0.01,804,20
0.89,0.0001,453,451,10,100,0.01,904,20
0.936,0.0001,499,505,10,100,0.01,1004,20
0.966,0.0001,554,550,10,100,0.01,1104,20
0.964,0.0001,604,600,10,100,0.01,1204,20
0.97,0.0001,658,646,10,100,0.01,1304,20
0.974,0.0001,705,699,10,100,0.01,1404,20
0.976,0.0001,757,747,10,100,0.01,1504,20
0.984,0.0001,814,790,10,100,0.01,1604,20
0.984,0.0001,853,851,10,100,0.01,1704,20
0.984,0.0001,901,903,10,100,0.01,1804,20
0.986,0.0001,949,955,10,100,0.01,1904,20
0.988,0.0001,996,1008,10,100,0.01,2004,20
0.478,0.001,55,49,10,100,0.0001,104,1
0.48,0.001,101,103,10,100,0.0001,204,1
0.482,0.001,155,149,10,100,0.0001,304,1
0.484,0.001,205,199,10,100,0.0001,404,1
0.484,0.001,246,258,10,100,0.0001,504,1
0.484,0.001,304,300,10,100,0.0001,604,1
0.486,0.001,352,352,10,100,0.0001,704,1
0.488,0.001,400,404,10,100,0.0001,804,1
0.49,0.001,447,457,10,100,0.0001,904,1
0.49,0.001,501,503,10,100,0.0001,1004,1
0.49,0.001,552,552,10,100,0.0001,1104,1
0.49,0.001,596,608,10,100,0.0001,1204,1
0.492,0.001,654,650,10,100,0.0001,1304,1
0.498,0.001,705,699,10,100,0.0001,1404,1
0.5,0.001,752,752,10,100,0.0001,1504,1
0.506,0.001,798,806,10,100,0.0001,1604,1
0.512,0.001,848,856,10,100,0.0001,1704,1
0.52,0.001,890,914,10,100,0.0001,1804,1
0.52,0.001,937,967,10,100,0.0001,1904,1
0.526,0.001,994,1010,10,100,0.0001,2004,1
0.516,0.001,45,59,10,100,0.0001,104,2
0.518,0.001,92,112,10,100,0.0001,204,2
0.518,0.001,146,158,10,100,0.0001,304,2
0.516,0.001,201,203,10,100,0.0001,404,2
0.512,0.001,249,255,10,100,0.0001,504,2
0.514,0.001,298,306,10,100,0.0001,604,2
0.514,0.001,349,355,10,100,0.0001,704,2
0.516,0.001,399,405,10,100,0.0001,804,2
0.518,0.001,453,451,10,100,0.0001,904,2
0.516,0.001,496,508,10,100,0.0001,1004,2
0.518,0.001,545,559,10,100,0.0001,1104,2
0.518,0.001,594,610,10,100,0.0001,1204,2
0.518,0.001,646,658,10,100,0.0001,1304,2
0.522,0.001,703,701,10,100,0.0001,1404,2
0.52,0.001,754,750,10,100,0.0001,1504,2
0.52,0.001,795,809,10,100,0.0001,1604,2
0.524,0.001,848,856,10,100,0.0001,1704,2
0.526,0.001,896,908,10,100,0.0001,1804,2
0.532,0.001,942,962,10,100,0.0001,1904,2
0.538,0.001,988,1016,10,100,0.0001,2004,2
0.474,0.001,55,49,10,100,0.0001,104,3
0.476,0.001,109,95,10,100,0.0001,204,3
0.48,0.001,157,147,10,100,0.0001,304,3
0.478,0.001,208,196,10,100,0.0001,404,3
0.482,0.001,262,242,10,100,0.0001,504,3
0.484,0.001,305,299,10,100,0.0001,604,3
0.488,0.001,356,348,10,100,0.0001,704,3
0.488,0.001,410,394,10,100,0.0001,804,3
0.486,0.001,466,438,10,100,0.0001,904,3
0.486,0.001,520,484,10,100,0.0001,1004,3
0.482,0.001,571,533,10,100,0.0001,1104,3
0.482,0.001,620,584,10,100,0.0001,1204,3
0.48,0.001,672,632,10,100,0.0001,1304,3
0.482,0.001,719,685,10,100,0.0001,1404,3
0.486,0.001,774,730,10,100,0.0001,1504,3
0.49,0.001,823,781,10,100,0.0001,1604,3
0.504,0.001,875,829,10,100,0.0001,1704,3
0.504,0.001,932,872,10,100,0.0001,1804,3
0.504,0.001,981,923,10,100,0.0001,1904,3
0.508,0.001,1032,972,10,100,0.0001,2004,3
0.55,0.001,55,49,10,100,0.0001,104,4
0.548,0.001,105,99,10,100,0.0001,204,4
0.548,0.001,153,151,10,100,0.0001,304,4
0.548,0.001,203,201,10,100,0.0001,404,4
0.55,0.001,244,260,10,100,0.0001,504,4
0.55,0.001,293,311,10,100,0.0001,604,4
0.55,0.001,362,342,10,100,0.0001,704,4
0.552,0.001,420,384,10,100,0.0001,804,4
0.554,0.001,477,427,10,100,0.0001,904,4
0.556,0.001,525,479,10,100,0.0001,1004,4
0.558,0.001,567,537,10,100,0.0001,1104,4
0.558,0.001,612,592,10,100,0.0001,1204,4
0.56,0.001,661,643,10,100,0.0001,1304,4
0.558,0.001,716,688,10,100,0.0001,1404,4
0.564,0.001,761,743,10,100,0.0001,1504,4
0.574,0.001,811,793,10,100,0.0001,1604,4
0.576,0.001,864,840,10,100,0.0001,1704,4
0.584,0.001,912,892,10,100,0.0001,1804,4
0.586,0.001,964,940,10,100,0.0001,1904,4
0.588,0.001,1017,987,10,100,0.0001,2004,4
0.482,0.001,51,53,10,100,0.0001,104,5
0.48,0.001,104,100,10,100,0.0001,204,5
0.482,0.001,164,140,10,100,0.0001,304,5
0.482,0.001,213,191,10,100,0.0001,404,5
0.486,0.001,257,247,10,100,0.0001,504,5
0.488,0.001,304,300,10,100,0.0001,604,5
0.492,0.001,354,350,10,100,0.0001,704,5
0.492,0.001,406,398,10,100,0.0001,804,5
0.502,0.001,460,444,10,100,0.0001,904,5
0.506,0.001,511,493,10,100,0.0001,1004,5
0.51,0.001,550,554,10,100,0.0001,1104,5
0.512,0.001,605,599,10,100,0.0001,1204,5
0.512,0.001,656,648,10,100,0.0001,1304,5
0.516,0.001,711,693,10,100,0.0001,1404,5
0.524,0.001,758,746,10,100,0.0001,1504,5
0.528,0.001,807,797,10,100,0.0001,1604,5
0.528,0.001,851,853,10,100,0.0001,1704,5
0.53,0.001,900,904,10,100,0.0001,1804,5
0.534,0.001,944,960,10,100,0.0001,1904,5
0.544,0.001,998,1006,10,100,0.0001,2004,5
0.508,0.001,57,47,10,100,0.0001,104,6
0.508,0.001,100,104,10,100,0.0001,204,6
0.512,0.001,154,150,10,100,0.0001,304,6
0.51,0.001,205,199,10,100,0.0001,404,6
0.512,0.001,262,242,10,100,0.0001,504,6
0.514,0.001,315,289,10,100,0.0001,604,6
0.516,0.001,365,339,10,100,0.0001,704,6
0.514,0.001,419,385,10,100,0.0001,804,6
0.512,0.001,470,434,10,100,0.0001,904,6
0.52,0.001,514,490,10,100,0.0001,1004,6
0.522,0.001,565,539,10,100,0.0001,1104,6
0.522,0.001,609,595,10,100,0.0001,1204,6
0.522,0.001,649,655,10,100,0.0001,1304,6
0.524,0.001,705,699,10,100,0.0001,1404,6
0.536,0.001,750,754,10,100,0.0001,1504,6
0.538,0.001,798,806,10,100,0.0001,1604,6
0.542,0.001,843,861,10,100,0.0001,1704,6
0.548,0.001,896,908,10,100,0.0001,1804,6
0.556,0.001,951,953,10,100,0.0001,1904,6
0.556,0.001,998,1006,10,100,0.0001,2004,6
0.478,0.001,56,48,10,100,0.0001,104,7
0.48,0.001,101,103,10,100,0.0001,204,7
0.478,0.001,148,156,10,100,0.0001,304,7
0.482,0.001,194,210,10,100,0.0001,404,7
0.482,0.001,236,268,10,100,0.0001,504,7
0.484,0.001,289,315,10,100,0.0001,604,7
0.484,0.001,338,366,10,100,0.0001,704,7
0.48,0.001,391,413,10,100,0.0001,804,7
0.478,0.001,433,471,10,100,0.0001,904,7
0.482,0.001,482,522,10,100,0.0001,1004,7
0.482,0.001,537,567,10,100,0.0001,1104,7
0.482,0.001,593,611,10,100,0.0001,1204,7
0.484,0.001,648,656,10,100,0.0001,1304,7
0.488,0.001,700,704,10,100,0.0001,1404,7
0.488,0.001,754,750,10,100,0.0001,1504,7
0.49,0.001,805,799,10,100,0.0001,1604,7
0.5,0.001,854,850,10,100,0.0001,1704,7
0.502,0.001,909,895,10,100,0.0001,1804,7
0.51,0.001,957,947,10,100,0.0001,1904,7
0.514,0.001,1014,990,10,100,0.0001,2004,7
0.486,0.001,50,54,10,100,0.0001,104,8
0.486,0.001,100,104,10,100,0.0001,204,8
0.484,0.001,154,150,10,100,0.0001,304,8
0.488,0.001,213,191,10,100,0.0001,404,8
0.494,0.001,264,240,10,100,0.0001,504,8
0.498,0.001,317,287,10,100,0.0001,604,8
0.496,0.001,360,344,10,100,0.0001,704,8
0.5,0.001,403,401,10,100,0.0001,804,8
0.506,0.001,467,437,10,100,0.0001,904,8
0.504,0.001,512,492,10,100,0.0001,1004,8
0.506,0.001,555,549,10,100,0.0001,1104,8
0.506,0.001,608,596,10,100,0.0001,1204,8
0.506,0.001,653,651,10,100,0.0001,1304,8
0.51,0.001,698,706,10,100,0.0001,1404,8
0.508,0.001,747,757,10,100,0.0001,1504,8
0.518,0.001,797,807,10,100,0.0001,1604,8
0.538,0.001,847,857,10,100,0.0001,1704,8
0.542,0.001,894,910,10,100,0.0001,1804,8
0.552,0.001,943,961,10,100,0.0001,1904,8
0.56,0.001,999,1005,10,100,0.0001,2004,8
0.532,0.001,59,45,10,100,0.0001,104,9
0.532,0.001,113,91,10,100,0.0001,204,9
0.53,0.001,164,140,10,100,0.0001,304,9
0.53,0.001,216,188,10,100,0.0001,404,9
0.528,0.001,270,234,10,100,0.0001,504,9
0.528,0.001,323,281,10,100,0.0001,604,9
0.53,0.001,373,331,10,100,0.0001,704,9
0.532,0.001,422,382,10,100,0.0001,804,9
0.532,0.001,465,439,10,100,0.0001,904,9
0.534,0.001,520,484,10,100,0.0001,1004,9
0.536,0.001,572,532,10,100,0.0001,1104,9
0.536,0.001,616,588,10,100,0.0001,1204,9
0.536,0.001,666,638,10,100,0.0001,1304,9
0.544,0.001,721,683,10,100,0.0001,1404,9
0.554,0.001,775,729,10,100,0.0001,1504,9
0.56,0.001,820,784,10,100,0.0001,1604,9
0.556,0.001,868,836,10,100,0.0001,1704,9
0.548,0.001,912,892,10,100,0.0001,1804,9
0.556,0.001,958,946,10,100,0.0001,1904,9
0.562,0.001,1006,998,10,100,0.0001,2004,9
0.464,0.001,59,45,10,100,0.0001,104,10
0.462,0.001,115,89,10,100,0.0001,204,10
0.464,0.001,166,138,10,100,0.0001,304,10
0.462,0.001,209,195,10,100,0.0001,404,10
0.464,0.001,258,246,10,100,0.0001,504,10
0.468,0.001,304,300,10,100,0.0001,604,10
0.468,0.001,354,350,10,100,0.0001,704,10
0.466,0.001,413,391,10,100,0.0001,804,10
0.462,0.001,461,443,10,100,0.0001,904,10
0.46,0.001,512,492,10,100,0.0001,1004,10
0.462,0.001,566,538,10,100,0.0001,1104,10
0.468,0.001,615,589,10,100,0.0001,1204,10
0.48,0.001,663,641,10,100,0.0001,1304,10
0.49,0.001,713,691,10,100,0.0001,1404,10
0.498,0.001,760,744,10,100,0.0001,1504,10
0.508,0.001,806,798,10,100,0.0001,1604,10
0.514,0.001,853,851,10,100,0.0001,1704,10
0.522,0.001,904,900,10,100,0.0001,1804,10
0.53,0.001,960,944,10,100,0.0001,1904,10
0.536,0.001,1010,994,10,100,0.0001,2004,10
0.496,0.001,50,54,10,100,0.0001,104,11
0.5,0.001,99,105,10,100,0.0001,204,11
0.502,0.001,149,155,10,100,0.0001,304,11
0.5,0.001,201,203,10,100,0.0001,404,11
0.504,0.001,252,252,10,100,0.0001,504,11
0.504,0.001,301,303,10,100,0.0001,604,11
0.504,0.001,356,348,10,100,0.0001,704,11
0.506,0.001,410,394,10,100,0.0001,804,11
0.504,0.001,458,446,10,100,0.0001,904,11
0.508,0.001,509,495,10,100,0.0001,1004,11
0.51,0.001,558,546,10,100,0.0001,1104,11
0.51,0.001,599,605,10,100,0.0001,1204,11
0.514,0.001,644,660,10,100,0.0001,1304,11
0.514,0.001,683,721,10,100,0.0001,1404,11
0.518,0.001,737,767,10,100,0.0001,1504,11
0.522,0.001,792,812,10,100,0.0001,1604,11
0.522,0.001,841,863,10,100,0.0001,1704,11
0.524,0.001,904,900,10,100,0.0001,1804,11
0.528,0.001,961,943,10,100,0.0001,1904,11
0.528,0.001,1010,994,10,100,0.0001,2004,11
0.468,0.001,54,50,10,100,0.0001,104,12
0.468,0.001,106,98,10,100,0.0001,204,12
0.47,0.001,155,149,10,100,0.0001,304,12
0.47,0.001,200,204,10,100,0.0001,404,12
0.47,0.001,248,256,10,100,0.0001,504,12
0.47,0.001,304,300,10,100,0.0001,604,12
0.472,0.001,353,351,10,100,0.0001,704,12
0.48,0.001,398,406,10,100,0.0001,804,12
0.482,0.001,445,459,10,100,0.0001,904,12
0.48,0.001,496,508,10,100,0.0001,1004,12
0.484,0.001,545,559,10,100,0.0001,1104,12
0.488,0.001,590,614,10,100,0.0001,1204,12
0.492,0.001,640,664,10,100,0.0001,1304,12
0.496,0.001,691,713,10,100,0.0001,1404,12
0.494,0.001,744,760,10,100,0.0001,1504,12
0.5,0.001,795,809,10,100,0.0001,1604,12
0.506,0.001,841,863,10,100,0.0001,1704,12
0.508,0.001,892,912,10,100,0.0001,1804,12
0.51,0.001,936,968,10,100,0.0001,1904,12
0.512,0.001,988,1016,10,100,0.0001,2004,12
0.526,0.001,50,54,10,100,0.0001,104,13
0.526,0.001,103,101,10,100,0.0001,204,13
0.53,0.001,140,164,10,100,0.0001,304,13
0.53,0.001,186,218,10,100,0.0001,404,13
0.532,0.001,236,268,10,100,0.0001,504,13
0.532,0.001,291,313,10,100,0.0001,604,13
0.534,0.001,344,360,10,100,0.0001,704,13
0.536,0.001,392,412,10,100,0.0001,804,13
0.534,0.001,445,459,10,100,0.0001,904,13
0.532,0.001,504,500,10,100,0.0001,1004,13
0.528,0.001,546,558,10,100,0.0001,1104,13
0.53,0.001,599,605,10,100,0.0001,1204,13
0.528,0.001,653,651,10,100,0.0001,1304,13
0.53,0.001,711,693,10,100,0.0001,1404,13
0.53,0.001,768,736,10,100,0.0001,1504,13
0.534,0.001,818,786,10,100,0.0001,1604,13
0.536,0.001,869,835,10,100,0.0001,1704,13
0.53,0.001,922,882,10,100,0.0001,1804,13
0.53,0.001,973,931,10,100,0.0001,1904,13
0.534,0.001,1023,981,10,100,0.0001,2004,13
0.526,0.001,57,47,10,100,0.0001,104,14
0.524,0.001,101,103,10,100,0.0001,204,14
0.524,0.001,154,150,10,100,0.0001,304,14
0.522,0.001,210,194,10,100,0.0001,404,14
0.52,0.001,259,245,10,100,0.0001,504,14
0.518,0.001,304,300,10,100,0.0001,604,14
0.516,0.001,349,355,10,100,0.0001,704,14
0.516,0.001,396,408,10,100,0.0001,804,14
0.516,0.001,446,458,10,100,0.0001,904,14
0.52,0.001,500,504,10,100,0.0001,1004,14
0.52,0.001,548,556,10,100,0.0001,1104,14
0.522,0.001,598,606,10,100,0.0001,1204,14
0.524,0.001,650,654,10,100,0.0001,1304,14
0.526,0.001,703,701,10,100,0.0001,1404,14
0.526,0.001,748,756,10,100,0.0001,1504,14
0.534,0.001,787,817,10,100,0.0001,1604,14
0.54,0.001,832,872,10,100,0.0001,1704,14
0.538,0.001,881,923,10,100,0.0001,1804,14
0.542,0.001,932,972,10,100,0.0001,1904,14
0.54,0.001,991,1013,10,100,0.0001,2004,14
0.466,0.001,46,58,10,100,0.0001,104,15
0.466,0.001,99,105,10,100,0.0001,204,15
0.466,0.001,150,154,10,100,0.0001,304,15
0.468,0.001,203,201,10,100,0.0001,404,15
0.468,0.001,267,237,10,100,0.0001,504,15
0.468,0.001,311,293,10,100,0.0001,604,15
0.464,0.001,358,346,10,100,0.0001,704,15
0.46,0.001,404,400,10,100,0.0001,804,15
0.466,0.001,452,452,10,100,0.0001,904,15
0.466,0.001,504,500,10,100,0.0001,1004,15
0.468,0.001,550,554,10,100,0.0001,1104,15
0.468,0.001,599,605,10,100,0.0001,1204,15
0.482,0.001,649,655,10,100,0.0001,1304,15
0.478,0.001,707,697,10,100,0.0001,1404,15
0.478,0.001,771,733,10,100,0.0001,1504,15
0.484,0.001,824,780,10,100,0.0001,1604,15
0.486,0.001,872,832,10,100,0.0001,1704,15
0.496,0.001,917,887,10,100,0.0001,1804,15
0.504,0.001,962,942,10,100,0.0001,1904,15
0.516,0.001,1013,991,10,100,0.0001,2004,15
0.48,0.001,46,58,10,100,0.0001,104,16
0.482,0.001,97,107,10,100,0.0001,204,16
0.484,0.001,142,162,10,100,0.0001,304,16
0.486,0.001,193,211,10,100,0.0001,404,16
0.486,0.001,239,265,10,100,0.0001,504,16
0.486,0.001,291,313,10,100,0.0001,604,16
0.484,0.001,345,359,10,100,0.0001,704,16
0.482,0.001,403,401,10,100,0.0001,804,16
0.486,0.001,451,453,10,100,0.0001,904,16
0.488,0.001,497,507,10,100,0.0001,1004,16
0.492,0.001,543,561,10,100,0.0001,1104,16
0.508,0.001,594,610,10,100,0.0001,1204,16
0.508,0.001,650,654,10,100,0.0001,1304,16
0.506,0.001,710,694,10,100,0.0001,1404,16
0.51,0.001,764,740,10,100,0.0001,1504,16
0.508,0.001,824,780,10,100,0.0001,1604,16
0.508,0.001,873,831,10,100,0.0001,1704,16
0.52,0.001,918,886,10,100,0.0001,1804,16
0.528,0.001,970,934,10,100,0.0001,1904,16
0.532,0.001,1021,983,10,100,0.0001,2004,16
0.47,0.001,45,59,10,100,0.0001,104,17
0.47,0.001,89,115,10,100,0.0001,204,17
0.466,0.001,135,169,10,100,0.0001,304,17
0.472,0.001,180,224,10,100,0.0001,404,17
0.48,0.001,234,270,10,100,0.0001,504,17
0.478,0.001,288,316,10,100,0.0001,604,17
0.48,0.001,330,374,10,100,0.0001,704,17
0.484,0.001,382,422,10,100,0.0001,804,17
0.484,0.001,443,461,10,100,0.0001,904,17
0.492,0.001,494,510,10,100,0.0001,1004,17
0.5,0.001,546,558,10,100,0.0001,1104,17
0.502,0.001,598,606,10,100,0.0001,1204,17
0.514,0.001,648,656,10,100,0.0001,1304,17
0.518,0.001,698,706,10,100,0.0001,1404,17
0.524,0.001,745,759,10,100,0.0001,1504,17
0.528,0.001,790,814,10,100,0.0001,1604,17
0.532,0.001,839,865,10,100,0.0001,1704,17
0.53,0.001,884,920,10,100,0.0001,1804,17
0.534,0.001,930,974,10,100,0.0001,1904,17
0.542,0.001,981,1023,10,100,0.0001,2004,17
0.528,0.001,51,53,10,100,0.0001,104,18
0.53,0.001,105,99,10,100,0.0001,204,18
0.53,0.001,153,151,10,100,0.0001,304,18
0.53,0.001,198,206,10,100,0.0001,404,18
0.53,0.001,251,253,10,100,0.0001,504,18
0.532,0.001,291,313,10,100,0.0001,604,18
0.532,0.001,340,364,10,100,0.0001,704,18
0.538,0.001,388,416,10,100,0.0001,804,18
0.536,0.001,444,460,10,100,0.0001,904,18
0.538,0.001,489,515,10,100,0.0001,1004,18
0.542,0.001,536,568,10,100,0.0001,1104,18
0.544,0.001,584,620,10,100,0.0001,1204,18
0.556,0.001,641,663,10,100,0.0001,1304,18
0.564,0.001,694,710,10,100,0.0001,1404,18
0.572,0.001,746,758,10,100,0.0001,1504,18
0.576,0.001,800,804,10,100,0.0001,1604,18
0.586,0.001,851,853,10,100,0.0001,1704,18
0.59,0.001,899,905,10,100,0.0001,1804,18
0.596,0.001,948,956,10,100,0.0001,1904,18
0.6,0.001,996,1008,10,100,0.0001,2004,18
0.5,0.001,52,52,10,100,0.0001,104,19
0.504,0.001,113,91,10,100,0.0001,204,19
0.502,0.001,159,145,10,100,0.0001,304,19
0.502,0.001,208,196,10,100,0.0001,404,19
0.502,0.001,266,238,10,100,0.0001,504,19
0.504,0.001,325,279,10,100,0.0001,604,19
0.502,0.001,380,324,10,100,0.0001,704,19
0.51,0.001,431,373,10,100,0.0001,804,19
0.518,0.001,486,418,10,100,0.0001,904,19
0.52,0.001,538,466,10,100,0.0001,1004,19
0.524,0.001,587,517,10,100,0.0001,1104,19
0.53,0.001,637,567,10,100,0.0001,1204,19
0.534,0.001,691,613,10,100,0.0001,1304,19
0.548,0.001,731,673,10,100,0.0001,1404,19
0.55,0.001,786,718,10,100,0.0001,1504,19
0.562,0.001,831,773,10,100,0.0001,1604,19
0.57,0.001,881,823,10,100,0.0001,1704,19
0.576,0.001,934,870,10,100,0.0001,1804,19
0.58,0.001,981,923,10,100,0.0001,1904,19
0.596,0.001,1019,985,10,100,0.0001,2004,19
0.46,0.001,47,57,10,100,0.0001,104,20
0.466,0.001,94,110,10,100,0.0001,204,20
0.466,0.001,146,158,10,100,0.0001,304,20
0.466,0.001,196,208,10,100,0.0001,404,20
0.46,0.001,245,259,10,100,0.0001,504,20
0.462,0.001,300,304,10,100,0.0001,604,20
0.464,0.001,354,350,10,100,0.0001,704,20
0.468,0.001,399,405,10,100,0.0001,804,20
0.472,0.001,461,443,10,100,0.0001,904,20
0.478,0.001,511,493,10,100,0.0001,1004,20
0.478,0.001,562,542,10,100,0.0001,1104,20
0.484,0.001,619,585,10,100,0.0001,1204,20
0.486,0.001,671,633,10,100,0.0001,1304,20
0.486,0.001,724,680,10,100,0.0001,1404,20
0.49,0.001,774,730,10,100,0.0001,1504,20
0.49,0.001,823,781,10,100,0.0001,1604,20
0.494,0.001,870,834,10,100,0.0001,1704,20
0.492,0.001,925,879,10,100,0.0001,1804,20
0.502,0.001,977,927,10,100,0.0001,1904,20
0.5,0.001,1028,976,10,100,0.0001,2004,20
0.54,0.001,49,55,10,100,0.001,104,1
0.552,0.001,102,102,10,100,0.001,204,1
0.546,0.001,149,155,10,100,0.001,304,1
0.556,0.001,200,204,10,100,0.001,404,1
0.564,0.001,254,250,10,100,0.001,504,1
0.568,0.001,305,299,10,100,0.001,604,1
0.582,0.001,356,348,10,100,0.001,704,1
0.618,0.001,402,402,10,100,0.001,804,1
0.644,0.001,457,447,10,100,0.001,904,1
0.68,0.001,502,502,10,100,0.001,1004,1
0.706,0.001,546,558,10,100,0.001,1104,1
0.73,0.001,595,609,10,100,0.001,1204,1
0.758,0.001,647,657,10,100,0.001,1304,1
0.778,0.001,694,710,10,100,0.001,1404,1
0.804,0.001,742,762,10,100,0.001,1504,1
0.834,0.001,793,811,10,100,0.001,1604,1
0.852,0.001,836,868,10,100,0.001,1704,1
0.87,0.001,886,918,10,100,0.001,1804,1
0.882,0.001,933,971,10,100,0.001,1904,1
0.898,0.001,984,1020,10,100,0.001,2004,1
0.456,0.001,55,49,10,100,0.001,104,2
0.466,0.001,107,97,10,100,0.001,204,2
0.476,0.001,162,142,10,100,0.001,304,2
0.488,0.001,210,194,10,100,0.001,404,2
0.492,0.001,252,252,10,100,0.001,504,2
0.508,0.001,295,309,10,100,0.001,604,2
0.546,0.001,339,365,10,100,0.001,704,2
0.562,0.001,383,421,10,100,0.001,804,2
0.584,0.001,437,467,10,100,0.001,904,2
0.61,0.001,485,519,10,100,0.001,1004,2
0.636,0.001,532,572,10,100,0.001,1104,2
0.648,0.001,580,624,10,100,0.001,1204,2
0.666,0.001,631,673,10,100,0.001,1304,2
0.694,0.001,680,724,10,100,0.001,1404,2
0.732,0.001,727,777,10,100,0.001,1504,2
0.756,0.001,780,824,10,100,0.001,1604,2
0.792,0.001,834,870,10,100,0.001,1704,2
0.824,0.001,884,920,10,100,0.001,1804,2
0.83,0.001,929,975,10,100,0.001,1904,2
0.856,0.001,984,1020,10,100,0.001,2004,2
0.518,0.001,53,51,10,100,0.001,104,3
0.528,0.001,101,103,10,100,0.001,204,3
0.53,0.001,148,156,10,100,0.001,304,3
0.54,0.001,192,212,10,100,0.001,404,3
0.538,0.001,244,260,10,100,0.001,504,3
0.562,0.001,290,314,10,100,0.001,604,3
0.574,0.001,347,357,10,100,0.001,704,3
0.602,0.001,388,416,10,100,0.001,804,3
0.63,0.001,438,466,10,100,0.001,904,3
0.658,0.001,488,516,10,100,0.001,1004,3
0.678,0.001,545,559,10,100,0.001,1104,3
0.71,0.001,594,610,10,100,0.001,1204,3
0.734,0.001,645,659,10,100,0.001,1304,3
0.752,0.001,694,710,10,100,0.001,1404,3
0.756,0.001,751,753,10,100,0.001,1504,3
0.782,0.001,799,805,10,100,0.001,1604,3
0.804,0.001,851,853,10,100,0.001,1704,3
0.838,0.001,903,901,10,100,0.001,1804,3
0.884,0.001,953,951,10,100,0.001,1904,3
0.89,0.001,1001,1003,10,100,0.001,2004,3
0.484,0.001,50,54,10,100,0.001,104,4
0.494,0.001,97,107,10,100,0.001,204,4
0.504,0.001,149,155,10,100,0.001,304,4
0.514,0.001,202,202,10,100,0.001,404,4
0.526,0.001,251,253,10,100,0.001,504,4
0.544,0.001,297,307,10,100,0.001,604,4
0.564,0.001,357,347,10,100,0.001,704,4
0.588,0.001,406,398,10,100,0.001,804,4
0.608,0.001,446,458,10,100,0.001,904,4
0.632,0.001,497,507,10,100,0.001,1004,4
0.646,0.001,547,557,10,100,0.001,1104,4
0.666,0.001,593,611,10,100,0.001,1204,4
0.694,0.001,644,660,10,100,0.001,1304,4
0.738,0.001,687,717,10,100,0.001,1404,4
0.762,0.001,738,766,10,100,0.001,1504,4
0.79,0.001,791,813,10,100,0.001,1604,4
0.814,0.001,845,859,10,100,0.001,1704,4
0.838,0.001,890,914,10,100,0.001,1804,4
0.858,0.001,941,963,10,100,0.001,1904,4
0.866,0.001,999,1005,10,100,0.001,2004,4
0.496,0.001,47,57,10,100,0.001,104,5
0.496,0.001,102,102,10,100,0.001,204,5
0.502,0.001,157,147,10,100,0.001,304,5
0.514,0.001,208,196,10,100,0.001,404,5
0.526,0.001,248,256,10,100,0.001,504,5
0.558,0.001,299,305,10,100,0.001,604,5
0.59,0.001,347,357,10,100,0.001,704,5
0.57,0.001,388,416,10,100,0.001,804,5
0.58,0.001,443,461,10,100,0.001,904,5
0.608,0.001,499,505,10,100,0.001,1004,5
0.622,0.001,546,558,10,100,0.001,1104,5
0.648,0.001,596,608,10,100,0.001,1204,5
0.672,0.001,649,655,10,100,0.001,1304,5
0.702,0.001,699,705,10,100,0.001,1404,5
0.716,0.001,758,746,10,100,0.001,1504,5
0.732,0.001,804,800,10,100,0.001,1604,5
0.766,0.001,846,858,10,100,0.001,1704,5
0.788,0.001,904,900,10,100,0.001,1804,5
0.82,0.001,953,951,10,100,0.001,1904,5
0.856,0.001,996,1008,10,100,0.001,2004,5
0.506,0.001,52,52,10,100,0.001,104,6
0.506,0.001,98,106,10,100,0.001,204,6
0.508,0.001,142,162,10,100,0.001,304,6
0.512,0.001,193,211,10,100,0.001,404,6
0.514,0.001,240,264,10,100,0.001,504,6
0.52,0.001,296,308,10,100,0.001,604,6
0.536,0.001,353,351,10,100,0.001,704,6
0.568,0.001,407,397,10,100,0.001,804,6
0.594,0.001,453,451,10,100,0.001,904,6
0.63,0.001,502,502,10,100,0.001,1004,6
0.658,0.001,550,554,10,100,0.001,1104,6
0.68,0.001,608,596,10,100,0.001,1204,6
0.732,0.001,653,651,10,100,0.001,1304,6
0.764,0.001,701,703,10,100,0.001,1404,6
0.8,0.001,746,758,10,100,0.001,1504,6
0.814,0.001,800,804,10,100,0.001,1604,6
0.84,0.001,852,852,10,100,0.001,1704,6
0.85,0.001,894,910,10,100,0.001,1804,6
0.848,0.001,948,956,10,100,0.001,1904,6
0.866,0.001,1003,1001,10,100,0.001,2004,6
0.534,0.001,55,49,10,100,0.001,104,7
0.544,0.001,105,99,10,100,0.001,204,7
0.552,0.001,149,155,10,100,0.001,304,7
0.584,0.001,199,205,10,100,0.001,404,7
0.596,0.001,251,253,10,100,0.001,504,7
0.622,0.001,304,300,10,100,0.001,604,7
0.638,0.001,352,352,10,100,0.001,704,7
0.66,0.001,405,399,10,100,0.001,804,7
0.69,0.001,462,442,10,100,0.001,904,7
0.722,0.001,509,495,10,100,0.001,1004,7
0.74,0.001,558,546,10,100,0.001,1104,7
0.76,0.001,617,587,10,100,0.001,1204,7
0.776,0.001,669,635,10,100,0.001,1304,7
0.804,0.001,704,700,10,100,0.001,1404,7
0.822,0.001,748,756,10,100,0.001,1504,7
0.84,0.001,795,809,10,100,0.001,1604,7
0.842,0.001,857,847,10,100,0.001,1704,7
0.868,0.001,906,898,10,100,0.001,1804,7
0.878,0.001,959,945,10,100,0.001,1904,7
0.884,0.001,1007,997,10,100,0.001,2004,7
0.478,0.001,53,51,10,100,0.001,104,8
0.486,0.001,104,100,10,100,0.001,204,8
0.482,0.001,153,151,10,100,0.001,304,8
0.496,0.001,195,209,10,100,0.001,404,8
0.492,0.001,244,260,10,100,0.001,504,8
0.51,0.001,296,308,10,100,0.001,604,8
0.518,0.001,347,357,10,100,0.001,704,8
0.544,0.001,399,405,10,100,0.001,804,8
0.55,0.001,441,463,10,100,0.001,904,8
0.568,0.001,490,514,10,100,0.001,1004,8
0.62,0.001,546,558,10,100,0.001,1104,8
0.676,0.001,601,603,10,100,0.001,1204,8
0.74,0.001,655,649,10,100,0.001,1304,8
0.77,0.001,702,702,10,100,0.001,1404,8
0.794,0.001,756,748,10,100,0.001,1504,8
0.808,0.001,802,802,10,100,0.001,1604,8
0.814,0.001,861,843,10,100,0.001,1704,8
0.838,0.001,913,891,10,100,0.001,1804,8
0.868,0.001,967,937,10,100,0.001,1904,8
0.888,0.001,1011,993,10,100,0.001,2004,8
0.496,0.001,44,60,10,100,0.001,104,9
0.51,0.001,98,106,10,100,0.001,204,9
0.522,0.001,153,151,10,100,0.001,304,9
0.534,0.001,200,204,10,100,0.001,404,9
0.556,0.001,254,250,10,100,0.001,504,9
0.594,0.001,304,300,10,100,0.001,604,9
0.604,0.001,357,347,10,100,0.001,704,9
0.624,0.001,404,400,10,100,0.001,804,9
0.63,0.001,450,454,10,100,0.001,904,9
0.624,0.001,497,507,10,100,0.001,1004,9
0.632,0.001,546,558,10,100,0.001,1104,9
0.648,0.001,594,610,10,100,0.001,1204,9
0.678,0.001,651,653,10,100,0.001,1304,9
0.712,0.001,700,704,10,100,0.001,1404,9
0.754,0.001,755,749,10,100,0.001,1504,9
0.796,0.001,811,793,10,100,0.001,1604,9
0.816,0.001,863,841,10,100,0.001,1704,9
0.846,0.001,911,893,10,100,0.001,1804,9
0.874,0.001,955,949,10,100,0.001,1904,9
0.892,0.001,1011,993,10,100,0.001,2004,9
0.432,0.001,54,50,10,100,0.001,104,10
0.428,0.001,109,95,10,100,0.001,204,10
0.438,0.001,162,142,10,100,0.001,304,10
0.454,0.001,210,194,10,100,0.001,404,10
0.466,0.001,264,240,10,100,0.001,504,10
0.494,0.001,315,289,10,100,0.001,604,10
0.518,0.001,360,344,10,100,0.001,704,10
0.554,0.001,405,399,10,100,0.001,804,10
0.566,0.001,456,448,10,100,0.001,904,10
0.592,0.001,508,496,10,100,0.001,1004,10
0.618,0.001,554,550,10,100,0.001,1104,10
0.638,0.001,601,603,10,100,0.001,1204,10
0.64,0.001,643,661,10,100,0.001,1304,10
0.65,0.001,687,717,10,100,0.001,1404,10
0.7,0.001,745,759,10,100,0.001,1504,10
0.732,0.001,794,810,10,100,0.001,1604,10
0.778,0.001,839,865,10,100,0.001,1704,10
0.802,0.001,894,910,10,100,0.001,1804,10
0.834,0.001,944,960,10,100,0.001,1904,10
0.854,0.001,991,1013,10,100,0.001,2004,10
0.426,0.001,52,52,10,100,0.001,104,11
0.43,0.001,104,100,10,100,0.001,204,11
0.446,0.001,157,147,10,100,0.001,304,11
0.46,0.001,201,203,10,100,0.001,404,11
0.474,0.001,256,248,10,100,0.001,504,11
0.492,0.001,298,306,10,100,0.001,604,11
0.5,0.001,344,360,10,100,0.001,704,11
0.536,0.001,390,414,10,100,0.001,804,11
0.556,0.001,443,461,10,100,0.001,904,11
0.594,0.001,497,507,10,100,0.001,1004,11
0.638,0.001,547,557,10,100,0.001,1104,11
0.658,0.001,602,602,10,100,0.001,1204,11
0.682,0.001,636,668,10,100,0.001,1304,11
0.706,0.001,696,708,10,100,0.001,1404,11
0.736,0.001,748,756,10,100,0.001,1504,11
0.758,0.001,796,808,10,100,0.001,1604,11
0.784,0.001,845,859,10,100,0.001,1704,11
0.81,0.001,904,900,10,100,0.001,1804,11
0.824,0.001,949,955,10,100,0.001,1904,11
0.854,0.001,1002,1002,10,100,0.001,2004,11
0.55,0.001,48,56,10,100,0.001,104,12
0.568,0.001,102,102,10,100,0.001,204,12
0.56,0.001,156,148,10,100,0.001,304,12
0.57,0.001,210,194,10,100,0.001,404,12
0.582,0.001,256,248,10,100,0.001,504,12
0.596,0.001,304,300,10,100,0.001,604,12
0.602,0.001,354,350,10,100,0.001,704,12
0.6,0.001,404,400,10,100,0.001,804,12
0.614,0.001,452,452,10,100,0.001,904,12
0.626,0.001,509,495,10,100,0.001,1004,12
0.646,0.001,557,547,10,100,0.001,1104,12
0.678,0.001,610,594,10,100,0.001,1204,12
0.714,0.001,658,646,10,100,0.001,1304,12
0.75,0.001,707,697,10,100,0.001,1404,12
0.768,0.001,760,744,10,100,0.001,1504,12
0.796,0.001,816,788,10,100,0.001,1604,12
0.822,0.001,862,842,10,100,0.001,1704,12
0.84,0.001,917,887,10,100,0.001,1804,12
0.87,0.001,964,940,10,100,0.001,1904,12
0.888,0.001,1008,996,10,100,0.001,2004,12
0.452,0.001,58,46,10,100,0.001,104,13
0.456,0.001,106,98,10,100,0.001,204,13
0.468,0.001,143,161,10,100,0.001,304,13
0.468,0.001,200,204,10,100,0.001,404,13
0.476,0.001,248,256,10,100,0.001,504,13
0.5,0.001,293,311,10,100,0.001,604,13
0.522,0.001,346,358,10,100,0.001,704,13
0.56,0.001,399,405,10,100,0.001,804,13
0.598,0.001,453,451,10,100,0.001,904,13
0.646,0.001,502,502,10,100,0.001,1004,13
0.68,0.001,547,557,10,100,0.001,1104,13
0.71,0.001,605,599,10,100,0.001,1204,13
0.742,0.001,655,649,10,100,0.001,1304,13
0.77,0.001,700,704,10,100,0.001,1404,13
0.786,0.001,751,753,10,100,0.001,1504,13
0.804,0.001,802,802,10,100,0.001,1604,13
0.812,0.001,843,861,10,100,0.001,1704,13
0.834,0.001,889,915,10,100,0.001,1804,13
0.854,0.001,937,967,10,100,0.001,1904,13
0.872,0.001,984,1020,10,100,0.001,2004,13
0.524,0.001,56,48,10,100,0.001,104,14
0.55,0.001,105,99,10,100,0.001,204,14
0.564,0.001,150,154,10,100,0.001,304,14
0.574,0.001,204,200,10,100,0.001,404,14
0.588,0.001,260,244,10,100,0.001,504,14
0.6,0.001,309,295,10,100,0.001,604,14
0.618,0.001,360,344,10,100,0.001,704,14
0.626,0.001,411,393,10,100,0.001,804,14
0.648,0.001,453,451,10,100,0.001,904,14
0.678,0.001,503,501,10,100,0.001,1004,14
0.682,0.001,553,551,10,100,0.001,1104,14
0.702,0.001,606,598,10,100,0.001,1204,14
0.718,0.001,651,653,10,100,0.001,1304,14
0.744,0.001,706,698,10,100,0.001,1404,14
0.774,0.001,762,742,10,100,0.001,1504,14
0.8,0.001,807,797,10,100,0.001,1604,14
0.814,0.001,847,857,10,100,0.001,1704,14
0.84,0.001,893,911,10,100,0.001,1804,14
0.866,0.001,943,961,10,100,0.001,1904,14
0.892,0.001,995,1009,10,100,0.001,2004,14
0.518,0.001,42,62,10,100,0.001,104,15
0.526,0.001,97,107,10,100,0.001,204,15
0.53,0.001,154,150,10,100,0.001,304,15
0.53,0.001,197,207,10,100,0.001,404,15
0.53,0.001,242,262,10,100,0.001,504,15
0.548,0.001,278,326,10,100,0.001,604,15
0.554,0.001,326,378,10,100,0.001,704,15
0.588,0.001,368,436,10,100,0.001,804,15
0.618,0.001,423,481,10,100,0.001,904,15
0.676,0.001,472,532,10,100,0.001,1004,15
0.704,0.001,522,582,10,100,0.001,1104,15
0.71,0.001,571,633,10,100,0.001,1204,15
0.718,0.001,626,678,10,100,0.001,1304,15
0.726,0.001,673,731,10,100,0.001,1404,15
0.744,0.001,723,781,10,100,0.001,1504,15
0.776,0.001,778,826,10,100,0.001,1604,15
0.828,0.001,835,869,10,100,0.001,1704,15
0.844,0.001,890,914,10,100,0.001,1804,15
0.848,0.001,947,957,10,100,0.001,1904,15
0.878,0.001,995,1009,10,100,0.001,2004,15
0.438,0.001,52,52,10,100,0.001,104,16
0.444,0.001,96,108,10,100,0.001,204,16
0.446,0.001,151,153,10,100,0.001,304,16
0.47,0.001,197,207,10,100,0.001,404,16
0.474,0.001,245,259,10,100,0.001,504,16
0.5,0.001,295,309,10,100,0.001,604,16
0.54,0.001,343,361,10,100,0.001,704,16
0.572,0.001,389,415,10,100,0.001,804,16
0.584,0.001,437,467,10,100,0.001,904,16
0.6,0.001,490,514,10,100,0.001,1004,16
0.628,0.001,539,565,10,100,0.001,1104,16
0.654,0.001,584,620,10,100,0.001,1204,16
0.666,0.001,641,663,10,100,0.001,1304,16
0.682,0.001,694,710,10,100,0.001,1404,16
0.716,0.001,748,756,10,100,0.001,1504,16
0.74,0.001,805,799,10,100,0.001,1604,16
0.764,0.001,857,847,10,100,0.001,1704,16
0.798,0.001,902,902,10,100,0.001,1804,16
0.838,0.001,955,949,10,100,0.001,1904,16
0.852,0.001,1002,1002,10,100,0.001,2004,16
0.5,0.001,58,46,10,100,0.001,104,17
0.506,0.001,110,94,10,100,0.001,204,17
0.518,0.001,152,152,10,100,0.001,304,17
0.524,0.001,200,204,10,100,0.001,404,17
0.526,0.001,254,250,10,100,0.001,504,17
0.538,0.001,312,292,10,100,0.001,604,17
0.562,0.001,356,348,10,100,0.001,704,17
0.59,0.001,408,396,10,100,0.001,804,17
0.63,0.001,460,444,10,100,0.001,904,17
0.654,0.001,506,498,10,100,0.001,1004,17
0.682,0.001,554,550,10,100,0.001,1104,17
0.722,0.001,600,604,10,100,0.001,1204,17
0.754,0.001,652,652,10,100,0.001,1304,17
0.764,0.001,702,702,10,100,0.001,1404,17
0.772,0.001,752,752,10,100,0.001,1504,17
0.79,0.001,806,798,10,100,0.001,1604,17
0.808,0.001,852,852,10,100,0.001,1704,17
0.826,0.001,907,897,10,100,0.001,1804,17
0.848,0.001,962,942,10,100,0.001,1904,17
0.866,0.001,1014,990,10,100,0.001,2004,17
0.466,0.001,47,57,10,100,0.001,104,18
0.48,0.001,98,106,10,100,0.001,204,18
0.494,0.001,148,156,10,100,0.001,304,18
0.51,0.001,200,204,10,100,0.001,404,18
0.528,0.001,242,262,10,100,0.001,504,18
0.55,0.001,290,314,10,100,0.001,604,18
0.582,0.001,340,364,10,100,0.001,704,18
0.59,0.001,381,423,10,100,0.001,804,18
0.61,0.001,430,474,10,100,0.001,904,18
0.62,0.001,480,524,10,100,0.001,1004,18
0.632,0.001,536,568,10,100,0.001,1104,18
0.658,0.001,588,616,10,100,0.001,1204,18
0.67,0.001,640,664,10,100,0.001,1304,18
0.696,0.001,689,715,10,100,0.001,1404,18
0.732,0.001,746,758,10,100,0.001,1504,18
0.762,0.001,799,805,10,100,0.001,1604,18
0.774,0.001,847,857,10,100,0.001,1704,18
0.796,0.001,893,911,10,100,0.001,1804,18
0.826,0.001,942,962,10,100,0.001,1904,18
0.858,0.001,997,1007,10,100,0.001,2004,18
0.516,0.001,50,54,10,100,0.001,104,19
0.516,0.001,100,104,10,100,0.001,204,19
0.536,0.001,153,151,10,100,0.001,304,19
0.554,0.001,199,205,10,100,0.001,404,19
0.572,0.001,250,254,10,100,0.001,504,19
0.598,0.001,296,308,10,100,0.001,604,19
0.626,0.001,341,363,10,100,0.001,704,19
0.66,0.001,390,414,10,100,0.001,804,19
0.692,0.001,445,459,10,100,0.001,904,19
0.71,0.001,487,517,10,100,0.001,1004,19
0.736,0.001,541,563,10,100,0.001,1104,19
0.766,0.001,593,611,10,100,0.001,1204,19
0.782,0.001,639,665,10,100,0.001,1304,19
0.808,0.001,684,720,10,100,0.001,1404,19
0.826,0.001,734,770,10,100,0.001,1504,19
0.85,0.001,791,813,10,100,0.001,1604,19
0.866,0.001,835,869,10,100,0.001,1704,19
0.88,0.001,892,912,10,100,0.001,1804,19
0.896,0.001,944,960,10,100,0.001,1904,19
0.896,0.001,992,1012,10,100,0.001,2004,19
0.46,0.001,55,49,10,100,0.001,104,20
0.474,0.001,106,98,10,100,0.001,204,20
0.49,0.001,152,152,10,100,0.001,304,20
0.52,0.001,192,212,10,100,0.001,404,20
0.528,0.001,243,261,10,100,0.001,504,20
0.54,0.001,288,316,10,100,0.001,604,20
0.556,0.001,338,366,10,100,0.001,704,20
0.582,0.001,382,422,10,100,0.001,804,20
0.592,0.001,438,466,10,100,0.001,904,20
0.61,0.001,484,520,10,100,0.001,1004,20
0.622,0.001,535,569,10,100,0.001,1104,20
0.63,0.001,584,620,10,100,0.001,1204,20
0.668,0.001,639,665,10,100,0.001,1304,20
0.712,0.001,685,719,10,100,0.001,1404,20
0.73,0.001,737,767,10,100,0.001,1504,20
0.762,0.001,790,814,10,100,0.001,1604,20
0.794,0.001,844,860,10,100,0.001,1704,20
0.836,0.001,893,911,10,100,0.001,1804,20
0.852,0.001,950,954,10,100,0.001,1904,20
0.89,0.001,1002,1002,10,100,0.001,2004,20
0.548,0.001,50,54,10,100,0.01,104,1
0.604,0.001,100,104,10,100,0.01,204,1
0.618,0.001,149,155,10,100,0.01,304,1
0.656,0.001,196,208,10,100,0.01,404,1
0.71,0.001,241,263,10,100,0.01,504,1
0.746,0.001,296,308,10,100,0.01,604,1
0.76,0.001,350,354,10,100,0.01,704,1
0.882,0.001,397,407,10,100,0.01,804,1
0.924,0.001,453,451,10,100,0.01,904,1
0.928,0.001,501,503,10,100,0.01,1004,1
0.94,0.001,556,548,10,100,0.01,1104,1
0.944,0.001,602,602,10,100,0.01,1204,1
0.942,0.001,655,649,10,100,0.01,1304,1
0.948,0.001,701,703,10,100,0.01,1404,1
0.952,0.001,754,750,10,100,0.01,1504,1
0.952,0.001,804,800,10,100,0.01,1604,1
0.966,0.001,857,847,10,100,0.01,1704,1
0.966,0.001,904,900,10,100,0.01,1804,1
0.974,0.001,960,944,10,100,0.01,1904,1
0.974,0.001,1006,998,10,100,0.01,2004,1
0.568,0.001,45,59,10,100,0.01,104,2
0.594,0.001,98,106,10,100,0.01,204,2
0.594,0.001,142,162,10,100,0.01,304,2
0.62,0.001,183,221,10,100,0.01,404,2
0.68,0.001,234,270,10,100,0.01,504,2
0.756,0.001,278,326,10,100,0.01,604,2
0.818,0.001,329,375,10,100,0.01,704,2
0.848,0.001,380,424,10,100,0.01,804,2
0.902,0.001,434,470,10,100,0.01,904,2
0.93,0.001,492,512,10,100,0.01,1004,2
0.938,0.001,540,564,10,100,0.01,1104,2
0.952,0.001,599,605,10,100,0.01,1204,2
0.956,0.001,648,656,10,100,0.01,1304,2
0.962,0.001,703,701,10,100,0.01,1404,2
0.964,0.001,757,747,10,100,0.01,1504,2
0.98,0.001,805,799,10,100,0.01,1604,2
0.978,0.001,861,843,10,100,0.01,1704,2
0.986,0.001,911,893,10,100,0.01,1804,2
0.982,0.001,960,944,10,100,0.01,1904,2
0.982,0.001,1009,995,10,100,0.01,2004,2
0.57,0.001,53,51,10,100,0.01,104,3
0.602,0.001,103,101,10,100,0.01,204,3
0.612,0.001,151,153,10,100,0.01,304,3
0.632,0.001,203,201,10,100,0.01,404,3
0.644,0.001,250,254,10,100,0.01,504,3
0.702,0.001,297,307,10,100,0.01,604,3
0.776,0.001,350,354,10,100,0.01,704,3
0.872,0.001,399,405,10,100,0.01,804,3
0.888,0.001,451,453,10,100,0.01,904,3
0.928,0.001,499,505,10,100,0.01,1004,3
0.938,0.001,549,555,10,100,0.01,1104,3
0.946,0.001,607,597,10,100,0.01,1204,3
0.944,0.001,658,646,10,100,0.01,1304,3
0.954,0.001,711,693,10,100,0.01,1404,3
0.96,0.001,767,737,10,100,0.01,1504,3
0.964,0.001,815,789,10,100,0.01,1604,3
0.964,0.001,863,841,10,100,0.01,1704,3
0.972,0.001,911,893,10,100,0.01,1804,3
0.96,0.001,958,946,10,100,0.01,1904,3
0.968,0.001,999,1005,10,100,0.01,2004,3
0.552,0.001,51,53,10,100,0.01,104,4
0.582,0.001,101,103,10,100,0.01,204,4
0.54,0.001,152,152,10,100,0.01,304,4
0.596,0.001,197,207,10,100,0.01,404,4
0.656,0.001,243,261,10,100,0.01,504,4
0.676,0.001,290,314,10,100,0.01,604,4
0.74,0.001,345,359,10,100,0.01,704,4
0.836,0.001,394,410,10,100,0.01,804,4
0.884,0.001,437,467,10,100,0.01,904,4
0.922,0.001,488,516,10,100,0.01,1004,4
0.934,0.001,541,563,10,100,0.01,1104,4
0.958,0.001,597,607,10,100,0.01,1204,4
0.962,0.001,649,655,10,100,0.01,1304,4
0.966,0.001,697,707,10,100,0.01,1404,4
0.968,0.001,749,755,10,100,0.01,1504,4
0.976,0.001,800,804,10,100,0.01,1604,4
0.976,0.001,848,856,10,100,0.01,1704,4
0.978,0.001,909,895,10,100,0.01,1804,4
0.98,0.001,962,942,10,100,0.01,1904,4
0.984,0.001,1007,997,10,100,0.01,2004,4
0.572,0.001,52,52,10,100,0.01,104,5
0.636,0.001,97,107,10,100,0.01,204,5
0.622,0.001,139,165,10,100,0.01,304,5
0.658,0.001,196,208,10,100,0.01,404,5
0.658,0.001,238,266,10,100,0.01,504,5
0.72,0.001,279,325,10,100,0.01,604,5
0.784,0.001,331,373,10,100,0.01,704,5
0.904,0.001,387,417,10,100,0.01,804,5
0.948,0.001,435,469,10,100,0.01,904,5
0.954,0.001,488,516,10,100,0.01,1004,5
0.97,0.001,539,565,10,100,0.01,1104,5
0.972,0.001,586,618,10,100,0.01,1204,5
0.972,0.001,634,670,10,100,0.01,1304,5
0.972,0.001,684,720,10,100,0.01,1404,5
0.97,0.001,742,762,10,100,0.01,1504,5
0.976,0.001,784,820,10,100,0.01,1604,5
0.98,0.001,835,869,10,100,0.01,1704,5
0.984,0.001,886,918,10,100,0.01,1804,5
0.984,0.001,936,968,10,100,0.01,1904,5
0.986,0.001,991,1013,10,100,0.01,2004,5
0.52,0.001,40,64,10,100,0.01,104,6
0.506,0.001,89,115,10,100,0.01,204,6
0.514,0.001,147,157,10,100,0.01,304,6
0.576,0.001,199,205,10,100,0.01,404,6
0.66,0.001,247,257,10,100,0.01,504,6
0.776,0.001,299,305,10,100,0.01,604,6
0.834,0.001,350,354,10,100,0.01,704,6
0.916,0.001,409,395,10,100,0.01,804,6
0.94,0.001,465,439,10,100,0.01,904,6
0.954,0.001,509,495,10,100,0.01,1004,6
0.958,0.001,557,547,10,100,0.01,1104,6
0.964,0.001,600,604,10,100,0.01,1204,6
0.966,0.001,656,648,10,100,0.01,1304,6
0.972,0.001,710,694,10,100,0.01,1404,6
0.974,0.001,764,740,10,100,0.01,1504,6
0.976,0.001,804,800,10,100,0.01,1604,6
0.972,0.001,852,852,10,100,0.01,1704,6
0.98,0.001,892,912,10,100,0.01,1804,6
0.982,0.001,945,959,10,100,0.01,1904,6
0.982,0.001,990,1014,10,100,0.01,2004,6
0.456,0.001,54,50,10,100,0.01,104,7
0.564,0.001,102,102,10,100,0.01,204,7
0.578,0.001,148,156,10,100,0.01,304,7
0.618,0.001,191,213,10,100,0.01,404,7
0.656,0.001,240,264,10,100,0.01,504,7
0.712,0.001,298,306,10,100,0.01,604,7
0.766,0.001,358,346,10,100,0.01,704,7
0.86,0.001,402,402,10,100,0.01,804,7
0.888,0.001,454,450,10,100,0.01,904,7
0.924,0.001,504,500,10,100,0.01,1004,7
0.936,0.001,552,552,10,100,0.01,1104,7
0.944,0.001,600,604,10,100,0.01,1204,7
0.94,0.001,655,649,10,100,0.01,1304,7
0.952,0.001,710,694,10,100,0.01,1404,7
0.968,0.001,762,742,10,100,0.01,1504,7
0.972,0.001,808,796,10,100,0.01,1604,7
0.978,0.001,853,851,10,100,0.01,1704,7
0.972,0.001,906,898,10,100,0.01,1804,7
0.98,0.001,957,947,10,100,0.01,1904,7
0.982,0.001,1008,996,10,100,0.01,2004,7
0.536,0.001,46,58,10,100,0.01,104,8
0.56,0.001,90,114,10,100,0.01,204,8
0.584,0.001,136,168,10,100,0.01,304,8
0.606,0.001,187,217,10,100,0.01,404,8
0.638,0.001,235,269,10,100,0.01,504,8
0.7,0.001,290,314,10,100,0.01,604,8
0.784,0.001,338,366,10,100,0.01,704,8
0.89,0.001,386,418,10,100,0.01,804,8
0.914,0.001,434,470,10,100,0.01,904,8
0.92,0.001,486,518,10,100,0.01,1004,8
0.924,0.001,541,563,10,100,0.01,1104,8
0.954,0.001,593,611,10,100,0.01,1204,8
0.95,0.001,647,657,10,100,0.01,1304,8
0.96,0.001,696,708,10,100,0.01,1404,8
0.966,0.001,748,756,10,100,0.01,1504,8
0.97,0.001,802,802,10,100,0.01,1604,8
0.978,0.001,855,849,10,100,0.01,1704,8
0.978,0.001,909,895,10,100,0.01,1804,8
0.982,0.001,960,944,10,100,0.01,1904,8
0.988,0.001,1012,992,10,100,0.01,2004,8
0.506,0.001,49,55,10,100,0.01,104,9
0.59,0.001,103,101,10,100,0.01,204,9
0.656,0.001,150,154,10,100,0.01,304,9
0.708,0.001,198,206,10,100,0.01,404,9
0.734,0.001,245,259,10,100,0.01,504,9
0.786,0.001,297,307,10,100,0.01,604,9
0.804,0.001,342,362,10,100,0.01,704,9
0.85,0.001,392,412,10,100,0.01,804,9
0.884,0.001,443,461,10,100,0.01,904,9
0.904,0.001,490,514,10,100,0.01,1004,9
0.942,0.001,544,560,10,100,0.01,1104,9
0.954,0.001,586,618,10,100,0.01,1204,9
0.954,0.001,632,672,10,100,0.01,1304,9
0.97,0.001,681,723,10,100,0.01,1404,9
0.968,0.001,737,767,10,100,0.01,1504,9
0.98,0.001,790,814,10,100,0.01,1604,9
0.982,0.001,841,863,10,100,0.01,1704,9
0.972,0.001,892,912,10,100,0.01,1804,9
0.984,0.001,945,959,10,100,0.01,1904,9
0.984,0.001,992,1012,10,100,0.01,2004,9
0.61,0.001,52,52,10,100,0.01,104,10
0.688,0.001,103,101,10,100,0.01,204,10
0.704,0.001,159,145,10,100,0.01,304,10
0.696,0.001,216,188,10,100,0.01,404,10
0.71,0.001,266,238,10,100,0.01,504,10
0.776,0.001,320,284,10,100,0.01,604,10
0.838,0.001,362,342,10,100,0.01,704,10
0.868,0.001,414,390,10,100,0.01,804,10
0.902,0.001,459,445,10,100,0.01,904,10
0.928,0.001,516,488,10,100,0.01,1004,10
0.938,0.001,571,533,10,100,0.01,1104,10
0.96,0.001,615,589,10,100,0.01,1204,10
0.974,0.001,661,643,10,100,0.01,1304,10
0.978,0.001,709,695,10,100,0.01,1404,10
0.98,0.001,756,748,10,100,0.01,1504,10
0.978,0.001,803,801,10,100,0.01,1604,10
0.976,0.001,853,851,10,100,0.01,1704,10
0.98,0.001,902,902,10,100,0.01,1804,10
0.982,0.001,950,954,10,100,0.01,1904,10
0.982,0.001,1006,998,10,100,0.01,2004,10
0.574,0.001,55,49,10,100,0.01,104,11
0.59,0.001,112,92,10,100,0.01,204,11
0.576,0.001,155,149,10,100,0.01,304,11
0.626,0.001,204,200,10,100,0.01,404,11
0.684,0.001,258,246,10,100,0.01,504,11
0.774,0.001,304,300,10,100,0.01,604,11
0.802,0.001,348,356,10,100,0.01,704,11
0.848,0.001,397,407,10,100,0.01,804,11
0.866,0.001,453,451,10,100,0.01,904,11
0.908,0.001,499,505,10,100,0.01,1004,11
0.932,0.001,551,553,10,100,0.01,1104,11
0.938,0.001,605,599,10,100,0.01,1204,11
0.942,0.001,651,653,10,100,0.01,1304,11
0.956,0.001,699,705,10,100,0.01,1404,11
0.96,0.001,746,758,10,100,0.01,1504,11
0.964,0.001,797,807,10,100,0.01,1604,11
0.97,0.001,848,856,10,100,0.01,1704,11
0.97,0.001,910,894,10,100,0.01,1804,11
0.974,0.001,961,943,10,100,0.01,1904,11
0.98,0.001,1015,989,10,100,0.01,2004,11
0.482,0.001,55,49,10,100,0.01,104,12
0.568,0.001,112,92,10,100,0.01,204,12
0.642,0.001,158,146,10,100,0.01,304,12
0.706,0.001,208,196,10,100,0.01,404,12
0.74,0.001,263,241,10,100,0.01,504,12
0.77,0.001,316,288,10,100,0.01,604,12
0.798,0.001,360,344,10,100,0.01,704,12
0.902,0.001,417,387,10,100,0.01,804,12
0.94,0.001,459,445,10,100,0.01,904,12
0.942,0.001,510,494,10,100,0.01,1004,12
0.95,0.001,564,540,10,100,0.01,1104,12
0.97,0.001,607,597,10,100,0.01,1204,12
0.98,0.001,660,644,10,100,0.01,1304,12
0.98,0.001,708,696,10,100,0.01,1404,12
0.984,0.001,761,743,10,100,0.01,1504,12
0.984,0.001,807,797,10,100,0.01,1604,12
0.986,0.001,858,846,10,100,0.01,1704,12
0.986,0.001,905,899,10,100,0.01,1804,12
0.99,0.001,958,946,10,100,0.01,1904,12
0.99,0.001,1013,991,10,100,0.01,2004,12
0.466,0.001,46,58,10,100,0.01,104,13
0.584,0.001,103,101,10,100,0.01,204,13
0.63,0.001,153,151,10,100,0.01,304,13
0.666,0.001,201,203,10,100,0.01,404,13
0.692,0.001,245,259,10,100,0.01,504,13
0.76,0.001,287,317,10,100,0.01,604,13
0.814,0.001,341,363,10,100,0.01,704,13
0.87,0.001,388,416,10,100,0.01,804,13
0.866,0.001,432,472,10,100,0.01,904,13
0.918,0.001,482,522,10,100,0.01,1004,13
0.934,0.001,535,569,10,100,0.01,1104,13
0.94,0.001,597,607,10,100,0.01,1204,13
0.942,0.001,650,654,10,100,0.01,1304,13
0.956,0.001,697,707,10,100,0.01,1404,13
0.964,0.001,739,765,10,100,0.01,1504,13
0.964,0.001,787,817,10,100,0.01,1604,13
0.968,0.001,840,864,10,100,0.01,1704,13
0.962,0.001,887,917,10,100,0.01,1804,13
0.97,0.001,939,965,10,100,0.01,1904,13
0.982,0.001,981,1023,10,100,0.01,2004,13
0.544,0.001,41,63,10,100,0.01,104,14
0.54,0.001,89,115,10,100,0.01,204,14
0.552,0.001,141,163,10,100,0.01,304,14
0.612,0.001,198,206,10,100,0.01,404,14
0.744,0.001,247,257,10,100,0.01,504,14
0.786,0.001,300,304,10,100,0.01,604,14
0.834,0.001,343,361,10,100,0.01,704,14
0.92,0.001,397,407,10,100,0.01,804,14
0.894,0.001,450,454,10,100,0.01,904,14
0.926,0.001,504,500,10,100,0.01,1004,14
0.954,0.001,561,543,10,100,0.01,1104,14
0.96,0.001,612,592,10,100,0.01,1204,14
0.968,0.001,663,641,10,100,0.01,1304,14
0.978,0.001,706,698,10,100,0.01,1404,14
0.976,0.001,758,746,10,100,0.01,1504,14
0.978,0.001,812,792,10,100,0.01,1604,14
0.982,0.001,866,838,10,100,0.01,1704,14
0.984,0.001,916,888,10,100,0.01,1804,14
0.99,0.001,964,940,10,100,0.01,1904,14
0.994,0.001,1014,990,10,100,0.01,2004,14
0.564,0.001,52,52,10,100,0.01,104,15
0.556,0.001,94,110,10,100,0.01,204,15
0.594,0.001,146,158,10,100,0.01,304,15
0.628,0.001,203,201,10,100,0.01,404,15
0.678,0.001,251,253,10,100,0.01,504,15
0.79,0.001,306,298,10,100,0.01,604,15
0.842,0.001,362,342,10,100,0.01,704,15
0.904,0.001,418,386,10,100,0.01,804,15
0.94,0.001,478,426,10,100,0.01,904,15
0.956,0.001,528,476,10,100,0.01,1004,15
0.966,0.001,578,526,10,100,0.01,1104,15
0.972,0.001,627,577,10,100,0.01,1204,15
0.98,0.001,681,623,10,100,0.01,1304,15
0.974,0.001,725,679,10,100,0.01,1404,15
0.978,0.001,771,733,10,100,0.01,1504,15
0.982,0.001,813,791,10,100,0.01,1604,15
0.986,0.001,860,844,10,100,0.01,1704,15
0.986,0.001,915,889,10,100,0.01,1804,15
0.988,0.001,958,946,10,100,0.01,1904,15
0.994,0.001,1011,993,10,100,0.01,2004,15
0.556,0.001,45,59,10,100,0.01,104,16
0.57,0.001,99,105,10,100,0.01,204,16
0.612,0.001,146,158,10,100,0.01,304,16
0.674,0.001,195,209,10,100,0.01,404,16
0.702,0.001,236,268,10,100,0.01,504,16
0.77,0.001,285,319,10,100,0.01,604,16
0.81,0.001,327,377,10,100,0.01,704,16
0.87,0.001,380,424,10,100,0.01,804,16
0.912,0.001,433,471,10,100,0.01,904,16
0.946,0.001,477,527,10,100,0.01,1004,16
0.956,0.001,525,579,10,100,0.01,1104,16
0.956,0.001,571,633,10,100,0.01,1204,16
0.95,0.001,623,681,10,100,0.01,1304,16
0.962,0.001,675,729,10,100,0.01,1404,16
0.974,0.001,733,771,10,100,0.01,1504,16
0.968,0.001,789,815,10,100,0.01,1604,16
0.968,0.001,833,871,10,100,0.01,1704,16
0.966,0.001,876,928,10,100,0.01,1804,16
0.976,0.001,931,973,10,100,0.01,1904,16
0.984,0.001,987,1017,10,100,0.01,2004,16
0.544,0.001,50,54,10,100,0.01,104,17
0.61,0.001,106,98,10,100,0.01,204,17
0.628,0.001,160,144,10,100,0.01,304,17
0.662,0.001,206,198,10,100,0.01,404,17
0.698,0.001,256,248,10,100,0.01,504,17
0.77,0.001,303,301,10,100,0.01,604,17
0.842,0.001,357,347,10,100,0.01,704,17
0.906,0.001,402,402,10,100,0.01,804,17
0.93,0.001,454,450,10,100,0.01,904,17
0.942,0.001,507,497,10,100,0.01,1004,17
0.96,0.001,552,552,10,100,0.01,1104,17
0.958,0.001,600,604,10,100,0.01,1204,17
0.962,0.001,664,640,10,100,0.01,1304,17
0.97,0.001,713,691,10,100,0.01,1404,17
0.972,0.001,762,742,10,100,0.01,1504,17
0.978,0.001,810,794,10,100,0.01,1604,17
0.98,0.001,861,843,10,100,0.01,1704,17
0.984,0.001,912,892,10,100,0.01,1804,17
0.984,0.001,955,949,10,100,0.01,1904,17
0.984,0.001,1004,1000,10,100,0.01,2004,17
0.548,0.001,53,51,10,100,0.01,104,18
0.598,0.001,98,106,10,100,0.01,204,18
0.56,0.001,148,156,10,100,0.01,304,18
0.58,0.001,193,211,10,100,0.01,404,18
0.662,0.001,240,264,10,100,0.01,504,18
0.768,0.001,296,308,10,100,0.01,604,18
0.8,0.001,350,354,10,100,0.01,704,18
0.86,0.001,399,405,10,100,0.01,804,18
0.894,0.001,443,461,10,100,0.01,904,18
0.916,0.001,490,514,10,100,0.01,1004,18
0.936,0.001,542,562,10,100,0.01,1104,18
0.944,0.001,595,609,10,100,0.01,1204,18
0.942,0.001,644,660,10,100,0.01,1304,18
0.954,0.001,700,704,10,100,0.01,1404,18
0.956,0.001,751,753,10,100,0.01,1504,18
0.96,0.001,801,803,10,100,0.01,1604,18
0.966,0.001,844,860,10,100,0.01,1704,18
0.966,0.001,899,905,10,100,0.01,1804,18
0.968,0.001,940,964,10,100,0.01,1904,18
0.97,0.001,991,1013,10,100,0.01,2004,18
0.636,0.001,54,50,10,100,0.01,104,19
0.656,0.001,104,100,10,100,0.01,204,19
0.68,0.001,159,145,10,100,0.01,304,19
0.742,0.001,211,193,10,100,0.01,404,19
0.782,0.001,267,237,10,100,0.01,504,19
0.864,0.001,324,280,10,100,0.01,604,19
0.896,0.001,378,326,10,100,0.01,704,19
0.914,0.001,429,375,10,100,0.01,804,19
0.934,0.001,484,420,10,100,0.01,904,19
0.944,0.001,534,470,10,100,0.01,1004,19
0.946,0.001,591,513,10,100,0.01,1104,19
0.958,0.001,635,569,10,100,0.01,1204,19
0.964,0.001,681,623,10,100,0.01,1304,19
0.974,0.001,732,672,10,100,0.01,1404,19
0.982,0.001,780,724,10,100,0.01,1504,19
0.984,0.001,826,778,10,100,0.01,1604,19
0.982,0.001,871,833,10,100,0.01,1704,19
0.98,0.001,920,884,10,100,0.01,1804,19
0.988,0.001,969,935,10,100,0.01,1904,19
0.99,0.001,1015,989,10,100,0.01,2004,19
0.608,0.001,56,48,10,100,0.01,104,20
0.662,0.001,109,95,10,100,0.01,204,20
0.698,0.001,161,143,10,100,0.01,304,20
0.75,0.001,213,191,10,100,0.01,404,20
0.824,0.001,260,244,10,100,0.01,504,20
0.864,0.001,310,294,10,100,0.01,604,20
0.866,0.001,364,340,10,100,0.01,704,20
0.908,0.001,407,397,10,100,0.01,804,20
0.956,0.001,455,449,10,100,0.01,904,20
0.97,0.001,502,502,10,100,0.01,1004,20
0.966,0.001,550,554,10,100,0.01,1104,20
0.97,0.001,598,606,10,100,0.01,1204,20
0.98,0.001,645,659,10,100,0.01,1304,20
0.974,0.001,697,707,10,100,0.01,1404,20
0.978,0.001,750,754,10,100,0.01,1504,20
0.98,0.001,796,808,10,100,0.01,1604,20
0.986,0.001,846,858,10,100,0.01,1704,20
0.986,0.001,901,903,10,100,0.01,1804,20
0.986,0.001,950,954,10,100,0.01,1904,20
0.988,0.001,1002,1002,10,100,0.01,2004,20
0.568,1e-05,50,54,25,2,0.0001,104,1
0.568,1e-05,93,111,25,2,0.0001,204,1
0.568,1e-05,139,165,25,2,0.0001,304,1
0.568,1e-05,186,218,25,2,0.0001,404,1
0.568,1e-05,234,270,25,2,0.0001,504,1
0.568,1e-05,291,313,25,2,0.0001,604,1
0.568,1e-05,341,363,25,2,0.0001,704,1
0.568,1e-05,395,409,25,2,0.0001,804,1
0.568,1e-05,438,466,25,2,0.0001,904,1
0.568,1e-05,490,514,25,2,0.0001,1004,1
0.568,1e-05,536,568,25,2,0.0001,1104,1
0.566,1e-05,590,614,25,2,0.0001,1204,1
0.566,1e-05,641,663,25,2,0.0001,1304,1
0.566,1e-05,695,709,25,2,0.0001,1404,1
0.564,1e-05,743,761,25,2,0.0001,1504,1
0.564,1e-05,795,809,25,2,0.0001,1604,1
0.562,1e-05,852,852,25,2,0.0001,1704,1
0.562,1e-05,889,915,25,2,0.0001,1804,1
0.564,1e-05,948,956,25,2,0.0001,1904,1
0.564,1e-05,993,1011,25,2,0.0001,2004,1
0.502,1e-05,55,49,25,2,0.0001,104,2
0.502,1e-05,110,94,25,2,0.0001,204,2
0.502,1e-05,155,149,25,2,0.0001,304,2
0.502,1e-05,205,199,25,2,0.0001,404,2
0.502,1e-05,259,245,25,2,0.0001,504,2
0.502,1e-05,305,299,25,2,0.0001,604,2
0.502,1e-05,357,347,25,2,0.0001,704,2
0.502,1e-05,408,396,25,2,0.0001,804,2
0.502,1e-05,457,447,25,2,0.0001,904,2
0.502,1e-05,504,500,25,2,0.0001,1004,2
0.502,1e-05,552,552,25,2,0.0001,1104,2
0.502,1e-05,603,601,25,2,0.0001,1204,2
0.502,1e-05,652,652,25,2,0.0001,1304,2
0.502,1e-05,703,701,25,2,0.0001,1404,2
0.502,1e-05,746,758,25,2,0.0001,1504,2
0.502,1e-05,796,808,25,2,0.0001,1604,2
0.502,1e-05,853,851,25,2,0.0001,1704,2
0.502,1e-05,891,913,25,2,0.0001,1804,2
0.502,1e-05,938,966,25,2,0.0001,1904,2
0.502,1e-05,999,1005,25,2,0.0001,2004,2
0.504,1e-05,52,52,25,2,0.0001,104,3
0.504,1e-05,108,96,25,2,0.0001,204,3
0.504,1e-05,155,149,25,2,0.0001,304,3
0.504,1e-05,214,190,25,2,0.0001,404,3
0.504,1e-05,262,242,25,2,0.0001,504,3
0.504,1e-05,320,284,25,2,0.0001,604,3
0.504,1e-05,371,333,25,2,0.0001,704,3
0.504,1e-05,421,383,25,2,0.0001,804,3
0.504,1e-05,464,440,25,2,0.0001,904,3
0.504,1e-05,512,492,25,2,0.0001,1004,3
0.504,1e-05,565,539,25,2,0.0001,1104,3
0.504,1e-05,608,596,25,2,0.0001,1204,3
0.504,1e-05,669,635,25,2,0.0001,1304,3
0.504,1e-05,719,685,25,2,0.0001,1404,3
0.504,1e-05,767,737,25,2,0.0001,1504,3
0.504,1e-05,815,789,25,2,0.0001,1604,3
0.504,1e-05,863,841,25,2,0.0001,1704,3
0.504,1e-05,908,896,25,2,0.0001,1804,3
0.504,1e-05,955,949,25,2,0.0001,1904,3
0.504,1e-05,1000,1004,25,2,0.0001,2004,3
0.45,1e-05,50,54,25,2,0.0001,104,4
0.45,1e-05,102,102,25,2,0.0001,204,4
0.45,1e-05,142,162,25,2,0.0001,304,4
0.45,1e-05,205,199,25,2,0.0001,404,4
0.45,1e-05,253,251,25,2,0.0001,504,4
0.45,1e-05,292,312,25,2,0.0001,604,4
0.45,1e-05,348,356,25,2,0.0001,704,4
0.45,1e-05,400,404,25,2,0.0001,804,4
0.45,1e-05,441,463,25,2,0.0001,904,4
0.45,1e-05,490,514,25,2,0.0001,1004,4
0.45,1e-05,544,560,25,2,0.0001,1104,4
0.45,1e-05,594,610,25,2,0.0001,1204,4
0.45,1e-05,645,659,25,2,0.0001,1304,4
0.45,1e-05,704,700,25,2,0.0001,1404,4
0.45,1e-05,752,752,25,2,0.0001,1504,4
0.45,1e-05,796,808,25,2,0.0001,1604,4
0.45,1e-05,841,863,25,2,0.0001,1704,4
0.45,1e-05,888,916,25,2,0.0001,1804,4
0.45,1e-05,930,974,25,2,0.0001,1904,4
0.45,1e-05,977,1027,25,2,0.0001,2004,4
0.512,1e-05,51,53,25,2,0.0001,104,5
0.512,1e-05,95,109,25,2,0.0001,204,5
0.512,1e-05,143,161,25,2,0.0001,304,5
0.512,1e-05,194,210,25,2,0.0001,404,5
0.514,1e-05,250,254,25,2,0.0001,504,5
0.514,1e-05,301,303,25,2,0.0001,604,5
0.514,1e-05,357,347,25,2,0.0001,704,5
0.514,1e-05,399,405,25,2,0.0001,804,5
0.514,1e-05,455,449,25,2,0.0001,904,5
0.514,1e-05,495,509,25,2,0.0001,1004,5
0.516,1e-05,544,560,25,2,0.0001,1104,5
0.516,1e-05,591,613,25,2,0.0001,1204,5
0.516,1e-05,650,654,25,2,0.0001,1304,5
0.516,1e-05,705,699,25,2,0.0001,1404,5
0.516,1e-05,755,749,25,2,0.0001,1504,5
0.516,1e-05,804,800,25,2,0.0001,1604,5
0.516,1e-05,857,847,25,2,0.0001,1704,5
0.518,1e-05,915,889,25,2,0.0001,1804,5
0.518,1e-05,960,944,25,2,0.0001,1904,5
0.52,1e-05,1013,991,25,2,0.0001,2004,5
0.496,1e-05,60,44,25,2,0.0001,104,6
0.496,1e-05,112,92,25,2,0.0001,204,6
0.496,1e-05,155,149,25,2,0.0001,304,6
0.496,1e-05,203,201,25,2,0.0001,404,6
0.496,1e-05,258,246,25,2,0.0001,504,6
0.496,1e-05,302,302,25,2,0.0001,604,6
0.496,1e-05,356,348,25,2,0.0001,704,6
0.496,1e-05,404,400,25,2,0.0001,804,6
0.496,1e-05,452,452,25,2,0.0001,904,6
0.496,1e-05,504,500,25,2,0.0001,1004,6
0.496,1e-05,555,549,25,2,0.0001,1104,6
0.496,1e-05,604,600,25,2,0.0001,1204,6
0.496,1e-05,649,655,25,2,0.0001,1304,6
0.496,1e-05,705,699,25,2,0.0001,1404,6
0.496,1e-05,753,751,25,2,0.0001,1504,6
0.496,1e-05,806,798,25,2,0.0001,1604,6
0.496,1e-05,854,850,25,2,0.0001,1704,6
0.496,1e-05,899,905,25,2,0.0001,1804,6
0.496,1e-05,952,952,25,2,0.0001,1904,6
0.496,1e-05,1004,1000,25,2,0.0001,2004,6
0.494,1e-05,53,51,25,2,0.0001,104,7
0.494,1e-05,101,103,25,2,0.0001,204,7
0.494,1e-05,145,159,25,2,0.0001,304,7
0.494,1e-05,197,207,25,2,0.0001,404,7
0.494,1e-05,241,263,25,2,0.0001,504,7
0.494,1e-05,299,305,25,2,0.0001,604,7
0.494,1e-05,352,352,25,2,0.0001,704,7
0.494,1e-05,408,396,25,2,0.0001,804,7
0.494,1e-05,460,444,25,2,0.0001,904,7
0.494,1e-05,506,498,25,2,0.0001,1004,7
0.494,1e-05,563,541,25,2,0.0001,1104,7
0.494,1e-05,618,586,25,2,0.0001,1204,7
0.494,1e-05,665,639,25,2,0.0001,1304,7
0.494,1e-05,712,692,25,2,0.0001,1404,7
0.494,1e-05,768,736,25,2,0.0001,1504,7
0.494,1e-05,811,793,25,2,0.0001,1604,7
0.494,1e-05,860,844,25,2,0.0001,1704,7
0.494,1e-05,915,889,25,2,0.0001,1804,7
0.494,1e-05,967,937,25,2,0.0001,1904,7
0.494,1e-05,1005,999,25,2,0.0001,2004,7
0.468,1e-05,55,49,25,2,0.0001,104,8
0.468,1e-05,99,105,25,2,0.0001,204,8
0.468,1e-05,151,153,25,2,0.0001,304,8
0.466,1e-05,200,204,25,2,0.0001,404,8
0.466,1e-05,251,253,25,2,0.0001,504,8
0.466,1e-05,298,306,25,2,0.0001,604,8
0.466,1e-05,348,356,25,2,0.0001,704,8
0.466,1e-05,399,405,25,2,0.0001,804,8
0.468,1e-05,446,458,25,2,0.0001,904,8
0.47,1e-05,493,511,25,2,0.0001,1004,8
0.47,1e-05,545,559,25,2,0.0001,1104,8
0.47,1e-05,592,612,25,2,0.0001,1204,8
0.47,1e-05,645,659,25,2,0.0001,1304,8
0.47,1e-05,702,702,25,2,0.0001,1404,8
0.468,1e-05,750,754,25,2,0.0001,1504,8
0.468,1e-05,790,814,25,2,0.0001,1604,8
0.468,1e-05,848,856,25,2,0.0001,1704,8
0.468,1e-05,894,910,25,2,0.0001,1804,8
0.466,1e-05,944,960,25,2,0.0001,1904,8
0.466,1e-05,995,1009,25,2,0.0001,2004,8
0.542,1e-05,53,51,25,2,0.0001,104,9
0.542,1e-05,100,104,25,2,0.0001,204,9
0.542,1e-05,155,149,25,2,0.0001,304,9
0.54,1e-05,200,204,25,2,0.0001,404,9
0.54,1e-05,250,254,25,2,0.0001,504,9
0.54,1e-05,306,298,25,2,0.0001,604,9
0.54,1e-05,350,354,25,2,0.0001,704,9
0.54,1e-05,393,411,25,2,0.0001,804,9
0.54,1e-05,433,471,25,2,0.0001,904,9
0.54,1e-05,488,516,25,2,0.0001,1004,9
0.542,1e-05,542,562,25,2,0.0001,1104,9
0.542,1e-05,589,615,25,2,0.0001,1204,9
0.544,1e-05,641,663,25,2,0.0001,1304,9
0.544,1e-05,705,699,25,2,0.0001,1404,9
0.544,1e-05,761,743,25,2,0.0001,1504,9
0.544,1e-05,803,801,25,2,0.0001,1604,9
0.544,1e-05,838,866,25,2,0.0001,1704,9
0.544,1e-05,888,916,25,2,0.0001,1804,9
0.544,1e-05,934,970,25,2,0.0001,1904,9
0.544,1e-05,993,1011,25,2,0.0001,2004,9
0.492,1e-05,52,52,25,2,0.0001,104,10
0.492,1e-05,106,98,25,2,0.0001,204,10
0.492,1e-05,151,153,25,2,0.0001,304,10
0.492,1e-05,195,209,25,2,0.0001,404,10
0.492,1e-05,242,262,25,2,0.0001,504,10
0.492,1e-05,293,311,25,2,0.0001,604,10
0.492,1e-05,342,362,25,2,0.0001,704,10
0.492,1e-05,396,408,25,2,0.0001,804,10
0.492,1e-05,441,463,25,2,0.0001,904,10
0.492,1e-05,493,511,25,2,0.0001,1004,10
0.492,1e-05,541,563,25,2,0.0001,1104,10
0.492,1e-05,587,617,25,2,0.0001,1204,10
0.492,1e-05,635,669,25,2,0.0001,1304,10
0.492,1e-05,692,712,25,2,0.0001,1404,10
0.492,1e-05,745,759,25,2,0.0001,1504,10
0.492,1e-05,789,815,25,2,0.0001,1604,10
0.492,1e-05,836,868,25,2,0.0001,1704,10
0.492,1e-05,883,921,25,2,0.0001,1804,10
0.492,1e-05,941,963,25,2,0.0001,1904,10
0.492,1e-05,998,1006,25,2,0.0001,2004,10
0.51,1e-05,50,54,25,2,0.0001,104,11
0.51,1e-05,98,106,25,2,0.0001,204,11
0.51,1e-05,148,156,25,2,0.0001,304,11
0.51,1e-05,204,200,25,2,0.0001,404,11
0.51,1e-05,254,250,25,2,0.0001,504,11
0.51,1e-05,306,298,25,2,0.0001,604,11
0.51,1e-05,355,349,25,2,0.0001,704,11
0.51,1e-05,410,394,25,2,0.0001,804,11
0.506,1e-05,457,447,25,2,0.0001,904,11
0.506,1e-05,509,495,25,2,0.0001,1004,11
0.506,1e-05,563,541,25,2,0.0001,1104,11
0.508,1e-05,603,601,25,2,0.0001,1204,11
0.508,1e-05,657,647,25,2,0.0001,1304,11
0.508,1e-05,709,695,25,2,0.0001,1404,11
0.508,1e-05,758,746,25,2,0.0001,1504,11
0.508,1e-05,808,796,25,2,0.0001,1604,11
0.508,1e-05,852,852,25,2,0.0001,1704,11
0.508,1e-05,905,899,25,2,0.0001,1804,11
0.508,1e-05,958,946,25,2,0.0001,1904,11
0.508,1e-05,1013,991,25,2,0.0001,2004,11
0.51,1e-05,66,38,25,2,0.0001,104,12
0.51,1e-05,114,90,25,2,0.0001,204,12
0.51,1e-05,159,145,25,2,0.0001,304,12
0.51,1e-05,209,195,25,2,0.0001,404,12
0.51,1e-05,247,257,25,2,0.0001,504,12
0.51,1e-05,300,304,25,2,0.0001,604,12
0.51,1e-05,351,353,25,2,0.0001,704,12
0.51,1e-05,403,401,25,2,0.0001,804,12
0.51,1e-05,449,455,25,2,0.0001,904,12
0.51,1e-05,495,509,25,2,0.0001,1004,12
0.51,1e-05,538,566,25,2,0.0001,1104,12
0.51,1e-05,590,614,25,2,0.0001,1204,12
0.51,1e-05,641,663,25,2,0.0001,1304,12
0.51,1e-05,688,716,25,2,0.0001,1404,12
0.51,1e-05,743,761,25,2,0.0001,1504,12
0.51,1e-05,785,819,25,2,0.0001,1604,12
0.51,1e-05,842,862,25,2,0.0001,1704,12
0.512,1e-05,890,914,25,2,0.0001,1804,12
0.514,1e-05,944,960,25,2,0.0001,1904,12
0.514,1e-05,997,1007,25,2,0.0001,2004,12
0.49,1e-05,52,52,25,2,0.0001,104,13
0.49,1e-05,98,106,25,2,0.0001,204,13
0.49,1e-05,154,150,25,2,0.0001,304,13
0.49,1e-05,208,196,25,2,0.0001,404,13
0.49,1e-05,261,243,25,2,0.0001,504,13
0.49,1e-05,310,294,25,2,0.0001,604,13
0.49,1e-05,359,345,25,2,0.0001,704,13
0.49,1e-05,414,390,25,2,0.0001,804,13
0.49,1e-05,472,432,25,2,0.0001,904,13
0.49,1e-05,517,487,25,2,0.0001,1004,13
0.49,1e-05,559,545,25,2,0.0001,1104,13
0.49,1e-05,604,600,25,2,0.0001,1204,13
0.49,1e-05,655,649,25,2,0.0001,1304,13
0.49,1e-05,695,709,25,2,0.0001,1404,13
0.49,1e-05,748,756,25,2,0.0001,1504,13
0.49,1e-05,798,806,25,2,0.0001,1604,13
0.49,1e-05,840,864,25,2,0.0001,1704,13
0.49,1e-05,891,913,25,2,0.0001,1804,13
0.49,1e-05,944,960,25,2,0.0001,1904,13
0.49,1e-05,997,1007,25,2,0.0001,2004,13
0.5,1e-05,55,49,25,2,0.0001,104,14
0.5,1e-05,108,96,25,2,0.0001,204,14
0.5,1e-05,162,142,25,2,0.0001,304,14
0.5,1e-05,208,196,25,2,0.0001,404,14
0.5,1e-05,263,241,25,2,0.0001,504,14
0.5,1e-05,311,293,25,2,0.0001,604,14
0.5,1e-05,365,339,25,2,0.0001,704,14
0.5,1e-05,418,386,25,2,0.0001,804,14
0.5,1e-05,468,436,25,2,0.0001,904,14
0.5,1e-05,511,493,25,2,0.0001,1004,14
0.5,1e-05,557,547,25,2,0.0001,1104,14
0.5,1e-05,602,602,25,2,0.0001,1204,14
0.5,1e-05,661,643,25,2,0.0001,1304,14
0.5,1e-05,711,693,25,2,0.0001,1404,14
0.5,1e-05,759,745,25,2,0.0001,1504,14
0.5,1e-05,807,797,25,2,0.0001,1604,14
0.5,1e-05,854,850,25,2,0.0001,1704,14
0.5,1e-05,908,896,25,2,0.0001,1804,14
0.5,1e-05,954,950,25,2,0.0001,1904,14
0.5,1e-05,1002,1002,25,2,0.0001,2004,14
0.484,1e-05,50,54,25,2,0.0001,104,15
0.484,1e-05,102,102,25,2,0.0001,204,15
0.486,1e-05,154,150,25,2,0.0001,304,15
0.486,1e-05,202,202,25,2,0.0001,404,15
0.486,1e-05,252,252,25,2,0.0001,504,15
0.486,1e-05,303,301,25,2,0.0001,604,15
0.486,1e-05,358,346,25,2,0.0001,704,15
0.486,1e-05,399,405,25,2,0.0001,804,15
0.486,1e-05,453,451,25,2,0.0001,904,15
0.486,1e-05,509,495,25,2,0.0001,1004,15
0.486,1e-05,557,547,25,2,0.0001,1104,15
0.486,1e-05,607,597,25,2,0.0001,1204,15
0.486,1e-05,652,652,25,2,0.0001,1304,15
0.486,1e-05,702,702,25,2,0.0001,1404,15
0.486,1e-05,756,748,25,2,0.0001,1504,15
0.486,1e-05,803,801,25,2,0.0001,1604,15
0.486,1e-05,860,844,25,2,0.0001,1704,15
0.484,1e-05,914,890,25,2,0.0001,1804,15
0.484,1e-05,965,939,25,2,0.0001,1904,15
0.486,1e-05,1009,995,25,2,0.0001,2004,15
0.552,1e-05,47,57,25,2,0.0001,104,16
0.552,1e-05,95,109,25,2,0.0001,204,16
0.552,1e-05,131,173,25,2,0.0001,304,16
0.552,1e-05,177,227,25,2,0.0001,404,16
0.552,1e-05,231,273,25,2,0.0001,504,16
0.552,1e-05,285,319,25,2,0.0001,604,16
0.552,1e-05,327,377,25,2,0.0001,704,16
0.552,1e-05,376,428,25,2,0.0001,804,16
0.552,1e-05,425,479,25,2,0.0001,904,16
0.552,1e-05,474,530,25,2,0.0001,1004,16
0.552,1e-05,522,582,25,2,0.0001,1104,16
0.552,1e-05,570,634,25,2,0.0001,1204,16
0.552,1e-05,617,687,25,2,0.0001,1304,16
0.552,1e-05,678,726,25,2,0.0001,1404,16
0.552,1e-05,728,776,25,2,0.0001,1504,16
0.552,1e-05,775,829,25,2,0.0001,1604,16
0.552,1e-05,825,879,25,2,0.0001,1704,16
0.552,1e-05,875,929,25,2,0.0001,1804,16
0.552,1e-05,927,977,25,2,0.0001,1904,16
0.552,1e-05,976,1028,25,2,0.0001,2004,16
0.478,1e-05,47,57,25,2,0.0001,104,17
0.478,1e-05,86,118,25,2,0.0001,204,17
0.478,1e-05,141,163,25,2,0.0001,304,17
0.478,1e-05,187,217,25,2,0.0001,404,17
0.476,1e-05,239,265,25,2,0.0001,504,17
0.476,1e-05,295,309,25,2,0.0001,604,17
0.476,1e-05,350,354,25,2,0.0001,704,17
0.478,1e-05,394,410,25,2,0.0001,804,17
0.478,1e-05,449,455,25,2,0.0001,904,17
0.48,1e-05,503,501,25,2,0.0001,1004,17
0.48,1e-05,558,546,25,2,0.0001,1104,17
0.482,1e-05,606,598,25,2,0.0001,1204,17
0.48,1e-05,659,645,25,2,0.0001,1304,17
0.488,1e-05,706,698,25,2,0.0001,1404,17
0.49,1e-05,755,749,25,2,0.0001,1504,17
0.488,1e-05,801,803,25,2,0.0001,1604,17
0.49,1e-05,854,850,25,2,0.0001,1704,17
0.49,1e-05,908,896,25,2,0.0001,1804,17
0.49,1e-05,954,950,25,2,0.0001,1904,17
0.488,1e-05,1007,997,25,2,0.0001,2004,17
0.48,1e-05,49,55,25,2,0.0001,104,18
0.48,1e-05,104,100,25,2,0.0001,204,18
0.48,1e-05,156,148,25,2,0.0001,304,18
0.48,1e-05,205,199,25,2,0.0001,404,18
0.48,1e-05,256,248,25,2,0.0001,504,18
0.48,1e-05,306,298,25,2,0.0001,604,18
0.48,1e-05,358,346,25,2,0.0001,704,18
0.48,1e-05,406,398,25,2,0.0001,804,18
0.48,1e-05,458,446,25,2,0.0001,904,18
0.48,1e-05,502,502,25,2,0.0001,1004,18
0.48,1e-05,557,547,25,2,0.0001,1104,18
0.48,1e-05,605,599,25,2,0.0001,1204,18
0.48,1e-05,652,652,25,2,0.0001,1304,18
0.48,1e-05,690,714,25,2,0.0001,1404,18
0.48,1e-05,737,767,25,2,0.0001,1504,18
0.48,1e-05,786,818,25,2,0.0001,1604,18
0.48,1e-05,838,866,25,2,0.0001,1704,18
0.48,1e-05,900,904,25,2,0.0001,1804,18
0.48,1e-05,948,956,25,2,0.0001,1904,18
0.48,1e-05,992,1012,25,2,0.0001,2004,18
0.508,1e-05,49,55,25,2,0.0001,104,19
0.508,1e-05,103,101,25,2,0.0001,204,19
0.508,1e-05,150,154,25,2,0.0001,304,19
0.508,1e-05,188,216,25,2,0.0001,404,19
0.508,1e-05,237,267,25,2,0.0001,504,19
0.508,1e-05,289,315,25,2,0.0001,604,19
0.508,1e-05,337,367,25,2,0.0001,704,19
0.508,1e-05,386,418,25,2,0.0001,804,19
0.508,1e-05,430,474,25,2,0.0001,904,19
0.508,1e-05,485,519,25,2,0.0001,1004,19
0.508,1e-05,536,568,25,2,0.0001,1104,19
0.508,1e-05,591,613,25,2,0.0001,1204,19
0.508,1e-05,641,663,25,2,0.0001,1304,19
0.508,1e-05,690,714,25,2,0.0001,1404,19
0.508,1e-05,735,769,25,2,0.0001,1504,19
0.508,1e-05,786,818,25,2,0.0001,1604,19
0.508,1e-05,840,864,25,2,0.0001,1704,19
0.508,1e-05,887,917,25,2,0.0001,1804,19
0.506,1e-05,936,968,25,2,0.0001,1904,19
0.506,1e-05,994,1010,25,2,0.0001,2004,19
0.516,1e-05,53,51,25,2,0.0001,104,20
0.516,1e-05,102,102,25,2,0.0001,204,20
0.516,1e-05,151,153,25,2,0.0001,304,20
0.516,1e-05,199,205,25,2,0.0001,404,20
0.516,1e-05,250,254,25,2,0.0001,504,20
0.516,1e-05,298,306,25,2,0.0001,604,20
0.516,1e-05,349,355,25,2,0.0001,704,20
0.516,1e-05,397,407,25,2,0.0001,804,20
0.516,1e-05,456,448,25,2,0.0001,904,20
0.516,1e-05,502,502,25,2,0.0001,1004,20
0.516,1e-05,546,558,25,2,0.0001,1104,20
0.516,1e-05,597,607,25,2,0.0001,1204,20
0.516,1e-05,648,656,25,2,0.0001,1304,20
0.516,1e-05,695,709,25,2,0.0001,1404,20
0.516,1e-05,748,756,25,2,0.0001,1504,20
0.516,1e-05,811,793,25,2,0.0001,1604,20
0.516,1e-05,861,843,25,2,0.0001,1704,20
0.516,1e-05,910,894,25,2,0.0001,1804,20
0.516,1e-05,962,942,25,2,0.0001,1904,20
0.516,1e-05,1010,994,25,2,0.0001,2004,20
0.502,1e-05,44,60,25,2,0.001,104,1
0.502,1e-05,91,113,25,2,0.001,204,1
0.502,1e-05,143,161,25,2,0.001,304,1
0.502,1e-05,200,204,25,2,0.001,404,1
0.502,1e-05,245,259,25,2,0.001,504,1
0.504,1e-05,298,306,25,2,0.001,604,1
0.504,1e-05,350,354,25,2,0.001,704,1
0.504,1e-05,407,397,25,2,0.001,804,1
0.506,1e-05,448,456,25,2,0.001,904,1
0.512,1e-05,492,512,25,2,0.001,1004,1
0.512,1e-05,532,572,25,2,0.001,1104,1
0.516,1e-05,582,622,25,2,0.001,1204,1
0.52,1e-05,633,671,25,2,0.001,1304,1
0.526,1e-05,689,715,25,2,0.001,1404,1
0.534,1e-05,739,765,25,2,0.001,1504,1
0.532,1e-05,790,814,25,2,0.001,1604,1
0.534,1e-05,844,860,25,2,0.001,1704,1
0.542,1e-05,900,904,25,2,0.001,1804,1
0.546,1e-05,956,948,25,2,0.001,1904,1
0.554,1e-05,1002,1002,25,2,0.001,2004,1
0.492,1e-05,59,45,25,2,0.001,104,2
0.494,1e-05,106,98,25,2,0.001,204,2
0.494,1e-05,153,151,25,2,0.001,304,2
0.494,1e-05,203,201,25,2,0.001,404,2
0.494,1e-05,248,256,25,2,0.001,504,2
0.496,1e-05,293,311,25,2,0.001,604,2
0.496,1e-05,337,367,25,2,0.001,704,2
0.498,1e-05,382,422,25,2,0.001,804,2
0.502,1e-05,429,475,25,2,0.001,904,2
0.504,1e-05,479,525,25,2,0.001,1004,2
0.502,1e-05,536,568,25,2,0.001,1104,2
0.512,1e-05,582,622,25,2,0.001,1204,2
0.516,1e-05,633,671,25,2,0.001,1304,2
0.52,1e-05,689,715,25,2,0.001,1404,2
0.526,1e-05,745,759,25,2,0.001,1504,2
0.532,1e-05,796,808,25,2,0.001,1604,2
0.542,1e-05,844,860,25,2,0.001,1704,2
0.542,1e-05,896,908,25,2,0.001,1804,2
0.552,1e-05,946,958,25,2,0.001,1904,2
0.554,1e-05,1003,1001,25,2,0.001,2004,2
0.524,1e-05,48,56,25,2,0.001,104,3
0.52,1e-05,106,98,25,2,0.001,204,3
0.522,1e-05,150,154,25,2,0.001,304,3
0.522,1e-05,201,203,25,2,0.001,404,3
0.526,1e-05,255,249,25,2,0.001,504,3
0.526,1e-05,294,310,25,2,0.001,604,3
0.528,1e-05,348,356,25,2,0.001,704,3
0.526,1e-05,397,407,25,2,0.001,804,3
0.53,1e-05,453,451,25,2,0.001,904,3
0.532,1e-05,503,501,25,2,0.001,1004,3
0.536,1e-05,563,541,25,2,0.001,1104,3
0.536,1e-05,600,604,25,2,0.001,1204,3
0.538,1e-05,652,652,25,2,0.001,1304,3
0.536,1e-05,701,703,25,2,0.001,1404,3
0.534,1e-05,753,751,25,2,0.001,1504,3
0.538,1e-05,799,805,25,2,0.001,1604,3
0.538,1e-05,843,861,25,2,0.001,1704,3
0.546,1e-05,885,919,25,2,0.001,1804,3
0.544,1e-05,937,967,25,2,0.001,1904,3
0.546,1e-05,993,1011,25,2,0.001,2004,3
0.508,1e-05,60,44,25,2,0.001,104,4
0.508,1e-05,112,92,25,2,0.001,204,4
0.508,1e-05,167,137,25,2,0.001,304,4
0.508,1e-05,223,181,25,2,0.001,404,4
0.512,1e-05,278,226,25,2,0.001,504,4
0.514,1e-05,320,284,25,2,0.001,604,4
0.514,1e-05,371,333,25,2,0.001,704,4
0.514,1e-05,419,385,25,2,0.001,804,4
0.516,1e-05,467,437,25,2,0.001,904,4
0.518,1e-05,519,485,25,2,0.001,1004,4
0.518,1e-05,567,537,25,2,0.001,1104,4
0.52,1e-05,621,583,25,2,0.001,1204,4
0.516,1e-05,668,636,25,2,0.001,1304,4
0.518,1e-05,719,685,25,2,0.001,1404,4
0.52,1e-05,767,737,25,2,0.001,1504,4
0.518,1e-05,816,788,25,2,0.001,1604,4
0.52,1e-05,864,840,25,2,0.001,1704,4
0.526,1e-05,910,894,25,2,0.001,1804,4
0.534,1e-05,960,944,25,2,0.001,1904,4
0.538,1e-05,1005,999,25,2,0.001,2004,4
0.498,1e-05,53,51,25,2,0.001,104,5
0.502,1e-05,104,100,25,2,0.001,204,5
0.51,1e-05,147,157,25,2,0.001,304,5
0.51,1e-05,196,208,25,2,0.001,404,5
0.512,1e-05,236,268,25,2,0.001,504,5
0.514,1e-05,290,314,25,2,0.001,604,5
0.51,1e-05,343,361,25,2,0.001,704,5
0.512,1e-05,391,413,25,2,0.001,804,5
0.51,1e-05,442,462,25,2,0.001,904,5
0.508,1e-05,486,518,25,2,0.001,1004,5
0.5,1e-05,537,567,25,2,0.001,1104,5
0.5,1e-05,585,619,25,2,0.001,1204,5
0.508,1e-05,637,667,25,2,0.001,1304,5
0.51,1e-05,684,720,25,2,0.001,1404,5
0.512,1e-05,743,761,25,2,0.001,1504,5
0.514,1e-05,792,812,25,2,0.001,1604,5
0.532,1e-05,844,860,25,2,0.001,1704,5
0.536,1e-05,891,913,25,2,0.001,1804,5
0.536,1e-05,943,961,25,2,0.001,1904,5
0.54,1e-05,997,1007,25,2,0.001,2004,5
0.49,1e-05,53,51,25,2,0.001,104,6
0.492,1e-05,108,96,25,2,0.001,204,6
0.492,1e-05,158,146,25,2,0.001,304,6
0.492,1e-05,201,203,25,2,0.001,404,6
0.492,1e-05,257,247,25,2,0.001,504,6
0.492,1e-05,300,304,25,2,0.001,604,6
0.492,1e-05,356,348,25,2,0.001,704,6
0.492,1e-05,403,401,25,2,0.001,804,6
0.49,1e-05,455,449,25,2,0.001,904,6
0.49,1e-05,506,498,25,2,0.001,1004,6
0.492,1e-05,554,550,25,2,0.001,1104,6
0.494,1e-05,607,597,25,2,0.001,1204,6
0.494,1e-05,651,653,25,2,0.001,1304,6
0.494,1e-05,705,699,25,2,0.001,1404,6
0.494,1e-05,759,745,25,2,0.001,1504,6
0.496,1e-05,808,796,25,2,0.001,1604,6
0.496,1e-05,852,852,25,2,0.001,1704,6
0.5,1e-05,903,901,25,2,0.001,1804,6
0.5,1e-05,955,949,25,2,0.001,1904,6
0.5,1e-05,1006,998,25,2,0.001,2004,6
0.5,1e-05,50,54,25,2,0.001,104,7
0.5,1e-05,88,116,25,2,0.001,204,7
0.5,1e-05,143,161,25,2,0.001,304,7
0.5,1e-05,191,213,25,2,0.001,404,7
0.5,1e-05,240,264,25,2,0.001,504,7
0.5,1e-05,297,307,25,2,0.001,604,7
0.5,1e-05,346,358,25,2,0.001,704,7
0.5,1e-05,399,405,25,2,0.001,804,7
0.5,1e-05,452,452,25,2,0.001,904,7
0.5,1e-05,490,514,25,2,0.001,1004,7
0.5,1e-05,541,563,25,2,0.001,1104,7
0.5,1e-05,593,611,25,2,0.001,1204,7
0.5,1e-05,646,658,25,2,0.001,1304,7
0.5,1e-05,700,704,25,2,0.001,1404,7
0.5,1e-05,754,750,25,2,0.001,1504,7
0.5,1e-05,806,798,25,2,0.001,1604,7
0.5,1e-05,857,847,25,2,0.001,1704,7
0.5,1e-05,901,903,25,2,0.001,1804,7
0.5,1e-05,951,953,25,2,0.001,1904,7
0.5,1e-05,1002,1002,25,2,0.001,2004,7
0.504,1e-05,57,47,25,2,0.001,104,8
0.504,1e-05,112,92,25,2,0.001,204,8
0.498,1e-05,168,136,25,2,0.001,304,8
0.498,1e-05,217,187,25,2,0.001,404,8
0.496,1e-05,265,239,25,2,0.001,504,8
0.492,1e-05,317,287,25,2,0.001,604,8
0.488,1e-05,368,336,25,2,0.001,704,8
0.486,1e-05,425,379,25,2,0.001,804,8
0.484,1e-05,477,427,25,2,0.001,904,8
0.484,1e-05,519,485,25,2,0.001,1004,8
0.482,1e-05,563,541,25,2,0.001,1104,8
0.518,1e-05,610,594,25,2,0.001,1204,8
0.522,1e-05,662,642,25,2,0.001,1304,8
0.522,1e-05,705,699,25,2,0.001,1404,8
0.522,1e-05,764,740,25,2,0.001,1504,8
0.528,1e-05,809,795,25,2,0.001,1604,8
0.54,1e-05,857,847,25,2,0.001,1704,8
0.548,1e-05,907,897,25,2,0.001,1804,8
0.552,1e-05,958,946,25,2,0.001,1904,8
0.556,1e-05,1008,996,25,2,0.001,2004,8
0.526,1e-05,55,49,25,2,0.001,104,9
0.526,1e-05,106,98,25,2,0.001,204,9
0.528,1e-05,150,154,25,2,0.001,304,9
0.526,1e-05,197,207,25,2,0.001,404,9
0.524,1e-05,243,261,25,2,0.001,504,9
0.526,1e-05,291,313,25,2,0.001,604,9
0.526,1e-05,350,354,25,2,0.001,704,9
0.526,1e-05,397,407,25,2,0.001,804,9
0.526,1e-05,450,454,25,2,0.001,904,9
0.526,1e-05,499,505,25,2,0.001,1004,9
0.526,1e-05,549,555,25,2,0.001,1104,9
0.528,1e-05,596,608,25,2,0.001,1204,9
0.526,1e-05,644,660,25,2,0.001,1304,9
0.528,1e-05,698,706,25,2,0.001,1404,9
0.53,1e-05,747,757,25,2,0.001,1504,9
0.53,1e-05,794,810,25,2,0.001,1604,9
0.528,1e-05,845,859,25,2,0.001,1704,9
0.522,1e-05,891,913,25,2,0.001,1804,9
0.526,1e-05,935,969,25,2,0.001,1904,9
0.53,1e-05,995,1009,25,2,0.001,2004,9
0.492,1e-05,55,49,25,2,0.001,104,10
0.492,1e-05,103,101,25,2,0.001,204,10
0.492,1e-05,157,147,25,2,0.001,304,10
0.492,1e-05,209,195,25,2,0.001,404,10
0.492,1e-05,255,249,25,2,0.001,504,10
0.492,1e-05,303,301,25,2,0.001,604,10
0.492,1e-05,365,339,25,2,0.001,704,10
0.492,1e-05,421,383,25,2,0.001,804,10
0.492,1e-05,473,431,25,2,0.001,904,10
0.492,1e-05,513,491,25,2,0.001,1004,10
0.492,1e-05,569,535,25,2,0.001,1104,10
0.492,1e-05,615,589,25,2,0.001,1204,10
0.492,1e-05,659,645,25,2,0.001,1304,10
0.492,1e-05,708,696,25,2,0.001,1404,10
0.492,1e-05,759,745,25,2,0.001,1504,10
0.49,1e-05,809,795,25,2,0.001,1604,10
0.49,1e-05,860,844,25,2,0.001,1704,10
0.492,1e-05,913,891,25,2,0.001,1804,10
0.498,1e-05,958,946,25,2,0.001,1904,10
0.5,1e-05,1006,998,25,2,0.001,2004,10
0.498,1e-05,55,49,25,2,0.001,104,11
0.498,1e-05,102,102,25,2,0.001,204,11
0.498,1e-05,152,152,25,2,0.001,304,11
0.498,1e-05,205,199,25,2,0.001,404,11
0.498,1e-05,257,247,25,2,0.001,504,11
0.498,1e-05,309,295,25,2,0.001,604,11
0.498,1e-05,366,338,25,2,0.001,704,11
0.498,1e-05,424,380,25,2,0.001,804,11
0.498,1e-05,474,430,25,2,0.001,904,11
0.498,1e-05,526,478,25,2,0.001,1004,11
0.498,1e-05,560,544,25,2,0.001,1104,11
0.498,1e-05,608,596,25,2,0.001,1204,11
0.498,1e-05,663,641,25,2,0.001,1304,11
0.498,1e-05,712,692,25,2,0.001,1404,11
0.498,1e-05,757,747,25,2,0.001,1504,11
0.498,1e-05,811,793,25,2,0.001,1604,11
0.498,1e-05,860,844,25,2,0.001,1704,11
0.498,1e-05,918,886,25,2,0.001,1804,11
0.498,1e-05,963,941,25,2,0.001,1904,11
0.498,1e-05,1003,1001,25,2,0.001,2004,11
0.508,1e-05,55,49,25,2,0.001,104,12
0.508,1e-05,106,98,25,2,0.001,204,12
0.508,1e-05,157,147,25,2,0.001,304,12
0.512,1e-05,209,195,25,2,0.001,404,12
0.512,1e-05,257,247,25,2,0.001,504,12
0.514,1e-05,310,294,25,2,0.001,604,12
0.512,1e-05,370,334,25,2,0.001,704,12
0.508,1e-05,417,387,25,2,0.001,804,12
0.508,1e-05,458,446,25,2,0.001,904,12
0.508,1e-05,507,497,25,2,0.001,1004,12
0.506,1e-05,561,543,25,2,0.001,1104,12
0.504,1e-05,611,593,25,2,0.001,1204,12
0.504,1e-05,658,646,25,2,0.001,1304,12
0.506,1e-05,709,695,25,2,0.001,1404,12
0.506,1e-05,761,743,25,2,0.001,1504,12
0.508,1e-05,815,789,25,2,0.001,1604,12
0.51,1e-05,860,844,25,2,0.001,1704,12
0.51,1e-05,910,894,25,2,0.001,1804,12
0.51,1e-05,955,949,25,2,0.001,1904,12
0.518,1e-05,999,1005,25,2,0.001,2004,12
0.536,1e-05,48,56,25,2,0.001,104,13
0.536,1e-05,102,102,25,2,0.001,204,13
0.536,1e-05,164,140,25,2,0.001,304,13
0.536,1e-05,210,194,25,2,0.001,404,13
0.536,1e-05,266,238,25,2,0.001,504,13
0.536,1e-05,321,283,25,2,0.001,604,13
0.536,1e-05,378,326,25,2,0.001,704,13
0.536,1e-05,421,383,25,2,0.001,804,13
0.536,1e-05,474,430,25,2,0.001,904,13
0.536,1e-05,525,479,25,2,0.001,1004,13
0.536,1e-05,570,534,25,2,0.001,1104,13
0.536,1e-05,626,578,25,2,0.001,1204,13
0.536,1e-05,670,634,25,2,0.001,1304,13
0.512,1e-05,721,683,25,2,0.001,1404,13
0.51,1e-05,784,720,25,2,0.001,1504,13
0.514,1e-05,832,772,25,2,0.001,1604,13
0.516,1e-05,876,828,25,2,0.001,1704,13
0.518,1e-05,922,882,25,2,0.001,1804,13
0.522,1e-05,971,933,25,2,0.001,1904,13
0.518,1e-05,1020,984,25,2,0.001,2004,13
0.5,1e-05,53,51,25,2,0.001,104,14
0.5,1e-05,111,93,25,2,0.001,204,14
0.5,1e-05,164,140,25,2,0.001,304,14
0.502,1e-05,213,191,25,2,0.001,404,14
0.504,1e-05,259,245,25,2,0.001,504,14
0.504,1e-05,313,291,25,2,0.001,604,14
0.506,1e-05,369,335,25,2,0.001,704,14
0.502,1e-05,418,386,25,2,0.001,804,14
0.508,1e-05,465,439,25,2,0.001,904,14
0.512,1e-05,508,496,25,2,0.001,1004,14
0.512,1e-05,557,547,25,2,0.001,1104,14
0.512,1e-05,605,599,25,2,0.001,1204,14
0.51,1e-05,658,646,25,2,0.001,1304,14
0.51,1e-05,707,697,25,2,0.001,1404,14
0.51,1e-05,754,750,25,2,0.001,1504,14
0.514,1e-05,810,794,25,2,0.001,1604,14
0.514,1e-05,860,844,25,2,0.001,1704,14
0.508,1e-05,901,903,25,2,0.001,1804,14
0.506,1e-05,950,954,25,2,0.001,1904,14
0.518,1e-05,997,1007,25,2,0.001,2004,14
0.55,1e-05,56,48,25,2,0.001,104,15
0.55,1e-05,106,98,25,2,0.001,204,15
0.55,1e-05,145,159,25,2,0.001,304,15
0.546,1e-05,181,223,25,2,0.001,404,15
0.55,1e-05,230,274,25,2,0.001,504,15
0.544,1e-05,280,324,25,2,0.001,604,15
0.544,1e-05,328,376,25,2,0.001,704,15
0.546,1e-05,379,425,25,2,0.001,804,15
0.546,1e-05,423,481,25,2,0.001,904,15
0.542,1e-05,482,522,25,2,0.001,1004,15
0.544,1e-05,531,573,25,2,0.001,1104,15
0.542,1e-05,582,622,25,2,0.001,1204,15
0.544,1e-05,629,675,25,2,0.001,1304,15
0.542,1e-05,680,724,25,2,0.001,1404,15
0.548,1e-05,729,775,25,2,0.001,1504,15
0.552,1e-05,784,820,25,2,0.001,1604,15
0.55,1e-05,832,872,25,2,0.001,1704,15
0.554,1e-05,888,916,25,2,0.001,1804,15
0.556,1e-05,939,965,25,2,0.001,1904,15
0.564,1e-05,981,1023,25,2,0.001,2004,15
0.486,1e-05,51,53,25,2,0.001,104,16
0.486,1e-05,94,110,25,2,0.001,204,16
0.484,1e-05,135,169,25,2,0.001,304,16
0.494,1e-05,182,222,25,2,0.001,404,16
0.494,1e-05,227,277,25,2,0.001,504,16
0.494,1e-05,274,330,25,2,0.001,604,16
0.494,1e-05,327,377,25,2,0.001,704,16
0.496,1e-05,377,427,25,2,0.001,804,16
0.496,1e-05,425,479,25,2,0.001,904,16
0.494,1e-05,472,532,25,2,0.001,1004,16
0.494,1e-05,534,570,25,2,0.001,1104,16
0.49,1e-05,574,630,25,2,0.001,1204,16
0.49,1e-05,618,686,25,2,0.001,1304,16
0.492,1e-05,668,736,25,2,0.001,1404,16
0.494,1e-05,720,784,25,2,0.001,1504,16
0.492,1e-05,773,831,25,2,0.001,1604,16
0.492,1e-05,826,878,25,2,0.001,1704,16
0.492,1e-05,871,933,25,2,0.001,1804,16
0.488,1e-05,930,974,25,2,0.001,1904,16
0.486,1e-05,985,1019,25,2,0.001,2004,16
0.512,1e-05,52,52,25,2,0.001,104,17
0.512,1e-05,101,103,25,2,0.001,204,17
0.512,1e-05,153,151,25,2,0.001,304,17
0.512,1e-05,197,207,25,2,0.001,404,17
0.512,1e-05,255,249,25,2,0.001,504,17
0.512,1e-05,306,298,25,2,0.001,604,17
0.512,1e-05,354,350,25,2,0.001,704,17
0.512,1e-05,401,403,25,2,0.001,804,17
0.512,1e-05,453,451,25,2,0.001,904,17
0.512,1e-05,499,505,25,2,0.001,1004,17
0.512,1e-05,550,554,25,2,0.001,1104,17
0.512,1e-05,595,609,25,2,0.001,1204,17
0.514,1e-05,643,661,25,2,0.001,1304,17
0.516,1e-05,696,708,25,2,0.001,1404,17
0.522,1e-05,742,762,25,2,0.001,1504,17
0.526,1e-05,791,813,25,2,0.001,1604,17
0.528,1e-05,847,857,25,2,0.001,1704,17
0.53,1e-05,893,911,25,2,0.001,1804,17
0.534,1e-05,945,959,25,2,0.001,1904,17
0.54,1e-05,996,1008,25,2,0.001,2004,17
0.504,1e-05,48,56,25,2,0.001,104,18
0.504,1e-05,100,104,25,2,0.001,204,18
0.504,1e-05,156,148,25,2,0.001,304,18
0.504,1e-05,198,206,25,2,0.001,404,18
0.504,1e-05,247,257,25,2,0.001,504,18
0.504,1e-05,292,312,25,2,0.001,604,18
0.504,1e-05,346,358,25,2,0.001,704,18
0.504,1e-05,398,406,25,2,0.001,804,18
0.504,1e-05,453,451,25,2,0.001,904,18
0.504,1e-05,493,511,25,2,0.001,1004,18
0.504,1e-05,542,562,25,2,0.001,1104,18
0.504,1e-05,594,610,25,2,0.001,1204,18
0.504,1e-05,648,656,25,2,0.001,1304,18
0.504,1e-05,698,706,25,2,0.001,1404,18
0.504,1e-05,754,750,25,2,0.001,1504,18
0.504,1e-05,802,802,25,2,0.001,1604,18
0.504,1e-05,855,849,25,2,0.001,1704,18
0.504,1e-05,905,899,25,2,0.001,1804,18
0.504,1e-05,948,956,25,2,0.001,1904,18
0.504,1e-05,1004,1000,25,2,0.001,2004,18
0.476,1e-05,43,61,25,2,0.001,104,19
0.476,1e-05,103,101,25,2,0.001,204,19
0.476,1e-05,155,149,25,2,0.001,304,19
0.476,1e-05,213,191,25,2,0.001,404,19
0.476,1e-05,261,243,25,2,0.001,504,19
0.476,1e-05,306,298,25,2,0.001,604,19
0.476,1e-05,358,346,25,2,0.001,704,19
0.476,1e-05,403,401,25,2,0.001,804,19
0.476,1e-05,449,455,25,2,0.001,904,19
0.478,1e-05,503,501,25,2,0.001,1004,19
0.478,1e-05,551,553,25,2,0.001,1104,19
0.478,1e-05,604,600,25,2,0.001,1204,19
0.478,1e-05,650,654,25,2,0.001,1304,19
0.478,1e-05,694,710,25,2,0.001,1404,19
0.478,1e-05,743,761,25,2,0.001,1504,19
0.478,1e-05,797,807,25,2,0.001,1604,19
0.48,1e-05,845,859,25,2,0.001,1704,19
0.48,1e-05,903,901,25,2,0.001,1804,19
0.478,1e-05,960,944,25,2,0.001,1904,19
0.478,1e-05,1014,990,25,2,0.001,2004,19
0.48,1e-05,52,52,25,2,0.001,104,20
0.48,1e-05,104,100,25,2,0.001,204,20
0.48,1e-05,152,152,25,2,0.001,304,20
0.48,1e-05,206,198,25,2,0.001,404,20
0.48,1e-05,268,236,25,2,0.001,504,20
0.48,1e-05,310,294,25,2,0.001,604,20
0.48,1e-05,369,335,25,2,0.001,704,20
0.48,1e-05,423,381,25,2,0.001,804,20
0.48,1e-05,468,436,25,2,0.001,904,20
0.48,1e-05,521,483,25,2,0.001,1004,20
0.48,1e-05,575,529,25,2,0.001,1104,20
0.48,1e-05,632,572,25,2,0.001,1204,20
0.48,1e-05,681,623,25,2,0.001,1304,20
0.48,1e-05,736,668,25,2,0.001,1404,20
0.48,1e-05,787,717,25,2,0.001,1504,20
0.478,1e-05,834,770,25,2,0.001,1604,20
0.478,1e-05,877,827,25,2,0.001,1704,20
0.48,1e-05,919,885,25,2,0.001,1804,20
0.48,1e-05,965,939,25,2,0.001,1904,20
0.48,1e-05,1012,992,25,2,0.001,2004,20
0.502,1e-05,51,53,25,2,0.01,104,1
0.498,1e-05,106,98,25,2,0.01,204,1
0.494,1e-05,157,147,25,2,0.01,304,1
0.504,1e-05,214,190,25,2,0.01,404,1
0.514,1e-05,269,235,25,2,0.01,504,1
0.528,1e-05,309,295,25,2,0.01,604,1
0.544,1e-05,361,343,25,2,0.01,704,1
0.546,1e-05,418,386,25,2,0.01,804,1
0.57,1e-05,464,440,25,2,0.01,904,1
0.57,1e-05,513,491,25,2,0.01,1004,1
0.568,1e-05,563,541,25,2,0.01,1104,1
0.58,1e-05,614,590,25,2,0.01,1204,1
0.584,1e-05,663,641,25,2,0.01,1304,1
0.578,1e-05,710,694,25,2,0.01,1404,1
0.562,1e-05,755,749,25,2,0.01,1504,1
0.556,1e-05,797,807,25,2,0.01,1604,1
0.55,1e-05,848,856,25,2,0.01,1704,1
0.57,1e-05,893,911,25,2,0.01,1804,1
0.568,1e-05,941,963,25,2,0.01,1904,1
0.614,1e-05,991,1013,25,2,0.01,2004,1
0.502,1e-05,56,48,25,2,0.01,104,2
0.5,1e-05,103,101,25,2,0.01,204,2
0.502,1e-05,154,150,25,2,0.01,304,2
0.506,1e-05,201,203,25,2,0.01,404,2
0.506,1e-05,247,257,25,2,0.01,504,2
0.494,1e-05,300,304,25,2,0.01,604,2
0.506,1e-05,345,359,25,2,0.01,704,2
0.52,1e-05,399,405,25,2,0.01,804,2
0.518,1e-05,452,452,25,2,0.01,904,2
0.532,1e-05,502,502,25,2,0.01,1004,2
0.546,1e-05,546,558,25,2,0.01,1104,2
0.558,1e-05,601,603,25,2,0.01,1204,2
0.558,1e-05,657,647,25,2,0.01,1304,2
0.574,1e-05,711,693,25,2,0.01,1404,2
0.618,1e-05,770,734,25,2,0.01,1504,2
0.638,1e-05,814,790,25,2,0.01,1604,2
0.66,1e-05,864,840,25,2,0.01,1704,2
0.682,1e-05,912,892,25,2,0.01,1804,2
0.684,1e-05,956,948,25,2,0.01,1904,2
0.7,1e-05,1003,1001,25,2,0.01,2004,2
0.466,1e-05,55,49,25,2,0.01,104,3
0.468,1e-05,101,103,25,2,0.01,204,3
0.474,1e-05,158,146,25,2,0.01,304,3
0.484,1e-05,208,196,25,2,0.01,404,3
0.506,1e-05,258,246,25,2,0.01,504,3
0.514,1e-05,313,291,25,2,0.01,604,3
0.516,1e-05,357,347,25,2,0.01,704,3
0.526,1e-05,394,410,25,2,0.01,804,3
0.522,1e-05,448,456,25,2,0.01,904,3
0.548,1e-05,500,504,25,2,0.01,1004,3
0.562,1e-05,559,545,25,2,0.01,1104,3
0.58,1e-05,609,595,25,2,0.01,1204,3
0.576,1e-05,657,647,25,2,0.01,1304,3
0.608,1e-05,709,695,25,2,0.01,1404,3
0.624,1e-05,758,746,25,2,0.01,1504,3
0.666,1e-05,810,794,25,2,0.01,1604,3
0.672,1e-05,859,845,25,2,0.01,1704,3
0.684,1e-05,902,902,25,2,0.01,1804,3
0.692,1e-05,954,950,25,2,0.01,1904,3
0.694,1e-05,993,1011,25,2,0.01,2004,3
0.504,1e-05,58,46,25,2,0.01,104,4
0.504,1e-05,103,101,25,2,0.01,204,4
0.504,1e-05,157,147,25,2,0.01,304,4
0.506,1e-05,202,202,25,2,0.01,404,4
0.508,1e-05,251,253,25,2,0.01,504,4
0.516,1e-05,301,303,25,2,0.01,604,4
0.532,1e-05,359,345,25,2,0.01,704,4
0.54,1e-05,402,402,25,2,0.01,804,4
0.558,1e-05,449,455,25,2,0.01,904,4
0.584,1e-05,503,501,25,2,0.01,1004,4
0.604,1e-05,550,554,25,2,0.01,1104,4
0.624,1e-05,607,597,25,2,0.01,1204,4
0.636,1e-05,655,649,25,2,0.01,1304,4
0.662,1e-05,703,701,25,2,0.01,1404,4
0.69,1e-05,755,749,25,2,0.01,1504,4
0.714,1e-05,799,805,25,2,0.01,1604,4
0.736,1e-05,855,849,25,2,0.01,1704,4
0.754,1e-05,908,896,25,2,0.01,1804,4
0.762,1e-05,953,951,25,2,0.01,1904,4
0.764,1e-05,1004,1000,25,2,0.01,2004,4
0.474,1e-05,54,50,25,2,0.01,104,5
0.474,1e-05,102,102,25,2,0.01,204,5
0.474,1e-05,155,149,25,2,0.01,304,5
0.474,1e-05,204,200,25,2,0.01,404,5
0.474,1e-05,254,250,25,2,0.01,504,5
0.486,1e-05,309,295,25,2,0.01,604,5
0.5,1e-05,359,345,25,2,0.01,704,5
0.498,1e-05,407,397,25,2,0.01,804,5
0.504,1e-05,461,443,25,2,0.01,904,5
0.504,1e-05,502,502,25,2,0.01,1004,5
0.512,1e-05,547,557,25,2,0.01,1104,5
0.514,1e-05,601,603,25,2,0.01,1204,5
0.53,1e-05,651,653,25,2,0.01,1304,5
0.526,1e-05,699,705,25,2,0.01,1404,5
0.53,1e-05,753,751,25,2,0.01,1504,5
0.54,1e-05,805,799,25,2,0.01,1604,5
0.536,1e-05,848,856,25,2,0.01,1704,5
0.564,1e-05,902,902,25,2,0.01,1804,5
0.586,1e-05,958,946,25,2,0.01,1904,5
0.602,1e-05,1015,989,25,2,0.01,2004,5
0.528,1e-05,47,57,25,2,0.01,104,6
0.532,1e-05,101,103,25,2,0.01,204,6
0.534,1e-05,147,157,25,2,0.01,304,6
0.542,1e-05,199,205,25,2,0.01,404,6
0.554,1e-05,250,254,25,2,0.01,504,6
0.562,1e-05,300,304,25,2,0.01,604,6
0.582,1e-05,351,353,25,2,0.01,704,6
0.604,1e-05,405,399,25,2,0.01,804,6
0.628,1e-05,451,453,25,2,0.01,904,6
0.678,1e-05,499,505,25,2,0.01,1004,6
0.748,1e-05,547,557,25,2,0.01,1104,6
0.812,1e-05,600,604,25,2,0.01,1204,6
0.842,1e-05,650,654,25,2,0.01,1304,6
0.866,1e-05,699,705,25,2,0.01,1404,6
0.888,1e-05,750,754,25,2,0.01,1504,6
0.906,1e-05,808,796,25,2,0.01,1604,6
0.906,1e-05,853,851,25,2,0.01,1704,6
0.926,1e-05,914,890,25,2,0.01,1804,6
0.922,1e-05,962,942,25,2,0.01,1904,6
0.926,1e-05,1008,996,25,2,0.01,2004,6
0.492,1e-05,46,58,25,2,0.01,104,7
0.496,1e-05,90,114,25,2,0.01,204,7
0.504,1e-05,139,165,25,2,0.01,304,7
0.514,1e-05,188,216,25,2,0.01,404,7
0.522,1e-05,241,263,25,2,0.01,504,7
0.542,1e-05,303,301,25,2,0.01,604,7
0.55,1e-05,365,339,25,2,0.01,704,7
0.544,1e-05,415,389,25,2,0.01,804,7
0.542,1e-05,460,444,25,2,0.01,904,7
0.542,1e-05,506,498,25,2,0.01,1004,7
0.554,1e-05,557,547,25,2,0.01,1104,7
0.558,1e-05,606,598,25,2,0.01,1204,7
0.558,1e-05,666,638,25,2,0.01,1304,7
0.568,1e-05,714,690,25,2,0.01,1404,7
0.576,1e-05,758,746,25,2,0.01,1504,7
0.58,1e-05,807,797,25,2,0.01,1604,7
0.588,1e-05,851,853,25,2,0.01,1704,7
0.594,1e-05,905,899,25,2,0.01,1804,7
0.596,1e-05,958,946,25,2,0.01,1904,7
0.596,1e-05,1007,997,25,2,0.01,2004,7
0.528,1e-05,53,51,25,2,0.01,104,8
0.54,1e-05,99,105,25,2,0.01,204,8
0.552,1e-05,146,158,25,2,0.01,304,8
0.57,1e-05,191,213,25,2,0.01,404,8
0.578,1e-05,231,273,25,2,0.01,504,8
0.576,1e-05,287,317,25,2,0.01,604,8
0.586,1e-05,342,362,25,2,0.01,704,8
0.592,1e-05,387,417,25,2,0.01,804,8
0.572,1e-05,446,458,25,2,0.01,904,8
0.572,1e-05,495,509,25,2,0.01,1004,8
0.586,1e-05,547,557,25,2,0.01,1104,8
0.58,1e-05,595,609,25,2,0.01,1204,8
0.586,1e-05,641,663,25,2,0.01,1304,8
0.582,1e-05,692,712,25,2,0.01,1404,8
0.592,1e-05,734,770,25,2,0.01,1504,8
0.602,1e-05,782,822,25,2,0.01,1604,8
0.614,1e-05,836,868,25,2,0.01,1704,8
0.63,1e-05,887,917,25,2,0.01,1804,8
0.636,1e-05,935,969,25,2,0.01,1904,8
0.638,1e-05,990,1014,25,2,0.01,2004,8
0.516,1e-05,50,54,25,2,0.01,104,9
0.512,1e-05,94,110,25,2,0.01,204,9
0.52,1e-05,144,160,25,2,0.01,304,9
0.522,1e-05,196,208,25,2,0.01,404,9
0.526,1e-05,243,261,25,2,0.01,504,9
0.54,1e-05,299,305,25,2,0.01,604,9
0.512,1e-05,339,365,25,2,0.01,704,9
0.512,1e-05,399,405,25,2,0.01,804,9
0.524,1e-05,456,448,25,2,0.01,904,9
0.532,1e-05,501,503,25,2,0.01,1004,9
0.536,1e-05,541,563,25,2,0.01,1104,9
0.536,1e-05,590,614,25,2,0.01,1204,9
0.542,1e-05,637,667,25,2,0.01,1304,9
0.556,1e-05,687,717,25,2,0.01,1404,9
0.572,1e-05,748,756,25,2,0.01,1504,9
0.598,1e-05,799,805,25,2,0.01,1604,9
0.61,1e-05,850,854,25,2,0.01,1704,9
0.63,1e-05,903,901,25,2,0.01,1804,9
0.63,1e-05,951,953,25,2,0.01,1904,9
0.642,1e-05,1002,1002,25,2,0.01,2004,9
0.504,1e-05,64,40,25,2,0.01,104,10
0.504,1e-05,106,98,25,2,0.01,204,10
0.506,1e-05,158,146,25,2,0.01,304,10
0.51,1e-05,206,198,25,2,0.01,404,10
0.524,1e-05,247,257,25,2,0.01,504,10
0.54,1e-05,303,301,25,2,0.01,604,10
0.554,1e-05,343,361,25,2,0.01,704,10
0.57,1e-05,392,412,25,2,0.01,804,10
0.586,1e-05,441,463,25,2,0.01,904,10
0.584,1e-05,491,513,25,2,0.01,1004,10
0.606,1e-05,529,575,25,2,0.01,1104,10
0.614,1e-05,587,617,25,2,0.01,1204,10
0.624,1e-05,644,660,25,2,0.01,1304,10
0.626,1e-05,692,712,25,2,0.01,1404,10
0.63,1e-05,743,761,25,2,0.01,1504,10
0.644,1e-05,795,809,25,2,0.01,1604,10
0.644,1e-05,847,857,25,2,0.01,1704,10
0.646,1e-05,895,909,25,2,0.01,1804,10
0.658,1e-05,949,955,25,2,0.01,1904,10
0.662,1e-05,1000,1004,25,2,0.01,2004,10
0.5,1e-05,40,64,25,2,0.01,104,11
0.512,1e-05,93,111,25,2,0.01,204,11
0.514,1e-05,147,157,25,2,0.01,304,11
0.514,1e-05,195,209,25,2,0.01,404,11
0.514,1e-05,234,270,25,2,0.01,504,11
0.528,1e-05,287,317,25,2,0.01,604,11
0.522,1e-05,338,366,25,2,0.01,704,11
0.532,1e-05,391,413,25,2,0.01,804,11
0.534,1e-05,443,461,25,2,0.01,904,11
0.532,1e-05,502,502,25,2,0.01,1004,11
0.538,1e-05,553,551,25,2,0.01,1104,11
0.548,1e-05,601,603,25,2,0.01,1204,11
0.55,1e-05,650,654,25,2,0.01,1304,11
0.558,1e-05,703,701,25,2,0.01,1404,11
0.566,1e-05,757,747,25,2,0.01,1504,11
0.588,1e-05,806,798,25,2,0.01,1604,11
0.602,1e-05,852,852,25,2,0.01,1704,11
0.616,1e-05,899,905,25,2,0.01,1804,11
0.624,1e-05,948,956,25,2,0.01,1904,11
0.626,1e-05,997,1007,25,2,0.01,2004,11
0.506,1e-05,57,47,25,2,0.01,104,12
0.506,1e-05,99,105,25,2,0.01,204,12
0.506,1e-05,157,147,25,2,0.01,304,12
0.506,1e-05,199,205,25,2,0.01,404,12
0.506,1e-05,256,248,25,2,0.01,504,12
0.506,1e-05,304,300,25,2,0.01,604,12
0.506,1e-05,356,348,25,2,0.01,704,12
0.506,1e-05,399,405,25,2,0.01,804,12
0.506,1e-05,442,462,25,2,0.01,904,12
0.506,1e-05,486,518,25,2,0.01,1004,12
0.506,1e-05,540,564,25,2,0.01,1104,12
0.506,1e-05,582,622,25,2,0.01,1204,12
0.506,1e-05,643,661,25,2,0.01,1304,12
0.506,1e-05,691,713,25,2,0.01,1404,12
0.506,1e-05,743,761,25,2,0.01,1504,12
0.506,1e-05,794,810,25,2,0.01,1604,12
0.502,1e-05,838,866,25,2,0.01,1704,12
0.508,1e-05,893,911,25,2,0.01,1804,12
0.524,1e-05,949,955,25,2,0.01,1904,12
0.532,1e-05,1005,999,25,2,0.01,2004,12
0.474,1e-05,54,50,25,2,0.01,104,13
0.548,1e-05,98,106,25,2,0.01,204,13
0.538,1e-05,145,159,25,2,0.01,304,13
0.536,1e-05,192,212,25,2,0.01,404,13
0.534,1e-05,243,261,25,2,0.01,504,13
0.538,1e-05,289,315,25,2,0.01,604,13
0.538,1e-05,340,364,25,2,0.01,704,13
0.552,1e-05,390,414,25,2,0.01,804,13
0.556,1e-05,439,465,25,2,0.01,904,13
0.576,1e-05,494,510,25,2,0.01,1004,13
0.586,1e-05,548,556,25,2,0.01,1104,13
0.586,1e-05,605,599,25,2,0.01,1204,13
0.612,1e-05,654,650,25,2,0.01,1304,13
0.608,1e-05,704,700,25,2,0.01,1404,13
0.598,1e-05,759,745,25,2,0.01,1504,13
0.592,1e-05,813,791,25,2,0.01,1604,13
0.594,1e-05,862,842,25,2,0.01,1704,13
0.63,1e-05,918,886,25,2,0.01,1804,13
0.654,1e-05,967,937,25,2,0.01,1904,13
0.726,1e-05,1015,989,25,2,0.01,2004,13
0.502,1e-05,49,55,25,2,0.01,104,14
0.502,1e-05,106,98,25,2,0.01,204,14
0.502,1e-05,157,147,25,2,0.01,304,14
0.504,1e-05,207,197,25,2,0.01,404,14
0.514,1e-05,269,235,25,2,0.01,504,14
0.55,1e-05,320,284,25,2,0.01,604,14
0.56,1e-05,370,334,25,2,0.01,704,14
0.556,1e-05,423,381,25,2,0.01,804,14
0.556,1e-05,476,428,25,2,0.01,904,14
0.546,1e-05,525,479,25,2,0.01,1004,14
0.528,1e-05,565,539,25,2,0.01,1104,14
0.534,1e-05,608,596,25,2,0.01,1204,14
0.6,1e-05,651,653,25,2,0.01,1304,14
0.644,1e-05,698,706,25,2,0.01,1404,14
0.624,1e-05,744,760,25,2,0.01,1504,14
0.686,1e-05,794,810,25,2,0.01,1604,14
0.684,1e-05,852,852,25,2,0.01,1704,14
0.698,1e-05,908,896,25,2,0.01,1804,14
0.702,1e-05,957,947,25,2,0.01,1904,14
0.704,1e-05,1003,1001,25,2,0.01,2004,14
0.512,1e-05,51,53,25,2,0.01,104,15
0.512,1e-05,102,102,25,2,0.01,204,15
0.512,1e-05,140,164,25,2,0.01,304,15
0.512,1e-05,184,220,25,2,0.01,404,15
0.512,1e-05,244,260,25,2,0.01,504,15
0.512,1e-05,287,317,25,2,0.01,604,15
0.512,1e-05,337,367,25,2,0.01,704,15
0.512,1e-05,388,416,25,2,0.01,804,15
0.512,1e-05,435,469,25,2,0.01,904,15
0.53,1e-05,486,518,25,2,0.01,1004,15
0.58,1e-05,547,557,25,2,0.01,1104,15
0.594,1e-05,590,614,25,2,0.01,1204,15
0.616,1e-05,641,663,25,2,0.01,1304,15
0.628,1e-05,695,709,25,2,0.01,1404,15
0.636,1e-05,750,754,25,2,0.01,1504,15
0.65,1e-05,792,812,25,2,0.01,1604,15
0.664,1e-05,845,859,25,2,0.01,1704,15
0.672,1e-05,890,914,25,2,0.01,1804,15
0.676,1e-05,945,959,25,2,0.01,1904,15
0.682,1e-05,996,1008,25,2,0.01,2004,15
0.478,1e-05,52,52,25,2,0.01,104,16
0.478,1e-05,103,101,25,2,0.01,204,16
0.478,1e-05,151,153,25,2,0.01,304,16
0.478,1e-05,205,199,25,2,0.01,404,16
0.478,1e-05,259,245,25,2,0.01,504,16
0.478,1e-05,296,308,25,2,0.01,604,16
0.478,1e-05,337,367,25,2,0.01,704,16
0.478,1e-05,387,417,25,2,0.01,804,16
0.478,1e-05,437,467,25,2,0.01,904,16
0.478,1e-05,484,520,25,2,0.01,1004,16
0.478,1e-05,525,579,25,2,0.01,1104,16
0.478,1e-05,583,621,25,2,0.01,1204,16
0.478,1e-05,630,674,25,2,0.01,1304,16
0.478,1e-05,683,721,25,2,0.01,1404,16
0.478,1e-05,738,766,25,2,0.01,1504,16
0.478,1e-05,787,817,25,2,0.01,1604,16
0.478,1e-05,839,865,25,2,0.01,1704,16
0.478,1e-05,891,913,25,2,0.01,1804,16
0.524,1e-05,939,965,25,2,0.01,1904,16
0.53,1e-05,991,1013,25,2,0.01,2004,16
0.49,1e-05,60,44,25,2,0.01,104,17
0.494,1e-05,106,98,25,2,0.01,204,17
0.498,1e-05,159,145,25,2,0.01,304,17
0.502,1e-05,213,191,25,2,0.01,404,17
0.514,1e-05,263,241,25,2,0.01,504,17
0.518,1e-05,318,286,25,2,0.01,604,17
0.536,1e-05,371,333,25,2,0.01,704,17
0.542,1e-05,421,383,25,2,0.01,804,17
0.538,1e-05,464,440,25,2,0.01,904,17
0.532,1e-05,514,490,25,2,0.01,1004,17
0.55,1e-05,562,542,25,2,0.01,1104,17
0.564,1e-05,611,593,25,2,0.01,1204,17
0.58,1e-05,659,645,25,2,0.01,1304,17
0.58,1e-05,715,689,25,2,0.01,1404,17
0.576,1e-05,763,741,25,2,0.01,1504,17
0.572,1e-05,814,790,25,2,0.01,1604,17
0.568,1e-05,872,832,25,2,0.01,1704,17
0.562,1e-05,913,891,25,2,0.01,1804,17
0.568,1e-05,966,938,25,2,0.01,1904,17
0.558,1e-05,1011,993,25,2,0.01,2004,17
0.524,1e-05,56,48,25,2,0.01,104,18
0.53,1e-05,108,96,25,2,0.01,204,18
0.538,1e-05,151,153,25,2,0.01,304,18
0.532,1e-05,204,200,25,2,0.01,404,18
0.538,1e-05,252,252,25,2,0.01,504,18
0.53,1e-05,302,302,25,2,0.01,604,18
0.532,1e-05,354,350,25,2,0.01,704,18
0.534,1e-05,399,405,25,2,0.01,804,18
0.522,1e-05,452,452,25,2,0.01,904,18
0.528,1e-05,502,502,25,2,0.01,1004,18
0.526,1e-05,554,550,25,2,0.01,1104,18
0.53,1e-05,599,605,25,2,0.01,1204,18
0.544,1e-05,641,663,25,2,0.01,1304,18
0.546,1e-05,691,713,25,2,0.01,1404,18
0.554,1e-05,750,754,25,2,0.01,1504,18
0.554,1e-05,800,804,25,2,0.01,1604,18
0.548,1e-05,857,847,25,2,0.01,1704,18
0.568,1e-05,907,897,25,2,0.01,1804,18
0.57,1e-05,959,945,25,2,0.01,1904,18
0.564,1e-05,1004,1000,25,2,0.01,2004,18
0.504,1e-05,52,52,25,2,0.01,104,19
0.504,1e-05,101,103,25,2,0.01,204,19
0.504,1e-05,157,147,25,2,0.01,304,19
0.504,1e-05,199,205,25,2,0.01,404,19
0.504,1e-05,256,248,25,2,0.01,504,19
0.504,1e-05,308,296,25,2,0.01,604,19
0.504,1e-05,357,347,25,2,0.01,704,19
0.504,1e-05,402,402,25,2,0.01,804,19
0.504,1e-05,456,448,25,2,0.01,904,19
0.504,1e-05,503,501,25,2,0.01,1004,19
0.504,1e-05,550,554,25,2,0.01,1104,19
0.504,1e-05,602,602,25,2,0.01,1204,19
0.504,1e-05,648,656,25,2,0.01,1304,19
0.504,1e-05,698,706,25,2,0.01,1404,19
0.504,1e-05,748,756,25,2,0.01,1504,19
0.504,1e-05,796,808,25,2,0.01,1604,19
0.504,1e-05,843,861,25,2,0.01,1704,19
0.504,1e-05,894,910,25,2,0.01,1804,19
0.504,1e-05,946,958,25,2,0.01,1904,19
0.658,1e-05,1000,1004,25,2,0.01,2004,19
0.506,1e-05,54,50,25,2,0.01,104,20
0.506,1e-05,112,92,25,2,0.01,204,20
0.506,1e-05,163,141,25,2,0.01,304,20
0.506,1e-05,205,199,25,2,0.01,404,20
0.506,1e-05,254,250,25,2,0.01,504,20
0.506,1e-05,307,297,25,2,0.01,604,20
0.506,1e-05,358,346,25,2,0.01,704,20
0.506,1e-05,402,402,25,2,0.01,804,20
0.506,1e-05,460,444,25,2,0.01,904,20
0.506,1e-05,509,495,25,2,0.01,1004,20
0.506,1e-05,558,546,25,2,0.01,1104,20
0.506,1e-05,600,604,25,2,0.01,1204,20
0.506,1e-05,647,657,25,2,0.01,1304,20
0.506,1e-05,697,707,25,2,0.01,1404,20
0.506,1e-05,746,758,25,2,0.01,1504,20
0.506,1e-05,800,804,25,2,0.01,1604,20
0.618,1e-05,858,846,25,2,0.01,1704,20
0.63,1e-05,904,900,25,2,0.01,1804,20
0.632,1e-05,958,946,25,2,0.01,1904,20
0.644,1e-05,1005,999,25,2,0.01,2004,20
0.472,0.0001,63,41,25,2,0.0001,104,1
0.472,0.0001,111,93,25,2,0.0001,204,1
0.472,0.0001,160,144,25,2,0.0001,304,1
0.472,0.0001,202,202,25,2,0.0001,404,1
0.472,0.0001,252,252,25,2,0.0001,504,1
0.472,0.0001,294,310,25,2,0.0001,604,1
0.472,0.0001,341,363,25,2,0.0001,704,1
0.472,0.0001,394,410,25,2,0.0001,804,1
0.472,0.0001,442,462,25,2,0.0001,904,1
0.472,0.0001,493,511,25,2,0.0001,1004,1
0.472,0.0001,541,563,25,2,0.0001,1104,1
0.472,0.0001,600,604,25,2,0.0001,1204,1
0.472,0.0001,659,645,25,2,0.0001,1304,1
0.472,0.0001,703,701,25,2,0.0001,1404,1
0.472,0.0001,752,752,25,2,0.0001,1504,1
0.472,0.0001,801,803,25,2,0.0001,1604,1
0.472,0.0001,855,849,25,2,0.0001,1704,1
0.472,0.0001,912,892,25,2,0.0001,1804,1
0.472,0.0001,964,940,25,2,0.0001,1904,1
0.472,0.0001,1006,998,25,2,0.0001,2004,1
0.494,0.0001,54,50,25,2,0.0001,104,2
0.494,0.0001,97,107,25,2,0.0001,204,2
0.494,0.0001,144,160,25,2,0.0001,304,2
0.494,0.0001,192,212,25,2,0.0001,404,2
0.494,0.0001,239,265,25,2,0.0001,504,2
0.494,0.0001,297,307,25,2,0.0001,604,2
0.494,0.0001,348,356,25,2,0.0001,704,2
0.494,0.0001,396,408,25,2,0.0001,804,2
0.494,0.0001,449,455,25,2,0.0001,904,2
0.494,0.0001,494,510,25,2,0.0001,1004,2
0.494,0.0001,542,562,25,2,0.0001,1104,2
0.494,0.0001,594,610,25,2,0.0001,1204,2
0.494,0.0001,643,661,25,2,0.0001,1304,2
0.494,0.0001,692,712,25,2,0.0001,1404,2
0.494,0.0001,739,765,25,2,0.0001,1504,2
0.494,0.0001,794,810,25,2,0.0001,1604,2
0.494,0.0001,843,861,25,2,0.0001,1704,2
0.494,0.0001,897,907,25,2,0.0001,1804,2
0.494,0.0001,948,956,25,2,0.0001,1904,2
0.494,0.0001,999,1005,25,2,0.0001,2004,2
0.518,0.0001,44,60,25,2,0.0001,104,3
0.518,0.0001,96,108,25,2,0.0001,204,3
0.518,0.0001,146,158,25,2,0.0001,304,3
0.516,0.0001,195,209,25,2,0.0001,404,3
0.516,0.0001,250,254,25,2,0.0001,504,3
0.516,0.0001,299,305,25,2,0.0001,604,3
0.516,0.0001,347,357,25,2,0.0001,704,3
0.518,0.0001,392,412,25,2,0.0001,804,3
0.518,0.0001,445,459,25,2,0.0001,904,3
0.518,0.0001,495,509,25,2,0.0001,1004,3
0.518,0.0001,546,558,25,2,0.0001,1104,3
0.518,0.0001,597,607,25,2,0.0001,1204,3
0.52,0.0001,658,646,25,2,0.0001,1304,3
0.52,0.0001,704,700,25,2,0.0001,1404,3
0.52,0.0001,751,753,25,2,0.0001,1504,3
0.52,0.0001,804,800,25,2,0.0001,1604,3
0.52,0.0001,855,849,25,2,0.0001,1704,3
0.522,0.0001,905,899,25,2,0.0001,1804,3
0.526,0.0001,955,949,25,2,0.0001,1904,3
0.53,0.0001,1002,1002,25,2,0.0001,2004,3
0.482,0.0001,59,45,25,2,0.0001,104,4
0.482,0.0001,118,86,25,2,0.0001,204,4
0.482,0.0001,159,145,25,2,0.0001,304,4
0.482,0.0001,211,193,25,2,0.0001,404,4
0.482,0.0001,260,244,25,2,0.0001,504,4
0.482,0.0001,311,293,25,2,0.0001,604,4
0.482,0.0001,362,342,25,2,0.0001,704,4
0.482,0.0001,415,389,25,2,0.0001,804,4
0.482,0.0001,464,440,25,2,0.0001,904,4
0.482,0.0001,509,495,25,2,0.0001,1004,4
0.482,0.0001,561,543,25,2,0.0001,1104,4
0.482,0.0001,612,592,25,2,0.0001,1204,4
0.482,0.0001,661,643,25,2,0.0001,1304,4
0.482,0.0001,705,699,25,2,0.0001,1404,4
0.48,0.0001,769,735,25,2,0.0001,1504,4
0.48,0.0001,813,791,25,2,0.0001,1604,4
0.48,0.0001,864,840,25,2,0.0001,1704,4
0.48,0.0001,907,897,25,2,0.0001,1804,4
0.48,0.0001,953,951,25,2,0.0001,1904,4
0.482,0.0001,1007,997,25,2,0.0001,2004,4
0.5,0.0001,52,52,25,2,0.0001,104,5
0.5,0.0001,97,107,25,2,0.0001,204,5
0.5,0.0001,140,164,25,2,0.0001,304,5
0.5,0.0001,179,225,25,2,0.0001,404,5
0.5,0.0001,224,280,25,2,0.0001,504,5
0.5,0.0001,278,326,25,2,0.0001,604,5
0.5,0.0001,323,381,25,2,0.0001,704,5
0.5,0.0001,377,427,25,2,0.0001,804,5
0.5,0.0001,436,468,25,2,0.0001,904,5
0.5,0.0001,483,521,25,2,0.0001,1004,5
0.5,0.0001,535,569,25,2,0.0001,1104,5
0.5,0.0001,586,618,25,2,0.0001,1204,5
0.5,0.0001,642,662,25,2,0.0001,1304,5
0.5,0.0001,694,710,25,2,0.0001,1404,5
0.5,0.0001,747,757,25,2,0.0001,1504,5
0.502,0.0001,798,806,25,2,0.0001,1604,5
0.502,0.0001,850,854,25,2,0.0001,1704,5
0.502,0.0001,905,899,25,2,0.0001,1804,5
0.502,0.0001,954,950,25,2,0.0001,1904,5
0.504,0.0001,1001,1003,25,2,0.0001,2004,5
0.504,0.0001,55,49,25,2,0.0001,104,6
0.504,0.0001,109,95,25,2,0.0001,204,6
0.504,0.0001,157,147,25,2,0.0001,304,6
0.504,0.0001,206,198,25,2,0.0001,404,6
0.504,0.0001,260,244,25,2,0.0001,504,6
0.504,0.0001,306,298,25,2,0.0001,604,6
0.504,0.0001,362,342,25,2,0.0001,704,6
0.508,0.0001,419,385,25,2,0.0001,804,6
0.51,0.0001,470,434,25,2,0.0001,904,6
0.51,0.0001,525,479,25,2,0.0001,1004,6
0.51,0.0001,571,533,25,2,0.0001,1104,6
0.506,0.0001,623,581,25,2,0.0001,1204,6
0.506,0.0001,672,632,25,2,0.0001,1304,6
0.506,0.0001,724,680,25,2,0.0001,1404,6
0.504,0.0001,770,734,25,2,0.0001,1504,6
0.504,0.0001,813,791,25,2,0.0001,1604,6
0.504,0.0001,866,838,25,2,0.0001,1704,6
0.504,0.0001,916,888,25,2,0.0001,1804,6
0.502,0.0001,966,938,25,2,0.0001,1904,6
0.502,0.0001,1010,994,25,2,0.0001,2004,6
0.484,0.0001,60,44,25,2,0.0001,104,7
0.484,0.0001,110,94,25,2,0.0001,204,7
0.484,0.0001,153,151,25,2,0.0001,304,7
0.484,0.0001,203,201,25,2,0.0001,404,7
0.484,0.0001,257,247,25,2,0.0001,504,7
0.484,0.0001,313,291,25,2,0.0001,604,7
0.484,0.0001,357,347,25,2,0.0001,704,7
0.486,0.0001,405,399,25,2,0.0001,804,7
0.486,0.0001,460,444,25,2,0.0001,904,7
0.486,0.0001,504,500,25,2,0.0001,1004,7
0.486,0.0001,559,545,25,2,0.0001,1104,7
0.484,0.0001,615,589,25,2,0.0001,1204,7
0.484,0.0001,660,644,25,2,0.0001,1304,7
0.486,0.0001,710,694,25,2,0.0001,1404,7
0.486,0.0001,765,739,25,2,0.0001,1504,7
0.488,0.0001,809,795,25,2,0.0001,1604,7
0.488,0.0001,863,841,25,2,0.0001,1704,7
0.488,0.0001,909,895,25,2,0.0001,1804,7
0.49,0.0001,965,939,25,2,0.0001,1904,7
0.488,0.0001,1017,987,25,2,0.0001,2004,7
0.476,0.0001,43,61,25,2,0.0001,104,8
0.476,0.0001,89,115,25,2,0.0001,204,8
0.476,0.0001,134,170,25,2,0.0001,304,8
0.476,0.0001,185,219,25,2,0.0001,404,8
0.476,0.0001,231,273,25,2,0.0001,504,8
0.476,0.0001,286,318,25,2,0.0001,604,8
0.476,0.0001,332,372,25,2,0.0001,704,8
0.476,0.0001,381,423,25,2,0.0001,804,8
0.476,0.0001,425,479,25,2,0.0001,904,8
0.476,0.0001,470,534,25,2,0.0001,1004,8
0.476,0.0001,523,581,25,2,0.0001,1104,8
0.476,0.0001,580,624,25,2,0.0001,1204,8
0.476,0.0001,631,673,25,2,0.0001,1304,8
0.476,0.0001,683,721,25,2,0.0001,1404,8
0.476,0.0001,733,771,25,2,0.0001,1504,8
0.476,0.0001,783,821,25,2,0.0001,1604,8
0.476,0.0001,836,868,25,2,0.0001,1704,8
0.476,0.0001,893,911,25,2,0.0001,1804,8
0.476,0.0001,943,961,25,2,0.0001,1904,8
0.476,0.0001,990,1014,25,2,0.0001,2004,8
0.508,0.0001,46,58,25,2,0.0001,104,9
0.508,0.0001,93,111,25,2,0.0001,204,9
0.508,0.0001,148,156,25,2,0.0001,304,9
0.508,0.0001,201,203,25,2,0.0001,404,9
0.508,0.0001,256,248,25,2,0.0001,504,9
0.508,0.0001,314,290,25,2,0.0001,604,9
0.508,0.0001,356,348,25,2,0.0001,704,9
0.508,0.0001,401,403,25,2,0.0001,804,9
0.508,0.0001,448,456,25,2,0.0001,904,9
0.508,0.0001,495,509,25,2,0.0001,1004,9
0.508,0.0001,549,555,25,2,0.0001,1104,9
0.508,0.0001,602,602,25,2,0.0001,1204,9
0.508,0.0001,654,650,25,2,0.0001,1304,9
0.508,0.0001,702,702,25,2,0.0001,1404,9
0.508,0.0001,753,751,25,2,0.0001,1504,9
0.508,0.0001,797,807,25,2,0.0001,1604,9
0.508,0.0001,846,858,25,2,0.0001,1704,9
0.508,0.0001,898,906,25,2,0.0001,1804,9
0.508,0.0001,949,955,25,2,0.0001,1904,9
0.508,0.0001,1006,998,25,2,0.0001,2004,9
0.512,0.0001,64,40,25,2,0.0001,104,10
0.512,0.0001,110,94,25,2,0.0001,204,10
0.512,0.0001,163,141,25,2,0.0001,304,10
0.512,0.0001,212,192,25,2,0.0001,404,10
0.512,0.0001,259,245,25,2,0.0001,504,10
0.512,0.0001,316,288,25,2,0.0001,604,10
0.512,0.0001,358,346,25,2,0.0001,704,10
0.512,0.0001,412,392,25,2,0.0001,804,10
0.512,0.0001,466,438,25,2,0.0001,904,10
0.512,0.0001,511,493,25,2,0.0001,1004,10
0.514,0.0001,553,551,25,2,0.0001,1104,10
0.514,0.0001,601,603,25,2,0.0001,1204,10
0.514,0.0001,650,654,25,2,0.0001,1304,10
0.514,0.0001,705,699,25,2,0.0001,1404,10
0.514,0.0001,753,751,25,2,0.0001,1504,10
0.514,0.0001,801,803,25,2,0.0001,1604,10
0.514,0.0001,854,850,25,2,0.0001,1704,10
0.514,0.0001,905,899,25,2,0.0001,1804,10
0.516,0.0001,956,948,25,2,0.0001,1904,10
0.514,0.0001,1005,999,25,2,0.0001,2004,10
0.468,0.0001,56,48,25,2,0.0001,104,11
0.468,0.0001,110,94,25,2,0.0001,204,11
0.47,0.0001,161,143,25,2,0.0001,304,11
0.47,0.0001,214,190,25,2,0.0001,404,11
0.47,0.0001,264,240,25,2,0.0001,504,11
0.47,0.0001,309,295,25,2,0.0001,604,11
0.47,0.0001,354,350,25,2,0.0001,704,11
0.47,0.0001,400,404,25,2,0.0001,804,11
0.47,0.0001,454,450,25,2,0.0001,904,11
0.47,0.0001,504,500,25,2,0.0001,1004,11
0.47,0.0001,559,545,25,2,0.0001,1104,11
0.47,0.0001,599,605,25,2,0.0001,1204,11
0.472,0.0001,651,653,25,2,0.0001,1304,11
0.472,0.0001,696,708,25,2,0.0001,1404,11
0.472,0.0001,740,764,25,2,0.0001,1504,11
0.474,0.0001,791,813,25,2,0.0001,1604,11
0.474,0.0001,837,867,25,2,0.0001,1704,11
0.474,0.0001,881,923,25,2,0.0001,1804,11
0.474,0.0001,932,972,25,2,0.0001,1904,11
0.474,0.0001,986,1018,25,2,0.0001,2004,11
0.48,0.0001,58,46,25,2,0.0001,104,12
0.48,0.0001,103,101,25,2,0.0001,204,12
0.48,0.0001,151,153,25,2,0.0001,304,12
0.48,0.0001,203,201,25,2,0.0001,404,12
0.478,0.0001,256,248,25,2,0.0001,504,12
0.478,0.0001,312,292,25,2,0.0001,604,12
0.478,0.0001,351,353,25,2,0.0001,704,12
0.478,0.0001,406,398,25,2,0.0001,804,12
0.478,0.0001,451,453,25,2,0.0001,904,12
0.478,0.0001,498,506,25,2,0.0001,1004,12
0.478,0.0001,543,561,25,2,0.0001,1104,12
0.48,0.0001,600,604,25,2,0.0001,1204,12
0.48,0.0001,660,644,25,2,0.0001,1304,12
0.48,0.0001,704,700,25,2,0.0001,1404,12
0.48,0.0001,747,757,25,2,0.0001,1504,12
0.48,0.0001,794,810,25,2,0.0001,1604,12
0.48,0.0001,845,859,25,2,0.0001,1704,12
0.482,0.0001,892,912,25,2,0.0001,1804,12
0.482,0.0001,943,961,25,2,0.0001,1904,12
0.48,0.0001,991,1013,25,2,0.0001,2004,12
0.516,0.0001,52,52,25,2,0.0001,104,13
0.516,0.0001,95,109,25,2,0.0001,204,13
0.516,0.0001,145,159,25,2,0.0001,304,13
0.516,0.0001,196,208,25,2,0.0001,404,13
0.516,0.0001,253,251,25,2,0.0001,504,13
0.516,0.0001,301,303,25,2,0.0001,604,13
0.516,0.0001,342,362,25,2,0.0001,704,13
0.516,0.0001,392,412,25,2,0.0001,804,13
0.516,0.0001,452,452,25,2,0.0001,904,13
0.516,0.0001,503,501,25,2,0.0001,1004,13
0.516,0.0001,555,549,25,2,0.0001,1104,13
0.516,0.0001,608,596,25,2,0.0001,1204,13
0.516,0.0001,658,646,25,2,0.0001,1304,13
0.516,0.0001,710,694,25,2,0.0001,1404,13
0.516,0.0001,752,752,25,2,0.0001,1504,13
0.516,0.0001,805,799,25,2,0.0001,1604,13
0.516,0.0001,843,861,25,2,0.0001,1704,13
0.516,0.0001,899,905,25,2,0.0001,1804,13
0.516,0.0001,945,959,25,2,0.0001,1904,13
0.516,0.0001,994,1010,25,2,0.0001,2004,13
0.486,0.0001,47,57,25,2,0.0001,104,14
0.486,0.0001,101,103,25,2,0.0001,204,14
0.486,0.0001,153,151,25,2,0.0001,304,14
0.486,0.0001,196,208,25,2,0.0001,404,14
0.486,0.0001,248,256,25,2,0.0001,504,14
0.486,0.0001,307,297,25,2,0.0001,604,14
0.486,0.0001,363,341,25,2,0.0001,704,14
0.486,0.0001,413,391,25,2,0.0001,804,14
0.486,0.0001,465,439,25,2,0.0001,904,14
0.486,0.0001,505,499,25,2,0.0001,1004,14
0.486,0.0001,561,543,25,2,0.0001,1104,14
0.486,0.0001,615,589,25,2,0.0001,1204,14
0.486,0.0001,670,634,25,2,0.0001,1304,14
0.486,0.0001,724,680,25,2,0.0001,1404,14
0.486,0.0001,768,736,25,2,0.0001,1504,14
0.486,0.0001,808,796,25,2,0.0001,1604,14
0.486,0.0001,859,845,25,2,0.0001,1704,14
0.486,0.0001,905,899,25,2,0.0001,1804,14
0.486,0.0001,952,952,25,2,0.0001,1904,14
0.486,0.0001,995,1009,25,2,0.0001,2004,14
0.452,0.0001,55,49,25,2,0.0001,104,15
0.452,0.0001,103,101,25,2,0.0001,204,15
0.452,0.0001,153,151,25,2,0.0001,304,15
0.452,0.0001,201,203,25,2,0.0001,404,15
0.452,0.0001,249,255,25,2,0.0001,504,15
0.452,0.0001,301,303,25,2,0.0001,604,15
0.452,0.0001,358,346,25,2,0.0001,704,15
0.452,0.0001,409,395,25,2,0.0001,804,15
0.452,0.0001,462,442,25,2,0.0001,904,15
0.452,0.0001,516,488,25,2,0.0001,1004,15
0.452,0.0001,568,536,25,2,0.0001,1104,15
0.452,0.0001,614,590,25,2,0.0001,1204,15
0.452,0.0001,661,643,25,2,0.0001,1304,15
0.452,0.0001,723,681,25,2,0.0001,1404,15
0.452,0.0001,764,740,25,2,0.0001,1504,15
0.452,0.0001,816,788,25,2,0.0001,1604,15
0.452,0.0001,868,836,25,2,0.0001,1704,15
0.452,0.0001,920,884,25,2,0.0001,1804,15
0.452,0.0001,973,931,25,2,0.0001,1904,15
0.452,0.0001,1026,978,25,2,0.0001,2004,15
0.476,0.0001,44,60,25,2,0.0001,104,16
0.476,0.0001,90,114,25,2,0.0001,204,16
0.476,0.0001,135,169,25,2,0.0001,304,16
0.476,0.0001,182,222,25,2,0.0001,404,16
0.476,0.0001,235,269,25,2,0.0001,504,16
0.476,0.0001,288,316,25,2,0.0001,604,16
0.476,0.0001,341,363,25,2,0.0001,704,16
0.476,0.0001,386,418,25,2,0.0001,804,16
0.476,0.0001,444,460,25,2,0.0001,904,16
0.476,0.0001,493,511,25,2,0.0001,1004,16
0.476,0.0001,541,563,25,2,0.0001,1104,16
0.476,0.0001,594,610,25,2,0.0001,1204,16
0.476,0.0001,639,665,25,2,0.0001,1304,16
0.476,0.0001,683,721,25,2,0.0001,1404,16
0.476,0.0001,736,768,25,2,0.0001,1504,16
0.476,0.0001,786,818,25,2,0.0001,1604,16
0.476,0.0001,839,865,25,2,0.0001,1704,16
0.476,0.0001,889,915,25,2,0.0001,1804,16
0.476,0.0001,939,965,25,2,0.0001,1904,16
0.476,0.0001,990,1014,25,2,0.0001,2004,16
0.534,0.0001,45,59,25,2,0.0001,104,17
0.534,0.0001,103,101,25,2,0.0001,204,17
0.534,0.0001,149,155,25,2,0.0001,304,17
0.534,0.0001,201,203,25,2,0.0001,404,17
0.534,0.0001,250,254,25,2,0.0001,504,17
0.534,0.0001,303,301,25,2,0.0001,604,17
0.534,0.0001,352,352,25,2,0.0001,704,17
0.534,0.0001,396,408,25,2,0.0001,804,17
0.534,0.0001,436,468,25,2,0.0001,904,17
0.534,0.0001,492,512,25,2,0.0001,1004,17
0.532,0.0001,541,563,25,2,0.0001,1104,17
0.532,0.0001,601,603,25,2,0.0001,1204,17
0.532,0.0001,652,652,25,2,0.0001,1304,17
0.532,0.0001,714,690,25,2,0.0001,1404,17
0.532,0.0001,767,737,25,2,0.0001,1504,17
0.536,0.0001,817,787,25,2,0.0001,1604,17
0.536,0.0001,873,831,25,2,0.0001,1704,17
0.538,0.0001,928,876,25,2,0.0001,1804,17
0.54,0.0001,965,939,25,2,0.0001,1904,17
0.54,0.0001,1013,991,25,2,0.0001,2004,17
0.49,0.0001,51,53,25,2,0.0001,104,18
0.49,0.0001,101,103,25,2,0.0001,204,18
0.49,0.0001,156,148,25,2,0.0001,304,18
0.49,0.0001,201,203,25,2,0.0001,404,18
0.49,0.0001,256,248,25,2,0.0001,504,18
0.49,0.0001,303,301,25,2,0.0001,604,18
0.49,0.0001,344,360,25,2,0.0001,704,18
0.49,0.0001,394,410,25,2,0.0001,804,18
0.49,0.0001,449,455,25,2,0.0001,904,18
0.49,0.0001,495,509,25,2,0.0001,1004,18
0.49,0.0001,538,566,25,2,0.0001,1104,18
0.49,0.0001,586,618,25,2,0.0001,1204,18
0.49,0.0001,637,667,25,2,0.0001,1304,18
0.49,0.0001,683,721,25,2,0.0001,1404,18
0.49,0.0001,736,768,25,2,0.0001,1504,18
0.49,0.0001,789,815,25,2,0.0001,1604,18
0.49,0.0001,844,860,25,2,0.0001,1704,18
0.49,0.0001,892,912,25,2,0.0001,1804,18
0.49,0.0001,949,955,25,2,0.0001,1904,18
0.49,0.0001,997,1007,25,2,0.0001,2004,18
0.49,0.0001,51,53,25,2,0.0001,104,19
0.49,0.0001,107,97,25,2,0.0001,204,19
0.49,0.0001,151,153,25,2,0.0001,304,19
0.49,0.0001,206,198,25,2,0.0001,404,19
0.49,0.0001,257,247,25,2,0.0001,504,19
0.49,0.0001,306,298,25,2,0.0001,604,19
0.49,0.0001,353,351,25,2,0.0001,704,19
0.49,0.0001,408,396,25,2,0.0001,804,19
0.49,0.0001,465,439,25,2,0.0001,904,19
0.49,0.0001,506,498,25,2,0.0001,1004,19
0.49,0.0001,560,544,25,2,0.0001,1104,19
0.49,0.0001,612,592,25,2,0.0001,1204,19
0.49,0.0001,663,641,25,2,0.0001,1304,19
0.49,0.0001,719,685,25,2,0.0001,1404,19
0.49,0.0001,762,742,25,2,0.0001,1504,19
0.49,0.0001,806,798,25,2,0.0001,1604,19
0.49,0.0001,856,848,25,2,0.0001,1704,19
0.49,0.0001,908,896,25,2,0.0001,1804,19
0.49,0.0001,961,943,25,2,0.0001,1904,19
0.49,0.0001,1007,997,25,2,0.0001,2004,19
0.47,0.0001,50,54,25,2,0.0001,104,20
0.47,0.0001,102,102,25,2,0.0001,204,20
0.47,0.0001,154,150,25,2,0.0001,304,20
0.47,0.0001,195,209,25,2,0.0001,404,20
0.47,0.0001,240,264,25,2,0.0001,504,20
0.47,0.0001,292,312,25,2,0.0001,604,20
0.47,0.0001,336,368,25,2,0.0001,704,20
0.47,0.0001,378,426,25,2,0.0001,804,20
0.47,0.0001,429,475,25,2,0.0001,904,20
0.47,0.0001,484,520,25,2,0.0001,1004,20
0.47,0.0001,532,572,25,2,0.0001,1104,20
0.47,0.0001,576,628,25,2,0.0001,1204,20
0.47,0.0001,624,680,25,2,0.0001,1304,20
0.47,0.0001,674,730,25,2,0.0001,1404,20
0.47,0.0001,720,784,25,2,0.0001,1504,20
0.47,0.0001,780,824,25,2,0.0001,1604,20
0.47,0.0001,831,873,25,2,0.0001,1704,20
0.47,0.0001,879,925,25,2,0.0001,1804,20
0.47,0.0001,926,978,25,2,0.0001,1904,20
0.47,0.0001,987,1017,25,2,0.0001,2004,20
0.502,0.0001,40,64,25,2,0.001,104,1
0.502,0.0001,87,117,25,2,0.001,204,1
0.502,0.0001,138,166,25,2,0.001,304,1
0.504,0.0001,187,217,25,2,0.001,404,1
0.504,0.0001,243,261,25,2,0.001,504,1
0.504,0.0001,296,308,25,2,0.001,604,1
0.504,0.0001,347,357,25,2,0.001,704,1
0.502,0.0001,390,414,25,2,0.001,804,1
0.5,0.0001,440,464,25,2,0.001,904,1
0.498,0.0001,497,507,25,2,0.001,1004,1
0.5,0.0001,551,553,25,2,0.001,1104,1
0.502,0.0001,604,600,25,2,0.001,1204,1
0.512,0.0001,654,650,25,2,0.001,1304,1
0.514,0.0001,697,707,25,2,0.001,1404,1
0.52,0.0001,747,757,25,2,0.001,1504,1
0.528,0.0001,798,806,25,2,0.001,1604,1
0.536,0.0001,854,850,25,2,0.001,1704,1
0.544,0.0001,896,908,25,2,0.001,1804,1
0.55,0.0001,949,955,25,2,0.001,1904,1
0.562,0.0001,999,1005,25,2,0.001,2004,1
0.5,0.0001,58,46,25,2,0.001,104,2
0.5,0.0001,111,93,25,2,0.001,204,2
0.5,0.0001,165,139,25,2,0.001,304,2
0.5,0.0001,207,197,25,2,0.001,404,2
0.498,0.0001,263,241,25,2,0.001,504,2
0.498,0.0001,315,289,25,2,0.001,604,2
0.5,0.0001,360,344,25,2,0.001,704,2
0.504,0.0001,406,398,25,2,0.001,804,2
0.504,0.0001,456,448,25,2,0.001,904,2
0.504,0.0001,507,497,25,2,0.001,1004,2
0.504,0.0001,563,541,25,2,0.001,1104,2
0.504,0.0001,622,582,25,2,0.001,1204,2
0.504,0.0001,670,634,25,2,0.001,1304,2
0.506,0.0001,721,683,25,2,0.001,1404,2
0.508,0.0001,761,743,25,2,0.001,1504,2
0.51,0.0001,805,799,25,2,0.001,1604,2
0.512,0.0001,859,845,25,2,0.001,1704,2
0.516,0.0001,906,898,25,2,0.001,1804,2
0.518,0.0001,951,953,25,2,0.001,1904,2
0.518,0.0001,1002,1002,25,2,0.001,2004,2
0.524,0.0001,56,48,25,2,0.001,104,3
0.524,0.0001,113,91,25,2,0.001,204,3
0.524,0.0001,153,151,25,2,0.001,304,3
0.524,0.0001,210,194,25,2,0.001,404,3
0.524,0.0001,253,251,25,2,0.001,504,3
0.524,0.0001,310,294,25,2,0.001,604,3
0.524,0.0001,359,345,25,2,0.001,704,3
0.524,0.0001,406,398,25,2,0.001,804,3
0.524,0.0001,454,450,25,2,0.001,904,3
0.524,0.0001,502,502,25,2,0.001,1004,3
0.524,0.0001,551,553,25,2,0.001,1104,3
0.524,0.0001,611,593,25,2,0.001,1204,3
0.524,0.0001,661,643,25,2,0.001,1304,3
0.524,0.0001,716,688,25,2,0.001,1404,3
0.524,0.0001,758,746,25,2,0.001,1504,3
0.524,0.0001,807,797,25,2,0.001,1604,3
0.524,0.0001,862,842,25,2,0.001,1704,3
0.524,0.0001,915,889,25,2,0.001,1804,3
0.524,0.0001,959,945,25,2,0.001,1904,3
0.524,0.0001,1014,990,25,2,0.001,2004,3
0.51,0.0001,59,45,25,2,0.001,104,4
0.51,0.0001,112,92,25,2,0.001,204,4
0.51,0.0001,163,141,25,2,0.001,304,4
0.51,0.0001,212,192,25,2,0.001,404,4
0.51,0.0001,259,245,25,2,0.001,504,4
0.51,0.0001,311,293,25,2,0.001,604,4
0.51,0.0001,357,347,25,2,0.001,704,4
0.51,0.0001,411,393,25,2,0.001,804,4
0.51,0.0001,460,444,25,2,0.001,904,4
0.51,0.0001,507,497,25,2,0.001,1004,4
0.51,0.0001,558,546,25,2,0.001,1104,4
0.51,0.0001,610,594,25,2,0.001,1204,4
0.51,0.0001,653,651,25,2,0.001,1304,4
0.51,0.0001,700,704,25,2,0.001,1404,4
0.51,0.0001,755,749,25,2,0.001,1504,4
0.51,0.0001,802,802,25,2,0.001,1604,4
0.51,0.0001,839,865,25,2,0.001,1704,4
0.51,0.0001,894,910,25,2,0.001,1804,4
0.51,0.0001,945,959,25,2,0.001,1904,4
0.51,0.0001,997,1007,25,2,0.001,2004,4
0.51,0.0001,61,43,25,2,0.001,104,5
0.51,0.0001,115,89,25,2,0.001,204,5
0.512,0.0001,166,138,25,2,0.001,304,5
0.516,0.0001,214,190,25,2,0.001,404,5
0.518,0.0001,257,247,25,2,0.001,504,5
0.52,0.0001,302,302,25,2,0.001,604,5
0.524,0.0001,359,345,25,2,0.001,704,5
0.528,0.0001,414,390,25,2,0.001,804,5
0.532,0.0001,456,448,25,2,0.001,904,5
0.532,0.0001,503,501,25,2,0.001,1004,5
0.536,0.0001,555,549,25,2,0.001,1104,5
0.538,0.0001,601,603,25,2,0.001,1204,5
0.54,0.0001,654,650,25,2,0.001,1304,5
0.546,0.0001,698,706,25,2,0.001,1404,5
0.548,0.0001,749,755,25,2,0.001,1504,5
0.552,0.0001,807,797,25,2,0.001,1604,5
0.554,0.0001,858,846,25,2,0.001,1704,5
0.56,0.0001,911,893,25,2,0.001,1804,5
0.568,0.0001,954,950,25,2,0.001,1904,5
0.572,0.0001,1005,999,25,2,0.001,2004,5
0.482,0.0001,53,51,25,2,0.001,104,6
0.482,0.0001,110,94,25,2,0.001,204,6
0.482,0.0001,155,149,25,2,0.001,304,6
0.482,0.0001,203,201,25,2,0.001,404,6
0.482,0.0001,255,249,25,2,0.001,504,6
0.482,0.0001,303,301,25,2,0.001,604,6
0.482,0.0001,348,356,25,2,0.001,704,6
0.482,0.0001,393,411,25,2,0.001,804,6
0.482,0.0001,446,458,25,2,0.001,904,6
0.482,0.0001,498,506,25,2,0.001,1004,6
0.482,0.0001,554,550,25,2,0.001,1104,6
0.482,0.0001,608,596,25,2,0.001,1204,6
0.482,0.0001,664,640,25,2,0.001,1304,6
0.482,0.0001,714,690,25,2,0.001,1404,6
0.482,0.0001,765,739,25,2,0.001,1504,6
0.482,0.0001,813,791,25,2,0.001,1604,6
0.482,0.0001,864,840,25,2,0.001,1704,6
0.482,0.0001,906,898,25,2,0.001,1804,6
0.482,0.0001,959,945,25,2,0.001,1904,6
0.482,0.0001,1011,993,25,2,0.001,2004,6
0.508,0.0001,48,56,25,2,0.001,104,7
0.508,0.0001,94,110,25,2,0.001,204,7
0.508,0.0001,158,146,25,2,0.001,304,7
0.508,0.0001,202,202,25,2,0.001,404,7
0.508,0.0001,244,260,25,2,0.001,504,7
0.508,0.0001,295,309,25,2,0.001,604,7
0.508,0.0001,355,349,25,2,0.001,704,7
0.508,0.0001,408,396,25,2,0.001,804,7
0.508,0.0001,455,449,25,2,0.001,904,7
0.508,0.0001,508,496,25,2,0.001,1004,7
0.508,0.0001,568,536,25,2,0.001,1104,7
0.508,0.0001,622,582,25,2,0.001,1204,7
0.508,0.0001,671,633,25,2,0.001,1304,7
0.508,0.0001,721,683,25,2,0.001,1404,7
0.508,0.0001,774,730,25,2,0.001,1504,7
0.508,0.0001,816,788,25,2,0.001,1604,7
0.508,0.0001,860,844,25,2,0.001,1704,7
0.508,0.0001,909,895,25,2,0.001,1804,7
0.508,0.0001,960,944,25,2,0.001,1904,7
0.508,0.0001,1006,998,25,2,0.001,2004,7
0.488,0.0001,50,54,25,2,0.001,104,8
0.488,0.0001,108,96,25,2,0.001,204,8
0.486,0.0001,153,151,25,2,0.001,304,8
0.484,0.0001,205,199,25,2,0.001,404,8
0.486,0.0001,254,250,25,2,0.001,504,8
0.488,0.0001,295,309,25,2,0.001,604,8
0.49,0.0001,342,362,25,2,0.001,704,8
0.492,0.0001,391,413,25,2,0.001,804,8
0.494,0.0001,447,457,25,2,0.001,904,8
0.498,0.0001,495,509,25,2,0.001,1004,8
0.5,0.0001,549,555,25,2,0.001,1104,8
0.5,0.0001,603,601,25,2,0.001,1204,8
0.504,0.0001,646,658,25,2,0.001,1304,8
0.514,0.0001,694,710,25,2,0.001,1404,8
0.514,0.0001,745,759,25,2,0.001,1504,8
0.516,0.0001,789,815,25,2,0.001,1604,8
0.52,0.0001,839,865,25,2,0.001,1704,8
0.526,0.0001,887,917,25,2,0.001,1804,8
0.524,0.0001,946,958,25,2,0.001,1904,8
0.528,0.0001,999,1005,25,2,0.001,2004,8
0.516,0.0001,56,48,25,2,0.001,104,9
0.516,0.0001,106,98,25,2,0.001,204,9
0.516,0.0001,151,153,25,2,0.001,304,9
0.516,0.0001,200,204,25,2,0.001,404,9
0.516,0.0001,247,257,25,2,0.001,504,9
0.516,0.0001,299,305,25,2,0.001,604,9
0.516,0.0001,342,362,25,2,0.001,704,9
0.516,0.0001,403,401,25,2,0.001,804,9
0.516,0.0001,448,456,25,2,0.001,904,9
0.516,0.0001,500,504,25,2,0.001,1004,9
0.516,0.0001,546,558,25,2,0.001,1104,9
0.516,0.0001,600,604,25,2,0.001,1204,9
0.516,0.0001,649,655,25,2,0.001,1304,9
0.516,0.0001,697,707,25,2,0.001,1404,9
0.516,0.0001,750,754,25,2,0.001,1504,9
0.516,0.0001,797,807,25,2,0.001,1604,9
0.516,0.0001,851,853,25,2,0.001,1704,9
0.516,0.0001,898,906,25,2,0.001,1804,9
0.516,0.0001,947,957,25,2,0.001,1904,9
0.516,0.0001,994,1010,25,2,0.001,2004,9
0.478,0.0001,43,61,25,2,0.001,104,10
0.478,0.0001,101,103,25,2,0.001,204,10
0.478,0.0001,150,154,25,2,0.001,304,10
0.48,0.0001,201,203,25,2,0.001,404,10
0.482,0.0001,251,253,25,2,0.001,504,10
0.484,0.0001,296,308,25,2,0.001,604,10
0.488,0.0001,353,351,25,2,0.001,704,10
0.488,0.0001,406,398,25,2,0.001,804,10
0.49,0.0001,457,447,25,2,0.001,904,10
0.492,0.0001,502,502,25,2,0.001,1004,10
0.496,0.0001,553,551,25,2,0.001,1104,10
0.498,0.0001,601,603,25,2,0.001,1204,10
0.504,0.0001,643,661,25,2,0.001,1304,10
0.508,0.0001,690,714,25,2,0.001,1404,10
0.508,0.0001,740,764,25,2,0.001,1504,10
0.516,0.0001,793,811,25,2,0.001,1604,10
0.516,0.0001,843,861,25,2,0.001,1704,10
0.514,0.0001,892,912,25,2,0.001,1804,10
0.522,0.0001,938,966,25,2,0.001,1904,10
0.524,0.0001,990,1014,25,2,0.001,2004,10
0.51,0.0001,52,52,25,2,0.001,104,11
0.51,0.0001,107,97,25,2,0.001,204,11
0.51,0.0001,151,153,25,2,0.001,304,11
0.51,0.0001,200,204,25,2,0.001,404,11
0.51,0.0001,254,250,25,2,0.001,504,11
0.508,0.0001,301,303,25,2,0.001,604,11
0.51,0.0001,350,354,25,2,0.001,704,11
0.512,0.0001,405,399,25,2,0.001,804,11
0.514,0.0001,463,441,25,2,0.001,904,11
0.516,0.0001,504,500,25,2,0.001,1004,11
0.518,0.0001,553,551,25,2,0.001,1104,11
0.52,0.0001,602,602,25,2,0.001,1204,11
0.526,0.0001,659,645,25,2,0.001,1304,11
0.534,0.0001,707,697,25,2,0.001,1404,11
0.532,0.0001,750,754,25,2,0.001,1504,11
0.534,0.0001,800,804,25,2,0.001,1604,11
0.528,0.0001,843,861,25,2,0.001,1704,11
0.532,0.0001,896,908,25,2,0.001,1804,11
0.536,0.0001,942,962,25,2,0.001,1904,11
0.542,0.0001,998,1006,25,2,0.001,2004,11
0.51,0.0001,45,59,25,2,0.001,104,12
0.51,0.0001,90,114,25,2,0.001,204,12
0.508,0.0001,135,169,25,2,0.001,304,12
0.508,0.0001,189,215,25,2,0.001,404,12
0.51,0.0001,235,269,25,2,0.001,504,12
0.51,0.0001,278,326,25,2,0.001,604,12
0.51,0.0001,339,365,25,2,0.001,704,12
0.514,0.0001,386,418,25,2,0.001,804,12
0.516,0.0001,436,468,25,2,0.001,904,12
0.516,0.0001,488,516,25,2,0.001,1004,12
0.516,0.0001,537,567,25,2,0.001,1104,12
0.518,0.0001,586,618,25,2,0.001,1204,12
0.518,0.0001,638,666,25,2,0.001,1304,12
0.528,0.0001,691,713,25,2,0.001,1404,12
0.53,0.0001,738,766,25,2,0.001,1504,12
0.53,0.0001,792,812,25,2,0.001,1604,12
0.532,0.0001,838,866,25,2,0.001,1704,12
0.532,0.0001,897,907,25,2,0.001,1804,12
0.546,0.0001,946,958,25,2,0.001,1904,12
0.548,0.0001,996,1008,25,2,0.001,2004,12
0.498,0.0001,51,53,25,2,0.001,104,13
0.498,0.0001,91,113,25,2,0.001,204,13
0.498,0.0001,137,167,25,2,0.001,304,13
0.498,0.0001,187,217,25,2,0.001,404,13
0.498,0.0001,238,266,25,2,0.001,504,13
0.498,0.0001,296,308,25,2,0.001,604,13
0.498,0.0001,354,350,25,2,0.001,704,13
0.498,0.0001,399,405,25,2,0.001,804,13
0.498,0.0001,457,447,25,2,0.001,904,13
0.498,0.0001,501,503,25,2,0.001,1004,13
0.498,0.0001,548,556,25,2,0.001,1104,13
0.498,0.0001,596,608,25,2,0.001,1204,13
0.498,0.0001,642,662,25,2,0.001,1304,13
0.498,0.0001,706,698,25,2,0.001,1404,13
0.498,0.0001,758,746,25,2,0.001,1504,13
0.498,0.0001,809,795,25,2,0.001,1604,13
0.498,0.0001,862,842,25,2,0.001,1704,13
0.498,0.0001,907,897,25,2,0.001,1804,13
0.498,0.0001,957,947,25,2,0.001,1904,13
0.498,0.0001,1001,1003,25,2,0.001,2004,13
0.51,0.0001,59,45,25,2,0.001,104,14
0.508,0.0001,120,84,25,2,0.001,204,14
0.508,0.0001,167,137,25,2,0.001,304,14
0.512,0.0001,209,195,25,2,0.001,404,14
0.516,0.0001,266,238,25,2,0.001,504,14
0.514,0.0001,314,290,25,2,0.001,604,14
0.514,0.0001,366,338,25,2,0.001,704,14
0.518,0.0001,411,393,25,2,0.001,804,14
0.518,0.0001,456,448,25,2,0.001,904,14
0.522,0.0001,499,505,25,2,0.001,1004,14
0.524,0.0001,550,554,25,2,0.001,1104,14
0.528,0.0001,590,614,25,2,0.001,1204,14
0.52,0.0001,643,661,25,2,0.001,1304,14
0.53,0.0001,694,710,25,2,0.001,1404,14
0.528,0.0001,749,755,25,2,0.001,1504,14
0.55,0.0001,803,801,25,2,0.001,1604,14
0.542,0.0001,844,860,25,2,0.001,1704,14
0.546,0.0001,893,911,25,2,0.001,1804,14
0.56,0.0001,950,954,25,2,0.001,1904,14
0.566,0.0001,1002,1002,25,2,0.001,2004,14
0.492,0.0001,50,54,25,2,0.001,104,15
0.496,0.0001,94,110,25,2,0.001,204,15
0.5,0.0001,147,157,25,2,0.001,304,15
0.5,0.0001,189,215,25,2,0.001,404,15
0.502,0.0001,234,270,25,2,0.001,504,15
0.5,0.0001,286,318,25,2,0.001,604,15
0.494,0.0001,326,378,25,2,0.001,704,15
0.49,0.0001,376,428,25,2,0.001,804,15
0.484,0.0001,431,473,25,2,0.001,904,15
0.486,0.0001,478,526,25,2,0.001,1004,15
0.48,0.0001,526,578,25,2,0.001,1104,15
0.484,0.0001,576,628,25,2,0.001,1204,15
0.484,0.0001,633,671,25,2,0.001,1304,15
0.49,0.0001,690,714,25,2,0.001,1404,15
0.49,0.0001,749,755,25,2,0.001,1504,15
0.49,0.0001,797,807,25,2,0.001,1604,15
0.488,0.0001,845,859,25,2,0.001,1704,15
0.492,0.0001,892,912,25,2,0.001,1804,15
0.494,0.0001,947,957,25,2,0.001,1904,15
0.498,0.0001,996,1008,25,2,0.001,2004,15
0.548,0.0001,51,53,25,2,0.001,104,16
0.55,0.0001,104,100,25,2,0.001,204,16
0.55,0.0001,147,157,25,2,0.001,304,16
0.548,0.0001,209,195,25,2,0.001,404,16
0.548,0.0001,254,250,25,2,0.001,504,16
0.546,0.0001,301,303,25,2,0.001,604,16
0.55,0.0001,352,352,25,2,0.001,704,16
0.54,0.0001,407,397,25,2,0.001,804,16
0.54,0.0001,455,449,25,2,0.001,904,16
0.538,0.0001,512,492,25,2,0.001,1004,16
0.534,0.0001,560,544,25,2,0.001,1104,16
0.538,0.0001,605,599,25,2,0.001,1204,16
0.542,0.0001,648,656,25,2,0.001,1304,16
0.54,0.0001,696,708,25,2,0.001,1404,16
0.54,0.0001,738,766,25,2,0.001,1504,16
0.54,0.0001,790,814,25,2,0.001,1604,16
0.544,0.0001,833,871,25,2,0.001,1704,16
0.548,0.0001,882,922,25,2,0.001,1804,16
0.552,0.0001,934,970,25,2,0.001,1904,16
0.556,0.0001,983,1021,25,2,0.001,2004,16
0.49,0.0001,52,52,25,2,0.001,104,17
0.488,0.0001,100,104,25,2,0.001,204,17
0.492,0.0001,147,157,25,2,0.001,304,17
0.498,0.0001,204,200,25,2,0.001,404,17
0.502,0.0001,258,246,25,2,0.001,504,17
0.506,0.0001,310,294,25,2,0.001,604,17
0.508,0.0001,361,343,25,2,0.001,704,17
0.512,0.0001,415,389,25,2,0.001,804,17
0.508,0.0001,475,429,25,2,0.001,904,17
0.516,0.0001,531,473,25,2,0.001,1004,17
0.516,0.0001,579,525,25,2,0.001,1104,17
0.518,0.0001,630,574,25,2,0.001,1204,17
0.52,0.0001,680,624,25,2,0.001,1304,17
0.522,0.0001,717,687,25,2,0.001,1404,17
0.526,0.0001,763,741,25,2,0.001,1504,17
0.522,0.0001,816,788,25,2,0.001,1604,17
0.516,0.0001,874,830,25,2,0.001,1704,17
0.522,0.0001,919,885,25,2,0.001,1804,17
0.522,0.0001,970,934,25,2,0.001,1904,17
0.524,0.0001,1016,988,25,2,0.001,2004,17
0.488,0.0001,56,48,25,2,0.001,104,18
0.488,0.0001,100,104,25,2,0.001,204,18
0.49,0.0001,146,158,25,2,0.001,304,18
0.49,0.0001,194,210,25,2,0.001,404,18
0.494,0.0001,248,256,25,2,0.001,504,18
0.498,0.0001,300,304,25,2,0.001,604,18
0.496,0.0001,345,359,25,2,0.001,704,18
0.502,0.0001,397,407,25,2,0.001,804,18
0.502,0.0001,442,462,25,2,0.001,904,18
0.502,0.0001,490,514,25,2,0.001,1004,18
0.504,0.0001,544,560,25,2,0.001,1104,18
0.51,0.0001,594,610,25,2,0.001,1204,18
0.512,0.0001,645,659,25,2,0.001,1304,18
0.512,0.0001,694,710,25,2,0.001,1404,18
0.52,0.0001,743,761,25,2,0.001,1504,18
0.52,0.0001,802,802,25,2,0.001,1604,18
0.522,0.0001,851,853,25,2,0.001,1704,18
0.524,0.0001,904,900,25,2,0.001,1804,18
0.532,0.0001,953,951,25,2,0.001,1904,18
0.534,0.0001,1001,1003,25,2,0.001,2004,18
0.514,0.0001,51,53,25,2,0.001,104,19
0.514,0.0001,102,102,25,2,0.001,204,19
0.514,0.0001,150,154,25,2,0.001,304,19
0.514,0.0001,198,206,25,2,0.001,404,19
0.514,0.0001,248,256,25,2,0.001,504,19
0.514,0.0001,292,312,25,2,0.001,604,19
0.514,0.0001,350,354,25,2,0.001,704,19
0.514,0.0001,401,403,25,2,0.001,804,19
0.514,0.0001,448,456,25,2,0.001,904,19
0.514,0.0001,495,509,25,2,0.001,1004,19
0.514,0.0001,555,549,25,2,0.001,1104,19
0.514,0.0001,609,595,25,2,0.001,1204,19
0.514,0.0001,660,644,25,2,0.001,1304,19
0.514,0.0001,718,686,25,2,0.001,1404,19
0.514,0.0001,770,734,25,2,0.001,1504,19
0.514,0.0001,818,786,25,2,0.001,1604,19
0.514,0.0001,867,837,25,2,0.001,1704,19
0.514,0.0001,917,887,25,2,0.001,1804,19
0.514,0.0001,970,934,25,2,0.001,1904,19
0.514,0.0001,1009,995,25,2,0.001,2004,19
0.488,0.0001,53,51,25,2,0.001,104,20
0.486,0.0001,101,103,25,2,0.001,204,20
0.486,0.0001,153,151,25,2,0.001,304,20
0.49,0.0001,202,202,25,2,0.001,404,20
0.49,0.0001,254,250,25,2,0.001,504,20
0.494,0.0001,307,297,25,2,0.001,604,20
0.496,0.0001,360,344,25,2,0.001,704,20
0.498,0.0001,402,402,25,2,0.001,804,20
0.498,0.0001,453,451,25,2,0.001,904,20
0.498,0.0001,501,503,25,2,0.001,1004,20
0.502,0.0001,544,560,25,2,0.001,1104,20
0.5,0.0001,597,607,25,2,0.001,1204,20
0.498,0.0001,647,657,25,2,0.001,1304,20
0.496,0.0001,697,707,25,2,0.001,1404,20
0.504,0.0001,746,758,25,2,0.001,1504,20
0.508,0.0001,796,808,25,2,0.001,1604,20
0.508,0.0001,836,868,25,2,0.001,1704,20
0.506,0.0001,895,909,25,2,0.001,1804,20
0.502,0.0001,943,961,25,2,0.001,1904,20
0.504,0.0001,996,1008,25,2,0.001,2004,20
0.514,0.0001,51,53,25,2,0.01,104,1
0.514,0.0001,102,102,25,2,0.01,204,1
0.514,0.0001,144,160,25,2,0.01,304,1
0.514,0.0001,192,212,25,2,0.01,404,1
0.514,0.0001,245,259,25,2,0.01,504,1
0.514,0.0001,296,308,25,2,0.01,604,1
0.514,0.0001,352,352,25,2,0.01,704,1
0.514,0.0001,403,401,25,2,0.01,804,1
0.514,0.0001,459,445,25,2,0.01,904,1
0.514,0.0001,505,499,25,2,0.01,1004,1
0.514,0.0001,557,547,25,2,0.01,1104,1
0.514,0.0001,599,605,25,2,0.01,1204,1
0.514,0.0001,654,650,25,2,0.01,1304,1
0.514,0.0001,698,706,25,2,0.01,1404,1
0.514,0.0001,745,759,25,2,0.01,1504,1
0.514,0.0001,793,811,25,2,0.01,1604,1
0.514,0.0001,839,865,25,2,0.01,1704,1
0.514,0.0001,886,918,25,2,0.01,1804,1
0.514,0.0001,944,960,25,2,0.01,1904,1
0.514,0.0001,995,1009,25,2,0.01,2004,1
0.51,0.0001,44,60,25,2,0.01,104,2
0.5,0.0001,96,108,25,2,0.01,204,2
0.496,0.0001,154,150,25,2,0.01,304,2
0.512,0.0001,197,207,25,2,0.01,404,2
0.516,0.0001,246,258,25,2,0.01,504,2
0.522,0.0001,300,304,25,2,0.01,604,2
0.526,0.0001,354,350,25,2,0.01,704,2
0.522,0.0001,408,396,25,2,0.01,804,2
0.516,0.0001,461,443,25,2,0.01,904,2
0.504,0.0001,506,498,25,2,0.01,1004,2
0.55,0.0001,552,552,25,2,0.01,1104,2
0.564,0.0001,603,601,25,2,0.01,1204,2
0.572,0.0001,659,645,25,2,0.01,1304,2
0.584,0.0001,711,693,25,2,0.01,1404,2
0.6,0.0001,761,743,25,2,0.01,1504,2
0.616,0.0001,807,797,25,2,0.01,1604,2
0.684,0.0001,857,847,25,2,0.01,1704,2
0.7,0.0001,899,905,25,2,0.01,1804,2
0.736,0.0001,947,957,25,2,0.01,1904,2
0.742,0.0001,1006,998,25,2,0.01,2004,2
0.546,0.0001,51,53,25,2,0.01,104,3
0.546,0.0001,92,112,25,2,0.01,204,3
0.546,0.0001,135,169,25,2,0.01,304,3
0.546,0.0001,175,229,25,2,0.01,404,3
0.546,0.0001,229,275,25,2,0.01,504,3
0.546,0.0001,276,328,25,2,0.01,604,3
0.546,0.0001,325,379,25,2,0.01,704,3
0.546,0.0001,379,425,25,2,0.01,804,3
0.546,0.0001,430,474,25,2,0.01,904,3
0.546,0.0001,477,527,25,2,0.01,1004,3
0.546,0.0001,523,581,25,2,0.01,1104,3
0.546,0.0001,565,639,25,2,0.01,1204,3
0.546,0.0001,616,688,25,2,0.01,1304,3
0.592,0.0001,667,737,25,2,0.01,1404,3
0.602,0.0001,717,787,25,2,0.01,1504,3
0.594,0.0001,769,835,25,2,0.01,1604,3
0.596,0.0001,823,881,25,2,0.01,1704,3
0.604,0.0001,870,934,25,2,0.01,1804,3
0.608,0.0001,927,977,25,2,0.01,1904,3
0.62,0.0001,979,1025,25,2,0.01,2004,3
0.462,0.0001,60,44,25,2,0.01,104,4
0.466,0.0001,114,90,25,2,0.01,204,4
0.466,0.0001,170,134,25,2,0.01,304,4
0.482,0.0001,217,187,25,2,0.01,404,4
0.484,0.0001,271,233,25,2,0.01,504,4
0.482,0.0001,318,286,25,2,0.01,604,4
0.478,0.0001,368,336,25,2,0.01,704,4
0.504,0.0001,418,386,25,2,0.01,804,4
0.514,0.0001,474,430,25,2,0.01,904,4
0.52,0.0001,522,482,25,2,0.01,1004,4
0.534,0.0001,565,539,25,2,0.01,1104,4
0.542,0.0001,616,588,25,2,0.01,1204,4
0.542,0.0001,665,639,25,2,0.01,1304,4
0.558,0.0001,715,689,25,2,0.01,1404,4
0.58,0.0001,767,737,25,2,0.01,1504,4
0.592,0.0001,809,795,25,2,0.01,1604,4
0.602,0.0001,859,845,25,2,0.01,1704,4
0.682,0.0001,906,898,25,2,0.01,1804,4
0.682,0.0001,952,952,25,2,0.01,1904,4
0.702,0.0001,999,1005,25,2,0.01,2004,4
0.512,0.0001,52,52,25,2,0.01,104,5
0.512,0.0001,101,103,25,2,0.01,204,5
0.506,0.0001,150,154,25,2,0.01,304,5
0.508,0.0001,195,209,25,2,0.01,404,5
0.522,0.0001,244,260,25,2,0.01,504,5
0.542,0.0001,295,309,25,2,0.01,604,5
0.544,0.0001,349,355,25,2,0.01,704,5
0.564,0.0001,398,406,25,2,0.01,804,5
0.586,0.0001,449,455,25,2,0.01,904,5
0.586,0.0001,495,509,25,2,0.01,1004,5
0.61,0.0001,545,559,25,2,0.01,1104,5
0.614,0.0001,590,614,25,2,0.01,1204,5
0.634,0.0001,655,649,25,2,0.01,1304,5
0.68,0.0001,703,701,25,2,0.01,1404,5
0.718,0.0001,754,750,25,2,0.01,1504,5
0.748,0.0001,808,796,25,2,0.01,1604,5
0.78,0.0001,851,853,25,2,0.01,1704,5
0.822,0.0001,898,906,25,2,0.01,1804,5
0.832,0.0001,947,957,25,2,0.01,1904,5
0.844,0.0001,1008,996,25,2,0.01,2004,5
0.472,0.0001,47,57,25,2,0.01,104,6
0.474,0.0001,92,112,25,2,0.01,204,6
0.458,0.0001,148,156,25,2,0.01,304,6
0.47,0.0001,190,214,25,2,0.01,404,6
0.466,0.0001,240,264,25,2,0.01,504,6
0.472,0.0001,296,308,25,2,0.01,604,6
0.484,0.0001,345,359,25,2,0.01,704,6
0.496,0.0001,388,416,25,2,0.01,804,6
0.51,0.0001,441,463,25,2,0.01,904,6
0.528,0.0001,485,519,25,2,0.01,1004,6
0.554,0.0001,538,566,25,2,0.01,1104,6
0.56,0.0001,592,612,25,2,0.01,1204,6
0.576,0.0001,637,667,25,2,0.01,1304,6
0.594,0.0001,701,703,25,2,0.01,1404,6
0.63,0.0001,752,752,25,2,0.01,1504,6
0.656,0.0001,811,793,25,2,0.01,1604,6
0.672,0.0001,856,848,25,2,0.01,1704,6
0.684,0.0001,905,899,25,2,0.01,1804,6
0.688,0.0001,953,951,25,2,0.01,1904,6
0.696,0.0001,994,1010,25,2,0.01,2004,6
0.49,0.0001,52,52,25,2,0.01,104,7
0.492,0.0001,110,94,25,2,0.01,204,7
0.496,0.0001,167,137,25,2,0.01,304,7
0.504,0.0001,219,185,25,2,0.01,404,7
0.512,0.0001,270,234,25,2,0.01,504,7
0.51,0.0001,313,291,25,2,0.01,604,7
0.512,0.0001,368,336,25,2,0.01,704,7
0.522,0.0001,417,387,25,2,0.01,804,7
0.524,0.0001,466,438,25,2,0.01,904,7
0.524,0.0001,514,490,25,2,0.01,1004,7
0.53,0.0001,568,536,25,2,0.01,1104,7
0.526,0.0001,616,588,25,2,0.01,1204,7
0.538,0.0001,659,645,25,2,0.01,1304,7
0.536,0.0001,712,692,25,2,0.01,1404,7
0.534,0.0001,763,741,25,2,0.01,1504,7
0.542,0.0001,813,791,25,2,0.01,1604,7
0.548,0.0001,850,854,25,2,0.01,1704,7
0.568,0.0001,910,894,25,2,0.01,1804,7
0.578,0.0001,955,949,25,2,0.01,1904,7
0.578,0.0001,1006,998,25,2,0.01,2004,7
0.496,0.0001,50,54,25,2,0.01,104,8
0.504,0.0001,92,112,25,2,0.01,204,8
0.512,0.0001,146,158,25,2,0.01,304,8
0.518,0.0001,192,212,25,2,0.01,404,8
0.516,0.0001,242,262,25,2,0.01,504,8
0.526,0.0001,294,310,25,2,0.01,604,8
0.542,0.0001,348,356,25,2,0.01,704,8
0.558,0.0001,399,405,25,2,0.01,804,8
0.578,0.0001,454,450,25,2,0.01,904,8
0.592,0.0001,498,506,25,2,0.01,1004,8
0.606,0.0001,548,556,25,2,0.01,1104,8
0.608,0.0001,597,607,25,2,0.01,1204,8
0.614,0.0001,652,652,25,2,0.01,1304,8
0.626,0.0001,704,700,25,2,0.01,1404,8
0.64,0.0001,753,751,25,2,0.01,1504,8
0.64,0.0001,805,799,25,2,0.01,1604,8
0.632,0.0001,850,854,25,2,0.01,1704,8
0.636,0.0001,895,909,25,2,0.01,1804,8
0.64,0.0001,946,958,25,2,0.01,1904,8
0.634,0.0001,998,1006,25,2,0.01,2004,8
0.474,0.0001,50,54,25,2,0.01,104,9
0.474,0.0001,97,107,25,2,0.01,204,9
0.474,0.0001,149,155,25,2,0.01,304,9
0.474,0.0001,191,213,25,2,0.01,404,9
0.474,0.0001,236,268,25,2,0.01,504,9
0.474,0.0001,285,319,25,2,0.01,604,9
0.474,0.0001,346,358,25,2,0.01,704,9
0.474,0.0001,391,413,25,2,0.01,804,9
0.474,0.0001,434,470,25,2,0.01,904,9
0.474,0.0001,482,522,25,2,0.01,1004,9
0.474,0.0001,531,573,25,2,0.01,1104,9
0.474,0.0001,583,621,25,2,0.01,1204,9
0.474,0.0001,632,672,25,2,0.01,1304,9
0.474,0.0001,678,726,25,2,0.01,1404,9
0.474,0.0001,734,770,25,2,0.01,1504,9
0.474,0.0001,788,816,25,2,0.01,1604,9
0.474,0.0001,841,863,25,2,0.01,1704,9
0.474,0.0001,900,904,25,2,0.01,1804,9
0.474,0.0001,944,960,25,2,0.01,1904,9
0.584,0.0001,989,1015,25,2,0.01,2004,9
0.506,0.0001,56,48,25,2,0.01,104,10
0.506,0.0001,105,99,25,2,0.01,204,10
0.508,0.0001,156,148,25,2,0.01,304,10
0.508,0.0001,204,200,25,2,0.01,404,10
0.514,0.0001,254,250,25,2,0.01,504,10
0.516,0.0001,297,307,25,2,0.01,604,10
0.522,0.0001,349,355,25,2,0.01,704,10
0.528,0.0001,401,403,25,2,0.01,804,10
0.532,0.0001,452,452,25,2,0.01,904,10
0.55,0.0001,499,505,25,2,0.01,1004,10
0.548,0.0001,555,549,25,2,0.01,1104,10
0.55,0.0001,608,596,25,2,0.01,1204,10
0.54,0.0001,646,658,25,2,0.01,1304,10
0.55,0.0001,686,718,25,2,0.01,1404,10
0.55,0.0001,733,771,25,2,0.01,1504,10
0.558,0.0001,785,819,25,2,0.01,1604,10
0.58,0.0001,841,863,25,2,0.01,1704,10
0.6,0.0001,898,906,25,2,0.01,1804,10
0.612,0.0001,948,956,25,2,0.01,1904,10
0.624,0.0001,998,1006,25,2,0.01,2004,10
0.514,0.0001,55,49,25,2,0.01,104,11
0.514,0.0001,103,101,25,2,0.01,204,11
0.514,0.0001,153,151,25,2,0.01,304,11
0.514,0.0001,196,208,25,2,0.01,404,11
0.514,0.0001,252,252,25,2,0.01,504,11
0.514,0.0001,300,304,25,2,0.01,604,11
0.514,0.0001,345,359,25,2,0.01,704,11
0.514,0.0001,394,410,25,2,0.01,804,11
0.514,0.0001,442,462,25,2,0.01,904,11
0.514,0.0001,496,508,25,2,0.01,1004,11
0.514,0.0001,543,561,25,2,0.01,1104,11
0.514,0.0001,590,614,25,2,0.01,1204,11
0.514,0.0001,641,663,25,2,0.01,1304,11
0.514,0.0001,700,704,25,2,0.01,1404,11
0.514,0.0001,753,751,25,2,0.01,1504,11
0.516,0.0001,793,811,25,2,0.01,1604,11
0.588,0.0001,839,865,25,2,0.01,1704,11
0.664,0.0001,895,909,25,2,0.01,1804,11
0.686,0.0001,954,950,25,2,0.01,1904,11
0.692,0.0001,1009,995,25,2,0.01,2004,11
0.506,0.0001,57,47,25,2,0.01,104,12
0.516,0.0001,110,94,25,2,0.01,204,12
0.518,0.0001,159,145,25,2,0.01,304,12
0.518,0.0001,208,196,25,2,0.01,404,12
0.522,0.0001,258,246,25,2,0.01,504,12
0.538,0.0001,312,292,25,2,0.01,604,12
0.542,0.0001,354,350,25,2,0.01,704,12
0.55,0.0001,411,393,25,2,0.01,804,12
0.57,0.0001,457,447,25,2,0.01,904,12
0.562,0.0001,503,501,25,2,0.01,1004,12
0.56,0.0001,548,556,25,2,0.01,1104,12
0.566,0.0001,595,609,25,2,0.01,1204,12
0.572,0.0001,645,659,25,2,0.01,1304,12
0.58,0.0001,698,706,25,2,0.01,1404,12
0.584,0.0001,748,756,25,2,0.01,1504,12
0.594,0.0001,807,797,25,2,0.01,1604,12
0.6,0.0001,857,847,25,2,0.01,1704,12
0.604,0.0001,904,900,25,2,0.01,1804,12
0.614,0.0001,943,961,25,2,0.01,1904,12
0.622,0.0001,996,1008,25,2,0.01,2004,12
0.454,0.0001,51,53,25,2,0.01,104,13
0.458,0.0001,96,108,25,2,0.01,204,13
0.466,0.0001,141,163,25,2,0.01,304,13
0.472,0.0001,192,212,25,2,0.01,404,13
0.482,0.0001,239,265,25,2,0.01,504,13
0.482,0.0001,281,323,25,2,0.01,604,13
0.49,0.0001,334,370,25,2,0.01,704,13
0.506,0.0001,386,418,25,2,0.01,804,13
0.534,0.0001,446,458,25,2,0.01,904,13
0.554,0.0001,503,501,25,2,0.01,1004,13
0.56,0.0001,553,551,25,2,0.01,1104,13
0.57,0.0001,594,610,25,2,0.01,1204,13
0.578,0.0001,649,655,25,2,0.01,1304,13
0.582,0.0001,704,700,25,2,0.01,1404,13
0.58,0.0001,754,750,25,2,0.01,1504,13
0.558,0.0001,808,796,25,2,0.01,1604,13
0.562,0.0001,853,851,25,2,0.01,1704,13
0.568,0.0001,899,905,25,2,0.01,1804,13
0.574,0.0001,941,963,25,2,0.01,1904,13
0.582,0.0001,988,1016,25,2,0.01,2004,13
0.51,0.0001,42,62,25,2,0.01,104,14
0.516,0.0001,90,114,25,2,0.01,204,14
0.524,0.0001,140,164,25,2,0.01,304,14
0.54,0.0001,195,209,25,2,0.01,404,14
0.528,0.0001,248,256,25,2,0.01,504,14
0.544,0.0001,299,305,25,2,0.01,604,14
0.544,0.0001,350,354,25,2,0.01,704,14
0.538,0.0001,396,408,25,2,0.01,804,14
0.552,0.0001,439,465,25,2,0.01,904,14
0.568,0.0001,485,519,25,2,0.01,1004,14
0.572,0.0001,539,565,25,2,0.01,1104,14
0.568,0.0001,588,616,25,2,0.01,1204,14
0.578,0.0001,647,657,25,2,0.01,1304,14
0.584,0.0001,695,709,25,2,0.01,1404,14
0.608,0.0001,745,759,25,2,0.01,1504,14
0.61,0.0001,799,805,25,2,0.01,1604,14
0.626,0.0001,847,857,25,2,0.01,1704,14
0.626,0.0001,905,899,25,2,0.01,1804,14
0.628,0.0001,967,937,25,2,0.01,1904,14
0.634,0.0001,1010,994,25,2,0.01,2004,14
0.548,0.0001,53,51,25,2,0.01,104,15
0.548,0.0001,103,101,25,2,0.01,204,15
0.548,0.0001,162,142,25,2,0.01,304,15
0.548,0.0001,206,198,25,2,0.01,404,15
0.538,0.0001,253,251,25,2,0.01,504,15
0.534,0.0001,302,302,25,2,0.01,604,15
0.53,0.0001,358,346,25,2,0.01,704,15
0.536,0.0001,409,395,25,2,0.01,804,15
0.528,0.0001,454,450,25,2,0.01,904,15
0.546,0.0001,503,501,25,2,0.01,1004,15
0.548,0.0001,561,543,25,2,0.01,1104,15
0.534,0.0001,607,597,25,2,0.01,1204,15
0.546,0.0001,658,646,25,2,0.01,1304,15
0.552,0.0001,713,691,25,2,0.01,1404,15
0.526,0.0001,766,738,25,2,0.01,1504,15
0.526,0.0001,814,790,25,2,0.01,1604,15
0.522,0.0001,867,837,25,2,0.01,1704,15
0.558,0.0001,921,883,25,2,0.01,1804,15
0.54,0.0001,971,933,25,2,0.01,1904,15
0.544,0.0001,1026,978,25,2,0.01,2004,15
0.448,0.0001,53,51,25,2,0.01,104,16
0.462,0.0001,111,93,25,2,0.01,204,16
0.474,0.0001,162,142,25,2,0.01,304,16
0.488,0.0001,211,193,25,2,0.01,404,16
0.508,0.0001,268,236,25,2,0.01,504,16
0.522,0.0001,320,284,25,2,0.01,604,16
0.534,0.0001,367,337,25,2,0.01,704,16
0.554,0.0001,411,393,25,2,0.01,804,16
0.59,0.0001,462,442,25,2,0.01,904,16
0.628,0.0001,514,490,25,2,0.01,1004,16
0.636,0.0001,570,534,25,2,0.01,1104,16
0.672,0.0001,618,586,25,2,0.01,1204,16
0.69,0.0001,669,635,25,2,0.01,1304,16
0.732,0.0001,715,689,25,2,0.01,1404,16
0.744,0.0001,764,740,25,2,0.01,1504,16
0.762,0.0001,805,799,25,2,0.01,1604,16
0.774,0.0001,856,848,25,2,0.01,1704,16
0.784,0.0001,896,908,25,2,0.01,1804,16
0.792,0.0001,949,955,25,2,0.01,1904,16
0.804,0.0001,994,1010,25,2,0.01,2004,16
0.488,0.0001,54,50,25,2,0.01,104,17
0.492,0.0001,107,97,25,2,0.01,204,17
0.502,0.0001,148,156,25,2,0.01,304,17
0.524,0.0001,204,200,25,2,0.01,404,17
0.544,0.0001,253,251,25,2,0.01,504,17
0.564,0.0001,299,305,25,2,0.01,604,17
0.58,0.0001,346,358,25,2,0.01,704,17
0.6,0.0001,400,404,25,2,0.01,804,17
0.602,0.0001,452,452,25,2,0.01,904,17
0.612,0.0001,502,502,25,2,0.01,1004,17
0.62,0.0001,554,550,25,2,0.01,1104,17
0.624,0.0001,611,593,25,2,0.01,1204,17
0.636,0.0001,665,639,25,2,0.01,1304,17
0.648,0.0001,709,695,25,2,0.01,1404,17
0.648,0.0001,759,745,25,2,0.01,1504,17
0.664,0.0001,810,794,25,2,0.01,1604,17
0.666,0.0001,855,849,25,2,0.01,1704,17
0.674,0.0001,904,900,25,2,0.01,1804,17
0.678,0.0001,954,950,25,2,0.01,1904,17
0.68,0.0001,1008,996,25,2,0.01,2004,17
0.526,0.0001,48,56,25,2,0.01,104,18
0.526,0.0001,96,108,25,2,0.01,204,18
0.526,0.0001,150,154,25,2,0.01,304,18
0.526,0.0001,206,198,25,2,0.01,404,18
0.526,0.0001,253,251,25,2,0.01,504,18
0.526,0.0001,295,309,25,2,0.01,604,18
0.526,0.0001,343,361,25,2,0.01,704,18
0.526,0.0001,395,409,25,2,0.01,804,18
0.526,0.0001,446,458,25,2,0.01,904,18
0.526,0.0001,497,507,25,2,0.01,1004,18
0.526,0.0001,543,561,25,2,0.01,1104,18
0.526,0.0001,588,616,25,2,0.01,1204,18
0.526,0.0001,650,654,25,2,0.01,1304,18
0.526,0.0001,704,700,25,2,0.01,1404,18
0.526,0.0001,753,751,25,2,0.01,1504,18
0.526,0.0001,799,805,25,2,0.01,1604,18
0.526,0.0001,846,858,25,2,0.01,1704,18
0.526,0.0001,892,912,25,2,0.01,1804,18
0.87,0.0001,936,968,25,2,0.01,1904,18
0.896,0.0001,989,1015,25,2,0.01,2004,18
0.512,0.0001,63,41,25,2,0.01,104,19
0.512,0.0001,116,88,25,2,0.01,204,19
0.512,0.0001,167,137,25,2,0.01,304,19
0.512,0.0001,223,181,25,2,0.01,404,19
0.516,0.0001,267,237,25,2,0.01,504,19
0.518,0.0001,312,292,25,2,0.01,604,19
0.528,0.0001,367,337,25,2,0.01,704,19
0.57,0.0001,422,382,25,2,0.01,804,19
0.568,0.0001,475,429,25,2,0.01,904,19
0.576,0.0001,512,492,25,2,0.01,1004,19
0.58,0.0001,563,541,25,2,0.01,1104,19
0.588,0.0001,612,592,25,2,0.01,1204,19
0.59,0.0001,655,649,25,2,0.01,1304,19
0.6,0.0001,694,710,25,2,0.01,1404,19
0.602,0.0001,749,755,25,2,0.01,1504,19
0.604,0.0001,802,802,25,2,0.01,1604,19
0.62,0.0001,848,856,25,2,0.01,1704,19
0.63,0.0001,892,912,25,2,0.01,1804,19
0.628,0.0001,941,963,25,2,0.01,1904,19
0.634,0.0001,996,1008,25,2,0.01,2004,19
0.498,0.0001,53,51,25,2,0.01,104,20
0.498,0.0001,103,101,25,2,0.01,204,20
0.498,0.0001,145,159,25,2,0.01,304,20
0.498,0.0001,197,207,25,2,0.01,404,20
0.498,0.0001,243,261,25,2,0.01,504,20
0.498,0.0001,295,309,25,2,0.01,604,20
0.498,0.0001,326,378,25,2,0.01,704,20
0.498,0.0001,376,428,25,2,0.01,804,20
0.498,0.0001,429,475,25,2,0.01,904,20
0.648,0.0001,481,523,25,2,0.01,1004,20
0.696,0.0001,527,577,25,2,0.01,1104,20
0.746,0.0001,580,624,25,2,0.01,1204,20
0.788,0.0001,636,668,25,2,0.01,1304,20
0.842,0.0001,689,715,25,2,0.01,1404,20
0.882,0.0001,746,758,25,2,0.01,1504,20
0.92,0.0001,797,807,25,2,0.01,1604,20
0.918,0.0001,841,863,25,2,0.01,1704,20
0.918,0.0001,900,904,25,2,0.01,1804,20
0.916,0.0001,952,952,25,2,0.01,1904,20
0.914,0.0001,1003,1001,25,2,0.01,2004,20
0.52,0.001,62,42,25,2,0.0001,104,1
0.52,0.001,113,91,25,2,0.0001,204,1
0.52,0.001,159,145,25,2,0.0001,304,1
0.522,0.001,209,195,25,2,0.0001,404,1
0.522,0.001,264,240,25,2,0.0001,504,1
0.522,0.001,314,290,25,2,0.0001,604,1
0.522,0.001,363,341,25,2,0.0001,704,1
0.522,0.001,421,383,25,2,0.0001,804,1
0.522,0.001,473,431,25,2,0.0001,904,1
0.522,0.001,525,479,25,2,0.0001,1004,1
0.524,0.001,567,537,25,2,0.0001,1104,1
0.524,0.001,627,577,25,2,0.0001,1204,1
0.524,0.001,676,628,25,2,0.0001,1304,1
0.526,0.001,721,683,25,2,0.0001,1404,1
0.526,0.001,773,731,25,2,0.0001,1504,1
0.528,0.001,825,779,25,2,0.0001,1604,1
0.528,0.001,872,832,25,2,0.0001,1704,1
0.528,0.001,917,887,25,2,0.0001,1804,1
0.528,0.001,966,938,25,2,0.0001,1904,1
0.528,0.001,1014,990,25,2,0.0001,2004,1
0.5,0.001,52,52,25,2,0.0001,104,2
0.5,0.001,105,99,25,2,0.0001,204,2
0.5,0.001,150,154,25,2,0.0001,304,2
0.5,0.001,204,200,25,2,0.0001,404,2
0.5,0.001,265,239,25,2,0.0001,504,2
0.5,0.001,319,285,25,2,0.0001,604,2
0.5,0.001,371,333,25,2,0.0001,704,2
0.5,0.001,422,382,25,2,0.0001,804,2
0.5,0.001,465,439,25,2,0.0001,904,2
0.5,0.001,515,489,25,2,0.0001,1004,2
0.5,0.001,559,545,25,2,0.0001,1104,2
0.5,0.001,602,602,25,2,0.0001,1204,2
0.5,0.001,652,652,25,2,0.0001,1304,2
0.5,0.001,703,701,25,2,0.0001,1404,2
0.5,0.001,746,758,25,2,0.0001,1504,2
0.5,0.001,804,800,25,2,0.0001,1604,2
0.5,0.001,854,850,25,2,0.0001,1704,2
0.5,0.001,902,902,25,2,0.0001,1804,2
0.5,0.001,949,955,25,2,0.0001,1904,2
0.5,0.001,1002,1002,25,2,0.0001,2004,2
0.494,0.001,56,48,25,2,0.0001,104,3
0.494,0.001,93,111,25,2,0.0001,204,3
0.494,0.001,143,161,25,2,0.0001,304,3
0.494,0.001,188,216,25,2,0.0001,404,3
0.494,0.001,247,257,25,2,0.0001,504,3
0.494,0.001,294,310,25,2,0.0001,604,3
0.494,0.001,349,355,25,2,0.0001,704,3
0.494,0.001,397,407,25,2,0.0001,804,3
0.494,0.001,453,451,25,2,0.0001,904,3
0.494,0.001,505,499,25,2,0.0001,1004,3
0.496,0.001,559,545,25,2,0.0001,1104,3
0.496,0.001,610,594,25,2,0.0001,1204,3
0.496,0.001,668,636,25,2,0.0001,1304,3
0.496,0.001,719,685,25,2,0.0001,1404,3
0.496,0.001,758,746,25,2,0.0001,1504,3
0.496,0.001,804,800,25,2,0.0001,1604,3
0.496,0.001,853,851,25,2,0.0001,1704,3
0.496,0.001,901,903,25,2,0.0001,1804,3
0.496,0.001,946,958,25,2,0.0001,1904,3
0.496,0.001,999,1005,25,2,0.0001,2004,3
0.5,0.001,54,50,25,2,0.0001,104,4
0.5,0.001,110,94,25,2,0.0001,204,4
0.5,0.001,151,153,25,2,0.0001,304,4
0.5,0.001,202,202,25,2,0.0001,404,4
0.5,0.001,247,257,25,2,0.0001,504,4
0.502,0.001,291,313,25,2,0.0001,604,4
0.502,0.001,345,359,25,2,0.0001,704,4
0.502,0.001,390,414,25,2,0.0001,804,4
0.502,0.001,438,466,25,2,0.0001,904,4
0.502,0.001,484,520,25,2,0.0001,1004,4
0.502,0.001,530,574,25,2,0.0001,1104,4
0.502,0.001,577,627,25,2,0.0001,1204,4
0.502,0.001,625,679,25,2,0.0001,1304,4
0.502,0.001,678,726,25,2,0.0001,1404,4
0.502,0.001,734,770,25,2,0.0001,1504,4
0.502,0.001,795,809,25,2,0.0001,1604,4
0.5,0.001,847,857,25,2,0.0001,1704,4
0.5,0.001,898,906,25,2,0.0001,1804,4
0.502,0.001,937,967,25,2,0.0001,1904,4
0.5,0.001,995,1009,25,2,0.0001,2004,4
0.478,0.001,60,44,25,2,0.0001,104,5
0.478,0.001,104,100,25,2,0.0001,204,5
0.478,0.001,150,154,25,2,0.0001,304,5
0.478,0.001,201,203,25,2,0.0001,404,5
0.478,0.001,255,249,25,2,0.0001,504,5
0.48,0.001,314,290,25,2,0.0001,604,5
0.48,0.001,366,338,25,2,0.0001,704,5
0.48,0.001,417,387,25,2,0.0001,804,5
0.48,0.001,471,433,25,2,0.0001,904,5
0.48,0.001,520,484,25,2,0.0001,1004,5
0.48,0.001,566,538,25,2,0.0001,1104,5
0.478,0.001,620,584,25,2,0.0001,1204,5
0.478,0.001,671,633,25,2,0.0001,1304,5
0.474,0.001,726,678,25,2,0.0001,1404,5
0.474,0.001,770,734,25,2,0.0001,1504,5
0.474,0.001,812,792,25,2,0.0001,1604,5
0.476,0.001,866,838,25,2,0.0001,1704,5
0.476,0.001,921,883,25,2,0.0001,1804,5
0.476,0.001,970,934,25,2,0.0001,1904,5
0.478,0.001,1020,984,25,2,0.0001,2004,5
0.49,0.001,57,47,25,2,0.0001,104,6
0.49,0.001,109,95,25,2,0.0001,204,6
0.49,0.001,156,148,25,2,0.0001,304,6
0.49,0.001,205,199,25,2,0.0001,404,6
0.49,0.001,254,250,25,2,0.0001,504,6
0.49,0.001,295,309,25,2,0.0001,604,6
0.49,0.001,343,361,25,2,0.0001,704,6
0.49,0.001,397,407,25,2,0.0001,804,6
0.49,0.001,455,449,25,2,0.0001,904,6
0.49,0.001,510,494,25,2,0.0001,1004,6
0.49,0.001,550,554,25,2,0.0001,1104,6
0.492,0.001,599,605,25,2,0.0001,1204,6
0.494,0.001,655,649,25,2,0.0001,1304,6
0.494,0.001,705,699,25,2,0.0001,1404,6
0.496,0.001,749,755,25,2,0.0001,1504,6
0.496,0.001,789,815,25,2,0.0001,1604,6
0.496,0.001,839,865,25,2,0.0001,1704,6
0.496,0.001,889,915,25,2,0.0001,1804,6
0.496,0.001,928,976,25,2,0.0001,1904,6
0.496,0.001,983,1021,25,2,0.0001,2004,6
0.476,0.001,48,56,25,2,0.0001,104,7
0.474,0.001,93,111,25,2,0.0001,204,7
0.474,0.001,135,169,25,2,0.0001,304,7
0.474,0.001,193,211,25,2,0.0001,404,7
0.476,0.001,240,264,25,2,0.0001,504,7
0.476,0.001,297,307,25,2,0.0001,604,7
0.476,0.001,348,356,25,2,0.0001,704,7
0.476,0.001,402,402,25,2,0.0001,804,7
0.476,0.001,448,456,25,2,0.0001,904,7
0.476,0.001,501,503,25,2,0.0001,1004,7
0.476,0.001,542,562,25,2,0.0001,1104,7
0.476,0.001,582,622,25,2,0.0001,1204,7
0.476,0.001,644,660,25,2,0.0001,1304,7
0.476,0.001,695,709,25,2,0.0001,1404,7
0.476,0.001,746,758,25,2,0.0001,1504,7
0.476,0.001,798,806,25,2,0.0001,1604,7
0.478,0.001,847,857,25,2,0.0001,1704,7
0.478,0.001,898,906,25,2,0.0001,1804,7
0.478,0.001,948,956,25,2,0.0001,1904,7
0.478,0.001,1006,998,25,2,0.0001,2004,7
0.508,0.001,54,50,25,2,0.0001,104,8
0.506,0.001,113,91,25,2,0.0001,204,8
0.506,0.001,162,142,25,2,0.0001,304,8
0.506,0.001,215,189,25,2,0.0001,404,8
0.506,0.001,259,245,25,2,0.0001,504,8
0.506,0.001,295,309,25,2,0.0001,604,8
0.504,0.001,340,364,25,2,0.0001,704,8
0.504,0.001,388,416,25,2,0.0001,804,8
0.504,0.001,435,469,25,2,0.0001,904,8
0.502,0.001,483,521,25,2,0.0001,1004,8
0.504,0.001,536,568,25,2,0.0001,1104,8
0.504,0.001,586,618,25,2,0.0001,1204,8
0.504,0.001,646,658,25,2,0.0001,1304,8
0.508,0.001,697,707,25,2,0.0001,1404,8
0.508,0.001,744,760,25,2,0.0001,1504,8
0.508,0.001,795,809,25,2,0.0001,1604,8
0.506,0.001,848,856,25,2,0.0001,1704,8
0.506,0.001,905,899,25,2,0.0001,1804,8
0.504,0.001,956,948,25,2,0.0001,1904,8
0.502,0.001,1001,1003,25,2,0.0001,2004,8
0.47,0.001,53,51,25,2,0.0001,104,9
0.47,0.001,105,99,25,2,0.0001,204,9
0.47,0.001,148,156,25,2,0.0001,304,9
0.47,0.001,200,204,25,2,0.0001,404,9
0.47,0.001,245,259,25,2,0.0001,504,9
0.47,0.001,301,303,25,2,0.0001,604,9
0.47,0.001,352,352,25,2,0.0001,704,9
0.47,0.001,405,399,25,2,0.0001,804,9
0.47,0.001,456,448,25,2,0.0001,904,9
0.47,0.001,503,501,25,2,0.0001,1004,9
0.47,0.001,550,554,25,2,0.0001,1104,9
0.47,0.001,595,609,25,2,0.0001,1204,9
0.47,0.001,640,664,25,2,0.0001,1304,9
0.47,0.001,697,707,25,2,0.0001,1404,9
0.47,0.001,746,758,25,2,0.0001,1504,9
0.47,0.001,793,811,25,2,0.0001,1604,9
0.47,0.001,850,854,25,2,0.0001,1704,9
0.47,0.001,895,909,25,2,0.0001,1804,9
0.47,0.001,938,966,25,2,0.0001,1904,9
0.47,0.001,987,1017,25,2,0.0001,2004,9
0.496,0.001,50,54,25,2,0.0001,104,10
0.496,0.001,94,110,25,2,0.0001,204,10
0.496,0.001,146,158,25,2,0.0001,304,10
0.496,0.001,194,210,25,2,0.0001,404,10
0.496,0.001,244,260,25,2,0.0001,504,10
0.496,0.001,296,308,25,2,0.0001,604,10
0.496,0.001,341,363,25,2,0.0001,704,10
0.496,0.001,389,415,25,2,0.0001,804,10
0.496,0.001,435,469,25,2,0.0001,904,10
0.496,0.001,477,527,25,2,0.0001,1004,10
0.496,0.001,531,573,25,2,0.0001,1104,10
0.496,0.001,589,615,25,2,0.0001,1204,10
0.496,0.001,643,661,25,2,0.0001,1304,10
0.496,0.001,694,710,25,2,0.0001,1404,10
0.496,0.001,741,763,25,2,0.0001,1504,10
0.496,0.001,790,814,25,2,0.0001,1604,10
0.496,0.001,844,860,25,2,0.0001,1704,10
0.496,0.001,896,908,25,2,0.0001,1804,10
0.496,0.001,951,953,25,2,0.0001,1904,10
0.496,0.001,1004,1000,25,2,0.0001,2004,10
0.496,0.001,57,47,25,2,0.0001,104,11
0.496,0.001,107,97,25,2,0.0001,204,11
0.496,0.001,152,152,25,2,0.0001,304,11
0.496,0.001,195,209,25,2,0.0001,404,11
0.496,0.001,235,269,25,2,0.0001,504,11
0.496,0.001,286,318,25,2,0.0001,604,11
0.496,0.001,335,369,25,2,0.0001,704,11
0.496,0.001,385,419,25,2,0.0001,804,11
0.496,0.001,442,462,25,2,0.0001,904,11
0.496,0.001,486,518,25,2,0.0001,1004,11
0.496,0.001,532,572,25,2,0.0001,1104,11
0.496,0.001,591,613,25,2,0.0001,1204,11
0.496,0.001,643,661,25,2,0.0001,1304,11
0.496,0.001,693,711,25,2,0.0001,1404,11
0.496,0.001,739,765,25,2,0.0001,1504,11
0.496,0.001,795,809,25,2,0.0001,1604,11
0.496,0.001,842,862,25,2,0.0001,1704,11
0.496,0.001,892,912,25,2,0.0001,1804,11
0.496,0.001,945,959,25,2,0.0001,1904,11
0.496,0.001,1000,1004,25,2,0.0001,2004,11
0.52,0.001,59,45,25,2,0.0001,104,12
0.52,0.001,104,100,25,2,0.0001,204,12
0.52,0.001,158,146,25,2,0.0001,304,12
0.52,0.001,210,194,25,2,0.0001,404,12
0.52,0.001,255,249,25,2,0.0001,504,12
0.52,0.001,304,300,25,2,0.0001,604,12
0.52,0.001,351,353,25,2,0.0001,704,12
0.52,0.001,403,401,25,2,0.0001,804,12
0.52,0.001,448,456,25,2,0.0001,904,12
0.52,0.001,501,503,25,2,0.0001,1004,12
0.52,0.001,552,552,25,2,0.0001,1104,12
0.52,0.001,606,598,25,2,0.0001,1204,12
0.52,0.001,650,654,25,2,0.0001,1304,12
0.52,0.001,701,703,25,2,0.0001,1404,12
0.52,0.001,753,751,25,2,0.0001,1504,12
0.52,0.001,812,792,25,2,0.0001,1604,12
0.52,0.001,857,847,25,2,0.0001,1704,12
0.52,0.001,912,892,25,2,0.0001,1804,12
0.52,0.001,964,940,25,2,0.0001,1904,12
0.52,0.001,1012,992,25,2,0.0001,2004,12
0.508,0.001,53,51,25,2,0.0001,104,13
0.508,0.001,91,113,25,2,0.0001,204,13
0.508,0.001,136,168,25,2,0.0001,304,13
0.508,0.001,183,221,25,2,0.0001,404,13
0.508,0.001,235,269,25,2,0.0001,504,13
0.508,0.001,282,322,25,2,0.0001,604,13
0.508,0.001,336,368,25,2,0.0001,704,13
0.508,0.001,380,424,25,2,0.0001,804,13
0.508,0.001,419,485,25,2,0.0001,904,13
0.508,0.001,478,526,25,2,0.0001,1004,13
0.508,0.001,526,578,25,2,0.0001,1104,13
0.508,0.001,584,620,25,2,0.0001,1204,13
0.508,0.001,637,667,25,2,0.0001,1304,13
0.508,0.001,686,718,25,2,0.0001,1404,13
0.508,0.001,746,758,25,2,0.0001,1504,13
0.508,0.001,799,805,25,2,0.0001,1604,13
0.508,0.001,841,863,25,2,0.0001,1704,13
0.508,0.001,896,908,25,2,0.0001,1804,13
0.508,0.001,948,956,25,2,0.0001,1904,13
0.508,0.001,998,1006,25,2,0.0001,2004,13
0.514,0.001,53,51,25,2,0.0001,104,14
0.514,0.001,107,97,25,2,0.0001,204,14
0.514,0.001,153,151,25,2,0.0001,304,14
0.514,0.001,207,197,25,2,0.0001,404,14
0.514,0.001,256,248,25,2,0.0001,504,14
0.514,0.001,300,304,25,2,0.0001,604,14
0.514,0.001,348,356,25,2,0.0001,704,14
0.514,0.001,398,406,25,2,0.0001,804,14
0.514,0.001,452,452,25,2,0.0001,904,14
0.514,0.001,502,502,25,2,0.0001,1004,14
0.514,0.001,549,555,25,2,0.0001,1104,14
0.514,0.001,603,601,25,2,0.0001,1204,14
0.512,0.001,661,643,25,2,0.0001,1304,14
0.512,0.001,709,695,25,2,0.0001,1404,14
0.512,0.001,761,743,25,2,0.0001,1504,14
0.512,0.001,812,792,25,2,0.0001,1604,14
0.512,0.001,855,849,25,2,0.0001,1704,14
0.51,0.001,898,906,25,2,0.0001,1804,14
0.51,0.001,944,960,25,2,0.0001,1904,14
0.51,0.001,993,1011,25,2,0.0001,2004,14
0.514,0.001,45,59,25,2,0.0001,104,15
0.514,0.001,96,108,25,2,0.0001,204,15
0.514,0.001,150,154,25,2,0.0001,304,15
0.514,0.001,206,198,25,2,0.0001,404,15
0.514,0.001,259,245,25,2,0.0001,504,15
0.514,0.001,313,291,25,2,0.0001,604,15
0.514,0.001,363,341,25,2,0.0001,704,15
0.514,0.001,412,392,25,2,0.0001,804,15
0.514,0.001,463,441,25,2,0.0001,904,15
0.514,0.001,518,486,25,2,0.0001,1004,15
0.514,0.001,560,544,25,2,0.0001,1104,15
0.514,0.001,597,607,25,2,0.0001,1204,15
0.514,0.001,646,658,25,2,0.0001,1304,15
0.514,0.001,695,709,25,2,0.0001,1404,15
0.514,0.001,748,756,25,2,0.0001,1504,15
0.514,0.001,795,809,25,2,0.0001,1604,15
0.514,0.001,843,861,25,2,0.0001,1704,15
0.514,0.001,892,912,25,2,0.0001,1804,15
0.514,0.001,936,968,25,2,0.0001,1904,15
0.514,0.001,995,1009,25,2,0.0001,2004,15
0.514,0.001,58,46,25,2,0.0001,104,16
0.514,0.001,117,87,25,2,0.0001,204,16
0.514,0.001,161,143,25,2,0.0001,304,16
0.514,0.001,203,201,25,2,0.0001,404,16
0.514,0.001,257,247,25,2,0.0001,504,16
0.514,0.001,302,302,25,2,0.0001,604,16
0.514,0.001,350,354,25,2,0.0001,704,16
0.516,0.001,402,402,25,2,0.0001,804,16
0.516,0.001,451,453,25,2,0.0001,904,16
0.516,0.001,505,499,25,2,0.0001,1004,16
0.516,0.001,549,555,25,2,0.0001,1104,16
0.516,0.001,602,602,25,2,0.0001,1204,16
0.516,0.001,660,644,25,2,0.0001,1304,16
0.516,0.001,710,694,25,2,0.0001,1404,16
0.514,0.001,760,744,25,2,0.0001,1504,16
0.514,0.001,806,798,25,2,0.0001,1604,16
0.514,0.001,858,846,25,2,0.0001,1704,16
0.518,0.001,915,889,25,2,0.0001,1804,16
0.52,0.001,959,945,25,2,0.0001,1904,16
0.52,0.001,1007,997,25,2,0.0001,2004,16
0.558,0.001,49,55,25,2,0.0001,104,17
0.558,0.001,102,102,25,2,0.0001,204,17
0.558,0.001,146,158,25,2,0.0001,304,17
0.558,0.001,193,211,25,2,0.0001,404,17
0.558,0.001,246,258,25,2,0.0001,504,17
0.558,0.001,304,300,25,2,0.0001,604,17
0.558,0.001,355,349,25,2,0.0001,704,17
0.558,0.001,402,402,25,2,0.0001,804,17
0.556,0.001,444,460,25,2,0.0001,904,17
0.558,0.001,491,513,25,2,0.0001,1004,17
0.558,0.001,538,566,25,2,0.0001,1104,17
0.558,0.001,583,621,25,2,0.0001,1204,17
0.558,0.001,633,671,25,2,0.0001,1304,17
0.558,0.001,684,720,25,2,0.0001,1404,17
0.558,0.001,738,766,25,2,0.0001,1504,17
0.56,0.001,788,816,25,2,0.0001,1604,17
0.56,0.001,848,856,25,2,0.0001,1704,17
0.56,0.001,901,903,25,2,0.0001,1804,17
0.56,0.001,951,953,25,2,0.0001,1904,17
0.56,0.001,988,1016,25,2,0.0001,2004,17
0.496,0.001,44,60,25,2,0.0001,104,18
0.496,0.001,99,105,25,2,0.0001,204,18
0.496,0.001,147,157,25,2,0.0001,304,18
0.496,0.001,196,208,25,2,0.0001,404,18
0.496,0.001,247,257,25,2,0.0001,504,18
0.496,0.001,294,310,25,2,0.0001,604,18
0.496,0.001,344,360,25,2,0.0001,704,18
0.496,0.001,392,412,25,2,0.0001,804,18
0.496,0.001,442,462,25,2,0.0001,904,18
0.496,0.001,495,509,25,2,0.0001,1004,18
0.496,0.001,544,560,25,2,0.0001,1104,18
0.496,0.001,598,606,25,2,0.0001,1204,18
0.496,0.001,644,660,25,2,0.0001,1304,18
0.496,0.001,698,706,25,2,0.0001,1404,18
0.496,0.001,741,763,25,2,0.0001,1504,18
0.496,0.001,794,810,25,2,0.0001,1604,18
0.496,0.001,840,864,25,2,0.0001,1704,18
0.496,0.001,894,910,25,2,0.0001,1804,18
0.496,0.001,951,953,25,2,0.0001,1904,18
0.496,0.001,1000,1004,25,2,0.0001,2004,18
0.506,0.001,56,48,25,2,0.0001,104,19
0.506,0.001,104,100,25,2,0.0001,204,19
0.506,0.001,145,159,25,2,0.0001,304,19
0.506,0.001,196,208,25,2,0.0001,404,19
0.506,0.001,251,253,25,2,0.0001,504,19
0.506,0.001,296,308,25,2,0.0001,604,19
0.506,0.001,349,355,25,2,0.0001,704,19
0.506,0.001,399,405,25,2,0.0001,804,19
0.506,0.001,445,459,25,2,0.0001,904,19
0.506,0.001,500,504,25,2,0.0001,1004,19
0.506,0.001,544,560,25,2,0.0001,1104,19
0.506,0.001,592,612,25,2,0.0001,1204,19
0.506,0.001,636,668,25,2,0.0001,1304,19
0.506,0.001,683,721,25,2,0.0001,1404,19
0.506,0.001,731,773,25,2,0.0001,1504,19
0.506,0.001,788,816,25,2,0.0001,1604,19
0.504,0.001,840,864,25,2,0.0001,1704,19
0.504,0.001,896,908,25,2,0.0001,1804,19
0.504,0.001,949,955,25,2,0.0001,1904,19
0.504,0.001,1006,998,25,2,0.0001,2004,19
0.528,0.001,57,47,25,2,0.0001,104,20
0.528,0.001,104,100,25,2,0.0001,204,20
0.526,0.001,157,147,25,2,0.0001,304,20
0.526,0.001,205,199,25,2,0.0001,404,20
0.528,0.001,249,255,25,2,0.0001,504,20
0.528,0.001,299,305,25,2,0.0001,604,20
0.528,0.001,345,359,25,2,0.0001,704,20
0.528,0.001,387,417,25,2,0.0001,804,20
0.528,0.001,441,463,25,2,0.0001,904,20
0.528,0.001,493,511,25,2,0.0001,1004,20
0.528,0.001,547,557,25,2,0.0001,1104,20
0.528,0.001,589,615,25,2,0.0001,1204,20
0.528,0.001,642,662,25,2,0.0001,1304,20
0.528,0.001,702,702,25,2,0.0001,1404,20
0.528,0.001,755,749,25,2,0.0001,1504,20
0.528,0.001,805,799,25,2,0.0001,1604,20
0.528,0.001,858,846,25,2,0.0001,1704,20
0.528,0.001,915,889,25,2,0.0001,1804,20
0.528,0.001,963,941,25,2,0.0001,1904,20
0.528,0.001,1016,988,25,2,0.0001,2004,20
0.472,0.001,55,49,25,2,0.001,104,1
0.472,0.001,112,92,25,2,0.001,204,1
0.472,0.001,158,146,25,2,0.001,304,1
0.472,0.001,203,201,25,2,0.001,404,1
0.472,0.001,258,246,25,2,0.001,504,1
0.472,0.001,304,300,25,2,0.001,604,1
0.472,0.001,363,341,25,2,0.001,704,1
0.472,0.001,413,391,25,2,0.001,804,1
0.472,0.001,463,441,25,2,0.001,904,1
0.472,0.001,510,494,25,2,0.001,1004,1
0.472,0.001,554,550,25,2,0.001,1104,1
0.472,0.001,605,599,25,2,0.001,1204,1
0.472,0.001,647,657,25,2,0.001,1304,1
0.472,0.001,690,714,25,2,0.001,1404,1
0.472,0.001,743,761,25,2,0.001,1504,1
0.472,0.001,795,809,25,2,0.001,1604,1
0.472,0.001,839,865,25,2,0.001,1704,1
0.472,0.001,889,915,25,2,0.001,1804,1
0.472,0.001,940,964,25,2,0.001,1904,1
0.472,0.001,988,1016,25,2,0.001,2004,1
0.494,0.001,52,52,25,2,0.001,104,2
0.494,0.001,100,104,25,2,0.001,204,2
0.494,0.001,149,155,25,2,0.001,304,2
0.494,0.001,199,205,25,2,0.001,404,2
0.492,0.001,245,259,25,2,0.001,504,2
0.496,0.001,288,316,25,2,0.001,604,2
0.496,0.001,338,366,25,2,0.001,704,2
0.496,0.001,390,414,25,2,0.001,804,2
0.496,0.001,434,470,25,2,0.001,904,2
0.498,0.001,485,519,25,2,0.001,1004,2
0.498,0.001,537,567,25,2,0.001,1104,2
0.498,0.001,590,614,25,2,0.001,1204,2
0.498,0.001,637,667,25,2,0.001,1304,2
0.5,0.001,692,712,25,2,0.001,1404,2
0.502,0.001,747,757,25,2,0.001,1504,2
0.504,0.001,796,808,25,2,0.001,1604,2
0.506,0.001,855,849,25,2,0.001,1704,2
0.508,0.001,914,890,25,2,0.001,1804,2
0.508,0.001,960,944,25,2,0.001,1904,2
0.502,0.001,1005,999,25,2,0.001,2004,2
0.472,0.001,47,57,25,2,0.001,104,3
0.47,0.001,101,103,25,2,0.001,204,3
0.472,0.001,152,152,25,2,0.001,304,3
0.472,0.001,204,200,25,2,0.001,404,3
0.47,0.001,254,250,25,2,0.001,504,3
0.47,0.001,307,297,25,2,0.001,604,3
0.468,0.001,349,355,25,2,0.001,704,3
0.47,0.001,393,411,25,2,0.001,804,3
0.468,0.001,437,467,25,2,0.001,904,3
0.466,0.001,477,527,25,2,0.001,1004,3
0.468,0.001,532,572,25,2,0.001,1104,3
0.466,0.001,576,628,25,2,0.001,1204,3
0.464,0.001,631,673,25,2,0.001,1304,3
0.466,0.001,692,712,25,2,0.001,1404,3
0.464,0.001,736,768,25,2,0.001,1504,3
0.46,0.001,788,816,25,2,0.001,1604,3
0.46,0.001,841,863,25,2,0.001,1704,3
0.464,0.001,892,912,25,2,0.001,1804,3
0.46,0.001,942,962,25,2,0.001,1904,3
0.462,0.001,991,1013,25,2,0.001,2004,3
0.516,0.001,48,56,25,2,0.001,104,4
0.516,0.001,96,108,25,2,0.001,204,4
0.516,0.001,144,160,25,2,0.001,304,4
0.516,0.001,192,212,25,2,0.001,404,4
0.516,0.001,248,256,25,2,0.001,504,4
0.516,0.001,297,307,25,2,0.001,604,4
0.516,0.001,345,359,25,2,0.001,704,4
0.516,0.001,396,408,25,2,0.001,804,4
0.516,0.001,441,463,25,2,0.001,904,4
0.516,0.001,496,508,25,2,0.001,1004,4
0.516,0.001,549,555,25,2,0.001,1104,4
0.516,0.001,598,606,25,2,0.001,1204,4
0.516,0.001,647,657,25,2,0.001,1304,4
0.516,0.001,705,699,25,2,0.001,1404,4
0.516,0.001,752,752,25,2,0.001,1504,4
0.516,0.001,804,800,25,2,0.001,1604,4
0.516,0.001,846,858,25,2,0.001,1704,4
0.516,0.001,901,903,25,2,0.001,1804,4
0.516,0.001,949,955,25,2,0.001,1904,4
0.516,0.001,994,1010,25,2,0.001,2004,4
0.494,0.001,55,49,25,2,0.001,104,5
0.498,0.001,103,101,25,2,0.001,204,5
0.498,0.001,151,153,25,2,0.001,304,5
0.498,0.001,208,196,25,2,0.001,404,5
0.498,0.001,257,247,25,2,0.001,504,5
0.496,0.001,304,300,25,2,0.001,604,5
0.5,0.001,354,350,25,2,0.001,704,5
0.496,0.001,407,397,25,2,0.001,804,5
0.5,0.001,451,453,25,2,0.001,904,5
0.502,0.001,499,505,25,2,0.001,1004,5
0.502,0.001,553,551,25,2,0.001,1104,5
0.502,0.001,606,598,25,2,0.001,1204,5
0.502,0.001,658,646,25,2,0.001,1304,5
0.508,0.001,702,702,25,2,0.001,1404,5
0.51,0.001,755,749,25,2,0.001,1504,5
0.51,0.001,805,799,25,2,0.001,1604,5
0.51,0.001,858,846,25,2,0.001,1704,5
0.512,0.001,904,900,25,2,0.001,1804,5
0.518,0.001,951,953,25,2,0.001,1904,5
0.516,0.001,988,1016,25,2,0.001,2004,5
0.47,0.001,51,53,25,2,0.001,104,6
0.468,0.001,100,104,25,2,0.001,204,6
0.472,0.001,149,155,25,2,0.001,304,6
0.472,0.001,204,200,25,2,0.001,404,6
0.472,0.001,262,242,25,2,0.001,504,6
0.478,0.001,310,294,25,2,0.001,604,6
0.478,0.001,362,342,25,2,0.001,704,6
0.482,0.001,406,398,25,2,0.001,804,6
0.484,0.001,451,453,25,2,0.001,904,6
0.482,0.001,498,506,25,2,0.001,1004,6
0.48,0.001,546,558,25,2,0.001,1104,6
0.48,0.001,602,602,25,2,0.001,1204,6
0.476,0.001,657,647,25,2,0.001,1304,6
0.474,0.001,706,698,25,2,0.001,1404,6
0.476,0.001,751,753,25,2,0.001,1504,6
0.474,0.001,804,800,25,2,0.001,1604,6
0.478,0.001,854,850,25,2,0.001,1704,6
0.478,0.001,901,903,25,2,0.001,1804,6
0.476,0.001,949,955,25,2,0.001,1904,6
0.48,0.001,1003,1001,25,2,0.001,2004,6
0.482,0.001,52,52,25,2,0.001,104,7
0.482,0.001,111,93,25,2,0.001,204,7
0.482,0.001,155,149,25,2,0.001,304,7
0.482,0.001,202,202,25,2,0.001,404,7
0.482,0.001,249,255,25,2,0.001,504,7
0.482,0.001,298,306,25,2,0.001,604,7
0.482,0.001,351,353,25,2,0.001,704,7
0.482,0.001,397,407,25,2,0.001,804,7
0.482,0.001,451,453,25,2,0.001,904,7
0.482,0.001,502,502,25,2,0.001,1004,7
0.482,0.001,553,551,25,2,0.001,1104,7
0.482,0.001,607,597,25,2,0.001,1204,7
0.482,0.001,645,659,25,2,0.001,1304,7
0.482,0.001,693,711,25,2,0.001,1404,7
0.482,0.001,747,757,25,2,0.001,1504,7
0.482,0.001,798,806,25,2,0.001,1604,7
0.482,0.001,843,861,25,2,0.001,1704,7
0.482,0.001,893,911,25,2,0.001,1804,7
0.482,0.001,941,963,25,2,0.001,1904,7
0.482,0.001,993,1011,25,2,0.001,2004,7
0.502,0.001,54,50,25,2,0.001,104,8
0.502,0.001,102,102,25,2,0.001,204,8
0.502,0.001,142,162,25,2,0.001,304,8
0.502,0.001,193,211,25,2,0.001,404,8
0.502,0.001,245,259,25,2,0.001,504,8
0.502,0.001,295,309,25,2,0.001,604,8
0.502,0.001,344,360,25,2,0.001,704,8
0.502,0.001,399,405,25,2,0.001,804,8
0.502,0.001,449,455,25,2,0.001,904,8
0.502,0.001,495,509,25,2,0.001,1004,8
0.502,0.001,553,551,25,2,0.001,1104,8
0.502,0.001,597,607,25,2,0.001,1204,8
0.502,0.001,641,663,25,2,0.001,1304,8
0.502,0.001,691,713,25,2,0.001,1404,8
0.502,0.001,741,763,25,2,0.001,1504,8
0.502,0.001,795,809,25,2,0.001,1604,8
0.502,0.001,852,852,25,2,0.001,1704,8
0.502,0.001,906,898,25,2,0.001,1804,8
0.502,0.001,954,950,25,2,0.001,1904,8
0.502,0.001,1001,1003,25,2,0.001,2004,8
0.532,0.001,54,50,25,2,0.001,104,9
0.534,0.001,104,100,25,2,0.001,204,9
0.534,0.001,158,146,25,2,0.001,304,9
0.534,0.001,208,196,25,2,0.001,404,9
0.534,0.001,263,241,25,2,0.001,504,9
0.532,0.001,312,292,25,2,0.001,604,9
0.532,0.001,371,333,25,2,0.001,704,9
0.53,0.001,416,388,25,2,0.001,804,9
0.532,0.001,464,440,25,2,0.001,904,9
0.532,0.001,518,486,25,2,0.001,1004,9
0.538,0.001,563,541,25,2,0.001,1104,9
0.532,0.001,617,587,25,2,0.001,1204,9
0.536,0.001,665,639,25,2,0.001,1304,9
0.542,0.001,706,698,25,2,0.001,1404,9
0.544,0.001,746,758,25,2,0.001,1504,9
0.55,0.001,805,799,25,2,0.001,1604,9
0.546,0.001,851,853,25,2,0.001,1704,9
0.542,0.001,898,906,25,2,0.001,1804,9
0.542,0.001,950,954,25,2,0.001,1904,9
0.55,0.001,1001,1003,25,2,0.001,2004,9
0.538,0.001,44,60,25,2,0.001,104,10
0.542,0.001,92,112,25,2,0.001,204,10
0.542,0.001,144,160,25,2,0.001,304,10
0.538,0.001,189,215,25,2,0.001,404,10
0.534,0.001,238,266,25,2,0.001,504,10
0.532,0.001,293,311,25,2,0.001,604,10
0.532,0.001,335,369,25,2,0.001,704,10
0.53,0.001,384,420,25,2,0.001,804,10
0.53,0.001,436,468,25,2,0.001,904,10
0.538,0.001,495,509,25,2,0.001,1004,10
0.534,0.001,548,556,25,2,0.001,1104,10
0.536,0.001,601,603,25,2,0.001,1204,10
0.538,0.001,647,657,25,2,0.001,1304,10
0.542,0.001,690,714,25,2,0.001,1404,10
0.548,0.001,734,770,25,2,0.001,1504,10
0.542,0.001,785,819,25,2,0.001,1604,10
0.552,0.001,828,876,25,2,0.001,1704,10
0.558,0.001,889,915,25,2,0.001,1804,10
0.562,0.001,940,964,25,2,0.001,1904,10
0.556,0.001,985,1019,25,2,0.001,2004,10
0.506,0.001,50,54,25,2,0.001,104,11
0.506,0.001,107,97,25,2,0.001,204,11
0.506,0.001,157,147,25,2,0.001,304,11
0.506,0.001,202,202,25,2,0.001,404,11
0.506,0.001,255,249,25,2,0.001,504,11
0.506,0.001,301,303,25,2,0.001,604,11
0.506,0.001,352,352,25,2,0.001,704,11
0.504,0.001,397,407,25,2,0.001,804,11
0.504,0.001,451,453,25,2,0.001,904,11
0.504,0.001,501,503,25,2,0.001,1004,11
0.502,0.001,543,561,25,2,0.001,1104,11
0.5,0.001,602,602,25,2,0.001,1204,11
0.5,0.001,651,653,25,2,0.001,1304,11
0.502,0.001,696,708,25,2,0.001,1404,11
0.5,0.001,750,754,25,2,0.001,1504,11
0.5,0.001,801,803,25,2,0.001,1604,11
0.506,0.001,854,850,25,2,0.001,1704,11
0.508,0.001,901,903,25,2,0.001,1804,11
0.508,0.001,955,949,25,2,0.001,1904,11
0.508,0.001,1005,999,25,2,0.001,2004,11
0.482,0.001,62,42,25,2,0.001,104,12
0.484,0.001,112,92,25,2,0.001,204,12
0.484,0.001,165,139,25,2,0.001,304,12
0.484,0.001,211,193,25,2,0.001,404,12
0.484,0.001,253,251,25,2,0.001,504,12
0.484,0.001,310,294,25,2,0.001,604,12
0.484,0.001,367,337,25,2,0.001,704,12
0.486,0.001,415,389,25,2,0.001,804,12
0.486,0.001,461,443,25,2,0.001,904,12
0.486,0.001,516,488,25,2,0.001,1004,12
0.486,0.001,557,547,25,2,0.001,1104,12
0.486,0.001,607,597,25,2,0.001,1204,12
0.486,0.001,648,656,25,2,0.001,1304,12
0.486,0.001,691,713,25,2,0.001,1404,12
0.486,0.001,747,757,25,2,0.001,1504,12
0.488,0.001,797,807,25,2,0.001,1604,12
0.49,0.001,857,847,25,2,0.001,1704,12
0.49,0.001,906,898,25,2,0.001,1804,12
0.488,0.001,957,947,25,2,0.001,1904,12
0.496,0.001,1011,993,25,2,0.001,2004,12
0.494,0.001,52,52,25,2,0.001,104,13
0.494,0.001,100,104,25,2,0.001,204,13
0.494,0.001,152,152,25,2,0.001,304,13
0.494,0.001,203,201,25,2,0.001,404,13
0.494,0.001,251,253,25,2,0.001,504,13
0.494,0.001,299,305,25,2,0.001,604,13
0.494,0.001,347,357,25,2,0.001,704,13
0.494,0.001,408,396,25,2,0.001,804,13
0.494,0.001,454,450,25,2,0.001,904,13
0.494,0.001,499,505,25,2,0.001,1004,13
0.494,0.001,555,549,25,2,0.001,1104,13
0.494,0.001,600,604,25,2,0.001,1204,13
0.494,0.001,655,649,25,2,0.001,1304,13
0.494,0.001,701,703,25,2,0.001,1404,13
0.494,0.001,740,764,25,2,0.001,1504,13
0.494,0.001,793,811,25,2,0.001,1604,13
0.492,0.001,847,857,25,2,0.001,1704,13
0.492,0.001,897,907,25,2,0.001,1804,13
0.488,0.001,955,949,25,2,0.001,1904,13
0.492,0.001,1005,999,25,2,0.001,2004,13
0.492,0.001,58,46,25,2,0.001,104,14
0.494,0.001,98,106,25,2,0.001,204,14
0.496,0.001,148,156,25,2,0.001,304,14
0.496,0.001,197,207,25,2,0.001,404,14
0.498,0.001,245,259,25,2,0.001,504,14
0.496,0.001,295,309,25,2,0.001,604,14
0.5,0.001,334,370,25,2,0.001,704,14
0.498,0.001,388,416,25,2,0.001,804,14
0.498,0.001,429,475,25,2,0.001,904,14
0.498,0.001,486,518,25,2,0.001,1004,14
0.498,0.001,531,573,25,2,0.001,1104,14
0.492,0.001,582,622,25,2,0.001,1204,14
0.5,0.001,635,669,25,2,0.001,1304,14
0.498,0.001,685,719,25,2,0.001,1404,14
0.502,0.001,740,764,25,2,0.001,1504,14
0.506,0.001,799,805,25,2,0.001,1604,14
0.512,0.001,848,856,25,2,0.001,1704,14
0.524,0.001,904,900,25,2,0.001,1804,14
0.52,0.001,955,949,25,2,0.001,1904,14
0.528,0.001,1006,998,25,2,0.001,2004,14
0.522,0.001,56,48,25,2,0.001,104,15
0.522,0.001,105,99,25,2,0.001,204,15
0.522,0.001,152,152,25,2,0.001,304,15
0.522,0.001,205,199,25,2,0.001,404,15
0.522,0.001,259,245,25,2,0.001,504,15
0.522,0.001,302,302,25,2,0.001,604,15
0.522,0.001,348,356,25,2,0.001,704,15
0.522,0.001,394,410,25,2,0.001,804,15
0.522,0.001,454,450,25,2,0.001,904,15
0.522,0.001,504,500,25,2,0.001,1004,15
0.522,0.001,545,559,25,2,0.001,1104,15
0.522,0.001,592,612,25,2,0.001,1204,15
0.522,0.001,641,663,25,2,0.001,1304,15
0.522,0.001,688,716,25,2,0.001,1404,15
0.522,0.001,738,766,25,2,0.001,1504,15
0.522,0.001,789,815,25,2,0.001,1604,15
0.522,0.001,836,868,25,2,0.001,1704,15
0.522,0.001,887,917,25,2,0.001,1804,15
0.522,0.001,935,969,25,2,0.001,1904,15
0.522,0.001,991,1013,25,2,0.001,2004,15
0.48,0.001,52,52,25,2,0.001,104,16
0.48,0.001,99,105,25,2,0.001,204,16
0.48,0.001,163,141,25,2,0.001,304,16
0.48,0.001,215,189,25,2,0.001,404,16
0.48,0.001,261,243,25,2,0.001,504,16
0.48,0.001,309,295,25,2,0.001,604,16
0.48,0.001,354,350,25,2,0.001,704,16
0.48,0.001,399,405,25,2,0.001,804,16
0.48,0.001,444,460,25,2,0.001,904,16
0.48,0.001,491,513,25,2,0.001,1004,16
0.48,0.001,540,564,25,2,0.001,1104,16
0.48,0.001,589,615,25,2,0.001,1204,16
0.48,0.001,638,666,25,2,0.001,1304,16
0.48,0.001,687,717,25,2,0.001,1404,16
0.48,0.001,734,770,25,2,0.001,1504,16
0.48,0.001,785,819,25,2,0.001,1604,16
0.48,0.001,843,861,25,2,0.001,1704,16
0.48,0.001,895,909,25,2,0.001,1804,16
0.48,0.001,960,944,25,2,0.001,1904,16
0.48,0.001,1012,992,25,2,0.001,2004,16
0.484,0.001,44,60,25,2,0.001,104,17
0.484,0.001,95,109,25,2,0.001,204,17
0.484,0.001,146,158,25,2,0.001,304,17
0.484,0.001,191,213,25,2,0.001,404,17
0.484,0.001,240,264,25,2,0.001,504,17
0.484,0.001,296,308,25,2,0.001,604,17
0.484,0.001,355,349,25,2,0.001,704,17
0.484,0.001,411,393,25,2,0.001,804,17
0.484,0.001,465,439,25,2,0.001,904,17
0.482,0.001,514,490,25,2,0.001,1004,17
0.482,0.001,566,538,25,2,0.001,1104,17
0.484,0.001,616,588,25,2,0.001,1204,17
0.484,0.001,663,641,25,2,0.001,1304,17
0.484,0.001,724,680,25,2,0.001,1404,17
0.484,0.001,766,738,25,2,0.001,1504,17
0.482,0.001,821,783,25,2,0.001,1604,17
0.482,0.001,868,836,25,2,0.001,1704,17
0.484,0.001,915,889,25,2,0.001,1804,17
0.484,0.001,962,942,25,2,0.001,1904,17
0.484,0.001,1010,994,25,2,0.001,2004,17
0.498,0.001,49,55,25,2,0.001,104,18
0.498,0.001,97,107,25,2,0.001,204,18
0.498,0.001,147,157,25,2,0.001,304,18
0.498,0.001,199,205,25,2,0.001,404,18
0.498,0.001,251,253,25,2,0.001,504,18
0.498,0.001,306,298,25,2,0.001,604,18
0.498,0.001,356,348,25,2,0.001,704,18
0.498,0.001,404,400,25,2,0.001,804,18
0.498,0.001,451,453,25,2,0.001,904,18
0.498,0.001,494,510,25,2,0.001,1004,18
0.498,0.001,551,553,25,2,0.001,1104,18
0.498,0.001,606,598,25,2,0.001,1204,18
0.498,0.001,653,651,25,2,0.001,1304,18
0.498,0.001,708,696,25,2,0.001,1404,18
0.498,0.001,761,743,25,2,0.001,1504,18
0.498,0.001,810,794,25,2,0.001,1604,18
0.498,0.001,855,849,25,2,0.001,1704,18
0.498,0.001,897,907,25,2,0.001,1804,18
0.498,0.001,959,945,25,2,0.001,1904,18
0.498,0.001,1001,1003,25,2,0.001,2004,18
0.494,0.001,53,51,25,2,0.001,104,19
0.498,0.001,94,110,25,2,0.001,204,19
0.502,0.001,137,167,25,2,0.001,304,19
0.5,0.001,189,215,25,2,0.001,404,19
0.502,0.001,237,267,25,2,0.001,504,19
0.5,0.001,284,320,25,2,0.001,604,19
0.508,0.001,326,378,25,2,0.001,704,19
0.502,0.001,379,425,25,2,0.001,804,19
0.496,0.001,430,474,25,2,0.001,904,19
0.484,0.001,476,528,25,2,0.001,1004,19
0.488,0.001,521,583,25,2,0.001,1104,19
0.488,0.001,575,629,25,2,0.001,1204,19
0.486,0.001,636,668,25,2,0.001,1304,19
0.486,0.001,687,717,25,2,0.001,1404,19
0.482,0.001,739,765,25,2,0.001,1504,19
0.486,0.001,793,811,25,2,0.001,1604,19
0.498,0.001,848,856,25,2,0.001,1704,19
0.508,0.001,907,897,25,2,0.001,1804,19
0.52,0.001,954,950,25,2,0.001,1904,19
0.522,0.001,1010,994,25,2,0.001,2004,19
0.51,0.001,45,59,25,2,0.001,104,20
0.514,0.001,96,108,25,2,0.001,204,20
0.512,0.001,147,157,25,2,0.001,304,20
0.514,0.001,192,212,25,2,0.001,404,20
0.514,0.001,247,257,25,2,0.001,504,20
0.51,0.001,305,299,25,2,0.001,604,20
0.508,0.001,347,357,25,2,0.001,704,20
0.506,0.001,398,406,25,2,0.001,804,20
0.506,0.001,448,456,25,2,0.001,904,20
0.51,0.001,496,508,25,2,0.001,1004,20
0.508,0.001,557,547,25,2,0.001,1104,20
0.508,0.001,614,590,25,2,0.001,1204,20
0.508,0.001,663,641,25,2,0.001,1304,20
0.516,0.001,712,692,25,2,0.001,1404,20
0.52,0.001,767,737,25,2,0.001,1504,20
0.52,0.001,817,787,25,2,0.001,1604,20
0.52,0.001,863,841,25,2,0.001,1704,20
0.518,0.001,910,894,25,2,0.001,1804,20
0.518,0.001,961,943,25,2,0.001,1904,20
0.516,0.001,1012,992,25,2,0.001,2004,20
0.538,0.001,56,48,25,2,0.01,104,1
0.538,0.001,107,97,25,2,0.01,204,1
0.538,0.001,152,152,25,2,0.01,304,1
0.538,0.001,197,207,25,2,0.01,404,1
0.538,0.001,248,256,25,2,0.01,504,1
0.538,0.001,287,317,25,2,0.01,604,1
0.538,0.001,331,373,25,2,0.01,704,1
0.548,0.001,379,425,25,2,0.01,804,1
0.56,0.001,434,470,25,2,0.01,904,1
0.58,0.001,489,515,25,2,0.01,1004,1
0.576,0.001,531,573,25,2,0.01,1104,1
0.594,0.001,581,623,25,2,0.01,1204,1
0.6,0.001,631,673,25,2,0.01,1304,1
0.602,0.001,683,721,25,2,0.01,1404,1
0.612,0.001,731,773,25,2,0.01,1504,1
0.618,0.001,786,818,25,2,0.01,1604,1
0.63,0.001,830,874,25,2,0.01,1704,1
0.646,0.001,880,924,25,2,0.01,1804,1
0.668,0.001,934,970,25,2,0.01,1904,1
0.664,0.001,983,1021,25,2,0.01,2004,1
0.502,0.001,47,57,25,2,0.01,104,2
0.494,0.001,100,104,25,2,0.01,204,2
0.502,0.001,151,153,25,2,0.01,304,2
0.502,0.001,201,203,25,2,0.01,404,2
0.51,0.001,242,262,25,2,0.01,504,2
0.526,0.001,292,312,25,2,0.01,604,2
0.534,0.001,335,369,25,2,0.01,704,2
0.556,0.001,391,413,25,2,0.01,804,2
0.574,0.001,444,460,25,2,0.01,904,2
0.586,0.001,488,516,25,2,0.01,1004,2
0.596,0.001,531,573,25,2,0.01,1104,2
0.6,0.001,577,627,25,2,0.01,1204,2
0.602,0.001,626,678,25,2,0.01,1304,2
0.618,0.001,681,723,25,2,0.01,1404,2
0.618,0.001,739,765,25,2,0.01,1504,2
0.632,0.001,781,823,25,2,0.01,1604,2
0.634,0.001,832,872,25,2,0.01,1704,2
0.64,0.001,878,926,25,2,0.01,1804,2
0.66,0.001,933,971,25,2,0.01,1904,2
0.658,0.001,994,1010,25,2,0.01,2004,2
0.52,0.001,55,49,25,2,0.01,104,3
0.522,0.001,101,103,25,2,0.01,204,3
0.53,0.001,159,145,25,2,0.01,304,3
0.544,0.001,210,194,25,2,0.01,404,3
0.542,0.001,253,251,25,2,0.01,504,3
0.56,0.001,300,304,25,2,0.01,604,3
0.568,0.001,356,348,25,2,0.01,704,3
0.586,0.001,403,401,25,2,0.01,804,3
0.58,0.001,454,450,25,2,0.01,904,3
0.574,0.001,501,503,25,2,0.01,1004,3
0.578,0.001,553,551,25,2,0.01,1104,3
0.588,0.001,610,594,25,2,0.01,1204,3
0.582,0.001,665,639,25,2,0.01,1304,3
0.59,0.001,716,688,25,2,0.01,1404,3
0.58,0.001,769,735,25,2,0.01,1504,3
0.576,0.001,817,787,25,2,0.01,1604,3
0.58,0.001,861,843,25,2,0.01,1704,3
0.592,0.001,911,893,25,2,0.01,1804,3
0.588,0.001,960,944,25,2,0.01,1904,3
0.602,0.001,1008,996,25,2,0.01,2004,3
0.49,0.001,57,47,25,2,0.01,104,4
0.49,0.001,104,100,25,2,0.01,204,4
0.524,0.001,154,150,25,2,0.01,304,4
0.522,0.001,207,197,25,2,0.01,404,4
0.516,0.001,254,250,25,2,0.01,504,4
0.53,0.001,303,301,25,2,0.01,604,4
0.546,0.001,349,355,25,2,0.01,704,4
0.544,0.001,398,406,25,2,0.01,804,4
0.58,0.001,449,455,25,2,0.01,904,4
0.614,0.001,505,499,25,2,0.01,1004,4
0.65,0.001,551,553,25,2,0.01,1104,4
0.68,0.001,597,607,25,2,0.01,1204,4
0.71,0.001,648,656,25,2,0.01,1304,4
0.752,0.001,702,702,25,2,0.01,1404,4
0.796,0.001,752,752,25,2,0.01,1504,4
0.828,0.001,794,810,25,2,0.01,1604,4
0.844,0.001,848,856,25,2,0.01,1704,4
0.854,0.001,902,902,25,2,0.01,1804,4
0.858,0.001,951,953,25,2,0.01,1904,4
0.874,0.001,1007,997,25,2,0.01,2004,4
0.49,0.001,55,49,25,2,0.01,104,5
0.496,0.001,103,101,25,2,0.01,204,5
0.492,0.001,154,150,25,2,0.01,304,5
0.496,0.001,212,192,25,2,0.01,404,5
0.5,0.001,264,240,25,2,0.01,504,5
0.512,0.001,310,294,25,2,0.01,604,5
0.508,0.001,362,342,25,2,0.01,704,5
0.526,0.001,410,394,25,2,0.01,804,5
0.534,0.001,459,445,25,2,0.01,904,5
0.554,0.001,506,498,25,2,0.01,1004,5
0.568,0.001,550,554,25,2,0.01,1104,5
0.57,0.001,603,601,25,2,0.01,1204,5
0.588,0.001,662,642,25,2,0.01,1304,5
0.596,0.001,714,690,25,2,0.01,1404,5
0.61,0.001,769,735,25,2,0.01,1504,5
0.62,0.001,812,792,25,2,0.01,1604,5
0.626,0.001,861,843,25,2,0.01,1704,5
0.62,0.001,908,896,25,2,0.01,1804,5
0.636,0.001,965,939,25,2,0.01,1904,5
0.644,0.001,1006,998,25,2,0.01,2004,5
0.498,0.001,49,55,25,2,0.01,104,6
0.494,0.001,98,106,25,2,0.01,204,6
0.5,0.001,143,161,25,2,0.01,304,6
0.518,0.001,193,211,25,2,0.01,404,6
0.534,0.001,244,260,25,2,0.01,504,6
0.532,0.001,293,311,25,2,0.01,604,6
0.558,0.001,341,363,25,2,0.01,704,6
0.586,0.001,399,405,25,2,0.01,804,6
0.598,0.001,447,457,25,2,0.01,904,6
0.616,0.001,501,503,25,2,0.01,1004,6
0.642,0.001,552,552,25,2,0.01,1104,6
0.676,0.001,598,606,25,2,0.01,1204,6
0.702,0.001,653,651,25,2,0.01,1304,6
0.718,0.001,708,696,25,2,0.01,1404,6
0.77,0.001,759,745,25,2,0.01,1504,6
0.824,0.001,810,794,25,2,0.01,1604,6
0.856,0.001,861,843,25,2,0.01,1704,6
0.876,0.001,915,889,25,2,0.01,1804,6
0.878,0.001,959,945,25,2,0.01,1904,6
0.882,0.001,1017,987,25,2,0.01,2004,6
0.472,0.001,56,48,25,2,0.01,104,7
0.488,0.001,104,100,25,2,0.01,204,7
0.5,0.001,154,150,25,2,0.01,304,7
0.52,0.001,195,209,25,2,0.01,404,7
0.54,0.001,249,255,25,2,0.01,504,7
0.558,0.001,300,304,25,2,0.01,604,7
0.56,0.001,352,352,25,2,0.01,704,7
0.574,0.001,404,400,25,2,0.01,804,7
0.568,0.001,456,448,25,2,0.01,904,7
0.58,0.001,511,493,25,2,0.01,1004,7
0.576,0.001,568,536,25,2,0.01,1104,7
0.586,0.001,625,579,25,2,0.01,1204,7
0.586,0.001,674,630,25,2,0.01,1304,7
0.592,0.001,719,685,25,2,0.01,1404,7
0.584,0.001,769,735,25,2,0.01,1504,7
0.61,0.001,814,790,25,2,0.01,1604,7
0.604,0.001,865,839,25,2,0.01,1704,7
0.612,0.001,907,897,25,2,0.01,1804,7
0.622,0.001,959,945,25,2,0.01,1904,7
0.624,0.001,1012,992,25,2,0.01,2004,7
0.466,0.001,55,49,25,2,0.01,104,8
0.466,0.001,111,93,25,2,0.01,204,8
0.466,0.001,156,148,25,2,0.01,304,8
0.466,0.001,216,188,25,2,0.01,404,8
0.466,0.001,260,244,25,2,0.01,504,8
0.466,0.001,310,294,25,2,0.01,604,8
0.466,0.001,357,347,25,2,0.01,704,8
0.466,0.001,408,396,25,2,0.01,804,8
0.466,0.001,460,444,25,2,0.01,904,8
0.466,0.001,505,499,25,2,0.01,1004,8
0.466,0.001,557,547,25,2,0.01,1104,8
0.466,0.001,603,601,25,2,0.01,1204,8
0.466,0.001,651,653,25,2,0.01,1304,8
0.466,0.001,694,710,25,2,0.01,1404,8
0.466,0.001,742,762,25,2,0.01,1504,8
0.466,0.001,797,807,25,2,0.01,1604,8
0.466,0.001,843,861,25,2,0.01,1704,8
0.466,0.001,885,919,25,2,0.01,1804,8
0.466,0.001,938,966,25,2,0.01,1904,8
0.466,0.001,985,1019,25,2,0.01,2004,8
0.512,0.001,54,50,25,2,0.01,104,9
0.52,0.001,98,106,25,2,0.01,204,9
0.518,0.001,144,160,25,2,0.01,304,9
0.526,0.001,194,210,25,2,0.01,404,9
0.526,0.001,240,264,25,2,0.01,504,9
0.532,0.001,295,309,25,2,0.01,604,9
0.52,0.001,345,359,25,2,0.01,704,9
0.522,0.001,392,412,25,2,0.01,804,9
0.534,0.001,444,460,25,2,0.01,904,9
0.54,0.001,498,506,25,2,0.01,1004,9
0.554,0.001,548,556,25,2,0.01,1104,9
0.566,0.001,599,605,25,2,0.01,1204,9
0.58,0.001,647,657,25,2,0.01,1304,9
0.588,0.001,701,703,25,2,0.01,1404,9
0.6,0.001,749,755,25,2,0.01,1504,9
0.602,0.001,791,813,25,2,0.01,1604,9
0.626,0.001,843,861,25,2,0.01,1704,9
0.642,0.001,892,912,25,2,0.01,1804,9
0.638,0.001,942,962,25,2,0.01,1904,9
0.672,0.001,991,1013,25,2,0.01,2004,9
0.524,0.001,52,52,25,2,0.01,104,10
0.536,0.001,99,105,25,2,0.01,204,10
0.546,0.001,142,162,25,2,0.01,304,10
0.552,0.001,187,217,25,2,0.01,404,10
0.58,0.001,236,268,25,2,0.01,504,10
0.59,0.001,294,310,25,2,0.01,604,10
0.592,0.001,343,361,25,2,0.01,704,10
0.602,0.001,396,408,25,2,0.01,804,10
0.618,0.001,450,454,25,2,0.01,904,10
0.638,0.001,491,513,25,2,0.01,1004,10
0.666,0.001,532,572,25,2,0.01,1104,10
0.674,0.001,583,621,25,2,0.01,1204,10
0.696,0.001,638,666,25,2,0.01,1304,10
0.7,0.001,689,715,25,2,0.01,1404,10
0.714,0.001,749,755,25,2,0.01,1504,10
0.726,0.001,807,797,25,2,0.01,1604,10
0.722,0.001,854,850,25,2,0.01,1704,10
0.726,0.001,903,901,25,2,0.01,1804,10
0.728,0.001,946,958,25,2,0.01,1904,10
0.738,0.001,993,1011,25,2,0.01,2004,10
0.486,0.001,52,52,25,2,0.01,104,11
0.498,0.001,104,100,25,2,0.01,204,11
0.506,0.001,155,149,25,2,0.01,304,11
0.518,0.001,205,199,25,2,0.01,404,11
0.524,0.001,251,253,25,2,0.01,504,11
0.548,0.001,306,298,25,2,0.01,604,11
0.556,0.001,359,345,25,2,0.01,704,11
0.584,0.001,415,389,25,2,0.01,804,11
0.62,0.001,455,449,25,2,0.01,904,11
0.66,0.001,507,497,25,2,0.01,1004,11
0.704,0.001,556,548,25,2,0.01,1104,11
0.756,0.001,612,592,25,2,0.01,1204,11
0.784,0.001,659,645,25,2,0.01,1304,11
0.82,0.001,714,690,25,2,0.01,1404,11
0.834,0.001,759,745,25,2,0.01,1504,11
0.844,0.001,800,804,25,2,0.01,1604,11
0.854,0.001,853,851,25,2,0.01,1704,11
0.864,0.001,899,905,25,2,0.01,1804,11
0.866,0.001,949,955,25,2,0.01,1904,11
0.878,0.001,996,1008,25,2,0.01,2004,11
0.528,0.001,55,49,25,2,0.01,104,12
0.53,0.001,95,109,25,2,0.01,204,12
0.53,0.001,146,158,25,2,0.01,304,12
0.53,0.001,196,208,25,2,0.01,404,12
0.538,0.001,239,265,25,2,0.01,504,12
0.55,0.001,290,314,25,2,0.01,604,12
0.554,0.001,345,359,25,2,0.01,704,12
0.588,0.001,400,404,25,2,0.01,804,12
0.622,0.001,450,454,25,2,0.01,904,12
0.656,0.001,507,497,25,2,0.01,1004,12
0.678,0.001,559,545,25,2,0.01,1104,12
0.68,0.001,611,593,25,2,0.01,1204,12
0.708,0.001,664,640,25,2,0.01,1304,12
0.744,0.001,713,691,25,2,0.01,1404,12
0.782,0.001,763,741,25,2,0.01,1504,12
0.816,0.001,816,788,25,2,0.01,1604,12
0.83,0.001,870,834,25,2,0.01,1704,12
0.85,0.001,920,884,25,2,0.01,1804,12
0.852,0.001,970,934,25,2,0.01,1904,12
0.862,0.001,1015,989,25,2,0.01,2004,12
0.496,0.001,48,56,25,2,0.01,104,13
0.496,0.001,106,98,25,2,0.01,204,13
0.49,0.001,152,152,25,2,0.01,304,13
0.51,0.001,202,202,25,2,0.01,404,13
0.492,0.001,253,251,25,2,0.01,504,13
0.514,0.001,299,305,25,2,0.01,604,13
0.518,0.001,347,357,25,2,0.01,704,13
0.53,0.001,399,405,25,2,0.01,804,13
0.534,0.001,444,460,25,2,0.01,904,13
0.55,0.001,487,517,25,2,0.01,1004,13
0.562,0.001,537,567,25,2,0.01,1104,13
0.574,0.001,587,617,25,2,0.01,1204,13
0.56,0.001,641,663,25,2,0.01,1304,13
0.566,0.001,685,719,25,2,0.01,1404,13
0.568,0.001,735,769,25,2,0.01,1504,13
0.574,0.001,794,810,25,2,0.01,1604,13
0.578,0.001,844,860,25,2,0.01,1704,13
0.59,0.001,903,901,25,2,0.01,1804,13
0.584,0.001,951,953,25,2,0.01,1904,13
0.586,0.001,1000,1004,25,2,0.01,2004,13
0.528,0.001,48,56,25,2,0.01,104,14
0.528,0.001,103,101,25,2,0.01,204,14
0.53,0.001,157,147,25,2,0.01,304,14
0.536,0.001,207,197,25,2,0.01,404,14
0.536,0.001,252,252,25,2,0.01,504,14
0.556,0.001,301,303,25,2,0.01,604,14
0.558,0.001,355,349,25,2,0.01,704,14
0.568,0.001,410,394,25,2,0.01,804,14
0.574,0.001,455,449,25,2,0.01,904,14
0.574,0.001,501,503,25,2,0.01,1004,14
0.576,0.001,550,554,25,2,0.01,1104,14
0.578,0.001,597,607,25,2,0.01,1204,14
0.576,0.001,641,663,25,2,0.01,1304,14
0.582,0.001,693,711,25,2,0.01,1404,14
0.576,0.001,742,762,25,2,0.01,1504,14
0.58,0.001,790,814,25,2,0.01,1604,14
0.584,0.001,838,866,25,2,0.01,1704,14
0.6,0.001,886,918,25,2,0.01,1804,14
0.612,0.001,937,967,25,2,0.01,1904,14
0.608,0.001,986,1018,25,2,0.01,2004,14
0.47,0.001,54,50,25,2,0.01,104,15
0.47,0.001,102,102,25,2,0.01,204,15
0.47,0.001,156,148,25,2,0.01,304,15
0.47,0.001,204,200,25,2,0.01,404,15
0.47,0.001,253,251,25,2,0.01,504,15
0.47,0.001,309,295,25,2,0.01,604,15
0.47,0.001,355,349,25,2,0.01,704,15
0.47,0.001,400,404,25,2,0.01,804,15
0.47,0.001,447,457,25,2,0.01,904,15
0.47,0.001,502,502,25,2,0.01,1004,15
0.47,0.001,554,550,25,2,0.01,1104,15
0.47,0.001,603,601,25,2,0.01,1204,15
0.47,0.001,645,659,25,2,0.01,1304,15
0.47,0.001,682,722,25,2,0.01,1404,15
0.47,0.001,738,766,25,2,0.01,1504,15
0.47,0.001,793,811,25,2,0.01,1604,15
0.47,0.001,838,866,25,2,0.01,1704,15
0.47,0.001,891,913,25,2,0.01,1804,15
0.47,0.001,945,959,25,2,0.01,1904,15
0.47,0.001,987,1017,25,2,0.01,2004,15
0.512,0.001,56,48,25,2,0.01,104,16
0.512,0.001,104,100,25,2,0.01,204,16
0.522,0.001,156,148,25,2,0.01,304,16
0.516,0.001,211,193,25,2,0.01,404,16
0.522,0.001,255,249,25,2,0.01,504,16
0.528,0.001,311,293,25,2,0.01,604,16
0.546,0.001,358,346,25,2,0.01,704,16
0.552,0.001,401,403,25,2,0.01,804,16
0.552,0.001,447,457,25,2,0.01,904,16
0.568,0.001,491,513,25,2,0.01,1004,16
0.578,0.001,538,566,25,2,0.01,1104,16
0.608,0.001,586,618,25,2,0.01,1204,16
0.624,0.001,637,667,25,2,0.01,1304,16
0.65,0.001,695,709,25,2,0.01,1404,16
0.672,0.001,748,756,25,2,0.01,1504,16
0.71,0.001,794,810,25,2,0.01,1604,16
0.726,0.001,845,859,25,2,0.01,1704,16
0.736,0.001,896,908,25,2,0.01,1804,16
0.742,0.001,948,956,25,2,0.01,1904,16
0.744,0.001,997,1007,25,2,0.01,2004,16
0.472,0.001,56,48,25,2,0.01,104,17
0.472,0.001,110,94,25,2,0.01,204,17
0.472,0.001,159,145,25,2,0.01,304,17
0.472,0.001,201,203,25,2,0.01,404,17
0.472,0.001,250,254,25,2,0.01,504,17
0.472,0.001,299,305,25,2,0.01,604,17
0.472,0.001,349,355,25,2,0.01,704,17
0.472,0.001,403,401,25,2,0.01,804,17
0.472,0.001,462,442,25,2,0.01,904,17
0.472,0.001,519,485,25,2,0.01,1004,17
0.472,0.001,569,535,25,2,0.01,1104,17
0.472,0.001,615,589,25,2,0.01,1204,17
0.472,0.001,670,634,25,2,0.01,1304,17
0.536,0.001,715,689,25,2,0.01,1404,17
0.54,0.001,760,744,25,2,0.01,1504,17
0.544,0.001,807,797,25,2,0.01,1604,17
0.56,0.001,856,848,25,2,0.01,1704,17
0.55,0.001,906,898,25,2,0.01,1804,17
0.558,0.001,946,958,25,2,0.01,1904,17
0.56,0.001,988,1016,25,2,0.01,2004,17
0.53,0.001,42,62,25,2,0.01,104,18
0.524,0.001,91,113,25,2,0.01,204,18
0.522,0.001,140,164,25,2,0.01,304,18
0.524,0.001,186,218,25,2,0.01,404,18
0.532,0.001,230,274,25,2,0.01,504,18
0.526,0.001,287,317,25,2,0.01,604,18
0.524,0.001,335,369,25,2,0.01,704,18
0.53,0.001,384,420,25,2,0.01,804,18
0.538,0.001,427,477,25,2,0.01,904,18
0.542,0.001,481,523,25,2,0.01,1004,18
0.556,0.001,523,581,25,2,0.01,1104,18
0.584,0.001,578,626,25,2,0.01,1204,18
0.608,0.001,629,675,25,2,0.01,1304,18
0.622,0.001,679,725,25,2,0.01,1404,18
0.66,0.001,731,773,25,2,0.01,1504,18
0.692,0.001,790,814,25,2,0.01,1604,18
0.726,0.001,838,866,25,2,0.01,1704,18
0.73,0.001,883,921,25,2,0.01,1804,18
0.732,0.001,934,970,25,2,0.01,1904,18
0.73,0.001,992,1012,25,2,0.01,2004,18
0.508,0.001,55,49,25,2,0.01,104,19
0.508,0.001,95,109,25,2,0.01,204,19
0.508,0.001,149,155,25,2,0.01,304,19
0.508,0.001,207,197,25,2,0.01,404,19
0.508,0.001,254,250,25,2,0.01,504,19
0.508,0.001,291,313,25,2,0.01,604,19
0.508,0.001,341,363,25,2,0.01,704,19
0.508,0.001,387,417,25,2,0.01,804,19
0.508,0.001,436,468,25,2,0.01,904,19
0.508,0.001,481,523,25,2,0.01,1004,19
0.508,0.001,533,571,25,2,0.01,1104,19
0.508,0.001,588,616,25,2,0.01,1204,19
0.508,0.001,637,667,25,2,0.01,1304,19
0.508,0.001,679,725,25,2,0.01,1404,19
0.508,0.001,733,771,25,2,0.01,1504,19
0.508,0.001,788,816,25,2,0.01,1604,19
0.508,0.001,836,868,25,2,0.01,1704,19
0.508,0.001,884,920,25,2,0.01,1804,19
0.738,0.001,939,965,25,2,0.01,1904,19
0.878,0.001,998,1006,25,2,0.01,2004,19
0.48,0.001,52,52,25,2,0.01,104,20
0.48,0.001,90,114,25,2,0.01,204,20
0.48,0.001,143,161,25,2,0.01,304,20
0.48,0.001,192,212,25,2,0.01,404,20
0.48,0.001,238,266,25,2,0.01,504,20
0.48,0.001,289,315,25,2,0.01,604,20
0.48,0.001,344,360,25,2,0.01,704,20
0.48,0.001,397,407,25,2,0.01,804,20
0.48,0.001,444,460,25,2,0.01,904,20
0.48,0.001,492,512,25,2,0.01,1004,20
0.48,0.001,545,559,25,2,0.01,1104,20
0.48,0.001,605,599,25,2,0.01,1204,20
0.48,0.001,654,650,25,2,0.01,1304,20
0.48,0.001,701,703,25,2,0.01,1404,20
0.48,0.001,756,748,25,2,0.01,1504,20
0.48,0.001,816,788,25,2,0.01,1604,20
0.48,0.001,866,838,25,2,0.01,1704,20
0.48,0.001,915,889,25,2,0.01,1804,20
0.48,0.001,963,941,25,2,0.01,1904,20
0.48,0.001,1012,992,25,2,0.01,2004,20
0.544,1e-05,56,48,25,10,0.0001,104,1
0.542,1e-05,107,97,25,10,0.0001,204,1
0.542,1e-05,150,154,25,10,0.0001,304,1
0.542,1e-05,200,204,25,10,0.0001,404,1
0.542,1e-05,253,251,25,10,0.0001,504,1
0.544,1e-05,314,290,25,10,0.0001,604,1
0.544,1e-05,362,342,25,10,0.0001,704,1
0.544,1e-05,414,390,25,10,0.0001,804,1
0.544,1e-05,465,439,25,10,0.0001,904,1
0.544,1e-05,514,490,25,10,0.0001,1004,1
0.544,1e-05,554,550,25,10,0.0001,1104,1
0.546,1e-05,603,601,25,10,0.0001,1204,1
0.548,1e-05,653,651,25,10,0.0001,1304,1
0.548,1e-05,707,697,25,10,0.0001,1404,1
0.546,1e-05,753,751,25,10,0.0001,1504,1
0.546,1e-05,807,797,25,10,0.0001,1604,1
0.546,1e-05,856,848,25,10,0.0001,1704,1
0.548,1e-05,911,893,25,10,0.0001,1804,1
0.548,1e-05,959,945,25,10,0.0001,1904,1
0.548,1e-05,1012,992,25,10,0.0001,2004,1
0.474,1e-05,49,55,25,10,0.0001,104,2
0.474,1e-05,100,104,25,10,0.0001,204,2
0.474,1e-05,150,154,25,10,0.0001,304,2
0.474,1e-05,202,202,25,10,0.0001,404,2
0.474,1e-05,254,250,25,10,0.0001,504,2
0.474,1e-05,310,294,25,10,0.0001,604,2
0.474,1e-05,360,344,25,10,0.0001,704,2
0.476,1e-05,405,399,25,10,0.0001,804,2
0.476,1e-05,457,447,25,10,0.0001,904,2
0.476,1e-05,501,503,25,10,0.0001,1004,2
0.476,1e-05,542,562,25,10,0.0001,1104,2
0.478,1e-05,594,610,25,10,0.0001,1204,2
0.48,1e-05,637,667,25,10,0.0001,1304,2
0.48,1e-05,686,718,25,10,0.0001,1404,2
0.48,1e-05,735,769,25,10,0.0001,1504,2
0.48,1e-05,785,819,25,10,0.0001,1604,2
0.484,1e-05,836,868,25,10,0.0001,1704,2
0.484,1e-05,883,921,25,10,0.0001,1804,2
0.482,1e-05,934,970,25,10,0.0001,1904,2
0.48,1e-05,986,1018,25,10,0.0001,2004,2
0.512,1e-05,41,63,25,10,0.0001,104,3
0.512,1e-05,99,105,25,10,0.0001,204,3
0.514,1e-05,149,155,25,10,0.0001,304,3
0.516,1e-05,200,204,25,10,0.0001,404,3
0.516,1e-05,251,253,25,10,0.0001,504,3
0.518,1e-05,295,309,25,10,0.0001,604,3
0.518,1e-05,348,356,25,10,0.0001,704,3
0.522,1e-05,405,399,25,10,0.0001,804,3
0.522,1e-05,460,444,25,10,0.0001,904,3
0.522,1e-05,511,493,25,10,0.0001,1004,3
0.522,1e-05,567,537,25,10,0.0001,1104,3
0.522,1e-05,612,592,25,10,0.0001,1204,3
0.522,1e-05,664,640,25,10,0.0001,1304,3
0.524,1e-05,711,693,25,10,0.0001,1404,3
0.526,1e-05,763,741,25,10,0.0001,1504,3
0.528,1e-05,808,796,25,10,0.0001,1604,3
0.528,1e-05,853,851,25,10,0.0001,1704,3
0.53,1e-05,893,911,25,10,0.0001,1804,3
0.528,1e-05,948,956,25,10,0.0001,1904,3
0.53,1e-05,999,1005,25,10,0.0001,2004,3
0.474,1e-05,41,63,25,10,0.0001,104,4
0.474,1e-05,91,113,25,10,0.0001,204,4
0.474,1e-05,145,159,25,10,0.0001,304,4
0.474,1e-05,202,202,25,10,0.0001,404,4
0.476,1e-05,251,253,25,10,0.0001,504,4
0.476,1e-05,306,298,25,10,0.0001,604,4
0.476,1e-05,349,355,25,10,0.0001,704,4
0.478,1e-05,405,399,25,10,0.0001,804,4
0.478,1e-05,448,456,25,10,0.0001,904,4
0.48,1e-05,497,507,25,10,0.0001,1004,4
0.48,1e-05,551,553,25,10,0.0001,1104,4
0.48,1e-05,603,601,25,10,0.0001,1204,4
0.484,1e-05,658,646,25,10,0.0001,1304,4
0.488,1e-05,709,695,25,10,0.0001,1404,4
0.486,1e-05,759,745,25,10,0.0001,1504,4
0.488,1e-05,806,798,25,10,0.0001,1604,4
0.488,1e-05,850,854,25,10,0.0001,1704,4
0.488,1e-05,902,902,25,10,0.0001,1804,4
0.488,1e-05,942,962,25,10,0.0001,1904,4
0.486,1e-05,992,1012,25,10,0.0001,2004,4
0.528,1e-05,52,52,25,10,0.0001,104,5
0.528,1e-05,93,111,25,10,0.0001,204,5
0.528,1e-05,148,156,25,10,0.0001,304,5
0.528,1e-05,202,202,25,10,0.0001,404,5
0.526,1e-05,248,256,25,10,0.0001,504,5
0.526,1e-05,299,305,25,10,0.0001,604,5
0.526,1e-05,349,355,25,10,0.0001,704,5
0.524,1e-05,394,410,25,10,0.0001,804,5
0.526,1e-05,450,454,25,10,0.0001,904,5
0.528,1e-05,493,511,25,10,0.0001,1004,5
0.53,1e-05,542,562,25,10,0.0001,1104,5
0.532,1e-05,594,610,25,10,0.0001,1204,5
0.532,1e-05,636,668,25,10,0.0001,1304,5
0.532,1e-05,699,705,25,10,0.0001,1404,5
0.532,1e-05,739,765,25,10,0.0001,1504,5
0.532,1e-05,793,811,25,10,0.0001,1604,5
0.532,1e-05,837,867,25,10,0.0001,1704,5
0.536,1e-05,885,919,25,10,0.0001,1804,5
0.536,1e-05,936,968,25,10,0.0001,1904,5
0.534,1e-05,989,1015,25,10,0.0001,2004,5
0.488,1e-05,55,49,25,10,0.0001,104,6
0.488,1e-05,107,97,25,10,0.0001,204,6
0.488,1e-05,152,152,25,10,0.0001,304,6
0.488,1e-05,199,205,25,10,0.0001,404,6
0.488,1e-05,248,256,25,10,0.0001,504,6
0.488,1e-05,305,299,25,10,0.0001,604,6
0.488,1e-05,356,348,25,10,0.0001,704,6
0.49,1e-05,404,400,25,10,0.0001,804,6
0.49,1e-05,449,455,25,10,0.0001,904,6
0.49,1e-05,500,504,25,10,0.0001,1004,6
0.49,1e-05,550,554,25,10,0.0001,1104,6
0.492,1e-05,604,600,25,10,0.0001,1204,6
0.494,1e-05,649,655,25,10,0.0001,1304,6
0.492,1e-05,699,705,25,10,0.0001,1404,6
0.494,1e-05,746,758,25,10,0.0001,1504,6
0.494,1e-05,793,811,25,10,0.0001,1604,6
0.494,1e-05,849,855,25,10,0.0001,1704,6
0.496,1e-05,909,895,25,10,0.0001,1804,6
0.498,1e-05,957,947,25,10,0.0001,1904,6
0.496,1e-05,1010,994,25,10,0.0001,2004,6
0.508,1e-05,52,52,25,10,0.0001,104,7
0.508,1e-05,112,92,25,10,0.0001,204,7
0.508,1e-05,159,145,25,10,0.0001,304,7
0.506,1e-05,211,193,25,10,0.0001,404,7
0.506,1e-05,259,245,25,10,0.0001,504,7
0.508,1e-05,313,291,25,10,0.0001,604,7
0.508,1e-05,370,334,25,10,0.0001,704,7
0.508,1e-05,425,379,25,10,0.0001,804,7
0.508,1e-05,475,429,25,10,0.0001,904,7
0.512,1e-05,529,475,25,10,0.0001,1004,7
0.52,1e-05,570,534,25,10,0.0001,1104,7
0.52,1e-05,622,582,25,10,0.0001,1204,7
0.518,1e-05,668,636,25,10,0.0001,1304,7
0.52,1e-05,716,688,25,10,0.0001,1404,7
0.52,1e-05,768,736,25,10,0.0001,1504,7
0.518,1e-05,816,788,25,10,0.0001,1604,7
0.518,1e-05,868,836,25,10,0.0001,1704,7
0.52,1e-05,912,892,25,10,0.0001,1804,7
0.522,1e-05,968,936,25,10,0.0001,1904,7
0.52,1e-05,1018,986,25,10,0.0001,2004,7
0.514,1e-05,51,53,25,10,0.0001,104,8
0.514,1e-05,88,116,25,10,0.0001,204,8
0.514,1e-05,135,169,25,10,0.0001,304,8
0.514,1e-05,181,223,25,10,0.0001,404,8
0.514,1e-05,235,269,25,10,0.0001,504,8
0.512,1e-05,273,331,25,10,0.0001,604,8
0.512,1e-05,324,380,25,10,0.0001,704,8
0.512,1e-05,378,426,25,10,0.0001,804,8
0.512,1e-05,435,469,25,10,0.0001,904,8
0.512,1e-05,478,526,25,10,0.0001,1004,8
0.512,1e-05,523,581,25,10,0.0001,1104,8
0.512,1e-05,578,626,25,10,0.0001,1204,8
0.514,1e-05,629,675,25,10,0.0001,1304,8
0.514,1e-05,686,718,25,10,0.0001,1404,8
0.516,1e-05,739,765,25,10,0.0001,1504,8
0.516,1e-05,794,810,25,10,0.0001,1604,8
0.518,1e-05,842,862,25,10,0.0001,1704,8
0.518,1e-05,888,916,25,10,0.0001,1804,8
0.516,1e-05,948,956,25,10,0.0001,1904,8
0.514,1e-05,997,1007,25,10,0.0001,2004,8
0.458,1e-05,59,45,25,10,0.0001,104,9
0.46,1e-05,112,92,25,10,0.0001,204,9
0.46,1e-05,166,138,25,10,0.0001,304,9
0.46,1e-05,220,184,25,10,0.0001,404,9
0.464,1e-05,266,238,25,10,0.0001,504,9
0.464,1e-05,310,294,25,10,0.0001,604,9
0.466,1e-05,357,347,25,10,0.0001,704,9
0.466,1e-05,409,395,25,10,0.0001,804,9
0.466,1e-05,455,449,25,10,0.0001,904,9
0.466,1e-05,504,500,25,10,0.0001,1004,9
0.466,1e-05,563,541,25,10,0.0001,1104,9
0.468,1e-05,614,590,25,10,0.0001,1204,9
0.468,1e-05,666,638,25,10,0.0001,1304,9
0.468,1e-05,711,693,25,10,0.0001,1404,9
0.468,1e-05,761,743,25,10,0.0001,1504,9
0.47,1e-05,802,802,25,10,0.0001,1604,9
0.472,1e-05,855,849,25,10,0.0001,1704,9
0.472,1e-05,906,898,25,10,0.0001,1804,9
0.474,1e-05,960,944,25,10,0.0001,1904,9
0.474,1e-05,1001,1003,25,10,0.0001,2004,9
0.49,1e-05,51,53,25,10,0.0001,104,10
0.494,1e-05,97,107,25,10,0.0001,204,10
0.494,1e-05,143,161,25,10,0.0001,304,10
0.494,1e-05,189,215,25,10,0.0001,404,10
0.494,1e-05,243,261,25,10,0.0001,504,10
0.494,1e-05,288,316,25,10,0.0001,604,10
0.494,1e-05,331,373,25,10,0.0001,704,10
0.494,1e-05,375,429,25,10,0.0001,804,10
0.494,1e-05,427,477,25,10,0.0001,904,10
0.494,1e-05,479,525,25,10,0.0001,1004,10
0.492,1e-05,524,580,25,10,0.0001,1104,10
0.494,1e-05,576,628,25,10,0.0001,1204,10
0.494,1e-05,629,675,25,10,0.0001,1304,10
0.494,1e-05,681,723,25,10,0.0001,1404,10
0.498,1e-05,729,775,25,10,0.0001,1504,10
0.498,1e-05,781,823,25,10,0.0001,1604,10
0.5,1e-05,830,874,25,10,0.0001,1704,10
0.5,1e-05,882,922,25,10,0.0001,1804,10
0.5,1e-05,935,969,25,10,0.0001,1904,10
0.498,1e-05,984,1020,25,10,0.0001,2004,10
0.494,1e-05,54,50,25,10,0.0001,104,11
0.494,1e-05,109,95,25,10,0.0001,204,11
0.494,1e-05,151,153,25,10,0.0001,304,11
0.494,1e-05,201,203,25,10,0.0001,404,11
0.494,1e-05,247,257,25,10,0.0001,504,11
0.492,1e-05,294,310,25,10,0.0001,604,11
0.494,1e-05,338,366,25,10,0.0001,704,11
0.494,1e-05,395,409,25,10,0.0001,804,11
0.494,1e-05,448,456,25,10,0.0001,904,11
0.494,1e-05,506,498,25,10,0.0001,1004,11
0.494,1e-05,557,547,25,10,0.0001,1104,11
0.494,1e-05,608,596,25,10,0.0001,1204,11
0.494,1e-05,658,646,25,10,0.0001,1304,11
0.494,1e-05,710,694,25,10,0.0001,1404,11
0.494,1e-05,761,743,25,10,0.0001,1504,11
0.496,1e-05,808,796,25,10,0.0001,1604,11
0.496,1e-05,862,842,25,10,0.0001,1704,11
0.498,1e-05,910,894,25,10,0.0001,1804,11
0.496,1e-05,954,950,25,10,0.0001,1904,11
0.498,1e-05,1005,999,25,10,0.0001,2004,11
0.468,1e-05,42,62,25,10,0.0001,104,12
0.468,1e-05,87,117,25,10,0.0001,204,12
0.468,1e-05,141,163,25,10,0.0001,304,12
0.468,1e-05,192,212,25,10,0.0001,404,12
0.468,1e-05,238,266,25,10,0.0001,504,12
0.468,1e-05,288,316,25,10,0.0001,604,12
0.468,1e-05,349,355,25,10,0.0001,704,12
0.468,1e-05,396,408,25,10,0.0001,804,12
0.468,1e-05,448,456,25,10,0.0001,904,12
0.468,1e-05,499,505,25,10,0.0001,1004,12
0.468,1e-05,542,562,25,10,0.0001,1104,12
0.468,1e-05,585,619,25,10,0.0001,1204,12
0.468,1e-05,640,664,25,10,0.0001,1304,12
0.468,1e-05,688,716,25,10,0.0001,1404,12
0.468,1e-05,737,767,25,10,0.0001,1504,12
0.468,1e-05,794,810,25,10,0.0001,1604,12
0.468,1e-05,846,858,25,10,0.0001,1704,12
0.468,1e-05,895,909,25,10,0.0001,1804,12
0.47,1e-05,944,960,25,10,0.0001,1904,12
0.47,1e-05,995,1009,25,10,0.0001,2004,12
0.52,1e-05,68,36,25,10,0.0001,104,13
0.52,1e-05,114,90,25,10,0.0001,204,13
0.52,1e-05,162,142,25,10,0.0001,304,13
0.52,1e-05,212,192,25,10,0.0001,404,13
0.52,1e-05,268,236,25,10,0.0001,504,13
0.52,1e-05,324,280,25,10,0.0001,604,13
0.52,1e-05,374,330,25,10,0.0001,704,13
0.522,1e-05,435,369,25,10,0.0001,804,13
0.522,1e-05,483,421,25,10,0.0001,904,13
0.522,1e-05,521,483,25,10,0.0001,1004,13
0.522,1e-05,571,533,25,10,0.0001,1104,13
0.522,1e-05,628,576,25,10,0.0001,1204,13
0.522,1e-05,678,626,25,10,0.0001,1304,13
0.524,1e-05,726,678,25,10,0.0001,1404,13
0.524,1e-05,782,722,25,10,0.0001,1504,13
0.524,1e-05,821,783,25,10,0.0001,1604,13
0.526,1e-05,864,840,25,10,0.0001,1704,13
0.522,1e-05,907,897,25,10,0.0001,1804,13
0.522,1e-05,949,955,25,10,0.0001,1904,13
0.522,1e-05,993,1011,25,10,0.0001,2004,13
0.496,1e-05,56,48,25,10,0.0001,104,14
0.498,1e-05,110,94,25,10,0.0001,204,14
0.496,1e-05,155,149,25,10,0.0001,304,14
0.498,1e-05,204,200,25,10,0.0001,404,14
0.498,1e-05,256,248,25,10,0.0001,504,14
0.496,1e-05,300,304,25,10,0.0001,604,14
0.496,1e-05,343,361,25,10,0.0001,704,14
0.496,1e-05,393,411,25,10,0.0001,804,14
0.496,1e-05,453,451,25,10,0.0001,904,14
0.496,1e-05,507,497,25,10,0.0001,1004,14
0.496,1e-05,559,545,25,10,0.0001,1104,14
0.496,1e-05,611,593,25,10,0.0001,1204,14
0.498,1e-05,653,651,25,10,0.0001,1304,14
0.496,1e-05,700,704,25,10,0.0001,1404,14
0.496,1e-05,743,761,25,10,0.0001,1504,14
0.496,1e-05,801,803,25,10,0.0001,1604,14
0.496,1e-05,856,848,25,10,0.0001,1704,14
0.496,1e-05,905,899,25,10,0.0001,1804,14
0.494,1e-05,960,944,25,10,0.0001,1904,14
0.496,1e-05,1003,1001,25,10,0.0001,2004,14
0.518,1e-05,54,50,25,10,0.0001,104,15
0.518,1e-05,114,90,25,10,0.0001,204,15
0.518,1e-05,162,142,25,10,0.0001,304,15
0.518,1e-05,209,195,25,10,0.0001,404,15
0.518,1e-05,266,238,25,10,0.0001,504,15
0.518,1e-05,314,290,25,10,0.0001,604,15
0.518,1e-05,360,344,25,10,0.0001,704,15
0.516,1e-05,407,397,25,10,0.0001,804,15
0.516,1e-05,460,444,25,10,0.0001,904,15
0.518,1e-05,514,490,25,10,0.0001,1004,15
0.518,1e-05,557,547,25,10,0.0001,1104,15
0.518,1e-05,604,600,25,10,0.0001,1204,15
0.52,1e-05,656,648,25,10,0.0001,1304,15
0.52,1e-05,707,697,25,10,0.0001,1404,15
0.52,1e-05,755,749,25,10,0.0001,1504,15
0.52,1e-05,803,801,25,10,0.0001,1604,15
0.518,1e-05,844,860,25,10,0.0001,1704,15
0.516,1e-05,881,923,25,10,0.0001,1804,15
0.516,1e-05,930,974,25,10,0.0001,1904,15
0.516,1e-05,979,1025,25,10,0.0001,2004,15
0.514,1e-05,49,55,25,10,0.0001,104,16
0.516,1e-05,104,100,25,10,0.0001,204,16
0.516,1e-05,156,148,25,10,0.0001,304,16
0.516,1e-05,215,189,25,10,0.0001,404,16
0.516,1e-05,264,240,25,10,0.0001,504,16
0.516,1e-05,320,284,25,10,0.0001,604,16
0.516,1e-05,370,334,25,10,0.0001,704,16
0.516,1e-05,422,382,25,10,0.0001,804,16
0.516,1e-05,471,433,25,10,0.0001,904,16
0.518,1e-05,516,488,25,10,0.0001,1004,16
0.52,1e-05,565,539,25,10,0.0001,1104,16
0.52,1e-05,609,595,25,10,0.0001,1204,16
0.52,1e-05,652,652,25,10,0.0001,1304,16
0.522,1e-05,703,701,25,10,0.0001,1404,16
0.522,1e-05,757,747,25,10,0.0001,1504,16
0.522,1e-05,792,812,25,10,0.0001,1604,16
0.52,1e-05,836,868,25,10,0.0001,1704,16
0.52,1e-05,892,912,25,10,0.0001,1804,16
0.52,1e-05,945,959,25,10,0.0001,1904,16
0.522,1e-05,994,1010,25,10,0.0001,2004,16
0.506,1e-05,57,47,25,10,0.0001,104,17
0.506,1e-05,101,103,25,10,0.0001,204,17
0.506,1e-05,148,156,25,10,0.0001,304,17
0.506,1e-05,190,214,25,10,0.0001,404,17
0.506,1e-05,235,269,25,10,0.0001,504,17
0.506,1e-05,286,318,25,10,0.0001,604,17
0.506,1e-05,336,368,25,10,0.0001,704,17
0.506,1e-05,386,418,25,10,0.0001,804,17
0.504,1e-05,434,470,25,10,0.0001,904,17
0.506,1e-05,494,510,25,10,0.0001,1004,17
0.506,1e-05,546,558,25,10,0.0001,1104,17
0.506,1e-05,602,602,25,10,0.0001,1204,17
0.508,1e-05,643,661,25,10,0.0001,1304,17
0.504,1e-05,692,712,25,10,0.0001,1404,17
0.504,1e-05,747,757,25,10,0.0001,1504,17
0.502,1e-05,802,802,25,10,0.0001,1604,17
0.502,1e-05,855,849,25,10,0.0001,1704,17
0.506,1e-05,909,895,25,10,0.0001,1804,17
0.508,1e-05,959,945,25,10,0.0001,1904,17
0.508,1e-05,1005,999,25,10,0.0001,2004,17
0.522,1e-05,52,52,25,10,0.0001,104,18
0.522,1e-05,97,107,25,10,0.0001,204,18
0.522,1e-05,149,155,25,10,0.0001,304,18
0.526,1e-05,196,208,25,10,0.0001,404,18
0.526,1e-05,246,258,25,10,0.0001,504,18
0.528,1e-05,297,307,25,10,0.0001,604,18
0.526,1e-05,346,358,25,10,0.0001,704,18
0.526,1e-05,388,416,25,10,0.0001,804,18
0.53,1e-05,440,464,25,10,0.0001,904,18
0.53,1e-05,498,506,25,10,0.0001,1004,18
0.534,1e-05,548,556,25,10,0.0001,1104,18
0.534,1e-05,598,606,25,10,0.0001,1204,18
0.532,1e-05,648,656,25,10,0.0001,1304,18
0.532,1e-05,696,708,25,10,0.0001,1404,18
0.532,1e-05,748,756,25,10,0.0001,1504,18
0.534,1e-05,801,803,25,10,0.0001,1604,18
0.534,1e-05,845,859,25,10,0.0001,1704,18
0.534,1e-05,902,902,25,10,0.0001,1804,18
0.534,1e-05,951,953,25,10,0.0001,1904,18
0.534,1e-05,1002,1002,25,10,0.0001,2004,18
0.47,1e-05,53,51,25,10,0.0001,104,19
0.468,1e-05,101,103,25,10,0.0001,204,19
0.468,1e-05,144,160,25,10,0.0001,304,19
0.468,1e-05,197,207,25,10,0.0001,404,19
0.47,1e-05,250,254,25,10,0.0001,504,19
0.47,1e-05,292,312,25,10,0.0001,604,19
0.472,1e-05,348,356,25,10,0.0001,704,19
0.472,1e-05,393,411,25,10,0.0001,804,19
0.472,1e-05,453,451,25,10,0.0001,904,19
0.472,1e-05,504,500,25,10,0.0001,1004,19
0.472,1e-05,550,554,25,10,0.0001,1104,19
0.472,1e-05,596,608,25,10,0.0001,1204,19
0.474,1e-05,645,659,25,10,0.0001,1304,19
0.476,1e-05,697,707,25,10,0.0001,1404,19
0.476,1e-05,744,760,25,10,0.0001,1504,19
0.478,1e-05,790,814,25,10,0.0001,1604,19
0.476,1e-05,837,867,25,10,0.0001,1704,19
0.476,1e-05,889,915,25,10,0.0001,1804,19
0.476,1e-05,942,962,25,10,0.0001,1904,19
0.476,1e-05,988,1016,25,10,0.0001,2004,19
0.502,1e-05,51,53,25,10,0.0001,104,20
0.502,1e-05,101,103,25,10,0.0001,204,20
0.504,1e-05,142,162,25,10,0.0001,304,20
0.504,1e-05,195,209,25,10,0.0001,404,20
0.504,1e-05,250,254,25,10,0.0001,504,20
0.504,1e-05,292,312,25,10,0.0001,604,20
0.502,1e-05,348,356,25,10,0.0001,704,20
0.502,1e-05,403,401,25,10,0.0001,804,20
0.502,1e-05,458,446,25,10,0.0001,904,20
0.502,1e-05,511,493,25,10,0.0001,1004,20
0.502,1e-05,567,537,25,10,0.0001,1104,20
0.502,1e-05,624,580,25,10,0.0001,1204,20
0.504,1e-05,676,628,25,10,0.0001,1304,20
0.506,1e-05,723,681,25,10,0.0001,1404,20
0.506,1e-05,769,735,25,10,0.0001,1504,20
0.508,1e-05,825,779,25,10,0.0001,1604,20
0.51,1e-05,873,831,25,10,0.0001,1704,20
0.512,1e-05,908,896,25,10,0.0001,1804,20
0.512,1e-05,967,937,25,10,0.0001,1904,20
0.52,1e-05,1015,989,25,10,0.0001,2004,20
0.514,1e-05,43,61,25,10,0.001,104,1
0.514,1e-05,90,114,25,10,0.001,204,1
0.51,1e-05,139,165,25,10,0.001,304,1
0.51,1e-05,187,217,25,10,0.001,404,1
0.512,1e-05,238,266,25,10,0.001,504,1
0.516,1e-05,289,315,25,10,0.001,604,1
0.518,1e-05,338,366,25,10,0.001,704,1
0.522,1e-05,387,417,25,10,0.001,804,1
0.526,1e-05,445,459,25,10,0.001,904,1
0.532,1e-05,499,505,25,10,0.001,1004,1
0.542,1e-05,555,549,25,10,0.001,1104,1
0.54,1e-05,601,603,25,10,0.001,1204,1
0.544,1e-05,653,651,25,10,0.001,1304,1
0.566,1e-05,702,702,25,10,0.001,1404,1
0.574,1e-05,751,753,25,10,0.001,1504,1
0.576,1e-05,797,807,25,10,0.001,1604,1
0.596,1e-05,854,850,25,10,0.001,1704,1
0.596,1e-05,898,906,25,10,0.001,1804,1
0.606,1e-05,939,965,25,10,0.001,1904,1
0.616,1e-05,990,1014,25,10,0.001,2004,1
0.518,1e-05,51,53,25,10,0.001,104,2
0.514,1e-05,100,104,25,10,0.001,204,2
0.508,1e-05,155,149,25,10,0.001,304,2
0.506,1e-05,207,197,25,10,0.001,404,2
0.504,1e-05,251,253,25,10,0.001,504,2
0.502,1e-05,290,314,25,10,0.001,604,2
0.502,1e-05,337,367,25,10,0.001,704,2
0.508,1e-05,392,412,25,10,0.001,804,2
0.516,1e-05,436,468,25,10,0.001,904,2
0.526,1e-05,496,508,25,10,0.001,1004,2
0.528,1e-05,542,562,25,10,0.001,1104,2
0.536,1e-05,590,614,25,10,0.001,1204,2
0.546,1e-05,648,656,25,10,0.001,1304,2
0.554,1e-05,715,689,25,10,0.001,1404,2
0.556,1e-05,762,742,25,10,0.001,1504,2
0.57,1e-05,807,797,25,10,0.001,1604,2
0.578,1e-05,855,849,25,10,0.001,1704,2
0.592,1e-05,898,906,25,10,0.001,1804,2
0.592,1e-05,942,962,25,10,0.001,1904,2
0.614,1e-05,994,1010,25,10,0.001,2004,2
0.496,1e-05,47,57,25,10,0.001,104,3
0.502,1e-05,94,110,25,10,0.001,204,3
0.508,1e-05,145,159,25,10,0.001,304,3
0.514,1e-05,200,204,25,10,0.001,404,3
0.52,1e-05,243,261,25,10,0.001,504,3
0.518,1e-05,292,312,25,10,0.001,604,3
0.52,1e-05,334,370,25,10,0.001,704,3
0.524,1e-05,377,427,25,10,0.001,804,3
0.528,1e-05,425,479,25,10,0.001,904,3
0.534,1e-05,464,540,25,10,0.001,1004,3
0.54,1e-05,511,593,25,10,0.001,1104,3
0.542,1e-05,560,644,25,10,0.001,1204,3
0.546,1e-05,611,693,25,10,0.001,1304,3
0.552,1e-05,653,751,25,10,0.001,1404,3
0.558,1e-05,709,795,25,10,0.001,1504,3
0.574,1e-05,765,839,25,10,0.001,1604,3
0.574,1e-05,818,886,25,10,0.001,1704,3
0.58,1e-05,873,931,25,10,0.001,1804,3
0.584,1e-05,922,982,25,10,0.001,1904,3
0.59,1e-05,979,1025,25,10,0.001,2004,3
0.484,1e-05,58,46,25,10,0.001,104,4
0.488,1e-05,112,92,25,10,0.001,204,4
0.488,1e-05,158,146,25,10,0.001,304,4
0.492,1e-05,207,197,25,10,0.001,404,4
0.494,1e-05,251,253,25,10,0.001,504,4
0.492,1e-05,303,301,25,10,0.001,604,4
0.494,1e-05,354,350,25,10,0.001,704,4
0.496,1e-05,409,395,25,10,0.001,804,4
0.492,1e-05,458,446,25,10,0.001,904,4
0.498,1e-05,506,498,25,10,0.001,1004,4
0.506,1e-05,553,551,25,10,0.001,1104,4
0.51,1e-05,603,601,25,10,0.001,1204,4
0.512,1e-05,652,652,25,10,0.001,1304,4
0.516,1e-05,694,710,25,10,0.001,1404,4
0.514,1e-05,740,764,25,10,0.001,1504,4
0.514,1e-05,790,814,25,10,0.001,1604,4
0.518,1e-05,839,865,25,10,0.001,1704,4
0.536,1e-05,903,901,25,10,0.001,1804,4
0.546,1e-05,951,953,25,10,0.001,1904,4
0.572,1e-05,1005,999,25,10,0.001,2004,4
0.514,1e-05,51,53,25,10,0.001,104,5
0.512,1e-05,105,99,25,10,0.001,204,5
0.514,1e-05,152,152,25,10,0.001,304,5
0.516,1e-05,203,201,25,10,0.001,404,5
0.516,1e-05,258,246,25,10,0.001,504,5
0.514,1e-05,313,291,25,10,0.001,604,5
0.52,1e-05,364,340,25,10,0.001,704,5
0.522,1e-05,418,386,25,10,0.001,804,5
0.528,1e-05,469,435,25,10,0.001,904,5
0.526,1e-05,516,488,25,10,0.001,1004,5
0.524,1e-05,562,542,25,10,0.001,1104,5
0.528,1e-05,611,593,25,10,0.001,1204,5
0.522,1e-05,661,643,25,10,0.001,1304,5
0.528,1e-05,714,690,25,10,0.001,1404,5
0.526,1e-05,764,740,25,10,0.001,1504,5
0.534,1e-05,814,790,25,10,0.001,1604,5
0.538,1e-05,869,835,25,10,0.001,1704,5
0.548,1e-05,916,888,25,10,0.001,1804,5
0.562,1e-05,966,938,25,10,0.001,1904,5
0.564,1e-05,1013,991,25,10,0.001,2004,5
0.542,1e-05,44,60,25,10,0.001,104,6
0.542,1e-05,95,109,25,10,0.001,204,6
0.54,1e-05,142,162,25,10,0.001,304,6
0.538,1e-05,193,211,25,10,0.001,404,6
0.54,1e-05,247,257,25,10,0.001,504,6
0.538,1e-05,294,310,25,10,0.001,604,6
0.538,1e-05,342,362,25,10,0.001,704,6
0.538,1e-05,390,414,25,10,0.001,804,6
0.536,1e-05,446,458,25,10,0.001,904,6
0.53,1e-05,501,503,25,10,0.001,1004,6
0.53,1e-05,547,557,25,10,0.001,1104,6
0.528,1e-05,590,614,25,10,0.001,1204,6
0.536,1e-05,639,665,25,10,0.001,1304,6
0.536,1e-05,689,715,25,10,0.001,1404,6
0.542,1e-05,738,766,25,10,0.001,1504,6
0.554,1e-05,797,807,25,10,0.001,1604,6
0.56,1e-05,845,859,25,10,0.001,1704,6
0.568,1e-05,897,907,25,10,0.001,1804,6
0.576,1e-05,936,968,25,10,0.001,1904,6
0.582,1e-05,981,1023,25,10,0.001,2004,6
0.498,1e-05,47,57,25,10,0.001,104,7
0.5,1e-05,95,109,25,10,0.001,204,7
0.5,1e-05,144,160,25,10,0.001,304,7
0.5,1e-05,192,212,25,10,0.001,404,7
0.502,1e-05,243,261,25,10,0.001,504,7
0.504,1e-05,301,303,25,10,0.001,604,7
0.504,1e-05,350,354,25,10,0.001,704,7
0.504,1e-05,402,402,25,10,0.001,804,7
0.506,1e-05,454,450,25,10,0.001,904,7
0.514,1e-05,505,499,25,10,0.001,1004,7
0.518,1e-05,559,545,25,10,0.001,1104,7
0.526,1e-05,607,597,25,10,0.001,1204,7
0.53,1e-05,651,653,25,10,0.001,1304,7
0.532,1e-05,703,701,25,10,0.001,1404,7
0.534,1e-05,761,743,25,10,0.001,1504,7
0.544,1e-05,805,799,25,10,0.001,1604,7
0.552,1e-05,852,852,25,10,0.001,1704,7
0.57,1e-05,902,902,25,10,0.001,1804,7
0.582,1e-05,958,946,25,10,0.001,1904,7
0.586,1e-05,998,1006,25,10,0.001,2004,7
0.522,1e-05,53,51,25,10,0.001,104,8
0.522,1e-05,102,102,25,10,0.001,204,8
0.524,1e-05,149,155,25,10,0.001,304,8
0.526,1e-05,208,196,25,10,0.001,404,8
0.526,1e-05,263,241,25,10,0.001,504,8
0.53,1e-05,310,294,25,10,0.001,604,8
0.53,1e-05,356,348,25,10,0.001,704,8
0.532,1e-05,411,393,25,10,0.001,804,8
0.532,1e-05,456,448,25,10,0.001,904,8
0.53,1e-05,507,497,25,10,0.001,1004,8
0.528,1e-05,555,549,25,10,0.001,1104,8
0.53,1e-05,606,598,25,10,0.001,1204,8
0.538,1e-05,658,646,25,10,0.001,1304,8
0.55,1e-05,707,697,25,10,0.001,1404,8
0.554,1e-05,757,747,25,10,0.001,1504,8
0.566,1e-05,810,794,25,10,0.001,1604,8
0.578,1e-05,852,852,25,10,0.001,1704,8
0.594,1e-05,895,909,25,10,0.001,1804,8
0.596,1e-05,949,955,25,10,0.001,1904,8
0.608,1e-05,1003,1001,25,10,0.001,2004,8
0.466,1e-05,53,51,25,10,0.001,104,9
0.474,1e-05,98,106,25,10,0.001,204,9
0.468,1e-05,150,154,25,10,0.001,304,9
0.464,1e-05,199,205,25,10,0.001,404,9
0.466,1e-05,255,249,25,10,0.001,504,9
0.468,1e-05,306,298,25,10,0.001,604,9
0.478,1e-05,349,355,25,10,0.001,704,9
0.478,1e-05,401,403,25,10,0.001,804,9
0.484,1e-05,453,451,25,10,0.001,904,9
0.484,1e-05,496,508,25,10,0.001,1004,9
0.492,1e-05,551,553,25,10,0.001,1104,9
0.496,1e-05,600,604,25,10,0.001,1204,9
0.504,1e-05,648,656,25,10,0.001,1304,9
0.532,1e-05,702,702,25,10,0.001,1404,9
0.552,1e-05,758,746,25,10,0.001,1504,9
0.57,1e-05,803,801,25,10,0.001,1604,9
0.588,1e-05,861,843,25,10,0.001,1704,9
0.61,1e-05,906,898,25,10,0.001,1804,9
0.618,1e-05,959,945,25,10,0.001,1904,9
0.638,1e-05,1010,994,25,10,0.001,2004,9
0.532,1e-05,47,57,25,10,0.001,104,10
0.534,1e-05,93,111,25,10,0.001,204,10
0.544,1e-05,143,161,25,10,0.001,304,10
0.554,1e-05,188,216,25,10,0.001,404,10
0.546,1e-05,235,269,25,10,0.001,504,10
0.558,1e-05,286,318,25,10,0.001,604,10
0.562,1e-05,336,368,25,10,0.001,704,10
0.574,1e-05,381,423,25,10,0.001,804,10
0.58,1e-05,428,476,25,10,0.001,904,10
0.58,1e-05,483,521,25,10,0.001,1004,10
0.584,1e-05,540,564,25,10,0.001,1104,10
0.586,1e-05,592,612,25,10,0.001,1204,10
0.586,1e-05,636,668,25,10,0.001,1304,10
0.61,1e-05,682,722,25,10,0.001,1404,10
0.626,1e-05,739,765,25,10,0.001,1504,10
0.638,1e-05,789,815,25,10,0.001,1604,10
0.644,1e-05,838,866,25,10,0.001,1704,10
0.656,1e-05,886,918,25,10,0.001,1804,10
0.674,1e-05,935,969,25,10,0.001,1904,10
0.684,1e-05,988,1016,25,10,0.001,2004,10
0.522,1e-05,55,49,25,10,0.001,104,11
0.522,1e-05,104,100,25,10,0.001,204,11
0.524,1e-05,150,154,25,10,0.001,304,11
0.522,1e-05,202,202,25,10,0.001,404,11
0.526,1e-05,260,244,25,10,0.001,504,11
0.528,1e-05,307,297,25,10,0.001,604,11
0.53,1e-05,350,354,25,10,0.001,704,11
0.534,1e-05,402,402,25,10,0.001,804,11
0.536,1e-05,442,462,25,10,0.001,904,11
0.538,1e-05,477,527,25,10,0.001,1004,11
0.546,1e-05,528,576,25,10,0.001,1104,11
0.556,1e-05,567,637,25,10,0.001,1204,11
0.566,1e-05,610,694,25,10,0.001,1304,11
0.568,1e-05,666,738,25,10,0.001,1404,11
0.582,1e-05,716,788,25,10,0.001,1504,11
0.592,1e-05,772,832,25,10,0.001,1604,11
0.6,1e-05,816,888,25,10,0.001,1704,11
0.61,1e-05,881,923,25,10,0.001,1804,11
0.626,1e-05,931,973,25,10,0.001,1904,11
0.638,1e-05,977,1027,25,10,0.001,2004,11
0.566,1e-05,44,60,25,10,0.001,104,12
0.568,1e-05,97,107,25,10,0.001,204,12
0.568,1e-05,141,163,25,10,0.001,304,12
0.564,1e-05,192,212,25,10,0.001,404,12
0.566,1e-05,249,255,25,10,0.001,504,12
0.57,1e-05,301,303,25,10,0.001,604,12
0.566,1e-05,349,355,25,10,0.001,704,12
0.574,1e-05,401,403,25,10,0.001,804,12
0.572,1e-05,445,459,25,10,0.001,904,12
0.576,1e-05,496,508,25,10,0.001,1004,12
0.574,1e-05,548,556,25,10,0.001,1104,12
0.574,1e-05,603,601,25,10,0.001,1204,12
0.584,1e-05,657,647,25,10,0.001,1304,12
0.582,1e-05,700,704,25,10,0.001,1404,12
0.588,1e-05,758,746,25,10,0.001,1504,12
0.596,1e-05,808,796,25,10,0.001,1604,12
0.594,1e-05,857,847,25,10,0.001,1704,12
0.596,1e-05,907,897,25,10,0.001,1804,12
0.602,1e-05,954,950,25,10,0.001,1904,12
0.6,1e-05,1012,992,25,10,0.001,2004,12
0.51,1e-05,56,48,25,10,0.001,104,13
0.51,1e-05,102,102,25,10,0.001,204,13
0.51,1e-05,154,150,25,10,0.001,304,13
0.512,1e-05,205,199,25,10,0.001,404,13
0.514,1e-05,248,256,25,10,0.001,504,13
0.514,1e-05,296,308,25,10,0.001,604,13
0.516,1e-05,351,353,25,10,0.001,704,13
0.516,1e-05,402,402,25,10,0.001,804,13
0.518,1e-05,457,447,25,10,0.001,904,13
0.528,1e-05,512,492,25,10,0.001,1004,13
0.524,1e-05,561,543,25,10,0.001,1104,13
0.534,1e-05,606,598,25,10,0.001,1204,13
0.532,1e-05,656,648,25,10,0.001,1304,13
0.536,1e-05,700,704,25,10,0.001,1404,13
0.54,1e-05,751,753,25,10,0.001,1504,13
0.544,1e-05,799,805,25,10,0.001,1604,13
0.554,1e-05,848,856,25,10,0.001,1704,13
0.56,1e-05,900,904,25,10,0.001,1804,13
0.568,1e-05,937,967,25,10,0.001,1904,13
0.584,1e-05,992,1012,25,10,0.001,2004,13
0.508,1e-05,49,55,25,10,0.001,104,14
0.508,1e-05,104,100,25,10,0.001,204,14
0.508,1e-05,160,144,25,10,0.001,304,14
0.51,1e-05,206,198,25,10,0.001,404,14
0.514,1e-05,259,245,25,10,0.001,504,14
0.514,1e-05,311,293,25,10,0.001,604,14
0.512,1e-05,361,343,25,10,0.001,704,14
0.512,1e-05,407,397,25,10,0.001,804,14
0.516,1e-05,462,442,25,10,0.001,904,14
0.514,1e-05,515,489,25,10,0.001,1004,14
0.516,1e-05,568,536,25,10,0.001,1104,14
0.52,1e-05,619,585,25,10,0.001,1204,14
0.52,1e-05,675,629,25,10,0.001,1304,14
0.526,1e-05,722,682,25,10,0.001,1404,14
0.532,1e-05,778,726,25,10,0.001,1504,14
0.546,1e-05,824,780,25,10,0.001,1604,14
0.546,1e-05,868,836,25,10,0.001,1704,14
0.554,1e-05,912,892,25,10,0.001,1804,14
0.558,1e-05,956,948,25,10,0.001,1904,14
0.558,1e-05,1004,1000,25,10,0.001,2004,14
0.462,1e-05,54,50,25,10,0.001,104,15
0.462,1e-05,103,101,25,10,0.001,204,15
0.46,1e-05,153,151,25,10,0.001,304,15
0.456,1e-05,209,195,25,10,0.001,404,15
0.456,1e-05,252,252,25,10,0.001,504,15
0.454,1e-05,307,297,25,10,0.001,604,15
0.454,1e-05,356,348,25,10,0.001,704,15
0.454,1e-05,402,402,25,10,0.001,804,15
0.45,1e-05,450,454,25,10,0.001,904,15
0.452,1e-05,503,501,25,10,0.001,1004,15
0.452,1e-05,549,555,25,10,0.001,1104,15
0.454,1e-05,587,617,25,10,0.001,1204,15
0.456,1e-05,635,669,25,10,0.001,1304,15
0.46,1e-05,685,719,25,10,0.001,1404,15
0.462,1e-05,734,770,25,10,0.001,1504,15
0.456,1e-05,784,820,25,10,0.001,1604,15
0.458,1e-05,836,868,25,10,0.001,1704,15
0.458,1e-05,892,912,25,10,0.001,1804,15
0.46,1e-05,944,960,25,10,0.001,1904,15
0.474,1e-05,999,1005,25,10,0.001,2004,15
0.532,1e-05,58,46,25,10,0.001,104,16
0.536,1e-05,115,89,25,10,0.001,204,16
0.536,1e-05,165,139,25,10,0.001,304,16
0.534,1e-05,208,196,25,10,0.001,404,16
0.536,1e-05,255,249,25,10,0.001,504,16
0.54,1e-05,305,299,25,10,0.001,604,16
0.536,1e-05,355,349,25,10,0.001,704,16
0.532,1e-05,398,406,25,10,0.001,804,16
0.534,1e-05,441,463,25,10,0.001,904,16
0.536,1e-05,485,519,25,10,0.001,1004,16
0.536,1e-05,531,573,25,10,0.001,1104,16
0.544,1e-05,578,626,25,10,0.001,1204,16
0.55,1e-05,632,672,25,10,0.001,1304,16
0.556,1e-05,684,720,25,10,0.001,1404,16
0.57,1e-05,744,760,25,10,0.001,1504,16
0.592,1e-05,783,821,25,10,0.001,1604,16
0.616,1e-05,830,874,25,10,0.001,1704,16
0.618,1e-05,880,924,25,10,0.001,1804,16
0.626,1e-05,938,966,25,10,0.001,1904,16
0.648,1e-05,986,1018,25,10,0.001,2004,16
0.514,1e-05,59,45,25,10,0.001,104,17
0.514,1e-05,104,100,25,10,0.001,204,17
0.52,1e-05,151,153,25,10,0.001,304,17
0.53,1e-05,199,205,25,10,0.001,404,17
0.532,1e-05,249,255,25,10,0.001,504,17
0.538,1e-05,300,304,25,10,0.001,604,17
0.54,1e-05,347,357,25,10,0.001,704,17
0.54,1e-05,401,403,25,10,0.001,804,17
0.542,1e-05,451,453,25,10,0.001,904,17
0.542,1e-05,504,500,25,10,0.001,1004,17
0.544,1e-05,554,550,25,10,0.001,1104,17
0.542,1e-05,606,598,25,10,0.001,1204,17
0.542,1e-05,652,652,25,10,0.001,1304,17
0.55,1e-05,703,701,25,10,0.001,1404,17
0.556,1e-05,760,744,25,10,0.001,1504,17
0.556,1e-05,806,798,25,10,0.001,1604,17
0.572,1e-05,856,848,25,10,0.001,1704,17
0.584,1e-05,899,905,25,10,0.001,1804,17
0.59,1e-05,951,953,25,10,0.001,1904,17
0.604,1e-05,1003,1001,25,10,0.001,2004,17
0.478,1e-05,50,54,25,10,0.001,104,18
0.478,1e-05,97,107,25,10,0.001,204,18
0.48,1e-05,153,151,25,10,0.001,304,18
0.478,1e-05,201,203,25,10,0.001,404,18
0.478,1e-05,249,255,25,10,0.001,504,18
0.478,1e-05,288,316,25,10,0.001,604,18
0.478,1e-05,347,357,25,10,0.001,704,18
0.478,1e-05,401,403,25,10,0.001,804,18
0.478,1e-05,449,455,25,10,0.001,904,18
0.478,1e-05,497,507,25,10,0.001,1004,18
0.478,1e-05,546,558,25,10,0.001,1104,18
0.48,1e-05,590,614,25,10,0.001,1204,18
0.482,1e-05,643,661,25,10,0.001,1304,18
0.486,1e-05,695,709,25,10,0.001,1404,18
0.496,1e-05,749,755,25,10,0.001,1504,18
0.506,1e-05,797,807,25,10,0.001,1604,18
0.512,1e-05,846,858,25,10,0.001,1704,18
0.526,1e-05,894,910,25,10,0.001,1804,18
0.534,1e-05,945,959,25,10,0.001,1904,18
0.562,1e-05,992,1012,25,10,0.001,2004,18
0.47,1e-05,47,57,25,10,0.001,104,19
0.472,1e-05,90,114,25,10,0.001,204,19
0.474,1e-05,139,165,25,10,0.001,304,19
0.472,1e-05,188,216,25,10,0.001,404,19
0.472,1e-05,244,260,25,10,0.001,504,19
0.478,1e-05,291,313,25,10,0.001,604,19
0.48,1e-05,345,359,25,10,0.001,704,19
0.484,1e-05,388,416,25,10,0.001,804,19
0.49,1e-05,438,466,25,10,0.001,904,19
0.498,1e-05,481,523,25,10,0.001,1004,19
0.498,1e-05,532,572,25,10,0.001,1104,19
0.498,1e-05,583,621,25,10,0.001,1204,19
0.498,1e-05,628,676,25,10,0.001,1304,19
0.502,1e-05,683,721,25,10,0.001,1404,19
0.51,1e-05,725,779,25,10,0.001,1504,19
0.518,1e-05,780,824,25,10,0.001,1604,19
0.528,1e-05,823,881,25,10,0.001,1704,19
0.54,1e-05,881,923,25,10,0.001,1804,19
0.55,1e-05,934,970,25,10,0.001,1904,19
0.572,1e-05,985,1019,25,10,0.001,2004,19
0.506,1e-05,48,56,25,10,0.001,104,20
0.506,1e-05,93,111,25,10,0.001,204,20
0.508,1e-05,141,163,25,10,0.001,304,20
0.508,1e-05,184,220,25,10,0.001,404,20
0.506,1e-05,226,278,25,10,0.001,504,20
0.5,1e-05,278,326,25,10,0.001,604,20
0.496,1e-05,328,376,25,10,0.001,704,20
0.492,1e-05,374,430,25,10,0.001,804,20
0.49,1e-05,428,476,25,10,0.001,904,20
0.48,1e-05,479,525,25,10,0.001,1004,20
0.484,1e-05,524,580,25,10,0.001,1104,20
0.49,1e-05,570,634,25,10,0.001,1204,20
0.504,1e-05,623,681,25,10,0.001,1304,20
0.512,1e-05,676,728,25,10,0.001,1404,20
0.518,1e-05,729,775,25,10,0.001,1504,20
0.53,1e-05,782,822,25,10,0.001,1604,20
0.532,1e-05,834,870,25,10,0.001,1704,20
0.542,1e-05,893,911,25,10,0.001,1804,20
0.556,1e-05,944,960,25,10,0.001,1904,20
0.564,1e-05,995,1009,25,10,0.001,2004,20
0.512,1e-05,50,54,25,10,0.01,104,1
0.52,1e-05,97,107,25,10,0.01,204,1
0.518,1e-05,146,158,25,10,0.01,304,1
0.534,1e-05,199,205,25,10,0.01,404,1
0.552,1e-05,248,256,25,10,0.01,504,1
0.558,1e-05,301,303,25,10,0.01,604,1
0.586,1e-05,353,351,25,10,0.01,704,1
0.592,1e-05,392,412,25,10,0.01,804,1
0.614,1e-05,436,468,25,10,0.01,904,1
0.662,1e-05,488,516,25,10,0.01,1004,1
0.708,1e-05,537,567,25,10,0.01,1104,1
0.772,1e-05,586,618,25,10,0.01,1204,1
0.826,1e-05,630,674,25,10,0.01,1304,1
0.86,1e-05,679,725,25,10,0.01,1404,1
0.902,1e-05,716,788,25,10,0.01,1504,1
0.93,1e-05,772,832,25,10,0.01,1604,1
0.944,1e-05,820,884,25,10,0.01,1704,1
0.958,1e-05,877,927,25,10,0.01,1804,1
0.956,1e-05,935,969,25,10,0.01,1904,1
0.964,1e-05,994,1010,25,10,0.01,2004,1
0.518,1e-05,55,49,25,10,0.01,104,2
0.518,1e-05,99,105,25,10,0.01,204,2
0.53,1e-05,151,153,25,10,0.01,304,2
0.532,1e-05,199,205,25,10,0.01,404,2
0.56,1e-05,252,252,25,10,0.01,504,2
0.574,1e-05,299,305,25,10,0.01,604,2
0.598,1e-05,356,348,25,10,0.01,704,2
0.646,1e-05,411,393,25,10,0.01,804,2
0.706,1e-05,464,440,25,10,0.01,904,2
0.748,1e-05,517,487,25,10,0.01,1004,2
0.746,1e-05,563,541,25,10,0.01,1104,2
0.77,1e-05,607,597,25,10,0.01,1204,2
0.82,1e-05,661,643,25,10,0.01,1304,2
0.892,1e-05,707,697,25,10,0.01,1404,2
0.904,1e-05,757,747,25,10,0.01,1504,2
0.92,1e-05,809,795,25,10,0.01,1604,2
0.938,1e-05,863,841,25,10,0.01,1704,2
0.95,1e-05,908,896,25,10,0.01,1804,2
0.954,1e-05,959,945,25,10,0.01,1904,2
0.962,1e-05,1005,999,25,10,0.01,2004,2
0.558,1e-05,45,59,25,10,0.01,104,3
0.556,1e-05,101,103,25,10,0.01,204,3
0.56,1e-05,147,157,25,10,0.01,304,3
0.586,1e-05,197,207,25,10,0.01,404,3
0.588,1e-05,253,251,25,10,0.01,504,3
0.584,1e-05,305,299,25,10,0.01,604,3
0.596,1e-05,349,355,25,10,0.01,704,3
0.634,1e-05,400,404,25,10,0.01,804,3
0.652,1e-05,450,454,25,10,0.01,904,3
0.718,1e-05,502,502,25,10,0.01,1004,3
0.77,1e-05,557,547,25,10,0.01,1104,3
0.826,1e-05,606,598,25,10,0.01,1204,3
0.836,1e-05,645,659,25,10,0.01,1304,3
0.872,1e-05,699,705,25,10,0.01,1404,3
0.904,1e-05,748,756,25,10,0.01,1504,3
0.924,1e-05,796,808,25,10,0.01,1604,3
0.938,1e-05,848,856,25,10,0.01,1704,3
0.944,1e-05,898,906,25,10,0.01,1804,3
0.95,1e-05,953,951,25,10,0.01,1904,3
0.96,1e-05,994,1010,25,10,0.01,2004,3
0.544,1e-05,50,54,25,10,0.01,104,4
0.568,1e-05,103,101,25,10,0.01,204,4
0.568,1e-05,149,155,25,10,0.01,304,4
0.56,1e-05,202,202,25,10,0.01,404,4
0.574,1e-05,259,245,25,10,0.01,504,4
0.586,1e-05,301,303,25,10,0.01,604,4
0.598,1e-05,355,349,25,10,0.01,704,4
0.606,1e-05,401,403,25,10,0.01,804,4
0.64,1e-05,449,455,25,10,0.01,904,4
0.698,1e-05,499,505,25,10,0.01,1004,4
0.738,1e-05,560,544,25,10,0.01,1104,4
0.786,1e-05,606,598,25,10,0.01,1204,4
0.82,1e-05,661,643,25,10,0.01,1304,4
0.858,1e-05,711,693,25,10,0.01,1404,4
0.88,1e-05,755,749,25,10,0.01,1504,4
0.906,1e-05,807,797,25,10,0.01,1604,4
0.916,1e-05,855,849,25,10,0.01,1704,4
0.926,1e-05,898,906,25,10,0.01,1804,4
0.928,1e-05,949,955,25,10,0.01,1904,4
0.932,1e-05,997,1007,25,10,0.01,2004,4
0.53,1e-05,49,55,25,10,0.01,104,5
0.554,1e-05,106,98,25,10,0.01,204,5
0.558,1e-05,156,148,25,10,0.01,304,5
0.546,1e-05,201,203,25,10,0.01,404,5
0.568,1e-05,253,251,25,10,0.01,504,5
0.582,1e-05,304,300,25,10,0.01,604,5
0.6,1e-05,359,345,25,10,0.01,704,5
0.632,1e-05,400,404,25,10,0.01,804,5
0.644,1e-05,454,450,25,10,0.01,904,5
0.69,1e-05,505,499,25,10,0.01,1004,5
0.734,1e-05,560,544,25,10,0.01,1104,5
0.782,1e-05,611,593,25,10,0.01,1204,5
0.832,1e-05,657,647,25,10,0.01,1304,5
0.866,1e-05,699,705,25,10,0.01,1404,5
0.898,1e-05,747,757,25,10,0.01,1504,5
0.928,1e-05,803,801,25,10,0.01,1604,5
0.924,1e-05,853,851,25,10,0.01,1704,5
0.934,1e-05,901,903,25,10,0.01,1804,5
0.946,1e-05,947,957,25,10,0.01,1904,5
0.95,1e-05,999,1005,25,10,0.01,2004,5
0.476,1e-05,47,57,25,10,0.01,104,6
0.48,1e-05,96,108,25,10,0.01,204,6
0.49,1e-05,146,158,25,10,0.01,304,6
0.5,1e-05,197,207,25,10,0.01,404,6
0.538,1e-05,257,247,25,10,0.01,504,6
0.582,1e-05,297,307,25,10,0.01,604,6
0.62,1e-05,341,363,25,10,0.01,704,6
0.652,1e-05,382,422,25,10,0.01,804,6
0.712,1e-05,438,466,25,10,0.01,904,6
0.758,1e-05,486,518,25,10,0.01,1004,6
0.814,1e-05,540,564,25,10,0.01,1104,6
0.854,1e-05,589,615,25,10,0.01,1204,6
0.906,1e-05,632,672,25,10,0.01,1304,6
0.936,1e-05,678,726,25,10,0.01,1404,6
0.928,1e-05,727,777,25,10,0.01,1504,6
0.946,1e-05,776,828,25,10,0.01,1604,6
0.958,1e-05,837,867,25,10,0.01,1704,6
0.966,1e-05,893,911,25,10,0.01,1804,6
0.962,1e-05,944,960,25,10,0.01,1904,6
0.964,1e-05,994,1010,25,10,0.01,2004,6
0.516,1e-05,51,53,25,10,0.01,104,7
0.518,1e-05,107,97,25,10,0.01,204,7
0.526,1e-05,165,139,25,10,0.01,304,7
0.528,1e-05,214,190,25,10,0.01,404,7
0.528,1e-05,263,241,25,10,0.01,504,7
0.592,1e-05,312,292,25,10,0.01,604,7
0.63,1e-05,368,336,25,10,0.01,704,7
0.654,1e-05,419,385,25,10,0.01,804,7
0.664,1e-05,461,443,25,10,0.01,904,7
0.712,1e-05,503,501,25,10,0.01,1004,7
0.772,1e-05,544,560,25,10,0.01,1104,7
0.81,1e-05,589,615,25,10,0.01,1204,7
0.85,1e-05,643,661,25,10,0.01,1304,7
0.88,1e-05,698,706,25,10,0.01,1404,7
0.91,1e-05,751,753,25,10,0.01,1504,7
0.922,1e-05,803,801,25,10,0.01,1604,7
0.934,1e-05,851,853,25,10,0.01,1704,7
0.936,1e-05,897,907,25,10,0.01,1804,7
0.946,1e-05,942,962,25,10,0.01,1904,7
0.952,1e-05,992,1012,25,10,0.01,2004,7
0.482,1e-05,45,59,25,10,0.01,104,8
0.494,1e-05,92,112,25,10,0.01,204,8
0.504,1e-05,136,168,25,10,0.01,304,8
0.524,1e-05,187,217,25,10,0.01,404,8
0.54,1e-05,232,272,25,10,0.01,504,8
0.556,1e-05,276,328,25,10,0.01,604,8
0.566,1e-05,331,373,25,10,0.01,704,8
0.606,1e-05,382,422,25,10,0.01,804,8
0.626,1e-05,435,469,25,10,0.01,904,8
0.682,1e-05,489,515,25,10,0.01,1004,8
0.702,1e-05,538,566,25,10,0.01,1104,8
0.746,1e-05,586,618,25,10,0.01,1204,8
0.808,1e-05,638,666,25,10,0.01,1304,8
0.876,1e-05,686,718,25,10,0.01,1404,8
0.882,1e-05,734,770,25,10,0.01,1504,8
0.896,1e-05,781,823,25,10,0.01,1604,8
0.92,1e-05,831,873,25,10,0.01,1704,8
0.924,1e-05,885,919,25,10,0.01,1804,8
0.936,1e-05,934,970,25,10,0.01,1904,8
0.944,1e-05,986,1018,25,10,0.01,2004,8
0.496,1e-05,62,42,25,10,0.01,104,9
0.496,1e-05,107,97,25,10,0.01,204,9
0.504,1e-05,166,138,25,10,0.01,304,9
0.55,1e-05,222,182,25,10,0.01,404,9
0.546,1e-05,271,233,25,10,0.01,504,9
0.58,1e-05,317,287,25,10,0.01,604,9
0.588,1e-05,365,339,25,10,0.01,704,9
0.602,1e-05,413,391,25,10,0.01,804,9
0.606,1e-05,458,446,25,10,0.01,904,9
0.666,1e-05,506,498,25,10,0.01,1004,9
0.716,1e-05,558,546,25,10,0.01,1104,9
0.75,1e-05,608,596,25,10,0.01,1204,9
0.788,1e-05,666,638,25,10,0.01,1304,9
0.812,1e-05,714,690,25,10,0.01,1404,9
0.838,1e-05,754,750,25,10,0.01,1504,9
0.882,1e-05,802,802,25,10,0.01,1604,9
0.878,1e-05,849,855,25,10,0.01,1704,9
0.902,1e-05,896,908,25,10,0.01,1804,9
0.914,1e-05,953,951,25,10,0.01,1904,9
0.93,1e-05,1003,1001,25,10,0.01,2004,9
0.504,1e-05,54,50,25,10,0.01,104,10
0.516,1e-05,105,99,25,10,0.01,204,10
0.508,1e-05,162,142,25,10,0.01,304,10
0.52,1e-05,212,192,25,10,0.01,404,10
0.538,1e-05,267,237,25,10,0.01,504,10
0.556,1e-05,318,286,25,10,0.01,604,10
0.566,1e-05,358,346,25,10,0.01,704,10
0.594,1e-05,399,405,25,10,0.01,804,10
0.624,1e-05,446,458,25,10,0.01,904,10
0.654,1e-05,506,498,25,10,0.01,1004,10
0.716,1e-05,562,542,25,10,0.01,1104,10
0.774,1e-05,608,596,25,10,0.01,1204,10
0.8,1e-05,664,640,25,10,0.01,1304,10
0.86,1e-05,712,692,25,10,0.01,1404,10
0.884,1e-05,769,735,25,10,0.01,1504,10
0.906,1e-05,816,788,25,10,0.01,1604,10
0.92,1e-05,858,846,25,10,0.01,1704,10
0.934,1e-05,908,896,25,10,0.01,1804,10
0.938,1e-05,961,943,25,10,0.01,1904,10
0.938,1e-05,1011,993,25,10,0.01,2004,10
0.516,1e-05,61,43,25,10,0.01,104,11
0.516,1e-05,109,95,25,10,0.01,204,11
0.518,1e-05,160,144,25,10,0.01,304,11
0.518,1e-05,210,194,25,10,0.01,404,11
0.552,1e-05,265,239,25,10,0.01,504,11
0.578,1e-05,311,293,25,10,0.01,604,11
0.622,1e-05,359,345,25,10,0.01,704,11
0.64,1e-05,407,397,25,10,0.01,804,11
0.674,1e-05,462,442,25,10,0.01,904,11
0.7,1e-05,509,495,25,10,0.01,1004,11
0.726,1e-05,556,548,25,10,0.01,1104,11
0.76,1e-05,600,604,25,10,0.01,1204,11
0.8,1e-05,647,657,25,10,0.01,1304,11
0.832,1e-05,693,711,25,10,0.01,1404,11
0.874,1e-05,747,757,25,10,0.01,1504,11
0.916,1e-05,801,803,25,10,0.01,1604,11
0.92,1e-05,852,852,25,10,0.01,1704,11
0.942,1e-05,902,902,25,10,0.01,1804,11
0.944,1e-05,952,952,25,10,0.01,1904,11
0.944,1e-05,1004,1000,25,10,0.01,2004,11
0.482,1e-05,54,50,25,10,0.01,104,12
0.482,1e-05,106,98,25,10,0.01,204,12
0.486,1e-05,159,145,25,10,0.01,304,12
0.49,1e-05,207,197,25,10,0.01,404,12
0.498,1e-05,248,256,25,10,0.01,504,12
0.52,1e-05,301,303,25,10,0.01,604,12
0.544,1e-05,352,352,25,10,0.01,704,12
0.566,1e-05,396,408,25,10,0.01,804,12
0.632,1e-05,443,461,25,10,0.01,904,12
0.688,1e-05,493,511,25,10,0.01,1004,12
0.732,1e-05,543,561,25,10,0.01,1104,12
0.774,1e-05,588,616,25,10,0.01,1204,12
0.822,1e-05,635,669,25,10,0.01,1304,12
0.886,1e-05,693,711,25,10,0.01,1404,12
0.902,1e-05,748,756,25,10,0.01,1504,12
0.918,1e-05,802,802,25,10,0.01,1604,12
0.934,1e-05,849,855,25,10,0.01,1704,12
0.942,1e-05,894,910,25,10,0.01,1804,12
0.942,1e-05,942,962,25,10,0.01,1904,12
0.946,1e-05,993,1011,25,10,0.01,2004,12
0.506,1e-05,55,49,25,10,0.01,104,13
0.514,1e-05,97,107,25,10,0.01,204,13
0.514,1e-05,151,153,25,10,0.01,304,13
0.55,1e-05,206,198,25,10,0.01,404,13
0.572,1e-05,255,249,25,10,0.01,504,13
0.584,1e-05,297,307,25,10,0.01,604,13
0.61,1e-05,346,358,25,10,0.01,704,13
0.64,1e-05,398,406,25,10,0.01,804,13
0.664,1e-05,446,458,25,10,0.01,904,13
0.682,1e-05,497,507,25,10,0.01,1004,13
0.728,1e-05,549,555,25,10,0.01,1104,13
0.77,1e-05,596,608,25,10,0.01,1204,13
0.818,1e-05,651,653,25,10,0.01,1304,13
0.862,1e-05,707,697,25,10,0.01,1404,13
0.892,1e-05,756,748,25,10,0.01,1504,13
0.92,1e-05,811,793,25,10,0.01,1604,13
0.936,1e-05,861,843,25,10,0.01,1704,13
0.948,1e-05,910,894,25,10,0.01,1804,13
0.962,1e-05,960,944,25,10,0.01,1904,13
0.966,1e-05,1011,993,25,10,0.01,2004,13
0.494,1e-05,55,49,25,10,0.01,104,14
0.504,1e-05,106,98,25,10,0.01,204,14
0.516,1e-05,165,139,25,10,0.01,304,14
0.53,1e-05,208,196,25,10,0.01,404,14
0.55,1e-05,259,245,25,10,0.01,504,14
0.582,1e-05,316,288,25,10,0.01,604,14
0.6,1e-05,358,346,25,10,0.01,704,14
0.614,1e-05,411,393,25,10,0.01,804,14
0.652,1e-05,462,442,25,10,0.01,904,14
0.69,1e-05,508,496,25,10,0.01,1004,14
0.738,1e-05,550,554,25,10,0.01,1104,14
0.788,1e-05,604,600,25,10,0.01,1204,14
0.824,1e-05,656,648,25,10,0.01,1304,14
0.858,1e-05,708,696,25,10,0.01,1404,14
0.88,1e-05,759,745,25,10,0.01,1504,14
0.906,1e-05,808,796,25,10,0.01,1604,14
0.926,1e-05,858,846,25,10,0.01,1704,14
0.948,1e-05,912,892,25,10,0.01,1804,14
0.96,1e-05,968,936,25,10,0.01,1904,14
0.962,1e-05,1014,990,25,10,0.01,2004,14
0.512,1e-05,62,42,25,10,0.01,104,15
0.518,1e-05,123,81,25,10,0.01,204,15
0.518,1e-05,173,131,25,10,0.01,304,15
0.52,1e-05,220,184,25,10,0.01,404,15
0.526,1e-05,275,229,25,10,0.01,504,15
0.548,1e-05,314,290,25,10,0.01,604,15
0.6,1e-05,356,348,25,10,0.01,704,15
0.664,1e-05,406,398,25,10,0.01,804,15
0.718,1e-05,451,453,25,10,0.01,904,15
0.778,1e-05,498,506,25,10,0.01,1004,15
0.824,1e-05,547,557,25,10,0.01,1104,15
0.88,1e-05,596,608,25,10,0.01,1204,15
0.91,1e-05,649,655,25,10,0.01,1304,15
0.928,1e-05,692,712,25,10,0.01,1404,15
0.936,1e-05,744,760,25,10,0.01,1504,15
0.94,1e-05,798,806,25,10,0.01,1604,15
0.95,1e-05,844,860,25,10,0.01,1704,15
0.958,1e-05,897,907,25,10,0.01,1804,15
0.968,1e-05,944,960,25,10,0.01,1904,15
0.966,1e-05,999,1005,25,10,0.01,2004,15
0.496,1e-05,62,42,25,10,0.01,104,16
0.496,1e-05,109,95,25,10,0.01,204,16
0.518,1e-05,162,142,25,10,0.01,304,16
0.546,1e-05,219,185,25,10,0.01,404,16
0.558,1e-05,277,227,25,10,0.01,504,16
0.562,1e-05,338,266,25,10,0.01,604,16
0.58,1e-05,375,329,25,10,0.01,704,16
0.616,1e-05,422,382,25,10,0.01,804,16
0.674,1e-05,465,439,25,10,0.01,904,16
0.696,1e-05,510,494,25,10,0.01,1004,16
0.694,1e-05,566,538,25,10,0.01,1104,16
0.73,1e-05,621,583,25,10,0.01,1204,16
0.752,1e-05,666,638,25,10,0.01,1304,16
0.788,1e-05,712,692,25,10,0.01,1404,16
0.816,1e-05,753,751,25,10,0.01,1504,16
0.838,1e-05,803,801,25,10,0.01,1604,16
0.844,1e-05,865,839,25,10,0.01,1704,16
0.864,1e-05,907,897,25,10,0.01,1804,16
0.888,1e-05,960,944,25,10,0.01,1904,16
0.908,1e-05,1004,1000,25,10,0.01,2004,16
0.512,1e-05,54,50,25,10,0.01,104,17
0.526,1e-05,104,100,25,10,0.01,204,17
0.534,1e-05,155,149,25,10,0.01,304,17
0.544,1e-05,199,205,25,10,0.01,404,17
0.578,1e-05,256,248,25,10,0.01,504,17
0.58,1e-05,299,305,25,10,0.01,604,17
0.598,1e-05,343,361,25,10,0.01,704,17
0.608,1e-05,388,416,25,10,0.01,804,17
0.64,1e-05,436,468,25,10,0.01,904,17
0.662,1e-05,486,518,25,10,0.01,1004,17
0.678,1e-05,547,557,25,10,0.01,1104,17
0.716,1e-05,595,609,25,10,0.01,1204,17
0.754,1e-05,652,652,25,10,0.01,1304,17
0.8,1e-05,696,708,25,10,0.01,1404,17
0.806,1e-05,743,761,25,10,0.01,1504,17
0.85,1e-05,797,807,25,10,0.01,1604,17
0.868,1e-05,843,861,25,10,0.01,1704,17
0.904,1e-05,897,907,25,10,0.01,1804,17
0.908,1e-05,951,953,25,10,0.01,1904,17
0.908,1e-05,998,1006,25,10,0.01,2004,17
0.502,1e-05,47,57,25,10,0.01,104,18
0.494,1e-05,102,102,25,10,0.01,204,18
0.486,1e-05,153,151,25,10,0.01,304,18
0.506,1e-05,200,204,25,10,0.01,404,18
0.51,1e-05,244,260,25,10,0.01,504,18
0.526,1e-05,298,306,25,10,0.01,604,18
0.53,1e-05,349,355,25,10,0.01,704,18
0.554,1e-05,402,402,25,10,0.01,804,18
0.602,1e-05,454,450,25,10,0.01,904,18
0.638,1e-05,513,491,25,10,0.01,1004,18
0.688,1e-05,558,546,25,10,0.01,1104,18
0.73,1e-05,600,604,25,10,0.01,1204,18
0.772,1e-05,657,647,25,10,0.01,1304,18
0.808,1e-05,714,690,25,10,0.01,1404,18
0.848,1e-05,762,742,25,10,0.01,1504,18
0.878,1e-05,810,794,25,10,0.01,1604,18
0.884,1e-05,859,845,25,10,0.01,1704,18
0.912,1e-05,919,885,25,10,0.01,1804,18
0.924,1e-05,967,937,25,10,0.01,1904,18
0.934,1e-05,1010,994,25,10,0.01,2004,18
0.528,1e-05,51,53,25,10,0.01,104,19
0.534,1e-05,105,99,25,10,0.01,204,19
0.534,1e-05,158,146,25,10,0.01,304,19
0.556,1e-05,214,190,25,10,0.01,404,19
0.56,1e-05,268,236,25,10,0.01,504,19
0.584,1e-05,316,288,25,10,0.01,604,19
0.614,1e-05,368,336,25,10,0.01,704,19
0.624,1e-05,413,391,25,10,0.01,804,19
0.658,1e-05,462,442,25,10,0.01,904,19
0.688,1e-05,504,500,25,10,0.01,1004,19
0.702,1e-05,551,553,25,10,0.01,1104,19
0.74,1e-05,598,606,25,10,0.01,1204,19
0.764,1e-05,652,652,25,10,0.01,1304,19
0.82,1e-05,699,705,25,10,0.01,1404,19
0.838,1e-05,749,755,25,10,0.01,1504,19
0.86,1e-05,791,813,25,10,0.01,1604,19
0.876,1e-05,843,861,25,10,0.01,1704,19
0.91,1e-05,886,918,25,10,0.01,1804,19
0.918,1e-05,936,968,25,10,0.01,1904,19
0.932,1e-05,983,1021,25,10,0.01,2004,19
0.494,1e-05,42,62,25,10,0.01,104,20
0.51,1e-05,87,117,25,10,0.01,204,20
0.514,1e-05,138,166,25,10,0.01,304,20
0.534,1e-05,198,206,25,10,0.01,404,20
0.562,1e-05,244,260,25,10,0.01,504,20
0.574,1e-05,288,316,25,10,0.01,604,20
0.606,1e-05,332,372,25,10,0.01,704,20
0.626,1e-05,383,421,25,10,0.01,804,20
0.652,1e-05,437,467,25,10,0.01,904,20
0.71,1e-05,485,519,25,10,0.01,1004,20
0.752,1e-05,535,569,25,10,0.01,1104,20
0.79,1e-05,592,612,25,10,0.01,1204,20
0.82,1e-05,643,661,25,10,0.01,1304,20
0.852,1e-05,695,709,25,10,0.01,1404,20
0.892,1e-05,747,757,25,10,0.01,1504,20
0.91,1e-05,798,806,25,10,0.01,1604,20
0.922,1e-05,846,858,25,10,0.01,1704,20
0.932,1e-05,901,903,25,10,0.01,1804,20
0.946,1e-05,957,947,25,10,0.01,1904,20
0.946,1e-05,1003,1001,25,10,0.01,2004,20
0.49,0.0001,56,48,25,10,0.0001,104,1
0.49,0.0001,105,99,25,10,0.0001,204,1
0.49,0.0001,155,149,25,10,0.0001,304,1
0.49,0.0001,206,198,25,10,0.0001,404,1
0.49,0.0001,256,248,25,10,0.0001,504,1
0.49,0.0001,295,309,25,10,0.0001,604,1
0.49,0.0001,346,358,25,10,0.0001,704,1
0.49,0.0001,396,408,25,10,0.0001,804,1
0.488,0.0001,443,461,25,10,0.0001,904,1
0.488,0.0001,496,508,25,10,0.0001,1004,1
0.488,0.0001,549,555,25,10,0.0001,1104,1
0.488,0.0001,605,599,25,10,0.0001,1204,1
0.49,0.0001,656,648,25,10,0.0001,1304,1
0.492,0.0001,709,695,25,10,0.0001,1404,1
0.492,0.0001,763,741,25,10,0.0001,1504,1
0.49,0.0001,812,792,25,10,0.0001,1604,1
0.492,0.0001,862,842,25,10,0.0001,1704,1
0.49,0.0001,913,891,25,10,0.0001,1804,1
0.488,0.0001,953,951,25,10,0.0001,1904,1
0.49,0.0001,999,1005,25,10,0.0001,2004,1
0.508,0.0001,54,50,25,10,0.0001,104,2
0.508,0.0001,103,101,25,10,0.0001,204,2
0.508,0.0001,162,142,25,10,0.0001,304,2
0.508,0.0001,212,192,25,10,0.0001,404,2
0.508,0.0001,260,244,25,10,0.0001,504,2
0.51,0.0001,311,293,25,10,0.0001,604,2
0.51,0.0001,361,343,25,10,0.0001,704,2
0.51,0.0001,409,395,25,10,0.0001,804,2
0.51,0.0001,458,446,25,10,0.0001,904,2
0.51,0.0001,507,497,25,10,0.0001,1004,2
0.512,0.0001,549,555,25,10,0.0001,1104,2
0.512,0.0001,597,607,25,10,0.0001,1204,2
0.512,0.0001,652,652,25,10,0.0001,1304,2
0.512,0.0001,704,700,25,10,0.0001,1404,2
0.514,0.0001,752,752,25,10,0.0001,1504,2
0.514,0.0001,803,801,25,10,0.0001,1604,2
0.514,0.0001,854,850,25,10,0.0001,1704,2
0.514,0.0001,906,898,25,10,0.0001,1804,2
0.518,0.0001,962,942,25,10,0.0001,1904,2
0.518,0.0001,1010,994,25,10,0.0001,2004,2
0.478,0.0001,61,43,25,10,0.0001,104,3
0.478,0.0001,109,95,25,10,0.0001,204,3
0.478,0.0001,154,150,25,10,0.0001,304,3
0.478,0.0001,203,201,25,10,0.0001,404,3
0.48,0.0001,244,260,25,10,0.0001,504,3
0.48,0.0001,297,307,25,10,0.0001,604,3
0.482,0.0001,348,356,25,10,0.0001,704,3
0.482,0.0001,401,403,25,10,0.0001,804,3
0.482,0.0001,441,463,25,10,0.0001,904,3
0.48,0.0001,497,507,25,10,0.0001,1004,3
0.48,0.0001,556,548,25,10,0.0001,1104,3
0.48,0.0001,605,599,25,10,0.0001,1204,3
0.48,0.0001,651,653,25,10,0.0001,1304,3
0.482,0.0001,696,708,25,10,0.0001,1404,3
0.484,0.0001,746,758,25,10,0.0001,1504,3
0.486,0.0001,789,815,25,10,0.0001,1604,3
0.486,0.0001,839,865,25,10,0.0001,1704,3
0.488,0.0001,898,906,25,10,0.0001,1804,3
0.49,0.0001,954,950,25,10,0.0001,1904,3
0.49,0.0001,1002,1002,25,10,0.0001,2004,3
0.482,0.0001,47,57,25,10,0.0001,104,4
0.482,0.0001,94,110,25,10,0.0001,204,4
0.482,0.0001,149,155,25,10,0.0001,304,4
0.482,0.0001,197,207,25,10,0.0001,404,4
0.48,0.0001,246,258,25,10,0.0001,504,4
0.48,0.0001,290,314,25,10,0.0001,604,4
0.48,0.0001,337,367,25,10,0.0001,704,4
0.48,0.0001,387,417,25,10,0.0001,804,4
0.48,0.0001,433,471,25,10,0.0001,904,4
0.48,0.0001,483,521,25,10,0.0001,1004,4
0.48,0.0001,532,572,25,10,0.0001,1104,4
0.482,0.0001,585,619,25,10,0.0001,1204,4
0.484,0.0001,640,664,25,10,0.0001,1304,4
0.486,0.0001,686,718,25,10,0.0001,1404,4
0.488,0.0001,736,768,25,10,0.0001,1504,4
0.484,0.0001,792,812,25,10,0.0001,1604,4
0.484,0.0001,831,873,25,10,0.0001,1704,4
0.486,0.0001,888,916,25,10,0.0001,1804,4
0.486,0.0001,944,960,25,10,0.0001,1904,4
0.488,0.0001,1000,1004,25,10,0.0001,2004,4
0.538,0.0001,42,62,25,10,0.0001,104,5
0.536,0.0001,95,109,25,10,0.0001,204,5
0.534,0.0001,146,158,25,10,0.0001,304,5
0.534,0.0001,205,199,25,10,0.0001,404,5
0.534,0.0001,253,251,25,10,0.0001,504,5
0.534,0.0001,310,294,25,10,0.0001,604,5
0.534,0.0001,360,344,25,10,0.0001,704,5
0.534,0.0001,401,403,25,10,0.0001,804,5
0.534,0.0001,449,455,25,10,0.0001,904,5
0.538,0.0001,499,505,25,10,0.0001,1004,5
0.538,0.0001,553,551,25,10,0.0001,1104,5
0.54,0.0001,599,605,25,10,0.0001,1204,5
0.54,0.0001,639,665,25,10,0.0001,1304,5
0.544,0.0001,693,711,25,10,0.0001,1404,5
0.542,0.0001,748,756,25,10,0.0001,1504,5
0.546,0.0001,805,799,25,10,0.0001,1604,5
0.548,0.0001,849,855,25,10,0.0001,1704,5
0.55,0.0001,896,908,25,10,0.0001,1804,5
0.546,0.0001,942,962,25,10,0.0001,1904,5
0.546,0.0001,990,1014,25,10,0.0001,2004,5
0.51,0.0001,54,50,25,10,0.0001,104,6
0.51,0.0001,112,92,25,10,0.0001,204,6
0.51,0.0001,164,140,25,10,0.0001,304,6
0.51,0.0001,205,199,25,10,0.0001,404,6
0.51,0.0001,255,249,25,10,0.0001,504,6
0.51,0.0001,304,300,25,10,0.0001,604,6
0.51,0.0001,349,355,25,10,0.0001,704,6
0.51,0.0001,408,396,25,10,0.0001,804,6
0.51,0.0001,457,447,25,10,0.0001,904,6
0.51,0.0001,509,495,25,10,0.0001,1004,6
0.51,0.0001,562,542,25,10,0.0001,1104,6
0.51,0.0001,612,592,25,10,0.0001,1204,6
0.51,0.0001,666,638,25,10,0.0001,1304,6
0.51,0.0001,720,684,25,10,0.0001,1404,6
0.51,0.0001,765,739,25,10,0.0001,1504,6
0.51,0.0001,817,787,25,10,0.0001,1604,6
0.512,0.0001,867,837,25,10,0.0001,1704,6
0.512,0.0001,914,890,25,10,0.0001,1804,6
0.512,0.0001,957,947,25,10,0.0001,1904,6
0.512,0.0001,1008,996,25,10,0.0001,2004,6
0.446,0.0001,41,63,25,10,0.0001,104,7
0.446,0.0001,95,109,25,10,0.0001,204,7
0.446,0.0001,146,158,25,10,0.0001,304,7
0.446,0.0001,200,204,25,10,0.0001,404,7
0.446,0.0001,245,259,25,10,0.0001,504,7
0.446,0.0001,296,308,25,10,0.0001,604,7
0.446,0.0001,345,359,25,10,0.0001,704,7
0.446,0.0001,390,414,25,10,0.0001,804,7
0.446,0.0001,446,458,25,10,0.0001,904,7
0.446,0.0001,490,514,25,10,0.0001,1004,7
0.446,0.0001,552,552,25,10,0.0001,1104,7
0.446,0.0001,600,604,25,10,0.0001,1204,7
0.45,0.0001,651,653,25,10,0.0001,1304,7
0.45,0.0001,697,707,25,10,0.0001,1404,7
0.454,0.0001,745,759,25,10,0.0001,1504,7
0.456,0.0001,792,812,25,10,0.0001,1604,7
0.458,0.0001,844,860,25,10,0.0001,1704,7
0.46,0.0001,895,909,25,10,0.0001,1804,7
0.46,0.0001,943,961,25,10,0.0001,1904,7
0.462,0.0001,997,1007,25,10,0.0001,2004,7
0.474,0.0001,47,57,25,10,0.0001,104,8
0.474,0.0001,98,106,25,10,0.0001,204,8
0.476,0.0001,151,153,25,10,0.0001,304,8
0.474,0.0001,205,199,25,10,0.0001,404,8
0.474,0.0001,251,253,25,10,0.0001,504,8
0.474,0.0001,297,307,25,10,0.0001,604,8
0.476,0.0001,353,351,25,10,0.0001,704,8
0.478,0.0001,408,396,25,10,0.0001,804,8
0.478,0.0001,464,440,25,10,0.0001,904,8
0.478,0.0001,514,490,25,10,0.0001,1004,8
0.478,0.0001,559,545,25,10,0.0001,1104,8
0.478,0.0001,615,589,25,10,0.0001,1204,8
0.478,0.0001,668,636,25,10,0.0001,1304,8
0.478,0.0001,721,683,25,10,0.0001,1404,8
0.476,0.0001,765,739,25,10,0.0001,1504,8
0.476,0.0001,806,798,25,10,0.0001,1604,8
0.476,0.0001,868,836,25,10,0.0001,1704,8
0.478,0.0001,913,891,25,10,0.0001,1804,8
0.478,0.0001,960,944,25,10,0.0001,1904,8
0.48,0.0001,996,1008,25,10,0.0001,2004,8
0.5,0.0001,59,45,25,10,0.0001,104,9
0.5,0.0001,110,94,25,10,0.0001,204,9
0.5,0.0001,165,139,25,10,0.0001,304,9
0.498,0.0001,211,193,25,10,0.0001,404,9
0.498,0.0001,254,250,25,10,0.0001,504,9
0.498,0.0001,308,296,25,10,0.0001,604,9
0.498,0.0001,354,350,25,10,0.0001,704,9
0.498,0.0001,403,401,25,10,0.0001,804,9
0.498,0.0001,447,457,25,10,0.0001,904,9
0.496,0.0001,493,511,25,10,0.0001,1004,9
0.496,0.0001,540,564,25,10,0.0001,1104,9
0.496,0.0001,591,613,25,10,0.0001,1204,9
0.496,0.0001,642,662,25,10,0.0001,1304,9
0.496,0.0001,698,706,25,10,0.0001,1404,9
0.496,0.0001,745,759,25,10,0.0001,1504,9
0.498,0.0001,789,815,25,10,0.0001,1604,9
0.498,0.0001,847,857,25,10,0.0001,1704,9
0.5,0.0001,896,908,25,10,0.0001,1804,9
0.5,0.0001,947,957,25,10,0.0001,1904,9
0.496,0.0001,998,1006,25,10,0.0001,2004,9
0.454,0.0001,52,52,25,10,0.0001,104,10
0.454,0.0001,107,97,25,10,0.0001,204,10
0.454,0.0001,162,142,25,10,0.0001,304,10
0.454,0.0001,209,195,25,10,0.0001,404,10
0.454,0.0001,263,241,25,10,0.0001,504,10
0.454,0.0001,309,295,25,10,0.0001,604,10
0.454,0.0001,355,349,25,10,0.0001,704,10
0.454,0.0001,411,393,25,10,0.0001,804,10
0.454,0.0001,461,443,25,10,0.0001,904,10
0.454,0.0001,511,493,25,10,0.0001,1004,10
0.454,0.0001,557,547,25,10,0.0001,1104,10
0.454,0.0001,617,587,25,10,0.0001,1204,10
0.454,0.0001,670,634,25,10,0.0001,1304,10
0.454,0.0001,729,675,25,10,0.0001,1404,10
0.454,0.0001,775,729,25,10,0.0001,1504,10
0.454,0.0001,827,777,25,10,0.0001,1604,10
0.454,0.0001,886,818,25,10,0.0001,1704,10
0.454,0.0001,932,872,25,10,0.0001,1804,10
0.454,0.0001,976,928,25,10,0.0001,1904,10
0.454,0.0001,1025,979,25,10,0.0001,2004,10
0.494,0.0001,55,49,25,10,0.0001,104,11
0.494,0.0001,101,103,25,10,0.0001,204,11
0.494,0.0001,158,146,25,10,0.0001,304,11
0.494,0.0001,212,192,25,10,0.0001,404,11
0.494,0.0001,263,241,25,10,0.0001,504,11
0.494,0.0001,322,282,25,10,0.0001,604,11
0.492,0.0001,378,326,25,10,0.0001,704,11
0.494,0.0001,429,375,25,10,0.0001,804,11
0.496,0.0001,484,420,25,10,0.0001,904,11
0.498,0.0001,530,474,25,10,0.0001,1004,11
0.496,0.0001,572,532,25,10,0.0001,1104,11
0.496,0.0001,618,586,25,10,0.0001,1204,11
0.498,0.0001,667,637,25,10,0.0001,1304,11
0.498,0.0001,714,690,25,10,0.0001,1404,11
0.498,0.0001,763,741,25,10,0.0001,1504,11
0.498,0.0001,815,789,25,10,0.0001,1604,11
0.5,0.0001,866,838,25,10,0.0001,1704,11
0.5,0.0001,909,895,25,10,0.0001,1804,11
0.5,0.0001,958,946,25,10,0.0001,1904,11
0.5,0.0001,1011,993,25,10,0.0001,2004,11
0.462,0.0001,45,59,25,10,0.0001,104,12
0.464,0.0001,91,113,25,10,0.0001,204,12
0.464,0.0001,140,164,25,10,0.0001,304,12
0.466,0.0001,192,212,25,10,0.0001,404,12
0.466,0.0001,246,258,25,10,0.0001,504,12
0.466,0.0001,292,312,25,10,0.0001,604,12
0.464,0.0001,360,344,25,10,0.0001,704,12
0.464,0.0001,412,392,25,10,0.0001,804,12
0.464,0.0001,466,438,25,10,0.0001,904,12
0.464,0.0001,513,491,25,10,0.0001,1004,12
0.462,0.0001,563,541,25,10,0.0001,1104,12
0.464,0.0001,610,594,25,10,0.0001,1204,12
0.468,0.0001,664,640,25,10,0.0001,1304,12
0.468,0.0001,709,695,25,10,0.0001,1404,12
0.468,0.0001,757,747,25,10,0.0001,1504,12
0.47,0.0001,810,794,25,10,0.0001,1604,12
0.472,0.0001,860,844,25,10,0.0001,1704,12
0.478,0.0001,902,902,25,10,0.0001,1804,12
0.472,0.0001,955,949,25,10,0.0001,1904,12
0.474,0.0001,1011,993,25,10,0.0001,2004,12
0.538,0.0001,56,48,25,10,0.0001,104,13
0.538,0.0001,104,100,25,10,0.0001,204,13
0.538,0.0001,151,153,25,10,0.0001,304,13
0.538,0.0001,208,196,25,10,0.0001,404,13
0.538,0.0001,268,236,25,10,0.0001,504,13
0.538,0.0001,314,290,25,10,0.0001,604,13
0.538,0.0001,366,338,25,10,0.0001,704,13
0.538,0.0001,419,385,25,10,0.0001,804,13
0.538,0.0001,476,428,25,10,0.0001,904,13
0.538,0.0001,521,483,25,10,0.0001,1004,13
0.54,0.0001,570,534,25,10,0.0001,1104,13
0.54,0.0001,623,581,25,10,0.0001,1204,13
0.54,0.0001,670,634,25,10,0.0001,1304,13
0.54,0.0001,722,682,25,10,0.0001,1404,13
0.54,0.0001,781,723,25,10,0.0001,1504,13
0.542,0.0001,834,770,25,10,0.0001,1604,13
0.542,0.0001,878,826,25,10,0.0001,1704,13
0.542,0.0001,929,875,25,10,0.0001,1804,13
0.542,0.0001,968,936,25,10,0.0001,1904,13
0.542,0.0001,1021,983,25,10,0.0001,2004,13
0.494,0.0001,51,53,25,10,0.0001,104,14
0.494,0.0001,103,101,25,10,0.0001,204,14
0.496,0.0001,148,156,25,10,0.0001,304,14
0.496,0.0001,200,204,25,10,0.0001,404,14
0.496,0.0001,249,255,25,10,0.0001,504,14
0.498,0.0001,301,303,25,10,0.0001,604,14
0.498,0.0001,350,354,25,10,0.0001,704,14
0.498,0.0001,404,400,25,10,0.0001,804,14
0.496,0.0001,457,447,25,10,0.0001,904,14
0.494,0.0001,505,499,25,10,0.0001,1004,14
0.494,0.0001,554,550,25,10,0.0001,1104,14
0.494,0.0001,603,601,25,10,0.0001,1204,14
0.496,0.0001,650,654,25,10,0.0001,1304,14
0.498,0.0001,698,706,25,10,0.0001,1404,14
0.498,0.0001,751,753,25,10,0.0001,1504,14
0.494,0.0001,799,805,25,10,0.0001,1604,14
0.494,0.0001,850,854,25,10,0.0001,1704,14
0.494,0.0001,904,900,25,10,0.0001,1804,14
0.494,0.0001,948,956,25,10,0.0001,1904,14
0.494,0.0001,1003,1001,25,10,0.0001,2004,14
0.474,0.0001,55,49,25,10,0.0001,104,15
0.474,0.0001,106,98,25,10,0.0001,204,15
0.474,0.0001,158,146,25,10,0.0001,304,15
0.474,0.0001,209,195,25,10,0.0001,404,15
0.474,0.0001,261,243,25,10,0.0001,504,15
0.474,0.0001,308,296,25,10,0.0001,604,15
0.474,0.0001,354,350,25,10,0.0001,704,15
0.474,0.0001,406,398,25,10,0.0001,804,15
0.474,0.0001,454,450,25,10,0.0001,904,15
0.474,0.0001,504,500,25,10,0.0001,1004,15
0.474,0.0001,559,545,25,10,0.0001,1104,15
0.474,0.0001,609,595,25,10,0.0001,1204,15
0.474,0.0001,658,646,25,10,0.0001,1304,15
0.474,0.0001,710,694,25,10,0.0001,1404,15
0.474,0.0001,755,749,25,10,0.0001,1504,15
0.474,0.0001,796,808,25,10,0.0001,1604,15
0.474,0.0001,844,860,25,10,0.0001,1704,15
0.476,0.0001,892,912,25,10,0.0001,1804,15
0.476,0.0001,938,966,25,10,0.0001,1904,15
0.478,0.0001,990,1014,25,10,0.0001,2004,15
0.488,0.0001,54,50,25,10,0.0001,104,16
0.49,0.0001,107,97,25,10,0.0001,204,16
0.49,0.0001,162,142,25,10,0.0001,304,16
0.49,0.0001,206,198,25,10,0.0001,404,16
0.488,0.0001,262,242,25,10,0.0001,504,16
0.488,0.0001,313,291,25,10,0.0001,604,16
0.492,0.0001,357,347,25,10,0.0001,704,16
0.492,0.0001,404,400,25,10,0.0001,804,16
0.494,0.0001,451,453,25,10,0.0001,904,16
0.492,0.0001,504,500,25,10,0.0001,1004,16
0.494,0.0001,556,548,25,10,0.0001,1104,16
0.5,0.0001,601,603,25,10,0.0001,1204,16
0.498,0.0001,658,646,25,10,0.0001,1304,16
0.498,0.0001,707,697,25,10,0.0001,1404,16
0.498,0.0001,758,746,25,10,0.0001,1504,16
0.498,0.0001,810,794,25,10,0.0001,1604,16
0.5,0.0001,858,846,25,10,0.0001,1704,16
0.5,0.0001,908,896,25,10,0.0001,1804,16
0.502,0.0001,949,955,25,10,0.0001,1904,16
0.502,0.0001,998,1006,25,10,0.0001,2004,16
0.524,0.0001,64,40,25,10,0.0001,104,17
0.524,0.0001,112,92,25,10,0.0001,204,17
0.522,0.0001,152,152,25,10,0.0001,304,17
0.522,0.0001,210,194,25,10,0.0001,404,17
0.522,0.0001,258,246,25,10,0.0001,504,17
0.522,0.0001,312,292,25,10,0.0001,604,17
0.522,0.0001,356,348,25,10,0.0001,704,17
0.522,0.0001,399,405,25,10,0.0001,804,17
0.522,0.0001,449,455,25,10,0.0001,904,17
0.524,0.0001,495,509,25,10,0.0001,1004,17
0.524,0.0001,548,556,25,10,0.0001,1104,17
0.524,0.0001,602,602,25,10,0.0001,1204,17
0.524,0.0001,642,662,25,10,0.0001,1304,17
0.524,0.0001,685,719,25,10,0.0001,1404,17
0.524,0.0001,742,762,25,10,0.0001,1504,17
0.524,0.0001,798,806,25,10,0.0001,1604,17
0.526,0.0001,857,847,25,10,0.0001,1704,17
0.526,0.0001,916,888,25,10,0.0001,1804,17
0.526,0.0001,956,948,25,10,0.0001,1904,17
0.526,0.0001,1006,998,25,10,0.0001,2004,17
0.51,0.0001,55,49,25,10,0.0001,104,18
0.51,0.0001,100,104,25,10,0.0001,204,18
0.51,0.0001,149,155,25,10,0.0001,304,18
0.512,0.0001,194,210,25,10,0.0001,404,18
0.512,0.0001,252,252,25,10,0.0001,504,18
0.512,0.0001,300,304,25,10,0.0001,604,18
0.512,0.0001,359,345,25,10,0.0001,704,18
0.514,0.0001,410,394,25,10,0.0001,804,18
0.514,0.0001,458,446,25,10,0.0001,904,18
0.514,0.0001,517,487,25,10,0.0001,1004,18
0.514,0.0001,571,533,25,10,0.0001,1104,18
0.514,0.0001,614,590,25,10,0.0001,1204,18
0.514,0.0001,664,640,25,10,0.0001,1304,18
0.514,0.0001,713,691,25,10,0.0001,1404,18
0.512,0.0001,762,742,25,10,0.0001,1504,18
0.512,0.0001,819,785,25,10,0.0001,1604,18
0.512,0.0001,868,836,25,10,0.0001,1704,18
0.512,0.0001,909,895,25,10,0.0001,1804,18
0.512,0.0001,953,951,25,10,0.0001,1904,18
0.512,0.0001,1000,1004,25,10,0.0001,2004,18
0.494,0.0001,45,59,25,10,0.0001,104,19
0.494,0.0001,101,103,25,10,0.0001,204,19
0.494,0.0001,157,147,25,10,0.0001,304,19
0.494,0.0001,211,193,25,10,0.0001,404,19
0.494,0.0001,261,243,25,10,0.0001,504,19
0.494,0.0001,314,290,25,10,0.0001,604,19
0.494,0.0001,358,346,25,10,0.0001,704,19
0.494,0.0001,400,404,25,10,0.0001,804,19
0.496,0.0001,458,446,25,10,0.0001,904,19
0.496,0.0001,510,494,25,10,0.0001,1004,19
0.496,0.0001,547,557,25,10,0.0001,1104,19
0.496,0.0001,599,605,25,10,0.0001,1204,19
0.496,0.0001,648,656,25,10,0.0001,1304,19
0.498,0.0001,704,700,25,10,0.0001,1404,19
0.5,0.0001,749,755,25,10,0.0001,1504,19
0.5,0.0001,800,804,25,10,0.0001,1604,19
0.5,0.0001,847,857,25,10,0.0001,1704,19
0.502,0.0001,890,914,25,10,0.0001,1804,19
0.504,0.0001,941,963,25,10,0.0001,1904,19
0.504,0.0001,997,1007,25,10,0.0001,2004,19
0.482,0.0001,56,48,25,10,0.0001,104,20
0.482,0.0001,115,89,25,10,0.0001,204,20
0.484,0.0001,156,148,25,10,0.0001,304,20
0.484,0.0001,204,200,25,10,0.0001,404,20
0.484,0.0001,252,252,25,10,0.0001,504,20
0.484,0.0001,303,301,25,10,0.0001,604,20
0.484,0.0001,352,352,25,10,0.0001,704,20
0.484,0.0001,407,397,25,10,0.0001,804,20
0.484,0.0001,451,453,25,10,0.0001,904,20
0.482,0.0001,501,503,25,10,0.0001,1004,20
0.484,0.0001,558,546,25,10,0.0001,1104,20
0.484,0.0001,612,592,25,10,0.0001,1204,20
0.484,0.0001,655,649,25,10,0.0001,1304,20
0.484,0.0001,710,694,25,10,0.0001,1404,20
0.486,0.0001,762,742,25,10,0.0001,1504,20
0.484,0.0001,813,791,25,10,0.0001,1604,20
0.486,0.0001,862,842,25,10,0.0001,1704,20
0.484,0.0001,913,891,25,10,0.0001,1804,20
0.484,0.0001,961,943,25,10,0.0001,1904,20
0.486,0.0001,1013,991,25,10,0.0001,2004,20
0.506,0.0001,54,50,25,10,0.001,104,1
0.51,0.0001,103,101,25,10,0.001,204,1
0.508,0.0001,160,144,25,10,0.001,304,1
0.51,0.0001,214,190,25,10,0.001,404,1
0.512,0.0001,266,238,25,10,0.001,504,1
0.514,0.0001,313,291,25,10,0.001,604,1
0.516,0.0001,361,343,25,10,0.001,704,1
0.516,0.0001,411,393,25,10,0.001,804,1
0.514,0.0001,461,443,25,10,0.001,904,1
0.518,0.0001,506,498,25,10,0.001,1004,1
0.516,0.0001,555,549,25,10,0.001,1104,1
0.524,0.0001,611,593,25,10,0.001,1204,1
0.528,0.0001,663,641,25,10,0.001,1304,1
0.538,0.0001,707,697,25,10,0.001,1404,1
0.538,0.0001,754,750,25,10,0.001,1504,1
0.542,0.0001,797,807,25,10,0.001,1604,1
0.544,0.0001,856,848,25,10,0.001,1704,1
0.552,0.0001,905,899,25,10,0.001,1804,1
0.554,0.0001,955,949,25,10,0.001,1904,1
0.582,0.0001,999,1005,25,10,0.001,2004,1
0.512,0.0001,53,51,25,10,0.001,104,2
0.512,0.0001,94,110,25,10,0.001,204,2
0.512,0.0001,139,165,25,10,0.001,304,2
0.516,0.0001,191,213,25,10,0.001,404,2
0.516,0.0001,249,255,25,10,0.001,504,2
0.524,0.0001,298,306,25,10,0.001,604,2
0.526,0.0001,349,355,25,10,0.001,704,2
0.526,0.0001,401,403,25,10,0.001,804,2
0.528,0.0001,449,455,25,10,0.001,904,2
0.528,0.0001,503,501,25,10,0.001,1004,2
0.536,0.0001,556,548,25,10,0.001,1104,2
0.546,0.0001,603,601,25,10,0.001,1204,2
0.554,0.0001,648,656,25,10,0.001,1304,2
0.566,0.0001,694,710,25,10,0.001,1404,2
0.564,0.0001,751,753,25,10,0.001,1504,2
0.57,0.0001,794,810,25,10,0.001,1604,2
0.58,0.0001,841,863,25,10,0.001,1704,2
0.588,0.0001,895,909,25,10,0.001,1804,2
0.608,0.0001,948,956,25,10,0.001,1904,2
0.62,0.0001,1000,1004,25,10,0.001,2004,2
0.438,0.0001,52,52,25,10,0.001,104,3
0.434,0.0001,97,107,25,10,0.001,204,3
0.434,0.0001,152,152,25,10,0.001,304,3
0.448,0.0001,205,199,25,10,0.001,404,3
0.454,0.0001,257,247,25,10,0.001,504,3
0.46,0.0001,316,288,25,10,0.001,604,3
0.458,0.0001,370,334,25,10,0.001,704,3
0.458,0.0001,421,383,25,10,0.001,804,3
0.462,0.0001,473,431,25,10,0.001,904,3
0.47,0.0001,529,475,25,10,0.001,1004,3
0.476,0.0001,586,518,25,10,0.001,1104,3
0.494,0.0001,631,573,25,10,0.001,1204,3
0.5,0.0001,686,618,25,10,0.001,1304,3
0.504,0.0001,734,670,25,10,0.001,1404,3
0.51,0.0001,777,727,25,10,0.001,1504,3
0.526,0.0001,824,780,25,10,0.001,1604,3
0.554,0.0001,864,840,25,10,0.001,1704,3
0.58,0.0001,914,890,25,10,0.001,1804,3
0.584,0.0001,969,935,25,10,0.001,1904,3
0.6,0.0001,1021,983,25,10,0.001,2004,3
0.47,0.0001,51,53,25,10,0.001,104,4
0.472,0.0001,102,102,25,10,0.001,204,4
0.472,0.0001,153,151,25,10,0.001,304,4
0.474,0.0001,205,199,25,10,0.001,404,4
0.476,0.0001,256,248,25,10,0.001,504,4
0.48,0.0001,302,302,25,10,0.001,604,4
0.484,0.0001,357,347,25,10,0.001,704,4
0.48,0.0001,409,395,25,10,0.001,804,4
0.486,0.0001,461,443,25,10,0.001,904,4
0.488,0.0001,514,490,25,10,0.001,1004,4
0.492,0.0001,566,538,25,10,0.001,1104,4
0.494,0.0001,614,590,25,10,0.001,1204,4
0.502,0.0001,665,639,25,10,0.001,1304,4
0.506,0.0001,713,691,25,10,0.001,1404,4
0.516,0.0001,759,745,25,10,0.001,1504,4
0.528,0.0001,801,803,25,10,0.001,1604,4
0.536,0.0001,846,858,25,10,0.001,1704,4
0.558,0.0001,890,914,25,10,0.001,1804,4
0.562,0.0001,946,958,25,10,0.001,1904,4
0.564,0.0001,996,1008,25,10,0.001,2004,4
0.534,0.0001,51,53,25,10,0.001,104,5
0.536,0.0001,94,110,25,10,0.001,204,5
0.536,0.0001,146,158,25,10,0.001,304,5
0.536,0.0001,195,209,25,10,0.001,404,5
0.544,0.0001,253,251,25,10,0.001,504,5
0.544,0.0001,311,293,25,10,0.001,604,5
0.536,0.0001,364,340,25,10,0.001,704,5
0.542,0.0001,418,386,25,10,0.001,804,5
0.532,0.0001,462,442,25,10,0.001,904,5
0.534,0.0001,510,494,25,10,0.001,1004,5
0.548,0.0001,562,542,25,10,0.001,1104,5
0.562,0.0001,615,589,25,10,0.001,1204,5
0.554,0.0001,669,635,25,10,0.001,1304,5
0.55,0.0001,717,687,25,10,0.001,1404,5
0.556,0.0001,771,733,25,10,0.001,1504,5
0.558,0.0001,819,785,25,10,0.001,1604,5
0.56,0.0001,866,838,25,10,0.001,1704,5
0.564,0.0001,913,891,25,10,0.001,1804,5
0.564,0.0001,959,945,25,10,0.001,1904,5
0.572,0.0001,1017,987,25,10,0.001,2004,5
0.544,0.0001,54,50,25,10,0.001,104,6
0.55,0.0001,104,100,25,10,0.001,204,6
0.542,0.0001,157,147,25,10,0.001,304,6
0.54,0.0001,202,202,25,10,0.001,404,6
0.542,0.0001,255,249,25,10,0.001,504,6
0.544,0.0001,307,297,25,10,0.001,604,6
0.546,0.0001,348,356,25,10,0.001,704,6
0.546,0.0001,407,397,25,10,0.001,804,6
0.556,0.0001,465,439,25,10,0.001,904,6
0.558,0.0001,513,491,25,10,0.001,1004,6
0.558,0.0001,564,540,25,10,0.001,1104,6
0.564,0.0001,617,587,25,10,0.001,1204,6
0.562,0.0001,671,633,25,10,0.001,1304,6
0.572,0.0001,716,688,25,10,0.001,1404,6
0.57,0.0001,764,740,25,10,0.001,1504,6
0.578,0.0001,814,790,25,10,0.001,1604,6
0.586,0.0001,868,836,25,10,0.001,1704,6
0.59,0.0001,925,879,25,10,0.001,1804,6
0.598,0.0001,971,933,25,10,0.001,1904,6
0.608,0.0001,1024,980,25,10,0.001,2004,6
0.48,0.0001,51,53,25,10,0.001,104,7
0.484,0.0001,90,114,25,10,0.001,204,7
0.492,0.0001,144,160,25,10,0.001,304,7
0.496,0.0001,188,216,25,10,0.001,404,7
0.492,0.0001,239,265,25,10,0.001,504,7
0.504,0.0001,283,321,25,10,0.001,604,7
0.512,0.0001,327,377,25,10,0.001,704,7
0.512,0.0001,383,421,25,10,0.001,804,7
0.512,0.0001,432,472,25,10,0.001,904,7
0.518,0.0001,481,523,25,10,0.001,1004,7
0.52,0.0001,535,569,25,10,0.001,1104,7
0.534,0.0001,584,620,25,10,0.001,1204,7
0.538,0.0001,632,672,25,10,0.001,1304,7
0.54,0.0001,682,722,25,10,0.001,1404,7
0.546,0.0001,731,773,25,10,0.001,1504,7
0.548,0.0001,773,831,25,10,0.001,1604,7
0.56,0.0001,832,872,25,10,0.001,1704,7
0.576,0.0001,878,926,25,10,0.001,1804,7
0.586,0.0001,931,973,25,10,0.001,1904,7
0.598,0.0001,982,1022,25,10,0.001,2004,7
0.52,0.0001,52,52,25,10,0.001,104,8
0.524,0.0001,110,94,25,10,0.001,204,8
0.53,0.0001,150,154,25,10,0.001,304,8
0.534,0.0001,199,205,25,10,0.001,404,8
0.53,0.0001,251,253,25,10,0.001,504,8
0.534,0.0001,293,311,25,10,0.001,604,8
0.534,0.0001,335,369,25,10,0.001,704,8
0.536,0.0001,388,416,25,10,0.001,804,8
0.536,0.0001,435,469,25,10,0.001,904,8
0.536,0.0001,494,510,25,10,0.001,1004,8
0.542,0.0001,541,563,25,10,0.001,1104,8
0.554,0.0001,597,607,25,10,0.001,1204,8
0.572,0.0001,648,656,25,10,0.001,1304,8
0.568,0.0001,696,708,25,10,0.001,1404,8
0.59,0.0001,747,757,25,10,0.001,1504,8
0.608,0.0001,797,807,25,10,0.001,1604,8
0.612,0.0001,849,855,25,10,0.001,1704,8
0.618,0.0001,899,905,25,10,0.001,1804,8
0.614,0.0001,954,950,25,10,0.001,1904,8
0.63,0.0001,1007,997,25,10,0.001,2004,8
0.49,0.0001,54,50,25,10,0.001,104,9
0.498,0.0001,103,101,25,10,0.001,204,9
0.496,0.0001,154,150,25,10,0.001,304,9
0.498,0.0001,204,200,25,10,0.001,404,9
0.502,0.0001,256,248,25,10,0.001,504,9
0.51,0.0001,307,297,25,10,0.001,604,9
0.508,0.0001,351,353,25,10,0.001,704,9
0.506,0.0001,401,403,25,10,0.001,804,9
0.52,0.0001,439,465,25,10,0.001,904,9
0.528,0.0001,494,510,25,10,0.001,1004,9
0.536,0.0001,532,572,25,10,0.001,1104,9
0.54,0.0001,583,621,25,10,0.001,1204,9
0.544,0.0001,630,674,25,10,0.001,1304,9
0.56,0.0001,687,717,25,10,0.001,1404,9
0.574,0.0001,742,762,25,10,0.001,1504,9
0.586,0.0001,789,815,25,10,0.001,1604,9
0.596,0.0001,834,870,25,10,0.001,1704,9
0.602,0.0001,891,913,25,10,0.001,1804,9
0.606,0.0001,944,960,25,10,0.001,1904,9
0.624,0.0001,983,1021,25,10,0.001,2004,9
0.48,0.0001,60,44,25,10,0.001,104,10
0.48,0.0001,109,95,25,10,0.001,204,10
0.478,0.0001,159,145,25,10,0.001,304,10
0.482,0.0001,205,199,25,10,0.001,404,10
0.482,0.0001,255,249,25,10,0.001,504,10
0.48,0.0001,314,290,25,10,0.001,604,10
0.48,0.0001,362,342,25,10,0.001,704,10
0.486,0.0001,407,397,25,10,0.001,804,10
0.492,0.0001,461,443,25,10,0.001,904,10
0.496,0.0001,518,486,25,10,0.001,1004,10
0.502,0.0001,569,535,25,10,0.001,1104,10
0.512,0.0001,620,584,25,10,0.001,1204,10
0.52,0.0001,668,636,25,10,0.001,1304,10
0.534,0.0001,727,677,25,10,0.001,1404,10
0.54,0.0001,777,727,25,10,0.001,1504,10
0.55,0.0001,825,779,25,10,0.001,1604,10
0.566,0.0001,868,836,25,10,0.001,1704,10
0.568,0.0001,915,889,25,10,0.001,1804,10
0.57,0.0001,960,944,25,10,0.001,1904,10
0.572,0.0001,1009,995,25,10,0.001,2004,10
0.504,0.0001,54,50,25,10,0.001,104,11
0.5,0.0001,103,101,25,10,0.001,204,11
0.504,0.0001,148,156,25,10,0.001,304,11
0.506,0.0001,198,206,25,10,0.001,404,11
0.508,0.0001,248,256,25,10,0.001,504,11
0.506,0.0001,301,303,25,10,0.001,604,11
0.506,0.0001,344,360,25,10,0.001,704,11
0.504,0.0001,389,415,25,10,0.001,804,11
0.512,0.0001,441,463,25,10,0.001,904,11
0.516,0.0001,496,508,25,10,0.001,1004,11
0.52,0.0001,547,557,25,10,0.001,1104,11
0.53,0.0001,609,595,25,10,0.001,1204,11
0.532,0.0001,657,647,25,10,0.001,1304,11
0.542,0.0001,702,702,25,10,0.001,1404,11
0.548,0.0001,756,748,25,10,0.001,1504,11
0.548,0.0001,811,793,25,10,0.001,1604,11
0.56,0.0001,851,853,25,10,0.001,1704,11
0.568,0.0001,904,900,25,10,0.001,1804,11
0.576,0.0001,963,941,25,10,0.001,1904,11
0.576,0.0001,1008,996,25,10,0.001,2004,11
0.572,0.0001,52,52,25,10,0.001,104,12
0.572,0.0001,100,104,25,10,0.001,204,12
0.578,0.0001,154,150,25,10,0.001,304,12
0.572,0.0001,205,199,25,10,0.001,404,12
0.574,0.0001,261,243,25,10,0.001,504,12
0.576,0.0001,315,289,25,10,0.001,604,12
0.58,0.0001,363,341,25,10,0.001,704,12
0.578,0.0001,417,387,25,10,0.001,804,12
0.578,0.0001,465,439,25,10,0.001,904,12
0.586,0.0001,518,486,25,10,0.001,1004,12
0.592,0.0001,569,535,25,10,0.001,1104,12
0.602,0.0001,626,578,25,10,0.001,1204,12
0.604,0.0001,678,626,25,10,0.001,1304,12
0.592,0.0001,728,676,25,10,0.001,1404,12
0.608,0.0001,776,728,25,10,0.001,1504,12
0.622,0.0001,820,784,25,10,0.001,1604,12
0.64,0.0001,867,837,25,10,0.001,1704,12
0.64,0.0001,918,886,25,10,0.001,1804,12
0.648,0.0001,968,936,25,10,0.001,1904,12
0.658,0.0001,1001,1003,25,10,0.001,2004,12
0.536,0.0001,52,52,25,10,0.001,104,13
0.536,0.0001,106,98,25,10,0.001,204,13
0.536,0.0001,150,154,25,10,0.001,304,13
0.54,0.0001,191,213,25,10,0.001,404,13
0.536,0.0001,241,263,25,10,0.001,504,13
0.542,0.0001,283,321,25,10,0.001,604,13
0.546,0.0001,332,372,25,10,0.001,704,13
0.542,0.0001,390,414,25,10,0.001,804,13
0.544,0.0001,436,468,25,10,0.001,904,13
0.548,0.0001,483,521,25,10,0.001,1004,13
0.548,0.0001,525,579,25,10,0.001,1104,13
0.552,0.0001,573,631,25,10,0.001,1204,13
0.556,0.0001,625,679,25,10,0.001,1304,13
0.568,0.0001,669,735,25,10,0.001,1404,13
0.572,0.0001,714,790,25,10,0.001,1504,13
0.582,0.0001,765,839,25,10,0.001,1604,13
0.582,0.0001,812,892,25,10,0.001,1704,13
0.596,0.0001,872,932,25,10,0.001,1804,13
0.608,0.0001,924,980,25,10,0.001,1904,13
0.62,0.0001,982,1022,25,10,0.001,2004,13
0.528,0.0001,54,50,25,10,0.001,104,14
0.536,0.0001,107,97,25,10,0.001,204,14
0.536,0.0001,148,156,25,10,0.001,304,14
0.526,0.0001,205,199,25,10,0.001,404,14
0.524,0.0001,260,244,25,10,0.001,504,14
0.53,0.0001,315,289,25,10,0.001,604,14
0.534,0.0001,364,340,25,10,0.001,704,14
0.548,0.0001,411,393,25,10,0.001,804,14
0.542,0.0001,461,443,25,10,0.001,904,14
0.558,0.0001,515,489,25,10,0.001,1004,14
0.562,0.0001,572,532,25,10,0.001,1104,14
0.566,0.0001,619,585,25,10,0.001,1204,14
0.566,0.0001,667,637,25,10,0.001,1304,14
0.58,0.0001,714,690,25,10,0.001,1404,14
0.59,0.0001,757,747,25,10,0.001,1504,14
0.6,0.0001,800,804,25,10,0.001,1604,14
0.608,0.0001,858,846,25,10,0.001,1704,14
0.618,0.0001,903,901,25,10,0.001,1804,14
0.628,0.0001,960,944,25,10,0.001,1904,14
0.648,0.0001,1004,1000,25,10,0.001,2004,14
0.532,0.0001,54,50,25,10,0.001,104,15
0.526,0.0001,101,103,25,10,0.001,204,15
0.53,0.0001,156,148,25,10,0.001,304,15
0.534,0.0001,211,193,25,10,0.001,404,15
0.536,0.0001,257,247,25,10,0.001,504,15
0.546,0.0001,306,298,25,10,0.001,604,15
0.548,0.0001,357,347,25,10,0.001,704,15
0.552,0.0001,403,401,25,10,0.001,804,15
0.56,0.0001,448,456,25,10,0.001,904,15
0.568,0.0001,500,504,25,10,0.001,1004,15
0.578,0.0001,557,547,25,10,0.001,1104,15
0.586,0.0001,607,597,25,10,0.001,1204,15
0.602,0.0001,655,649,25,10,0.001,1304,15
0.612,0.0001,698,706,25,10,0.001,1404,15
0.618,0.0001,755,749,25,10,0.001,1504,15
0.63,0.0001,797,807,25,10,0.001,1604,15
0.638,0.0001,849,855,25,10,0.001,1704,15
0.642,0.0001,899,905,25,10,0.001,1804,15
0.646,0.0001,959,945,25,10,0.001,1904,15
0.666,0.0001,999,1005,25,10,0.001,2004,15
0.48,0.0001,49,55,25,10,0.001,104,16
0.482,0.0001,95,109,25,10,0.001,204,16
0.49,0.0001,147,157,25,10,0.001,304,16
0.494,0.0001,192,212,25,10,0.001,404,16
0.5,0.0001,242,262,25,10,0.001,504,16
0.508,0.0001,292,312,25,10,0.001,604,16
0.516,0.0001,348,356,25,10,0.001,704,16
0.522,0.0001,408,396,25,10,0.001,804,16
0.528,0.0001,455,449,25,10,0.001,904,16
0.536,0.0001,497,507,25,10,0.001,1004,16
0.54,0.0001,544,560,25,10,0.001,1104,16
0.542,0.0001,601,603,25,10,0.001,1204,16
0.55,0.0001,648,656,25,10,0.001,1304,16
0.556,0.0001,694,710,25,10,0.001,1404,16
0.562,0.0001,749,755,25,10,0.001,1504,16
0.57,0.0001,799,805,25,10,0.001,1604,16
0.568,0.0001,845,859,25,10,0.001,1704,16
0.578,0.0001,889,915,25,10,0.001,1804,16
0.592,0.0001,942,962,25,10,0.001,1904,16
0.598,0.0001,987,1017,25,10,0.001,2004,16
0.458,0.0001,57,47,25,10,0.001,104,17
0.462,0.0001,105,99,25,10,0.001,204,17
0.45,0.0001,153,151,25,10,0.001,304,17
0.448,0.0001,201,203,25,10,0.001,404,17
0.452,0.0001,259,245,25,10,0.001,504,17
0.466,0.0001,307,297,25,10,0.001,604,17
0.47,0.0001,355,349,25,10,0.001,704,17
0.468,0.0001,404,400,25,10,0.001,804,17
0.466,0.0001,451,453,25,10,0.001,904,17
0.474,0.0001,501,503,25,10,0.001,1004,17
0.478,0.0001,549,555,25,10,0.001,1104,17
0.486,0.0001,605,599,25,10,0.001,1204,17
0.496,0.0001,658,646,25,10,0.001,1304,17
0.512,0.0001,707,697,25,10,0.001,1404,17
0.518,0.0001,752,752,25,10,0.001,1504,17
0.53,0.0001,803,801,25,10,0.001,1604,17
0.542,0.0001,855,849,25,10,0.001,1704,17
0.556,0.0001,914,890,25,10,0.001,1804,17
0.566,0.0001,964,940,25,10,0.001,1904,17
0.57,0.0001,1017,987,25,10,0.001,2004,17
0.474,0.0001,61,43,25,10,0.001,104,18
0.474,0.0001,111,93,25,10,0.001,204,18
0.472,0.0001,154,150,25,10,0.001,304,18
0.47,0.0001,208,196,25,10,0.001,404,18
0.47,0.0001,250,254,25,10,0.001,504,18
0.472,0.0001,304,300,25,10,0.001,604,18
0.472,0.0001,360,344,25,10,0.001,704,18
0.474,0.0001,413,391,25,10,0.001,804,18
0.474,0.0001,460,444,25,10,0.001,904,18
0.47,0.0001,509,495,25,10,0.001,1004,18
0.474,0.0001,559,545,25,10,0.001,1104,18
0.482,0.0001,605,599,25,10,0.001,1204,18
0.486,0.0001,648,656,25,10,0.001,1304,18
0.486,0.0001,695,709,25,10,0.001,1404,18
0.486,0.0001,746,758,25,10,0.001,1504,18
0.496,0.0001,794,810,25,10,0.001,1604,18
0.5,0.0001,836,868,25,10,0.001,1704,18
0.508,0.0001,887,917,25,10,0.001,1804,18
0.508,0.0001,940,964,25,10,0.001,1904,18
0.53,0.0001,991,1013,25,10,0.001,2004,18
0.516,0.0001,54,50,25,10,0.001,104,19
0.514,0.0001,103,101,25,10,0.001,204,19
0.51,0.0001,145,159,25,10,0.001,304,19
0.508,0.0001,185,219,25,10,0.001,404,19
0.514,0.0001,233,271,25,10,0.001,504,19
0.522,0.0001,287,317,25,10,0.001,604,19
0.526,0.0001,340,364,25,10,0.001,704,19
0.528,0.0001,381,423,25,10,0.001,804,19
0.526,0.0001,435,469,25,10,0.001,904,19
0.528,0.0001,493,511,25,10,0.001,1004,19
0.536,0.0001,546,558,25,10,0.001,1104,19
0.542,0.0001,591,613,25,10,0.001,1204,19
0.55,0.0001,642,662,25,10,0.001,1304,19
0.554,0.0001,694,710,25,10,0.001,1404,19
0.554,0.0001,745,759,25,10,0.001,1504,19
0.558,0.0001,794,810,25,10,0.001,1604,19
0.564,0.0001,849,855,25,10,0.001,1704,19
0.576,0.0001,908,896,25,10,0.001,1804,19
0.586,0.0001,958,946,25,10,0.001,1904,19
0.612,0.0001,1008,996,25,10,0.001,2004,19
0.504,0.0001,51,53,25,10,0.001,104,20
0.504,0.0001,92,112,25,10,0.001,204,20
0.504,0.0001,152,152,25,10,0.001,304,20
0.508,0.0001,198,206,25,10,0.001,404,20
0.504,0.0001,245,259,25,10,0.001,504,20
0.502,0.0001,285,319,25,10,0.001,604,20
0.5,0.0001,339,365,25,10,0.001,704,20
0.502,0.0001,381,423,25,10,0.001,804,20
0.502,0.0001,433,471,25,10,0.001,904,20
0.506,0.0001,480,524,25,10,0.001,1004,20
0.508,0.0001,526,578,25,10,0.001,1104,20
0.51,0.0001,576,628,25,10,0.001,1204,20
0.506,0.0001,626,678,25,10,0.001,1304,20
0.51,0.0001,676,728,25,10,0.001,1404,20
0.51,0.0001,726,778,25,10,0.001,1504,20
0.518,0.0001,774,830,25,10,0.001,1604,20
0.524,0.0001,825,879,25,10,0.001,1704,20
0.532,0.0001,883,921,25,10,0.001,1804,20
0.54,0.0001,934,970,25,10,0.001,1904,20
0.542,0.0001,998,1006,25,10,0.001,2004,20
0.53,0.0001,53,51,25,10,0.01,104,1
0.536,0.0001,102,102,25,10,0.01,204,1
0.538,0.0001,154,150,25,10,0.01,304,1
0.554,0.0001,205,199,25,10,0.01,404,1
0.556,0.0001,258,246,25,10,0.01,504,1
0.544,0.0001,314,290,25,10,0.01,604,1
0.538,0.0001,360,344,25,10,0.01,704,1
0.528,0.0001,413,391,25,10,0.01,804,1
0.57,0.0001,458,446,25,10,0.01,904,1
0.628,0.0001,512,492,25,10,0.01,1004,1
0.692,0.0001,553,551,25,10,0.01,1104,1
0.74,0.0001,604,600,25,10,0.01,1204,1
0.772,0.0001,641,663,25,10,0.01,1304,1
0.81,0.0001,696,708,25,10,0.01,1404,1
0.85,0.0001,745,759,25,10,0.01,1504,1
0.908,0.0001,804,800,25,10,0.01,1604,1
0.914,0.0001,855,849,25,10,0.01,1704,1
0.928,0.0001,897,907,25,10,0.01,1804,1
0.944,0.0001,948,956,25,10,0.01,1904,1
0.946,0.0001,1001,1003,25,10,0.01,2004,1
0.492,0.0001,54,50,25,10,0.01,104,2
0.488,0.0001,110,94,25,10,0.01,204,2
0.496,0.0001,157,147,25,10,0.01,304,2
0.516,0.0001,204,200,25,10,0.01,404,2
0.538,0.0001,258,246,25,10,0.01,504,2
0.562,0.0001,304,300,25,10,0.01,604,2
0.602,0.0001,361,343,25,10,0.01,704,2
0.644,0.0001,408,396,25,10,0.01,804,2
0.676,0.0001,463,441,25,10,0.01,904,2
0.73,0.0001,512,492,25,10,0.01,1004,2
0.776,0.0001,553,551,25,10,0.01,1104,2
0.822,0.0001,596,608,25,10,0.01,1204,2
0.854,0.0001,654,650,25,10,0.01,1304,2
0.888,0.0001,702,702,25,10,0.01,1404,2
0.916,0.0001,750,754,25,10,0.01,1504,2
0.932,0.0001,801,803,25,10,0.01,1604,2
0.954,0.0001,854,850,25,10,0.01,1704,2
0.958,0.0001,904,900,25,10,0.01,1804,2
0.964,0.0001,954,950,25,10,0.01,1904,2
0.968,0.0001,1009,995,25,10,0.01,2004,2
0.52,0.0001,58,46,25,10,0.01,104,3
0.528,0.0001,102,102,25,10,0.01,204,3
0.534,0.0001,159,145,25,10,0.01,304,3
0.548,0.0001,201,203,25,10,0.01,404,3
0.554,0.0001,253,251,25,10,0.01,504,3
0.58,0.0001,299,305,25,10,0.01,604,3
0.608,0.0001,346,358,25,10,0.01,704,3
0.626,0.0001,398,406,25,10,0.01,804,3
0.648,0.0001,446,458,25,10,0.01,904,3
0.674,0.0001,494,510,25,10,0.01,1004,3
0.684,0.0001,550,554,25,10,0.01,1104,3
0.732,0.0001,595,609,25,10,0.01,1204,3
0.774,0.0001,653,651,25,10,0.01,1304,3
0.816,0.0001,695,709,25,10,0.01,1404,3
0.86,0.0001,746,758,25,10,0.01,1504,3
0.892,0.0001,800,804,25,10,0.01,1604,3
0.904,0.0001,859,845,25,10,0.01,1704,3
0.924,0.0001,898,906,25,10,0.01,1804,3
0.924,0.0001,948,956,25,10,0.01,1904,3
0.928,0.0001,998,1006,25,10,0.01,2004,3
0.498,0.0001,55,49,25,10,0.01,104,4
0.506,0.0001,104,100,25,10,0.01,204,4
0.512,0.0001,153,151,25,10,0.01,304,4
0.528,0.0001,199,205,25,10,0.01,404,4
0.544,0.0001,244,260,25,10,0.01,504,4
0.558,0.0001,295,309,25,10,0.01,604,4
0.576,0.0001,347,357,25,10,0.01,704,4
0.586,0.0001,404,400,25,10,0.01,804,4
0.596,0.0001,452,452,25,10,0.01,904,4
0.638,0.0001,502,502,25,10,0.01,1004,4
0.67,0.0001,554,550,25,10,0.01,1104,4
0.708,0.0001,604,600,25,10,0.01,1204,4
0.736,0.0001,650,654,25,10,0.01,1304,4
0.776,0.0001,702,702,25,10,0.01,1404,4
0.8,0.0001,755,749,25,10,0.01,1504,4
0.836,0.0001,809,795,25,10,0.01,1604,4
0.866,0.0001,859,845,25,10,0.01,1704,4
0.89,0.0001,906,898,25,10,0.01,1804,4
0.912,0.0001,952,952,25,10,0.01,1904,4
0.922,0.0001,1003,1001,25,10,0.01,2004,4
0.494,0.0001,57,47,25,10,0.01,104,5
0.542,0.0001,102,102,25,10,0.01,204,5
0.544,0.0001,162,142,25,10,0.01,304,5
0.58,0.0001,213,191,25,10,0.01,404,5
0.598,0.0001,255,249,25,10,0.01,504,5
0.628,0.0001,309,295,25,10,0.01,604,5
0.628,0.0001,358,346,25,10,0.01,704,5
0.642,0.0001,412,392,25,10,0.01,804,5
0.666,0.0001,460,444,25,10,0.01,904,5
0.714,0.0001,506,498,25,10,0.01,1004,5
0.75,0.0001,562,542,25,10,0.01,1104,5
0.8,0.0001,622,582,25,10,0.01,1204,5
0.838,0.0001,666,638,25,10,0.01,1304,5
0.864,0.0001,718,686,25,10,0.01,1404,5
0.896,0.0001,761,743,25,10,0.01,1504,5
0.91,0.0001,808,796,25,10,0.01,1604,5
0.918,0.0001,860,844,25,10,0.01,1704,5
0.922,0.0001,914,890,25,10,0.01,1804,5
0.93,0.0001,957,947,25,10,0.01,1904,5
0.936,0.0001,1003,1001,25,10,0.01,2004,5
0.452,0.0001,55,49,25,10,0.01,104,6
0.474,0.0001,110,94,25,10,0.01,204,6
0.508,0.0001,158,146,25,10,0.01,304,6
0.538,0.0001,200,204,25,10,0.01,404,6
0.552,0.0001,241,263,25,10,0.01,504,6
0.588,0.0001,295,309,25,10,0.01,604,6
0.61,0.0001,345,359,25,10,0.01,704,6
0.64,0.0001,397,407,25,10,0.01,804,6
0.67,0.0001,441,463,25,10,0.01,904,6
0.702,0.0001,482,522,25,10,0.01,1004,6
0.714,0.0001,533,571,25,10,0.01,1104,6
0.744,0.0001,594,610,25,10,0.01,1204,6
0.778,0.0001,637,667,25,10,0.01,1304,6
0.806,0.0001,684,720,25,10,0.01,1404,6
0.828,0.0001,736,768,25,10,0.01,1504,6
0.862,0.0001,783,821,25,10,0.01,1604,6
0.868,0.0001,835,869,25,10,0.01,1704,6
0.89,0.0001,883,921,25,10,0.01,1804,6
0.902,0.0001,934,970,25,10,0.01,1904,6
0.918,0.0001,991,1013,25,10,0.01,2004,6
0.518,0.0001,53,51,25,10,0.01,104,7
0.528,0.0001,101,103,25,10,0.01,204,7
0.536,0.0001,156,148,25,10,0.01,304,7
0.536,0.0001,211,193,25,10,0.01,404,7
0.544,0.0001,268,236,25,10,0.01,504,7
0.55,0.0001,315,289,25,10,0.01,604,7
0.554,0.0001,357,347,25,10,0.01,704,7
0.566,0.0001,415,389,25,10,0.01,804,7
0.602,0.0001,460,444,25,10,0.01,904,7
0.656,0.0001,506,498,25,10,0.01,1004,7
0.686,0.0001,568,536,25,10,0.01,1104,7
0.722,0.0001,613,591,25,10,0.01,1204,7
0.776,0.0001,661,643,25,10,0.01,1304,7
0.826,0.0001,711,693,25,10,0.01,1404,7
0.842,0.0001,757,747,25,10,0.01,1504,7
0.872,0.0001,810,794,25,10,0.01,1604,7
0.892,0.0001,848,856,25,10,0.01,1704,7
0.914,0.0001,899,905,25,10,0.01,1804,7
0.934,0.0001,950,954,25,10,0.01,1904,7
0.946,0.0001,998,1006,25,10,0.01,2004,7
0.498,0.0001,53,51,25,10,0.01,104,8
0.502,0.0001,102,102,25,10,0.01,204,8
0.498,0.0001,149,155,25,10,0.01,304,8
0.494,0.0001,207,197,25,10,0.01,404,8
0.488,0.0001,265,239,25,10,0.01,504,8
0.502,0.0001,310,294,25,10,0.01,604,8
0.518,0.0001,352,352,25,10,0.01,704,8
0.544,0.0001,397,407,25,10,0.01,804,8
0.588,0.0001,448,456,25,10,0.01,904,8
0.644,0.0001,493,511,25,10,0.01,1004,8
0.66,0.0001,538,566,25,10,0.01,1104,8
0.698,0.0001,586,618,25,10,0.01,1204,8
0.718,0.0001,641,663,25,10,0.01,1304,8
0.768,0.0001,691,713,25,10,0.01,1404,8
0.808,0.0001,742,762,25,10,0.01,1504,8
0.842,0.0001,783,821,25,10,0.01,1604,8
0.844,0.0001,835,869,25,10,0.01,1704,8
0.88,0.0001,898,906,25,10,0.01,1804,8
0.906,0.0001,950,954,25,10,0.01,1904,8
0.906,0.0001,1001,1003,25,10,0.01,2004,8
0.516,0.0001,50,54,25,10,0.01,104,9
0.548,0.0001,105,99,25,10,0.01,204,9
0.544,0.0001,149,155,25,10,0.01,304,9
0.554,0.0001,201,203,25,10,0.01,404,9
0.572,0.0001,250,254,25,10,0.01,504,9
0.596,0.0001,291,313,25,10,0.01,604,9
0.614,0.0001,343,361,25,10,0.01,704,9
0.628,0.0001,401,403,25,10,0.01,804,9
0.658,0.0001,446,458,25,10,0.01,904,9
0.69,0.0001,502,502,25,10,0.01,1004,9
0.736,0.0001,552,552,25,10,0.01,1104,9
0.796,0.0001,606,598,25,10,0.01,1204,9
0.836,0.0001,657,647,25,10,0.01,1304,9
0.862,0.0001,703,701,25,10,0.01,1404,9
0.876,0.0001,752,752,25,10,0.01,1504,9
0.898,0.0001,798,806,25,10,0.01,1604,9
0.904,0.0001,844,860,25,10,0.01,1704,9
0.914,0.0001,899,905,25,10,0.01,1804,9
0.922,0.0001,952,952,25,10,0.01,1904,9
0.93,0.0001,1012,992,25,10,0.01,2004,9
0.466,0.0001,53,51,25,10,0.01,104,10
0.486,0.0001,106,98,25,10,0.01,204,10
0.488,0.0001,156,148,25,10,0.01,304,10
0.504,0.0001,210,194,25,10,0.01,404,10
0.538,0.0001,260,244,25,10,0.01,504,10
0.596,0.0001,306,298,25,10,0.01,604,10
0.63,0.0001,360,344,25,10,0.01,704,10
0.688,0.0001,406,398,25,10,0.01,804,10
0.728,0.0001,452,452,25,10,0.01,904,10
0.778,0.0001,501,503,25,10,0.01,1004,10
0.836,0.0001,551,553,25,10,0.01,1104,10
0.894,0.0001,603,601,25,10,0.01,1204,10
0.918,0.0001,660,644,25,10,0.01,1304,10
0.934,0.0001,714,690,25,10,0.01,1404,10
0.942,0.0001,764,740,25,10,0.01,1504,10
0.948,0.0001,814,790,25,10,0.01,1604,10
0.946,0.0001,867,837,25,10,0.01,1704,10
0.954,0.0001,925,879,25,10,0.01,1804,10
0.954,0.0001,974,930,25,10,0.01,1904,10
0.952,0.0001,1019,985,25,10,0.01,2004,10
0.52,0.0001,57,47,25,10,0.01,104,11
0.54,0.0001,100,104,25,10,0.01,204,11
0.556,0.0001,156,148,25,10,0.01,304,11
0.576,0.0001,206,198,25,10,0.01,404,11
0.596,0.0001,253,251,25,10,0.01,504,11
0.622,0.0001,294,310,25,10,0.01,604,11
0.648,0.0001,349,355,25,10,0.01,704,11
0.67,0.0001,393,411,25,10,0.01,804,11
0.702,0.0001,456,448,25,10,0.01,904,11
0.736,0.0001,498,506,25,10,0.01,1004,11
0.782,0.0001,551,553,25,10,0.01,1104,11
0.832,0.0001,601,603,25,10,0.01,1204,11
0.854,0.0001,651,653,25,10,0.01,1304,11
0.876,0.0001,704,700,25,10,0.01,1404,11
0.91,0.0001,761,743,25,10,0.01,1504,11
0.92,0.0001,809,795,25,10,0.01,1604,11
0.938,0.0001,856,848,25,10,0.01,1704,11
0.948,0.0001,909,895,25,10,0.01,1804,11
0.946,0.0001,951,953,25,10,0.01,1904,11
0.946,0.0001,1005,999,25,10,0.01,2004,11
0.494,0.0001,44,60,25,10,0.01,104,12
0.498,0.0001,90,114,25,10,0.01,204,12
0.502,0.0001,141,163,25,10,0.01,304,12
0.504,0.0001,191,213,25,10,0.01,404,12
0.522,0.0001,237,267,25,10,0.01,504,12
0.548,0.0001,282,322,25,10,0.01,604,12
0.562,0.0001,327,377,25,10,0.01,704,12
0.576,0.0001,373,431,25,10,0.01,804,12
0.608,0.0001,419,485,25,10,0.01,904,12
0.618,0.0001,467,537,25,10,0.01,1004,12
0.626,0.0001,519,585,25,10,0.01,1104,12
0.666,0.0001,569,635,25,10,0.01,1204,12
0.72,0.0001,623,681,25,10,0.01,1304,12
0.758,0.0001,675,729,25,10,0.01,1404,12
0.806,0.0001,721,783,25,10,0.01,1504,12
0.86,0.0001,769,835,25,10,0.01,1604,12
0.902,0.0001,827,877,25,10,0.01,1704,12
0.924,0.0001,884,920,25,10,0.01,1804,12
0.936,0.0001,948,956,25,10,0.01,1904,12
0.95,0.0001,1000,1004,25,10,0.01,2004,12
0.484,0.0001,50,54,25,10,0.01,104,13
0.494,0.0001,97,107,25,10,0.01,204,13
0.516,0.0001,147,157,25,10,0.01,304,13
0.546,0.0001,193,211,25,10,0.01,404,13
0.562,0.0001,244,260,25,10,0.01,504,13
0.586,0.0001,295,309,25,10,0.01,604,13
0.602,0.0001,344,360,25,10,0.01,704,13
0.62,0.0001,394,410,25,10,0.01,804,13
0.654,0.0001,445,459,25,10,0.01,904,13
0.69,0.0001,498,506,25,10,0.01,1004,13
0.702,0.0001,541,563,25,10,0.01,1104,13
0.74,0.0001,589,615,25,10,0.01,1204,13
0.808,0.0001,643,661,25,10,0.01,1304,13
0.854,0.0001,699,705,25,10,0.01,1404,13
0.896,0.0001,747,757,25,10,0.01,1504,13
0.922,0.0001,800,804,25,10,0.01,1604,13
0.928,0.0001,855,849,25,10,0.01,1704,13
0.942,0.0001,906,898,25,10,0.01,1804,13
0.95,0.0001,952,952,25,10,0.01,1904,13
0.958,0.0001,1003,1001,25,10,0.01,2004,13
0.51,0.0001,57,47,25,10,0.01,104,14
0.544,0.0001,108,96,25,10,0.01,204,14
0.566,0.0001,161,143,25,10,0.01,304,14
0.578,0.0001,213,191,25,10,0.01,404,14
0.592,0.0001,271,233,25,10,0.01,504,14
0.598,0.0001,319,285,25,10,0.01,604,14
0.624,0.0001,370,334,25,10,0.01,704,14
0.648,0.0001,426,378,25,10,0.01,804,14
0.664,0.0001,476,428,25,10,0.01,904,14
0.712,0.0001,531,473,25,10,0.01,1004,14
0.778,0.0001,576,528,25,10,0.01,1104,14
0.842,0.0001,624,580,25,10,0.01,1204,14
0.872,0.0001,662,642,25,10,0.01,1304,14
0.912,0.0001,713,691,25,10,0.01,1404,14
0.924,0.0001,758,746,25,10,0.01,1504,14
0.938,0.0001,804,800,25,10,0.01,1604,14
0.942,0.0001,853,851,25,10,0.01,1704,14
0.964,0.0001,903,901,25,10,0.01,1804,14
0.97,0.0001,952,952,25,10,0.01,1904,14
0.978,0.0001,998,1006,25,10,0.01,2004,14
0.522,0.0001,52,52,25,10,0.01,104,15
0.53,0.0001,106,98,25,10,0.01,204,15
0.536,0.0001,158,146,25,10,0.01,304,15
0.57,0.0001,207,197,25,10,0.01,404,15
0.594,0.0001,257,247,25,10,0.01,504,15
0.618,0.0001,310,294,25,10,0.01,604,15
0.654,0.0001,352,352,25,10,0.01,704,15
0.678,0.0001,400,404,25,10,0.01,804,15
0.724,0.0001,449,455,25,10,0.01,904,15
0.76,0.0001,497,507,25,10,0.01,1004,15
0.804,0.0001,548,556,25,10,0.01,1104,15
0.824,0.0001,601,603,25,10,0.01,1204,15
0.84,0.0001,655,649,25,10,0.01,1304,15
0.89,0.0001,696,708,25,10,0.01,1404,15
0.924,0.0001,750,754,25,10,0.01,1504,15
0.942,0.0001,807,797,25,10,0.01,1604,15
0.948,0.0001,850,854,25,10,0.01,1704,15
0.952,0.0001,910,894,25,10,0.01,1804,15
0.964,0.0001,956,948,25,10,0.01,1904,15
0.966,0.0001,1011,993,25,10,0.01,2004,15
0.54,0.0001,44,60,25,10,0.01,104,16
0.564,0.0001,96,108,25,10,0.01,204,16
0.58,0.0001,144,160,25,10,0.01,304,16
0.608,0.0001,201,203,25,10,0.01,404,16
0.64,0.0001,251,253,25,10,0.01,504,16
0.654,0.0001,300,304,25,10,0.01,604,16
0.658,0.0001,359,345,25,10,0.01,704,16
0.674,0.0001,410,394,25,10,0.01,804,16
0.704,0.0001,459,445,25,10,0.01,904,16
0.74,0.0001,513,491,25,10,0.01,1004,16
0.78,0.0001,566,538,25,10,0.01,1104,16
0.84,0.0001,613,591,25,10,0.01,1204,16
0.872,0.0001,657,647,25,10,0.01,1304,16
0.902,0.0001,706,698,25,10,0.01,1404,16
0.922,0.0001,754,750,25,10,0.01,1504,16
0.948,0.0001,797,807,25,10,0.01,1604,16
0.95,0.0001,846,858,25,10,0.01,1704,16
0.956,0.0001,899,905,25,10,0.01,1804,16
0.952,0.0001,943,961,25,10,0.01,1904,16
0.952,0.0001,991,1013,25,10,0.01,2004,16
0.528,0.0001,55,49,25,10,0.01,104,17
0.534,0.0001,108,96,25,10,0.01,204,17
0.546,0.0001,153,151,25,10,0.01,304,17
0.554,0.0001,196,208,25,10,0.01,404,17
0.552,0.0001,249,255,25,10,0.01,504,17
0.572,0.0001,302,302,25,10,0.01,604,17
0.584,0.0001,352,352,25,10,0.01,704,17
0.616,0.0001,400,404,25,10,0.01,804,17
0.654,0.0001,444,460,25,10,0.01,904,17
0.706,0.0001,485,519,25,10,0.01,1004,17
0.74,0.0001,545,559,25,10,0.01,1104,17
0.792,0.0001,591,613,25,10,0.01,1204,17
0.842,0.0001,640,664,25,10,0.01,1304,17
0.884,0.0001,690,714,25,10,0.01,1404,17
0.928,0.0001,739,765,25,10,0.01,1504,17
0.948,0.0001,795,809,25,10,0.01,1604,17
0.97,0.0001,842,862,25,10,0.01,1704,17
0.98,0.0001,899,905,25,10,0.01,1804,17
0.98,0.0001,945,959,25,10,0.01,1904,17
0.984,0.0001,997,1007,25,10,0.01,2004,17
0.516,0.0001,54,50,25,10,0.01,104,18
0.564,0.0001,99,105,25,10,0.01,204,18
0.604,0.0001,144,160,25,10,0.01,304,18
0.604,0.0001,197,207,25,10,0.01,404,18
0.63,0.0001,252,252,25,10,0.01,504,18
0.652,0.0001,296,308,25,10,0.01,604,18
0.684,0.0001,348,356,25,10,0.01,704,18
0.722,0.0001,394,410,25,10,0.01,804,18
0.79,0.0001,448,456,25,10,0.01,904,18
0.834,0.0001,502,502,25,10,0.01,1004,18
0.856,0.0001,558,546,25,10,0.01,1104,18
0.86,0.0001,607,597,25,10,0.01,1204,18
0.886,0.0001,657,647,25,10,0.01,1304,18
0.914,0.0001,698,706,25,10,0.01,1404,18
0.928,0.0001,748,756,25,10,0.01,1504,18
0.928,0.0001,789,815,25,10,0.01,1604,18
0.938,0.0001,837,867,25,10,0.01,1704,18
0.944,0.0001,887,917,25,10,0.01,1804,18
0.95,0.0001,936,968,25,10,0.01,1904,18
0.952,0.0001,982,1022,25,10,0.01,2004,18
0.522,0.0001,52,52,25,10,0.01,104,19
0.546,0.0001,103,101,25,10,0.01,204,19
0.556,0.0001,152,152,25,10,0.01,304,19
0.576,0.0001,209,195,25,10,0.01,404,19
0.584,0.0001,259,245,25,10,0.01,504,19
0.616,0.0001,315,289,25,10,0.01,604,19
0.634,0.0001,366,338,25,10,0.01,704,19
0.67,0.0001,414,390,25,10,0.01,804,19
0.7,0.0001,461,443,25,10,0.01,904,19
0.768,0.0001,517,487,25,10,0.01,1004,19
0.78,0.0001,563,541,25,10,0.01,1104,19
0.83,0.0001,617,587,25,10,0.01,1204,19
0.856,0.0001,668,636,25,10,0.01,1304,19
0.884,0.0001,714,690,25,10,0.01,1404,19
0.888,0.0001,758,746,25,10,0.01,1504,19
0.912,0.0001,805,799,25,10,0.01,1604,19
0.912,0.0001,851,853,25,10,0.01,1704,19
0.93,0.0001,901,903,25,10,0.01,1804,19
0.932,0.0001,945,959,25,10,0.01,1904,19
0.936,0.0001,1003,1001,25,10,0.01,2004,19
0.472,0.0001,49,55,25,10,0.01,104,20
0.496,0.0001,99,105,25,10,0.01,204,20
0.512,0.0001,157,147,25,10,0.01,304,20
0.526,0.0001,209,195,25,10,0.01,404,20
0.53,0.0001,256,248,25,10,0.01,504,20
0.534,0.0001,305,299,25,10,0.01,604,20
0.538,0.0001,357,347,25,10,0.01,704,20
0.57,0.0001,411,393,25,10,0.01,804,20
0.602,0.0001,468,436,25,10,0.01,904,20
0.636,0.0001,523,481,25,10,0.01,1004,20
0.654,0.0001,577,527,25,10,0.01,1104,20
0.672,0.0001,624,580,25,10,0.01,1204,20
0.672,0.0001,668,636,25,10,0.01,1304,20
0.722,0.0001,718,686,25,10,0.01,1404,20
0.754,0.0001,765,739,25,10,0.01,1504,20
0.812,0.0001,816,788,25,10,0.01,1604,20
0.844,0.0001,854,850,25,10,0.01,1704,20
0.86,0.0001,900,904,25,10,0.01,1804,20
0.878,0.0001,954,950,25,10,0.01,1904,20
0.9,0.0001,999,1005,25,10,0.01,2004,20
0.478,0.001,50,54,25,10,0.0001,104,1
0.478,0.001,102,102,25,10,0.0001,204,1
0.478,0.001,156,148,25,10,0.0001,304,1
0.478,0.001,211,193,25,10,0.0001,404,1
0.478,0.001,254,250,25,10,0.0001,504,1
0.478,0.001,310,294,25,10,0.0001,604,1
0.478,0.001,361,343,25,10,0.0001,704,1
0.478,0.001,411,393,25,10,0.0001,804,1
0.478,0.001,460,444,25,10,0.0001,904,1
0.478,0.001,510,494,25,10,0.0001,1004,1
0.478,0.001,559,545,25,10,0.0001,1104,1
0.478,0.001,608,596,25,10,0.0001,1204,1
0.478,0.001,661,643,25,10,0.0001,1304,1
0.478,0.001,717,687,25,10,0.0001,1404,1
0.478,0.001,766,738,25,10,0.0001,1504,1
0.478,0.001,819,785,25,10,0.0001,1604,1
0.478,0.001,863,841,25,10,0.0001,1704,1
0.478,0.001,909,895,25,10,0.0001,1804,1
0.478,0.001,960,944,25,10,0.0001,1904,1
0.478,0.001,1014,990,25,10,0.0001,2004,1
0.474,0.001,52,52,25,10,0.0001,104,2
0.474,0.001,97,107,25,10,0.0001,204,2
0.474,0.001,148,156,25,10,0.0001,304,2
0.474,0.001,198,206,25,10,0.0001,404,2
0.472,0.001,253,251,25,10,0.0001,504,2
0.472,0.001,303,301,25,10,0.0001,604,2
0.472,0.001,354,350,25,10,0.0001,704,2
0.472,0.001,396,408,25,10,0.0001,804,2
0.472,0.001,434,470,25,10,0.0001,904,2
0.474,0.001,486,518,25,10,0.0001,1004,2
0.474,0.001,540,564,25,10,0.0001,1104,2
0.474,0.001,587,617,25,10,0.0001,1204,2
0.472,0.001,631,673,25,10,0.0001,1304,2
0.474,0.001,686,718,25,10,0.0001,1404,2
0.474,0.001,730,774,25,10,0.0001,1504,2
0.476,0.001,777,827,25,10,0.0001,1604,2
0.476,0.001,833,871,25,10,0.0001,1704,2
0.476,0.001,885,919,25,10,0.0001,1804,2
0.474,0.001,930,974,25,10,0.0001,1904,2
0.472,0.001,984,1020,25,10,0.0001,2004,2
0.52,0.001,56,48,25,10,0.0001,104,3
0.52,0.001,107,97,25,10,0.0001,204,3
0.52,0.001,168,136,25,10,0.0001,304,3
0.52,0.001,217,187,25,10,0.0001,404,3
0.52,0.001,260,244,25,10,0.0001,504,3
0.52,0.001,308,296,25,10,0.0001,604,3
0.52,0.001,353,351,25,10,0.0001,704,3
0.52,0.001,407,397,25,10,0.0001,804,3
0.52,0.001,447,457,25,10,0.0001,904,3
0.518,0.001,499,505,25,10,0.0001,1004,3
0.52,0.001,541,563,25,10,0.0001,1104,3
0.52,0.001,589,615,25,10,0.0001,1204,3
0.524,0.001,644,660,25,10,0.0001,1304,3
0.524,0.001,695,709,25,10,0.0001,1404,3
0.526,0.001,755,749,25,10,0.0001,1504,3
0.526,0.001,805,799,25,10,0.0001,1604,3
0.526,0.001,857,847,25,10,0.0001,1704,3
0.53,0.001,903,901,25,10,0.0001,1804,3
0.53,0.001,953,951,25,10,0.0001,1904,3
0.528,0.001,997,1007,25,10,0.0001,2004,3
0.504,0.001,53,51,25,10,0.0001,104,4
0.504,0.001,105,99,25,10,0.0001,204,4
0.504,0.001,154,150,25,10,0.0001,304,4
0.504,0.001,202,202,25,10,0.0001,404,4
0.504,0.001,254,250,25,10,0.0001,504,4
0.508,0.001,303,301,25,10,0.0001,604,4
0.508,0.001,354,350,25,10,0.0001,704,4
0.508,0.001,409,395,25,10,0.0001,804,4
0.51,0.001,457,447,25,10,0.0001,904,4
0.51,0.001,504,500,25,10,0.0001,1004,4
0.508,0.001,554,550,25,10,0.0001,1104,4
0.508,0.001,595,609,25,10,0.0001,1204,4
0.508,0.001,638,666,25,10,0.0001,1304,4
0.508,0.001,696,708,25,10,0.0001,1404,4
0.506,0.001,743,761,25,10,0.0001,1504,4
0.506,0.001,792,812,25,10,0.0001,1604,4
0.506,0.001,839,865,25,10,0.0001,1704,4
0.508,0.001,886,918,25,10,0.0001,1804,4
0.508,0.001,943,961,25,10,0.0001,1904,4
0.508,0.001,1000,1004,25,10,0.0001,2004,4
0.506,0.001,52,52,25,10,0.0001,104,5
0.506,0.001,99,105,25,10,0.0001,204,5
0.506,0.001,146,158,25,10,0.0001,304,5
0.506,0.001,200,204,25,10,0.0001,404,5
0.508,0.001,252,252,25,10,0.0001,504,5
0.508,0.001,313,291,25,10,0.0001,604,5
0.51,0.001,360,344,25,10,0.0001,704,5
0.512,0.001,413,391,25,10,0.0001,804,5
0.512,0.001,468,436,25,10,0.0001,904,5
0.512,0.001,512,492,25,10,0.0001,1004,5
0.512,0.001,564,540,25,10,0.0001,1104,5
0.512,0.001,612,592,25,10,0.0001,1204,5
0.51,0.001,662,642,25,10,0.0001,1304,5
0.51,0.001,711,693,25,10,0.0001,1404,5
0.51,0.001,762,742,25,10,0.0001,1504,5
0.508,0.001,810,794,25,10,0.0001,1604,5
0.51,0.001,855,849,25,10,0.0001,1704,5
0.51,0.001,902,902,25,10,0.0001,1804,5
0.514,0.001,957,947,25,10,0.0001,1904,5
0.514,0.001,1009,995,25,10,0.0001,2004,5
0.478,0.001,55,49,25,10,0.0001,104,6
0.478,0.001,97,107,25,10,0.0001,204,6
0.474,0.001,139,165,25,10,0.0001,304,6
0.474,0.001,192,212,25,10,0.0001,404,6
0.476,0.001,250,254,25,10,0.0001,504,6
0.476,0.001,298,306,25,10,0.0001,604,6
0.476,0.001,346,358,25,10,0.0001,704,6
0.476,0.001,394,410,25,10,0.0001,804,6
0.478,0.001,439,465,25,10,0.0001,904,6
0.478,0.001,482,522,25,10,0.0001,1004,6
0.476,0.001,536,568,25,10,0.0001,1104,6
0.476,0.001,584,620,25,10,0.0001,1204,6
0.48,0.001,640,664,25,10,0.0001,1304,6
0.478,0.001,690,714,25,10,0.0001,1404,6
0.48,0.001,748,756,25,10,0.0001,1504,6
0.482,0.001,805,799,25,10,0.0001,1604,6
0.48,0.001,849,855,25,10,0.0001,1704,6
0.484,0.001,900,904,25,10,0.0001,1804,6
0.484,0.001,951,953,25,10,0.0001,1904,6
0.484,0.001,1010,994,25,10,0.0001,2004,6
0.488,0.001,44,60,25,10,0.0001,104,7
0.488,0.001,101,103,25,10,0.0001,204,7
0.488,0.001,154,150,25,10,0.0001,304,7
0.488,0.001,203,201,25,10,0.0001,404,7
0.488,0.001,254,250,25,10,0.0001,504,7
0.488,0.001,311,293,25,10,0.0001,604,7
0.488,0.001,352,352,25,10,0.0001,704,7
0.488,0.001,410,394,25,10,0.0001,804,7
0.488,0.001,447,457,25,10,0.0001,904,7
0.488,0.001,486,518,25,10,0.0001,1004,7
0.488,0.001,537,567,25,10,0.0001,1104,7
0.49,0.001,594,610,25,10,0.0001,1204,7
0.488,0.001,652,652,25,10,0.0001,1304,7
0.49,0.001,703,701,25,10,0.0001,1404,7
0.492,0.001,753,751,25,10,0.0001,1504,7
0.492,0.001,811,793,25,10,0.0001,1604,7
0.494,0.001,856,848,25,10,0.0001,1704,7
0.494,0.001,904,900,25,10,0.0001,1804,7
0.494,0.001,958,946,25,10,0.0001,1904,7
0.496,0.001,1002,1002,25,10,0.0001,2004,7
0.52,0.001,43,61,25,10,0.0001,104,8
0.52,0.001,96,108,25,10,0.0001,204,8
0.52,0.001,147,157,25,10,0.0001,304,8
0.52,0.001,199,205,25,10,0.0001,404,8
0.52,0.001,241,263,25,10,0.0001,504,8
0.52,0.001,292,312,25,10,0.0001,604,8
0.52,0.001,338,366,25,10,0.0001,704,8
0.52,0.001,386,418,25,10,0.0001,804,8
0.52,0.001,445,459,25,10,0.0001,904,8
0.52,0.001,501,503,25,10,0.0001,1004,8
0.52,0.001,548,556,25,10,0.0001,1104,8
0.52,0.001,601,603,25,10,0.0001,1204,8
0.52,0.001,644,660,25,10,0.0001,1304,8
0.52,0.001,694,710,25,10,0.0001,1404,8
0.518,0.001,744,760,25,10,0.0001,1504,8
0.52,0.001,805,799,25,10,0.0001,1604,8
0.522,0.001,853,851,25,10,0.0001,1704,8
0.524,0.001,906,898,25,10,0.0001,1804,8
0.524,0.001,946,958,25,10,0.0001,1904,8
0.524,0.001,1004,1000,25,10,0.0001,2004,8
0.508,0.001,53,51,25,10,0.0001,104,9
0.508,0.001,100,104,25,10,0.0001,204,9
0.508,0.001,154,150,25,10,0.0001,304,9
0.508,0.001,208,196,25,10,0.0001,404,9
0.508,0.001,259,245,25,10,0.0001,504,9
0.508,0.001,310,294,25,10,0.0001,604,9
0.508,0.001,364,340,25,10,0.0001,704,9
0.508,0.001,413,391,25,10,0.0001,804,9
0.508,0.001,460,444,25,10,0.0001,904,9
0.508,0.001,503,501,25,10,0.0001,1004,9
0.508,0.001,553,551,25,10,0.0001,1104,9
0.508,0.001,600,604,25,10,0.0001,1204,9
0.508,0.001,647,657,25,10,0.0001,1304,9
0.506,0.001,697,707,25,10,0.0001,1404,9
0.506,0.001,749,755,25,10,0.0001,1504,9
0.506,0.001,805,799,25,10,0.0001,1604,9
0.506,0.001,856,848,25,10,0.0001,1704,9
0.506,0.001,900,904,25,10,0.0001,1804,9
0.506,0.001,943,961,25,10,0.0001,1904,9
0.506,0.001,996,1008,25,10,0.0001,2004,9
0.54,0.001,60,44,25,10,0.0001,104,10
0.54,0.001,107,97,25,10,0.0001,204,10
0.54,0.001,164,140,25,10,0.0001,304,10
0.538,0.001,202,202,25,10,0.0001,404,10
0.538,0.001,249,255,25,10,0.0001,504,10
0.54,0.001,299,305,25,10,0.0001,604,10
0.54,0.001,355,349,25,10,0.0001,704,10
0.54,0.001,403,401,25,10,0.0001,804,10
0.54,0.001,448,456,25,10,0.0001,904,10
0.542,0.001,504,500,25,10,0.0001,1004,10
0.542,0.001,553,551,25,10,0.0001,1104,10
0.542,0.001,609,595,25,10,0.0001,1204,10
0.54,0.001,653,651,25,10,0.0001,1304,10
0.54,0.001,702,702,25,10,0.0001,1404,10
0.54,0.001,748,756,25,10,0.0001,1504,10
0.54,0.001,798,806,25,10,0.0001,1604,10
0.54,0.001,851,853,25,10,0.0001,1704,10
0.542,0.001,903,901,25,10,0.0001,1804,10
0.544,0.001,960,944,25,10,0.0001,1904,10
0.544,0.001,1009,995,25,10,0.0001,2004,10
0.446,0.001,50,54,25,10,0.0001,104,11
0.446,0.001,105,99,25,10,0.0001,204,11
0.446,0.001,163,141,25,10,0.0001,304,11
0.446,0.001,212,192,25,10,0.0001,404,11
0.444,0.001,253,251,25,10,0.0001,504,11
0.444,0.001,306,298,25,10,0.0001,604,11
0.446,0.001,361,343,25,10,0.0001,704,11
0.446,0.001,409,395,25,10,0.0001,804,11
0.448,0.001,459,445,25,10,0.0001,904,11
0.448,0.001,514,490,25,10,0.0001,1004,11
0.448,0.001,559,545,25,10,0.0001,1104,11
0.45,0.001,607,597,25,10,0.0001,1204,11
0.448,0.001,658,646,25,10,0.0001,1304,11
0.452,0.001,703,701,25,10,0.0001,1404,11
0.452,0.001,753,751,25,10,0.0001,1504,11
0.452,0.001,801,803,25,10,0.0001,1604,11
0.45,0.001,852,852,25,10,0.0001,1704,11
0.452,0.001,907,897,25,10,0.0001,1804,11
0.454,0.001,956,948,25,10,0.0001,1904,11
0.454,0.001,1006,998,25,10,0.0001,2004,11
0.476,0.001,53,51,25,10,0.0001,104,12
0.476,0.001,106,98,25,10,0.0001,204,12
0.476,0.001,150,154,25,10,0.0001,304,12
0.476,0.001,195,209,25,10,0.0001,404,12
0.476,0.001,245,259,25,10,0.0001,504,12
0.476,0.001,294,310,25,10,0.0001,604,12
0.476,0.001,342,362,25,10,0.0001,704,12
0.476,0.001,403,401,25,10,0.0001,804,12
0.478,0.001,449,455,25,10,0.0001,904,12
0.478,0.001,496,508,25,10,0.0001,1004,12
0.478,0.001,538,566,25,10,0.0001,1104,12
0.48,0.001,588,616,25,10,0.0001,1204,12
0.48,0.001,636,668,25,10,0.0001,1304,12
0.482,0.001,695,709,25,10,0.0001,1404,12
0.486,0.001,746,758,25,10,0.0001,1504,12
0.486,0.001,800,804,25,10,0.0001,1604,12
0.486,0.001,855,849,25,10,0.0001,1704,12
0.488,0.001,905,899,25,10,0.0001,1804,12
0.492,0.001,956,948,25,10,0.0001,1904,12
0.492,0.001,1001,1003,25,10,0.0001,2004,12
0.5,0.001,61,43,25,10,0.0001,104,13
0.502,0.001,113,91,25,10,0.0001,204,13
0.502,0.001,165,139,25,10,0.0001,304,13
0.5,0.001,217,187,25,10,0.0001,404,13
0.5,0.001,265,239,25,10,0.0001,504,13
0.5,0.001,315,289,25,10,0.0001,604,13
0.5,0.001,362,342,25,10,0.0001,704,13
0.5,0.001,416,388,25,10,0.0001,804,13
0.502,0.001,468,436,25,10,0.0001,904,13
0.502,0.001,512,492,25,10,0.0001,1004,13
0.502,0.001,575,529,25,10,0.0001,1104,13
0.502,0.001,620,584,25,10,0.0001,1204,13
0.502,0.001,671,633,25,10,0.0001,1304,13
0.504,0.001,723,681,25,10,0.0001,1404,13
0.502,0.001,772,732,25,10,0.0001,1504,13
0.502,0.001,824,780,25,10,0.0001,1604,13
0.506,0.001,871,833,25,10,0.0001,1704,13
0.508,0.001,912,892,25,10,0.0001,1804,13
0.51,0.001,959,945,25,10,0.0001,1904,13
0.51,0.001,1000,1004,25,10,0.0001,2004,13
0.52,0.001,49,55,25,10,0.0001,104,14
0.52,0.001,103,101,25,10,0.0001,204,14
0.52,0.001,157,147,25,10,0.0001,304,14
0.524,0.001,206,198,25,10,0.0001,404,14
0.524,0.001,256,248,25,10,0.0001,504,14
0.526,0.001,310,294,25,10,0.0001,604,14
0.526,0.001,365,339,25,10,0.0001,704,14
0.526,0.001,418,386,25,10,0.0001,804,14
0.526,0.001,464,440,25,10,0.0001,904,14
0.526,0.001,519,485,25,10,0.0001,1004,14
0.528,0.001,568,536,25,10,0.0001,1104,14
0.53,0.001,613,591,25,10,0.0001,1204,14
0.532,0.001,674,630,25,10,0.0001,1304,14
0.532,0.001,723,681,25,10,0.0001,1404,14
0.534,0.001,781,723,25,10,0.0001,1504,14
0.538,0.001,824,780,25,10,0.0001,1604,14
0.542,0.001,870,834,25,10,0.0001,1704,14
0.542,0.001,908,896,25,10,0.0001,1804,14
0.544,0.001,959,945,25,10,0.0001,1904,14
0.548,0.001,1007,997,25,10,0.0001,2004,14
0.484,0.001,55,49,25,10,0.0001,104,15
0.484,0.001,103,101,25,10,0.0001,204,15
0.484,0.001,157,147,25,10,0.0001,304,15
0.484,0.001,213,191,25,10,0.0001,404,15
0.484,0.001,259,245,25,10,0.0001,504,15
0.484,0.001,305,299,25,10,0.0001,604,15
0.484,0.001,363,341,25,10,0.0001,704,15
0.484,0.001,416,388,25,10,0.0001,804,15
0.484,0.001,456,448,25,10,0.0001,904,15
0.484,0.001,505,499,25,10,0.0001,1004,15
0.484,0.001,550,554,25,10,0.0001,1104,15
0.484,0.001,595,609,25,10,0.0001,1204,15
0.484,0.001,641,663,25,10,0.0001,1304,15
0.484,0.001,691,713,25,10,0.0001,1404,15
0.484,0.001,752,752,25,10,0.0001,1504,15
0.484,0.001,798,806,25,10,0.0001,1604,15
0.484,0.001,851,853,25,10,0.0001,1704,15
0.484,0.001,907,897,25,10,0.0001,1804,15
0.484,0.001,956,948,25,10,0.0001,1904,15
0.484,0.001,1010,994,25,10,0.0001,2004,15
0.506,0.001,54,50,25,10,0.0001,104,16
0.506,0.001,99,105,25,10,0.0001,204,16
0.506,0.001,153,151,25,10,0.0001,304,16
0.506,0.001,204,200,25,10,0.0001,404,16
0.506,0.001,245,259,25,10,0.0001,504,16
0.506,0.001,291,313,25,10,0.0001,604,16
0.506,0.001,343,361,25,10,0.0001,704,16
0.504,0.001,397,407,25,10,0.0001,804,16
0.504,0.001,436,468,25,10,0.0001,904,16
0.504,0.001,484,520,25,10,0.0001,1004,16
0.504,0.001,532,572,25,10,0.0001,1104,16
0.504,0.001,586,618,25,10,0.0001,1204,16
0.504,0.001,631,673,25,10,0.0001,1304,16
0.504,0.001,685,719,25,10,0.0001,1404,16
0.506,0.001,736,768,25,10,0.0001,1504,16
0.506,0.001,797,807,25,10,0.0001,1604,16
0.506,0.001,850,854,25,10,0.0001,1704,16
0.506,0.001,906,898,25,10,0.0001,1804,16
0.506,0.001,947,957,25,10,0.0001,1904,16
0.508,0.001,1002,1002,25,10,0.0001,2004,16
0.508,0.001,58,46,25,10,0.0001,104,17
0.51,0.001,112,92,25,10,0.0001,204,17
0.51,0.001,174,130,25,10,0.0001,304,17
0.51,0.001,225,179,25,10,0.0001,404,17
0.508,0.001,271,233,25,10,0.0001,504,17
0.508,0.001,321,283,25,10,0.0001,604,17
0.508,0.001,373,331,25,10,0.0001,704,17
0.508,0.001,421,383,25,10,0.0001,804,17
0.506,0.001,472,432,25,10,0.0001,904,17
0.506,0.001,520,484,25,10,0.0001,1004,17
0.506,0.001,571,533,25,10,0.0001,1104,17
0.508,0.001,622,582,25,10,0.0001,1204,17
0.508,0.001,666,638,25,10,0.0001,1304,17
0.508,0.001,709,695,25,10,0.0001,1404,17
0.506,0.001,753,751,25,10,0.0001,1504,17
0.508,0.001,816,788,25,10,0.0001,1604,17
0.508,0.001,860,844,25,10,0.0001,1704,17
0.508,0.001,911,893,25,10,0.0001,1804,17
0.51,0.001,957,947,25,10,0.0001,1904,17
0.51,0.001,1001,1003,25,10,0.0001,2004,17
0.5,0.001,52,52,25,10,0.0001,104,18
0.5,0.001,105,99,25,10,0.0001,204,18
0.5,0.001,156,148,25,10,0.0001,304,18
0.5,0.001,205,199,25,10,0.0001,404,18
0.5,0.001,257,247,25,10,0.0001,504,18
0.5,0.001,313,291,25,10,0.0001,604,18
0.5,0.001,361,343,25,10,0.0001,704,18
0.5,0.001,415,389,25,10,0.0001,804,18
0.5,0.001,462,442,25,10,0.0001,904,18
0.5,0.001,511,493,25,10,0.0001,1004,18
0.5,0.001,572,532,25,10,0.0001,1104,18
0.5,0.001,626,578,25,10,0.0001,1204,18
0.5,0.001,676,628,25,10,0.0001,1304,18
0.502,0.001,723,681,25,10,0.0001,1404,18
0.502,0.001,769,735,25,10,0.0001,1504,18
0.502,0.001,803,801,25,10,0.0001,1604,18
0.502,0.001,851,853,25,10,0.0001,1704,18
0.504,0.001,906,898,25,10,0.0001,1804,18
0.504,0.001,957,947,25,10,0.0001,1904,18
0.504,0.001,1008,996,25,10,0.0001,2004,18
0.524,0.001,54,50,25,10,0.0001,104,19
0.524,0.001,102,102,25,10,0.0001,204,19
0.526,0.001,154,150,25,10,0.0001,304,19
0.528,0.001,196,208,25,10,0.0001,404,19
0.528,0.001,240,264,25,10,0.0001,504,19
0.528,0.001,288,316,25,10,0.0001,604,19
0.53,0.001,334,370,25,10,0.0001,704,19
0.53,0.001,381,423,25,10,0.0001,804,19
0.53,0.001,430,474,25,10,0.0001,904,19
0.53,0.001,483,521,25,10,0.0001,1004,19
0.53,0.001,529,575,25,10,0.0001,1104,19
0.53,0.001,579,625,25,10,0.0001,1204,19
0.528,0.001,633,671,25,10,0.0001,1304,19
0.528,0.001,689,715,25,10,0.0001,1404,19
0.528,0.001,734,770,25,10,0.0001,1504,19
0.526,0.001,788,816,25,10,0.0001,1604,19
0.53,0.001,840,864,25,10,0.0001,1704,19
0.532,0.001,896,908,25,10,0.0001,1804,19
0.53,0.001,953,951,25,10,0.0001,1904,19
0.536,0.001,998,1006,25,10,0.0001,2004,19
0.5,0.001,50,54,25,10,0.0001,104,20
0.5,0.001,100,104,25,10,0.0001,204,20
0.502,0.001,156,148,25,10,0.0001,304,20
0.502,0.001,210,194,25,10,0.0001,404,20
0.502,0.001,269,235,25,10,0.0001,504,20
0.502,0.001,319,285,25,10,0.0001,604,20
0.502,0.001,366,338,25,10,0.0001,704,20
0.504,0.001,416,388,25,10,0.0001,804,20
0.506,0.001,454,450,25,10,0.0001,904,20
0.502,0.001,503,501,25,10,0.0001,1004,20
0.502,0.001,557,547,25,10,0.0001,1104,20
0.502,0.001,606,598,25,10,0.0001,1204,20
0.502,0.001,652,652,25,10,0.0001,1304,20
0.5,0.001,706,698,25,10,0.0001,1404,20
0.5,0.001,763,741,25,10,0.0001,1504,20
0.5,0.001,811,793,25,10,0.0001,1604,20
0.5,0.001,865,839,25,10,0.0001,1704,20
0.502,0.001,905,899,25,10,0.0001,1804,20
0.506,0.001,966,938,25,10,0.0001,1904,20
0.508,0.001,1016,988,25,10,0.0001,2004,20
0.508,0.001,53,51,25,10,0.001,104,1
0.51,0.001,111,93,25,10,0.001,204,1
0.512,0.001,156,148,25,10,0.001,304,1
0.512,0.001,205,199,25,10,0.001,404,1
0.512,0.001,253,251,25,10,0.001,504,1
0.512,0.001,301,303,25,10,0.001,604,1
0.514,0.001,351,353,25,10,0.001,704,1
0.514,0.001,405,399,25,10,0.001,804,1
0.522,0.001,455,449,25,10,0.001,904,1
0.524,0.001,499,505,25,10,0.001,1004,1
0.526,0.001,548,556,25,10,0.001,1104,1
0.528,0.001,608,596,25,10,0.001,1204,1
0.534,0.001,661,643,25,10,0.001,1304,1
0.536,0.001,702,702,25,10,0.001,1404,1
0.54,0.001,747,757,25,10,0.001,1504,1
0.542,0.001,797,807,25,10,0.001,1604,1
0.548,0.001,841,863,25,10,0.001,1704,1
0.564,0.001,894,910,25,10,0.001,1804,1
0.58,0.001,944,960,25,10,0.001,1904,1
0.592,0.001,994,1010,25,10,0.001,2004,1
0.488,0.001,56,48,25,10,0.001,104,2
0.49,0.001,93,111,25,10,0.001,204,2
0.492,0.001,146,158,25,10,0.001,304,2
0.492,0.001,205,199,25,10,0.001,404,2
0.484,0.001,256,248,25,10,0.001,504,2
0.492,0.001,309,295,25,10,0.001,604,2
0.492,0.001,359,345,25,10,0.001,704,2
0.486,0.001,408,396,25,10,0.001,804,2
0.484,0.001,455,449,25,10,0.001,904,2
0.49,0.001,506,498,25,10,0.001,1004,2
0.504,0.001,551,553,25,10,0.001,1104,2
0.512,0.001,600,604,25,10,0.001,1204,2
0.524,0.001,646,658,25,10,0.001,1304,2
0.546,0.001,693,711,25,10,0.001,1404,2
0.544,0.001,737,767,25,10,0.001,1504,2
0.548,0.001,781,823,25,10,0.001,1604,2
0.56,0.001,835,869,25,10,0.001,1704,2
0.586,0.001,888,916,25,10,0.001,1804,2
0.592,0.001,940,964,25,10,0.001,1904,2
0.602,0.001,1003,1001,25,10,0.001,2004,2
0.506,0.001,54,50,25,10,0.001,104,3
0.508,0.001,102,102,25,10,0.001,204,3
0.508,0.001,150,154,25,10,0.001,304,3
0.508,0.001,200,204,25,10,0.001,404,3
0.506,0.001,248,256,25,10,0.001,504,3
0.506,0.001,300,304,25,10,0.001,604,3
0.504,0.001,352,352,25,10,0.001,704,3
0.504,0.001,405,399,25,10,0.001,804,3
0.506,0.001,454,450,25,10,0.001,904,3
0.502,0.001,502,502,25,10,0.001,1004,3
0.508,0.001,546,558,25,10,0.001,1104,3
0.516,0.001,596,608,25,10,0.001,1204,3
0.51,0.001,649,655,25,10,0.001,1304,3
0.516,0.001,700,704,25,10,0.001,1404,3
0.516,0.001,752,752,25,10,0.001,1504,3
0.522,0.001,797,807,25,10,0.001,1604,3
0.522,0.001,845,859,25,10,0.001,1704,3
0.526,0.001,897,907,25,10,0.001,1804,3
0.526,0.001,948,956,25,10,0.001,1904,3
0.534,0.001,998,1006,25,10,0.001,2004,3
0.49,0.001,60,44,25,10,0.001,104,4
0.49,0.001,106,98,25,10,0.001,204,4
0.492,0.001,145,159,25,10,0.001,304,4
0.49,0.001,194,210,25,10,0.001,404,4
0.488,0.001,243,261,25,10,0.001,504,4
0.484,0.001,286,318,25,10,0.001,604,4
0.486,0.001,339,365,25,10,0.001,704,4
0.484,0.001,387,417,25,10,0.001,804,4
0.496,0.001,441,463,25,10,0.001,904,4
0.5,0.001,493,511,25,10,0.001,1004,4
0.498,0.001,541,563,25,10,0.001,1104,4
0.502,0.001,594,610,25,10,0.001,1204,4
0.514,0.001,642,662,25,10,0.001,1304,4
0.518,0.001,693,711,25,10,0.001,1404,4
0.528,0.001,744,760,25,10,0.001,1504,4
0.532,0.001,795,809,25,10,0.001,1604,4
0.542,0.001,845,859,25,10,0.001,1704,4
0.55,0.001,903,901,25,10,0.001,1804,4
0.568,0.001,953,951,25,10,0.001,1904,4
0.568,0.001,1001,1003,25,10,0.001,2004,4
0.482,0.001,52,52,25,10,0.001,104,5
0.48,0.001,99,105,25,10,0.001,204,5
0.482,0.001,140,164,25,10,0.001,304,5
0.488,0.001,198,206,25,10,0.001,404,5
0.492,0.001,258,246,25,10,0.001,504,5
0.498,0.001,305,299,25,10,0.001,604,5
0.508,0.001,352,352,25,10,0.001,704,5
0.504,0.001,398,406,25,10,0.001,804,5
0.498,0.001,449,455,25,10,0.001,904,5
0.494,0.001,497,507,25,10,0.001,1004,5
0.504,0.001,548,556,25,10,0.001,1104,5
0.512,0.001,594,610,25,10,0.001,1204,5
0.52,0.001,637,667,25,10,0.001,1304,5
0.522,0.001,684,720,25,10,0.001,1404,5
0.53,0.001,738,766,25,10,0.001,1504,5
0.538,0.001,783,821,25,10,0.001,1604,5
0.542,0.001,834,870,25,10,0.001,1704,5
0.556,0.001,888,916,25,10,0.001,1804,5
0.56,0.001,940,964,25,10,0.001,1904,5
0.574,0.001,994,1010,25,10,0.001,2004,5
0.546,0.001,57,47,25,10,0.001,104,6
0.546,0.001,111,93,25,10,0.001,204,6
0.546,0.001,157,147,25,10,0.001,304,6
0.548,0.001,213,191,25,10,0.001,404,6
0.546,0.001,274,230,25,10,0.001,504,6
0.546,0.001,313,291,25,10,0.001,604,6
0.55,0.001,362,342,25,10,0.001,704,6
0.552,0.001,417,387,25,10,0.001,804,6
0.554,0.001,465,439,25,10,0.001,904,6
0.568,0.001,515,489,25,10,0.001,1004,6
0.576,0.001,569,535,25,10,0.001,1104,6
0.57,0.001,624,580,25,10,0.001,1204,6
0.584,0.001,686,618,25,10,0.001,1304,6
0.596,0.001,730,674,25,10,0.001,1404,6
0.604,0.001,784,720,25,10,0.001,1504,6
0.628,0.001,836,768,25,10,0.001,1604,6
0.64,0.001,892,812,25,10,0.001,1704,6
0.64,0.001,939,865,25,10,0.001,1804,6
0.648,0.001,982,922,25,10,0.001,1904,6
0.658,0.001,1030,974,25,10,0.001,2004,6
0.498,0.001,56,48,25,10,0.001,104,7
0.498,0.001,117,87,25,10,0.001,204,7
0.498,0.001,166,138,25,10,0.001,304,7
0.498,0.001,214,190,25,10,0.001,404,7
0.498,0.001,264,240,25,10,0.001,504,7
0.498,0.001,317,287,25,10,0.001,604,7
0.498,0.001,366,338,25,10,0.001,704,7
0.498,0.001,414,390,25,10,0.001,804,7
0.498,0.001,470,434,25,10,0.001,904,7
0.498,0.001,512,492,25,10,0.001,1004,7
0.498,0.001,563,541,25,10,0.001,1104,7
0.498,0.001,606,598,25,10,0.001,1204,7
0.498,0.001,650,654,25,10,0.001,1304,7
0.498,0.001,696,708,25,10,0.001,1404,7
0.498,0.001,752,752,25,10,0.001,1504,7
0.498,0.001,790,814,25,10,0.001,1604,7
0.498,0.001,847,857,25,10,0.001,1704,7
0.498,0.001,888,916,25,10,0.001,1804,7
0.498,0.001,951,953,25,10,0.001,1904,7
0.498,0.001,1001,1003,25,10,0.001,2004,7
0.512,0.001,55,49,25,10,0.001,104,8
0.518,0.001,107,97,25,10,0.001,204,8
0.514,0.001,163,141,25,10,0.001,304,8
0.508,0.001,207,197,25,10,0.001,404,8
0.51,0.001,256,248,25,10,0.001,504,8
0.514,0.001,301,303,25,10,0.001,604,8
0.518,0.001,349,355,25,10,0.001,704,8
0.526,0.001,395,409,25,10,0.001,804,8
0.526,0.001,445,459,25,10,0.001,904,8
0.534,0.001,490,514,25,10,0.001,1004,8
0.538,0.001,549,555,25,10,0.001,1104,8
0.55,0.001,597,607,25,10,0.001,1204,8
0.55,0.001,653,651,25,10,0.001,1304,8
0.548,0.001,704,700,25,10,0.001,1404,8
0.544,0.001,762,742,25,10,0.001,1504,8
0.542,0.001,816,788,25,10,0.001,1604,8
0.546,0.001,863,841,25,10,0.001,1704,8
0.554,0.001,911,893,25,10,0.001,1804,8
0.564,0.001,959,945,25,10,0.001,1904,8
0.574,0.001,1014,990,25,10,0.001,2004,8
0.516,0.001,51,53,25,10,0.001,104,9
0.518,0.001,109,95,25,10,0.001,204,9
0.516,0.001,155,149,25,10,0.001,304,9
0.516,0.001,201,203,25,10,0.001,404,9
0.518,0.001,257,247,25,10,0.001,504,9
0.52,0.001,317,287,25,10,0.001,604,9
0.516,0.001,366,338,25,10,0.001,704,9
0.522,0.001,409,395,25,10,0.001,804,9
0.52,0.001,461,443,25,10,0.001,904,9
0.526,0.001,514,490,25,10,0.001,1004,9
0.522,0.001,566,538,25,10,0.001,1104,9
0.52,0.001,615,589,25,10,0.001,1204,9
0.52,0.001,667,637,25,10,0.001,1304,9
0.522,0.001,711,693,25,10,0.001,1404,9
0.532,0.001,759,745,25,10,0.001,1504,9
0.542,0.001,814,790,25,10,0.001,1604,9
0.542,0.001,861,843,25,10,0.001,1704,9
0.544,0.001,909,895,25,10,0.001,1804,9
0.55,0.001,955,949,25,10,0.001,1904,9
0.562,0.001,1014,990,25,10,0.001,2004,9
0.502,0.001,55,49,25,10,0.001,104,10
0.504,0.001,116,88,25,10,0.001,204,10
0.504,0.001,164,140,25,10,0.001,304,10
0.506,0.001,209,195,25,10,0.001,404,10
0.504,0.001,257,247,25,10,0.001,504,10
0.506,0.001,315,289,25,10,0.001,604,10
0.508,0.001,365,339,25,10,0.001,704,10
0.514,0.001,408,396,25,10,0.001,804,10
0.514,0.001,453,451,25,10,0.001,904,10
0.524,0.001,503,501,25,10,0.001,1004,10
0.528,0.001,557,547,25,10,0.001,1104,10
0.528,0.001,607,597,25,10,0.001,1204,10
0.53,0.001,657,647,25,10,0.001,1304,10
0.528,0.001,717,687,25,10,0.001,1404,10
0.534,0.001,760,744,25,10,0.001,1504,10
0.538,0.001,797,807,25,10,0.001,1604,10
0.544,0.001,847,857,25,10,0.001,1704,10
0.546,0.001,897,907,25,10,0.001,1804,10
0.56,0.001,952,952,25,10,0.001,1904,10
0.574,0.001,1003,1001,25,10,0.001,2004,10
0.474,0.001,48,56,25,10,0.001,104,11
0.478,0.001,102,102,25,10,0.001,204,11
0.478,0.001,157,147,25,10,0.001,304,11
0.48,0.001,207,197,25,10,0.001,404,11
0.486,0.001,254,250,25,10,0.001,504,11
0.484,0.001,312,292,25,10,0.001,604,11
0.484,0.001,360,344,25,10,0.001,704,11
0.486,0.001,401,403,25,10,0.001,804,11
0.492,0.001,450,454,25,10,0.001,904,11
0.494,0.001,495,509,25,10,0.001,1004,11
0.5,0.001,546,558,25,10,0.001,1104,11
0.498,0.001,583,621,25,10,0.001,1204,11
0.498,0.001,632,672,25,10,0.001,1304,11
0.51,0.001,680,724,25,10,0.001,1404,11
0.52,0.001,731,773,25,10,0.001,1504,11
0.53,0.001,781,823,25,10,0.001,1604,11
0.538,0.001,829,875,25,10,0.001,1704,11
0.552,0.001,876,928,25,10,0.001,1804,11
0.558,0.001,926,978,25,10,0.001,1904,11
0.556,0.001,983,1021,25,10,0.001,2004,11
0.476,0.001,48,56,25,10,0.001,104,12
0.478,0.001,100,104,25,10,0.001,204,12
0.478,0.001,150,154,25,10,0.001,304,12
0.476,0.001,191,213,25,10,0.001,404,12
0.476,0.001,248,256,25,10,0.001,504,12
0.482,0.001,296,308,25,10,0.001,604,12
0.482,0.001,344,360,25,10,0.001,704,12
0.49,0.001,400,404,25,10,0.001,804,12
0.496,0.001,440,464,25,10,0.001,904,12
0.5,0.001,487,517,25,10,0.001,1004,12
0.506,0.001,539,565,25,10,0.001,1104,12
0.512,0.001,592,612,25,10,0.001,1204,12
0.514,0.001,641,663,25,10,0.001,1304,12
0.522,0.001,693,711,25,10,0.001,1404,12
0.534,0.001,741,763,25,10,0.001,1504,12
0.534,0.001,795,809,25,10,0.001,1604,12
0.534,0.001,839,865,25,10,0.001,1704,12
0.55,0.001,887,917,25,10,0.001,1804,12
0.552,0.001,939,965,25,10,0.001,1904,12
0.548,0.001,980,1024,25,10,0.001,2004,12
0.518,0.001,59,45,25,10,0.001,104,13
0.518,0.001,106,98,25,10,0.001,204,13
0.518,0.001,152,152,25,10,0.001,304,13
0.52,0.001,199,205,25,10,0.001,404,13
0.52,0.001,248,256,25,10,0.001,504,13
0.52,0.001,310,294,25,10,0.001,604,13
0.518,0.001,359,345,25,10,0.001,704,13
0.518,0.001,410,394,25,10,0.001,804,13
0.522,0.001,460,444,25,10,0.001,904,13
0.526,0.001,516,488,25,10,0.001,1004,13
0.532,0.001,569,535,25,10,0.001,1104,13
0.544,0.001,619,585,25,10,0.001,1204,13
0.556,0.001,667,637,25,10,0.001,1304,13
0.568,0.001,721,683,25,10,0.001,1404,13
0.576,0.001,771,733,25,10,0.001,1504,13
0.576,0.001,822,782,25,10,0.001,1604,13
0.584,0.001,868,836,25,10,0.001,1704,13
0.584,0.001,912,892,25,10,0.001,1804,13
0.586,0.001,957,947,25,10,0.001,1904,13
0.592,0.001,1007,997,25,10,0.001,2004,13
0.488,0.001,53,51,25,10,0.001,104,14
0.486,0.001,98,106,25,10,0.001,204,14
0.484,0.001,155,149,25,10,0.001,304,14
0.486,0.001,206,198,25,10,0.001,404,14
0.484,0.001,251,253,25,10,0.001,504,14
0.486,0.001,295,309,25,10,0.001,604,14
0.484,0.001,344,360,25,10,0.001,704,14
0.484,0.001,395,409,25,10,0.001,804,14
0.49,0.001,434,470,25,10,0.001,904,14
0.484,0.001,488,516,25,10,0.001,1004,14
0.5,0.001,535,569,25,10,0.001,1104,14
0.52,0.001,586,618,25,10,0.001,1204,14
0.522,0.001,645,659,25,10,0.001,1304,14
0.532,0.001,698,706,25,10,0.001,1404,14
0.54,0.001,759,745,25,10,0.001,1504,14
0.544,0.001,808,796,25,10,0.001,1604,14
0.552,0.001,861,843,25,10,0.001,1704,14
0.56,0.001,909,895,25,10,0.001,1804,14
0.566,0.001,958,946,25,10,0.001,1904,14
0.574,0.001,1007,997,25,10,0.001,2004,14
0.468,0.001,56,48,25,10,0.001,104,15
0.466,0.001,104,100,25,10,0.001,204,15
0.466,0.001,160,144,25,10,0.001,304,15
0.468,0.001,213,191,25,10,0.001,404,15
0.47,0.001,259,245,25,10,0.001,504,15
0.468,0.001,312,292,25,10,0.001,604,15
0.468,0.001,364,340,25,10,0.001,704,15
0.47,0.001,414,390,25,10,0.001,804,15
0.47,0.001,464,440,25,10,0.001,904,15
0.47,0.001,514,490,25,10,0.001,1004,15
0.468,0.001,563,541,25,10,0.001,1104,15
0.472,0.001,611,593,25,10,0.001,1204,15
0.476,0.001,660,644,25,10,0.001,1304,15
0.476,0.001,714,690,25,10,0.001,1404,15
0.484,0.001,768,736,25,10,0.001,1504,15
0.486,0.001,816,788,25,10,0.001,1604,15
0.494,0.001,859,845,25,10,0.001,1704,15
0.5,0.001,912,892,25,10,0.001,1804,15
0.516,0.001,965,939,25,10,0.001,1904,15
0.526,0.001,1015,989,25,10,0.001,2004,15
0.556,0.001,61,43,25,10,0.001,104,16
0.554,0.001,114,90,25,10,0.001,204,16
0.558,0.001,164,140,25,10,0.001,304,16
0.558,0.001,213,191,25,10,0.001,404,16
0.56,0.001,260,244,25,10,0.001,504,16
0.56,0.001,306,298,25,10,0.001,604,16
0.568,0.001,352,352,25,10,0.001,704,16
0.574,0.001,398,406,25,10,0.001,804,16
0.576,0.001,454,450,25,10,0.001,904,16
0.574,0.001,492,512,25,10,0.001,1004,16
0.586,0.001,541,563,25,10,0.001,1104,16
0.588,0.001,594,610,25,10,0.001,1204,16
0.594,0.001,638,666,25,10,0.001,1304,16
0.598,0.001,694,710,25,10,0.001,1404,16
0.606,0.001,740,764,25,10,0.001,1504,16
0.612,0.001,784,820,25,10,0.001,1604,16
0.632,0.001,832,872,25,10,0.001,1704,16
0.658,0.001,877,927,25,10,0.001,1804,16
0.67,0.001,933,971,25,10,0.001,1904,16
0.69,0.001,987,1017,25,10,0.001,2004,16
0.442,0.001,46,58,25,10,0.001,104,17
0.444,0.001,94,110,25,10,0.001,204,17
0.448,0.001,140,164,25,10,0.001,304,17
0.454,0.001,181,223,25,10,0.001,404,17
0.452,0.001,238,266,25,10,0.001,504,17
0.46,0.001,289,315,25,10,0.001,604,17
0.462,0.001,334,370,25,10,0.001,704,17
0.466,0.001,385,419,25,10,0.001,804,17
0.476,0.001,437,467,25,10,0.001,904,17
0.474,0.001,493,511,25,10,0.001,1004,17
0.482,0.001,544,560,25,10,0.001,1104,17
0.486,0.001,595,609,25,10,0.001,1204,17
0.488,0.001,646,658,25,10,0.001,1304,17
0.494,0.001,694,710,25,10,0.001,1404,17
0.502,0.001,746,758,25,10,0.001,1504,17
0.496,0.001,795,809,25,10,0.001,1604,17
0.498,0.001,850,854,25,10,0.001,1704,17
0.5,0.001,900,904,25,10,0.001,1804,17
0.502,0.001,947,957,25,10,0.001,1904,17
0.514,0.001,993,1011,25,10,0.001,2004,17
0.49,0.001,63,41,25,10,0.001,104,18
0.49,0.001,114,90,25,10,0.001,204,18
0.49,0.001,167,137,25,10,0.001,304,18
0.49,0.001,213,191,25,10,0.001,404,18
0.49,0.001,262,242,25,10,0.001,504,18
0.49,0.001,307,297,25,10,0.001,604,18
0.49,0.001,347,357,25,10,0.001,704,18
0.49,0.001,400,404,25,10,0.001,804,18
0.49,0.001,446,458,25,10,0.001,904,18
0.49,0.001,504,500,25,10,0.001,1004,18
0.49,0.001,551,553,25,10,0.001,1104,18
0.49,0.001,600,604,25,10,0.001,1204,18
0.49,0.001,647,657,25,10,0.001,1304,18
0.49,0.001,699,705,25,10,0.001,1404,18
0.49,0.001,753,751,25,10,0.001,1504,18
0.49,0.001,797,807,25,10,0.001,1604,18
0.494,0.001,846,858,25,10,0.001,1704,18
0.498,0.001,894,910,25,10,0.001,1804,18
0.508,0.001,949,955,25,10,0.001,1904,18
0.512,0.001,997,1007,25,10,0.001,2004,18
0.506,0.001,51,53,25,10,0.001,104,19
0.51,0.001,104,100,25,10,0.001,204,19
0.508,0.001,150,154,25,10,0.001,304,19
0.512,0.001,202,202,25,10,0.001,404,19
0.52,0.001,248,256,25,10,0.001,504,19
0.522,0.001,295,309,25,10,0.001,604,19
0.524,0.001,344,360,25,10,0.001,704,19
0.528,0.001,393,411,25,10,0.001,804,19
0.536,0.001,443,461,25,10,0.001,904,19
0.534,0.001,486,518,25,10,0.001,1004,19
0.536,0.001,538,566,25,10,0.001,1104,19
0.538,0.001,589,615,25,10,0.001,1204,19
0.542,0.001,640,664,25,10,0.001,1304,19
0.55,0.001,694,710,25,10,0.001,1404,19
0.552,0.001,738,766,25,10,0.001,1504,19
0.56,0.001,790,814,25,10,0.001,1604,19
0.566,0.001,842,862,25,10,0.001,1704,19
0.572,0.001,893,911,25,10,0.001,1804,19
0.584,0.001,943,961,25,10,0.001,1904,19
0.596,0.001,1000,1004,25,10,0.001,2004,19
0.508,0.001,48,56,25,10,0.001,104,20
0.522,0.001,92,112,25,10,0.001,204,20
0.526,0.001,145,159,25,10,0.001,304,20
0.53,0.001,198,206,25,10,0.001,404,20
0.534,0.001,251,253,25,10,0.001,504,20
0.542,0.001,302,302,25,10,0.001,604,20
0.55,0.001,353,351,25,10,0.001,704,20
0.552,0.001,400,404,25,10,0.001,804,20
0.548,0.001,454,450,25,10,0.001,904,20
0.546,0.001,507,497,25,10,0.001,1004,20
0.546,0.001,553,551,25,10,0.001,1104,20
0.548,0.001,609,595,25,10,0.001,1204,20
0.548,0.001,666,638,25,10,0.001,1304,20
0.564,0.001,729,675,25,10,0.001,1404,20
0.564,0.001,772,732,25,10,0.001,1504,20
0.574,0.001,822,782,25,10,0.001,1604,20
0.582,0.001,870,834,25,10,0.001,1704,20
0.59,0.001,915,889,25,10,0.001,1804,20
0.596,0.001,964,940,25,10,0.001,1904,20
0.604,0.001,1016,988,25,10,0.001,2004,20
0.54,0.001,52,52,25,10,0.01,104,1
0.544,0.001,97,107,25,10,0.01,204,1
0.534,0.001,140,164,25,10,0.01,304,1
0.544,0.001,189,215,25,10,0.01,404,1
0.56,0.001,239,265,25,10,0.01,504,1
0.566,0.001,294,310,25,10,0.01,604,1
0.568,0.001,342,362,25,10,0.01,704,1
0.608,0.001,386,418,25,10,0.01,804,1
0.63,0.001,438,466,25,10,0.01,904,1
0.666,0.001,488,516,25,10,0.01,1004,1
0.708,0.001,536,568,25,10,0.01,1104,1
0.76,0.001,582,622,25,10,0.01,1204,1
0.808,0.001,637,667,25,10,0.01,1304,1
0.862,0.001,686,718,25,10,0.01,1404,1
0.882,0.001,741,763,25,10,0.01,1504,1
0.916,0.001,792,812,25,10,0.01,1604,1
0.946,0.001,836,868,25,10,0.01,1704,1
0.954,0.001,883,921,25,10,0.01,1804,1
0.964,0.001,935,969,25,10,0.01,1904,1
0.96,0.001,986,1018,25,10,0.01,2004,1
0.54,0.001,48,56,25,10,0.01,104,2
0.556,0.001,101,103,25,10,0.01,204,2
0.548,0.001,153,151,25,10,0.01,304,2
0.564,0.001,206,198,25,10,0.01,404,2
0.592,0.001,251,253,25,10,0.01,504,2
0.62,0.001,303,301,25,10,0.01,604,2
0.642,0.001,356,348,25,10,0.01,704,2
0.686,0.001,408,396,25,10,0.01,804,2
0.73,0.001,465,439,25,10,0.01,904,2
0.792,0.001,512,492,25,10,0.01,1004,2
0.798,0.001,561,543,25,10,0.01,1104,2
0.85,0.001,623,581,25,10,0.01,1204,2
0.9,0.001,670,634,25,10,0.01,1304,2
0.948,0.001,711,693,25,10,0.01,1404,2
0.954,0.001,759,745,25,10,0.01,1504,2
0.956,0.001,817,787,25,10,0.01,1604,2
0.966,0.001,859,845,25,10,0.01,1704,2
0.972,0.001,904,900,25,10,0.01,1804,2
0.974,0.001,953,951,25,10,0.01,1904,2
0.976,0.001,1006,998,25,10,0.01,2004,2
0.494,0.001,56,48,25,10,0.01,104,3
0.496,0.001,104,100,25,10,0.01,204,3
0.504,0.001,151,153,25,10,0.01,304,3
0.494,0.001,207,197,25,10,0.01,404,3
0.514,0.001,258,246,25,10,0.01,504,3
0.534,0.001,304,300,25,10,0.01,604,3
0.534,0.001,352,352,25,10,0.01,704,3
0.54,0.001,406,398,25,10,0.01,804,3
0.57,0.001,458,446,25,10,0.01,904,3
0.608,0.001,508,496,25,10,0.01,1004,3
0.648,0.001,556,548,25,10,0.01,1104,3
0.686,0.001,600,604,25,10,0.01,1204,3
0.71,0.001,647,657,25,10,0.01,1304,3
0.764,0.001,706,698,25,10,0.01,1404,3
0.846,0.001,750,754,25,10,0.01,1504,3
0.874,0.001,794,810,25,10,0.01,1604,3
0.896,0.001,854,850,25,10,0.01,1704,3
0.91,0.001,903,901,25,10,0.01,1804,3
0.91,0.001,951,953,25,10,0.01,1904,3
0.942,0.001,1006,998,25,10,0.01,2004,3
0.48,0.001,47,57,25,10,0.01,104,4
0.48,0.001,86,118,25,10,0.01,204,4
0.482,0.001,124,180,25,10,0.01,304,4
0.482,0.001,167,237,25,10,0.01,404,4
0.486,0.001,222,282,25,10,0.01,504,4
0.534,0.001,269,335,25,10,0.01,604,4
0.57,0.001,323,381,25,10,0.01,704,4
0.68,0.001,374,430,25,10,0.01,804,4
0.742,0.001,419,485,25,10,0.01,904,4
0.824,0.001,470,534,25,10,0.01,1004,4
0.818,0.001,527,577,25,10,0.01,1104,4
0.864,0.001,576,628,25,10,0.01,1204,4
0.894,0.001,628,676,25,10,0.01,1304,4
0.898,0.001,681,723,25,10,0.01,1404,4
0.9,0.001,728,776,25,10,0.01,1504,4
0.914,0.001,780,824,25,10,0.01,1604,4
0.93,0.001,831,873,25,10,0.01,1704,4
0.938,0.001,893,911,25,10,0.01,1804,4
0.946,0.001,943,961,25,10,0.01,1904,4
0.948,0.001,992,1012,25,10,0.01,2004,4
0.506,0.001,62,42,25,10,0.01,104,5
0.522,0.001,112,92,25,10,0.01,204,5
0.508,0.001,164,140,25,10,0.01,304,5
0.534,0.001,212,192,25,10,0.01,404,5
0.56,0.001,260,244,25,10,0.01,504,5
0.564,0.001,304,300,25,10,0.01,604,5
0.578,0.001,362,342,25,10,0.01,704,5
0.598,0.001,414,390,25,10,0.01,804,5
0.612,0.001,475,429,25,10,0.01,904,5
0.64,0.001,528,476,25,10,0.01,1004,5
0.66,0.001,577,527,25,10,0.01,1104,5
0.704,0.001,634,570,25,10,0.01,1204,5
0.75,0.001,681,623,25,10,0.01,1304,5
0.794,0.001,733,671,25,10,0.01,1404,5
0.816,0.001,772,732,25,10,0.01,1504,5
0.862,0.001,823,781,25,10,0.01,1604,5
0.886,0.001,868,836,25,10,0.01,1704,5
0.902,0.001,915,889,25,10,0.01,1804,5
0.934,0.001,961,943,25,10,0.01,1904,5
0.944,0.001,1018,986,25,10,0.01,2004,5
0.448,0.001,58,46,25,10,0.01,104,6
0.476,0.001,107,97,25,10,0.01,204,6
0.52,0.001,153,151,25,10,0.01,304,6
0.564,0.001,213,191,25,10,0.01,404,6
0.56,0.001,260,244,25,10,0.01,504,6
0.576,0.001,309,295,25,10,0.01,604,6
0.574,0.001,363,341,25,10,0.01,704,6
0.604,0.001,410,394,25,10,0.01,804,6
0.632,0.001,454,450,25,10,0.01,904,6
0.682,0.001,500,504,25,10,0.01,1004,6
0.698,0.001,560,544,25,10,0.01,1104,6
0.736,0.001,615,589,25,10,0.01,1204,6
0.782,0.001,672,632,25,10,0.01,1304,6
0.818,0.001,721,683,25,10,0.01,1404,6
0.84,0.001,772,732,25,10,0.01,1504,6
0.852,0.001,826,778,25,10,0.01,1604,6
0.856,0.001,880,824,25,10,0.01,1704,6
0.868,0.001,928,876,25,10,0.01,1804,6
0.884,0.001,977,927,25,10,0.01,1904,6
0.898,0.001,1027,977,25,10,0.01,2004,6
0.518,0.001,56,48,25,10,0.01,104,7
0.536,0.001,110,94,25,10,0.01,204,7
0.546,0.001,163,141,25,10,0.01,304,7
0.548,0.001,218,186,25,10,0.01,404,7
0.56,0.001,265,239,25,10,0.01,504,7
0.56,0.001,311,293,25,10,0.01,604,7
0.568,0.001,351,353,25,10,0.01,704,7
0.596,0.001,406,398,25,10,0.01,804,7
0.628,0.001,454,450,25,10,0.01,904,7
0.654,0.001,503,501,25,10,0.01,1004,7
0.69,0.001,554,550,25,10,0.01,1104,7
0.736,0.001,601,603,25,10,0.01,1204,7
0.796,0.001,646,658,25,10,0.01,1304,7
0.89,0.001,701,703,25,10,0.01,1404,7
0.928,0.001,751,753,25,10,0.01,1504,7
0.948,0.001,795,809,25,10,0.01,1604,7
0.956,0.001,848,856,25,10,0.01,1704,7
0.956,0.001,901,903,25,10,0.01,1804,7
0.96,0.001,951,953,25,10,0.01,1904,7
0.966,0.001,994,1010,25,10,0.01,2004,7
0.476,0.001,40,64,25,10,0.01,104,8
0.482,0.001,88,116,25,10,0.01,204,8
0.492,0.001,137,167,25,10,0.01,304,8
0.502,0.001,189,215,25,10,0.01,404,8
0.544,0.001,235,269,25,10,0.01,504,8
0.578,0.001,291,313,25,10,0.01,604,8
0.63,0.001,339,365,25,10,0.01,704,8
0.71,0.001,391,413,25,10,0.01,804,8
0.76,0.001,436,468,25,10,0.01,904,8
0.83,0.001,482,522,25,10,0.01,1004,8
0.858,0.001,532,572,25,10,0.01,1104,8
0.898,0.001,582,622,25,10,0.01,1204,8
0.912,0.001,637,667,25,10,0.01,1304,8
0.93,0.001,689,715,25,10,0.01,1404,8
0.942,0.001,734,770,25,10,0.01,1504,8
0.944,0.001,785,819,25,10,0.01,1604,8
0.946,0.001,845,859,25,10,0.01,1704,8
0.95,0.001,896,908,25,10,0.01,1804,8
0.952,0.001,943,961,25,10,0.01,1904,8
0.96,0.001,993,1011,25,10,0.01,2004,8
0.568,0.001,56,48,25,10,0.01,104,9
0.586,0.001,118,86,25,10,0.01,204,9
0.572,0.001,171,133,25,10,0.01,304,9
0.578,0.001,223,181,25,10,0.01,404,9
0.574,0.001,270,234,25,10,0.01,504,9
0.576,0.001,316,288,25,10,0.01,604,9
0.586,0.001,359,345,25,10,0.01,704,9
0.602,0.001,407,397,25,10,0.01,804,9
0.656,0.001,458,446,25,10,0.01,904,9
0.68,0.001,509,495,25,10,0.01,1004,9
0.696,0.001,558,546,25,10,0.01,1104,9
0.744,0.001,611,593,25,10,0.01,1204,9
0.788,0.001,656,648,25,10,0.01,1304,9
0.824,0.001,706,698,25,10,0.01,1404,9
0.854,0.001,750,754,25,10,0.01,1504,9
0.882,0.001,803,801,25,10,0.01,1604,9
0.906,0.001,851,853,25,10,0.01,1704,9
0.92,0.001,897,907,25,10,0.01,1804,9
0.924,0.001,952,952,25,10,0.01,1904,9
0.924,0.001,1003,1001,25,10,0.01,2004,9
0.536,0.001,48,56,25,10,0.01,104,10
0.556,0.001,96,108,25,10,0.01,204,10
0.558,0.001,140,164,25,10,0.01,304,10
0.55,0.001,198,206,25,10,0.01,404,10
0.574,0.001,248,256,25,10,0.01,504,10
0.612,0.001,299,305,25,10,0.01,604,10
0.644,0.001,351,353,25,10,0.01,704,10
0.682,0.001,405,399,25,10,0.01,804,10
0.696,0.001,457,447,25,10,0.01,904,10
0.734,0.001,519,485,25,10,0.01,1004,10
0.776,0.001,568,536,25,10,0.01,1104,10
0.844,0.001,613,591,25,10,0.01,1204,10
0.87,0.001,660,644,25,10,0.01,1304,10
0.904,0.001,713,691,25,10,0.01,1404,10
0.918,0.001,756,748,25,10,0.01,1504,10
0.928,0.001,806,798,25,10,0.01,1604,10
0.94,0.001,860,844,25,10,0.01,1704,10
0.938,0.001,917,887,25,10,0.01,1804,10
0.946,0.001,973,931,25,10,0.01,1904,10
0.952,0.001,1018,986,25,10,0.01,2004,10
0.506,0.001,55,49,25,10,0.01,104,11
0.516,0.001,100,104,25,10,0.01,204,11
0.538,0.001,154,150,25,10,0.01,304,11
0.56,0.001,211,193,25,10,0.01,404,11
0.584,0.001,257,247,25,10,0.01,504,11
0.6,0.001,315,289,25,10,0.01,604,11
0.6,0.001,363,341,25,10,0.01,704,11
0.616,0.001,408,396,25,10,0.01,804,11
0.644,0.001,449,455,25,10,0.01,904,11
0.696,0.001,499,505,25,10,0.01,1004,11
0.752,0.001,553,551,25,10,0.01,1104,11
0.832,0.001,601,603,25,10,0.01,1204,11
0.884,0.001,647,657,25,10,0.01,1304,11
0.932,0.001,696,708,25,10,0.01,1404,11
0.948,0.001,753,751,25,10,0.01,1504,11
0.966,0.001,808,796,25,10,0.01,1604,11
0.972,0.001,854,850,25,10,0.01,1704,11
0.974,0.001,899,905,25,10,0.01,1804,11
0.976,0.001,946,958,25,10,0.01,1904,11
0.984,0.001,998,1006,25,10,0.01,2004,11
0.524,0.001,50,54,25,10,0.01,104,12
0.526,0.001,98,106,25,10,0.01,204,12
0.538,0.001,144,160,25,10,0.01,304,12
0.528,0.001,197,207,25,10,0.01,404,12
0.542,0.001,242,262,25,10,0.01,504,12
0.58,0.001,297,307,25,10,0.01,604,12
0.606,0.001,348,356,25,10,0.01,704,12
0.668,0.001,399,405,25,10,0.01,804,12
0.724,0.001,448,456,25,10,0.01,904,12
0.764,0.001,499,505,25,10,0.01,1004,12
0.804,0.001,548,556,25,10,0.01,1104,12
0.842,0.001,607,597,25,10,0.01,1204,12
0.878,0.001,657,647,25,10,0.01,1304,12
0.902,0.001,708,696,25,10,0.01,1404,12
0.908,0.001,759,745,25,10,0.01,1504,12
0.922,0.001,810,794,25,10,0.01,1604,12
0.938,0.001,859,845,25,10,0.01,1704,12
0.946,0.001,904,900,25,10,0.01,1804,12
0.948,0.001,956,948,25,10,0.01,1904,12
0.956,0.001,1009,995,25,10,0.01,2004,12
0.504,0.001,51,53,25,10,0.01,104,13
0.52,0.001,106,98,25,10,0.01,204,13
0.536,0.001,163,141,25,10,0.01,304,13
0.566,0.001,210,194,25,10,0.01,404,13
0.588,0.001,258,246,25,10,0.01,504,13
0.608,0.001,306,298,25,10,0.01,604,13
0.64,0.001,352,352,25,10,0.01,704,13
0.65,0.001,396,408,25,10,0.01,804,13
0.666,0.001,449,455,25,10,0.01,904,13
0.704,0.001,496,508,25,10,0.01,1004,13
0.732,0.001,542,562,25,10,0.01,1104,13
0.776,0.001,596,608,25,10,0.01,1204,13
0.818,0.001,651,653,25,10,0.01,1304,13
0.86,0.001,702,702,25,10,0.01,1404,13
0.87,0.001,755,749,25,10,0.01,1504,13
0.916,0.001,810,794,25,10,0.01,1604,13
0.92,0.001,854,850,25,10,0.01,1704,13
0.942,0.001,909,895,25,10,0.01,1804,13
0.956,0.001,959,945,25,10,0.01,1904,13
0.952,0.001,1002,1002,25,10,0.01,2004,13
0.504,0.001,42,62,25,10,0.01,104,14
0.542,0.001,86,118,25,10,0.01,204,14
0.526,0.001,138,166,25,10,0.01,304,14
0.526,0.001,179,225,25,10,0.01,404,14
0.528,0.001,221,283,25,10,0.01,504,14
0.558,0.001,276,328,25,10,0.01,604,14
0.574,0.001,326,378,25,10,0.01,704,14
0.594,0.001,385,419,25,10,0.01,804,14
0.642,0.001,443,461,25,10,0.01,904,14
0.694,0.001,495,509,25,10,0.01,1004,14
0.754,0.001,545,559,25,10,0.01,1104,14
0.804,0.001,599,605,25,10,0.01,1204,14
0.82,0.001,650,654,25,10,0.01,1304,14
0.85,0.001,708,696,25,10,0.01,1404,14
0.866,0.001,750,754,25,10,0.01,1504,14
0.884,0.001,802,802,25,10,0.01,1604,14
0.888,0.001,854,850,25,10,0.01,1704,14
0.898,0.001,906,898,25,10,0.01,1804,14
0.914,0.001,956,948,25,10,0.01,1904,14
0.932,0.001,1006,998,25,10,0.01,2004,14
0.52,0.001,51,53,25,10,0.01,104,15
0.536,0.001,104,100,25,10,0.01,204,15
0.552,0.001,156,148,25,10,0.01,304,15
0.576,0.001,209,195,25,10,0.01,404,15
0.586,0.001,259,245,25,10,0.01,504,15
0.598,0.001,312,292,25,10,0.01,604,15
0.64,0.001,360,344,25,10,0.01,704,15
0.68,0.001,415,389,25,10,0.01,804,15
0.724,0.001,461,443,25,10,0.01,904,15
0.784,0.001,506,498,25,10,0.01,1004,15
0.81,0.001,555,549,25,10,0.01,1104,15
0.86,0.001,611,593,25,10,0.01,1204,15
0.866,0.001,659,645,25,10,0.01,1304,15
0.902,0.001,712,692,25,10,0.01,1404,15
0.896,0.001,757,747,25,10,0.01,1504,15
0.92,0.001,799,805,25,10,0.01,1604,15
0.928,0.001,850,854,25,10,0.01,1704,15
0.93,0.001,892,912,25,10,0.01,1804,15
0.936,0.001,943,961,25,10,0.01,1904,15
0.94,0.001,996,1008,25,10,0.01,2004,15
0.512,0.001,43,61,25,10,0.01,104,16
0.528,0.001,89,115,25,10,0.01,204,16
0.55,0.001,132,172,25,10,0.01,304,16
0.552,0.001,186,218,25,10,0.01,404,16
0.578,0.001,232,272,25,10,0.01,504,16
0.632,0.001,283,321,25,10,0.01,604,16
0.632,0.001,334,370,25,10,0.01,704,16
0.648,0.001,380,424,25,10,0.01,804,16
0.67,0.001,439,465,25,10,0.01,904,16
0.698,0.001,486,518,25,10,0.01,1004,16
0.754,0.001,530,574,25,10,0.01,1104,16
0.802,0.001,587,617,25,10,0.01,1204,16
0.828,0.001,628,676,25,10,0.01,1304,16
0.858,0.001,689,715,25,10,0.01,1404,16
0.908,0.001,741,763,25,10,0.01,1504,16
0.93,0.001,796,808,25,10,0.01,1604,16
0.938,0.001,846,858,25,10,0.01,1704,16
0.936,0.001,896,908,25,10,0.01,1804,16
0.936,0.001,940,964,25,10,0.01,1904,16
0.942,0.001,998,1006,25,10,0.01,2004,16
0.514,0.001,44,60,25,10,0.01,104,17
0.54,0.001,103,101,25,10,0.01,204,17
0.544,0.001,148,156,25,10,0.01,304,17
0.566,0.001,192,212,25,10,0.01,404,17
0.6,0.001,252,252,25,10,0.01,504,17
0.634,0.001,300,304,25,10,0.01,604,17
0.656,0.001,359,345,25,10,0.01,704,17
0.674,0.001,410,394,25,10,0.01,804,17
0.698,0.001,465,439,25,10,0.01,904,17
0.744,0.001,522,482,25,10,0.01,1004,17
0.774,0.001,569,535,25,10,0.01,1104,17
0.818,0.001,617,587,25,10,0.01,1204,17
0.836,0.001,666,638,25,10,0.01,1304,17
0.882,0.001,707,697,25,10,0.01,1404,17
0.902,0.001,751,753,25,10,0.01,1504,17
0.902,0.001,801,803,25,10,0.01,1604,17
0.898,0.001,843,861,25,10,0.01,1704,17
0.932,0.001,900,904,25,10,0.01,1804,17
0.946,0.001,954,950,25,10,0.01,1904,17
0.954,0.001,1000,1004,25,10,0.01,2004,17
0.488,0.001,55,49,25,10,0.01,104,18
0.488,0.001,112,92,25,10,0.01,204,18
0.49,0.001,162,142,25,10,0.01,304,18
0.502,0.001,202,202,25,10,0.01,404,18
0.522,0.001,260,244,25,10,0.01,504,18
0.59,0.001,304,300,25,10,0.01,604,18
0.622,0.001,358,346,25,10,0.01,704,18
0.674,0.001,413,391,25,10,0.01,804,18
0.69,0.001,463,441,25,10,0.01,904,18
0.716,0.001,508,496,25,10,0.01,1004,18
0.758,0.001,558,546,25,10,0.01,1104,18
0.81,0.001,604,600,25,10,0.01,1204,18
0.85,0.001,651,653,25,10,0.01,1304,18
0.884,0.001,699,705,25,10,0.01,1404,18
0.91,0.001,750,754,25,10,0.01,1504,18
0.93,0.001,802,802,25,10,0.01,1604,18
0.93,0.001,852,852,25,10,0.01,1704,18
0.938,0.001,896,908,25,10,0.01,1804,18
0.936,0.001,947,957,25,10,0.01,1904,18
0.948,0.001,996,1008,25,10,0.01,2004,18
0.466,0.001,51,53,25,10,0.01,104,19
0.456,0.001,111,93,25,10,0.01,204,19
0.462,0.001,156,148,25,10,0.01,304,19
0.484,0.001,214,190,25,10,0.01,404,19
0.51,0.001,255,249,25,10,0.01,504,19
0.544,0.001,298,306,25,10,0.01,604,19
0.594,0.001,355,349,25,10,0.01,704,19
0.626,0.001,408,396,25,10,0.01,804,19
0.624,0.001,457,447,25,10,0.01,904,19
0.646,0.001,496,508,25,10,0.01,1004,19
0.668,0.001,542,562,25,10,0.01,1104,19
0.704,0.001,589,615,25,10,0.01,1204,19
0.736,0.001,637,667,25,10,0.01,1304,19
0.798,0.001,693,711,25,10,0.01,1404,19
0.84,0.001,744,760,25,10,0.01,1504,19
0.866,0.001,796,808,25,10,0.01,1604,19
0.88,0.001,851,853,25,10,0.01,1704,19
0.896,0.001,896,908,25,10,0.01,1804,19
0.908,0.001,948,956,25,10,0.01,1904,19
0.912,0.001,987,1017,25,10,0.01,2004,19
0.538,0.001,54,50,25,10,0.01,104,20
0.548,0.001,106,98,25,10,0.01,204,20
0.556,0.001,159,145,25,10,0.01,304,20
0.574,0.001,206,198,25,10,0.01,404,20
0.576,0.001,259,245,25,10,0.01,504,20
0.6,0.001,305,299,25,10,0.01,604,20
0.622,0.001,358,346,25,10,0.01,704,20
0.624,0.001,407,397,25,10,0.01,804,20
0.632,0.001,453,451,25,10,0.01,904,20
0.648,0.001,511,493,25,10,0.01,1004,20
0.646,0.001,548,556,25,10,0.01,1104,20
0.682,0.001,606,598,25,10,0.01,1204,20
0.7,0.001,656,648,25,10,0.01,1304,20
0.714,0.001,698,706,25,10,0.01,1404,20
0.746,0.001,742,762,25,10,0.01,1504,20
0.804,0.001,793,811,25,10,0.01,1604,20
0.822,0.001,838,866,25,10,0.01,1704,20
0.876,0.001,895,909,25,10,0.01,1804,20
0.892,0.001,936,968,25,10,0.01,1904,20
0.912,0.001,990,1014,25,10,0.01,2004,20
0.492,1e-05,57,47,25,25,0.0001,104,1
0.492,1e-05,107,97,25,25,0.0001,204,1
0.494,1e-05,163,141,25,25,0.0001,304,1
0.496,1e-05,214,190,25,25,0.0001,404,1
0.498,1e-05,254,250,25,25,0.0001,504,1
0.498,1e-05,303,301,25,25,0.0001,604,1
0.5,1e-05,357,347,25,25,0.0001,704,1
0.5,1e-05,421,383,25,25,0.0001,804,1
0.5,1e-05,462,442,25,25,0.0001,904,1
0.498,1e-05,513,491,25,25,0.0001,1004,1
0.498,1e-05,570,534,25,25,0.0001,1104,1
0.502,1e-05,623,581,25,25,0.0001,1204,1
0.502,1e-05,676,628,25,25,0.0001,1304,1
0.508,1e-05,720,684,25,25,0.0001,1404,1
0.508,1e-05,772,732,25,25,0.0001,1504,1
0.51,1e-05,822,782,25,25,0.0001,1604,1
0.51,1e-05,866,838,25,25,0.0001,1704,1
0.514,1e-05,909,895,25,25,0.0001,1804,1
0.516,1e-05,960,944,25,25,0.0001,1904,1
0.518,1e-05,1012,992,25,25,0.0001,2004,1
0.484,1e-05,63,41,25,25,0.0001,104,2
0.484,1e-05,115,89,25,25,0.0001,204,2
0.484,1e-05,162,142,25,25,0.0001,304,2
0.488,1e-05,214,190,25,25,0.0001,404,2
0.486,1e-05,265,239,25,25,0.0001,504,2
0.486,1e-05,315,289,25,25,0.0001,604,2
0.486,1e-05,364,340,25,25,0.0001,704,2
0.488,1e-05,405,399,25,25,0.0001,804,2
0.488,1e-05,461,443,25,25,0.0001,904,2
0.49,1e-05,513,491,25,25,0.0001,1004,2
0.49,1e-05,571,533,25,25,0.0001,1104,2
0.494,1e-05,618,586,25,25,0.0001,1204,2
0.494,1e-05,661,643,25,25,0.0001,1304,2
0.494,1e-05,715,689,25,25,0.0001,1404,2
0.496,1e-05,771,733,25,25,0.0001,1504,2
0.5,1e-05,813,791,25,25,0.0001,1604,2
0.5,1e-05,858,846,25,25,0.0001,1704,2
0.502,1e-05,908,896,25,25,0.0001,1804,2
0.504,1e-05,958,946,25,25,0.0001,1904,2
0.504,1e-05,1006,998,25,25,0.0001,2004,2
0.48,1e-05,49,55,25,25,0.0001,104,3
0.48,1e-05,94,110,25,25,0.0001,204,3
0.48,1e-05,148,156,25,25,0.0001,304,3
0.48,1e-05,196,208,25,25,0.0001,404,3
0.48,1e-05,248,256,25,25,0.0001,504,3
0.48,1e-05,292,312,25,25,0.0001,604,3
0.48,1e-05,357,347,25,25,0.0001,704,3
0.48,1e-05,402,402,25,25,0.0001,804,3
0.48,1e-05,449,455,25,25,0.0001,904,3
0.48,1e-05,504,500,25,25,0.0001,1004,3
0.48,1e-05,559,545,25,25,0.0001,1104,3
0.48,1e-05,608,596,25,25,0.0001,1204,3
0.48,1e-05,662,642,25,25,0.0001,1304,3
0.48,1e-05,715,689,25,25,0.0001,1404,3
0.48,1e-05,761,743,25,25,0.0001,1504,3
0.48,1e-05,810,794,25,25,0.0001,1604,3
0.48,1e-05,865,839,25,25,0.0001,1704,3
0.48,1e-05,914,890,25,25,0.0001,1804,3
0.48,1e-05,957,947,25,25,0.0001,1904,3
0.48,1e-05,1007,997,25,25,0.0001,2004,3
0.482,1e-05,62,42,25,25,0.0001,104,4
0.48,1e-05,110,94,25,25,0.0001,204,4
0.48,1e-05,162,142,25,25,0.0001,304,4
0.48,1e-05,212,192,25,25,0.0001,404,4
0.48,1e-05,265,239,25,25,0.0001,504,4
0.482,1e-05,318,286,25,25,0.0001,604,4
0.48,1e-05,376,328,25,25,0.0001,704,4
0.48,1e-05,425,379,25,25,0.0001,804,4
0.48,1e-05,472,432,25,25,0.0001,904,4
0.48,1e-05,525,479,25,25,0.0001,1004,4
0.48,1e-05,564,540,25,25,0.0001,1104,4
0.482,1e-05,620,584,25,25,0.0001,1204,4
0.482,1e-05,662,642,25,25,0.0001,1304,4
0.482,1e-05,701,703,25,25,0.0001,1404,4
0.486,1e-05,755,749,25,25,0.0001,1504,4
0.488,1e-05,805,799,25,25,0.0001,1604,4
0.488,1e-05,859,845,25,25,0.0001,1704,4
0.492,1e-05,907,897,25,25,0.0001,1804,4
0.492,1e-05,957,947,25,25,0.0001,1904,4
0.49,1e-05,999,1005,25,25,0.0001,2004,4
0.492,1e-05,45,59,25,25,0.0001,104,5
0.494,1e-05,99,105,25,25,0.0001,204,5
0.494,1e-05,152,152,25,25,0.0001,304,5
0.492,1e-05,200,204,25,25,0.0001,404,5
0.492,1e-05,252,252,25,25,0.0001,504,5
0.492,1e-05,294,310,25,25,0.0001,604,5
0.492,1e-05,349,355,25,25,0.0001,704,5
0.492,1e-05,402,402,25,25,0.0001,804,5
0.492,1e-05,457,447,25,25,0.0001,904,5
0.492,1e-05,512,492,25,25,0.0001,1004,5
0.49,1e-05,557,547,25,25,0.0001,1104,5
0.488,1e-05,605,599,25,25,0.0001,1204,5
0.49,1e-05,653,651,25,25,0.0001,1304,5
0.488,1e-05,703,701,25,25,0.0001,1404,5
0.488,1e-05,760,744,25,25,0.0001,1504,5
0.488,1e-05,814,790,25,25,0.0001,1604,5
0.486,1e-05,868,836,25,25,0.0001,1704,5
0.49,1e-05,911,893,25,25,0.0001,1804,5
0.488,1e-05,960,944,25,25,0.0001,1904,5
0.49,1e-05,1010,994,25,25,0.0001,2004,5
0.512,1e-05,49,55,25,25,0.0001,104,6
0.512,1e-05,99,105,25,25,0.0001,204,6
0.512,1e-05,145,159,25,25,0.0001,304,6
0.508,1e-05,188,216,25,25,0.0001,404,6
0.508,1e-05,241,263,25,25,0.0001,504,6
0.512,1e-05,293,311,25,25,0.0001,604,6
0.512,1e-05,338,366,25,25,0.0001,704,6
0.514,1e-05,381,423,25,25,0.0001,804,6
0.512,1e-05,428,476,25,25,0.0001,904,6
0.514,1e-05,473,531,25,25,0.0001,1004,6
0.514,1e-05,529,575,25,25,0.0001,1104,6
0.512,1e-05,574,630,25,25,0.0001,1204,6
0.512,1e-05,627,677,25,25,0.0001,1304,6
0.512,1e-05,681,723,25,25,0.0001,1404,6
0.514,1e-05,729,775,25,25,0.0001,1504,6
0.52,1e-05,784,820,25,25,0.0001,1604,6
0.52,1e-05,838,866,25,25,0.0001,1704,6
0.528,1e-05,880,924,25,25,0.0001,1804,6
0.524,1e-05,931,973,25,25,0.0001,1904,6
0.524,1e-05,989,1015,25,25,0.0001,2004,6
0.478,1e-05,58,46,25,25,0.0001,104,7
0.476,1e-05,109,95,25,25,0.0001,204,7
0.476,1e-05,151,153,25,25,0.0001,304,7
0.476,1e-05,207,197,25,25,0.0001,404,7
0.476,1e-05,256,248,25,25,0.0001,504,7
0.476,1e-05,317,287,25,25,0.0001,604,7
0.476,1e-05,367,337,25,25,0.0001,704,7
0.478,1e-05,414,390,25,25,0.0001,804,7
0.482,1e-05,464,440,25,25,0.0001,904,7
0.484,1e-05,515,489,25,25,0.0001,1004,7
0.484,1e-05,565,539,25,25,0.0001,1104,7
0.488,1e-05,613,591,25,25,0.0001,1204,7
0.486,1e-05,663,641,25,25,0.0001,1304,7
0.49,1e-05,709,695,25,25,0.0001,1404,7
0.494,1e-05,755,749,25,25,0.0001,1504,7
0.498,1e-05,801,803,25,25,0.0001,1604,7
0.5,1e-05,849,855,25,25,0.0001,1704,7
0.508,1e-05,903,901,25,25,0.0001,1804,7
0.508,1e-05,949,955,25,25,0.0001,1904,7
0.506,1e-05,998,1006,25,25,0.0001,2004,7
0.502,1e-05,59,45,25,25,0.0001,104,8
0.502,1e-05,115,89,25,25,0.0001,204,8
0.502,1e-05,164,140,25,25,0.0001,304,8
0.5,1e-05,217,187,25,25,0.0001,404,8
0.498,1e-05,262,242,25,25,0.0001,504,8
0.496,1e-05,307,297,25,25,0.0001,604,8
0.496,1e-05,357,347,25,25,0.0001,704,8
0.498,1e-05,406,398,25,25,0.0001,804,8
0.5,1e-05,453,451,25,25,0.0001,904,8
0.502,1e-05,504,500,25,25,0.0001,1004,8
0.502,1e-05,551,553,25,25,0.0001,1104,8
0.502,1e-05,599,605,25,25,0.0001,1204,8
0.506,1e-05,642,662,25,25,0.0001,1304,8
0.506,1e-05,693,711,25,25,0.0001,1404,8
0.51,1e-05,736,768,25,25,0.0001,1504,8
0.508,1e-05,785,819,25,25,0.0001,1604,8
0.504,1e-05,844,860,25,25,0.0001,1704,8
0.502,1e-05,890,914,25,25,0.0001,1804,8
0.504,1e-05,943,961,25,25,0.0001,1904,8
0.51,1e-05,998,1006,25,25,0.0001,2004,8
0.568,1e-05,56,48,25,25,0.0001,104,9
0.568,1e-05,102,102,25,25,0.0001,204,9
0.57,1e-05,151,153,25,25,0.0001,304,9
0.57,1e-05,203,201,25,25,0.0001,404,9
0.572,1e-05,264,240,25,25,0.0001,504,9
0.572,1e-05,312,292,25,25,0.0001,604,9
0.574,1e-05,364,340,25,25,0.0001,704,9
0.574,1e-05,404,400,25,25,0.0001,804,9
0.574,1e-05,458,446,25,25,0.0001,904,9
0.576,1e-05,512,492,25,25,0.0001,1004,9
0.578,1e-05,560,544,25,25,0.0001,1104,9
0.58,1e-05,602,602,25,25,0.0001,1204,9
0.58,1e-05,664,640,25,25,0.0001,1304,9
0.578,1e-05,715,689,25,25,0.0001,1404,9
0.576,1e-05,772,732,25,25,0.0001,1504,9
0.578,1e-05,819,785,25,25,0.0001,1604,9
0.578,1e-05,874,830,25,25,0.0001,1704,9
0.578,1e-05,926,878,25,25,0.0001,1804,9
0.58,1e-05,975,929,25,25,0.0001,1904,9
0.576,1e-05,1018,986,25,25,0.0001,2004,9
0.498,1e-05,42,62,25,25,0.0001,104,10
0.5,1e-05,92,112,25,25,0.0001,204,10
0.5,1e-05,143,161,25,25,0.0001,304,10
0.5,1e-05,195,209,25,25,0.0001,404,10
0.5,1e-05,240,264,25,25,0.0001,504,10
0.5,1e-05,284,320,25,25,0.0001,604,10
0.502,1e-05,338,366,25,25,0.0001,704,10
0.504,1e-05,385,419,25,25,0.0001,804,10
0.504,1e-05,437,467,25,25,0.0001,904,10
0.504,1e-05,483,521,25,25,0.0001,1004,10
0.504,1e-05,530,574,25,25,0.0001,1104,10
0.502,1e-05,583,621,25,25,0.0001,1204,10
0.5,1e-05,624,680,25,25,0.0001,1304,10
0.502,1e-05,682,722,25,25,0.0001,1404,10
0.504,1e-05,737,767,25,25,0.0001,1504,10
0.506,1e-05,797,807,25,25,0.0001,1604,10
0.504,1e-05,851,853,25,25,0.0001,1704,10
0.508,1e-05,899,905,25,25,0.0001,1804,10
0.51,1e-05,949,955,25,25,0.0001,1904,10
0.508,1e-05,993,1011,25,25,0.0001,2004,10
0.544,1e-05,57,47,25,25,0.0001,104,11
0.544,1e-05,106,98,25,25,0.0001,204,11
0.544,1e-05,158,146,25,25,0.0001,304,11
0.544,1e-05,203,201,25,25,0.0001,404,11
0.546,1e-05,250,254,25,25,0.0001,504,11
0.546,1e-05,293,311,25,25,0.0001,604,11
0.546,1e-05,348,356,25,25,0.0001,704,11
0.546,1e-05,401,403,25,25,0.0001,804,11
0.546,1e-05,458,446,25,25,0.0001,904,11
0.546,1e-05,515,489,25,25,0.0001,1004,11
0.546,1e-05,568,536,25,25,0.0001,1104,11
0.546,1e-05,616,588,25,25,0.0001,1204,11
0.546,1e-05,673,631,25,25,0.0001,1304,11
0.546,1e-05,729,675,25,25,0.0001,1404,11
0.546,1e-05,783,721,25,25,0.0001,1504,11
0.546,1e-05,831,773,25,25,0.0001,1604,11
0.546,1e-05,879,825,25,25,0.0001,1704,11
0.546,1e-05,925,879,25,25,0.0001,1804,11
0.546,1e-05,968,936,25,25,0.0001,1904,11
0.546,1e-05,1024,980,25,25,0.0001,2004,11
0.512,1e-05,42,62,25,25,0.0001,104,12
0.514,1e-05,95,109,25,25,0.0001,204,12
0.516,1e-05,143,161,25,25,0.0001,304,12
0.516,1e-05,190,214,25,25,0.0001,404,12
0.516,1e-05,230,274,25,25,0.0001,504,12
0.516,1e-05,281,323,25,25,0.0001,604,12
0.516,1e-05,331,373,25,25,0.0001,704,12
0.514,1e-05,383,421,25,25,0.0001,804,12
0.514,1e-05,436,468,25,25,0.0001,904,12
0.516,1e-05,487,517,25,25,0.0001,1004,12
0.516,1e-05,543,561,25,25,0.0001,1104,12
0.516,1e-05,599,605,25,25,0.0001,1204,12
0.516,1e-05,644,660,25,25,0.0001,1304,12
0.518,1e-05,693,711,25,25,0.0001,1404,12
0.52,1e-05,742,762,25,25,0.0001,1504,12
0.526,1e-05,786,818,25,25,0.0001,1604,12
0.526,1e-05,842,862,25,25,0.0001,1704,12
0.528,1e-05,895,909,25,25,0.0001,1804,12
0.528,1e-05,939,965,25,25,0.0001,1904,12
0.528,1e-05,990,1014,25,25,0.0001,2004,12
0.524,1e-05,56,48,25,25,0.0001,104,13
0.524,1e-05,111,93,25,25,0.0001,204,13
0.524,1e-05,162,142,25,25,0.0001,304,13
0.524,1e-05,210,194,25,25,0.0001,404,13
0.526,1e-05,256,248,25,25,0.0001,504,13
0.526,1e-05,306,298,25,25,0.0001,604,13
0.526,1e-05,358,346,25,25,0.0001,704,13
0.526,1e-05,416,388,25,25,0.0001,804,13
0.526,1e-05,457,447,25,25,0.0001,904,13
0.524,1e-05,508,496,25,25,0.0001,1004,13
0.524,1e-05,544,560,25,25,0.0001,1104,13
0.524,1e-05,599,605,25,25,0.0001,1204,13
0.524,1e-05,650,654,25,25,0.0001,1304,13
0.524,1e-05,704,700,25,25,0.0001,1404,13
0.524,1e-05,756,748,25,25,0.0001,1504,13
0.524,1e-05,804,800,25,25,0.0001,1604,13
0.526,1e-05,853,851,25,25,0.0001,1704,13
0.528,1e-05,907,897,25,25,0.0001,1804,13
0.53,1e-05,950,954,25,25,0.0001,1904,13
0.528,1e-05,995,1009,25,25,0.0001,2004,13
0.53,1e-05,52,52,25,25,0.0001,104,14
0.532,1e-05,99,105,25,25,0.0001,204,14
0.532,1e-05,157,147,25,25,0.0001,304,14
0.532,1e-05,218,186,25,25,0.0001,404,14
0.532,1e-05,264,240,25,25,0.0001,504,14
0.532,1e-05,313,291,25,25,0.0001,604,14
0.534,1e-05,361,343,25,25,0.0001,704,14
0.534,1e-05,413,391,25,25,0.0001,804,14
0.534,1e-05,466,438,25,25,0.0001,904,14
0.53,1e-05,513,491,25,25,0.0001,1004,14
0.53,1e-05,574,530,25,25,0.0001,1104,14
0.53,1e-05,623,581,25,25,0.0001,1204,14
0.528,1e-05,666,638,25,25,0.0001,1304,14
0.528,1e-05,706,698,25,25,0.0001,1404,14
0.53,1e-05,758,746,25,25,0.0001,1504,14
0.532,1e-05,802,802,25,25,0.0001,1604,14
0.528,1e-05,853,851,25,25,0.0001,1704,14
0.534,1e-05,904,900,25,25,0.0001,1804,14
0.532,1e-05,949,955,25,25,0.0001,1904,14
0.532,1e-05,990,1014,25,25,0.0001,2004,14
0.514,1e-05,66,38,25,25,0.0001,104,15
0.514,1e-05,114,90,25,25,0.0001,204,15
0.512,1e-05,166,138,25,25,0.0001,304,15
0.516,1e-05,215,189,25,25,0.0001,404,15
0.516,1e-05,265,239,25,25,0.0001,504,15
0.518,1e-05,310,294,25,25,0.0001,604,15
0.518,1e-05,362,342,25,25,0.0001,704,15
0.518,1e-05,412,392,25,25,0.0001,804,15
0.518,1e-05,454,450,25,25,0.0001,904,15
0.52,1e-05,504,500,25,25,0.0001,1004,15
0.52,1e-05,556,548,25,25,0.0001,1104,15
0.52,1e-05,607,597,25,25,0.0001,1204,15
0.522,1e-05,647,657,25,25,0.0001,1304,15
0.524,1e-05,702,702,25,25,0.0001,1404,15
0.526,1e-05,753,751,25,25,0.0001,1504,15
0.526,1e-05,807,797,25,25,0.0001,1604,15
0.528,1e-05,858,846,25,25,0.0001,1704,15
0.528,1e-05,910,894,25,25,0.0001,1804,15
0.528,1e-05,967,937,25,25,0.0001,1904,15
0.536,1e-05,1016,988,25,25,0.0001,2004,15
0.478,1e-05,67,37,25,25,0.0001,104,16
0.478,1e-05,123,81,25,25,0.0001,204,16
0.478,1e-05,172,132,25,25,0.0001,304,16
0.478,1e-05,208,196,25,25,0.0001,404,16
0.478,1e-05,257,247,25,25,0.0001,504,16
0.478,1e-05,304,300,25,25,0.0001,604,16
0.48,1e-05,353,351,25,25,0.0001,704,16
0.48,1e-05,400,404,25,25,0.0001,804,16
0.48,1e-05,451,453,25,25,0.0001,904,16
0.48,1e-05,507,497,25,25,0.0001,1004,16
0.48,1e-05,555,549,25,25,0.0001,1104,16
0.48,1e-05,608,596,25,25,0.0001,1204,16
0.482,1e-05,668,636,25,25,0.0001,1304,16
0.482,1e-05,714,690,25,25,0.0001,1404,16
0.482,1e-05,765,739,25,25,0.0001,1504,16
0.486,1e-05,805,799,25,25,0.0001,1604,16
0.49,1e-05,862,842,25,25,0.0001,1704,16
0.49,1e-05,902,902,25,25,0.0001,1804,16
0.492,1e-05,956,948,25,25,0.0001,1904,16
0.488,1e-05,1011,993,25,25,0.0001,2004,16
0.494,1e-05,48,56,25,25,0.0001,104,17
0.494,1e-05,97,107,25,25,0.0001,204,17
0.494,1e-05,145,159,25,25,0.0001,304,17
0.494,1e-05,194,210,25,25,0.0001,404,17
0.494,1e-05,248,256,25,25,0.0001,504,17
0.496,1e-05,290,314,25,25,0.0001,604,17
0.496,1e-05,340,364,25,25,0.0001,704,17
0.496,1e-05,391,413,25,25,0.0001,804,17
0.496,1e-05,444,460,25,25,0.0001,904,17
0.496,1e-05,497,507,25,25,0.0001,1004,17
0.496,1e-05,549,555,25,25,0.0001,1104,17
0.498,1e-05,600,604,25,25,0.0001,1204,17
0.498,1e-05,649,655,25,25,0.0001,1304,17
0.498,1e-05,704,700,25,25,0.0001,1404,17
0.502,1e-05,764,740,25,25,0.0001,1504,17
0.502,1e-05,816,788,25,25,0.0001,1604,17
0.504,1e-05,861,843,25,25,0.0001,1704,17
0.502,1e-05,912,892,25,25,0.0001,1804,17
0.502,1e-05,957,947,25,25,0.0001,1904,17
0.502,1e-05,1000,1004,25,25,0.0001,2004,17
0.456,1e-05,56,48,25,25,0.0001,104,18
0.456,1e-05,110,94,25,25,0.0001,204,18
0.456,1e-05,155,149,25,25,0.0001,304,18
0.456,1e-05,198,206,25,25,0.0001,404,18
0.456,1e-05,253,251,25,25,0.0001,504,18
0.454,1e-05,308,296,25,25,0.0001,604,18
0.454,1e-05,360,344,25,25,0.0001,704,18
0.456,1e-05,414,390,25,25,0.0001,804,18
0.456,1e-05,460,444,25,25,0.0001,904,18
0.458,1e-05,507,497,25,25,0.0001,1004,18
0.458,1e-05,559,545,25,25,0.0001,1104,18
0.46,1e-05,597,607,25,25,0.0001,1204,18
0.46,1e-05,651,653,25,25,0.0001,1304,18
0.46,1e-05,701,703,25,25,0.0001,1404,18
0.46,1e-05,754,750,25,25,0.0001,1504,18
0.46,1e-05,801,803,25,25,0.0001,1604,18
0.46,1e-05,857,847,25,25,0.0001,1704,18
0.462,1e-05,898,906,25,25,0.0001,1804,18
0.462,1e-05,944,960,25,25,0.0001,1904,18
0.464,1e-05,992,1012,25,25,0.0001,2004,18
0.478,1e-05,50,54,25,25,0.0001,104,19
0.478,1e-05,103,101,25,25,0.0001,204,19
0.476,1e-05,148,156,25,25,0.0001,304,19
0.476,1e-05,191,213,25,25,0.0001,404,19
0.478,1e-05,236,268,25,25,0.0001,504,19
0.478,1e-05,287,317,25,25,0.0001,604,19
0.48,1e-05,341,363,25,25,0.0001,704,19
0.482,1e-05,396,408,25,25,0.0001,804,19
0.482,1e-05,453,451,25,25,0.0001,904,19
0.482,1e-05,506,498,25,25,0.0001,1004,19
0.482,1e-05,548,556,25,25,0.0001,1104,19
0.48,1e-05,594,610,25,25,0.0001,1204,19
0.482,1e-05,643,661,25,25,0.0001,1304,19
0.482,1e-05,694,710,25,25,0.0001,1404,19
0.484,1e-05,741,763,25,25,0.0001,1504,19
0.49,1e-05,790,814,25,25,0.0001,1604,19
0.49,1e-05,840,864,25,25,0.0001,1704,19
0.488,1e-05,890,914,25,25,0.0001,1804,19
0.486,1e-05,940,964,25,25,0.0001,1904,19
0.488,1e-05,994,1010,25,25,0.0001,2004,19
0.444,1e-05,56,48,25,25,0.0001,104,20
0.444,1e-05,106,98,25,25,0.0001,204,20
0.444,1e-05,156,148,25,25,0.0001,304,20
0.442,1e-05,205,199,25,25,0.0001,404,20
0.442,1e-05,247,257,25,25,0.0001,504,20
0.442,1e-05,297,307,25,25,0.0001,604,20
0.442,1e-05,345,359,25,25,0.0001,704,20
0.442,1e-05,393,411,25,25,0.0001,804,20
0.444,1e-05,445,459,25,25,0.0001,904,20
0.444,1e-05,499,505,25,25,0.0001,1004,20
0.444,1e-05,548,556,25,25,0.0001,1104,20
0.44,1e-05,596,608,25,25,0.0001,1204,20
0.442,1e-05,643,661,25,25,0.0001,1304,20
0.444,1e-05,697,707,25,25,0.0001,1404,20
0.442,1e-05,754,750,25,25,0.0001,1504,20
0.442,1e-05,797,807,25,25,0.0001,1604,20
0.442,1e-05,848,856,25,25,0.0001,1704,20
0.444,1e-05,903,901,25,25,0.0001,1804,20
0.444,1e-05,956,948,25,25,0.0001,1904,20
0.446,1e-05,1009,995,25,25,0.0001,2004,20
0.51,1e-05,52,52,25,25,0.001,104,1
0.514,1e-05,106,98,25,25,0.001,204,1
0.52,1e-05,162,142,25,25,0.001,304,1
0.524,1e-05,211,193,25,25,0.001,404,1
0.528,1e-05,256,248,25,25,0.001,504,1
0.526,1e-05,305,299,25,25,0.001,604,1
0.534,1e-05,354,350,25,25,0.001,704,1
0.526,1e-05,405,399,25,25,0.001,804,1
0.524,1e-05,453,451,25,25,0.001,904,1
0.532,1e-05,509,495,25,25,0.001,1004,1
0.528,1e-05,564,540,25,25,0.001,1104,1
0.534,1e-05,610,594,25,25,0.001,1204,1
0.546,1e-05,662,642,25,25,0.001,1304,1
0.558,1e-05,708,696,25,25,0.001,1404,1
0.578,1e-05,756,748,25,25,0.001,1504,1
0.598,1e-05,807,797,25,25,0.001,1604,1
0.616,1e-05,851,853,25,25,0.001,1704,1
0.626,1e-05,904,900,25,25,0.001,1804,1
0.648,1e-05,952,952,25,25,0.001,1904,1
0.67,1e-05,1008,996,25,25,0.001,2004,1
0.52,1e-05,44,60,25,25,0.001,104,2
0.526,1e-05,87,117,25,25,0.001,204,2
0.53,1e-05,148,156,25,25,0.001,304,2
0.53,1e-05,205,199,25,25,0.001,404,2
0.538,1e-05,264,240,25,25,0.001,504,2
0.538,1e-05,318,286,25,25,0.001,604,2
0.542,1e-05,362,342,25,25,0.001,704,2
0.554,1e-05,404,400,25,25,0.001,804,2
0.562,1e-05,450,454,25,25,0.001,904,2
0.572,1e-05,506,498,25,25,0.001,1004,2
0.564,1e-05,563,541,25,25,0.001,1104,2
0.566,1e-05,610,594,25,25,0.001,1204,2
0.57,1e-05,660,644,25,25,0.001,1304,2
0.594,1e-05,704,700,25,25,0.001,1404,2
0.594,1e-05,753,751,25,25,0.001,1504,2
0.616,1e-05,793,811,25,25,0.001,1604,2
0.63,1e-05,835,869,25,25,0.001,1704,2
0.65,1e-05,884,920,25,25,0.001,1804,2
0.668,1e-05,933,971,25,25,0.001,1904,2
0.678,1e-05,995,1009,25,25,0.001,2004,2
0.464,1e-05,51,53,25,25,0.001,104,3
0.468,1e-05,106,98,25,25,0.001,204,3
0.472,1e-05,152,152,25,25,0.001,304,3
0.474,1e-05,199,205,25,25,0.001,404,3
0.478,1e-05,246,258,25,25,0.001,504,3
0.474,1e-05,292,312,25,25,0.001,604,3
0.474,1e-05,342,362,25,25,0.001,704,3
0.478,1e-05,392,412,25,25,0.001,804,3
0.49,1e-05,445,459,25,25,0.001,904,3
0.49,1e-05,499,505,25,25,0.001,1004,3
0.496,1e-05,539,565,25,25,0.001,1104,3
0.498,1e-05,592,612,25,25,0.001,1204,3
0.506,1e-05,637,667,25,25,0.001,1304,3
0.526,1e-05,694,710,25,25,0.001,1404,3
0.55,1e-05,752,752,25,25,0.001,1504,3
0.576,1e-05,798,806,25,25,0.001,1604,3
0.6,1e-05,853,851,25,25,0.001,1704,3
0.616,1e-05,904,900,25,25,0.001,1804,3
0.63,1e-05,953,951,25,25,0.001,1904,3
0.648,1e-05,993,1011,25,25,0.001,2004,3
0.498,1e-05,53,51,25,25,0.001,104,4
0.498,1e-05,115,89,25,25,0.001,204,4
0.496,1e-05,156,148,25,25,0.001,304,4
0.498,1e-05,193,211,25,25,0.001,404,4
0.498,1e-05,235,269,25,25,0.001,504,4
0.508,1e-05,295,309,25,25,0.001,604,4
0.52,1e-05,337,367,25,25,0.001,704,4
0.522,1e-05,384,420,25,25,0.001,804,4
0.53,1e-05,444,460,25,25,0.001,904,4
0.546,1e-05,494,510,25,25,0.001,1004,4
0.56,1e-05,546,558,25,25,0.001,1104,4
0.584,1e-05,600,604,25,25,0.001,1204,4
0.598,1e-05,659,645,25,25,0.001,1304,4
0.614,1e-05,708,696,25,25,0.001,1404,4
0.636,1e-05,766,738,25,25,0.001,1504,4
0.656,1e-05,817,787,25,25,0.001,1604,4
0.68,1e-05,864,840,25,25,0.001,1704,4
0.702,1e-05,910,894,25,25,0.001,1804,4
0.718,1e-05,958,946,25,25,0.001,1904,4
0.728,1e-05,1010,994,25,25,0.001,2004,4
0.5,1e-05,57,47,25,25,0.001,104,5
0.5,1e-05,101,103,25,25,0.001,204,5
0.5,1e-05,148,156,25,25,0.001,304,5
0.5,1e-05,199,205,25,25,0.001,404,5
0.5,1e-05,254,250,25,25,0.001,504,5
0.5,1e-05,311,293,25,25,0.001,604,5
0.502,1e-05,367,337,25,25,0.001,704,5
0.502,1e-05,416,388,25,25,0.001,804,5
0.502,1e-05,470,434,25,25,0.001,904,5
0.504,1e-05,524,480,25,25,0.001,1004,5
0.512,1e-05,568,536,25,25,0.001,1104,5
0.516,1e-05,624,580,25,25,0.001,1204,5
0.524,1e-05,671,633,25,25,0.001,1304,5
0.526,1e-05,719,685,25,25,0.001,1404,5
0.536,1e-05,771,733,25,25,0.001,1504,5
0.546,1e-05,813,791,25,25,0.001,1604,5
0.58,1e-05,861,843,25,25,0.001,1704,5
0.6,1e-05,907,897,25,25,0.001,1804,5
0.62,1e-05,957,947,25,25,0.001,1904,5
0.638,1e-05,1002,1002,25,25,0.001,2004,5
0.498,1e-05,43,61,25,25,0.001,104,6
0.494,1e-05,98,106,25,25,0.001,204,6
0.498,1e-05,140,164,25,25,0.001,304,6
0.496,1e-05,197,207,25,25,0.001,404,6
0.5,1e-05,243,261,25,25,0.001,504,6
0.502,1e-05,288,316,25,25,0.001,604,6
0.51,1e-05,340,364,25,25,0.001,704,6
0.522,1e-05,388,416,25,25,0.001,804,6
0.52,1e-05,434,470,25,25,0.001,904,6
0.528,1e-05,492,512,25,25,0.001,1004,6
0.536,1e-05,539,565,25,25,0.001,1104,6
0.542,1e-05,599,605,25,25,0.001,1204,6
0.552,1e-05,654,650,25,25,0.001,1304,6
0.558,1e-05,708,696,25,25,0.001,1404,6
0.578,1e-05,761,743,25,25,0.001,1504,6
0.6,1e-05,819,785,25,25,0.001,1604,6
0.614,1e-05,879,825,25,25,0.001,1704,6
0.63,1e-05,919,885,25,25,0.001,1804,6
0.648,1e-05,956,948,25,25,0.001,1904,6
0.654,1e-05,1007,997,25,25,0.001,2004,6
0.488,1e-05,52,52,25,25,0.001,104,7
0.486,1e-05,95,109,25,25,0.001,204,7
0.49,1e-05,154,150,25,25,0.001,304,7
0.484,1e-05,206,198,25,25,0.001,404,7
0.492,1e-05,256,248,25,25,0.001,504,7
0.5,1e-05,311,293,25,25,0.001,604,7
0.508,1e-05,365,339,25,25,0.001,704,7
0.516,1e-05,407,397,25,25,0.001,804,7
0.524,1e-05,454,450,25,25,0.001,904,7
0.546,1e-05,510,494,25,25,0.001,1004,7
0.552,1e-05,572,532,25,25,0.001,1104,7
0.564,1e-05,627,577,25,25,0.001,1204,7
0.57,1e-05,674,630,25,25,0.001,1304,7
0.608,1e-05,730,674,25,25,0.001,1404,7
0.63,1e-05,781,723,25,25,0.001,1504,7
0.65,1e-05,829,775,25,25,0.001,1604,7
0.654,1e-05,878,826,25,25,0.001,1704,7
0.666,1e-05,929,875,25,25,0.001,1804,7
0.686,1e-05,972,932,25,25,0.001,1904,7
0.702,1e-05,1013,991,25,25,0.001,2004,7
0.518,1e-05,55,49,25,25,0.001,104,8
0.52,1e-05,111,93,25,25,0.001,204,8
0.526,1e-05,166,138,25,25,0.001,304,8
0.536,1e-05,221,183,25,25,0.001,404,8
0.538,1e-05,269,235,25,25,0.001,504,8
0.544,1e-05,323,281,25,25,0.001,604,8
0.554,1e-05,371,333,25,25,0.001,704,8
0.562,1e-05,418,386,25,25,0.001,804,8
0.564,1e-05,466,438,25,25,0.001,904,8
0.576,1e-05,520,484,25,25,0.001,1004,8
0.572,1e-05,568,536,25,25,0.001,1104,8
0.586,1e-05,613,591,25,25,0.001,1204,8
0.598,1e-05,661,643,25,25,0.001,1304,8
0.614,1e-05,710,694,25,25,0.001,1404,8
0.622,1e-05,761,743,25,25,0.001,1504,8
0.64,1e-05,806,798,25,25,0.001,1604,8
0.66,1e-05,858,846,25,25,0.001,1704,8
0.666,1e-05,898,906,25,25,0.001,1804,8
0.67,1e-05,947,957,25,25,0.001,1904,8
0.692,1e-05,999,1005,25,25,0.001,2004,8
0.484,1e-05,59,45,25,25,0.001,104,9
0.486,1e-05,112,92,25,25,0.001,204,9
0.492,1e-05,163,141,25,25,0.001,304,9
0.494,1e-05,210,194,25,25,0.001,404,9
0.496,1e-05,268,236,25,25,0.001,504,9
0.496,1e-05,310,294,25,25,0.001,604,9
0.506,1e-05,356,348,25,25,0.001,704,9
0.512,1e-05,411,393,25,25,0.001,804,9
0.514,1e-05,459,445,25,25,0.001,904,9
0.534,1e-05,505,499,25,25,0.001,1004,9
0.536,1e-05,550,554,25,25,0.001,1104,9
0.556,1e-05,601,603,25,25,0.001,1204,9
0.564,1e-05,652,652,25,25,0.001,1304,9
0.578,1e-05,694,710,25,25,0.001,1404,9
0.574,1e-05,751,753,25,25,0.001,1504,9
0.594,1e-05,799,805,25,25,0.001,1604,9
0.594,1e-05,843,861,25,25,0.001,1704,9
0.604,1e-05,898,906,25,25,0.001,1804,9
0.626,1e-05,947,957,25,25,0.001,1904,9
0.64,1e-05,990,1014,25,25,0.001,2004,9
0.514,1e-05,48,56,25,25,0.001,104,10
0.516,1e-05,97,107,25,25,0.001,204,10
0.52,1e-05,151,153,25,25,0.001,304,10
0.522,1e-05,189,215,25,25,0.001,404,10
0.522,1e-05,237,267,25,25,0.001,504,10
0.518,1e-05,292,312,25,25,0.001,604,10
0.52,1e-05,339,365,25,25,0.001,704,10
0.526,1e-05,389,415,25,25,0.001,804,10
0.528,1e-05,440,464,25,25,0.001,904,10
0.526,1e-05,491,513,25,25,0.001,1004,10
0.524,1e-05,544,560,25,25,0.001,1104,10
0.528,1e-05,598,606,25,25,0.001,1204,10
0.542,1e-05,647,657,25,25,0.001,1304,10
0.546,1e-05,696,708,25,25,0.001,1404,10
0.556,1e-05,751,753,25,25,0.001,1504,10
0.58,1e-05,806,798,25,25,0.001,1604,10
0.598,1e-05,847,857,25,25,0.001,1704,10
0.628,1e-05,890,914,25,25,0.001,1804,10
0.652,1e-05,942,962,25,25,0.001,1904,10
0.682,1e-05,1002,1002,25,25,0.001,2004,10
0.486,1e-05,50,54,25,25,0.001,104,11
0.484,1e-05,96,108,25,25,0.001,204,11
0.486,1e-05,153,151,25,25,0.001,304,11
0.498,1e-05,204,200,25,25,0.001,404,11
0.506,1e-05,249,255,25,25,0.001,504,11
0.512,1e-05,296,308,25,25,0.001,604,11
0.52,1e-05,348,356,25,25,0.001,704,11
0.524,1e-05,407,397,25,25,0.001,804,11
0.542,1e-05,456,448,25,25,0.001,904,11
0.554,1e-05,508,496,25,25,0.001,1004,11
0.556,1e-05,563,541,25,25,0.001,1104,11
0.568,1e-05,614,590,25,25,0.001,1204,11
0.574,1e-05,650,654,25,25,0.001,1304,11
0.586,1e-05,702,702,25,25,0.001,1404,11
0.592,1e-05,752,752,25,25,0.001,1504,11
0.596,1e-05,804,800,25,25,0.001,1604,11
0.626,1e-05,855,849,25,25,0.001,1704,11
0.648,1e-05,899,905,25,25,0.001,1804,11
0.66,1e-05,951,953,25,25,0.001,1904,11
0.674,1e-05,999,1005,25,25,0.001,2004,11
0.5,1e-05,58,46,25,25,0.001,104,12
0.496,1e-05,109,95,25,25,0.001,204,12
0.498,1e-05,164,140,25,25,0.001,304,12
0.502,1e-05,216,188,25,25,0.001,404,12
0.502,1e-05,266,238,25,25,0.001,504,12
0.5,1e-05,314,290,25,25,0.001,604,12
0.504,1e-05,363,341,25,25,0.001,704,12
0.502,1e-05,409,395,25,25,0.001,804,12
0.504,1e-05,453,451,25,25,0.001,904,12
0.516,1e-05,501,503,25,25,0.001,1004,12
0.516,1e-05,545,559,25,25,0.001,1104,12
0.52,1e-05,601,603,25,25,0.001,1204,12
0.534,1e-05,656,648,25,25,0.001,1304,12
0.546,1e-05,697,707,25,25,0.001,1404,12
0.576,1e-05,753,751,25,25,0.001,1504,12
0.596,1e-05,798,806,25,25,0.001,1604,12
0.604,1e-05,844,860,25,25,0.001,1704,12
0.626,1e-05,906,898,25,25,0.001,1804,12
0.642,1e-05,957,947,25,25,0.001,1904,12
0.658,1e-05,1004,1000,25,25,0.001,2004,12
0.518,1e-05,52,52,25,25,0.001,104,13
0.52,1e-05,106,98,25,25,0.001,204,13
0.518,1e-05,155,149,25,25,0.001,304,13
0.524,1e-05,202,202,25,25,0.001,404,13
0.526,1e-05,251,253,25,25,0.001,504,13
0.53,1e-05,303,301,25,25,0.001,604,13
0.54,1e-05,356,348,25,25,0.001,704,13
0.546,1e-05,400,404,25,25,0.001,804,13
0.556,1e-05,444,460,25,25,0.001,904,13
0.562,1e-05,494,510,25,25,0.001,1004,13
0.566,1e-05,552,552,25,25,0.001,1104,13
0.57,1e-05,606,598,25,25,0.001,1204,13
0.574,1e-05,650,654,25,25,0.001,1304,13
0.592,1e-05,701,703,25,25,0.001,1404,13
0.6,1e-05,751,753,25,25,0.001,1504,13
0.612,1e-05,791,813,25,25,0.001,1604,13
0.62,1e-05,833,871,25,25,0.001,1704,13
0.634,1e-05,883,921,25,25,0.001,1804,13
0.654,1e-05,938,966,25,25,0.001,1904,13
0.672,1e-05,982,1022,25,25,0.001,2004,13
0.536,1e-05,52,52,25,25,0.001,104,14
0.542,1e-05,111,93,25,25,0.001,204,14
0.544,1e-05,159,145,25,25,0.001,304,14
0.544,1e-05,199,205,25,25,0.001,404,14
0.544,1e-05,262,242,25,25,0.001,504,14
0.546,1e-05,305,299,25,25,0.001,604,14
0.548,1e-05,358,346,25,25,0.001,704,14
0.558,1e-05,421,383,25,25,0.001,804,14
0.556,1e-05,465,439,25,25,0.001,904,14
0.57,1e-05,517,487,25,25,0.001,1004,14
0.572,1e-05,565,539,25,25,0.001,1104,14
0.592,1e-05,616,588,25,25,0.001,1204,14
0.6,1e-05,671,633,25,25,0.001,1304,14
0.61,1e-05,716,688,25,25,0.001,1404,14
0.636,1e-05,758,746,25,25,0.001,1504,14
0.658,1e-05,805,799,25,25,0.001,1604,14
0.67,1e-05,855,849,25,25,0.001,1704,14
0.684,1e-05,906,898,25,25,0.001,1804,14
0.7,1e-05,954,950,25,25,0.001,1904,14
0.714,1e-05,1005,999,25,25,0.001,2004,14
0.518,1e-05,53,51,25,25,0.001,104,15
0.516,1e-05,103,101,25,25,0.001,204,15
0.526,1e-05,148,156,25,25,0.001,304,15
0.522,1e-05,199,205,25,25,0.001,404,15
0.528,1e-05,252,252,25,25,0.001,504,15
0.534,1e-05,308,296,25,25,0.001,604,15
0.538,1e-05,355,349,25,25,0.001,704,15
0.538,1e-05,406,398,25,25,0.001,804,15
0.552,1e-05,462,442,25,25,0.001,904,15
0.558,1e-05,516,488,25,25,0.001,1004,15
0.558,1e-05,565,539,25,25,0.001,1104,15
0.562,1e-05,615,589,25,25,0.001,1204,15
0.566,1e-05,664,640,25,25,0.001,1304,15
0.582,1e-05,711,693,25,25,0.001,1404,15
0.588,1e-05,764,740,25,25,0.001,1504,15
0.608,1e-05,823,781,25,25,0.001,1604,15
0.622,1e-05,874,830,25,25,0.001,1704,15
0.634,1e-05,918,886,25,25,0.001,1804,15
0.65,1e-05,964,940,25,25,0.001,1904,15
0.67,1e-05,1010,994,25,25,0.001,2004,15
0.498,1e-05,54,50,25,25,0.001,104,16
0.508,1e-05,107,97,25,25,0.001,204,16
0.502,1e-05,148,156,25,25,0.001,304,16
0.5,1e-05,196,208,25,25,0.001,404,16
0.502,1e-05,237,267,25,25,0.001,504,16
0.504,1e-05,277,327,25,25,0.001,604,16
0.51,1e-05,329,375,25,25,0.001,704,16
0.518,1e-05,377,427,25,25,0.001,804,16
0.534,1e-05,430,474,25,25,0.001,904,16
0.538,1e-05,469,535,25,25,0.001,1004,16
0.546,1e-05,522,582,25,25,0.001,1104,16
0.54,1e-05,580,624,25,25,0.001,1204,16
0.568,1e-05,630,674,25,25,0.001,1304,16
0.58,1e-05,689,715,25,25,0.001,1404,16
0.586,1e-05,744,760,25,25,0.001,1504,16
0.604,1e-05,793,811,25,25,0.001,1604,16
0.622,1e-05,851,853,25,25,0.001,1704,16
0.63,1e-05,902,902,25,25,0.001,1804,16
0.648,1e-05,943,961,25,25,0.001,1904,16
0.67,1e-05,991,1013,25,25,0.001,2004,16
0.52,1e-05,59,45,25,25,0.001,104,17
0.518,1e-05,106,98,25,25,0.001,204,17
0.522,1e-05,157,147,25,25,0.001,304,17
0.52,1e-05,205,199,25,25,0.001,404,17
0.52,1e-05,255,249,25,25,0.001,504,17
0.52,1e-05,305,299,25,25,0.001,604,17
0.518,1e-05,358,346,25,25,0.001,704,17
0.524,1e-05,404,400,25,25,0.001,804,17
0.528,1e-05,455,449,25,25,0.001,904,17
0.534,1e-05,501,503,25,25,0.001,1004,17
0.538,1e-05,558,546,25,25,0.001,1104,17
0.55,1e-05,605,599,25,25,0.001,1204,17
0.568,1e-05,655,649,25,25,0.001,1304,17
0.576,1e-05,708,696,25,25,0.001,1404,17
0.59,1e-05,749,755,25,25,0.001,1504,17
0.612,1e-05,799,805,25,25,0.001,1604,17
0.624,1e-05,845,859,25,25,0.001,1704,17
0.648,1e-05,898,906,25,25,0.001,1804,17
0.66,1e-05,941,963,25,25,0.001,1904,17
0.68,1e-05,991,1013,25,25,0.001,2004,17
0.452,1e-05,57,47,25,25,0.001,104,18
0.456,1e-05,101,103,25,25,0.001,204,18
0.452,1e-05,151,153,25,25,0.001,304,18
0.464,1e-05,205,199,25,25,0.001,404,18
0.472,1e-05,260,244,25,25,0.001,504,18
0.48,1e-05,313,291,25,25,0.001,604,18
0.486,1e-05,369,335,25,25,0.001,704,18
0.496,1e-05,417,387,25,25,0.001,804,18
0.506,1e-05,470,434,25,25,0.001,904,18
0.528,1e-05,518,486,25,25,0.001,1004,18
0.54,1e-05,572,532,25,25,0.001,1104,18
0.554,1e-05,615,589,25,25,0.001,1204,18
0.562,1e-05,662,642,25,25,0.001,1304,18
0.576,1e-05,711,693,25,25,0.001,1404,18
0.586,1e-05,766,738,25,25,0.001,1504,18
0.604,1e-05,816,788,25,25,0.001,1604,18
0.63,1e-05,864,840,25,25,0.001,1704,18
0.65,1e-05,918,886,25,25,0.001,1804,18
0.68,1e-05,970,934,25,25,0.001,1904,18
0.704,1e-05,1013,991,25,25,0.001,2004,18
0.516,1e-05,55,49,25,25,0.001,104,19
0.528,1e-05,104,100,25,25,0.001,204,19
0.53,1e-05,153,151,25,25,0.001,304,19
0.534,1e-05,212,192,25,25,0.001,404,19
0.54,1e-05,265,239,25,25,0.001,504,19
0.548,1e-05,307,297,25,25,0.001,604,19
0.554,1e-05,358,346,25,25,0.001,704,19
0.56,1e-05,410,394,25,25,0.001,804,19
0.566,1e-05,446,458,25,25,0.001,904,19
0.57,1e-05,500,504,25,25,0.001,1004,19
0.578,1e-05,549,555,25,25,0.001,1104,19
0.592,1e-05,602,602,25,25,0.001,1204,19
0.606,1e-05,653,651,25,25,0.001,1304,19
0.612,1e-05,709,695,25,25,0.001,1404,19
0.614,1e-05,746,758,25,25,0.001,1504,19
0.644,1e-05,792,812,25,25,0.001,1604,19
0.65,1e-05,834,870,25,25,0.001,1704,19
0.664,1e-05,894,910,25,25,0.001,1804,19
0.678,1e-05,948,956,25,25,0.001,1904,19
0.714,1e-05,999,1005,25,25,0.001,2004,19
0.538,1e-05,56,48,25,25,0.001,104,20
0.542,1e-05,108,96,25,25,0.001,204,20
0.544,1e-05,159,145,25,25,0.001,304,20
0.544,1e-05,211,193,25,25,0.001,404,20
0.548,1e-05,257,247,25,25,0.001,504,20
0.548,1e-05,301,303,25,25,0.001,604,20
0.56,1e-05,356,348,25,25,0.001,704,20
0.568,1e-05,404,400,25,25,0.001,804,20
0.574,1e-05,457,447,25,25,0.001,904,20
0.592,1e-05,512,492,25,25,0.001,1004,20
0.608,1e-05,562,542,25,25,0.001,1104,20
0.608,1e-05,617,587,25,25,0.001,1204,20
0.608,1e-05,673,631,25,25,0.001,1304,20
0.622,1e-05,730,674,25,25,0.001,1404,20
0.64,1e-05,773,731,25,25,0.001,1504,20
0.656,1e-05,819,785,25,25,0.001,1604,20
0.676,1e-05,872,832,25,25,0.001,1704,20
0.696,1e-05,918,886,25,25,0.001,1804,20
0.718,1e-05,959,945,25,25,0.001,1904,20
0.736,1e-05,1003,1001,25,25,0.001,2004,20
0.516,1e-05,60,44,25,25,0.01,104,1
0.55,1e-05,110,94,25,25,0.01,204,1
0.558,1e-05,160,144,25,25,0.01,304,1
0.552,1e-05,207,197,25,25,0.01,404,1
0.584,1e-05,253,251,25,25,0.01,504,1
0.614,1e-05,304,300,25,25,0.01,604,1
0.63,1e-05,365,339,25,25,0.01,704,1
0.664,1e-05,405,399,25,25,0.01,804,1
0.7,1e-05,450,454,25,25,0.01,904,1
0.76,1e-05,502,502,25,25,0.01,1004,1
0.818,1e-05,552,552,25,25,0.01,1104,1
0.866,1e-05,605,599,25,25,0.01,1204,1
0.908,1e-05,658,646,25,25,0.01,1304,1
0.944,1e-05,710,694,25,25,0.01,1404,1
0.948,1e-05,754,750,25,25,0.01,1504,1
0.956,1e-05,790,814,25,25,0.01,1604,1
0.958,1e-05,832,872,25,25,0.01,1704,1
0.96,1e-05,885,919,25,25,0.01,1804,1
0.962,1e-05,926,978,25,25,0.01,1904,1
0.964,1e-05,978,1026,25,25,0.01,2004,1
0.482,1e-05,44,60,25,25,0.01,104,2
0.508,1e-05,97,107,25,25,0.01,204,2
0.526,1e-05,146,158,25,25,0.01,304,2
0.578,1e-05,192,212,25,25,0.01,404,2
0.62,1e-05,233,271,25,25,0.01,504,2
0.648,1e-05,275,329,25,25,0.01,604,2
0.704,1e-05,325,379,25,25,0.01,704,2
0.758,1e-05,378,426,25,25,0.01,804,2
0.79,1e-05,427,477,25,25,0.01,904,2
0.82,1e-05,475,529,25,25,0.01,1004,2
0.856,1e-05,517,587,25,25,0.01,1104,2
0.88,1e-05,565,639,25,25,0.01,1204,2
0.884,1e-05,615,689,25,25,0.01,1304,2
0.918,1e-05,673,731,25,25,0.01,1404,2
0.936,1e-05,734,770,25,25,0.01,1504,2
0.938,1e-05,783,821,25,25,0.01,1604,2
0.942,1e-05,832,872,25,25,0.01,1704,2
0.958,1e-05,881,923,25,25,0.01,1804,2
0.962,1e-05,935,969,25,25,0.01,1904,2
0.956,1e-05,991,1013,25,25,0.01,2004,2
0.514,1e-05,51,53,25,25,0.01,104,3
0.524,1e-05,106,98,25,25,0.01,204,3
0.572,1e-05,161,143,25,25,0.01,304,3
0.606,1e-05,214,190,25,25,0.01,404,3
0.65,1e-05,259,245,25,25,0.01,504,3
0.684,1e-05,314,290,25,25,0.01,604,3
0.712,1e-05,364,340,25,25,0.01,704,3
0.752,1e-05,415,389,25,25,0.01,804,3
0.79,1e-05,470,434,25,25,0.01,904,3
0.83,1e-05,510,494,25,25,0.01,1004,3
0.864,1e-05,561,543,25,25,0.01,1104,3
0.89,1e-05,613,591,25,25,0.01,1204,3
0.924,1e-05,661,643,25,25,0.01,1304,3
0.928,1e-05,708,696,25,25,0.01,1404,3
0.938,1e-05,763,741,25,25,0.01,1504,3
0.952,1e-05,807,797,25,25,0.01,1604,3
0.952,1e-05,856,848,25,25,0.01,1704,3
0.962,1e-05,907,897,25,25,0.01,1804,3
0.964,1e-05,961,943,25,25,0.01,1904,3
0.968,1e-05,1013,991,25,25,0.01,2004,3
0.516,1e-05,58,46,25,25,0.01,104,4
0.564,1e-05,107,97,25,25,0.01,204,4
0.548,1e-05,160,144,25,25,0.01,304,4
0.538,1e-05,213,191,25,25,0.01,404,4
0.566,1e-05,261,243,25,25,0.01,504,4
0.608,1e-05,324,280,25,25,0.01,604,4
0.618,1e-05,383,321,25,25,0.01,704,4
0.66,1e-05,437,367,25,25,0.01,804,4
0.686,1e-05,484,420,25,25,0.01,904,4
0.76,1e-05,531,473,25,25,0.01,1004,4
0.818,1e-05,585,519,25,25,0.01,1104,4
0.868,1e-05,641,563,25,25,0.01,1204,4
0.892,1e-05,680,624,25,25,0.01,1304,4
0.93,1e-05,736,668,25,25,0.01,1404,4
0.944,1e-05,780,724,25,25,0.01,1504,4
0.946,1e-05,822,782,25,25,0.01,1604,4
0.964,1e-05,871,833,25,25,0.01,1704,4
0.968,1e-05,920,884,25,25,0.01,1804,4
0.97,1e-05,969,935,25,25,0.01,1904,4
0.982,1e-05,1010,994,25,25,0.01,2004,4
0.482,1e-05,52,52,25,25,0.01,104,5
0.512,1e-05,96,108,25,25,0.01,204,5
0.516,1e-05,141,163,25,25,0.01,304,5
0.542,1e-05,188,216,25,25,0.01,404,5
0.562,1e-05,237,267,25,25,0.01,504,5
0.624,1e-05,286,318,25,25,0.01,604,5
0.66,1e-05,337,367,25,25,0.01,704,5
0.73,1e-05,390,414,25,25,0.01,804,5
0.774,1e-05,438,466,25,25,0.01,904,5
0.844,1e-05,489,515,25,25,0.01,1004,5
0.872,1e-05,540,564,25,25,0.01,1104,5
0.89,1e-05,583,621,25,25,0.01,1204,5
0.916,1e-05,633,671,25,25,0.01,1304,5
0.928,1e-05,676,728,25,25,0.01,1404,5
0.936,1e-05,726,778,25,25,0.01,1504,5
0.948,1e-05,779,825,25,25,0.01,1604,5
0.954,1e-05,828,876,25,25,0.01,1704,5
0.958,1e-05,881,923,25,25,0.01,1804,5
0.96,1e-05,927,977,25,25,0.01,1904,5
0.962,1e-05,982,1022,25,25,0.01,2004,5
0.454,1e-05,51,53,25,25,0.01,104,6
0.472,1e-05,104,100,25,25,0.01,204,6
0.518,1e-05,152,152,25,25,0.01,304,6
0.546,1e-05,200,204,25,25,0.01,404,6
0.566,1e-05,245,259,25,25,0.01,504,6
0.592,1e-05,293,311,25,25,0.01,604,6
0.602,1e-05,344,360,25,25,0.01,704,6
0.65,1e-05,393,411,25,25,0.01,804,6
0.7,1e-05,443,461,25,25,0.01,904,6
0.75,1e-05,498,506,25,25,0.01,1004,6
0.788,1e-05,550,554,25,25,0.01,1104,6
0.842,1e-05,596,608,25,25,0.01,1204,6
0.868,1e-05,652,652,25,25,0.01,1304,6
0.906,1e-05,708,696,25,25,0.01,1404,6
0.918,1e-05,763,741,25,25,0.01,1504,6
0.936,1e-05,816,788,25,25,0.01,1604,6
0.954,1e-05,862,842,25,25,0.01,1704,6
0.944,1e-05,903,901,25,25,0.01,1804,6
0.954,1e-05,951,953,25,25,0.01,1904,6
0.962,1e-05,1005,999,25,25,0.01,2004,6
0.496,1e-05,51,53,25,25,0.01,104,7
0.502,1e-05,95,109,25,25,0.01,204,7
0.518,1e-05,138,166,25,25,0.01,304,7
0.546,1e-05,189,215,25,25,0.01,404,7
0.524,1e-05,238,266,25,25,0.01,504,7
0.536,1e-05,299,305,25,25,0.01,604,7
0.608,1e-05,347,357,25,25,0.01,704,7
0.678,1e-05,402,402,25,25,0.01,804,7
0.728,1e-05,455,449,25,25,0.01,904,7
0.766,1e-05,504,500,25,25,0.01,1004,7
0.822,1e-05,546,558,25,25,0.01,1104,7
0.88,1e-05,600,604,25,25,0.01,1204,7
0.906,1e-05,647,657,25,25,0.01,1304,7
0.932,1e-05,707,697,25,25,0.01,1404,7
0.944,1e-05,758,746,25,25,0.01,1504,7
0.96,1e-05,800,804,25,25,0.01,1604,7
0.96,1e-05,852,852,25,25,0.01,1704,7
0.966,1e-05,899,905,25,25,0.01,1804,7
0.972,1e-05,954,950,25,25,0.01,1904,7
0.978,1e-05,1000,1004,25,25,0.01,2004,7
0.506,1e-05,58,46,25,25,0.01,104,8
0.536,1e-05,118,86,25,25,0.01,204,8
0.534,1e-05,176,128,25,25,0.01,304,8
0.542,1e-05,225,179,25,25,0.01,404,8
0.57,1e-05,272,232,25,25,0.01,504,8
0.628,1e-05,318,286,25,25,0.01,604,8
0.648,1e-05,366,338,25,25,0.01,704,8
0.7,1e-05,421,383,25,25,0.01,804,8
0.772,1e-05,465,439,25,25,0.01,904,8
0.82,1e-05,509,495,25,25,0.01,1004,8
0.856,1e-05,558,546,25,25,0.01,1104,8
0.898,1e-05,611,593,25,25,0.01,1204,8
0.934,1e-05,655,649,25,25,0.01,1304,8
0.952,1e-05,705,699,25,25,0.01,1404,8
0.958,1e-05,764,740,25,25,0.01,1504,8
0.96,1e-05,814,790,25,25,0.01,1604,8
0.968,1e-05,867,837,25,25,0.01,1704,8
0.972,1e-05,913,891,25,25,0.01,1804,8
0.974,1e-05,960,944,25,25,0.01,1904,8
0.978,1e-05,1003,1001,25,25,0.01,2004,8
0.536,1e-05,48,56,25,25,0.01,104,9
0.568,1e-05,105,99,25,25,0.01,204,9
0.566,1e-05,161,143,25,25,0.01,304,9
0.592,1e-05,214,190,25,25,0.01,404,9
0.62,1e-05,257,247,25,25,0.01,504,9
0.656,1e-05,303,301,25,25,0.01,604,9
0.676,1e-05,350,354,25,25,0.01,704,9
0.686,1e-05,391,413,25,25,0.01,804,9
0.728,1e-05,451,453,25,25,0.01,904,9
0.784,1e-05,500,504,25,25,0.01,1004,9
0.82,1e-05,549,555,25,25,0.01,1104,9
0.87,1e-05,599,605,25,25,0.01,1204,9
0.894,1e-05,654,650,25,25,0.01,1304,9
0.91,1e-05,707,697,25,25,0.01,1404,9
0.928,1e-05,750,754,25,25,0.01,1504,9
0.938,1e-05,802,802,25,25,0.01,1604,9
0.948,1e-05,849,855,25,25,0.01,1704,9
0.95,1e-05,898,906,25,25,0.01,1804,9
0.948,1e-05,947,957,25,25,0.01,1904,9
0.954,1e-05,991,1013,25,25,0.01,2004,9
0.48,1e-05,55,49,25,25,0.01,104,10
0.518,1e-05,105,99,25,25,0.01,204,10
0.552,1e-05,156,148,25,25,0.01,304,10
0.59,1e-05,208,196,25,25,0.01,404,10
0.596,1e-05,263,241,25,25,0.01,504,10
0.632,1e-05,313,291,25,25,0.01,604,10
0.66,1e-05,370,334,25,25,0.01,704,10
0.708,1e-05,410,394,25,25,0.01,804,10
0.752,1e-05,456,448,25,25,0.01,904,10
0.81,1e-05,495,509,25,25,0.01,1004,10
0.86,1e-05,551,553,25,25,0.01,1104,10
0.892,1e-05,602,602,25,25,0.01,1204,10
0.9,1e-05,650,654,25,25,0.01,1304,10
0.934,1e-05,701,703,25,25,0.01,1404,10
0.946,1e-05,749,755,25,25,0.01,1504,10
0.958,1e-05,800,804,25,25,0.01,1604,10
0.96,1e-05,851,853,25,25,0.01,1704,10
0.968,1e-05,895,909,25,25,0.01,1804,10
0.966,1e-05,948,956,25,25,0.01,1904,10
0.972,1e-05,1000,1004,25,25,0.01,2004,10
0.528,1e-05,49,55,25,25,0.01,104,11
0.548,1e-05,94,110,25,25,0.01,204,11
0.56,1e-05,145,159,25,25,0.01,304,11
0.576,1e-05,194,210,25,25,0.01,404,11
0.584,1e-05,245,259,25,25,0.01,504,11
0.604,1e-05,293,311,25,25,0.01,604,11
0.634,1e-05,340,364,25,25,0.01,704,11
0.676,1e-05,385,419,25,25,0.01,804,11
0.72,1e-05,438,466,25,25,0.01,904,11
0.772,1e-05,491,513,25,25,0.01,1004,11
0.806,1e-05,542,562,25,25,0.01,1104,11
0.876,1e-05,588,616,25,25,0.01,1204,11
0.898,1e-05,635,669,25,25,0.01,1304,11
0.922,1e-05,693,711,25,25,0.01,1404,11
0.944,1e-05,743,761,25,25,0.01,1504,11
0.956,1e-05,797,807,25,25,0.01,1604,11
0.966,1e-05,847,857,25,25,0.01,1704,11
0.968,1e-05,896,908,25,25,0.01,1804,11
0.97,1e-05,954,950,25,25,0.01,1904,11
0.972,1e-05,1004,1000,25,25,0.01,2004,11
0.526,1e-05,55,49,25,25,0.01,104,12
0.568,1e-05,101,103,25,25,0.01,204,12
0.614,1e-05,142,162,25,25,0.01,304,12
0.668,1e-05,187,217,25,25,0.01,404,12
0.666,1e-05,237,267,25,25,0.01,504,12
0.684,1e-05,290,314,25,25,0.01,604,12
0.728,1e-05,343,361,25,25,0.01,704,12
0.794,1e-05,393,411,25,25,0.01,804,12
0.84,1e-05,444,460,25,25,0.01,904,12
0.886,1e-05,491,513,25,25,0.01,1004,12
0.912,1e-05,543,561,25,25,0.01,1104,12
0.924,1e-05,585,619,25,25,0.01,1204,12
0.946,1e-05,631,673,25,25,0.01,1304,12
0.956,1e-05,687,717,25,25,0.01,1404,12
0.954,1e-05,737,767,25,25,0.01,1504,12
0.96,1e-05,783,821,25,25,0.01,1604,12
0.962,1e-05,834,870,25,25,0.01,1704,12
0.968,1e-05,882,922,25,25,0.01,1804,12
0.97,1e-05,937,967,25,25,0.01,1904,12
0.962,1e-05,994,1010,25,25,0.01,2004,12
0.492,1e-05,56,48,25,25,0.01,104,13
0.518,1e-05,100,104,25,25,0.01,204,13
0.564,1e-05,144,160,25,25,0.01,304,13
0.578,1e-05,194,210,25,25,0.01,404,13
0.578,1e-05,244,260,25,25,0.01,504,13
0.6,1e-05,295,309,25,25,0.01,604,13
0.668,1e-05,341,363,25,25,0.01,704,13
0.72,1e-05,394,410,25,25,0.01,804,13
0.754,1e-05,443,461,25,25,0.01,904,13
0.8,1e-05,501,503,25,25,0.01,1004,13
0.824,1e-05,553,551,25,25,0.01,1104,13
0.866,1e-05,606,598,25,25,0.01,1204,13
0.88,1e-05,659,645,25,25,0.01,1304,13
0.918,1e-05,710,694,25,25,0.01,1404,13
0.93,1e-05,765,739,25,25,0.01,1504,13
0.942,1e-05,803,801,25,25,0.01,1604,13
0.952,1e-05,847,857,25,25,0.01,1704,13
0.954,1e-05,905,899,25,25,0.01,1804,13
0.964,1e-05,954,950,25,25,0.01,1904,13
0.966,1e-05,995,1009,25,25,0.01,2004,13
0.494,1e-05,56,48,25,25,0.01,104,14
0.504,1e-05,111,93,25,25,0.01,204,14
0.536,1e-05,172,132,25,25,0.01,304,14
0.552,1e-05,223,181,25,25,0.01,404,14
0.566,1e-05,273,231,25,25,0.01,504,14
0.606,1e-05,319,285,25,25,0.01,604,14
0.644,1e-05,367,337,25,25,0.01,704,14
0.73,1e-05,418,386,25,25,0.01,804,14
0.784,1e-05,463,441,25,25,0.01,904,14
0.826,1e-05,514,490,25,25,0.01,1004,14
0.856,1e-05,566,538,25,25,0.01,1104,14
0.872,1e-05,615,589,25,25,0.01,1204,14
0.91,1e-05,665,639,25,25,0.01,1304,14
0.936,1e-05,715,689,25,25,0.01,1404,14
0.946,1e-05,769,735,25,25,0.01,1504,14
0.944,1e-05,809,795,25,25,0.01,1604,14
0.946,1e-05,858,846,25,25,0.01,1704,14
0.96,1e-05,905,899,25,25,0.01,1804,14
0.96,1e-05,956,948,25,25,0.01,1904,14
0.968,1e-05,1002,1002,25,25,0.01,2004,14
0.524,1e-05,51,53,25,25,0.01,104,15
0.552,1e-05,99,105,25,25,0.01,204,15
0.554,1e-05,148,156,25,25,0.01,304,15
0.57,1e-05,185,219,25,25,0.01,404,15
0.61,1e-05,238,266,25,25,0.01,504,15
0.66,1e-05,284,320,25,25,0.01,604,15
0.742,1e-05,337,367,25,25,0.01,704,15
0.81,1e-05,384,420,25,25,0.01,804,15
0.862,1e-05,435,469,25,25,0.01,904,15
0.886,1e-05,480,524,25,25,0.01,1004,15
0.914,1e-05,533,571,25,25,0.01,1104,15
0.928,1e-05,581,623,25,25,0.01,1204,15
0.93,1e-05,627,677,25,25,0.01,1304,15
0.946,1e-05,683,721,25,25,0.01,1404,15
0.958,1e-05,730,774,25,25,0.01,1504,15
0.964,1e-05,789,815,25,25,0.01,1604,15
0.966,1e-05,843,861,25,25,0.01,1704,15
0.964,1e-05,896,908,25,25,0.01,1804,15
0.964,1e-05,949,955,25,25,0.01,1904,15
0.972,1e-05,1002,1002,25,25,0.01,2004,15
0.544,1e-05,47,57,25,25,0.01,104,16
0.576,1e-05,99,105,25,25,0.01,204,16
0.588,1e-05,154,150,25,25,0.01,304,16
0.61,1e-05,206,198,25,25,0.01,404,16
0.612,1e-05,251,253,25,25,0.01,504,16
0.656,1e-05,305,299,25,25,0.01,604,16
0.67,1e-05,359,345,25,25,0.01,704,16
0.69,1e-05,414,390,25,25,0.01,804,16
0.74,1e-05,459,445,25,25,0.01,904,16
0.794,1e-05,511,493,25,25,0.01,1004,16
0.862,1e-05,556,548,25,25,0.01,1104,16
0.87,1e-05,604,600,25,25,0.01,1204,16
0.886,1e-05,655,649,25,25,0.01,1304,16
0.904,1e-05,704,700,25,25,0.01,1404,16
0.928,1e-05,755,749,25,25,0.01,1504,16
0.942,1e-05,802,802,25,25,0.01,1604,16
0.94,1e-05,851,853,25,25,0.01,1704,16
0.942,1e-05,898,906,25,25,0.01,1804,16
0.954,1e-05,948,956,25,25,0.01,1904,16
0.962,1e-05,983,1021,25,25,0.01,2004,16
0.498,1e-05,50,54,25,25,0.01,104,17
0.554,1e-05,107,97,25,25,0.01,204,17
0.6,1e-05,151,153,25,25,0.01,304,17
0.632,1e-05,200,204,25,25,0.01,404,17
0.65,1e-05,241,263,25,25,0.01,504,17
0.678,1e-05,301,303,25,25,0.01,604,17
0.722,1e-05,345,359,25,25,0.01,704,17
0.81,1e-05,396,408,25,25,0.01,804,17
0.872,1e-05,452,452,25,25,0.01,904,17
0.894,1e-05,506,498,25,25,0.01,1004,17
0.908,1e-05,555,549,25,25,0.01,1104,17
0.918,1e-05,614,590,25,25,0.01,1204,17
0.932,1e-05,668,636,25,25,0.01,1304,17
0.948,1e-05,715,689,25,25,0.01,1404,17
0.96,1e-05,760,744,25,25,0.01,1504,17
0.956,1e-05,807,797,25,25,0.01,1604,17
0.958,1e-05,850,854,25,25,0.01,1704,17
0.962,1e-05,897,907,25,25,0.01,1804,17
0.966,1e-05,948,956,25,25,0.01,1904,17
0.966,1e-05,1001,1003,25,25,0.01,2004,17
0.506,1e-05,53,51,25,25,0.01,104,18
0.546,1e-05,96,108,25,25,0.01,204,18
0.562,1e-05,144,160,25,25,0.01,304,18
0.594,1e-05,190,214,25,25,0.01,404,18
0.616,1e-05,245,259,25,25,0.01,504,18
0.63,1e-05,287,317,25,25,0.01,604,18
0.672,1e-05,345,359,25,25,0.01,704,18
0.686,1e-05,395,409,25,25,0.01,804,18
0.712,1e-05,442,462,25,25,0.01,904,18
0.786,1e-05,490,514,25,25,0.01,1004,18
0.836,1e-05,543,561,25,25,0.01,1104,18
0.902,1e-05,598,606,25,25,0.01,1204,18
0.932,1e-05,651,653,25,25,0.01,1304,18
0.944,1e-05,702,702,25,25,0.01,1404,18
0.952,1e-05,744,760,25,25,0.01,1504,18
0.956,1e-05,795,809,25,25,0.01,1604,18
0.96,1e-05,843,861,25,25,0.01,1704,18
0.962,1e-05,894,910,25,25,0.01,1804,18
0.962,1e-05,948,956,25,25,0.01,1904,18
0.97,1e-05,1008,996,25,25,0.01,2004,18
0.528,1e-05,60,44,25,25,0.01,104,19
0.54,1e-05,111,93,25,25,0.01,204,19
0.548,1e-05,160,144,25,25,0.01,304,19
0.546,1e-05,209,195,25,25,0.01,404,19
0.542,1e-05,262,242,25,25,0.01,504,19
0.562,1e-05,314,290,25,25,0.01,604,19
0.584,1e-05,364,340,25,25,0.01,704,19
0.61,1e-05,421,383,25,25,0.01,804,19
0.674,1e-05,465,439,25,25,0.01,904,19
0.734,1e-05,520,484,25,25,0.01,1004,19
0.788,1e-05,571,533,25,25,0.01,1104,19
0.838,1e-05,618,586,25,25,0.01,1204,19
0.862,1e-05,666,638,25,25,0.01,1304,19
0.892,1e-05,711,693,25,25,0.01,1404,19
0.908,1e-05,764,740,25,25,0.01,1504,19
0.93,1e-05,821,783,25,25,0.01,1604,19
0.932,1e-05,869,835,25,25,0.01,1704,19
0.956,1e-05,916,888,25,25,0.01,1804,19
0.958,1e-05,965,939,25,25,0.01,1904,19
0.96,1e-05,1018,986,25,25,0.01,2004,19
0.47,1e-05,46,58,25,25,0.01,104,20
0.512,1e-05,101,103,25,25,0.01,204,20
0.542,1e-05,147,157,25,25,0.01,304,20
0.598,1e-05,192,212,25,25,0.01,404,20
0.62,1e-05,242,262,25,25,0.01,504,20
0.658,1e-05,296,308,25,25,0.01,604,20
0.69,1e-05,346,358,25,25,0.01,704,20
0.736,1e-05,393,411,25,25,0.01,804,20
0.772,1e-05,441,463,25,25,0.01,904,20
0.822,1e-05,485,519,25,25,0.01,1004,20
0.854,1e-05,530,574,25,25,0.01,1104,20
0.912,1e-05,581,623,25,25,0.01,1204,20
0.926,1e-05,628,676,25,25,0.01,1304,20
0.942,1e-05,676,728,25,25,0.01,1404,20
0.944,1e-05,732,772,25,25,0.01,1504,20
0.962,1e-05,788,816,25,25,0.01,1604,20
0.956,1e-05,837,867,25,25,0.01,1704,20
0.962,1e-05,882,922,25,25,0.01,1804,20
0.964,1e-05,930,974,25,25,0.01,1904,20
0.97,1e-05,981,1023,25,25,0.01,2004,20
0.448,0.0001,57,47,25,25,0.0001,104,1
0.446,0.0001,117,87,25,25,0.0001,204,1
0.448,0.0001,169,135,25,25,0.0001,304,1
0.45,0.0001,219,185,25,25,0.0001,404,1
0.45,0.0001,276,228,25,25,0.0001,504,1
0.45,0.0001,329,275,25,25,0.0001,604,1
0.454,0.0001,385,319,25,25,0.0001,704,1
0.454,0.0001,434,370,25,25,0.0001,804,1
0.452,0.0001,490,414,25,25,0.0001,904,1
0.454,0.0001,546,458,25,25,0.0001,1004,1
0.458,0.0001,593,511,25,25,0.0001,1104,1
0.458,0.0001,643,561,25,25,0.0001,1204,1
0.456,0.0001,693,611,25,25,0.0001,1304,1
0.456,0.0001,740,664,25,25,0.0001,1404,1
0.458,0.0001,790,714,25,25,0.0001,1504,1
0.462,0.0001,833,771,25,25,0.0001,1604,1
0.462,0.0001,879,825,25,25,0.0001,1704,1
0.46,0.0001,930,874,25,25,0.0001,1804,1
0.462,0.0001,981,923,25,25,0.0001,1904,1
0.462,0.0001,1030,974,25,25,0.0001,2004,1
0.538,0.0001,59,45,25,25,0.0001,104,2
0.538,0.0001,105,99,25,25,0.0001,204,2
0.538,0.0001,153,151,25,25,0.0001,304,2
0.538,0.0001,207,197,25,25,0.0001,404,2
0.536,0.0001,258,246,25,25,0.0001,504,2
0.538,0.0001,306,298,25,25,0.0001,604,2
0.538,0.0001,356,348,25,25,0.0001,704,2
0.54,0.0001,403,401,25,25,0.0001,804,2
0.542,0.0001,446,458,25,25,0.0001,904,2
0.54,0.0001,488,516,25,25,0.0001,1004,2
0.538,0.0001,539,565,25,25,0.0001,1104,2
0.54,0.0001,594,610,25,25,0.0001,1204,2
0.54,0.0001,644,660,25,25,0.0001,1304,2
0.54,0.0001,693,711,25,25,0.0001,1404,2
0.538,0.0001,749,755,25,25,0.0001,1504,2
0.538,0.0001,806,798,25,25,0.0001,1604,2
0.538,0.0001,854,850,25,25,0.0001,1704,2
0.54,0.0001,905,899,25,25,0.0001,1804,2
0.542,0.0001,946,958,25,25,0.0001,1904,2
0.548,0.0001,998,1006,25,25,0.0001,2004,2
0.496,0.0001,57,47,25,25,0.0001,104,3
0.496,0.0001,114,90,25,25,0.0001,204,3
0.496,0.0001,163,141,25,25,0.0001,304,3
0.496,0.0001,210,194,25,25,0.0001,404,3
0.496,0.0001,249,255,25,25,0.0001,504,3
0.496,0.0001,298,306,25,25,0.0001,604,3
0.496,0.0001,354,350,25,25,0.0001,704,3
0.496,0.0001,399,405,25,25,0.0001,804,3
0.496,0.0001,454,450,25,25,0.0001,904,3
0.496,0.0001,498,506,25,25,0.0001,1004,3
0.496,0.0001,554,550,25,25,0.0001,1104,3
0.494,0.0001,604,600,25,25,0.0001,1204,3
0.494,0.0001,654,650,25,25,0.0001,1304,3
0.494,0.0001,703,701,25,25,0.0001,1404,3
0.494,0.0001,753,751,25,25,0.0001,1504,3
0.494,0.0001,802,802,25,25,0.0001,1604,3
0.494,0.0001,851,853,25,25,0.0001,1704,3
0.494,0.0001,907,897,25,25,0.0001,1804,3
0.494,0.0001,960,944,25,25,0.0001,1904,3
0.494,0.0001,1004,1000,25,25,0.0001,2004,3
0.496,0.0001,55,49,25,25,0.0001,104,4
0.494,0.0001,108,96,25,25,0.0001,204,4
0.494,0.0001,149,155,25,25,0.0001,304,4
0.492,0.0001,203,201,25,25,0.0001,404,4
0.492,0.0001,253,251,25,25,0.0001,504,4
0.498,0.0001,308,296,25,25,0.0001,604,4
0.498,0.0001,350,354,25,25,0.0001,704,4
0.5,0.0001,396,408,25,25,0.0001,804,4
0.5,0.0001,439,465,25,25,0.0001,904,4
0.506,0.0001,479,525,25,25,0.0001,1004,4
0.506,0.0001,534,570,25,25,0.0001,1104,4
0.502,0.0001,585,619,25,25,0.0001,1204,4
0.506,0.0001,642,662,25,25,0.0001,1304,4
0.508,0.0001,695,709,25,25,0.0001,1404,4
0.512,0.0001,754,750,25,25,0.0001,1504,4
0.514,0.0001,808,796,25,25,0.0001,1604,4
0.51,0.0001,854,850,25,25,0.0001,1704,4
0.508,0.0001,894,910,25,25,0.0001,1804,4
0.512,0.0001,943,961,25,25,0.0001,1904,4
0.516,0.0001,995,1009,25,25,0.0001,2004,4
0.52,0.0001,53,51,25,25,0.0001,104,5
0.522,0.0001,106,98,25,25,0.0001,204,5
0.522,0.0001,162,142,25,25,0.0001,304,5
0.522,0.0001,206,198,25,25,0.0001,404,5
0.522,0.0001,260,244,25,25,0.0001,504,5
0.522,0.0001,311,293,25,25,0.0001,604,5
0.524,0.0001,354,350,25,25,0.0001,704,5
0.526,0.0001,398,406,25,25,0.0001,804,5
0.528,0.0001,448,456,25,25,0.0001,904,5
0.528,0.0001,498,506,25,25,0.0001,1004,5
0.528,0.0001,553,551,25,25,0.0001,1104,5
0.528,0.0001,603,601,25,25,0.0001,1204,5
0.528,0.0001,659,645,25,25,0.0001,1304,5
0.528,0.0001,713,691,25,25,0.0001,1404,5
0.532,0.0001,756,748,25,25,0.0001,1504,5
0.536,0.0001,797,807,25,25,0.0001,1604,5
0.534,0.0001,849,855,25,25,0.0001,1704,5
0.536,0.0001,894,910,25,25,0.0001,1804,5
0.534,0.0001,947,957,25,25,0.0001,1904,5
0.536,0.0001,998,1006,25,25,0.0001,2004,5
0.52,0.0001,57,47,25,25,0.0001,104,6
0.52,0.0001,91,113,25,25,0.0001,204,6
0.52,0.0001,134,170,25,25,0.0001,304,6
0.52,0.0001,185,219,25,25,0.0001,404,6
0.52,0.0001,237,267,25,25,0.0001,504,6
0.524,0.0001,290,314,25,25,0.0001,604,6
0.524,0.0001,340,364,25,25,0.0001,704,6
0.524,0.0001,385,419,25,25,0.0001,804,6
0.528,0.0001,439,465,25,25,0.0001,904,6
0.528,0.0001,500,504,25,25,0.0001,1004,6
0.526,0.0001,551,553,25,25,0.0001,1104,6
0.528,0.0001,596,608,25,25,0.0001,1204,6
0.526,0.0001,648,656,25,25,0.0001,1304,6
0.526,0.0001,693,711,25,25,0.0001,1404,6
0.528,0.0001,739,765,25,25,0.0001,1504,6
0.53,0.0001,783,821,25,25,0.0001,1604,6
0.534,0.0001,838,866,25,25,0.0001,1704,6
0.54,0.0001,895,909,25,25,0.0001,1804,6
0.54,0.0001,944,960,25,25,0.0001,1904,6
0.54,0.0001,988,1016,25,25,0.0001,2004,6
0.51,0.0001,48,56,25,25,0.0001,104,7
0.508,0.0001,96,108,25,25,0.0001,204,7
0.508,0.0001,145,159,25,25,0.0001,304,7
0.506,0.0001,202,202,25,25,0.0001,404,7
0.506,0.0001,256,248,25,25,0.0001,504,7
0.506,0.0001,313,291,25,25,0.0001,604,7
0.506,0.0001,363,341,25,25,0.0001,704,7
0.506,0.0001,409,395,25,25,0.0001,804,7
0.51,0.0001,463,441,25,25,0.0001,904,7
0.512,0.0001,515,489,25,25,0.0001,1004,7
0.512,0.0001,568,536,25,25,0.0001,1104,7
0.514,0.0001,617,587,25,25,0.0001,1204,7
0.514,0.0001,666,638,25,25,0.0001,1304,7
0.512,0.0001,715,689,25,25,0.0001,1404,7
0.512,0.0001,760,744,25,25,0.0001,1504,7
0.514,0.0001,814,790,25,25,0.0001,1604,7
0.514,0.0001,857,847,25,25,0.0001,1704,7
0.512,0.0001,911,893,25,25,0.0001,1804,7
0.518,0.0001,953,951,25,25,0.0001,1904,7
0.52,0.0001,1004,1000,25,25,0.0001,2004,7
0.458,0.0001,57,47,25,25,0.0001,104,8
0.458,0.0001,104,100,25,25,0.0001,204,8
0.46,0.0001,154,150,25,25,0.0001,304,8
0.46,0.0001,207,197,25,25,0.0001,404,8
0.464,0.0001,250,254,25,25,0.0001,504,8
0.464,0.0001,294,310,25,25,0.0001,604,8
0.464,0.0001,344,360,25,25,0.0001,704,8
0.466,0.0001,387,417,25,25,0.0001,804,8
0.466,0.0001,438,466,25,25,0.0001,904,8
0.466,0.0001,493,511,25,25,0.0001,1004,8
0.468,0.0001,544,560,25,25,0.0001,1104,8
0.464,0.0001,598,606,25,25,0.0001,1204,8
0.468,0.0001,650,654,25,25,0.0001,1304,8
0.476,0.0001,700,704,25,25,0.0001,1404,8
0.478,0.0001,755,749,25,25,0.0001,1504,8
0.476,0.0001,798,806,25,25,0.0001,1604,8
0.476,0.0001,848,856,25,25,0.0001,1704,8
0.478,0.0001,897,907,25,25,0.0001,1804,8
0.482,0.0001,957,947,25,25,0.0001,1904,8
0.486,0.0001,1005,999,25,25,0.0001,2004,8
0.476,0.0001,51,53,25,25,0.0001,104,9
0.478,0.0001,99,105,25,25,0.0001,204,9
0.478,0.0001,146,158,25,25,0.0001,304,9
0.476,0.0001,192,212,25,25,0.0001,404,9
0.476,0.0001,250,254,25,25,0.0001,504,9
0.478,0.0001,302,302,25,25,0.0001,604,9
0.48,0.0001,353,351,25,25,0.0001,704,9
0.48,0.0001,417,387,25,25,0.0001,804,9
0.484,0.0001,467,437,25,25,0.0001,904,9
0.484,0.0001,518,486,25,25,0.0001,1004,9
0.486,0.0001,568,536,25,25,0.0001,1104,9
0.486,0.0001,614,590,25,25,0.0001,1204,9
0.486,0.0001,660,644,25,25,0.0001,1304,9
0.486,0.0001,706,698,25,25,0.0001,1404,9
0.486,0.0001,765,739,25,25,0.0001,1504,9
0.486,0.0001,811,793,25,25,0.0001,1604,9
0.486,0.0001,865,839,25,25,0.0001,1704,9
0.488,0.0001,919,885,25,25,0.0001,1804,9
0.488,0.0001,968,936,25,25,0.0001,1904,9
0.488,0.0001,1007,997,25,25,0.0001,2004,9
0.476,0.0001,51,53,25,25,0.0001,104,10
0.478,0.0001,101,103,25,25,0.0001,204,10
0.476,0.0001,148,156,25,25,0.0001,304,10
0.476,0.0001,198,206,25,25,0.0001,404,10
0.476,0.0001,249,255,25,25,0.0001,504,10
0.476,0.0001,299,305,25,25,0.0001,604,10
0.474,0.0001,344,360,25,25,0.0001,704,10
0.472,0.0001,398,406,25,25,0.0001,804,10
0.472,0.0001,443,461,25,25,0.0001,904,10
0.472,0.0001,495,509,25,25,0.0001,1004,10
0.474,0.0001,539,565,25,25,0.0001,1104,10
0.48,0.0001,587,617,25,25,0.0001,1204,10
0.482,0.0001,646,658,25,25,0.0001,1304,10
0.482,0.0001,699,705,25,25,0.0001,1404,10
0.482,0.0001,751,753,25,25,0.0001,1504,10
0.486,0.0001,792,812,25,25,0.0001,1604,10
0.488,0.0001,841,863,25,25,0.0001,1704,10
0.488,0.0001,896,908,25,25,0.0001,1804,10
0.49,0.0001,944,960,25,25,0.0001,1904,10
0.488,0.0001,997,1007,25,25,0.0001,2004,10
0.452,0.0001,55,49,25,25,0.0001,104,11
0.454,0.0001,98,106,25,25,0.0001,204,11
0.454,0.0001,148,156,25,25,0.0001,304,11
0.454,0.0001,197,207,25,25,0.0001,404,11
0.452,0.0001,252,252,25,25,0.0001,504,11
0.452,0.0001,307,297,25,25,0.0001,604,11
0.452,0.0001,354,350,25,25,0.0001,704,11
0.456,0.0001,402,402,25,25,0.0001,804,11
0.458,0.0001,443,461,25,25,0.0001,904,11
0.46,0.0001,494,510,25,25,0.0001,1004,11
0.46,0.0001,549,555,25,25,0.0001,1104,11
0.462,0.0001,594,610,25,25,0.0001,1204,11
0.464,0.0001,646,658,25,25,0.0001,1304,11
0.464,0.0001,692,712,25,25,0.0001,1404,11
0.464,0.0001,746,758,25,25,0.0001,1504,11
0.464,0.0001,806,798,25,25,0.0001,1604,11
0.464,0.0001,854,850,25,25,0.0001,1704,11
0.464,0.0001,914,890,25,25,0.0001,1804,11
0.462,0.0001,957,947,25,25,0.0001,1904,11
0.462,0.0001,1012,992,25,25,0.0001,2004,11
0.504,0.0001,48,56,25,25,0.0001,104,12
0.504,0.0001,97,107,25,25,0.0001,204,12
0.504,0.0001,148,156,25,25,0.0001,304,12
0.504,0.0001,193,211,25,25,0.0001,404,12
0.504,0.0001,249,255,25,25,0.0001,504,12
0.504,0.0001,302,302,25,25,0.0001,604,12
0.506,0.0001,351,353,25,25,0.0001,704,12
0.506,0.0001,394,410,25,25,0.0001,804,12
0.506,0.0001,448,456,25,25,0.0001,904,12
0.506,0.0001,496,508,25,25,0.0001,1004,12
0.506,0.0001,550,554,25,25,0.0001,1104,12
0.506,0.0001,608,596,25,25,0.0001,1204,12
0.508,0.0001,652,652,25,25,0.0001,1304,12
0.506,0.0001,697,707,25,25,0.0001,1404,12
0.506,0.0001,748,756,25,25,0.0001,1504,12
0.508,0.0001,803,801,25,25,0.0001,1604,12
0.512,0.0001,843,861,25,25,0.0001,1704,12
0.514,0.0001,899,905,25,25,0.0001,1804,12
0.514,0.0001,957,947,25,25,0.0001,1904,12
0.512,0.0001,1003,1001,25,25,0.0001,2004,12
0.52,0.0001,56,48,25,25,0.0001,104,13
0.52,0.0001,114,90,25,25,0.0001,204,13
0.52,0.0001,167,137,25,25,0.0001,304,13
0.52,0.0001,220,184,25,25,0.0001,404,13
0.522,0.0001,270,234,25,25,0.0001,504,13
0.526,0.0001,322,282,25,25,0.0001,604,13
0.526,0.0001,381,323,25,25,0.0001,704,13
0.528,0.0001,434,370,25,25,0.0001,804,13
0.524,0.0001,481,423,25,25,0.0001,904,13
0.524,0.0001,523,481,25,25,0.0001,1004,13
0.528,0.0001,574,530,25,25,0.0001,1104,13
0.528,0.0001,625,579,25,25,0.0001,1204,13
0.53,0.0001,675,629,25,25,0.0001,1304,13
0.528,0.0001,723,681,25,25,0.0001,1404,13
0.534,0.0001,765,739,25,25,0.0001,1504,13
0.538,0.0001,806,798,25,25,0.0001,1604,13
0.54,0.0001,857,847,25,25,0.0001,1704,13
0.54,0.0001,902,902,25,25,0.0001,1804,13
0.544,0.0001,955,949,25,25,0.0001,1904,13
0.544,0.0001,1000,1004,25,25,0.0001,2004,13
0.486,0.0001,52,52,25,25,0.0001,104,14
0.486,0.0001,103,101,25,25,0.0001,204,14
0.486,0.0001,158,146,25,25,0.0001,304,14
0.486,0.0001,203,201,25,25,0.0001,404,14
0.486,0.0001,253,251,25,25,0.0001,504,14
0.484,0.0001,309,295,25,25,0.0001,604,14
0.486,0.0001,359,345,25,25,0.0001,704,14
0.488,0.0001,410,394,25,25,0.0001,804,14
0.488,0.0001,462,442,25,25,0.0001,904,14
0.488,0.0001,509,495,25,25,0.0001,1004,14
0.488,0.0001,566,538,25,25,0.0001,1104,14
0.49,0.0001,609,595,25,25,0.0001,1204,14
0.49,0.0001,660,644,25,25,0.0001,1304,14
0.49,0.0001,706,698,25,25,0.0001,1404,14
0.494,0.0001,747,757,25,25,0.0001,1504,14
0.494,0.0001,802,802,25,25,0.0001,1604,14
0.492,0.0001,847,857,25,25,0.0001,1704,14
0.492,0.0001,898,906,25,25,0.0001,1804,14
0.492,0.0001,949,955,25,25,0.0001,1904,14
0.494,0.0001,1003,1001,25,25,0.0001,2004,14
0.528,0.0001,53,51,25,25,0.0001,104,15
0.528,0.0001,95,109,25,25,0.0001,204,15
0.526,0.0001,151,153,25,25,0.0001,304,15
0.528,0.0001,206,198,25,25,0.0001,404,15
0.528,0.0001,252,252,25,25,0.0001,504,15
0.53,0.0001,310,294,25,25,0.0001,604,15
0.534,0.0001,360,344,25,25,0.0001,704,15
0.536,0.0001,412,392,25,25,0.0001,804,15
0.536,0.0001,467,437,25,25,0.0001,904,15
0.538,0.0001,520,484,25,25,0.0001,1004,15
0.542,0.0001,572,532,25,25,0.0001,1104,15
0.542,0.0001,614,590,25,25,0.0001,1204,15
0.542,0.0001,666,638,25,25,0.0001,1304,15
0.536,0.0001,721,683,25,25,0.0001,1404,15
0.536,0.0001,773,731,25,25,0.0001,1504,15
0.538,0.0001,814,790,25,25,0.0001,1604,15
0.536,0.0001,869,835,25,25,0.0001,1704,15
0.538,0.0001,919,885,25,25,0.0001,1804,15
0.54,0.0001,973,931,25,25,0.0001,1904,15
0.542,0.0001,1016,988,25,25,0.0001,2004,15
0.502,0.0001,57,47,25,25,0.0001,104,16
0.502,0.0001,104,100,25,25,0.0001,204,16
0.502,0.0001,153,151,25,25,0.0001,304,16
0.502,0.0001,201,203,25,25,0.0001,404,16
0.502,0.0001,257,247,25,25,0.0001,504,16
0.502,0.0001,307,297,25,25,0.0001,604,16
0.502,0.0001,353,351,25,25,0.0001,704,16
0.502,0.0001,408,396,25,25,0.0001,804,16
0.502,0.0001,457,447,25,25,0.0001,904,16
0.502,0.0001,504,500,25,25,0.0001,1004,16
0.502,0.0001,545,559,25,25,0.0001,1104,16
0.502,0.0001,596,608,25,25,0.0001,1204,16
0.502,0.0001,651,653,25,25,0.0001,1304,16
0.5,0.0001,704,700,25,25,0.0001,1404,16
0.502,0.0001,744,760,25,25,0.0001,1504,16
0.502,0.0001,800,804,25,25,0.0001,1604,16
0.502,0.0001,859,845,25,25,0.0001,1704,16
0.504,0.0001,905,899,25,25,0.0001,1804,16
0.504,0.0001,960,944,25,25,0.0001,1904,16
0.504,0.0001,1003,1001,25,25,0.0001,2004,16
0.526,0.0001,62,42,25,25,0.0001,104,17
0.528,0.0001,115,89,25,25,0.0001,204,17
0.526,0.0001,178,126,25,25,0.0001,304,17
0.526,0.0001,221,183,25,25,0.0001,404,17
0.524,0.0001,267,237,25,25,0.0001,504,17
0.524,0.0001,320,284,25,25,0.0001,604,17
0.524,0.0001,373,331,25,25,0.0001,704,17
0.526,0.0001,426,378,25,25,0.0001,804,17
0.524,0.0001,466,438,25,25,0.0001,904,17
0.528,0.0001,516,488,25,25,0.0001,1004,17
0.53,0.0001,560,544,25,25,0.0001,1104,17
0.532,0.0001,604,600,25,25,0.0001,1204,17
0.536,0.0001,653,651,25,25,0.0001,1304,17
0.534,0.0001,707,697,25,25,0.0001,1404,17
0.534,0.0001,766,738,25,25,0.0001,1504,17
0.534,0.0001,819,785,25,25,0.0001,1604,17
0.53,0.0001,872,832,25,25,0.0001,1704,17
0.53,0.0001,921,883,25,25,0.0001,1804,17
0.53,0.0001,975,929,25,25,0.0001,1904,17
0.534,0.0001,1021,983,25,25,0.0001,2004,17
0.48,0.0001,56,48,25,25,0.0001,104,18
0.482,0.0001,109,95,25,25,0.0001,204,18
0.482,0.0001,156,148,25,25,0.0001,304,18
0.484,0.0001,206,198,25,25,0.0001,404,18
0.482,0.0001,255,249,25,25,0.0001,504,18
0.484,0.0001,308,296,25,25,0.0001,604,18
0.484,0.0001,359,345,25,25,0.0001,704,18
0.482,0.0001,410,394,25,25,0.0001,804,18
0.482,0.0001,457,447,25,25,0.0001,904,18
0.484,0.0001,510,494,25,25,0.0001,1004,18
0.488,0.0001,563,541,25,25,0.0001,1104,18
0.486,0.0001,615,589,25,25,0.0001,1204,18
0.486,0.0001,663,641,25,25,0.0001,1304,18
0.482,0.0001,700,704,25,25,0.0001,1404,18
0.478,0.0001,757,747,25,25,0.0001,1504,18
0.476,0.0001,804,800,25,25,0.0001,1604,18
0.476,0.0001,851,853,25,25,0.0001,1704,18
0.47,0.0001,894,910,25,25,0.0001,1804,18
0.47,0.0001,946,958,25,25,0.0001,1904,18
0.472,0.0001,998,1006,25,25,0.0001,2004,18
0.54,0.0001,55,49,25,25,0.0001,104,19
0.54,0.0001,107,97,25,25,0.0001,204,19
0.538,0.0001,161,143,25,25,0.0001,304,19
0.54,0.0001,212,192,25,25,0.0001,404,19
0.54,0.0001,268,236,25,25,0.0001,504,19
0.544,0.0001,322,282,25,25,0.0001,604,19
0.544,0.0001,375,329,25,25,0.0001,704,19
0.544,0.0001,422,382,25,25,0.0001,804,19
0.546,0.0001,469,435,25,25,0.0001,904,19
0.544,0.0001,521,483,25,25,0.0001,1004,19
0.542,0.0001,574,530,25,25,0.0001,1104,19
0.542,0.0001,622,582,25,25,0.0001,1204,19
0.542,0.0001,671,633,25,25,0.0001,1304,19
0.54,0.0001,724,680,25,25,0.0001,1404,19
0.54,0.0001,773,731,25,25,0.0001,1504,19
0.54,0.0001,824,780,25,25,0.0001,1604,19
0.54,0.0001,867,837,25,25,0.0001,1704,19
0.542,0.0001,915,889,25,25,0.0001,1804,19
0.542,0.0001,965,939,25,25,0.0001,1904,19
0.544,0.0001,1014,990,25,25,0.0001,2004,19
0.51,0.0001,56,48,25,25,0.0001,104,20
0.51,0.0001,103,101,25,25,0.0001,204,20
0.51,0.0001,152,152,25,25,0.0001,304,20
0.51,0.0001,204,200,25,25,0.0001,404,20
0.51,0.0001,253,251,25,25,0.0001,504,20
0.51,0.0001,302,302,25,25,0.0001,604,20
0.51,0.0001,365,339,25,25,0.0001,704,20
0.51,0.0001,405,399,25,25,0.0001,804,20
0.51,0.0001,453,451,25,25,0.0001,904,20
0.512,0.0001,498,506,25,25,0.0001,1004,20
0.512,0.0001,544,560,25,25,0.0001,1104,20
0.51,0.0001,592,612,25,25,0.0001,1204,20
0.51,0.0001,643,661,25,25,0.0001,1304,20
0.512,0.0001,695,709,25,25,0.0001,1404,20
0.514,0.0001,742,762,25,25,0.0001,1504,20
0.516,0.0001,794,810,25,25,0.0001,1604,20
0.516,0.0001,845,859,25,25,0.0001,1704,20
0.524,0.0001,895,909,25,25,0.0001,1804,20
0.526,0.0001,946,958,25,25,0.0001,1904,20
0.526,0.0001,996,1008,25,25,0.0001,2004,20
0.532,0.0001,53,51,25,25,0.001,104,1
0.532,0.0001,101,103,25,25,0.001,204,1
0.534,0.0001,149,155,25,25,0.001,304,1
0.53,0.0001,201,203,25,25,0.001,404,1
0.522,0.0001,243,261,25,25,0.001,504,1
0.526,0.0001,292,312,25,25,0.001,604,1
0.53,0.0001,336,368,25,25,0.001,704,1
0.536,0.0001,387,417,25,25,0.001,804,1
0.544,0.0001,432,472,25,25,0.001,904,1
0.552,0.0001,485,519,25,25,0.001,1004,1
0.572,0.0001,545,559,25,25,0.001,1104,1
0.596,0.0001,595,609,25,25,0.001,1204,1
0.616,0.0001,644,660,25,25,0.001,1304,1
0.62,0.0001,690,714,25,25,0.001,1404,1
0.634,0.0001,745,759,25,25,0.001,1504,1
0.636,0.0001,801,803,25,25,0.001,1604,1
0.662,0.0001,850,854,25,25,0.001,1704,1
0.668,0.0001,897,907,25,25,0.001,1804,1
0.684,0.0001,956,948,25,25,0.001,1904,1
0.698,0.0001,1007,997,25,25,0.001,2004,1
0.498,0.0001,56,48,25,25,0.001,104,2
0.498,0.0001,107,97,25,25,0.001,204,2
0.498,0.0001,155,149,25,25,0.001,304,2
0.502,0.0001,201,203,25,25,0.001,404,2
0.494,0.0001,251,253,25,25,0.001,504,2
0.49,0.0001,303,301,25,25,0.001,604,2
0.49,0.0001,348,356,25,25,0.001,704,2
0.492,0.0001,404,400,25,25,0.001,804,2
0.5,0.0001,450,454,25,25,0.001,904,2
0.498,0.0001,516,488,25,25,0.001,1004,2
0.514,0.0001,567,537,25,25,0.001,1104,2
0.524,0.0001,625,579,25,25,0.001,1204,2
0.532,0.0001,673,631,25,25,0.001,1304,2
0.556,0.0001,729,675,25,25,0.001,1404,2
0.568,0.0001,778,726,25,25,0.001,1504,2
0.592,0.0001,823,781,25,25,0.001,1604,2
0.6,0.0001,867,837,25,25,0.001,1704,2
0.614,0.0001,915,889,25,25,0.001,1804,2
0.62,0.0001,959,945,25,25,0.001,1904,2
0.644,0.0001,1004,1000,25,25,0.001,2004,2
0.58,0.0001,53,51,25,25,0.001,104,3
0.58,0.0001,99,105,25,25,0.001,204,3
0.578,0.0001,151,153,25,25,0.001,304,3
0.578,0.0001,199,205,25,25,0.001,404,3
0.576,0.0001,248,256,25,25,0.001,504,3
0.588,0.0001,296,308,25,25,0.001,604,3
0.592,0.0001,349,355,25,25,0.001,704,3
0.596,0.0001,396,408,25,25,0.001,804,3
0.594,0.0001,446,458,25,25,0.001,904,3
0.614,0.0001,496,508,25,25,0.001,1004,3
0.618,0.0001,543,561,25,25,0.001,1104,3
0.624,0.0001,591,613,25,25,0.001,1204,3
0.63,0.0001,646,658,25,25,0.001,1304,3
0.654,0.0001,694,710,25,25,0.001,1404,3
0.678,0.0001,752,752,25,25,0.001,1504,3
0.686,0.0001,792,812,25,25,0.001,1604,3
0.7,0.0001,843,861,25,25,0.001,1704,3
0.706,0.0001,895,909,25,25,0.001,1804,3
0.71,0.0001,944,960,25,25,0.001,1904,3
0.72,0.0001,994,1010,25,25,0.001,2004,3
0.502,0.0001,53,51,25,25,0.001,104,4
0.5,0.0001,105,99,25,25,0.001,204,4
0.496,0.0001,158,146,25,25,0.001,304,4
0.498,0.0001,216,188,25,25,0.001,404,4
0.494,0.0001,263,241,25,25,0.001,504,4
0.494,0.0001,319,285,25,25,0.001,604,4
0.5,0.0001,370,334,25,25,0.001,704,4
0.504,0.0001,418,386,25,25,0.001,804,4
0.508,0.0001,462,442,25,25,0.001,904,4
0.514,0.0001,507,497,25,25,0.001,1004,4
0.526,0.0001,557,547,25,25,0.001,1104,4
0.526,0.0001,604,600,25,25,0.001,1204,4
0.53,0.0001,651,653,25,25,0.001,1304,4
0.53,0.0001,694,710,25,25,0.001,1404,4
0.532,0.0001,746,758,25,25,0.001,1504,4
0.542,0.0001,792,812,25,25,0.001,1604,4
0.56,0.0001,844,860,25,25,0.001,1704,4
0.574,0.0001,889,915,25,25,0.001,1804,4
0.588,0.0001,944,960,25,25,0.001,1904,4
0.604,0.0001,1008,996,25,25,0.001,2004,4
0.478,0.0001,48,56,25,25,0.001,104,5
0.472,0.0001,96,108,25,25,0.001,204,5
0.474,0.0001,150,154,25,25,0.001,304,5
0.478,0.0001,204,200,25,25,0.001,404,5
0.478,0.0001,262,242,25,25,0.001,504,5
0.474,0.0001,309,295,25,25,0.001,604,5
0.476,0.0001,361,343,25,25,0.001,704,5
0.482,0.0001,417,387,25,25,0.001,804,5
0.496,0.0001,462,442,25,25,0.001,904,5
0.508,0.0001,508,496,25,25,0.001,1004,5
0.522,0.0001,556,548,25,25,0.001,1104,5
0.53,0.0001,605,599,25,25,0.001,1204,5
0.542,0.0001,661,643,25,25,0.001,1304,5
0.554,0.0001,719,685,25,25,0.001,1404,5
0.568,0.0001,764,740,25,25,0.001,1504,5
0.58,0.0001,817,787,25,25,0.001,1604,5
0.598,0.0001,861,843,25,25,0.001,1704,5
0.612,0.0001,907,897,25,25,0.001,1804,5
0.634,0.0001,961,943,25,25,0.001,1904,5
0.662,0.0001,1010,994,25,25,0.001,2004,5
0.546,0.0001,45,59,25,25,0.001,104,6
0.556,0.0001,90,114,25,25,0.001,204,6
0.566,0.0001,141,163,25,25,0.001,304,6
0.566,0.0001,192,212,25,25,0.001,404,6
0.576,0.0001,244,260,25,25,0.001,504,6
0.582,0.0001,295,309,25,25,0.001,604,6
0.588,0.0001,346,358,25,25,0.001,704,6
0.6,0.0001,391,413,25,25,0.001,804,6
0.612,0.0001,444,460,25,25,0.001,904,6
0.622,0.0001,484,520,25,25,0.001,1004,6
0.624,0.0001,532,572,25,25,0.001,1104,6
0.624,0.0001,573,631,25,25,0.001,1204,6
0.632,0.0001,633,671,25,25,0.001,1304,6
0.632,0.0001,687,717,25,25,0.001,1404,6
0.65,0.0001,740,764,25,25,0.001,1504,6
0.654,0.0001,789,815,25,25,0.001,1604,6
0.656,0.0001,837,867,25,25,0.001,1704,6
0.666,0.0001,884,920,25,25,0.001,1804,6
0.688,0.0001,940,964,25,25,0.001,1904,6
0.708,0.0001,1002,1002,25,25,0.001,2004,6
0.484,0.0001,57,47,25,25,0.001,104,7
0.484,0.0001,115,89,25,25,0.001,204,7
0.484,0.0001,166,138,25,25,0.001,304,7
0.486,0.0001,216,188,25,25,0.001,404,7
0.486,0.0001,262,242,25,25,0.001,504,7
0.486,0.0001,306,298,25,25,0.001,604,7
0.488,0.0001,351,353,25,25,0.001,704,7
0.492,0.0001,396,408,25,25,0.001,804,7
0.492,0.0001,452,452,25,25,0.001,904,7
0.5,0.0001,495,509,25,25,0.001,1004,7
0.504,0.0001,540,564,25,25,0.001,1104,7
0.508,0.0001,588,616,25,25,0.001,1204,7
0.516,0.0001,635,669,25,25,0.001,1304,7
0.524,0.0001,689,715,25,25,0.001,1404,7
0.536,0.0001,740,764,25,25,0.001,1504,7
0.556,0.0001,784,820,25,25,0.001,1604,7
0.566,0.0001,834,870,25,25,0.001,1704,7
0.582,0.0001,886,918,25,25,0.001,1804,7
0.606,0.0001,938,966,25,25,0.001,1904,7
0.622,0.0001,993,1011,25,25,0.001,2004,7
0.472,0.0001,44,60,25,25,0.001,104,8
0.48,0.0001,105,99,25,25,0.001,204,8
0.49,0.0001,142,162,25,25,0.001,304,8
0.498,0.0001,196,208,25,25,0.001,404,8
0.502,0.0001,247,257,25,25,0.001,504,8
0.504,0.0001,297,307,25,25,0.001,604,8
0.512,0.0001,346,358,25,25,0.001,704,8
0.522,0.0001,399,405,25,25,0.001,804,8
0.524,0.0001,450,454,25,25,0.001,904,8
0.528,0.0001,496,508,25,25,0.001,1004,8
0.534,0.0001,537,567,25,25,0.001,1104,8
0.548,0.0001,592,612,25,25,0.001,1204,8
0.558,0.0001,648,656,25,25,0.001,1304,8
0.586,0.0001,696,708,25,25,0.001,1404,8
0.606,0.0001,752,752,25,25,0.001,1504,8
0.618,0.0001,796,808,25,25,0.001,1604,8
0.624,0.0001,844,860,25,25,0.001,1704,8
0.652,0.0001,893,911,25,25,0.001,1804,8
0.678,0.0001,954,950,25,25,0.001,1904,8
0.706,0.0001,1004,1000,25,25,0.001,2004,8
0.486,0.0001,54,50,25,25,0.001,104,9
0.484,0.0001,98,106,25,25,0.001,204,9
0.484,0.0001,145,159,25,25,0.001,304,9
0.484,0.0001,185,219,25,25,0.001,404,9
0.484,0.0001,233,271,25,25,0.001,504,9
0.484,0.0001,279,325,25,25,0.001,604,9
0.482,0.0001,338,366,25,25,0.001,704,9
0.488,0.0001,394,410,25,25,0.001,804,9
0.492,0.0001,442,462,25,25,0.001,904,9
0.496,0.0001,502,502,25,25,0.001,1004,9
0.504,0.0001,545,559,25,25,0.001,1104,9
0.514,0.0001,600,604,25,25,0.001,1204,9
0.516,0.0001,644,660,25,25,0.001,1304,9
0.532,0.0001,694,710,25,25,0.001,1404,9
0.53,0.0001,748,756,25,25,0.001,1504,9
0.556,0.0001,794,810,25,25,0.001,1604,9
0.584,0.0001,838,866,25,25,0.001,1704,9
0.612,0.0001,894,910,25,25,0.001,1804,9
0.638,0.0001,950,954,25,25,0.001,1904,9
0.664,0.0001,995,1009,25,25,0.001,2004,9
0.53,0.0001,54,50,25,25,0.001,104,10
0.534,0.0001,106,98,25,25,0.001,204,10
0.532,0.0001,152,152,25,25,0.001,304,10
0.538,0.0001,203,201,25,25,0.001,404,10
0.532,0.0001,251,253,25,25,0.001,504,10
0.534,0.0001,305,299,25,25,0.001,604,10
0.534,0.0001,360,344,25,25,0.001,704,10
0.536,0.0001,414,390,25,25,0.001,804,10
0.544,0.0001,463,441,25,25,0.001,904,10
0.546,0.0001,508,496,25,25,0.001,1004,10
0.554,0.0001,558,546,25,25,0.001,1104,10
0.562,0.0001,612,592,25,25,0.001,1204,10
0.572,0.0001,658,646,25,25,0.001,1304,10
0.584,0.0001,702,702,25,25,0.001,1404,10
0.588,0.0001,751,753,25,25,0.001,1504,10
0.604,0.0001,804,800,25,25,0.001,1604,10
0.624,0.0001,860,844,25,25,0.001,1704,10
0.662,0.0001,918,886,25,25,0.001,1804,10
0.676,0.0001,967,937,25,25,0.001,1904,10
0.692,0.0001,1009,995,25,25,0.001,2004,10
0.51,0.0001,55,49,25,25,0.001,104,11
0.51,0.0001,106,98,25,25,0.001,204,11
0.51,0.0001,158,146,25,25,0.001,304,11
0.51,0.0001,206,198,25,25,0.001,404,11
0.516,0.0001,255,249,25,25,0.001,504,11
0.516,0.0001,306,298,25,25,0.001,604,11
0.526,0.0001,369,335,25,25,0.001,704,11
0.526,0.0001,413,391,25,25,0.001,804,11
0.536,0.0001,460,444,25,25,0.001,904,11
0.544,0.0001,511,493,25,25,0.001,1004,11
0.542,0.0001,559,545,25,25,0.001,1104,11
0.552,0.0001,609,595,25,25,0.001,1204,11
0.556,0.0001,646,658,25,25,0.001,1304,11
0.562,0.0001,704,700,25,25,0.001,1404,11
0.576,0.0001,753,751,25,25,0.001,1504,11
0.598,0.0001,811,793,25,25,0.001,1604,11
0.616,0.0001,858,846,25,25,0.001,1704,11
0.628,0.0001,912,892,25,25,0.001,1804,11
0.636,0.0001,966,938,25,25,0.001,1904,11
0.648,0.0001,1011,993,25,25,0.001,2004,11
0.546,0.0001,44,60,25,25,0.001,104,12
0.548,0.0001,91,113,25,25,0.001,204,12
0.548,0.0001,142,162,25,25,0.001,304,12
0.548,0.0001,194,210,25,25,0.001,404,12
0.552,0.0001,247,257,25,25,0.001,504,12
0.558,0.0001,293,311,25,25,0.001,604,12
0.56,0.0001,340,364,25,25,0.001,704,12
0.558,0.0001,391,413,25,25,0.001,804,12
0.556,0.0001,444,460,25,25,0.001,904,12
0.562,0.0001,498,506,25,25,0.001,1004,12
0.56,0.0001,543,561,25,25,0.001,1104,12
0.568,0.0001,601,603,25,25,0.001,1204,12
0.578,0.0001,651,653,25,25,0.001,1304,12
0.59,0.0001,705,699,25,25,0.001,1404,12
0.59,0.0001,761,743,25,25,0.001,1504,12
0.602,0.0001,810,794,25,25,0.001,1604,12
0.618,0.0001,865,839,25,25,0.001,1704,12
0.626,0.0001,912,892,25,25,0.001,1804,12
0.642,0.0001,958,946,25,25,0.001,1904,12
0.66,0.0001,1010,994,25,25,0.001,2004,12
0.552,0.0001,49,55,25,25,0.001,104,13
0.554,0.0001,99,105,25,25,0.001,204,13
0.558,0.0001,157,147,25,25,0.001,304,13
0.566,0.0001,209,195,25,25,0.001,404,13
0.562,0.0001,256,248,25,25,0.001,504,13
0.564,0.0001,303,301,25,25,0.001,604,13
0.568,0.0001,357,347,25,25,0.001,704,13
0.564,0.0001,400,404,25,25,0.001,804,13
0.572,0.0001,456,448,25,25,0.001,904,13
0.56,0.0001,507,497,25,25,0.001,1004,13
0.566,0.0001,556,548,25,25,0.001,1104,13
0.566,0.0001,603,601,25,25,0.001,1204,13
0.574,0.0001,645,659,25,25,0.001,1304,13
0.584,0.0001,699,705,25,25,0.001,1404,13
0.596,0.0001,747,757,25,25,0.001,1504,13
0.608,0.0001,795,809,25,25,0.001,1604,13
0.612,0.0001,846,858,25,25,0.001,1704,13
0.624,0.0001,904,900,25,25,0.001,1804,13
0.646,0.0001,956,948,25,25,0.001,1904,13
0.658,0.0001,1011,993,25,25,0.001,2004,13
0.466,0.0001,59,45,25,25,0.001,104,14
0.472,0.0001,111,93,25,25,0.001,204,14
0.476,0.0001,160,144,25,25,0.001,304,14
0.48,0.0001,206,198,25,25,0.001,404,14
0.486,0.0001,251,253,25,25,0.001,504,14
0.482,0.0001,298,306,25,25,0.001,604,14
0.496,0.0001,347,357,25,25,0.001,704,14
0.51,0.0001,396,408,25,25,0.001,804,14
0.512,0.0001,444,460,25,25,0.001,904,14
0.542,0.0001,505,499,25,25,0.001,1004,14
0.542,0.0001,547,557,25,25,0.001,1104,14
0.552,0.0001,593,611,25,25,0.001,1204,14
0.568,0.0001,646,658,25,25,0.001,1304,14
0.578,0.0001,687,717,25,25,0.001,1404,14
0.588,0.0001,738,766,25,25,0.001,1504,14
0.604,0.0001,778,826,25,25,0.001,1604,14
0.618,0.0001,826,878,25,25,0.001,1704,14
0.638,0.0001,881,923,25,25,0.001,1804,14
0.664,0.0001,928,976,25,25,0.001,1904,14
0.702,0.0001,978,1026,25,25,0.001,2004,14
0.464,0.0001,46,58,25,25,0.001,104,15
0.48,0.0001,95,109,25,25,0.001,204,15
0.494,0.0001,152,152,25,25,0.001,304,15
0.496,0.0001,200,204,25,25,0.001,404,15
0.502,0.0001,249,255,25,25,0.001,504,15
0.504,0.0001,303,301,25,25,0.001,604,15
0.512,0.0001,351,353,25,25,0.001,704,15
0.51,0.0001,404,400,25,25,0.001,804,15
0.51,0.0001,457,447,25,25,0.001,904,15
0.51,0.0001,508,496,25,25,0.001,1004,15
0.51,0.0001,551,553,25,25,0.001,1104,15
0.516,0.0001,594,610,25,25,0.001,1204,15
0.522,0.0001,644,660,25,25,0.001,1304,15
0.528,0.0001,700,704,25,25,0.001,1404,15
0.538,0.0001,742,762,25,25,0.001,1504,15
0.544,0.0001,789,815,25,25,0.001,1604,15
0.55,0.0001,835,869,25,25,0.001,1704,15
0.554,0.0001,884,920,25,25,0.001,1804,15
0.57,0.0001,938,966,25,25,0.001,1904,15
0.59,0.0001,989,1015,25,25,0.001,2004,15
0.52,0.0001,60,44,25,25,0.001,104,16
0.526,0.0001,103,101,25,25,0.001,204,16
0.534,0.0001,149,155,25,25,0.001,304,16
0.534,0.0001,196,208,25,25,0.001,404,16
0.536,0.0001,253,251,25,25,0.001,504,16
0.536,0.0001,297,307,25,25,0.001,604,16
0.544,0.0001,341,363,25,25,0.001,704,16
0.548,0.0001,395,409,25,25,0.001,804,16
0.558,0.0001,448,456,25,25,0.001,904,16
0.568,0.0001,499,505,25,25,0.001,1004,16
0.576,0.0001,553,551,25,25,0.001,1104,16
0.57,0.0001,601,603,25,25,0.001,1204,16
0.59,0.0001,647,657,25,25,0.001,1304,16
0.602,0.0001,698,706,25,25,0.001,1404,16
0.624,0.0001,745,759,25,25,0.001,1504,16
0.652,0.0001,793,811,25,25,0.001,1604,16
0.656,0.0001,841,863,25,25,0.001,1704,16
0.672,0.0001,889,915,25,25,0.001,1804,16
0.694,0.0001,943,961,25,25,0.001,1904,16
0.706,0.0001,998,1006,25,25,0.001,2004,16
0.51,0.0001,57,47,25,25,0.001,104,17
0.508,0.0001,107,97,25,25,0.001,204,17
0.506,0.0001,159,145,25,25,0.001,304,17
0.51,0.0001,209,195,25,25,0.001,404,17
0.506,0.0001,263,241,25,25,0.001,504,17
0.512,0.0001,321,283,25,25,0.001,604,17
0.52,0.0001,371,333,25,25,0.001,704,17
0.524,0.0001,417,387,25,25,0.001,804,17
0.526,0.0001,468,436,25,25,0.001,904,17
0.522,0.0001,517,487,25,25,0.001,1004,17
0.532,0.0001,566,538,25,25,0.001,1104,17
0.53,0.0001,615,589,25,25,0.001,1204,17
0.54,0.0001,660,644,25,25,0.001,1304,17
0.548,0.0001,711,693,25,25,0.001,1404,17
0.556,0.0001,755,749,25,25,0.001,1504,17
0.576,0.0001,807,797,25,25,0.001,1604,17
0.566,0.0001,858,846,25,25,0.001,1704,17
0.588,0.0001,915,889,25,25,0.001,1804,17
0.596,0.0001,967,937,25,25,0.001,1904,17
0.618,0.0001,1016,988,25,25,0.001,2004,17
0.502,0.0001,53,51,25,25,0.001,104,18
0.504,0.0001,91,113,25,25,0.001,204,18
0.506,0.0001,150,154,25,25,0.001,304,18
0.51,0.0001,202,202,25,25,0.001,404,18
0.508,0.0001,257,247,25,25,0.001,504,18
0.52,0.0001,304,300,25,25,0.001,604,18
0.524,0.0001,350,354,25,25,0.001,704,18
0.526,0.0001,400,404,25,25,0.001,804,18
0.536,0.0001,454,450,25,25,0.001,904,18
0.55,0.0001,505,499,25,25,0.001,1004,18
0.56,0.0001,555,549,25,25,0.001,1104,18
0.576,0.0001,602,602,25,25,0.001,1204,18
0.586,0.0001,654,650,25,25,0.001,1304,18
0.588,0.0001,705,699,25,25,0.001,1404,18
0.606,0.0001,750,754,25,25,0.001,1504,18
0.63,0.0001,801,803,25,25,0.001,1604,18
0.63,0.0001,854,850,25,25,0.001,1704,18
0.638,0.0001,906,898,25,25,0.001,1804,18
0.664,0.0001,962,942,25,25,0.001,1904,18
0.69,0.0001,1002,1002,25,25,0.001,2004,18
0.554,0.0001,47,57,25,25,0.001,104,19
0.554,0.0001,103,101,25,25,0.001,204,19
0.556,0.0001,153,151,25,25,0.001,304,19
0.562,0.0001,204,200,25,25,0.001,404,19
0.566,0.0001,254,250,25,25,0.001,504,19
0.564,0.0001,307,297,25,25,0.001,604,19
0.568,0.0001,363,341,25,25,0.001,704,19
0.576,0.0001,413,391,25,25,0.001,804,19
0.584,0.0001,462,442,25,25,0.001,904,19
0.58,0.0001,516,488,25,25,0.001,1004,19
0.596,0.0001,564,540,25,25,0.001,1104,19
0.588,0.0001,612,592,25,25,0.001,1204,19
0.588,0.0001,661,643,25,25,0.001,1304,19
0.598,0.0001,712,692,25,25,0.001,1404,19
0.604,0.0001,763,741,25,25,0.001,1504,19
0.61,0.0001,810,794,25,25,0.001,1604,19
0.624,0.0001,866,838,25,25,0.001,1704,19
0.632,0.0001,917,887,25,25,0.001,1804,19
0.652,0.0001,960,944,25,25,0.001,1904,19
0.664,0.0001,1006,998,25,25,0.001,2004,19
0.532,0.0001,56,48,25,25,0.001,104,20
0.534,0.0001,107,97,25,25,0.001,204,20
0.534,0.0001,164,140,25,25,0.001,304,20
0.53,0.0001,215,189,25,25,0.001,404,20
0.528,0.0001,263,241,25,25,0.001,504,20
0.542,0.0001,318,286,25,25,0.001,604,20
0.552,0.0001,362,342,25,25,0.001,704,20
0.556,0.0001,417,387,25,25,0.001,804,20
0.566,0.0001,476,428,25,25,0.001,904,20
0.576,0.0001,529,475,25,25,0.001,1004,20
0.588,0.0001,580,524,25,25,0.001,1104,20
0.596,0.0001,633,571,25,25,0.001,1204,20
0.6,0.0001,682,622,25,25,0.001,1304,20
0.608,0.0001,727,677,25,25,0.001,1404,20
0.614,0.0001,780,724,25,25,0.001,1504,20
0.63,0.0001,831,773,25,25,0.001,1604,20
0.654,0.0001,873,831,25,25,0.001,1704,20
0.672,0.0001,916,888,25,25,0.001,1804,20
0.682,0.0001,962,942,25,25,0.001,1904,20
0.708,0.0001,1007,997,25,25,0.001,2004,20
0.536,0.0001,44,60,25,25,0.01,104,1
0.574,0.0001,104,100,25,25,0.01,204,1
0.586,0.0001,157,147,25,25,0.01,304,1
0.612,0.0001,203,201,25,25,0.01,404,1
0.634,0.0001,255,249,25,25,0.01,504,1
0.654,0.0001,305,299,25,25,0.01,604,1
0.672,0.0001,349,355,25,25,0.01,704,1
0.71,0.0001,403,401,25,25,0.01,804,1
0.746,0.0001,445,459,25,25,0.01,904,1
0.8,0.0001,505,499,25,25,0.01,1004,1
0.836,0.0001,556,548,25,25,0.01,1104,1
0.876,0.0001,611,593,25,25,0.01,1204,1
0.898,0.0001,664,640,25,25,0.01,1304,1
0.94,0.0001,709,695,25,25,0.01,1404,1
0.954,0.0001,759,745,25,25,0.01,1504,1
0.966,0.0001,808,796,25,25,0.01,1604,1
0.966,0.0001,864,840,25,25,0.01,1704,1
0.97,0.0001,919,885,25,25,0.01,1804,1
0.972,0.0001,968,936,25,25,0.01,1904,1
0.972,0.0001,1016,988,25,25,0.01,2004,1
0.552,0.0001,56,48,25,25,0.01,104,2
0.578,0.0001,114,90,25,25,0.01,204,2
0.57,0.0001,163,141,25,25,0.01,304,2
0.57,0.0001,215,189,25,25,0.01,404,2
0.592,0.0001,269,235,25,25,0.01,504,2
0.616,0.0001,328,276,25,25,0.01,604,2
0.648,0.0001,387,317,25,25,0.01,704,2
0.686,0.0001,438,366,25,25,0.01,804,2
0.706,0.0001,492,412,25,25,0.01,904,2
0.764,0.0001,546,458,25,25,0.01,1004,2
0.81,0.0001,595,509,25,25,0.01,1104,2
0.866,0.0001,644,560,25,25,0.01,1204,2
0.902,0.0001,684,620,25,25,0.01,1304,2
0.932,0.0001,733,671,25,25,0.01,1404,2
0.932,0.0001,775,729,25,25,0.01,1504,2
0.944,0.0001,817,787,25,25,0.01,1604,2
0.948,0.0001,867,837,25,25,0.01,1704,2
0.954,0.0001,907,897,25,25,0.01,1804,2
0.96,0.0001,954,950,25,25,0.01,1904,2
0.962,0.0001,1002,1002,25,25,0.01,2004,2
0.534,0.0001,53,51,25,25,0.01,104,3
0.562,0.0001,105,99,25,25,0.01,204,3
0.572,0.0001,156,148,25,25,0.01,304,3
0.602,0.0001,200,204,25,25,0.01,404,3
0.604,0.0001,248,256,25,25,0.01,504,3
0.618,0.0001,298,306,25,25,0.01,604,3
0.658,0.0001,347,357,25,25,0.01,704,3
0.728,0.0001,393,411,25,25,0.01,804,3
0.768,0.0001,444,460,25,25,0.01,904,3
0.818,0.0001,491,513,25,25,0.01,1004,3
0.87,0.0001,538,566,25,25,0.01,1104,3
0.884,0.0001,591,613,25,25,0.01,1204,3
0.896,0.0001,638,666,25,25,0.01,1304,3
0.936,0.0001,691,713,25,25,0.01,1404,3
0.956,0.0001,742,762,25,25,0.01,1504,3
0.962,0.0001,801,803,25,25,0.01,1604,3
0.97,0.0001,846,858,25,25,0.01,1704,3
0.97,0.0001,903,901,25,25,0.01,1804,3
0.968,0.0001,946,958,25,25,0.01,1904,3
0.976,0.0001,994,1010,25,25,0.01,2004,3
0.5,0.0001,50,54,25,25,0.01,104,4
0.526,0.0001,102,102,25,25,0.01,204,4
0.52,0.0001,161,143,25,25,0.01,304,4
0.552,0.0001,207,197,25,25,0.01,404,4
0.58,0.0001,261,243,25,25,0.01,504,4
0.588,0.0001,315,289,25,25,0.01,604,4
0.608,0.0001,362,342,25,25,0.01,704,4
0.688,0.0001,413,391,25,25,0.01,804,4
0.718,0.0001,459,445,25,25,0.01,904,4
0.728,0.0001,506,498,25,25,0.01,1004,4
0.788,0.0001,556,548,25,25,0.01,1104,4
0.812,0.0001,605,599,25,25,0.01,1204,4
0.842,0.0001,648,656,25,25,0.01,1304,4
0.908,0.0001,697,707,25,25,0.01,1404,4
0.93,0.0001,751,753,25,25,0.01,1504,4
0.948,0.0001,803,801,25,25,0.01,1604,4
0.96,0.0001,858,846,25,25,0.01,1704,4
0.95,0.0001,913,891,25,25,0.01,1804,4
0.948,0.0001,960,944,25,25,0.01,1904,4
0.956,0.0001,999,1005,25,25,0.01,2004,4
0.532,0.0001,51,53,25,25,0.01,104,5
0.584,0.0001,101,103,25,25,0.01,204,5
0.584,0.0001,155,149,25,25,0.01,304,5
0.614,0.0001,195,209,25,25,0.01,404,5
0.628,0.0001,255,249,25,25,0.01,504,5
0.65,0.0001,305,299,25,25,0.01,604,5
0.73,0.0001,363,341,25,25,0.01,704,5
0.778,0.0001,406,398,25,25,0.01,804,5
0.81,0.0001,458,446,25,25,0.01,904,5
0.86,0.0001,507,497,25,25,0.01,1004,5
0.896,0.0001,566,538,25,25,0.01,1104,5
0.912,0.0001,613,591,25,25,0.01,1204,5
0.932,0.0001,654,650,25,25,0.01,1304,5
0.95,0.0001,705,699,25,25,0.01,1404,5
0.952,0.0001,763,741,25,25,0.01,1504,5
0.958,0.0001,806,798,25,25,0.01,1604,5
0.964,0.0001,859,845,25,25,0.01,1704,5
0.958,0.0001,902,902,25,25,0.01,1804,5
0.96,0.0001,957,947,25,25,0.01,1904,5
0.974,0.0001,1000,1004,25,25,0.01,2004,5
0.5,0.0001,42,62,25,25,0.01,104,6
0.54,0.0001,90,114,25,25,0.01,204,6
0.55,0.0001,137,167,25,25,0.01,304,6
0.54,0.0001,185,219,25,25,0.01,404,6
0.578,0.0001,234,270,25,25,0.01,504,6
0.608,0.0001,292,312,25,25,0.01,604,6
0.618,0.0001,341,363,25,25,0.01,704,6
0.66,0.0001,397,407,25,25,0.01,804,6
0.708,0.0001,450,454,25,25,0.01,904,6
0.748,0.0001,503,501,25,25,0.01,1004,6
0.796,0.0001,551,553,25,25,0.01,1104,6
0.84,0.0001,595,609,25,25,0.01,1204,6
0.88,0.0001,648,656,25,25,0.01,1304,6
0.93,0.0001,696,708,25,25,0.01,1404,6
0.942,0.0001,745,759,25,25,0.01,1504,6
0.954,0.0001,799,805,25,25,0.01,1604,6
0.96,0.0001,851,853,25,25,0.01,1704,6
0.966,0.0001,900,904,25,25,0.01,1804,6
0.964,0.0001,953,951,25,25,0.01,1904,6
0.964,0.0001,1005,999,25,25,0.01,2004,6
0.498,0.0001,52,52,25,25,0.01,104,7
0.508,0.0001,105,99,25,25,0.01,204,7
0.518,0.0001,166,138,25,25,0.01,304,7
0.544,0.0001,214,190,25,25,0.01,404,7
0.57,0.0001,269,235,25,25,0.01,504,7
0.626,0.0001,315,289,25,25,0.01,604,7
0.71,0.0001,363,341,25,25,0.01,704,7
0.74,0.0001,415,389,25,25,0.01,804,7
0.764,0.0001,459,445,25,25,0.01,904,7
0.852,0.0001,510,494,25,25,0.01,1004,7
0.892,0.0001,560,544,25,25,0.01,1104,7
0.922,0.0001,604,600,25,25,0.01,1204,7
0.964,0.0001,655,649,25,25,0.01,1304,7
0.964,0.0001,699,705,25,25,0.01,1404,7
0.964,0.0001,742,762,25,25,0.01,1504,7
0.976,0.0001,800,804,25,25,0.01,1604,7
0.978,0.0001,847,857,25,25,0.01,1704,7
0.982,0.0001,897,907,25,25,0.01,1804,7
0.982,0.0001,950,954,25,25,0.01,1904,7
0.984,0.0001,996,1008,25,25,0.01,2004,7
0.54,0.0001,44,60,25,25,0.01,104,8
0.574,0.0001,97,107,25,25,0.01,204,8
0.586,0.0001,150,154,25,25,0.01,304,8
0.59,0.0001,205,199,25,25,0.01,404,8
0.632,0.0001,253,251,25,25,0.01,504,8
0.674,0.0001,306,298,25,25,0.01,604,8
0.706,0.0001,353,351,25,25,0.01,704,8
0.742,0.0001,410,394,25,25,0.01,804,8
0.8,0.0001,450,454,25,25,0.01,904,8
0.868,0.0001,495,509,25,25,0.01,1004,8
0.93,0.0001,550,554,25,25,0.01,1104,8
0.942,0.0001,610,594,25,25,0.01,1204,8
0.942,0.0001,666,638,25,25,0.01,1304,8
0.954,0.0001,708,696,25,25,0.01,1404,8
0.96,0.0001,764,740,25,25,0.01,1504,8
0.956,0.0001,812,792,25,25,0.01,1604,8
0.958,0.0001,856,848,25,25,0.01,1704,8
0.968,0.0001,909,895,25,25,0.01,1804,8
0.97,0.0001,948,956,25,25,0.01,1904,8
0.972,0.0001,1001,1003,25,25,0.01,2004,8
0.51,0.0001,50,54,25,25,0.01,104,9
0.556,0.0001,101,103,25,25,0.01,204,9
0.562,0.0001,149,155,25,25,0.01,304,9
0.604,0.0001,202,202,25,25,0.01,404,9
0.61,0.0001,246,258,25,25,0.01,504,9
0.65,0.0001,302,302,25,25,0.01,604,9
0.678,0.0001,348,356,25,25,0.01,704,9
0.712,0.0001,394,410,25,25,0.01,804,9
0.73,0.0001,449,455,25,25,0.01,904,9
0.788,0.0001,493,511,25,25,0.01,1004,9
0.83,0.0001,550,554,25,25,0.01,1104,9
0.876,0.0001,603,601,25,25,0.01,1204,9
0.888,0.0001,661,643,25,25,0.01,1304,9
0.922,0.0001,711,693,25,25,0.01,1404,9
0.946,0.0001,765,739,25,25,0.01,1504,9
0.946,0.0001,811,793,25,25,0.01,1604,9
0.946,0.0001,857,847,25,25,0.01,1704,9
0.948,0.0001,903,901,25,25,0.01,1804,9
0.95,0.0001,948,956,25,25,0.01,1904,9
0.964,0.0001,1000,1004,25,25,0.01,2004,9
0.492,0.0001,44,60,25,25,0.01,104,10
0.488,0.0001,91,113,25,25,0.01,204,10
0.48,0.0001,145,159,25,25,0.01,304,10
0.496,0.0001,198,206,25,25,0.01,404,10
0.524,0.0001,253,251,25,25,0.01,504,10
0.544,0.0001,299,305,25,25,0.01,604,10
0.544,0.0001,342,362,25,25,0.01,704,10
0.61,0.0001,386,418,25,25,0.01,804,10
0.666,0.0001,432,472,25,25,0.01,904,10
0.728,0.0001,483,521,25,25,0.01,1004,10
0.784,0.0001,535,569,25,25,0.01,1104,10
0.832,0.0001,595,609,25,25,0.01,1204,10
0.862,0.0001,639,665,25,25,0.01,1304,10
0.91,0.0001,686,718,25,25,0.01,1404,10
0.942,0.0001,742,762,25,25,0.01,1504,10
0.938,0.0001,790,814,25,25,0.01,1604,10
0.95,0.0001,842,862,25,25,0.01,1704,10
0.952,0.0001,890,914,25,25,0.01,1804,10
0.958,0.0001,941,963,25,25,0.01,1904,10
0.96,0.0001,995,1009,25,25,0.01,2004,10
0.506,0.0001,48,56,25,25,0.01,104,11
0.53,0.0001,98,106,25,25,0.01,204,11
0.532,0.0001,146,158,25,25,0.01,304,11
0.572,0.0001,202,202,25,25,0.01,404,11
0.614,0.0001,251,253,25,25,0.01,504,11
0.65,0.0001,299,305,25,25,0.01,604,11
0.668,0.0001,354,350,25,25,0.01,704,11
0.718,0.0001,406,398,25,25,0.01,804,11
0.742,0.0001,457,447,25,25,0.01,904,11
0.838,0.0001,500,504,25,25,0.01,1004,11
0.87,0.0001,551,553,25,25,0.01,1104,11
0.904,0.0001,599,605,25,25,0.01,1204,11
0.916,0.0001,639,665,25,25,0.01,1304,11
0.93,0.0001,686,718,25,25,0.01,1404,11
0.936,0.0001,738,766,25,25,0.01,1504,11
0.944,0.0001,794,810,25,25,0.01,1604,11
0.948,0.0001,840,864,25,25,0.01,1704,11
0.95,0.0001,897,907,25,25,0.01,1804,11
0.964,0.0001,947,957,25,25,0.01,1904,11
0.966,0.0001,1003,1001,25,25,0.01,2004,11
0.54,0.0001,53,51,25,25,0.01,104,12
0.542,0.0001,100,104,25,25,0.01,204,12
0.548,0.0001,158,146,25,25,0.01,304,12
0.572,0.0001,213,191,25,25,0.01,404,12
0.598,0.0001,262,242,25,25,0.01,504,12
0.634,0.0001,314,290,25,25,0.01,604,12
0.656,0.0001,368,336,25,25,0.01,704,12
0.702,0.0001,420,384,25,25,0.01,804,12
0.728,0.0001,470,434,25,25,0.01,904,12
0.774,0.0001,516,488,25,25,0.01,1004,12
0.838,0.0001,569,535,25,25,0.01,1104,12
0.89,0.0001,626,578,25,25,0.01,1204,12
0.922,0.0001,670,634,25,25,0.01,1304,12
0.952,0.0001,724,680,25,25,0.01,1404,12
0.96,0.0001,775,729,25,25,0.01,1504,12
0.96,0.0001,824,780,25,25,0.01,1604,12
0.954,0.0001,876,828,25,25,0.01,1704,12
0.962,0.0001,917,887,25,25,0.01,1804,12
0.966,0.0001,967,937,25,25,0.01,1904,12
0.97,0.0001,1014,990,25,25,0.01,2004,12
0.524,0.0001,50,54,25,25,0.01,104,13
0.554,0.0001,105,99,25,25,0.01,204,13
0.552,0.0001,151,153,25,25,0.01,304,13
0.572,0.0001,193,211,25,25,0.01,404,13
0.578,0.0001,241,263,25,25,0.01,504,13
0.616,0.0001,298,306,25,25,0.01,604,13
0.666,0.0001,354,350,25,25,0.01,704,13
0.71,0.0001,407,397,25,25,0.01,804,13
0.746,0.0001,464,440,25,25,0.01,904,13
0.794,0.0001,517,487,25,25,0.01,1004,13
0.848,0.0001,565,539,25,25,0.01,1104,13
0.89,0.0001,613,591,25,25,0.01,1204,13
0.944,0.0001,665,639,25,25,0.01,1304,13
0.958,0.0001,716,688,25,25,0.01,1404,13
0.96,0.0001,756,748,25,25,0.01,1504,13
0.962,0.0001,812,792,25,25,0.01,1604,13
0.97,0.0001,857,847,25,25,0.01,1704,13
0.972,0.0001,909,895,25,25,0.01,1804,13
0.974,0.0001,959,945,25,25,0.01,1904,13
0.968,0.0001,1006,998,25,25,0.01,2004,13
0.54,0.0001,47,57,25,25,0.01,104,14
0.55,0.0001,104,100,25,25,0.01,204,14
0.546,0.0001,160,144,25,25,0.01,304,14
0.568,0.0001,219,185,25,25,0.01,404,14
0.568,0.0001,263,241,25,25,0.01,504,14
0.586,0.0001,316,288,25,25,0.01,604,14
0.584,0.0001,371,333,25,25,0.01,704,14
0.61,0.0001,420,384,25,25,0.01,804,14
0.692,0.0001,473,431,25,25,0.01,904,14
0.8,0.0001,512,492,25,25,0.01,1004,14
0.828,0.0001,563,541,25,25,0.01,1104,14
0.868,0.0001,610,594,25,25,0.01,1204,14
0.91,0.0001,662,642,25,25,0.01,1304,14
0.94,0.0001,717,687,25,25,0.01,1404,14
0.932,0.0001,767,737,25,25,0.01,1504,14
0.93,0.0001,812,792,25,25,0.01,1604,14
0.936,0.0001,859,845,25,25,0.01,1704,14
0.942,0.0001,908,896,25,25,0.01,1804,14
0.946,0.0001,957,947,25,25,0.01,1904,14
0.95,0.0001,1013,991,25,25,0.01,2004,14
0.488,0.0001,48,56,25,25,0.01,104,15
0.514,0.0001,96,108,25,25,0.01,204,15
0.53,0.0001,134,170,25,25,0.01,304,15
0.554,0.0001,184,220,25,25,0.01,404,15
0.598,0.0001,243,261,25,25,0.01,504,15
0.648,0.0001,291,313,25,25,0.01,604,15
0.666,0.0001,346,358,25,25,0.01,704,15
0.718,0.0001,388,416,25,25,0.01,804,15
0.748,0.0001,440,464,25,25,0.01,904,15
0.82,0.0001,498,506,25,25,0.01,1004,15
0.868,0.0001,546,558,25,25,0.01,1104,15
0.904,0.0001,594,610,25,25,0.01,1204,15
0.912,0.0001,638,666,25,25,0.01,1304,15
0.936,0.0001,692,712,25,25,0.01,1404,15
0.958,0.0001,745,759,25,25,0.01,1504,15
0.956,0.0001,793,811,25,25,0.01,1604,15
0.952,0.0001,846,858,25,25,0.01,1704,15
0.958,0.0001,906,898,25,25,0.01,1804,15
0.956,0.0001,956,948,25,25,0.01,1904,15
0.964,0.0001,1005,999,25,25,0.01,2004,15
0.524,0.0001,58,46,25,25,0.01,104,16
0.514,0.0001,104,100,25,25,0.01,204,16
0.542,0.0001,160,144,25,25,0.01,304,16
0.586,0.0001,210,194,25,25,0.01,404,16
0.584,0.0001,257,247,25,25,0.01,504,16
0.59,0.0001,302,302,25,25,0.01,604,16
0.624,0.0001,357,347,25,25,0.01,704,16
0.656,0.0001,399,405,25,25,0.01,804,16
0.694,0.0001,454,450,25,25,0.01,904,16
0.744,0.0001,508,496,25,25,0.01,1004,16
0.802,0.0001,560,544,25,25,0.01,1104,16
0.854,0.0001,604,600,25,25,0.01,1204,16
0.894,0.0001,658,646,25,25,0.01,1304,16
0.916,0.0001,711,693,25,25,0.01,1404,16
0.948,0.0001,759,745,25,25,0.01,1504,16
0.962,0.0001,811,793,25,25,0.01,1604,16
0.966,0.0001,867,837,25,25,0.01,1704,16
0.966,0.0001,915,889,25,25,0.01,1804,16
0.972,0.0001,963,941,25,25,0.01,1904,16
0.978,0.0001,1014,990,25,25,0.01,2004,16
0.484,0.0001,52,52,25,25,0.01,104,17
0.524,0.0001,102,102,25,25,0.01,204,17
0.528,0.0001,160,144,25,25,0.01,304,17
0.548,0.0001,209,195,25,25,0.01,404,17
0.582,0.0001,252,252,25,25,0.01,504,17
0.616,0.0001,309,295,25,25,0.01,604,17
0.652,0.0001,360,344,25,25,0.01,704,17
0.72,0.0001,414,390,25,25,0.01,804,17
0.754,0.0001,460,444,25,25,0.01,904,17
0.82,0.0001,518,486,25,25,0.01,1004,17
0.872,0.0001,572,532,25,25,0.01,1104,17
0.906,0.0001,621,583,25,25,0.01,1204,17
0.926,0.0001,665,639,25,25,0.01,1304,17
0.95,0.0001,713,691,25,25,0.01,1404,17
0.962,0.0001,770,734,25,25,0.01,1504,17
0.964,0.0001,822,782,25,25,0.01,1604,17
0.964,0.0001,873,831,25,25,0.01,1704,17
0.97,0.0001,922,882,25,25,0.01,1804,17
0.97,0.0001,976,928,25,25,0.01,1904,17
0.976,0.0001,1017,987,25,25,0.01,2004,17
0.486,0.0001,60,44,25,25,0.01,104,18
0.506,0.0001,113,91,25,25,0.01,204,18
0.534,0.0001,155,149,25,25,0.01,304,18
0.558,0.0001,201,203,25,25,0.01,404,18
0.566,0.0001,258,246,25,25,0.01,504,18
0.59,0.0001,306,298,25,25,0.01,604,18
0.642,0.0001,360,344,25,25,0.01,704,18
0.654,0.0001,407,397,25,25,0.01,804,18
0.696,0.0001,456,448,25,25,0.01,904,18
0.736,0.0001,508,496,25,25,0.01,1004,18
0.776,0.0001,565,539,25,25,0.01,1104,18
0.85,0.0001,615,589,25,25,0.01,1204,18
0.89,0.0001,666,638,25,25,0.01,1304,18
0.924,0.0001,716,688,25,25,0.01,1404,18
0.926,0.0001,772,732,25,25,0.01,1504,18
0.934,0.0001,819,785,25,25,0.01,1604,18
0.942,0.0001,862,842,25,25,0.01,1704,18
0.942,0.0001,914,890,25,25,0.01,1804,18
0.954,0.0001,953,951,25,25,0.01,1904,18
0.956,0.0001,1001,1003,25,25,0.01,2004,18
0.484,0.0001,54,50,25,25,0.01,104,19
0.49,0.0001,104,100,25,25,0.01,204,19
0.522,0.0001,153,151,25,25,0.01,304,19
0.554,0.0001,199,205,25,25,0.01,404,19
0.578,0.0001,251,253,25,25,0.01,504,19
0.612,0.0001,309,295,25,25,0.01,604,19
0.646,0.0001,353,351,25,25,0.01,704,19
0.71,0.0001,397,407,25,25,0.01,804,19
0.75,0.0001,446,458,25,25,0.01,904,19
0.808,0.0001,493,511,25,25,0.01,1004,19
0.85,0.0001,551,553,25,25,0.01,1104,19
0.896,0.0001,598,606,25,25,0.01,1204,19
0.904,0.0001,647,657,25,25,0.01,1304,19
0.932,0.0001,691,713,25,25,0.01,1404,19
0.932,0.0001,745,759,25,25,0.01,1504,19
0.948,0.0001,793,811,25,25,0.01,1604,19
0.952,0.0001,848,856,25,25,0.01,1704,19
0.952,0.0001,889,915,25,25,0.01,1804,19
0.958,0.0001,942,962,25,25,0.01,1904,19
0.958,0.0001,993,1011,25,25,0.01,2004,19
0.49,0.0001,55,49,25,25,0.01,104,20
0.528,0.0001,104,100,25,25,0.01,204,20
0.528,0.0001,156,148,25,25,0.01,304,20
0.558,0.0001,203,201,25,25,0.01,404,20
0.582,0.0001,246,258,25,25,0.01,504,20
0.632,0.0001,290,314,25,25,0.01,604,20
0.692,0.0001,332,372,25,25,0.01,704,20
0.718,0.0001,389,415,25,25,0.01,804,20
0.77,0.0001,448,456,25,25,0.01,904,20
0.834,0.0001,498,506,25,25,0.01,1004,20
0.854,0.0001,547,557,25,25,0.01,1104,20
0.898,0.0001,597,607,25,25,0.01,1204,20
0.92,0.0001,649,655,25,25,0.01,1304,20
0.948,0.0001,696,708,25,25,0.01,1404,20
0.948,0.0001,749,755,25,25,0.01,1504,20
0.952,0.0001,798,806,25,25,0.01,1604,20
0.964,0.0001,850,854,25,25,0.01,1704,20
0.97,0.0001,901,903,25,25,0.01,1804,20
0.97,0.0001,949,955,25,25,0.01,1904,20
0.972,0.0001,1007,997,25,25,0.01,2004,20
0.516,0.001,51,53,25,25,0.0001,104,1
0.516,0.001,97,107,25,25,0.0001,204,1
0.514,0.001,149,155,25,25,0.0001,304,1
0.514,0.001,201,203,25,25,0.0001,404,1
0.514,0.001,253,251,25,25,0.0001,504,1
0.512,0.001,311,293,25,25,0.0001,604,1
0.51,0.001,365,339,25,25,0.0001,704,1
0.512,0.001,412,392,25,25,0.0001,804,1
0.514,0.001,462,442,25,25,0.0001,904,1
0.514,0.001,504,500,25,25,0.0001,1004,1
0.514,0.001,549,555,25,25,0.0001,1104,1
0.518,0.001,597,607,25,25,0.0001,1204,1
0.518,0.001,648,656,25,25,0.0001,1304,1
0.518,0.001,700,704,25,25,0.0001,1404,1
0.522,0.001,754,750,25,25,0.0001,1504,1
0.518,0.001,802,802,25,25,0.0001,1604,1
0.52,0.001,857,847,25,25,0.0001,1704,1
0.518,0.001,899,905,25,25,0.0001,1804,1
0.522,0.001,946,958,25,25,0.0001,1904,1
0.52,0.001,985,1019,25,25,0.0001,2004,1
0.472,0.001,54,50,25,25,0.0001,104,2
0.472,0.001,102,102,25,25,0.0001,204,2
0.472,0.001,157,147,25,25,0.0001,304,2
0.47,0.001,214,190,25,25,0.0001,404,2
0.466,0.001,263,241,25,25,0.0001,504,2
0.466,0.001,319,285,25,25,0.0001,604,2
0.466,0.001,373,331,25,25,0.0001,704,2
0.464,0.001,422,382,25,25,0.0001,804,2
0.464,0.001,473,431,25,25,0.0001,904,2
0.458,0.001,534,470,25,25,0.0001,1004,2
0.458,0.001,587,517,25,25,0.0001,1104,2
0.464,0.001,641,563,25,25,0.0001,1204,2
0.468,0.001,680,624,25,25,0.0001,1304,2
0.47,0.001,725,679,25,25,0.0001,1404,2
0.47,0.001,769,735,25,25,0.0001,1504,2
0.474,0.001,812,792,25,25,0.0001,1604,2
0.482,0.001,861,843,25,25,0.0001,1704,2
0.486,0.001,914,890,25,25,0.0001,1804,2
0.49,0.001,959,945,25,25,0.0001,1904,2
0.492,0.001,1007,997,25,25,0.0001,2004,2
0.53,0.001,64,40,25,25,0.0001,104,3
0.53,0.001,117,87,25,25,0.0001,204,3
0.528,0.001,170,134,25,25,0.0001,304,3
0.528,0.001,217,187,25,25,0.0001,404,3
0.528,0.001,263,241,25,25,0.0001,504,3
0.528,0.001,314,290,25,25,0.0001,604,3
0.528,0.001,366,338,25,25,0.0001,704,3
0.528,0.001,418,386,25,25,0.0001,804,3
0.534,0.001,468,436,25,25,0.0001,904,3
0.534,0.001,519,485,25,25,0.0001,1004,3
0.536,0.001,573,531,25,25,0.0001,1104,3
0.536,0.001,625,579,25,25,0.0001,1204,3
0.534,0.001,667,637,25,25,0.0001,1304,3
0.534,0.001,724,680,25,25,0.0001,1404,3
0.538,0.001,770,734,25,25,0.0001,1504,3
0.54,0.001,819,785,25,25,0.0001,1604,3
0.542,0.001,865,839,25,25,0.0001,1704,3
0.542,0.001,910,894,25,25,0.0001,1804,3
0.542,0.001,956,948,25,25,0.0001,1904,3
0.544,0.001,1007,997,25,25,0.0001,2004,3
0.478,0.001,55,49,25,25,0.0001,104,4
0.476,0.001,110,94,25,25,0.0001,204,4
0.476,0.001,154,150,25,25,0.0001,304,4
0.476,0.001,207,197,25,25,0.0001,404,4
0.476,0.001,252,252,25,25,0.0001,504,4
0.476,0.001,297,307,25,25,0.0001,604,4
0.474,0.001,344,360,25,25,0.0001,704,4
0.474,0.001,393,411,25,25,0.0001,804,4
0.472,0.001,445,459,25,25,0.0001,904,4
0.474,0.001,493,511,25,25,0.0001,1004,4
0.47,0.001,546,558,25,25,0.0001,1104,4
0.472,0.001,592,612,25,25,0.0001,1204,4
0.468,0.001,639,665,25,25,0.0001,1304,4
0.466,0.001,690,714,25,25,0.0001,1404,4
0.47,0.001,747,757,25,25,0.0001,1504,4
0.472,0.001,803,801,25,25,0.0001,1604,4
0.474,0.001,860,844,25,25,0.0001,1704,4
0.474,0.001,912,892,25,25,0.0001,1804,4
0.476,0.001,955,949,25,25,0.0001,1904,4
0.478,0.001,1002,1002,25,25,0.0001,2004,4
0.52,0.001,47,57,25,25,0.0001,104,5
0.52,0.001,96,108,25,25,0.0001,204,5
0.52,0.001,145,159,25,25,0.0001,304,5
0.522,0.001,197,207,25,25,0.0001,404,5
0.524,0.001,247,257,25,25,0.0001,504,5
0.524,0.001,294,310,25,25,0.0001,604,5
0.526,0.001,348,356,25,25,0.0001,704,5
0.526,0.001,402,402,25,25,0.0001,804,5
0.528,0.001,448,456,25,25,0.0001,904,5
0.53,0.001,502,502,25,25,0.0001,1004,5
0.53,0.001,549,555,25,25,0.0001,1104,5
0.532,0.001,593,611,25,25,0.0001,1204,5
0.53,0.001,636,668,25,25,0.0001,1304,5
0.53,0.001,690,714,25,25,0.0001,1404,5
0.534,0.001,752,752,25,25,0.0001,1504,5
0.532,0.001,802,802,25,25,0.0001,1604,5
0.536,0.001,852,852,25,25,0.0001,1704,5
0.538,0.001,896,908,25,25,0.0001,1804,5
0.542,0.001,944,960,25,25,0.0001,1904,5
0.546,0.001,993,1011,25,25,0.0001,2004,5
0.468,0.001,62,42,25,25,0.0001,104,6
0.468,0.001,109,95,25,25,0.0001,204,6
0.468,0.001,154,150,25,25,0.0001,304,6
0.468,0.001,204,200,25,25,0.0001,404,6
0.468,0.001,269,235,25,25,0.0001,504,6
0.468,0.001,327,277,25,25,0.0001,604,6
0.468,0.001,373,331,25,25,0.0001,704,6
0.468,0.001,431,373,25,25,0.0001,804,6
0.47,0.001,477,427,25,25,0.0001,904,6
0.47,0.001,536,468,25,25,0.0001,1004,6
0.47,0.001,583,521,25,25,0.0001,1104,6
0.468,0.001,626,578,25,25,0.0001,1204,6
0.468,0.001,669,635,25,25,0.0001,1304,6
0.468,0.001,715,689,25,25,0.0001,1404,6
0.468,0.001,763,741,25,25,0.0001,1504,6
0.47,0.001,812,792,25,25,0.0001,1604,6
0.47,0.001,860,844,25,25,0.0001,1704,6
0.472,0.001,904,900,25,25,0.0001,1804,6
0.476,0.001,940,964,25,25,0.0001,1904,6
0.476,0.001,992,1012,25,25,0.0001,2004,6
0.494,0.001,56,48,25,25,0.0001,104,7
0.494,0.001,111,93,25,25,0.0001,204,7
0.494,0.001,157,147,25,25,0.0001,304,7
0.492,0.001,203,201,25,25,0.0001,404,7
0.492,0.001,256,248,25,25,0.0001,504,7
0.492,0.001,302,302,25,25,0.0001,604,7
0.492,0.001,357,347,25,25,0.0001,704,7
0.492,0.001,411,393,25,25,0.0001,804,7
0.492,0.001,457,447,25,25,0.0001,904,7
0.492,0.001,511,493,25,25,0.0001,1004,7
0.492,0.001,556,548,25,25,0.0001,1104,7
0.494,0.001,611,593,25,25,0.0001,1204,7
0.494,0.001,664,640,25,25,0.0001,1304,7
0.494,0.001,707,697,25,25,0.0001,1404,7
0.492,0.001,752,752,25,25,0.0001,1504,7
0.492,0.001,800,804,25,25,0.0001,1604,7
0.492,0.001,847,857,25,25,0.0001,1704,7
0.492,0.001,901,903,25,25,0.0001,1804,7
0.492,0.001,949,955,25,25,0.0001,1904,7
0.494,0.001,1001,1003,25,25,0.0001,2004,7
0.54,0.001,51,53,25,25,0.0001,104,8
0.54,0.001,104,100,25,25,0.0001,204,8
0.542,0.001,158,146,25,25,0.0001,304,8
0.54,0.001,200,204,25,25,0.0001,404,8
0.54,0.001,245,259,25,25,0.0001,504,8
0.54,0.001,296,308,25,25,0.0001,604,8
0.54,0.001,342,362,25,25,0.0001,704,8
0.54,0.001,389,415,25,25,0.0001,804,8
0.54,0.001,442,462,25,25,0.0001,904,8
0.54,0.001,495,509,25,25,0.0001,1004,8
0.54,0.001,541,563,25,25,0.0001,1104,8
0.54,0.001,596,608,25,25,0.0001,1204,8
0.54,0.001,647,657,25,25,0.0001,1304,8
0.538,0.001,697,707,25,25,0.0001,1404,8
0.538,0.001,750,754,25,25,0.0001,1504,8
0.54,0.001,804,800,25,25,0.0001,1604,8
0.542,0.001,854,850,25,25,0.0001,1704,8
0.544,0.001,909,895,25,25,0.0001,1804,8
0.542,0.001,965,939,25,25,0.0001,1904,8
0.544,0.001,1015,989,25,25,0.0001,2004,8
0.496,0.001,44,60,25,25,0.0001,104,9
0.498,0.001,101,103,25,25,0.0001,204,9
0.498,0.001,155,149,25,25,0.0001,304,9
0.498,0.001,210,194,25,25,0.0001,404,9
0.498,0.001,262,242,25,25,0.0001,504,9
0.5,0.001,320,284,25,25,0.0001,604,9
0.5,0.001,370,334,25,25,0.0001,704,9
0.5,0.001,418,386,25,25,0.0001,804,9
0.5,0.001,468,436,25,25,0.0001,904,9
0.5,0.001,518,486,25,25,0.0001,1004,9
0.5,0.001,564,540,25,25,0.0001,1104,9
0.5,0.001,609,595,25,25,0.0001,1204,9
0.5,0.001,654,650,25,25,0.0001,1304,9
0.5,0.001,705,699,25,25,0.0001,1404,9
0.5,0.001,745,759,25,25,0.0001,1504,9
0.502,0.001,805,799,25,25,0.0001,1604,9
0.504,0.001,860,844,25,25,0.0001,1704,9
0.502,0.001,914,890,25,25,0.0001,1804,9
0.506,0.001,965,939,25,25,0.0001,1904,9
0.506,0.001,1011,993,25,25,0.0001,2004,9
0.512,0.001,48,56,25,25,0.0001,104,10
0.514,0.001,109,95,25,25,0.0001,204,10
0.514,0.001,163,141,25,25,0.0001,304,10
0.514,0.001,212,192,25,25,0.0001,404,10
0.514,0.001,265,239,25,25,0.0001,504,10
0.512,0.001,307,297,25,25,0.0001,604,10
0.514,0.001,350,354,25,25,0.0001,704,10
0.514,0.001,398,406,25,25,0.0001,804,10
0.514,0.001,448,456,25,25,0.0001,904,10
0.518,0.001,508,496,25,25,0.0001,1004,10
0.514,0.001,548,556,25,25,0.0001,1104,10
0.51,0.001,603,601,25,25,0.0001,1204,10
0.512,0.001,648,656,25,25,0.0001,1304,10
0.512,0.001,697,707,25,25,0.0001,1404,10
0.508,0.001,750,754,25,25,0.0001,1504,10
0.508,0.001,799,805,25,25,0.0001,1604,10
0.51,0.001,850,854,25,25,0.0001,1704,10
0.51,0.001,906,898,25,25,0.0001,1804,10
0.512,0.001,954,950,25,25,0.0001,1904,10
0.514,0.001,1007,997,25,25,0.0001,2004,10
0.492,0.001,62,42,25,25,0.0001,104,11
0.492,0.001,109,95,25,25,0.0001,204,11
0.49,0.001,155,149,25,25,0.0001,304,11
0.49,0.001,201,203,25,25,0.0001,404,11
0.492,0.001,252,252,25,25,0.0001,504,11
0.492,0.001,291,313,25,25,0.0001,604,11
0.494,0.001,347,357,25,25,0.0001,704,11
0.494,0.001,386,418,25,25,0.0001,804,11
0.494,0.001,428,476,25,25,0.0001,904,11
0.494,0.001,487,517,25,25,0.0001,1004,11
0.494,0.001,537,567,25,25,0.0001,1104,11
0.494,0.001,590,614,25,25,0.0001,1204,11
0.496,0.001,639,665,25,25,0.0001,1304,11
0.496,0.001,686,718,25,25,0.0001,1404,11
0.496,0.001,740,764,25,25,0.0001,1504,11
0.496,0.001,790,814,25,25,0.0001,1604,11
0.496,0.001,838,866,25,25,0.0001,1704,11
0.496,0.001,888,916,25,25,0.0001,1804,11
0.496,0.001,937,967,25,25,0.0001,1904,11
0.496,0.001,986,1018,25,25,0.0001,2004,11
0.486,0.001,55,49,25,25,0.0001,104,12
0.486,0.001,105,99,25,25,0.0001,204,12
0.486,0.001,151,153,25,25,0.0001,304,12
0.486,0.001,194,210,25,25,0.0001,404,12
0.486,0.001,248,256,25,25,0.0001,504,12
0.486,0.001,298,306,25,25,0.0001,604,12
0.486,0.001,353,351,25,25,0.0001,704,12
0.488,0.001,404,400,25,25,0.0001,804,12
0.488,0.001,452,452,25,25,0.0001,904,12
0.488,0.001,512,492,25,25,0.0001,1004,12
0.488,0.001,566,538,25,25,0.0001,1104,12
0.486,0.001,610,594,25,25,0.0001,1204,12
0.49,0.001,653,651,25,25,0.0001,1304,12
0.488,0.001,712,692,25,25,0.0001,1404,12
0.49,0.001,768,736,25,25,0.0001,1504,12
0.492,0.001,810,794,25,25,0.0001,1604,12
0.49,0.001,860,844,25,25,0.0001,1704,12
0.488,0.001,909,895,25,25,0.0001,1804,12
0.494,0.001,961,943,25,25,0.0001,1904,12
0.494,0.001,1006,998,25,25,0.0001,2004,12
0.536,0.001,54,50,25,25,0.0001,104,13
0.534,0.001,100,104,25,25,0.0001,204,13
0.534,0.001,150,154,25,25,0.0001,304,13
0.534,0.001,196,208,25,25,0.0001,404,13
0.536,0.001,249,255,25,25,0.0001,504,13
0.536,0.001,302,302,25,25,0.0001,604,13
0.536,0.001,349,355,25,25,0.0001,704,13
0.536,0.001,405,399,25,25,0.0001,804,13
0.534,0.001,460,444,25,25,0.0001,904,13
0.534,0.001,513,491,25,25,0.0001,1004,13
0.534,0.001,560,544,25,25,0.0001,1104,13
0.538,0.001,617,587,25,25,0.0001,1204,13
0.536,0.001,667,637,25,25,0.0001,1304,13
0.538,0.001,720,684,25,25,0.0001,1404,13
0.538,0.001,765,739,25,25,0.0001,1504,13
0.542,0.001,813,791,25,25,0.0001,1604,13
0.55,0.001,853,851,25,25,0.0001,1704,13
0.552,0.001,903,901,25,25,0.0001,1804,13
0.552,0.001,956,948,25,25,0.0001,1904,13
0.558,0.001,1004,1000,25,25,0.0001,2004,13
0.494,0.001,57,47,25,25,0.0001,104,14
0.494,0.001,108,96,25,25,0.0001,204,14
0.496,0.001,153,151,25,25,0.0001,304,14
0.498,0.001,208,196,25,25,0.0001,404,14
0.498,0.001,259,245,25,25,0.0001,504,14
0.5,0.001,320,284,25,25,0.0001,604,14
0.5,0.001,370,334,25,25,0.0001,704,14
0.5,0.001,418,386,25,25,0.0001,804,14
0.5,0.001,472,432,25,25,0.0001,904,14
0.502,0.001,521,483,25,25,0.0001,1004,14
0.502,0.001,564,540,25,25,0.0001,1104,14
0.504,0.001,616,588,25,25,0.0001,1204,14
0.504,0.001,661,643,25,25,0.0001,1304,14
0.504,0.001,707,697,25,25,0.0001,1404,14
0.504,0.001,754,750,25,25,0.0001,1504,14
0.508,0.001,798,806,25,25,0.0001,1604,14
0.51,0.001,852,852,25,25,0.0001,1704,14
0.514,0.001,902,902,25,25,0.0001,1804,14
0.514,0.001,953,951,25,25,0.0001,1904,14
0.518,0.001,1006,998,25,25,0.0001,2004,14
0.476,0.001,50,54,25,25,0.0001,104,15
0.476,0.001,95,109,25,25,0.0001,204,15
0.476,0.001,143,161,25,25,0.0001,304,15
0.48,0.001,191,213,25,25,0.0001,404,15
0.48,0.001,245,259,25,25,0.0001,504,15
0.48,0.001,297,307,25,25,0.0001,604,15
0.48,0.001,354,350,25,25,0.0001,704,15
0.48,0.001,400,404,25,25,0.0001,804,15
0.48,0.001,443,461,25,25,0.0001,904,15
0.478,0.001,492,512,25,25,0.0001,1004,15
0.482,0.001,539,565,25,25,0.0001,1104,15
0.478,0.001,584,620,25,25,0.0001,1204,15
0.476,0.001,633,671,25,25,0.0001,1304,15
0.472,0.001,678,726,25,25,0.0001,1404,15
0.476,0.001,738,766,25,25,0.0001,1504,15
0.476,0.001,792,812,25,25,0.0001,1604,15
0.476,0.001,845,859,25,25,0.0001,1704,15
0.474,0.001,894,910,25,25,0.0001,1804,15
0.472,0.001,956,948,25,25,0.0001,1904,15
0.474,0.001,1010,994,25,25,0.0001,2004,15
0.476,0.001,54,50,25,25,0.0001,104,16
0.478,0.001,102,102,25,25,0.0001,204,16
0.478,0.001,149,155,25,25,0.0001,304,16
0.478,0.001,201,203,25,25,0.0001,404,16
0.474,0.001,245,259,25,25,0.0001,504,16
0.476,0.001,293,311,25,25,0.0001,604,16
0.48,0.001,336,368,25,25,0.0001,704,16
0.48,0.001,396,408,25,25,0.0001,804,16
0.48,0.001,450,454,25,25,0.0001,904,16
0.478,0.001,507,497,25,25,0.0001,1004,16
0.476,0.001,551,553,25,25,0.0001,1104,16
0.478,0.001,601,603,25,25,0.0001,1204,16
0.48,0.001,655,649,25,25,0.0001,1304,16
0.482,0.001,713,691,25,25,0.0001,1404,16
0.478,0.001,767,737,25,25,0.0001,1504,16
0.48,0.001,818,786,25,25,0.0001,1604,16
0.482,0.001,870,834,25,25,0.0001,1704,16
0.484,0.001,911,893,25,25,0.0001,1804,16
0.482,0.001,963,941,25,25,0.0001,1904,16
0.48,0.001,1013,991,25,25,0.0001,2004,16
0.552,0.001,52,52,25,25,0.0001,104,17
0.554,0.001,99,105,25,25,0.0001,204,17
0.552,0.001,153,151,25,25,0.0001,304,17
0.552,0.001,201,203,25,25,0.0001,404,17
0.554,0.001,253,251,25,25,0.0001,504,17
0.556,0.001,302,302,25,25,0.0001,604,17
0.556,0.001,349,355,25,25,0.0001,704,17
0.556,0.001,394,410,25,25,0.0001,804,17
0.556,0.001,447,457,25,25,0.0001,904,17
0.558,0.001,503,501,25,25,0.0001,1004,17
0.56,0.001,545,559,25,25,0.0001,1104,17
0.562,0.001,592,612,25,25,0.0001,1204,17
0.564,0.001,644,660,25,25,0.0001,1304,17
0.566,0.001,700,704,25,25,0.0001,1404,17
0.574,0.001,750,754,25,25,0.0001,1504,17
0.578,0.001,795,809,25,25,0.0001,1604,17
0.58,0.001,850,854,25,25,0.0001,1704,17
0.586,0.001,906,898,25,25,0.0001,1804,17
0.59,0.001,958,946,25,25,0.0001,1904,17
0.59,0.001,1009,995,25,25,0.0001,2004,17
0.532,0.001,52,52,25,25,0.0001,104,18
0.532,0.001,100,104,25,25,0.0001,204,18
0.532,0.001,150,154,25,25,0.0001,304,18
0.53,0.001,204,200,25,25,0.0001,404,18
0.53,0.001,259,245,25,25,0.0001,504,18
0.53,0.001,310,294,25,25,0.0001,604,18
0.532,0.001,359,345,25,25,0.0001,704,18
0.532,0.001,420,384,25,25,0.0001,804,18
0.53,0.001,473,431,25,25,0.0001,904,18
0.534,0.001,511,493,25,25,0.0001,1004,18
0.534,0.001,569,535,25,25,0.0001,1104,18
0.536,0.001,622,582,25,25,0.0001,1204,18
0.536,0.001,672,632,25,25,0.0001,1304,18
0.536,0.001,726,678,25,25,0.0001,1404,18
0.536,0.001,776,728,25,25,0.0001,1504,18
0.536,0.001,823,781,25,25,0.0001,1604,18
0.54,0.001,876,828,25,25,0.0001,1704,18
0.54,0.001,926,878,25,25,0.0001,1804,18
0.54,0.001,967,937,25,25,0.0001,1904,18
0.542,0.001,1010,994,25,25,0.0001,2004,18
0.524,0.001,48,56,25,25,0.0001,104,19
0.524,0.001,96,108,25,25,0.0001,204,19
0.524,0.001,147,157,25,25,0.0001,304,19
0.524,0.001,199,205,25,25,0.0001,404,19
0.524,0.001,243,261,25,25,0.0001,504,19
0.524,0.001,304,300,25,25,0.0001,604,19
0.524,0.001,353,351,25,25,0.0001,704,19
0.524,0.001,406,398,25,25,0.0001,804,19
0.524,0.001,449,455,25,25,0.0001,904,19
0.524,0.001,501,503,25,25,0.0001,1004,19
0.524,0.001,560,544,25,25,0.0001,1104,19
0.524,0.001,605,599,25,25,0.0001,1204,19
0.524,0.001,652,652,25,25,0.0001,1304,19
0.524,0.001,695,709,25,25,0.0001,1404,19
0.522,0.001,748,756,25,25,0.0001,1504,19
0.524,0.001,792,812,25,25,0.0001,1604,19
0.524,0.001,844,860,25,25,0.0001,1704,19
0.524,0.001,898,906,25,25,0.0001,1804,19
0.524,0.001,943,961,25,25,0.0001,1904,19
0.526,0.001,990,1014,25,25,0.0001,2004,19
0.522,0.001,53,51,25,25,0.0001,104,20
0.524,0.001,101,103,25,25,0.0001,204,20
0.524,0.001,149,155,25,25,0.0001,304,20
0.524,0.001,193,211,25,25,0.0001,404,20
0.524,0.001,240,264,25,25,0.0001,504,20
0.522,0.001,294,310,25,25,0.0001,604,20
0.524,0.001,345,359,25,25,0.0001,704,20
0.526,0.001,397,407,25,25,0.0001,804,20
0.522,0.001,451,453,25,25,0.0001,904,20
0.522,0.001,503,501,25,25,0.0001,1004,20
0.522,0.001,556,548,25,25,0.0001,1104,20
0.522,0.001,613,591,25,25,0.0001,1204,20
0.524,0.001,661,643,25,25,0.0001,1304,20
0.526,0.001,707,697,25,25,0.0001,1404,20
0.528,0.001,767,737,25,25,0.0001,1504,20
0.528,0.001,815,789,25,25,0.0001,1604,20
0.528,0.001,855,849,25,25,0.0001,1704,20
0.528,0.001,904,900,25,25,0.0001,1804,20
0.532,0.001,960,944,25,25,0.0001,1904,20
0.536,0.001,1007,997,25,25,0.0001,2004,20
0.562,0.001,53,51,25,25,0.001,104,1
0.56,0.001,102,102,25,25,0.001,204,1
0.56,0.001,153,151,25,25,0.001,304,1
0.56,0.001,207,197,25,25,0.001,404,1
0.558,0.001,254,250,25,25,0.001,504,1
0.556,0.001,302,302,25,25,0.001,604,1
0.55,0.001,350,354,25,25,0.001,704,1
0.564,0.001,397,407,25,25,0.001,804,1
0.562,0.001,439,465,25,25,0.001,904,1
0.566,0.001,499,505,25,25,0.001,1004,1
0.568,0.001,546,558,25,25,0.001,1104,1
0.574,0.001,599,605,25,25,0.001,1204,1
0.582,0.001,648,656,25,25,0.001,1304,1
0.588,0.001,708,696,25,25,0.001,1404,1
0.604,0.001,763,741,25,25,0.001,1504,1
0.608,0.001,817,787,25,25,0.001,1604,1
0.612,0.001,868,836,25,25,0.001,1704,1
0.62,0.001,926,878,25,25,0.001,1804,1
0.632,0.001,986,918,25,25,0.001,1904,1
0.652,0.001,1029,975,25,25,0.001,2004,1
0.482,0.001,51,53,25,25,0.001,104,2
0.484,0.001,104,100,25,25,0.001,204,2
0.48,0.001,155,149,25,25,0.001,304,2
0.472,0.001,199,205,25,25,0.001,404,2
0.482,0.001,254,250,25,25,0.001,504,2
0.482,0.001,303,301,25,25,0.001,604,2
0.476,0.001,349,355,25,25,0.001,704,2
0.48,0.001,400,404,25,25,0.001,804,2
0.492,0.001,443,461,25,25,0.001,904,2
0.496,0.001,493,511,25,25,0.001,1004,2
0.492,0.001,544,560,25,25,0.001,1104,2
0.506,0.001,599,605,25,25,0.001,1204,2
0.506,0.001,653,651,25,25,0.001,1304,2
0.518,0.001,698,706,25,25,0.001,1404,2
0.538,0.001,745,759,25,25,0.001,1504,2
0.562,0.001,793,811,25,25,0.001,1604,2
0.576,0.001,843,861,25,25,0.001,1704,2
0.598,0.001,896,908,25,25,0.001,1804,2
0.628,0.001,948,956,25,25,0.001,1904,2
0.648,0.001,995,1009,25,25,0.001,2004,2
0.504,0.001,53,51,25,25,0.001,104,3
0.498,0.001,108,96,25,25,0.001,204,3
0.506,0.001,153,151,25,25,0.001,304,3
0.504,0.001,199,205,25,25,0.001,404,3
0.502,0.001,257,247,25,25,0.001,504,3
0.5,0.001,305,299,25,25,0.001,604,3
0.508,0.001,361,343,25,25,0.001,704,3
0.51,0.001,412,392,25,25,0.001,804,3
0.518,0.001,468,436,25,25,0.001,904,3
0.536,0.001,525,479,25,25,0.001,1004,3
0.532,0.001,568,536,25,25,0.001,1104,3
0.552,0.001,608,596,25,25,0.001,1204,3
0.56,0.001,650,654,25,25,0.001,1304,3
0.574,0.001,703,701,25,25,0.001,1404,3
0.594,0.001,757,747,25,25,0.001,1504,3
0.604,0.001,815,789,25,25,0.001,1604,3
0.624,0.001,865,839,25,25,0.001,1704,3
0.642,0.001,915,889,25,25,0.001,1804,3
0.656,0.001,955,949,25,25,0.001,1904,3
0.674,0.001,1008,996,25,25,0.001,2004,3
0.486,0.001,40,64,25,25,0.001,104,4
0.492,0.001,84,120,25,25,0.001,204,4
0.494,0.001,128,176,25,25,0.001,304,4
0.496,0.001,170,234,25,25,0.001,404,4
0.496,0.001,214,290,25,25,0.001,504,4
0.498,0.001,263,341,25,25,0.001,604,4
0.502,0.001,306,398,25,25,0.001,704,4
0.508,0.001,357,447,25,25,0.001,804,4
0.518,0.001,417,487,25,25,0.001,904,4
0.524,0.001,474,530,25,25,0.001,1004,4
0.536,0.001,523,581,25,25,0.001,1104,4
0.538,0.001,581,623,25,25,0.001,1204,4
0.55,0.001,632,672,25,25,0.001,1304,4
0.548,0.001,688,716,25,25,0.001,1404,4
0.552,0.001,738,766,25,25,0.001,1504,4
0.556,0.001,794,810,25,25,0.001,1604,4
0.566,0.001,847,857,25,25,0.001,1704,4
0.592,0.001,899,905,25,25,0.001,1804,4
0.606,0.001,943,961,25,25,0.001,1904,4
0.63,0.001,994,1010,25,25,0.001,2004,4
0.52,0.001,58,46,25,25,0.001,104,5
0.52,0.001,102,102,25,25,0.001,204,5
0.526,0.001,152,152,25,25,0.001,304,5
0.532,0.001,203,201,25,25,0.001,404,5
0.532,0.001,259,245,25,25,0.001,504,5
0.538,0.001,311,293,25,25,0.001,604,5
0.536,0.001,357,347,25,25,0.001,704,5
0.546,0.001,400,404,25,25,0.001,804,5
0.546,0.001,448,456,25,25,0.001,904,5
0.55,0.001,503,501,25,25,0.001,1004,5
0.552,0.001,557,547,25,25,0.001,1104,5
0.564,0.001,608,596,25,25,0.001,1204,5
0.578,0.001,650,654,25,25,0.001,1304,5
0.588,0.001,697,707,25,25,0.001,1404,5
0.602,0.001,748,756,25,25,0.001,1504,5
0.61,0.001,800,804,25,25,0.001,1604,5
0.632,0.001,850,854,25,25,0.001,1704,5
0.66,0.001,893,911,25,25,0.001,1804,5
0.672,0.001,946,958,25,25,0.001,1904,5
0.688,0.001,1002,1002,25,25,0.001,2004,5
0.504,0.001,46,58,25,25,0.001,104,6
0.506,0.001,109,95,25,25,0.001,204,6
0.508,0.001,155,149,25,25,0.001,304,6
0.51,0.001,208,196,25,25,0.001,404,6
0.512,0.001,257,247,25,25,0.001,504,6
0.512,0.001,304,300,25,25,0.001,604,6
0.514,0.001,359,345,25,25,0.001,704,6
0.524,0.001,404,400,25,25,0.001,804,6
0.53,0.001,456,448,25,25,0.001,904,6
0.538,0.001,510,494,25,25,0.001,1004,6
0.542,0.001,560,544,25,25,0.001,1104,6
0.54,0.001,614,590,25,25,0.001,1204,6
0.564,0.001,670,634,25,25,0.001,1304,6
0.578,0.001,715,689,25,25,0.001,1404,6
0.59,0.001,766,738,25,25,0.001,1504,6
0.594,0.001,815,789,25,25,0.001,1604,6
0.604,0.001,859,845,25,25,0.001,1704,6
0.604,0.001,913,891,25,25,0.001,1804,6
0.624,0.001,967,937,25,25,0.001,1904,6
0.644,0.001,1007,997,25,25,0.001,2004,6
0.486,0.001,49,55,25,25,0.001,104,7
0.492,0.001,105,99,25,25,0.001,204,7
0.51,0.001,161,143,25,25,0.001,304,7
0.514,0.001,222,182,25,25,0.001,404,7
0.518,0.001,272,232,25,25,0.001,504,7
0.522,0.001,320,284,25,25,0.001,604,7
0.524,0.001,370,334,25,25,0.001,704,7
0.526,0.001,406,398,25,25,0.001,804,7
0.532,0.001,455,449,25,25,0.001,904,7
0.538,0.001,502,502,25,25,0.001,1004,7
0.544,0.001,550,554,25,25,0.001,1104,7
0.558,0.001,602,602,25,25,0.001,1204,7
0.566,0.001,655,649,25,25,0.001,1304,7
0.584,0.001,711,693,25,25,0.001,1404,7
0.6,0.001,760,744,25,25,0.001,1504,7
0.602,0.001,808,796,25,25,0.001,1604,7
0.616,0.001,851,853,25,25,0.001,1704,7
0.624,0.001,898,906,25,25,0.001,1804,7
0.636,0.001,943,961,25,25,0.001,1904,7
0.642,0.001,997,1007,25,25,0.001,2004,7
0.49,0.001,63,41,25,25,0.001,104,8
0.492,0.001,112,92,25,25,0.001,204,8
0.492,0.001,156,148,25,25,0.001,304,8
0.49,0.001,198,206,25,25,0.001,404,8
0.502,0.001,249,255,25,25,0.001,504,8
0.506,0.001,307,297,25,25,0.001,604,8
0.512,0.001,358,346,25,25,0.001,704,8
0.512,0.001,409,395,25,25,0.001,804,8
0.52,0.001,459,445,25,25,0.001,904,8
0.532,0.001,517,487,25,25,0.001,1004,8
0.532,0.001,566,538,25,25,0.001,1104,8
0.534,0.001,606,598,25,25,0.001,1204,8
0.548,0.001,657,647,25,25,0.001,1304,8
0.572,0.001,710,694,25,25,0.001,1404,8
0.59,0.001,760,744,25,25,0.001,1504,8
0.602,0.001,811,793,25,25,0.001,1604,8
0.624,0.001,865,839,25,25,0.001,1704,8
0.638,0.001,912,892,25,25,0.001,1804,8
0.646,0.001,964,940,25,25,0.001,1904,8
0.66,0.001,1011,993,25,25,0.001,2004,8
0.524,0.001,50,54,25,25,0.001,104,9
0.522,0.001,104,100,25,25,0.001,204,9
0.522,0.001,151,153,25,25,0.001,304,9
0.526,0.001,198,206,25,25,0.001,404,9
0.53,0.001,244,260,25,25,0.001,504,9
0.546,0.001,292,312,25,25,0.001,604,9
0.55,0.001,341,363,25,25,0.001,704,9
0.548,0.001,390,414,25,25,0.001,804,9
0.556,0.001,440,464,25,25,0.001,904,9
0.564,0.001,488,516,25,25,0.001,1004,9
0.58,0.001,547,557,25,25,0.001,1104,9
0.586,0.001,586,618,25,25,0.001,1204,9
0.604,0.001,638,666,25,25,0.001,1304,9
0.614,0.001,689,715,25,25,0.001,1404,9
0.608,0.001,747,757,25,25,0.001,1504,9
0.622,0.001,794,810,25,25,0.001,1604,9
0.642,0.001,839,865,25,25,0.001,1704,9
0.658,0.001,891,913,25,25,0.001,1804,9
0.67,0.001,947,957,25,25,0.001,1904,9
0.682,0.001,995,1009,25,25,0.001,2004,9
0.466,0.001,53,51,25,25,0.001,104,10
0.462,0.001,99,105,25,25,0.001,204,10
0.468,0.001,155,149,25,25,0.001,304,10
0.478,0.001,204,200,25,25,0.001,404,10
0.492,0.001,245,259,25,25,0.001,504,10
0.502,0.001,294,310,25,25,0.001,604,10
0.504,0.001,348,356,25,25,0.001,704,10
0.51,0.001,404,400,25,25,0.001,804,10
0.522,0.001,450,454,25,25,0.001,904,10
0.53,0.001,507,497,25,25,0.001,1004,10
0.534,0.001,558,546,25,25,0.001,1104,10
0.542,0.001,606,598,25,25,0.001,1204,10
0.548,0.001,644,660,25,25,0.001,1304,10
0.564,0.001,690,714,25,25,0.001,1404,10
0.574,0.001,750,754,25,25,0.001,1504,10
0.576,0.001,804,800,25,25,0.001,1604,10
0.59,0.001,851,853,25,25,0.001,1704,10
0.604,0.001,900,904,25,25,0.001,1804,10
0.622,0.001,951,953,25,25,0.001,1904,10
0.638,0.001,1000,1004,25,25,0.001,2004,10
0.49,0.001,54,50,25,25,0.001,104,11
0.494,0.001,107,97,25,25,0.001,204,11
0.494,0.001,156,148,25,25,0.001,304,11
0.486,0.001,205,199,25,25,0.001,404,11
0.474,0.001,257,247,25,25,0.001,504,11
0.476,0.001,300,304,25,25,0.001,604,11
0.486,0.001,345,359,25,25,0.001,704,11
0.496,0.001,393,411,25,25,0.001,804,11
0.5,0.001,448,456,25,25,0.001,904,11
0.5,0.001,498,506,25,25,0.001,1004,11
0.5,0.001,552,552,25,25,0.001,1104,11
0.514,0.001,599,605,25,25,0.001,1204,11
0.51,0.001,651,653,25,25,0.001,1304,11
0.522,0.001,705,699,25,25,0.001,1404,11
0.528,0.001,757,747,25,25,0.001,1504,11
0.536,0.001,808,796,25,25,0.001,1604,11
0.56,0.001,863,841,25,25,0.001,1704,11
0.586,0.001,915,889,25,25,0.001,1804,11
0.588,0.001,961,943,25,25,0.001,1904,11
0.598,0.001,1000,1004,25,25,0.001,2004,11
0.528,0.001,45,59,25,25,0.001,104,12
0.528,0.001,104,100,25,25,0.001,204,12
0.53,0.001,154,150,25,25,0.001,304,12
0.534,0.001,205,199,25,25,0.001,404,12
0.538,0.001,250,254,25,25,0.001,504,12
0.538,0.001,296,308,25,25,0.001,604,12
0.542,0.001,343,361,25,25,0.001,704,12
0.538,0.001,394,410,25,25,0.001,804,12
0.546,0.001,445,459,25,25,0.001,904,12
0.536,0.001,493,511,25,25,0.001,1004,12
0.54,0.001,541,563,25,25,0.001,1104,12
0.528,0.001,592,612,25,25,0.001,1204,12
0.536,0.001,642,662,25,25,0.001,1304,12
0.55,0.001,685,719,25,25,0.001,1404,12
0.564,0.001,729,775,25,25,0.001,1504,12
0.57,0.001,779,825,25,25,0.001,1604,12
0.588,0.001,830,874,25,25,0.001,1704,12
0.608,0.001,873,931,25,25,0.001,1804,12
0.644,0.001,931,973,25,25,0.001,1904,12
0.664,0.001,986,1018,25,25,0.001,2004,12
0.526,0.001,48,56,25,25,0.001,104,13
0.526,0.001,106,98,25,25,0.001,204,13
0.526,0.001,147,157,25,25,0.001,304,13
0.528,0.001,198,206,25,25,0.001,404,13
0.526,0.001,254,250,25,25,0.001,504,13
0.532,0.001,305,299,25,25,0.001,604,13
0.538,0.001,356,348,25,25,0.001,704,13
0.544,0.001,399,405,25,25,0.001,804,13
0.548,0.001,447,457,25,25,0.001,904,13
0.544,0.001,495,509,25,25,0.001,1004,13
0.552,0.001,551,553,25,25,0.001,1104,13
0.558,0.001,609,595,25,25,0.001,1204,13
0.558,0.001,662,642,25,25,0.001,1304,13
0.568,0.001,716,688,25,25,0.001,1404,13
0.574,0.001,763,741,25,25,0.001,1504,13
0.582,0.001,803,801,25,25,0.001,1604,13
0.596,0.001,852,852,25,25,0.001,1704,13
0.608,0.001,902,902,25,25,0.001,1804,13
0.618,0.001,957,947,25,25,0.001,1904,13
0.632,0.001,1004,1000,25,25,0.001,2004,13
0.456,0.001,55,49,25,25,0.001,104,14
0.458,0.001,107,97,25,25,0.001,204,14
0.466,0.001,144,160,25,25,0.001,304,14
0.472,0.001,192,212,25,25,0.001,404,14
0.468,0.001,253,251,25,25,0.001,504,14
0.472,0.001,306,298,25,25,0.001,604,14
0.47,0.001,363,341,25,25,0.001,704,14
0.488,0.001,418,386,25,25,0.001,804,14
0.506,0.001,462,442,25,25,0.001,904,14
0.512,0.001,506,498,25,25,0.001,1004,14
0.524,0.001,557,547,25,25,0.001,1104,14
0.536,0.001,601,603,25,25,0.001,1204,14
0.544,0.001,648,656,25,25,0.001,1304,14
0.548,0.001,695,709,25,25,0.001,1404,14
0.552,0.001,745,759,25,25,0.001,1504,14
0.558,0.001,795,809,25,25,0.001,1604,14
0.564,0.001,842,862,25,25,0.001,1704,14
0.564,0.001,891,913,25,25,0.001,1804,14
0.592,0.001,941,963,25,25,0.001,1904,14
0.616,0.001,995,1009,25,25,0.001,2004,14
0.526,0.001,57,47,25,25,0.001,104,15
0.524,0.001,107,97,25,25,0.001,204,15
0.516,0.001,156,148,25,25,0.001,304,15
0.52,0.001,201,203,25,25,0.001,404,15
0.526,0.001,252,252,25,25,0.001,504,15
0.53,0.001,299,305,25,25,0.001,604,15
0.528,0.001,350,354,25,25,0.001,704,15
0.542,0.001,400,404,25,25,0.001,804,15
0.54,0.001,447,457,25,25,0.001,904,15
0.554,0.001,501,503,25,25,0.001,1004,15
0.564,0.001,551,553,25,25,0.001,1104,15
0.568,0.001,598,606,25,25,0.001,1204,15
0.582,0.001,650,654,25,25,0.001,1304,15
0.598,0.001,699,705,25,25,0.001,1404,15
0.618,0.001,753,751,25,25,0.001,1504,15
0.63,0.001,808,796,25,25,0.001,1604,15
0.644,0.001,857,847,25,25,0.001,1704,15
0.662,0.001,902,902,25,25,0.001,1804,15
0.674,0.001,960,944,25,25,0.001,1904,15
0.7,0.001,1011,993,25,25,0.001,2004,15
0.496,0.001,58,46,25,25,0.001,104,16
0.498,0.001,108,96,25,25,0.001,204,16
0.5,0.001,155,149,25,25,0.001,304,16
0.508,0.001,209,195,25,25,0.001,404,16
0.508,0.001,260,244,25,25,0.001,504,16
0.512,0.001,317,287,25,25,0.001,604,16
0.518,0.001,369,335,25,25,0.001,704,16
0.52,0.001,417,387,25,25,0.001,804,16
0.526,0.001,457,447,25,25,0.001,904,16
0.544,0.001,510,494,25,25,0.001,1004,16
0.558,0.001,550,554,25,25,0.001,1104,16
0.58,0.001,605,599,25,25,0.001,1204,16
0.608,0.001,658,646,25,25,0.001,1304,16
0.628,0.001,709,695,25,25,0.001,1404,16
0.654,0.001,766,738,25,25,0.001,1504,16
0.67,0.001,819,785,25,25,0.001,1604,16
0.696,0.001,863,841,25,25,0.001,1704,16
0.716,0.001,917,887,25,25,0.001,1804,16
0.722,0.001,963,941,25,25,0.001,1904,16
0.746,0.001,1008,996,25,25,0.001,2004,16
0.496,0.001,52,52,25,25,0.001,104,17
0.5,0.001,105,99,25,25,0.001,204,17
0.504,0.001,157,147,25,25,0.001,304,17
0.51,0.001,213,191,25,25,0.001,404,17
0.51,0.001,266,238,25,25,0.001,504,17
0.514,0.001,322,282,25,25,0.001,604,17
0.51,0.001,373,331,25,25,0.001,704,17
0.518,0.001,433,371,25,25,0.001,804,17
0.524,0.001,476,428,25,25,0.001,904,17
0.522,0.001,521,483,25,25,0.001,1004,17
0.52,0.001,565,539,25,25,0.001,1104,17
0.526,0.001,616,588,25,25,0.001,1204,17
0.53,0.001,668,636,25,25,0.001,1304,17
0.546,0.001,710,694,25,25,0.001,1404,17
0.564,0.001,749,755,25,25,0.001,1504,17
0.572,0.001,801,803,25,25,0.001,1604,17
0.574,0.001,849,855,25,25,0.001,1704,17
0.584,0.001,899,905,25,25,0.001,1804,17
0.6,0.001,955,949,25,25,0.001,1904,17
0.626,0.001,1007,997,25,25,0.001,2004,17
0.472,0.001,50,54,25,25,0.001,104,18
0.48,0.001,104,100,25,25,0.001,204,18
0.482,0.001,156,148,25,25,0.001,304,18
0.476,0.001,204,200,25,25,0.001,404,18
0.488,0.001,246,258,25,25,0.001,504,18
0.5,0.001,286,318,25,25,0.001,604,18
0.496,0.001,332,372,25,25,0.001,704,18
0.502,0.001,385,419,25,25,0.001,804,18
0.512,0.001,431,473,25,25,0.001,904,18
0.514,0.001,491,513,25,25,0.001,1004,18
0.526,0.001,551,553,25,25,0.001,1104,18
0.53,0.001,599,605,25,25,0.001,1204,18
0.536,0.001,652,652,25,25,0.001,1304,18
0.568,0.001,706,698,25,25,0.001,1404,18
0.58,0.001,757,747,25,25,0.001,1504,18
0.592,0.001,803,801,25,25,0.001,1604,18
0.594,0.001,841,863,25,25,0.001,1704,18
0.616,0.001,895,909,25,25,0.001,1804,18
0.618,0.001,940,964,25,25,0.001,1904,18
0.644,0.001,985,1019,25,25,0.001,2004,18
0.514,0.001,56,48,25,25,0.001,104,19
0.512,0.001,104,100,25,25,0.001,204,19
0.512,0.001,156,148,25,25,0.001,304,19
0.516,0.001,208,196,25,25,0.001,404,19
0.516,0.001,261,243,25,25,0.001,504,19
0.524,0.001,311,293,25,25,0.001,604,19
0.518,0.001,367,337,25,25,0.001,704,19
0.524,0.001,416,388,25,25,0.001,804,19
0.534,0.001,470,434,25,25,0.001,904,19
0.552,0.001,517,487,25,25,0.001,1004,19
0.586,0.001,566,538,25,25,0.001,1104,19
0.588,0.001,616,588,25,25,0.001,1204,19
0.608,0.001,667,637,25,25,0.001,1304,19
0.614,0.001,718,686,25,25,0.001,1404,19
0.624,0.001,764,740,25,25,0.001,1504,19
0.636,0.001,811,793,25,25,0.001,1604,19
0.65,0.001,861,843,25,25,0.001,1704,19
0.66,0.001,905,899,25,25,0.001,1804,19
0.674,0.001,951,953,25,25,0.001,1904,19
0.692,0.001,994,1010,25,25,0.001,2004,19
0.47,0.001,60,44,25,25,0.001,104,20
0.466,0.001,104,100,25,25,0.001,204,20
0.47,0.001,154,150,25,25,0.001,304,20
0.466,0.001,204,200,25,25,0.001,404,20
0.47,0.001,248,256,25,25,0.001,504,20
0.48,0.001,302,302,25,25,0.001,604,20
0.492,0.001,351,353,25,25,0.001,704,20
0.498,0.001,398,406,25,25,0.001,804,20
0.5,0.001,450,454,25,25,0.001,904,20
0.504,0.001,489,515,25,25,0.001,1004,20
0.514,0.001,535,569,25,25,0.001,1104,20
0.528,0.001,584,620,25,25,0.001,1204,20
0.538,0.001,631,673,25,25,0.001,1304,20
0.544,0.001,685,719,25,25,0.001,1404,20
0.548,0.001,740,764,25,25,0.001,1504,20
0.56,0.001,790,814,25,25,0.001,1604,20
0.578,0.001,831,873,25,25,0.001,1704,20
0.6,0.001,879,925,25,25,0.001,1804,20
0.614,0.001,935,969,25,25,0.001,1904,20
0.634,0.001,984,1020,25,25,0.001,2004,20
0.564,0.001,59,45,25,25,0.01,104,1
0.568,0.001,101,103,25,25,0.01,204,1
0.556,0.001,147,157,25,25,0.01,304,1
0.554,0.001,191,213,25,25,0.01,404,1
0.55,0.001,226,278,25,25,0.01,504,1
0.574,0.001,279,325,25,25,0.01,604,1
0.588,0.001,327,377,25,25,0.01,704,1
0.638,0.001,383,421,25,25,0.01,804,1
0.68,0.001,436,468,25,25,0.01,904,1
0.73,0.001,486,518,25,25,0.01,1004,1
0.768,0.001,535,569,25,25,0.01,1104,1
0.818,0.001,576,628,25,25,0.01,1204,1
0.858,0.001,636,668,25,25,0.01,1304,1
0.89,0.001,683,721,25,25,0.01,1404,1
0.9,0.001,731,773,25,25,0.01,1504,1
0.926,0.001,779,825,25,25,0.01,1604,1
0.934,0.001,834,870,25,25,0.01,1704,1
0.946,0.001,890,914,25,25,0.01,1804,1
0.95,0.001,941,963,25,25,0.01,1904,1
0.952,0.001,990,1014,25,25,0.01,2004,1
0.522,0.001,45,59,25,25,0.01,104,2
0.546,0.001,92,112,25,25,0.01,204,2
0.554,0.001,144,160,25,25,0.01,304,2
0.532,0.001,200,204,25,25,0.01,404,2
0.56,0.001,250,254,25,25,0.01,504,2
0.608,0.001,306,298,25,25,0.01,604,2
0.642,0.001,368,336,25,25,0.01,704,2
0.666,0.001,420,384,25,25,0.01,804,2
0.714,0.001,471,433,25,25,0.01,904,2
0.746,0.001,524,480,25,25,0.01,1004,2
0.812,0.001,572,532,25,25,0.01,1104,2
0.87,0.001,619,585,25,25,0.01,1204,2
0.908,0.001,666,638,25,25,0.01,1304,2
0.946,0.001,709,695,25,25,0.01,1404,2
0.948,0.001,750,754,25,25,0.01,1504,2
0.946,0.001,807,797,25,25,0.01,1604,2
0.948,0.001,856,848,25,25,0.01,1704,2
0.952,0.001,901,903,25,25,0.01,1804,2
0.958,0.001,943,961,25,25,0.01,1904,2
0.964,0.001,1002,1002,25,25,0.01,2004,2
0.516,0.001,53,51,25,25,0.01,104,3
0.572,0.001,106,98,25,25,0.01,204,3
0.582,0.001,151,153,25,25,0.01,304,3
0.616,0.001,205,199,25,25,0.01,404,3
0.66,0.001,258,246,25,25,0.01,504,3
0.694,0.001,311,293,25,25,0.01,604,3
0.694,0.001,365,339,25,25,0.01,704,3
0.736,0.001,415,389,25,25,0.01,804,3
0.742,0.001,462,442,25,25,0.01,904,3
0.808,0.001,511,493,25,25,0.01,1004,3
0.848,0.001,558,546,25,25,0.01,1104,3
0.91,0.001,614,590,25,25,0.01,1204,3
0.91,0.001,662,642,25,25,0.01,1304,3
0.936,0.001,713,691,25,25,0.01,1404,3
0.942,0.001,760,744,25,25,0.01,1504,3
0.948,0.001,817,787,25,25,0.01,1604,3
0.948,0.001,871,833,25,25,0.01,1704,3
0.954,0.001,922,882,25,25,0.01,1804,3
0.956,0.001,968,936,25,25,0.01,1904,3
0.958,0.001,1020,984,25,25,0.01,2004,3
0.516,0.001,48,56,25,25,0.01,104,4
0.538,0.001,98,106,25,25,0.01,204,4
0.57,0.001,149,155,25,25,0.01,304,4
0.608,0.001,196,208,25,25,0.01,404,4
0.648,0.001,254,250,25,25,0.01,504,4
0.668,0.001,302,302,25,25,0.01,604,4
0.714,0.001,350,354,25,25,0.01,704,4
0.742,0.001,401,403,25,25,0.01,804,4
0.798,0.001,446,458,25,25,0.01,904,4
0.844,0.001,492,512,25,25,0.01,1004,4
0.88,0.001,553,551,25,25,0.01,1104,4
0.908,0.001,603,601,25,25,0.01,1204,4
0.91,0.001,655,649,25,25,0.01,1304,4
0.932,0.001,704,700,25,25,0.01,1404,4
0.944,0.001,760,744,25,25,0.01,1504,4
0.952,0.001,804,800,25,25,0.01,1604,4
0.952,0.001,854,850,25,25,0.01,1704,4
0.958,0.001,904,900,25,25,0.01,1804,4
0.962,0.001,950,954,25,25,0.01,1904,4
0.966,0.001,999,1005,25,25,0.01,2004,4
0.51,0.001,45,59,25,25,0.01,104,5
0.51,0.001,95,109,25,25,0.01,204,5
0.558,0.001,134,170,25,25,0.01,304,5
0.574,0.001,188,216,25,25,0.01,404,5
0.574,0.001,236,268,25,25,0.01,504,5
0.606,0.001,291,313,25,25,0.01,604,5
0.642,0.001,345,359,25,25,0.01,704,5
0.722,0.001,397,407,25,25,0.01,804,5
0.764,0.001,447,457,25,25,0.01,904,5
0.796,0.001,499,505,25,25,0.01,1004,5
0.846,0.001,547,557,25,25,0.01,1104,5
0.9,0.001,606,598,25,25,0.01,1204,5
0.93,0.001,658,646,25,25,0.01,1304,5
0.944,0.001,700,704,25,25,0.01,1404,5
0.954,0.001,751,753,25,25,0.01,1504,5
0.964,0.001,790,814,25,25,0.01,1604,5
0.97,0.001,844,860,25,25,0.01,1704,5
0.968,0.001,902,902,25,25,0.01,1804,5
0.964,0.001,951,953,25,25,0.01,1904,5
0.964,0.001,1007,997,25,25,0.01,2004,5
0.516,0.001,49,55,25,25,0.01,104,6
0.546,0.001,95,109,25,25,0.01,204,6
0.586,0.001,144,160,25,25,0.01,304,6
0.602,0.001,198,206,25,25,0.01,404,6
0.634,0.001,249,255,25,25,0.01,504,6
0.668,0.001,290,314,25,25,0.01,604,6
0.674,0.001,337,367,25,25,0.01,704,6
0.694,0.001,390,414,25,25,0.01,804,6
0.764,0.001,441,463,25,25,0.01,904,6
0.814,0.001,491,513,25,25,0.01,1004,6
0.848,0.001,546,558,25,25,0.01,1104,6
0.878,0.001,594,610,25,25,0.01,1204,6
0.894,0.001,649,655,25,25,0.01,1304,6
0.914,0.001,696,708,25,25,0.01,1404,6
0.922,0.001,752,752,25,25,0.01,1504,6
0.926,0.001,799,805,25,25,0.01,1604,6
0.94,0.001,844,860,25,25,0.01,1704,6
0.942,0.001,894,910,25,25,0.01,1804,6
0.952,0.001,948,956,25,25,0.01,1904,6
0.95,0.001,997,1007,25,25,0.01,2004,6
0.522,0.001,51,53,25,25,0.01,104,7
0.528,0.001,107,97,25,25,0.01,204,7
0.544,0.001,155,149,25,25,0.01,304,7
0.534,0.001,211,193,25,25,0.01,404,7
0.534,0.001,255,249,25,25,0.01,504,7
0.584,0.001,308,296,25,25,0.01,604,7
0.612,0.001,358,346,25,25,0.01,704,7
0.672,0.001,404,400,25,25,0.01,804,7
0.736,0.001,453,451,25,25,0.01,904,7
0.788,0.001,509,495,25,25,0.01,1004,7
0.822,0.001,559,545,25,25,0.01,1104,7
0.88,0.001,610,594,25,25,0.01,1204,7
0.91,0.001,660,644,25,25,0.01,1304,7
0.928,0.001,715,689,25,25,0.01,1404,7
0.932,0.001,764,740,25,25,0.01,1504,7
0.942,0.001,819,785,25,25,0.01,1604,7
0.95,0.001,869,835,25,25,0.01,1704,7
0.952,0.001,908,896,25,25,0.01,1804,7
0.962,0.001,960,944,25,25,0.01,1904,7
0.958,0.001,1008,996,25,25,0.01,2004,7
0.524,0.001,48,56,25,25,0.01,104,8
0.546,0.001,98,106,25,25,0.01,204,8
0.526,0.001,148,156,25,25,0.01,304,8
0.52,0.001,195,209,25,25,0.01,404,8
0.538,0.001,232,272,25,25,0.01,504,8
0.572,0.001,290,314,25,25,0.01,604,8
0.624,0.001,336,368,25,25,0.01,704,8
0.664,0.001,384,420,25,25,0.01,804,8
0.704,0.001,447,457,25,25,0.01,904,8
0.758,0.001,496,508,25,25,0.01,1004,8
0.808,0.001,548,556,25,25,0.01,1104,8
0.86,0.001,599,605,25,25,0.01,1204,8
0.884,0.001,644,660,25,25,0.01,1304,8
0.902,0.001,696,708,25,25,0.01,1404,8
0.92,0.001,752,752,25,25,0.01,1504,8
0.938,0.001,796,808,25,25,0.01,1604,8
0.956,0.001,855,849,25,25,0.01,1704,8
0.95,0.001,902,902,25,25,0.01,1804,8
0.956,0.001,956,948,25,25,0.01,1904,8
0.964,0.001,996,1008,25,25,0.01,2004,8
0.54,0.001,47,57,25,25,0.01,104,9
0.566,0.001,98,106,25,25,0.01,204,9
0.582,0.001,146,158,25,25,0.01,304,9
0.6,0.001,198,206,25,25,0.01,404,9
0.61,0.001,254,250,25,25,0.01,504,9
0.616,0.001,301,303,25,25,0.01,604,9
0.658,0.001,355,349,25,25,0.01,704,9
0.706,0.001,406,398,25,25,0.01,804,9
0.746,0.001,457,447,25,25,0.01,904,9
0.808,0.001,505,499,25,25,0.01,1004,9
0.864,0.001,558,546,25,25,0.01,1104,9
0.904,0.001,609,595,25,25,0.01,1204,9
0.914,0.001,665,639,25,25,0.01,1304,9
0.942,0.001,720,684,25,25,0.01,1404,9
0.946,0.001,765,739,25,25,0.01,1504,9
0.942,0.001,815,789,25,25,0.01,1604,9
0.938,0.001,863,841,25,25,0.01,1704,9
0.948,0.001,905,899,25,25,0.01,1804,9
0.954,0.001,955,949,25,25,0.01,1904,9
0.954,0.001,995,1009,25,25,0.01,2004,9
0.504,0.001,55,49,25,25,0.01,104,10
0.536,0.001,114,90,25,25,0.01,204,10
0.57,0.001,164,140,25,25,0.01,304,10
0.588,0.001,209,195,25,25,0.01,404,10
0.618,0.001,259,245,25,25,0.01,504,10
0.634,0.001,313,291,25,25,0.01,604,10
0.672,0.001,363,341,25,25,0.01,704,10
0.736,0.001,409,395,25,25,0.01,804,10
0.766,0.001,462,442,25,25,0.01,904,10
0.834,0.001,510,494,25,25,0.01,1004,10
0.854,0.001,567,537,25,25,0.01,1104,10
0.902,0.001,615,589,25,25,0.01,1204,10
0.934,0.001,670,634,25,25,0.01,1304,10
0.94,0.001,714,690,25,25,0.01,1404,10
0.944,0.001,760,744,25,25,0.01,1504,10
0.944,0.001,809,795,25,25,0.01,1604,10
0.958,0.001,863,841,25,25,0.01,1704,10
0.956,0.001,910,894,25,25,0.01,1804,10
0.952,0.001,960,944,25,25,0.01,1904,10
0.956,0.001,1009,995,25,25,0.01,2004,10
0.502,0.001,48,56,25,25,0.01,104,11
0.536,0.001,101,103,25,25,0.01,204,11
0.562,0.001,152,152,25,25,0.01,304,11
0.572,0.001,202,202,25,25,0.01,404,11
0.608,0.001,262,242,25,25,0.01,504,11
0.652,0.001,310,294,25,25,0.01,604,11
0.694,0.001,366,338,25,25,0.01,704,11
0.732,0.001,419,385,25,25,0.01,804,11
0.796,0.001,469,435,25,25,0.01,904,11
0.846,0.001,523,481,25,25,0.01,1004,11
0.868,0.001,575,529,25,25,0.01,1104,11
0.898,0.001,623,581,25,25,0.01,1204,11
0.926,0.001,668,636,25,25,0.01,1304,11
0.948,0.001,724,680,25,25,0.01,1404,11
0.948,0.001,772,732,25,25,0.01,1504,11
0.954,0.001,821,783,25,25,0.01,1604,11
0.956,0.001,867,837,25,25,0.01,1704,11
0.968,0.001,906,898,25,25,0.01,1804,11
0.962,0.001,958,946,25,25,0.01,1904,11
0.964,0.001,1013,991,25,25,0.01,2004,11
0.504,0.001,54,50,25,25,0.01,104,12
0.544,0.001,107,97,25,25,0.01,204,12
0.534,0.001,151,153,25,25,0.01,304,12
0.554,0.001,200,204,25,25,0.01,404,12
0.562,0.001,257,247,25,25,0.01,504,12
0.61,0.001,314,290,25,25,0.01,604,12
0.638,0.001,368,336,25,25,0.01,704,12
0.698,0.001,422,382,25,25,0.01,804,12
0.73,0.001,467,437,25,25,0.01,904,12
0.784,0.001,514,490,25,25,0.01,1004,12
0.836,0.001,567,537,25,25,0.01,1104,12
0.894,0.001,616,588,25,25,0.01,1204,12
0.926,0.001,671,633,25,25,0.01,1304,12
0.936,0.001,719,685,25,25,0.01,1404,12
0.946,0.001,758,746,25,25,0.01,1504,12
0.954,0.001,801,803,25,25,0.01,1604,12
0.966,0.001,852,852,25,25,0.01,1704,12
0.958,0.001,900,904,25,25,0.01,1804,12
0.964,0.001,953,951,25,25,0.01,1904,12
0.972,0.001,996,1008,25,25,0.01,2004,12
0.508,0.001,59,45,25,25,0.01,104,13
0.52,0.001,103,101,25,25,0.01,204,13
0.514,0.001,158,146,25,25,0.01,304,13
0.566,0.001,210,194,25,25,0.01,404,13
0.592,0.001,255,249,25,25,0.01,504,13
0.66,0.001,310,294,25,25,0.01,604,13
0.694,0.001,358,346,25,25,0.01,704,13
0.704,0.001,407,397,25,25,0.01,804,13
0.724,0.001,459,445,25,25,0.01,904,13
0.782,0.001,511,493,25,25,0.01,1004,13
0.828,0.001,563,541,25,25,0.01,1104,13
0.862,0.001,611,593,25,25,0.01,1204,13
0.874,0.001,662,642,25,25,0.01,1304,13
0.908,0.001,716,688,25,25,0.01,1404,13
0.932,0.001,764,740,25,25,0.01,1504,13
0.946,0.001,811,793,25,25,0.01,1604,13
0.948,0.001,861,843,25,25,0.01,1704,13
0.96,0.001,913,891,25,25,0.01,1804,13
0.96,0.001,959,945,25,25,0.01,1904,13
0.97,0.001,1010,994,25,25,0.01,2004,13
0.554,0.001,57,47,25,25,0.01,104,14
0.538,0.001,116,88,25,25,0.01,204,14
0.538,0.001,169,135,25,25,0.01,304,14
0.506,0.001,226,178,25,25,0.01,404,14
0.542,0.001,273,231,25,25,0.01,504,14
0.568,0.001,322,282,25,25,0.01,604,14
0.612,0.001,373,331,25,25,0.01,704,14
0.652,0.001,432,372,25,25,0.01,804,14
0.67,0.001,476,428,25,25,0.01,904,14
0.72,0.001,513,491,25,25,0.01,1004,14
0.742,0.001,557,547,25,25,0.01,1104,14
0.822,0.001,613,591,25,25,0.01,1204,14
0.872,0.001,667,637,25,25,0.01,1304,14
0.924,0.001,722,682,25,25,0.01,1404,14
0.952,0.001,773,731,25,25,0.01,1504,14
0.968,0.001,823,781,25,25,0.01,1604,14
0.972,0.001,866,838,25,25,0.01,1704,14
0.972,0.001,914,890,25,25,0.01,1804,14
0.974,0.001,958,946,25,25,0.01,1904,14
0.978,0.001,1001,1003,25,25,0.01,2004,14
0.492,0.001,50,54,25,25,0.01,104,15
0.524,0.001,101,103,25,25,0.01,204,15
0.564,0.001,150,154,25,25,0.01,304,15
0.632,0.001,198,206,25,25,0.01,404,15
0.674,0.001,246,258,25,25,0.01,504,15
0.702,0.001,300,304,25,25,0.01,604,15
0.732,0.001,350,354,25,25,0.01,704,15
0.768,0.001,403,401,25,25,0.01,804,15
0.82,0.001,452,452,25,25,0.01,904,15
0.87,0.001,500,504,25,25,0.01,1004,15
0.904,0.001,552,552,25,25,0.01,1104,15
0.924,0.001,614,590,25,25,0.01,1204,15
0.938,0.001,665,639,25,25,0.01,1304,15
0.94,0.001,722,682,25,25,0.01,1404,15
0.95,0.001,767,737,25,25,0.01,1504,15
0.946,0.001,819,785,25,25,0.01,1604,15
0.946,0.001,862,842,25,25,0.01,1704,15
0.952,0.001,905,899,25,25,0.01,1804,15
0.956,0.001,957,947,25,25,0.01,1904,15
0.96,0.001,1011,993,25,25,0.01,2004,15
0.548,0.001,46,58,25,25,0.01,104,16
0.59,0.001,96,108,25,25,0.01,204,16
0.608,0.001,149,155,25,25,0.01,304,16
0.634,0.001,197,207,25,25,0.01,404,16
0.638,0.001,253,251,25,25,0.01,504,16
0.658,0.001,305,299,25,25,0.01,604,16
0.696,0.001,346,358,25,25,0.01,704,16
0.754,0.001,401,403,25,25,0.01,804,16
0.818,0.001,451,453,25,25,0.01,904,16
0.836,0.001,500,504,25,25,0.01,1004,16
0.856,0.001,553,551,25,25,0.01,1104,16
0.896,0.001,600,604,25,25,0.01,1204,16
0.9,0.001,654,650,25,25,0.01,1304,16
0.924,0.001,702,702,25,25,0.01,1404,16
0.952,0.001,754,750,25,25,0.01,1504,16
0.958,0.001,798,806,25,25,0.01,1604,16
0.958,0.001,846,858,25,25,0.01,1704,16
0.97,0.001,897,907,25,25,0.01,1804,16
0.968,0.001,944,960,25,25,0.01,1904,16
0.972,0.001,1003,1001,25,25,0.01,2004,16
0.494,0.001,38,66,25,25,0.01,104,17
0.51,0.001,82,122,25,25,0.01,204,17
0.506,0.001,136,168,25,25,0.01,304,17
0.516,0.001,191,213,25,25,0.01,404,17
0.55,0.001,237,267,25,25,0.01,504,17
0.612,0.001,276,328,25,25,0.01,604,17
0.644,0.001,326,378,25,25,0.01,704,17
0.696,0.001,386,418,25,25,0.01,804,17
0.748,0.001,433,471,25,25,0.01,904,17
0.8,0.001,488,516,25,25,0.01,1004,17
0.834,0.001,534,570,25,25,0.01,1104,17
0.896,0.001,581,623,25,25,0.01,1204,17
0.914,0.001,638,666,25,25,0.01,1304,17
0.944,0.001,682,722,25,25,0.01,1404,17
0.954,0.001,726,778,25,25,0.01,1504,17
0.956,0.001,780,824,25,25,0.01,1604,17
0.962,0.001,837,867,25,25,0.01,1704,17
0.962,0.001,899,905,25,25,0.01,1804,17
0.968,0.001,953,951,25,25,0.01,1904,17
0.974,0.001,996,1008,25,25,0.01,2004,17
0.498,0.001,57,47,25,25,0.01,104,18
0.518,0.001,104,100,25,25,0.01,204,18
0.542,0.001,157,147,25,25,0.01,304,18
0.558,0.001,202,202,25,25,0.01,404,18
0.592,0.001,247,257,25,25,0.01,504,18
0.62,0.001,292,312,25,25,0.01,604,18
0.678,0.001,338,366,25,25,0.01,704,18
0.752,0.001,392,412,25,25,0.01,804,18
0.796,0.001,441,463,25,25,0.01,904,18
0.836,0.001,492,512,25,25,0.01,1004,18
0.868,0.001,537,567,25,25,0.01,1104,18
0.902,0.001,590,614,25,25,0.01,1204,18
0.916,0.001,641,663,25,25,0.01,1304,18
0.944,0.001,690,714,25,25,0.01,1404,18
0.952,0.001,734,770,25,25,0.01,1504,18
0.952,0.001,791,813,25,25,0.01,1604,18
0.96,0.001,840,864,25,25,0.01,1704,18
0.962,0.001,893,911,25,25,0.01,1804,18
0.966,0.001,944,960,25,25,0.01,1904,18
0.968,0.001,991,1013,25,25,0.01,2004,18
0.482,0.001,52,52,25,25,0.01,104,19
0.526,0.001,100,104,25,25,0.01,204,19
0.594,0.001,154,150,25,25,0.01,304,19
0.666,0.001,208,196,25,25,0.01,404,19
0.682,0.001,263,241,25,25,0.01,504,19
0.702,0.001,305,299,25,25,0.01,604,19
0.714,0.001,366,338,25,25,0.01,704,19
0.734,0.001,409,395,25,25,0.01,804,19
0.78,0.001,455,449,25,25,0.01,904,19
0.87,0.001,508,496,25,25,0.01,1004,19
0.916,0.001,563,541,25,25,0.01,1104,19
0.93,0.001,618,586,25,25,0.01,1204,19
0.95,0.001,668,636,25,25,0.01,1304,19
0.962,0.001,722,682,25,25,0.01,1404,19
0.962,0.001,771,733,25,25,0.01,1504,19
0.966,0.001,816,788,25,25,0.01,1604,19
0.972,0.001,872,832,25,25,0.01,1704,19
0.976,0.001,915,889,25,25,0.01,1804,19
0.976,0.001,964,940,25,25,0.01,1904,19
0.98,0.001,1010,994,25,25,0.01,2004,19
0.556,0.001,48,56,25,25,0.01,104,20
0.568,0.001,100,104,25,25,0.01,204,20
0.572,0.001,148,156,25,25,0.01,304,20
0.612,0.001,191,213,25,25,0.01,404,20
0.624,0.001,239,265,25,25,0.01,504,20
0.664,0.001,290,314,25,25,0.01,604,20
0.71,0.001,350,354,25,25,0.01,704,20
0.736,0.001,403,401,25,25,0.01,804,20
0.786,0.001,450,454,25,25,0.01,904,20
0.818,0.001,492,512,25,25,0.01,1004,20
0.822,0.001,544,560,25,25,0.01,1104,20
0.892,0.001,597,607,25,25,0.01,1204,20
0.924,0.001,644,660,25,25,0.01,1304,20
0.934,0.001,691,713,25,25,0.01,1404,20
0.95,0.001,736,768,25,25,0.01,1504,20
0.954,0.001,784,820,25,25,0.01,1604,20
0.956,0.001,833,871,25,25,0.01,1704,20
0.966,0.001,880,924,25,25,0.01,1804,20
0.972,0.001,933,971,25,25,0.01,1904,20
0.976,0.001,982,1022,25,25,0.01,2004,20
0.502,1e-05,57,47,25,50,0.0001,104,1
0.502,1e-05,107,97,25,50,0.0001,204,1
0.506,1e-05,156,148,25,50,0.0001,304,1
0.51,1e-05,209,195,25,50,0.0001,404,1
0.512,1e-05,254,250,25,50,0.0001,504,1
0.516,1e-05,310,294,25,50,0.0001,604,1
0.518,1e-05,345,359,25,50,0.0001,704,1
0.52,1e-05,395,409,25,50,0.0001,804,1
0.52,1e-05,441,463,25,50,0.0001,904,1
0.524,1e-05,494,510,25,50,0.0001,1004,1
0.524,1e-05,547,557,25,50,0.0001,1104,1
0.524,1e-05,596,608,25,50,0.0001,1204,1
0.526,1e-05,646,658,25,50,0.0001,1304,1
0.53,1e-05,698,706,25,50,0.0001,1404,1
0.53,1e-05,751,753,25,50,0.0001,1504,1
0.536,1e-05,799,805,25,50,0.0001,1604,1
0.542,1e-05,857,847,25,50,0.0001,1704,1
0.544,1e-05,908,896,25,50,0.0001,1804,1
0.548,1e-05,959,945,25,50,0.0001,1904,1
0.546,1e-05,1015,989,25,50,0.0001,2004,1
0.556,1e-05,50,54,25,50,0.0001,104,2
0.556,1e-05,102,102,25,50,0.0001,204,2
0.556,1e-05,154,150,25,50,0.0001,304,2
0.556,1e-05,198,206,25,50,0.0001,404,2
0.556,1e-05,249,255,25,50,0.0001,504,2
0.556,1e-05,303,301,25,50,0.0001,604,2
0.56,1e-05,358,346,25,50,0.0001,704,2
0.56,1e-05,410,394,25,50,0.0001,804,2
0.56,1e-05,462,442,25,50,0.0001,904,2
0.568,1e-05,514,490,25,50,0.0001,1004,2
0.572,1e-05,567,537,25,50,0.0001,1104,2
0.576,1e-05,610,594,25,50,0.0001,1204,2
0.576,1e-05,666,638,25,50,0.0001,1304,2
0.576,1e-05,718,686,25,50,0.0001,1404,2
0.58,1e-05,768,736,25,50,0.0001,1504,2
0.582,1e-05,816,788,25,50,0.0001,1604,2
0.582,1e-05,855,849,25,50,0.0001,1704,2
0.58,1e-05,908,896,25,50,0.0001,1804,2
0.578,1e-05,957,947,25,50,0.0001,1904,2
0.584,1e-05,1018,986,25,50,0.0001,2004,2
0.504,1e-05,54,50,25,50,0.0001,104,3
0.504,1e-05,98,106,25,50,0.0001,204,3
0.504,1e-05,142,162,25,50,0.0001,304,3
0.506,1e-05,184,220,25,50,0.0001,404,3
0.506,1e-05,239,265,25,50,0.0001,504,3
0.506,1e-05,294,310,25,50,0.0001,604,3
0.506,1e-05,350,354,25,50,0.0001,704,3
0.508,1e-05,404,400,25,50,0.0001,804,3
0.508,1e-05,451,453,25,50,0.0001,904,3
0.512,1e-05,506,498,25,50,0.0001,1004,3
0.516,1e-05,552,552,25,50,0.0001,1104,3
0.514,1e-05,599,605,25,50,0.0001,1204,3
0.514,1e-05,647,657,25,50,0.0001,1304,3
0.516,1e-05,696,708,25,50,0.0001,1404,3
0.516,1e-05,755,749,25,50,0.0001,1504,3
0.518,1e-05,796,808,25,50,0.0001,1604,3
0.522,1e-05,848,856,25,50,0.0001,1704,3
0.52,1e-05,901,903,25,50,0.0001,1804,3
0.522,1e-05,950,954,25,50,0.0001,1904,3
0.522,1e-05,1001,1003,25,50,0.0001,2004,3
0.452,1e-05,57,47,25,50,0.0001,104,4
0.452,1e-05,102,102,25,50,0.0001,204,4
0.454,1e-05,144,160,25,50,0.0001,304,4
0.452,1e-05,201,203,25,50,0.0001,404,4
0.452,1e-05,239,265,25,50,0.0001,504,4
0.452,1e-05,298,306,25,50,0.0001,604,4
0.454,1e-05,350,354,25,50,0.0001,704,4
0.46,1e-05,392,412,25,50,0.0001,804,4
0.46,1e-05,438,466,25,50,0.0001,904,4
0.462,1e-05,494,510,25,50,0.0001,1004,4
0.46,1e-05,549,555,25,50,0.0001,1104,4
0.458,1e-05,596,608,25,50,0.0001,1204,4
0.458,1e-05,647,657,25,50,0.0001,1304,4
0.466,1e-05,696,708,25,50,0.0001,1404,4
0.47,1e-05,748,756,25,50,0.0001,1504,4
0.474,1e-05,803,801,25,50,0.0001,1604,4
0.48,1e-05,857,847,25,50,0.0001,1704,4
0.484,1e-05,907,897,25,50,0.0001,1804,4
0.492,1e-05,953,951,25,50,0.0001,1904,4
0.494,1e-05,999,1005,25,50,0.0001,2004,4
0.518,1e-05,55,49,25,50,0.0001,104,5
0.52,1e-05,115,89,25,50,0.0001,204,5
0.52,1e-05,167,137,25,50,0.0001,304,5
0.52,1e-05,222,182,25,50,0.0001,404,5
0.522,1e-05,277,227,25,50,0.0001,504,5
0.524,1e-05,326,278,25,50,0.0001,604,5
0.522,1e-05,374,330,25,50,0.0001,704,5
0.522,1e-05,422,382,25,50,0.0001,804,5
0.522,1e-05,474,430,25,50,0.0001,904,5
0.52,1e-05,529,475,25,50,0.0001,1004,5
0.522,1e-05,578,526,25,50,0.0001,1104,5
0.524,1e-05,620,584,25,50,0.0001,1204,5
0.526,1e-05,668,636,25,50,0.0001,1304,5
0.528,1e-05,719,685,25,50,0.0001,1404,5
0.526,1e-05,760,744,25,50,0.0001,1504,5
0.526,1e-05,801,803,25,50,0.0001,1604,5
0.528,1e-05,856,848,25,50,0.0001,1704,5
0.528,1e-05,909,895,25,50,0.0001,1804,5
0.53,1e-05,959,945,25,50,0.0001,1904,5
0.53,1e-05,1006,998,25,50,0.0001,2004,5
0.516,1e-05,49,55,25,50,0.0001,104,6
0.518,1e-05,97,107,25,50,0.0001,204,6
0.516,1e-05,153,151,25,50,0.0001,304,6
0.514,1e-05,205,199,25,50,0.0001,404,6
0.516,1e-05,252,252,25,50,0.0001,504,6
0.516,1e-05,303,301,25,50,0.0001,604,6
0.512,1e-05,343,361,25,50,0.0001,704,6
0.514,1e-05,392,412,25,50,0.0001,804,6
0.512,1e-05,433,471,25,50,0.0001,904,6
0.514,1e-05,486,518,25,50,0.0001,1004,6
0.514,1e-05,535,569,25,50,0.0001,1104,6
0.514,1e-05,580,624,25,50,0.0001,1204,6
0.514,1e-05,636,668,25,50,0.0001,1304,6
0.52,1e-05,684,720,25,50,0.0001,1404,6
0.522,1e-05,734,770,25,50,0.0001,1504,6
0.526,1e-05,782,822,25,50,0.0001,1604,6
0.526,1e-05,835,869,25,50,0.0001,1704,6
0.53,1e-05,894,910,25,50,0.0001,1804,6
0.534,1e-05,947,957,25,50,0.0001,1904,6
0.536,1e-05,1002,1002,25,50,0.0001,2004,6
0.488,1e-05,54,50,25,50,0.0001,104,7
0.488,1e-05,101,103,25,50,0.0001,204,7
0.49,1e-05,162,142,25,50,0.0001,304,7
0.49,1e-05,208,196,25,50,0.0001,404,7
0.49,1e-05,264,240,25,50,0.0001,504,7
0.492,1e-05,310,294,25,50,0.0001,604,7
0.492,1e-05,368,336,25,50,0.0001,704,7
0.494,1e-05,420,384,25,50,0.0001,804,7
0.49,1e-05,477,427,25,50,0.0001,904,7
0.49,1e-05,528,476,25,50,0.0001,1004,7
0.492,1e-05,579,525,25,50,0.0001,1104,7
0.492,1e-05,623,581,25,50,0.0001,1204,7
0.492,1e-05,674,630,25,50,0.0001,1304,7
0.494,1e-05,718,686,25,50,0.0001,1404,7
0.492,1e-05,767,737,25,50,0.0001,1504,7
0.494,1e-05,816,788,25,50,0.0001,1604,7
0.496,1e-05,869,835,25,50,0.0001,1704,7
0.5,1e-05,920,884,25,50,0.0001,1804,7
0.502,1e-05,970,934,25,50,0.0001,1904,7
0.51,1e-05,1015,989,25,50,0.0001,2004,7
0.496,1e-05,57,47,25,50,0.0001,104,8
0.498,1e-05,106,98,25,50,0.0001,204,8
0.5,1e-05,156,148,25,50,0.0001,304,8
0.504,1e-05,210,194,25,50,0.0001,404,8
0.504,1e-05,257,247,25,50,0.0001,504,8
0.504,1e-05,315,289,25,50,0.0001,604,8
0.506,1e-05,363,341,25,50,0.0001,704,8
0.506,1e-05,403,401,25,50,0.0001,804,8
0.506,1e-05,450,454,25,50,0.0001,904,8
0.51,1e-05,501,503,25,50,0.0001,1004,8
0.51,1e-05,551,553,25,50,0.0001,1104,8
0.512,1e-05,595,609,25,50,0.0001,1204,8
0.516,1e-05,652,652,25,50,0.0001,1304,8
0.516,1e-05,706,698,25,50,0.0001,1404,8
0.52,1e-05,752,752,25,50,0.0001,1504,8
0.524,1e-05,802,802,25,50,0.0001,1604,8
0.522,1e-05,851,853,25,50,0.0001,1704,8
0.524,1e-05,894,910,25,50,0.0001,1804,8
0.528,1e-05,949,955,25,50,0.0001,1904,8
0.528,1e-05,997,1007,25,50,0.0001,2004,8
0.49,1e-05,61,43,25,50,0.0001,104,9
0.492,1e-05,115,89,25,50,0.0001,204,9
0.492,1e-05,168,136,25,50,0.0001,304,9
0.496,1e-05,211,193,25,50,0.0001,404,9
0.496,1e-05,264,240,25,50,0.0001,504,9
0.498,1e-05,318,286,25,50,0.0001,604,9
0.502,1e-05,369,335,25,50,0.0001,704,9
0.502,1e-05,425,379,25,50,0.0001,804,9
0.504,1e-05,470,434,25,50,0.0001,904,9
0.504,1e-05,519,485,25,50,0.0001,1004,9
0.504,1e-05,565,539,25,50,0.0001,1104,9
0.504,1e-05,609,595,25,50,0.0001,1204,9
0.51,1e-05,659,645,25,50,0.0001,1304,9
0.512,1e-05,709,695,25,50,0.0001,1404,9
0.514,1e-05,764,740,25,50,0.0001,1504,9
0.518,1e-05,804,800,25,50,0.0001,1604,9
0.516,1e-05,856,848,25,50,0.0001,1704,9
0.516,1e-05,907,897,25,50,0.0001,1804,9
0.518,1e-05,956,948,25,50,0.0001,1904,9
0.524,1e-05,1005,999,25,50,0.0001,2004,9
0.47,1e-05,46,58,25,50,0.0001,104,10
0.472,1e-05,96,108,25,50,0.0001,204,10
0.472,1e-05,145,159,25,50,0.0001,304,10
0.474,1e-05,196,208,25,50,0.0001,404,10
0.478,1e-05,249,255,25,50,0.0001,504,10
0.474,1e-05,299,305,25,50,0.0001,604,10
0.472,1e-05,350,354,25,50,0.0001,704,10
0.474,1e-05,405,399,25,50,0.0001,804,10
0.474,1e-05,455,449,25,50,0.0001,904,10
0.474,1e-05,502,502,25,50,0.0001,1004,10
0.476,1e-05,547,557,25,50,0.0001,1104,10
0.476,1e-05,604,600,25,50,0.0001,1204,10
0.474,1e-05,653,651,25,50,0.0001,1304,10
0.474,1e-05,702,702,25,50,0.0001,1404,10
0.474,1e-05,757,747,25,50,0.0001,1504,10
0.474,1e-05,808,796,25,50,0.0001,1604,10
0.478,1e-05,857,847,25,50,0.0001,1704,10
0.48,1e-05,904,900,25,50,0.0001,1804,10
0.482,1e-05,959,945,25,50,0.0001,1904,10
0.488,1e-05,1008,996,25,50,0.0001,2004,10
0.554,1e-05,46,58,25,50,0.0001,104,11
0.56,1e-05,90,114,25,50,0.0001,204,11
0.562,1e-05,140,164,25,50,0.0001,304,11
0.56,1e-05,197,207,25,50,0.0001,404,11
0.558,1e-05,243,261,25,50,0.0001,504,11
0.56,1e-05,295,309,25,50,0.0001,604,11
0.558,1e-05,350,354,25,50,0.0001,704,11
0.562,1e-05,402,402,25,50,0.0001,804,11
0.566,1e-05,451,453,25,50,0.0001,904,11
0.568,1e-05,494,510,25,50,0.0001,1004,11
0.566,1e-05,539,565,25,50,0.0001,1104,11
0.564,1e-05,593,611,25,50,0.0001,1204,11
0.566,1e-05,647,657,25,50,0.0001,1304,11
0.568,1e-05,696,708,25,50,0.0001,1404,11
0.572,1e-05,740,764,25,50,0.0001,1504,11
0.574,1e-05,803,801,25,50,0.0001,1604,11
0.576,1e-05,859,845,25,50,0.0001,1704,11
0.58,1e-05,897,907,25,50,0.0001,1804,11
0.578,1e-05,942,962,25,50,0.0001,1904,11
0.578,1e-05,999,1005,25,50,0.0001,2004,11
0.504,1e-05,55,49,25,50,0.0001,104,12
0.504,1e-05,111,93,25,50,0.0001,204,12
0.504,1e-05,171,133,25,50,0.0001,304,12
0.506,1e-05,226,178,25,50,0.0001,404,12
0.506,1e-05,273,231,25,50,0.0001,504,12
0.508,1e-05,314,290,25,50,0.0001,604,12
0.508,1e-05,357,347,25,50,0.0001,704,12
0.51,1e-05,405,399,25,50,0.0001,804,12
0.51,1e-05,448,456,25,50,0.0001,904,12
0.504,1e-05,499,505,25,50,0.0001,1004,12
0.51,1e-05,545,559,25,50,0.0001,1104,12
0.512,1e-05,586,618,25,50,0.0001,1204,12
0.514,1e-05,633,671,25,50,0.0001,1304,12
0.516,1e-05,675,729,25,50,0.0001,1404,12
0.524,1e-05,727,777,25,50,0.0001,1504,12
0.528,1e-05,785,819,25,50,0.0001,1604,12
0.528,1e-05,851,853,25,50,0.0001,1704,12
0.532,1e-05,901,903,25,50,0.0001,1804,12
0.536,1e-05,956,948,25,50,0.0001,1904,12
0.54,1e-05,1009,995,25,50,0.0001,2004,12
0.488,1e-05,52,52,25,50,0.0001,104,13
0.486,1e-05,102,102,25,50,0.0001,204,13
0.486,1e-05,151,153,25,50,0.0001,304,13
0.48,1e-05,215,189,25,50,0.0001,404,13
0.48,1e-05,270,234,25,50,0.0001,504,13
0.48,1e-05,314,290,25,50,0.0001,604,13
0.48,1e-05,361,343,25,50,0.0001,704,13
0.482,1e-05,411,393,25,50,0.0001,804,13
0.484,1e-05,459,445,25,50,0.0001,904,13
0.484,1e-05,517,487,25,50,0.0001,1004,13
0.486,1e-05,559,545,25,50,0.0001,1104,13
0.488,1e-05,604,600,25,50,0.0001,1204,13
0.492,1e-05,655,649,25,50,0.0001,1304,13
0.496,1e-05,707,697,25,50,0.0001,1404,13
0.498,1e-05,763,741,25,50,0.0001,1504,13
0.504,1e-05,816,788,25,50,0.0001,1604,13
0.506,1e-05,868,836,25,50,0.0001,1704,13
0.51,1e-05,914,890,25,50,0.0001,1804,13
0.51,1e-05,960,944,25,50,0.0001,1904,13
0.512,1e-05,1003,1001,25,50,0.0001,2004,13
0.484,1e-05,57,47,25,50,0.0001,104,14
0.484,1e-05,105,99,25,50,0.0001,204,14
0.486,1e-05,157,147,25,50,0.0001,304,14
0.49,1e-05,201,203,25,50,0.0001,404,14
0.49,1e-05,255,249,25,50,0.0001,504,14
0.49,1e-05,302,302,25,50,0.0001,604,14
0.494,1e-05,357,347,25,50,0.0001,704,14
0.496,1e-05,410,394,25,50,0.0001,804,14
0.496,1e-05,469,435,25,50,0.0001,904,14
0.498,1e-05,527,477,25,50,0.0001,1004,14
0.5,1e-05,584,520,25,50,0.0001,1104,14
0.5,1e-05,634,570,25,50,0.0001,1204,14
0.5,1e-05,678,626,25,50,0.0001,1304,14
0.5,1e-05,722,682,25,50,0.0001,1404,14
0.5,1e-05,775,729,25,50,0.0001,1504,14
0.504,1e-05,818,786,25,50,0.0001,1604,14
0.506,1e-05,865,839,25,50,0.0001,1704,14
0.506,1e-05,910,894,25,50,0.0001,1804,14
0.506,1e-05,964,940,25,50,0.0001,1904,14
0.508,1e-05,1004,1000,25,50,0.0001,2004,14
0.522,1e-05,56,48,25,50,0.0001,104,15
0.522,1e-05,109,95,25,50,0.0001,204,15
0.52,1e-05,152,152,25,50,0.0001,304,15
0.518,1e-05,200,204,25,50,0.0001,404,15
0.516,1e-05,249,255,25,50,0.0001,504,15
0.518,1e-05,298,306,25,50,0.0001,604,15
0.518,1e-05,350,354,25,50,0.0001,704,15
0.518,1e-05,397,407,25,50,0.0001,804,15
0.52,1e-05,445,459,25,50,0.0001,904,15
0.524,1e-05,509,495,25,50,0.0001,1004,15
0.524,1e-05,557,547,25,50,0.0001,1104,15
0.524,1e-05,603,601,25,50,0.0001,1204,15
0.524,1e-05,654,650,25,50,0.0001,1304,15
0.526,1e-05,708,696,25,50,0.0001,1404,15
0.528,1e-05,750,754,25,50,0.0001,1504,15
0.526,1e-05,798,806,25,50,0.0001,1604,15
0.528,1e-05,851,853,25,50,0.0001,1704,15
0.526,1e-05,903,901,25,50,0.0001,1804,15
0.526,1e-05,958,946,25,50,0.0001,1904,15
0.53,1e-05,1005,999,25,50,0.0001,2004,15
0.482,1e-05,53,51,25,50,0.0001,104,16
0.482,1e-05,98,106,25,50,0.0001,204,16
0.482,1e-05,146,158,25,50,0.0001,304,16
0.484,1e-05,194,210,25,50,0.0001,404,16
0.484,1e-05,249,255,25,50,0.0001,504,16
0.484,1e-05,311,293,25,50,0.0001,604,16
0.486,1e-05,359,345,25,50,0.0001,704,16
0.486,1e-05,406,398,25,50,0.0001,804,16
0.486,1e-05,464,440,25,50,0.0001,904,16
0.484,1e-05,517,487,25,50,0.0001,1004,16
0.484,1e-05,565,539,25,50,0.0001,1104,16
0.482,1e-05,612,592,25,50,0.0001,1204,16
0.482,1e-05,665,639,25,50,0.0001,1304,16
0.484,1e-05,715,689,25,50,0.0001,1404,16
0.486,1e-05,776,728,25,50,0.0001,1504,16
0.488,1e-05,827,777,25,50,0.0001,1604,16
0.49,1e-05,874,830,25,50,0.0001,1704,16
0.49,1e-05,919,885,25,50,0.0001,1804,16
0.488,1e-05,970,934,25,50,0.0001,1904,16
0.488,1e-05,1018,986,25,50,0.0001,2004,16
0.51,1e-05,48,56,25,50,0.0001,104,17
0.51,1e-05,95,109,25,50,0.0001,204,17
0.512,1e-05,150,154,25,50,0.0001,304,17
0.512,1e-05,196,208,25,50,0.0001,404,17
0.514,1e-05,239,265,25,50,0.0001,504,17
0.518,1e-05,286,318,25,50,0.0001,604,17
0.52,1e-05,339,365,25,50,0.0001,704,17
0.522,1e-05,392,412,25,50,0.0001,804,17
0.52,1e-05,449,455,25,50,0.0001,904,17
0.524,1e-05,504,500,25,50,0.0001,1004,17
0.526,1e-05,550,554,25,50,0.0001,1104,17
0.528,1e-05,596,608,25,50,0.0001,1204,17
0.528,1e-05,646,658,25,50,0.0001,1304,17
0.532,1e-05,705,699,25,50,0.0001,1404,17
0.536,1e-05,754,750,25,50,0.0001,1504,17
0.538,1e-05,813,791,25,50,0.0001,1604,17
0.542,1e-05,861,843,25,50,0.0001,1704,17
0.54,1e-05,903,901,25,50,0.0001,1804,17
0.54,1e-05,955,949,25,50,0.0001,1904,17
0.542,1e-05,990,1014,25,50,0.0001,2004,17
0.556,1e-05,60,44,25,50,0.0001,104,18
0.554,1e-05,115,89,25,50,0.0001,204,18
0.554,1e-05,170,134,25,50,0.0001,304,18
0.554,1e-05,215,189,25,50,0.0001,404,18
0.554,1e-05,263,241,25,50,0.0001,504,18
0.552,1e-05,318,286,25,50,0.0001,604,18
0.554,1e-05,367,337,25,50,0.0001,704,18
0.554,1e-05,410,394,25,50,0.0001,804,18
0.556,1e-05,464,440,25,50,0.0001,904,18
0.556,1e-05,509,495,25,50,0.0001,1004,18
0.558,1e-05,553,551,25,50,0.0001,1104,18
0.56,1e-05,598,606,25,50,0.0001,1204,18
0.562,1e-05,656,648,25,50,0.0001,1304,18
0.56,1e-05,707,697,25,50,0.0001,1404,18
0.558,1e-05,754,750,25,50,0.0001,1504,18
0.558,1e-05,799,805,25,50,0.0001,1604,18
0.558,1e-05,853,851,25,50,0.0001,1704,18
0.562,1e-05,899,905,25,50,0.0001,1804,18
0.56,1e-05,943,961,25,50,0.0001,1904,18
0.564,1e-05,992,1012,25,50,0.0001,2004,18
0.514,1e-05,50,54,25,50,0.0001,104,19
0.514,1e-05,104,100,25,50,0.0001,204,19
0.514,1e-05,152,152,25,50,0.0001,304,19
0.51,1e-05,206,198,25,50,0.0001,404,19
0.51,1e-05,263,241,25,50,0.0001,504,19
0.51,1e-05,305,299,25,50,0.0001,604,19
0.512,1e-05,352,352,25,50,0.0001,704,19
0.516,1e-05,415,389,25,50,0.0001,804,19
0.514,1e-05,461,443,25,50,0.0001,904,19
0.516,1e-05,518,486,25,50,0.0001,1004,19
0.514,1e-05,573,531,25,50,0.0001,1104,19
0.516,1e-05,618,586,25,50,0.0001,1204,19
0.518,1e-05,663,641,25,50,0.0001,1304,19
0.516,1e-05,707,697,25,50,0.0001,1404,19
0.514,1e-05,755,749,25,50,0.0001,1504,19
0.516,1e-05,805,799,25,50,0.0001,1604,19
0.516,1e-05,851,853,25,50,0.0001,1704,19
0.518,1e-05,894,910,25,50,0.0001,1804,19
0.52,1e-05,948,956,25,50,0.0001,1904,19
0.522,1e-05,997,1007,25,50,0.0001,2004,19
0.5,1e-05,57,47,25,50,0.0001,104,20
0.502,1e-05,108,96,25,50,0.0001,204,20
0.5,1e-05,157,147,25,50,0.0001,304,20
0.502,1e-05,201,203,25,50,0.0001,404,20
0.504,1e-05,246,258,25,50,0.0001,504,20
0.506,1e-05,294,310,25,50,0.0001,604,20
0.506,1e-05,345,359,25,50,0.0001,704,20
0.51,1e-05,401,403,25,50,0.0001,804,20
0.51,1e-05,455,449,25,50,0.0001,904,20
0.51,1e-05,505,499,25,50,0.0001,1004,20
0.508,1e-05,560,544,25,50,0.0001,1104,20
0.512,1e-05,607,597,25,50,0.0001,1204,20
0.514,1e-05,653,651,25,50,0.0001,1304,20
0.514,1e-05,701,703,25,50,0.0001,1404,20
0.516,1e-05,745,759,25,50,0.0001,1504,20
0.52,1e-05,797,807,25,50,0.0001,1604,20
0.522,1e-05,852,852,25,50,0.0001,1704,20
0.534,1e-05,901,903,25,50,0.0001,1804,20
0.536,1e-05,958,946,25,50,0.0001,1904,20
0.538,1e-05,1001,1003,25,50,0.0001,2004,20
0.514,1e-05,50,54,25,50,0.001,104,1
0.516,1e-05,101,103,25,50,0.001,204,1
0.52,1e-05,156,148,25,50,0.001,304,1
0.524,1e-05,203,201,25,50,0.001,404,1
0.526,1e-05,255,249,25,50,0.001,504,1
0.54,1e-05,313,291,25,50,0.001,604,1
0.542,1e-05,354,350,25,50,0.001,704,1
0.552,1e-05,407,397,25,50,0.001,804,1
0.56,1e-05,458,446,25,50,0.001,904,1
0.576,1e-05,501,503,25,50,0.001,1004,1
0.584,1e-05,550,554,25,50,0.001,1104,1
0.592,1e-05,596,608,25,50,0.001,1204,1
0.616,1e-05,645,659,25,50,0.001,1304,1
0.634,1e-05,699,705,25,50,0.001,1404,1
0.654,1e-05,755,749,25,50,0.001,1504,1
0.668,1e-05,797,807,25,50,0.001,1604,1
0.68,1e-05,843,861,25,50,0.001,1704,1
0.696,1e-05,895,909,25,50,0.001,1804,1
0.702,1e-05,948,956,25,50,0.001,1904,1
0.716,1e-05,1002,1002,25,50,0.001,2004,1
0.542,1e-05,58,46,25,50,0.001,104,2
0.548,1e-05,121,83,25,50,0.001,204,2
0.564,1e-05,166,138,25,50,0.001,304,2
0.568,1e-05,203,201,25,50,0.001,404,2
0.572,1e-05,252,252,25,50,0.001,504,2
0.578,1e-05,302,302,25,50,0.001,604,2
0.59,1e-05,355,349,25,50,0.001,704,2
0.608,1e-05,405,399,25,50,0.001,804,2
0.624,1e-05,455,449,25,50,0.001,904,2
0.648,1e-05,503,501,25,50,0.001,1004,2
0.654,1e-05,551,553,25,50,0.001,1104,2
0.666,1e-05,609,595,25,50,0.001,1204,2
0.688,1e-05,662,642,25,50,0.001,1304,2
0.708,1e-05,711,693,25,50,0.001,1404,2
0.714,1e-05,759,745,25,50,0.001,1504,2
0.738,1e-05,826,778,25,50,0.001,1604,2
0.75,1e-05,882,822,25,50,0.001,1704,2
0.776,1e-05,923,881,25,50,0.001,1804,2
0.782,1e-05,970,934,25,50,0.001,1904,2
0.794,1e-05,1016,988,25,50,0.001,2004,2
0.5,1e-05,47,57,25,50,0.001,104,3
0.504,1e-05,97,107,25,50,0.001,204,3
0.506,1e-05,135,169,25,50,0.001,304,3
0.526,1e-05,173,231,25,50,0.001,404,3
0.534,1e-05,235,269,25,50,0.001,504,3
0.556,1e-05,282,322,25,50,0.001,604,3
0.562,1e-05,334,370,25,50,0.001,704,3
0.57,1e-05,383,421,25,50,0.001,804,3
0.584,1e-05,432,472,25,50,0.001,904,3
0.582,1e-05,487,517,25,50,0.001,1004,3
0.592,1e-05,535,569,25,50,0.001,1104,3
0.618,1e-05,577,627,25,50,0.001,1204,3
0.632,1e-05,623,681,25,50,0.001,1304,3
0.636,1e-05,675,729,25,50,0.001,1404,3
0.666,1e-05,728,776,25,50,0.001,1504,3
0.676,1e-05,780,824,25,50,0.001,1604,3
0.698,1e-05,829,875,25,50,0.001,1704,3
0.718,1e-05,886,918,25,50,0.001,1804,3
0.744,1e-05,937,967,25,50,0.001,1904,3
0.778,1e-05,992,1012,25,50,0.001,2004,3
0.496,1e-05,69,35,25,50,0.001,104,4
0.5,1e-05,116,88,25,50,0.001,204,4
0.5,1e-05,164,140,25,50,0.001,304,4
0.496,1e-05,208,196,25,50,0.001,404,4
0.496,1e-05,256,248,25,50,0.001,504,4
0.502,1e-05,303,301,25,50,0.001,604,4
0.51,1e-05,356,348,25,50,0.001,704,4
0.532,1e-05,412,392,25,50,0.001,804,4
0.562,1e-05,455,449,25,50,0.001,904,4
0.572,1e-05,509,495,25,50,0.001,1004,4
0.596,1e-05,552,552,25,50,0.001,1104,4
0.606,1e-05,602,602,25,50,0.001,1204,4
0.644,1e-05,652,652,25,50,0.001,1304,4
0.654,1e-05,702,702,25,50,0.001,1404,4
0.684,1e-05,745,759,25,50,0.001,1504,4
0.7,1e-05,798,806,25,50,0.001,1604,4
0.712,1e-05,836,868,25,50,0.001,1704,4
0.716,1e-05,902,902,25,50,0.001,1804,4
0.754,1e-05,955,949,25,50,0.001,1904,4
0.778,1e-05,1005,999,25,50,0.001,2004,4
0.522,1e-05,43,61,25,50,0.001,104,5
0.526,1e-05,95,109,25,50,0.001,204,5
0.524,1e-05,143,161,25,50,0.001,304,5
0.532,1e-05,189,215,25,50,0.001,404,5
0.548,1e-05,233,271,25,50,0.001,504,5
0.556,1e-05,285,319,25,50,0.001,604,5
0.572,1e-05,335,369,25,50,0.001,704,5
0.576,1e-05,382,422,25,50,0.001,804,5
0.588,1e-05,430,474,25,50,0.001,904,5
0.594,1e-05,480,524,25,50,0.001,1004,5
0.614,1e-05,534,570,25,50,0.001,1104,5
0.63,1e-05,588,616,25,50,0.001,1204,5
0.634,1e-05,644,660,25,50,0.001,1304,5
0.646,1e-05,697,707,25,50,0.001,1404,5
0.662,1e-05,737,767,25,50,0.001,1504,5
0.7,1e-05,787,817,25,50,0.001,1604,5
0.722,1e-05,834,870,25,50,0.001,1704,5
0.758,1e-05,891,913,25,50,0.001,1804,5
0.778,1e-05,943,961,25,50,0.001,1904,5
0.796,1e-05,985,1019,25,50,0.001,2004,5
0.54,1e-05,49,55,25,50,0.001,104,6
0.554,1e-05,94,110,25,50,0.001,204,6
0.56,1e-05,148,156,25,50,0.001,304,6
0.562,1e-05,192,212,25,50,0.001,404,6
0.562,1e-05,250,254,25,50,0.001,504,6
0.574,1e-05,298,306,25,50,0.001,604,6
0.582,1e-05,351,353,25,50,0.001,704,6
0.596,1e-05,401,403,25,50,0.001,804,6
0.598,1e-05,446,458,25,50,0.001,904,6
0.612,1e-05,489,515,25,50,0.001,1004,6
0.616,1e-05,538,566,25,50,0.001,1104,6
0.65,1e-05,594,610,25,50,0.001,1204,6
0.65,1e-05,641,663,25,50,0.001,1304,6
0.666,1e-05,686,718,25,50,0.001,1404,6
0.676,1e-05,737,767,25,50,0.001,1504,6
0.702,1e-05,783,821,25,50,0.001,1604,6
0.718,1e-05,839,865,25,50,0.001,1704,6
0.748,1e-05,879,925,25,50,0.001,1804,6
0.754,1e-05,928,976,25,50,0.001,1904,6
0.78,1e-05,978,1026,25,50,0.001,2004,6
0.52,1e-05,50,54,25,50,0.001,104,7
0.516,1e-05,107,97,25,50,0.001,204,7
0.514,1e-05,147,157,25,50,0.001,304,7
0.512,1e-05,200,204,25,50,0.001,404,7
0.514,1e-05,249,255,25,50,0.001,504,7
0.534,1e-05,299,305,25,50,0.001,604,7
0.542,1e-05,344,360,25,50,0.001,704,7
0.56,1e-05,395,409,25,50,0.001,804,7
0.576,1e-05,445,459,25,50,0.001,904,7
0.59,1e-05,491,513,25,50,0.001,1004,7
0.598,1e-05,540,564,25,50,0.001,1104,7
0.62,1e-05,595,609,25,50,0.001,1204,7
0.644,1e-05,644,660,25,50,0.001,1304,7
0.662,1e-05,693,711,25,50,0.001,1404,7
0.682,1e-05,738,766,25,50,0.001,1504,7
0.716,1e-05,784,820,25,50,0.001,1604,7
0.746,1e-05,834,870,25,50,0.001,1704,7
0.782,1e-05,886,918,25,50,0.001,1804,7
0.794,1e-05,941,963,25,50,0.001,1904,7
0.818,1e-05,1002,1002,25,50,0.001,2004,7
0.532,1e-05,59,45,25,50,0.001,104,8
0.532,1e-05,102,102,25,50,0.001,204,8
0.538,1e-05,157,147,25,50,0.001,304,8
0.552,1e-05,214,190,25,50,0.001,404,8
0.558,1e-05,267,237,25,50,0.001,504,8
0.576,1e-05,311,293,25,50,0.001,604,8
0.588,1e-05,362,342,25,50,0.001,704,8
0.588,1e-05,405,399,25,50,0.001,804,8
0.592,1e-05,452,452,25,50,0.001,904,8
0.594,1e-05,494,510,25,50,0.001,1004,8
0.61,1e-05,531,573,25,50,0.001,1104,8
0.638,1e-05,584,620,25,50,0.001,1204,8
0.646,1e-05,632,672,25,50,0.001,1304,8
0.678,1e-05,686,718,25,50,0.001,1404,8
0.692,1e-05,738,766,25,50,0.001,1504,8
0.708,1e-05,789,815,25,50,0.001,1604,8
0.722,1e-05,839,865,25,50,0.001,1704,8
0.748,1e-05,895,909,25,50,0.001,1804,8
0.774,1e-05,945,959,25,50,0.001,1904,8
0.79,1e-05,992,1012,25,50,0.001,2004,8
0.496,1e-05,51,53,25,50,0.001,104,9
0.502,1e-05,105,99,25,50,0.001,204,9
0.502,1e-05,152,152,25,50,0.001,304,9
0.506,1e-05,200,204,25,50,0.001,404,9
0.512,1e-05,242,262,25,50,0.001,504,9
0.52,1e-05,303,301,25,50,0.001,604,9
0.526,1e-05,357,347,25,50,0.001,704,9
0.548,1e-05,416,388,25,50,0.001,804,9
0.56,1e-05,457,447,25,50,0.001,904,9
0.574,1e-05,508,496,25,50,0.001,1004,9
0.594,1e-05,549,555,25,50,0.001,1104,9
0.618,1e-05,598,606,25,50,0.001,1204,9
0.624,1e-05,654,650,25,50,0.001,1304,9
0.652,1e-05,696,708,25,50,0.001,1404,9
0.68,1e-05,743,761,25,50,0.001,1504,9
0.698,1e-05,793,811,25,50,0.001,1604,9
0.712,1e-05,843,861,25,50,0.001,1704,9
0.736,1e-05,904,900,25,50,0.001,1804,9
0.78,1e-05,955,949,25,50,0.001,1904,9
0.818,1e-05,1003,1001,25,50,0.001,2004,9
0.532,1e-05,54,50,25,50,0.001,104,10
0.528,1e-05,104,100,25,50,0.001,204,10
0.53,1e-05,154,150,25,50,0.001,304,10
0.528,1e-05,203,201,25,50,0.001,404,10
0.524,1e-05,243,261,25,50,0.001,504,10
0.526,1e-05,291,313,25,50,0.001,604,10
0.52,1e-05,338,366,25,50,0.001,704,10
0.528,1e-05,386,418,25,50,0.001,804,10
0.534,1e-05,428,476,25,50,0.001,904,10
0.576,1e-05,474,530,25,50,0.001,1004,10
0.602,1e-05,508,596,25,50,0.001,1104,10
0.62,1e-05,565,639,25,50,0.001,1204,10
0.638,1e-05,612,692,25,50,0.001,1304,10
0.676,1e-05,665,739,25,50,0.001,1404,10
0.696,1e-05,720,784,25,50,0.001,1504,10
0.716,1e-05,770,834,25,50,0.001,1604,10
0.734,1e-05,820,884,25,50,0.001,1704,10
0.75,1e-05,875,929,25,50,0.001,1804,10
0.778,1e-05,933,971,25,50,0.001,1904,10
0.804,1e-05,988,1016,25,50,0.001,2004,10
0.478,1e-05,56,48,25,50,0.001,104,11
0.48,1e-05,122,82,25,50,0.001,204,11
0.48,1e-05,173,131,25,50,0.001,304,11
0.484,1e-05,216,188,25,50,0.001,404,11
0.484,1e-05,271,233,25,50,0.001,504,11
0.498,1e-05,323,281,25,50,0.001,604,11
0.522,1e-05,370,334,25,50,0.001,704,11
0.534,1e-05,420,384,25,50,0.001,804,11
0.55,1e-05,471,433,25,50,0.001,904,11
0.566,1e-05,516,488,25,50,0.001,1004,11
0.58,1e-05,561,543,25,50,0.001,1104,11
0.6,1e-05,603,601,25,50,0.001,1204,11
0.636,1e-05,654,650,25,50,0.001,1304,11
0.666,1e-05,708,696,25,50,0.001,1404,11
0.682,1e-05,768,736,25,50,0.001,1504,11
0.706,1e-05,811,793,25,50,0.001,1604,11
0.73,1e-05,859,845,25,50,0.001,1704,11
0.75,1e-05,901,903,25,50,0.001,1804,11
0.77,1e-05,959,945,25,50,0.001,1904,11
0.786,1e-05,1007,997,25,50,0.001,2004,11
0.504,1e-05,45,59,25,50,0.001,104,12
0.51,1e-05,93,111,25,50,0.001,204,12
0.516,1e-05,144,160,25,50,0.001,304,12
0.508,1e-05,194,210,25,50,0.001,404,12
0.512,1e-05,248,256,25,50,0.001,504,12
0.516,1e-05,294,310,25,50,0.001,604,12
0.536,1e-05,343,361,25,50,0.001,704,12
0.548,1e-05,387,417,25,50,0.001,804,12
0.572,1e-05,436,468,25,50,0.001,904,12
0.6,1e-05,490,514,25,50,0.001,1004,12
0.624,1e-05,555,549,25,50,0.001,1104,12
0.654,1e-05,607,597,25,50,0.001,1204,12
0.676,1e-05,652,652,25,50,0.001,1304,12
0.686,1e-05,700,704,25,50,0.001,1404,12
0.726,1e-05,756,748,25,50,0.001,1504,12
0.74,1e-05,806,798,25,50,0.001,1604,12
0.752,1e-05,845,859,25,50,0.001,1704,12
0.786,1e-05,901,903,25,50,0.001,1804,12
0.806,1e-05,950,954,25,50,0.001,1904,12
0.842,1e-05,994,1010,25,50,0.001,2004,12
0.468,1e-05,59,45,25,50,0.001,104,13
0.474,1e-05,109,95,25,50,0.001,204,13
0.47,1e-05,167,137,25,50,0.001,304,13
0.48,1e-05,216,188,25,50,0.001,404,13
0.474,1e-05,264,240,25,50,0.001,504,13
0.49,1e-05,318,286,25,50,0.001,604,13
0.492,1e-05,366,338,25,50,0.001,704,13
0.49,1e-05,416,388,25,50,0.001,804,13
0.512,1e-05,468,436,25,50,0.001,904,13
0.524,1e-05,515,489,25,50,0.001,1004,13
0.544,1e-05,561,543,25,50,0.001,1104,13
0.554,1e-05,610,594,25,50,0.001,1204,13
0.582,1e-05,648,656,25,50,0.001,1304,13
0.59,1e-05,692,712,25,50,0.001,1404,13
0.616,1e-05,734,770,25,50,0.001,1504,13
0.638,1e-05,787,817,25,50,0.001,1604,13
0.664,1e-05,844,860,25,50,0.001,1704,13
0.69,1e-05,882,922,25,50,0.001,1804,13
0.726,1e-05,932,972,25,50,0.001,1904,13
0.74,1e-05,991,1013,25,50,0.001,2004,13
0.466,1e-05,60,44,25,50,0.001,104,14
0.464,1e-05,111,93,25,50,0.001,204,14
0.462,1e-05,165,139,25,50,0.001,304,14
0.472,1e-05,208,196,25,50,0.001,404,14
0.464,1e-05,265,239,25,50,0.001,504,14
0.476,1e-05,314,290,25,50,0.001,604,14
0.486,1e-05,368,336,25,50,0.001,704,14
0.5,1e-05,423,381,25,50,0.001,804,14
0.526,1e-05,470,434,25,50,0.001,904,14
0.538,1e-05,512,492,25,50,0.001,1004,14
0.568,1e-05,562,542,25,50,0.001,1104,14
0.606,1e-05,607,597,25,50,0.001,1204,14
0.628,1e-05,655,649,25,50,0.001,1304,14
0.65,1e-05,711,693,25,50,0.001,1404,14
0.678,1e-05,767,737,25,50,0.001,1504,14
0.688,1e-05,805,799,25,50,0.001,1604,14
0.718,1e-05,856,848,25,50,0.001,1704,14
0.75,1e-05,898,906,25,50,0.001,1804,14
0.756,1e-05,949,955,25,50,0.001,1904,14
0.786,1e-05,998,1006,25,50,0.001,2004,14
0.514,1e-05,51,53,25,50,0.001,104,15
0.512,1e-05,98,106,25,50,0.001,204,15
0.512,1e-05,154,150,25,50,0.001,304,15
0.518,1e-05,201,203,25,50,0.001,404,15
0.524,1e-05,253,251,25,50,0.001,504,15
0.53,1e-05,298,306,25,50,0.001,604,15
0.542,1e-05,338,366,25,50,0.001,704,15
0.562,1e-05,389,415,25,50,0.001,804,15
0.568,1e-05,450,454,25,50,0.001,904,15
0.586,1e-05,499,505,25,50,0.001,1004,15
0.61,1e-05,549,555,25,50,0.001,1104,15
0.622,1e-05,597,607,25,50,0.001,1204,15
0.63,1e-05,644,660,25,50,0.001,1304,15
0.66,1e-05,701,703,25,50,0.001,1404,15
0.688,1e-05,753,751,25,50,0.001,1504,15
0.716,1e-05,795,809,25,50,0.001,1604,15
0.724,1e-05,840,864,25,50,0.001,1704,15
0.75,1e-05,892,912,25,50,0.001,1804,15
0.764,1e-05,944,960,25,50,0.001,1904,15
0.786,1e-05,998,1006,25,50,0.001,2004,15
0.514,1e-05,50,54,25,50,0.001,104,16
0.514,1e-05,101,103,25,50,0.001,204,16
0.512,1e-05,155,149,25,50,0.001,304,16
0.512,1e-05,208,196,25,50,0.001,404,16
0.51,1e-05,260,244,25,50,0.001,504,16
0.504,1e-05,302,302,25,50,0.001,604,16
0.504,1e-05,351,353,25,50,0.001,704,16
0.508,1e-05,388,416,25,50,0.001,804,16
0.524,1e-05,433,471,25,50,0.001,904,16
0.542,1e-05,488,516,25,50,0.001,1004,16
0.558,1e-05,540,564,25,50,0.001,1104,16
0.572,1e-05,590,614,25,50,0.001,1204,16
0.59,1e-05,645,659,25,50,0.001,1304,16
0.618,1e-05,697,707,25,50,0.001,1404,16
0.632,1e-05,743,761,25,50,0.001,1504,16
0.664,1e-05,790,814,25,50,0.001,1604,16
0.684,1e-05,837,867,25,50,0.001,1704,16
0.708,1e-05,894,910,25,50,0.001,1804,16
0.72,1e-05,954,950,25,50,0.001,1904,16
0.744,1e-05,1008,996,25,50,0.001,2004,16
0.492,1e-05,47,57,25,50,0.001,104,17
0.498,1e-05,105,99,25,50,0.001,204,17
0.508,1e-05,154,150,25,50,0.001,304,17
0.52,1e-05,215,189,25,50,0.001,404,17
0.526,1e-05,266,238,25,50,0.001,504,17
0.538,1e-05,315,289,25,50,0.001,604,17
0.552,1e-05,365,339,25,50,0.001,704,17
0.568,1e-05,425,379,25,50,0.001,804,17
0.578,1e-05,473,431,25,50,0.001,904,17
0.602,1e-05,520,484,25,50,0.001,1004,17
0.61,1e-05,576,528,25,50,0.001,1104,17
0.624,1e-05,626,578,25,50,0.001,1204,17
0.64,1e-05,680,624,25,50,0.001,1304,17
0.658,1e-05,731,673,25,50,0.001,1404,17
0.672,1e-05,778,726,25,50,0.001,1504,17
0.686,1e-05,829,775,25,50,0.001,1604,17
0.722,1e-05,880,824,25,50,0.001,1704,17
0.738,1e-05,922,882,25,50,0.001,1804,17
0.758,1e-05,972,932,25,50,0.001,1904,17
0.774,1e-05,1026,978,25,50,0.001,2004,17
0.546,1e-05,49,55,25,50,0.001,104,18
0.546,1e-05,93,111,25,50,0.001,204,18
0.548,1e-05,137,167,25,50,0.001,304,18
0.566,1e-05,194,210,25,50,0.001,404,18
0.578,1e-05,237,267,25,50,0.001,504,18
0.568,1e-05,283,321,25,50,0.001,604,18
0.58,1e-05,326,378,25,50,0.001,704,18
0.596,1e-05,375,429,25,50,0.001,804,18
0.608,1e-05,427,477,25,50,0.001,904,18
0.622,1e-05,474,530,25,50,0.001,1004,18
0.644,1e-05,521,583,25,50,0.001,1104,18
0.652,1e-05,575,629,25,50,0.001,1204,18
0.658,1e-05,626,678,25,50,0.001,1304,18
0.668,1e-05,681,723,25,50,0.001,1404,18
0.67,1e-05,730,774,25,50,0.001,1504,18
0.694,1e-05,784,820,25,50,0.001,1604,18
0.722,1e-05,837,867,25,50,0.001,1704,18
0.746,1e-05,888,916,25,50,0.001,1804,18
0.764,1e-05,934,970,25,50,0.001,1904,18
0.782,1e-05,989,1015,25,50,0.001,2004,18
0.482,1e-05,48,56,25,50,0.001,104,19
0.494,1e-05,94,110,25,50,0.001,204,19
0.496,1e-05,142,162,25,50,0.001,304,19
0.514,1e-05,187,217,25,50,0.001,404,19
0.526,1e-05,229,275,25,50,0.001,504,19
0.532,1e-05,280,324,25,50,0.001,604,19
0.548,1e-05,332,372,25,50,0.001,704,19
0.58,1e-05,386,418,25,50,0.001,804,19
0.586,1e-05,429,475,25,50,0.001,904,19
0.606,1e-05,496,508,25,50,0.001,1004,19
0.614,1e-05,541,563,25,50,0.001,1104,19
0.64,1e-05,593,611,25,50,0.001,1204,19
0.662,1e-05,644,660,25,50,0.001,1304,19
0.676,1e-05,701,703,25,50,0.001,1404,19
0.72,1e-05,745,759,25,50,0.001,1504,19
0.738,1e-05,798,806,25,50,0.001,1604,19
0.772,1e-05,858,846,25,50,0.001,1704,19
0.784,1e-05,905,899,25,50,0.001,1804,19
0.802,1e-05,954,950,25,50,0.001,1904,19
0.838,1e-05,992,1012,25,50,0.001,2004,19
0.476,1e-05,48,56,25,50,0.001,104,20
0.48,1e-05,88,116,25,50,0.001,204,20
0.48,1e-05,144,160,25,50,0.001,304,20
0.474,1e-05,191,213,25,50,0.001,404,20
0.482,1e-05,233,271,25,50,0.001,504,20
0.492,1e-05,287,317,25,50,0.001,604,20
0.498,1e-05,329,375,25,50,0.001,704,20
0.508,1e-05,377,427,25,50,0.001,804,20
0.516,1e-05,436,468,25,50,0.001,904,20
0.522,1e-05,483,521,25,50,0.001,1004,20
0.538,1e-05,537,567,25,50,0.001,1104,20
0.558,1e-05,583,621,25,50,0.001,1204,20
0.568,1e-05,623,681,25,50,0.001,1304,20
0.576,1e-05,681,723,25,50,0.001,1404,20
0.598,1e-05,724,780,25,50,0.001,1504,20
0.634,1e-05,771,833,25,50,0.001,1604,20
0.652,1e-05,824,880,25,50,0.001,1704,20
0.69,1e-05,878,926,25,50,0.001,1804,20
0.71,1e-05,926,978,25,50,0.001,1904,20
0.748,1e-05,980,1024,25,50,0.001,2004,20
0.516,1e-05,51,53,25,50,0.01,104,1
0.566,1e-05,100,104,25,50,0.01,204,1
0.596,1e-05,138,166,25,50,0.01,304,1
0.65,1e-05,186,218,25,50,0.01,404,1
0.668,1e-05,233,271,25,50,0.01,504,1
0.706,1e-05,285,319,25,50,0.01,604,1
0.734,1e-05,346,358,25,50,0.01,704,1
0.792,1e-05,393,411,25,50,0.01,804,1
0.838,1e-05,447,457,25,50,0.01,904,1
0.908,1e-05,500,504,25,50,0.01,1004,1
0.93,1e-05,556,548,25,50,0.01,1104,1
0.942,1e-05,617,587,25,50,0.01,1204,1
0.954,1e-05,661,643,25,50,0.01,1304,1
0.962,1e-05,717,687,25,50,0.01,1404,1
0.96,1e-05,767,737,25,50,0.01,1504,1
0.964,1e-05,814,790,25,50,0.01,1604,1
0.97,1e-05,859,845,25,50,0.01,1704,1
0.976,1e-05,903,901,25,50,0.01,1804,1
0.98,1e-05,951,953,25,50,0.01,1904,1
0.98,1e-05,1001,1003,25,50,0.01,2004,1
0.478,1e-05,54,50,25,50,0.01,104,2
0.504,1e-05,104,100,25,50,0.01,204,2
0.528,1e-05,157,147,25,50,0.01,304,2
0.566,1e-05,198,206,25,50,0.01,404,2
0.604,1e-05,240,264,25,50,0.01,504,2
0.642,1e-05,284,320,25,50,0.01,604,2
0.694,1e-05,328,376,25,50,0.01,704,2
0.724,1e-05,384,420,25,50,0.01,804,2
0.756,1e-05,439,465,25,50,0.01,904,2
0.826,1e-05,480,524,25,50,0.01,1004,2
0.83,1e-05,536,568,25,50,0.01,1104,2
0.886,1e-05,576,628,25,50,0.01,1204,2
0.9,1e-05,627,677,25,50,0.01,1304,2
0.944,1e-05,674,730,25,50,0.01,1404,2
0.954,1e-05,730,774,25,50,0.01,1504,2
0.958,1e-05,780,824,25,50,0.01,1604,2
0.958,1e-05,832,872,25,50,0.01,1704,2
0.96,1e-05,881,923,25,50,0.01,1804,2
0.97,1e-05,935,969,25,50,0.01,1904,2
0.976,1e-05,984,1020,25,50,0.01,2004,2
0.512,1e-05,58,46,25,50,0.01,104,3
0.526,1e-05,114,90,25,50,0.01,204,3
0.552,1e-05,171,133,25,50,0.01,304,3
0.616,1e-05,216,188,25,50,0.01,404,3
0.674,1e-05,266,238,25,50,0.01,504,3
0.73,1e-05,314,290,25,50,0.01,604,3
0.766,1e-05,361,343,25,50,0.01,704,3
0.836,1e-05,409,395,25,50,0.01,804,3
0.852,1e-05,459,445,25,50,0.01,904,3
0.9,1e-05,504,500,25,50,0.01,1004,3
0.908,1e-05,555,549,25,50,0.01,1104,3
0.942,1e-05,599,605,25,50,0.01,1204,3
0.962,1e-05,650,654,25,50,0.01,1304,3
0.958,1e-05,695,709,25,50,0.01,1404,3
0.964,1e-05,745,759,25,50,0.01,1504,3
0.972,1e-05,798,806,25,50,0.01,1604,3
0.974,1e-05,849,855,25,50,0.01,1704,3
0.98,1e-05,906,898,25,50,0.01,1804,3
0.982,1e-05,962,942,25,50,0.01,1904,3
0.984,1e-05,1004,1000,25,50,0.01,2004,3
0.554,1e-05,46,58,25,50,0.01,104,4
0.568,1e-05,94,110,25,50,0.01,204,4
0.564,1e-05,148,156,25,50,0.01,304,4
0.612,1e-05,199,205,25,50,0.01,404,4
0.64,1e-05,250,254,25,50,0.01,504,4
0.702,1e-05,302,302,25,50,0.01,604,4
0.738,1e-05,348,356,25,50,0.01,704,4
0.802,1e-05,389,415,25,50,0.01,804,4
0.842,1e-05,434,470,25,50,0.01,904,4
0.9,1e-05,496,508,25,50,0.01,1004,4
0.906,1e-05,554,550,25,50,0.01,1104,4
0.942,1e-05,602,602,25,50,0.01,1204,4
0.944,1e-05,647,657,25,50,0.01,1304,4
0.962,1e-05,694,710,25,50,0.01,1404,4
0.968,1e-05,741,763,25,50,0.01,1504,4
0.96,1e-05,797,807,25,50,0.01,1604,4
0.958,1e-05,849,855,25,50,0.01,1704,4
0.974,1e-05,896,908,25,50,0.01,1804,4
0.978,1e-05,951,953,25,50,0.01,1904,4
0.984,1e-05,1007,997,25,50,0.01,2004,4
0.528,1e-05,50,54,25,50,0.01,104,5
0.552,1e-05,104,100,25,50,0.01,204,5
0.584,1e-05,161,143,25,50,0.01,304,5
0.608,1e-05,214,190,25,50,0.01,404,5
0.634,1e-05,268,236,25,50,0.01,504,5
0.638,1e-05,314,290,25,50,0.01,604,5
0.654,1e-05,360,344,25,50,0.01,704,5
0.722,1e-05,413,391,25,50,0.01,804,5
0.778,1e-05,463,441,25,50,0.01,904,5
0.854,1e-05,512,492,25,50,0.01,1004,5
0.894,1e-05,570,534,25,50,0.01,1104,5
0.916,1e-05,618,586,25,50,0.01,1204,5
0.934,1e-05,664,640,25,50,0.01,1304,5
0.954,1e-05,720,684,25,50,0.01,1404,5
0.962,1e-05,768,736,25,50,0.01,1504,5
0.968,1e-05,813,791,25,50,0.01,1604,5
0.98,1e-05,860,844,25,50,0.01,1704,5
0.988,1e-05,912,892,25,50,0.01,1804,5
0.988,1e-05,952,952,25,50,0.01,1904,5
0.992,1e-05,1002,1002,25,50,0.01,2004,5
0.528,1e-05,56,48,25,50,0.01,104,6
0.616,1e-05,101,103,25,50,0.01,204,6
0.642,1e-05,148,156,25,50,0.01,304,6
0.66,1e-05,208,196,25,50,0.01,404,6
0.684,1e-05,260,244,25,50,0.01,504,6
0.716,1e-05,313,291,25,50,0.01,604,6
0.762,1e-05,366,338,25,50,0.01,704,6
0.82,1e-05,408,396,25,50,0.01,804,6
0.876,1e-05,456,448,25,50,0.01,904,6
0.9,1e-05,511,493,25,50,0.01,1004,6
0.916,1e-05,557,547,25,50,0.01,1104,6
0.946,1e-05,602,602,25,50,0.01,1204,6
0.956,1e-05,656,648,25,50,0.01,1304,6
0.96,1e-05,699,705,25,50,0.01,1404,6
0.962,1e-05,746,758,25,50,0.01,1504,6
0.972,1e-05,795,809,25,50,0.01,1604,6
0.972,1e-05,844,860,25,50,0.01,1704,6
0.974,1e-05,895,909,25,50,0.01,1804,6
0.974,1e-05,941,963,25,50,0.01,1904,6
0.978,1e-05,1000,1004,25,50,0.01,2004,6
0.52,1e-05,50,54,25,50,0.01,104,7
0.548,1e-05,98,106,25,50,0.01,204,7
0.548,1e-05,152,152,25,50,0.01,304,7
0.582,1e-05,204,200,25,50,0.01,404,7
0.624,1e-05,257,247,25,50,0.01,504,7
0.676,1e-05,310,294,25,50,0.01,604,7
0.662,1e-05,357,347,25,50,0.01,704,7
0.728,1e-05,408,396,25,50,0.01,804,7
0.792,1e-05,456,448,25,50,0.01,904,7
0.858,1e-05,510,494,25,50,0.01,1004,7
0.864,1e-05,563,541,25,50,0.01,1104,7
0.928,1e-05,611,593,25,50,0.01,1204,7
0.94,1e-05,665,639,25,50,0.01,1304,7
0.954,1e-05,728,676,25,50,0.01,1404,7
0.956,1e-05,769,735,25,50,0.01,1504,7
0.964,1e-05,823,781,25,50,0.01,1604,7
0.968,1e-05,872,832,25,50,0.01,1704,7
0.976,1e-05,926,878,25,50,0.01,1804,7
0.978,1e-05,975,929,25,50,0.01,1904,7
0.98,1e-05,1016,988,25,50,0.01,2004,7
0.506,1e-05,56,48,25,50,0.01,104,8
0.548,1e-05,105,99,25,50,0.01,204,8
0.564,1e-05,163,141,25,50,0.01,304,8
0.596,1e-05,217,187,25,50,0.01,404,8
0.594,1e-05,262,242,25,50,0.01,504,8
0.648,1e-05,316,288,25,50,0.01,604,8
0.708,1e-05,364,340,25,50,0.01,704,8
0.692,1e-05,415,389,25,50,0.01,804,8
0.752,1e-05,462,442,25,50,0.01,904,8
0.828,1e-05,508,496,25,50,0.01,1004,8
0.89,1e-05,558,546,25,50,0.01,1104,8
0.934,1e-05,611,593,25,50,0.01,1204,8
0.94,1e-05,659,645,25,50,0.01,1304,8
0.968,1e-05,711,693,25,50,0.01,1404,8
0.964,1e-05,756,748,25,50,0.01,1504,8
0.972,1e-05,802,802,25,50,0.01,1604,8
0.972,1e-05,851,853,25,50,0.01,1704,8
0.974,1e-05,907,897,25,50,0.01,1804,8
0.978,1e-05,961,943,25,50,0.01,1904,8
0.98,1e-05,1013,991,25,50,0.01,2004,8
0.5,1e-05,55,49,25,50,0.01,104,9
0.552,1e-05,106,98,25,50,0.01,204,9
0.57,1e-05,161,143,25,50,0.01,304,9
0.618,1e-05,206,198,25,50,0.01,404,9
0.636,1e-05,259,245,25,50,0.01,504,9
0.694,1e-05,317,287,25,50,0.01,604,9
0.77,1e-05,362,342,25,50,0.01,704,9
0.822,1e-05,411,393,25,50,0.01,804,9
0.868,1e-05,462,442,25,50,0.01,904,9
0.92,1e-05,512,492,25,50,0.01,1004,9
0.926,1e-05,564,540,25,50,0.01,1104,9
0.942,1e-05,606,598,25,50,0.01,1204,9
0.95,1e-05,654,650,25,50,0.01,1304,9
0.962,1e-05,703,701,25,50,0.01,1404,9
0.968,1e-05,748,756,25,50,0.01,1504,9
0.974,1e-05,801,803,25,50,0.01,1604,9
0.98,1e-05,850,854,25,50,0.01,1704,9
0.986,1e-05,908,896,25,50,0.01,1804,9
0.986,1e-05,955,949,25,50,0.01,1904,9
0.986,1e-05,1003,1001,25,50,0.01,2004,9
0.518,1e-05,53,51,25,50,0.01,104,10
0.59,1e-05,106,98,25,50,0.01,204,10
0.624,1e-05,154,150,25,50,0.01,304,10
0.654,1e-05,202,202,25,50,0.01,404,10
0.654,1e-05,254,250,25,50,0.01,504,10
0.696,1e-05,305,299,25,50,0.01,604,10
0.73,1e-05,357,347,25,50,0.01,704,10
0.804,1e-05,404,400,25,50,0.01,804,10
0.854,1e-05,459,445,25,50,0.01,904,10
0.91,1e-05,507,497,25,50,0.01,1004,10
0.928,1e-05,549,555,25,50,0.01,1104,10
0.954,1e-05,613,591,25,50,0.01,1204,10
0.964,1e-05,670,634,25,50,0.01,1304,10
0.962,1e-05,713,691,25,50,0.01,1404,10
0.966,1e-05,765,739,25,50,0.01,1504,10
0.968,1e-05,820,784,25,50,0.01,1604,10
0.97,1e-05,872,832,25,50,0.01,1704,10
0.98,1e-05,922,882,25,50,0.01,1804,10
0.98,1e-05,964,940,25,50,0.01,1904,10
0.984,1e-05,1007,997,25,50,0.01,2004,10
0.554,1e-05,53,51,25,50,0.01,104,11
0.58,1e-05,104,100,25,50,0.01,204,11
0.584,1e-05,155,149,25,50,0.01,304,11
0.624,1e-05,212,192,25,50,0.01,404,11
0.658,1e-05,263,241,25,50,0.01,504,11
0.676,1e-05,309,295,25,50,0.01,604,11
0.716,1e-05,356,348,25,50,0.01,704,11
0.756,1e-05,407,397,25,50,0.01,804,11
0.806,1e-05,463,441,25,50,0.01,904,11
0.886,1e-05,508,496,25,50,0.01,1004,11
0.912,1e-05,554,550,25,50,0.01,1104,11
0.928,1e-05,602,602,25,50,0.01,1204,11
0.934,1e-05,656,648,25,50,0.01,1304,11
0.956,1e-05,704,700,25,50,0.01,1404,11
0.96,1e-05,754,750,25,50,0.01,1504,11
0.972,1e-05,809,795,25,50,0.01,1604,11
0.976,1e-05,858,846,25,50,0.01,1704,11
0.976,1e-05,912,892,25,50,0.01,1804,11
0.982,1e-05,956,948,25,50,0.01,1904,11
0.986,1e-05,1002,1002,25,50,0.01,2004,11
0.464,1e-05,46,58,25,50,0.01,104,12
0.486,1e-05,106,98,25,50,0.01,204,12
0.506,1e-05,160,144,25,50,0.01,304,12
0.588,1e-05,208,196,25,50,0.01,404,12
0.614,1e-05,260,244,25,50,0.01,504,12
0.694,1e-05,301,303,25,50,0.01,604,12
0.764,1e-05,356,348,25,50,0.01,704,12
0.804,1e-05,410,394,25,50,0.01,804,12
0.836,1e-05,450,454,25,50,0.01,904,12
0.872,1e-05,499,505,25,50,0.01,1004,12
0.894,1e-05,547,557,25,50,0.01,1104,12
0.922,1e-05,597,607,25,50,0.01,1204,12
0.94,1e-05,643,661,25,50,0.01,1304,12
0.944,1e-05,692,712,25,50,0.01,1404,12
0.946,1e-05,736,768,25,50,0.01,1504,12
0.958,1e-05,788,816,25,50,0.01,1604,12
0.964,1e-05,841,863,25,50,0.01,1704,12
0.97,1e-05,895,909,25,50,0.01,1804,12
0.968,1e-05,942,962,25,50,0.01,1904,12
0.972,1e-05,992,1012,25,50,0.01,2004,12
0.512,1e-05,42,62,25,50,0.01,104,13
0.548,1e-05,91,113,25,50,0.01,204,13
0.566,1e-05,139,165,25,50,0.01,304,13
0.566,1e-05,193,211,25,50,0.01,404,13
0.58,1e-05,240,264,25,50,0.01,504,13
0.64,1e-05,294,310,25,50,0.01,604,13
0.676,1e-05,346,358,25,50,0.01,704,13
0.762,1e-05,393,411,25,50,0.01,804,13
0.784,1e-05,447,457,25,50,0.01,904,13
0.83,1e-05,495,509,25,50,0.01,1004,13
0.866,1e-05,549,555,25,50,0.01,1104,13
0.912,1e-05,602,602,25,50,0.01,1204,13
0.938,1e-05,660,644,25,50,0.01,1304,13
0.956,1e-05,709,695,25,50,0.01,1404,13
0.96,1e-05,763,741,25,50,0.01,1504,13
0.966,1e-05,816,788,25,50,0.01,1604,13
0.966,1e-05,863,841,25,50,0.01,1704,13
0.968,1e-05,910,894,25,50,0.01,1804,13
0.97,1e-05,952,952,25,50,0.01,1904,13
0.97,1e-05,1008,996,25,50,0.01,2004,13
0.53,1e-05,48,56,25,50,0.01,104,14
0.528,1e-05,91,113,25,50,0.01,204,14
0.542,1e-05,145,159,25,50,0.01,304,14
0.61,1e-05,201,203,25,50,0.01,404,14
0.676,1e-05,252,252,25,50,0.01,504,14
0.708,1e-05,299,305,25,50,0.01,604,14
0.724,1e-05,344,360,25,50,0.01,704,14
0.81,1e-05,399,405,25,50,0.01,804,14
0.822,1e-05,449,455,25,50,0.01,904,14
0.85,1e-05,493,511,25,50,0.01,1004,14
0.872,1e-05,541,563,25,50,0.01,1104,14
0.898,1e-05,594,610,25,50,0.01,1204,14
0.918,1e-05,640,664,25,50,0.01,1304,14
0.928,1e-05,687,717,25,50,0.01,1404,14
0.932,1e-05,741,763,25,50,0.01,1504,14
0.946,1e-05,787,817,25,50,0.01,1604,14
0.954,1e-05,830,874,25,50,0.01,1704,14
0.956,1e-05,887,917,25,50,0.01,1804,14
0.966,1e-05,938,966,25,50,0.01,1904,14
0.966,1e-05,990,1014,25,50,0.01,2004,14
0.516,1e-05,47,57,25,50,0.01,104,15
0.55,1e-05,103,101,25,50,0.01,204,15
0.578,1e-05,153,151,25,50,0.01,304,15
0.64,1e-05,204,200,25,50,0.01,404,15
0.602,1e-05,242,262,25,50,0.01,504,15
0.638,1e-05,287,317,25,50,0.01,604,15
0.684,1e-05,330,374,25,50,0.01,704,15
0.704,1e-05,377,427,25,50,0.01,804,15
0.718,1e-05,435,469,25,50,0.01,904,15
0.766,1e-05,495,509,25,50,0.01,1004,15
0.824,1e-05,549,555,25,50,0.01,1104,15
0.892,1e-05,599,605,25,50,0.01,1204,15
0.928,1e-05,648,656,25,50,0.01,1304,15
0.926,1e-05,699,705,25,50,0.01,1404,15
0.948,1e-05,746,758,25,50,0.01,1504,15
0.95,1e-05,799,805,25,50,0.01,1604,15
0.95,1e-05,846,858,25,50,0.01,1704,15
0.958,1e-05,896,908,25,50,0.01,1804,15
0.964,1e-05,951,953,25,50,0.01,1904,15
0.966,1e-05,1001,1003,25,50,0.01,2004,15
0.53,1e-05,60,44,25,50,0.01,104,16
0.574,1e-05,111,93,25,50,0.01,204,16
0.604,1e-05,158,146,25,50,0.01,304,16
0.656,1e-05,219,185,25,50,0.01,404,16
0.656,1e-05,264,240,25,50,0.01,504,16
0.666,1e-05,314,290,25,50,0.01,604,16
0.678,1e-05,364,340,25,50,0.01,704,16
0.71,1e-05,414,390,25,50,0.01,804,16
0.78,1e-05,464,440,25,50,0.01,904,16
0.846,1e-05,518,486,25,50,0.01,1004,16
0.856,1e-05,574,530,25,50,0.01,1104,16
0.908,1e-05,624,580,25,50,0.01,1204,16
0.918,1e-05,676,628,25,50,0.01,1304,16
0.924,1e-05,725,679,25,50,0.01,1404,16
0.934,1e-05,764,740,25,50,0.01,1504,16
0.936,1e-05,818,786,25,50,0.01,1604,16
0.936,1e-05,869,835,25,50,0.01,1704,16
0.95,1e-05,926,878,25,50,0.01,1804,16
0.948,1e-05,970,934,25,50,0.01,1904,16
0.956,1e-05,1015,989,25,50,0.01,2004,16
0.478,1e-05,56,48,25,50,0.01,104,17
0.548,1e-05,109,95,25,50,0.01,204,17
0.546,1e-05,157,147,25,50,0.01,304,17
0.558,1e-05,214,190,25,50,0.01,404,17
0.598,1e-05,257,247,25,50,0.01,504,17
0.618,1e-05,307,297,25,50,0.01,604,17
0.672,1e-05,360,344,25,50,0.01,704,17
0.724,1e-05,415,389,25,50,0.01,804,17
0.776,1e-05,466,438,25,50,0.01,904,17
0.816,1e-05,518,486,25,50,0.01,1004,17
0.842,1e-05,566,538,25,50,0.01,1104,17
0.93,1e-05,610,594,25,50,0.01,1204,17
0.944,1e-05,662,642,25,50,0.01,1304,17
0.964,1e-05,706,698,25,50,0.01,1404,17
0.97,1e-05,770,734,25,50,0.01,1504,17
0.978,1e-05,814,790,25,50,0.01,1604,17
0.982,1e-05,862,842,25,50,0.01,1704,17
0.982,1e-05,908,896,25,50,0.01,1804,17
0.982,1e-05,960,944,25,50,0.01,1904,17
0.98,1e-05,1008,996,25,50,0.01,2004,17
0.492,1e-05,43,61,25,50,0.01,104,18
0.52,1e-05,97,107,25,50,0.01,204,18
0.532,1e-05,146,158,25,50,0.01,304,18
0.576,1e-05,191,213,25,50,0.01,404,18
0.59,1e-05,244,260,25,50,0.01,504,18
0.646,1e-05,289,315,25,50,0.01,604,18
0.674,1e-05,336,368,25,50,0.01,704,18
0.718,1e-05,386,418,25,50,0.01,804,18
0.768,1e-05,434,470,25,50,0.01,904,18
0.808,1e-05,483,521,25,50,0.01,1004,18
0.838,1e-05,537,567,25,50,0.01,1104,18
0.878,1e-05,591,613,25,50,0.01,1204,18
0.916,1e-05,641,663,25,50,0.01,1304,18
0.936,1e-05,701,703,25,50,0.01,1404,18
0.94,1e-05,750,754,25,50,0.01,1504,18
0.964,1e-05,797,807,25,50,0.01,1604,18
0.962,1e-05,845,859,25,50,0.01,1704,18
0.974,1e-05,897,907,25,50,0.01,1804,18
0.968,1e-05,944,960,25,50,0.01,1904,18
0.972,1e-05,992,1012,25,50,0.01,2004,18
0.518,1e-05,59,45,25,50,0.01,104,19
0.554,1e-05,105,99,25,50,0.01,204,19
0.566,1e-05,147,157,25,50,0.01,304,19
0.62,1e-05,199,205,25,50,0.01,404,19
0.686,1e-05,256,248,25,50,0.01,504,19
0.75,1e-05,308,296,25,50,0.01,604,19
0.814,1e-05,356,348,25,50,0.01,704,19
0.848,1e-05,404,400,25,50,0.01,804,19
0.87,1e-05,460,444,25,50,0.01,904,19
0.922,1e-05,508,496,25,50,0.01,1004,19
0.934,1e-05,558,546,25,50,0.01,1104,19
0.944,1e-05,612,592,25,50,0.01,1204,19
0.948,1e-05,665,639,25,50,0.01,1304,19
0.96,1e-05,717,687,25,50,0.01,1404,19
0.964,1e-05,764,740,25,50,0.01,1504,19
0.972,1e-05,820,784,25,50,0.01,1604,19
0.97,1e-05,865,839,25,50,0.01,1704,19
0.974,1e-05,913,891,25,50,0.01,1804,19
0.974,1e-05,962,942,25,50,0.01,1904,19
0.978,1e-05,1011,993,25,50,0.01,2004,19
0.512,1e-05,58,46,25,50,0.01,104,20
0.544,1e-05,109,95,25,50,0.01,204,20
0.592,1e-05,158,146,25,50,0.01,304,20
0.618,1e-05,206,198,25,50,0.01,404,20
0.638,1e-05,252,252,25,50,0.01,504,20
0.67,1e-05,305,299,25,50,0.01,604,20
0.722,1e-05,361,343,25,50,0.01,704,20
0.768,1e-05,407,397,25,50,0.01,804,20
0.824,1e-05,454,450,25,50,0.01,904,20
0.872,1e-05,498,506,25,50,0.01,1004,20
0.918,1e-05,553,551,25,50,0.01,1104,20
0.942,1e-05,603,601,25,50,0.01,1204,20
0.962,1e-05,658,646,25,50,0.01,1304,20
0.964,1e-05,708,696,25,50,0.01,1404,20
0.964,1e-05,759,745,25,50,0.01,1504,20
0.98,1e-05,805,799,25,50,0.01,1604,20
0.982,1e-05,855,849,25,50,0.01,1704,20
0.972,1e-05,900,904,25,50,0.01,1804,20
0.978,1e-05,951,953,25,50,0.01,1904,20
0.984,1e-05,995,1009,25,50,0.01,2004,20
0.548,0.0001,53,51,25,50,0.0001,104,1
0.55,0.0001,101,103,25,50,0.0001,204,1
0.55,0.0001,152,152,25,50,0.0001,304,1
0.552,0.0001,202,202,25,50,0.0001,404,1
0.554,0.0001,263,241,25,50,0.0001,504,1
0.554,0.0001,301,303,25,50,0.0001,604,1
0.552,0.0001,352,352,25,50,0.0001,704,1
0.55,0.0001,392,412,25,50,0.0001,804,1
0.546,0.0001,434,470,25,50,0.0001,904,1
0.544,0.0001,477,527,25,50,0.0001,1004,1
0.548,0.0001,527,577,25,50,0.0001,1104,1
0.55,0.0001,579,625,25,50,0.0001,1204,1
0.548,0.0001,622,682,25,50,0.0001,1304,1
0.552,0.0001,680,724,25,50,0.0001,1404,1
0.554,0.0001,736,768,25,50,0.0001,1504,1
0.554,0.0001,794,810,25,50,0.0001,1604,1
0.562,0.0001,842,862,25,50,0.0001,1704,1
0.566,0.0001,889,915,25,50,0.0001,1804,1
0.566,0.0001,936,968,25,50,0.0001,1904,1
0.57,0.0001,986,1018,25,50,0.0001,2004,1
0.548,0.0001,63,41,25,50,0.0001,104,2
0.546,0.0001,114,90,25,50,0.0001,204,2
0.55,0.0001,170,134,25,50,0.0001,304,2
0.55,0.0001,214,190,25,50,0.0001,404,2
0.55,0.0001,267,237,25,50,0.0001,504,2
0.55,0.0001,312,292,25,50,0.0001,604,2
0.552,0.0001,358,346,25,50,0.0001,704,2
0.554,0.0001,410,394,25,50,0.0001,804,2
0.552,0.0001,450,454,25,50,0.0001,904,2
0.554,0.0001,485,519,25,50,0.0001,1004,2
0.552,0.0001,543,561,25,50,0.0001,1104,2
0.55,0.0001,593,611,25,50,0.0001,1204,2
0.55,0.0001,645,659,25,50,0.0001,1304,2
0.55,0.0001,686,718,25,50,0.0001,1404,2
0.55,0.0001,738,766,25,50,0.0001,1504,2
0.55,0.0001,783,821,25,50,0.0001,1604,2
0.55,0.0001,839,865,25,50,0.0001,1704,2
0.55,0.0001,901,903,25,50,0.0001,1804,2
0.552,0.0001,959,945,25,50,0.0001,1904,2
0.552,0.0001,1008,996,25,50,0.0001,2004,2
0.544,0.0001,50,54,25,50,0.0001,104,3
0.542,0.0001,109,95,25,50,0.0001,204,3
0.542,0.0001,163,141,25,50,0.0001,304,3
0.54,0.0001,208,196,25,50,0.0001,404,3
0.542,0.0001,259,245,25,50,0.0001,504,3
0.544,0.0001,306,298,25,50,0.0001,604,3
0.546,0.0001,351,353,25,50,0.0001,704,3
0.544,0.0001,400,404,25,50,0.0001,804,3
0.546,0.0001,452,452,25,50,0.0001,904,3
0.552,0.0001,501,503,25,50,0.0001,1004,3
0.554,0.0001,549,555,25,50,0.0001,1104,3
0.556,0.0001,602,602,25,50,0.0001,1204,3
0.562,0.0001,644,660,25,50,0.0001,1304,3
0.566,0.0001,698,706,25,50,0.0001,1404,3
0.568,0.0001,750,754,25,50,0.0001,1504,3
0.572,0.0001,802,802,25,50,0.0001,1604,3
0.568,0.0001,852,852,25,50,0.0001,1704,3
0.572,0.0001,909,895,25,50,0.0001,1804,3
0.574,0.0001,961,943,25,50,0.0001,1904,3
0.572,0.0001,1012,992,25,50,0.0001,2004,3
0.49,0.0001,57,47,25,50,0.0001,104,4
0.49,0.0001,108,96,25,50,0.0001,204,4
0.49,0.0001,163,141,25,50,0.0001,304,4
0.488,0.0001,201,203,25,50,0.0001,404,4
0.49,0.0001,249,255,25,50,0.0001,504,4
0.49,0.0001,297,307,25,50,0.0001,604,4
0.492,0.0001,351,353,25,50,0.0001,704,4
0.488,0.0001,406,398,25,50,0.0001,804,4
0.486,0.0001,455,449,25,50,0.0001,904,4
0.486,0.0001,502,502,25,50,0.0001,1004,4
0.486,0.0001,559,545,25,50,0.0001,1104,4
0.484,0.0001,611,593,25,50,0.0001,1204,4
0.488,0.0001,657,647,25,50,0.0001,1304,4
0.488,0.0001,710,694,25,50,0.0001,1404,4
0.486,0.0001,762,742,25,50,0.0001,1504,4
0.482,0.0001,808,796,25,50,0.0001,1604,4
0.482,0.0001,850,854,25,50,0.0001,1704,4
0.482,0.0001,904,900,25,50,0.0001,1804,4
0.482,0.0001,958,946,25,50,0.0001,1904,4
0.488,0.0001,1004,1000,25,50,0.0001,2004,4
0.514,0.0001,63,41,25,50,0.0001,104,5
0.512,0.0001,114,90,25,50,0.0001,204,5
0.512,0.0001,164,140,25,50,0.0001,304,5
0.51,0.0001,208,196,25,50,0.0001,404,5
0.51,0.0001,259,245,25,50,0.0001,504,5
0.51,0.0001,310,294,25,50,0.0001,604,5
0.51,0.0001,372,332,25,50,0.0001,704,5
0.512,0.0001,434,370,25,50,0.0001,804,5
0.512,0.0001,479,425,25,50,0.0001,904,5
0.512,0.0001,523,481,25,50,0.0001,1004,5
0.516,0.0001,577,527,25,50,0.0001,1104,5
0.514,0.0001,626,578,25,50,0.0001,1204,5
0.514,0.0001,676,628,25,50,0.0001,1304,5
0.516,0.0001,726,678,25,50,0.0001,1404,5
0.526,0.0001,769,735,25,50,0.0001,1504,5
0.532,0.0001,813,791,25,50,0.0001,1604,5
0.532,0.0001,858,846,25,50,0.0001,1704,5
0.534,0.0001,908,896,25,50,0.0001,1804,5
0.534,0.0001,955,949,25,50,0.0001,1904,5
0.544,0.0001,1004,1000,25,50,0.0001,2004,5
0.53,0.0001,51,53,25,50,0.0001,104,6
0.528,0.0001,103,101,25,50,0.0001,204,6
0.528,0.0001,155,149,25,50,0.0001,304,6
0.53,0.0001,202,202,25,50,0.0001,404,6
0.53,0.0001,250,254,25,50,0.0001,504,6
0.536,0.0001,295,309,25,50,0.0001,604,6
0.54,0.0001,350,354,25,50,0.0001,704,6
0.536,0.0001,395,409,25,50,0.0001,804,6
0.534,0.0001,455,449,25,50,0.0001,904,6
0.544,0.0001,501,503,25,50,0.0001,1004,6
0.542,0.0001,554,550,25,50,0.0001,1104,6
0.546,0.0001,605,599,25,50,0.0001,1204,6
0.546,0.0001,656,648,25,50,0.0001,1304,6
0.548,0.0001,708,696,25,50,0.0001,1404,6
0.552,0.0001,760,744,25,50,0.0001,1504,6
0.552,0.0001,803,801,25,50,0.0001,1604,6
0.552,0.0001,851,853,25,50,0.0001,1704,6
0.558,0.0001,907,897,25,50,0.0001,1804,6
0.558,0.0001,966,938,25,50,0.0001,1904,6
0.556,0.0001,1016,988,25,50,0.0001,2004,6
0.506,0.0001,52,52,25,50,0.0001,104,7
0.506,0.0001,98,106,25,50,0.0001,204,7
0.506,0.0001,148,156,25,50,0.0001,304,7
0.508,0.0001,203,201,25,50,0.0001,404,7
0.508,0.0001,253,251,25,50,0.0001,504,7
0.506,0.0001,304,300,25,50,0.0001,604,7
0.506,0.0001,348,356,25,50,0.0001,704,7
0.512,0.0001,393,411,25,50,0.0001,804,7
0.512,0.0001,440,464,25,50,0.0001,904,7
0.514,0.0001,490,514,25,50,0.0001,1004,7
0.512,0.0001,538,566,25,50,0.0001,1104,7
0.51,0.0001,584,620,25,50,0.0001,1204,7
0.516,0.0001,636,668,25,50,0.0001,1304,7
0.518,0.0001,683,721,25,50,0.0001,1404,7
0.518,0.0001,740,764,25,50,0.0001,1504,7
0.522,0.0001,793,811,25,50,0.0001,1604,7
0.52,0.0001,847,857,25,50,0.0001,1704,7
0.516,0.0001,903,901,25,50,0.0001,1804,7
0.516,0.0001,941,963,25,50,0.0001,1904,7
0.518,0.0001,996,1008,25,50,0.0001,2004,7
0.488,0.0001,55,49,25,50,0.0001,104,8
0.492,0.0001,101,103,25,50,0.0001,204,8
0.49,0.0001,144,160,25,50,0.0001,304,8
0.488,0.0001,199,205,25,50,0.0001,404,8
0.49,0.0001,251,253,25,50,0.0001,504,8
0.488,0.0001,299,305,25,50,0.0001,604,8
0.486,0.0001,351,353,25,50,0.0001,704,8
0.486,0.0001,396,408,25,50,0.0001,804,8
0.49,0.0001,449,455,25,50,0.0001,904,8
0.49,0.0001,498,506,25,50,0.0001,1004,8
0.49,0.0001,553,551,25,50,0.0001,1104,8
0.49,0.0001,598,606,25,50,0.0001,1204,8
0.492,0.0001,645,659,25,50,0.0001,1304,8
0.496,0.0001,694,710,25,50,0.0001,1404,8
0.502,0.0001,753,751,25,50,0.0001,1504,8
0.502,0.0001,801,803,25,50,0.0001,1604,8
0.502,0.0001,850,854,25,50,0.0001,1704,8
0.502,0.0001,900,904,25,50,0.0001,1804,8
0.502,0.0001,948,956,25,50,0.0001,1904,8
0.506,0.0001,1002,1002,25,50,0.0001,2004,8
0.528,0.0001,49,55,25,50,0.0001,104,9
0.528,0.0001,99,105,25,50,0.0001,204,9
0.528,0.0001,152,152,25,50,0.0001,304,9
0.53,0.0001,199,205,25,50,0.0001,404,9
0.53,0.0001,244,260,25,50,0.0001,504,9
0.53,0.0001,292,312,25,50,0.0001,604,9
0.528,0.0001,341,363,25,50,0.0001,704,9
0.53,0.0001,397,407,25,50,0.0001,804,9
0.528,0.0001,445,459,25,50,0.0001,904,9
0.532,0.0001,492,512,25,50,0.0001,1004,9
0.534,0.0001,547,557,25,50,0.0001,1104,9
0.532,0.0001,606,598,25,50,0.0001,1204,9
0.532,0.0001,654,650,25,50,0.0001,1304,9
0.532,0.0001,701,703,25,50,0.0001,1404,9
0.53,0.0001,755,749,25,50,0.0001,1504,9
0.532,0.0001,807,797,25,50,0.0001,1604,9
0.532,0.0001,850,854,25,50,0.0001,1704,9
0.528,0.0001,901,903,25,50,0.0001,1804,9
0.532,0.0001,954,950,25,50,0.0001,1904,9
0.536,0.0001,1001,1003,25,50,0.0001,2004,9
0.512,0.0001,57,47,25,50,0.0001,104,10
0.512,0.0001,107,97,25,50,0.0001,204,10
0.512,0.0001,154,150,25,50,0.0001,304,10
0.512,0.0001,197,207,25,50,0.0001,404,10
0.51,0.0001,253,251,25,50,0.0001,504,10
0.51,0.0001,300,304,25,50,0.0001,604,10
0.506,0.0001,356,348,25,50,0.0001,704,10
0.506,0.0001,412,392,25,50,0.0001,804,10
0.504,0.0001,458,446,25,50,0.0001,904,10
0.506,0.0001,504,500,25,50,0.0001,1004,10
0.502,0.0001,558,546,25,50,0.0001,1104,10
0.502,0.0001,610,594,25,50,0.0001,1204,10
0.502,0.0001,666,638,25,50,0.0001,1304,10
0.506,0.0001,714,690,25,50,0.0001,1404,10
0.508,0.0001,761,743,25,50,0.0001,1504,10
0.512,0.0001,809,795,25,50,0.0001,1604,10
0.522,0.0001,855,849,25,50,0.0001,1704,10
0.524,0.0001,911,893,25,50,0.0001,1804,10
0.526,0.0001,961,943,25,50,0.0001,1904,10
0.524,0.0001,1008,996,25,50,0.0001,2004,10
0.478,0.0001,47,57,25,50,0.0001,104,11
0.474,0.0001,90,114,25,50,0.0001,204,11
0.474,0.0001,138,166,25,50,0.0001,304,11
0.476,0.0001,190,214,25,50,0.0001,404,11
0.476,0.0001,249,255,25,50,0.0001,504,11
0.476,0.0001,297,307,25,50,0.0001,604,11
0.48,0.0001,350,354,25,50,0.0001,704,11
0.48,0.0001,395,409,25,50,0.0001,804,11
0.48,0.0001,457,447,25,50,0.0001,904,11
0.48,0.0001,515,489,25,50,0.0001,1004,11
0.48,0.0001,563,541,25,50,0.0001,1104,11
0.482,0.0001,609,595,25,50,0.0001,1204,11
0.484,0.0001,660,644,25,50,0.0001,1304,11
0.486,0.0001,712,692,25,50,0.0001,1404,11
0.496,0.0001,755,749,25,50,0.0001,1504,11
0.5,0.0001,799,805,25,50,0.0001,1604,11
0.502,0.0001,852,852,25,50,0.0001,1704,11
0.504,0.0001,910,894,25,50,0.0001,1804,11
0.512,0.0001,960,944,25,50,0.0001,1904,11
0.516,0.0001,1004,1000,25,50,0.0001,2004,11
0.526,0.0001,46,58,25,50,0.0001,104,12
0.528,0.0001,96,108,25,50,0.0001,204,12
0.528,0.0001,155,149,25,50,0.0001,304,12
0.528,0.0001,206,198,25,50,0.0001,404,12
0.526,0.0001,258,246,25,50,0.0001,504,12
0.526,0.0001,315,289,25,50,0.0001,604,12
0.526,0.0001,361,343,25,50,0.0001,704,12
0.528,0.0001,411,393,25,50,0.0001,804,12
0.528,0.0001,460,444,25,50,0.0001,904,12
0.528,0.0001,509,495,25,50,0.0001,1004,12
0.53,0.0001,567,537,25,50,0.0001,1104,12
0.528,0.0001,620,584,25,50,0.0001,1204,12
0.53,0.0001,665,639,25,50,0.0001,1304,12
0.53,0.0001,713,691,25,50,0.0001,1404,12
0.53,0.0001,761,743,25,50,0.0001,1504,12
0.532,0.0001,805,799,25,50,0.0001,1604,12
0.534,0.0001,863,841,25,50,0.0001,1704,12
0.536,0.0001,912,892,25,50,0.0001,1804,12
0.538,0.0001,961,943,25,50,0.0001,1904,12
0.538,0.0001,1010,994,25,50,0.0001,2004,12
0.548,0.0001,53,51,25,50,0.0001,104,13
0.548,0.0001,96,108,25,50,0.0001,204,13
0.548,0.0001,149,155,25,50,0.0001,304,13
0.55,0.0001,205,199,25,50,0.0001,404,13
0.554,0.0001,255,249,25,50,0.0001,504,13
0.554,0.0001,310,294,25,50,0.0001,604,13
0.556,0.0001,363,341,25,50,0.0001,704,13
0.556,0.0001,423,381,25,50,0.0001,804,13
0.56,0.0001,478,426,25,50,0.0001,904,13
0.558,0.0001,527,477,25,50,0.0001,1004,13
0.556,0.0001,579,525,25,50,0.0001,1104,13
0.554,0.0001,628,576,25,50,0.0001,1204,13
0.556,0.0001,681,623,25,50,0.0001,1304,13
0.554,0.0001,730,674,25,50,0.0001,1404,13
0.56,0.0001,781,723,25,50,0.0001,1504,13
0.564,0.0001,823,781,25,50,0.0001,1604,13
0.566,0.0001,865,839,25,50,0.0001,1704,13
0.566,0.0001,916,888,25,50,0.0001,1804,13
0.566,0.0001,963,941,25,50,0.0001,1904,13
0.568,0.0001,1014,990,25,50,0.0001,2004,13
0.486,0.0001,49,55,25,50,0.0001,104,14
0.49,0.0001,99,105,25,50,0.0001,204,14
0.49,0.0001,149,155,25,50,0.0001,304,14
0.492,0.0001,197,207,25,50,0.0001,404,14
0.494,0.0001,246,258,25,50,0.0001,504,14
0.498,0.0001,304,300,25,50,0.0001,604,14
0.506,0.0001,340,364,25,50,0.0001,704,14
0.506,0.0001,400,404,25,50,0.0001,804,14
0.51,0.0001,442,462,25,50,0.0001,904,14
0.516,0.0001,488,516,25,50,0.0001,1004,14
0.51,0.0001,538,566,25,50,0.0001,1104,14
0.516,0.0001,584,620,25,50,0.0001,1204,14
0.516,0.0001,640,664,25,50,0.0001,1304,14
0.516,0.0001,686,718,25,50,0.0001,1404,14
0.514,0.0001,739,765,25,50,0.0001,1504,14
0.52,0.0001,787,817,25,50,0.0001,1604,14
0.524,0.0001,844,860,25,50,0.0001,1704,14
0.528,0.0001,892,912,25,50,0.0001,1804,14
0.532,0.0001,949,955,25,50,0.0001,1904,14
0.53,0.0001,1001,1003,25,50,0.0001,2004,14
0.49,0.0001,52,52,25,50,0.0001,104,15
0.49,0.0001,104,100,25,50,0.0001,204,15
0.488,0.0001,156,148,25,50,0.0001,304,15
0.488,0.0001,203,201,25,50,0.0001,404,15
0.488,0.0001,258,246,25,50,0.0001,504,15
0.49,0.0001,315,289,25,50,0.0001,604,15
0.488,0.0001,366,338,25,50,0.0001,704,15
0.49,0.0001,413,391,25,50,0.0001,804,15
0.492,0.0001,464,440,25,50,0.0001,904,15
0.49,0.0001,521,483,25,50,0.0001,1004,15
0.494,0.0001,575,529,25,50,0.0001,1104,15
0.494,0.0001,629,575,25,50,0.0001,1204,15
0.494,0.0001,681,623,25,50,0.0001,1304,15
0.502,0.0001,730,674,25,50,0.0001,1404,15
0.508,0.0001,782,722,25,50,0.0001,1504,15
0.502,0.0001,830,774,25,50,0.0001,1604,15
0.502,0.0001,879,825,25,50,0.0001,1704,15
0.504,0.0001,924,880,25,50,0.0001,1804,15
0.508,0.0001,967,937,25,50,0.0001,1904,15
0.514,0.0001,1017,987,25,50,0.0001,2004,15
0.462,0.0001,62,42,25,50,0.0001,104,16
0.464,0.0001,114,90,25,50,0.0001,204,16
0.464,0.0001,162,142,25,50,0.0001,304,16
0.464,0.0001,208,196,25,50,0.0001,404,16
0.464,0.0001,261,243,25,50,0.0001,504,16
0.462,0.0001,302,302,25,50,0.0001,604,16
0.46,0.0001,346,358,25,50,0.0001,704,16
0.464,0.0001,394,410,25,50,0.0001,804,16
0.462,0.0001,444,460,25,50,0.0001,904,16
0.458,0.0001,508,496,25,50,0.0001,1004,16
0.46,0.0001,559,545,25,50,0.0001,1104,16
0.462,0.0001,611,593,25,50,0.0001,1204,16
0.462,0.0001,661,643,25,50,0.0001,1304,16
0.468,0.0001,718,686,25,50,0.0001,1404,16
0.468,0.0001,768,736,25,50,0.0001,1504,16
0.466,0.0001,820,784,25,50,0.0001,1604,16
0.466,0.0001,874,830,25,50,0.0001,1704,16
0.476,0.0001,919,885,25,50,0.0001,1804,16
0.478,0.0001,972,932,25,50,0.0001,1904,16
0.48,0.0001,1012,992,25,50,0.0001,2004,16
0.488,0.0001,49,55,25,50,0.0001,104,17
0.488,0.0001,102,102,25,50,0.0001,204,17
0.488,0.0001,151,153,25,50,0.0001,304,17
0.488,0.0001,202,202,25,50,0.0001,404,17
0.488,0.0001,245,259,25,50,0.0001,504,17
0.486,0.0001,299,305,25,50,0.0001,604,17
0.486,0.0001,348,356,25,50,0.0001,704,17
0.486,0.0001,406,398,25,50,0.0001,804,17
0.488,0.0001,459,445,25,50,0.0001,904,17
0.484,0.0001,516,488,25,50,0.0001,1004,17
0.484,0.0001,559,545,25,50,0.0001,1104,17
0.484,0.0001,606,598,25,50,0.0001,1204,17
0.488,0.0001,654,650,25,50,0.0001,1304,17
0.486,0.0001,708,696,25,50,0.0001,1404,17
0.488,0.0001,767,737,25,50,0.0001,1504,17
0.488,0.0001,814,790,25,50,0.0001,1604,17
0.488,0.0001,860,844,25,50,0.0001,1704,17
0.49,0.0001,911,893,25,50,0.0001,1804,17
0.488,0.0001,956,948,25,50,0.0001,1904,17
0.484,0.0001,1002,1002,25,50,0.0001,2004,17
0.478,0.0001,55,49,25,50,0.0001,104,18
0.478,0.0001,100,104,25,50,0.0001,204,18
0.476,0.0001,159,145,25,50,0.0001,304,18
0.472,0.0001,207,197,25,50,0.0001,404,18
0.472,0.0001,256,248,25,50,0.0001,504,18
0.474,0.0001,297,307,25,50,0.0001,604,18
0.476,0.0001,354,350,25,50,0.0001,704,18
0.478,0.0001,403,401,25,50,0.0001,804,18
0.478,0.0001,447,457,25,50,0.0001,904,18
0.476,0.0001,492,512,25,50,0.0001,1004,18
0.476,0.0001,535,569,25,50,0.0001,1104,18
0.476,0.0001,586,618,25,50,0.0001,1204,18
0.476,0.0001,631,673,25,50,0.0001,1304,18
0.476,0.0001,670,734,25,50,0.0001,1404,18
0.476,0.0001,725,779,25,50,0.0001,1504,18
0.478,0.0001,780,824,25,50,0.0001,1604,18
0.482,0.0001,828,876,25,50,0.0001,1704,18
0.482,0.0001,887,917,25,50,0.0001,1804,18
0.484,0.0001,933,971,25,50,0.0001,1904,18
0.486,0.0001,986,1018,25,50,0.0001,2004,18
0.492,0.0001,50,54,25,50,0.0001,104,19
0.492,0.0001,97,107,25,50,0.0001,204,19
0.492,0.0001,145,159,25,50,0.0001,304,19
0.494,0.0001,199,205,25,50,0.0001,404,19
0.494,0.0001,253,251,25,50,0.0001,504,19
0.494,0.0001,308,296,25,50,0.0001,604,19
0.496,0.0001,349,355,25,50,0.0001,704,19
0.496,0.0001,398,406,25,50,0.0001,804,19
0.496,0.0001,444,460,25,50,0.0001,904,19
0.502,0.0001,498,506,25,50,0.0001,1004,19
0.5,0.0001,546,558,25,50,0.0001,1104,19
0.502,0.0001,597,607,25,50,0.0001,1204,19
0.508,0.0001,644,660,25,50,0.0001,1304,19
0.508,0.0001,689,715,25,50,0.0001,1404,19
0.508,0.0001,736,768,25,50,0.0001,1504,19
0.508,0.0001,787,817,25,50,0.0001,1604,19
0.508,0.0001,836,868,25,50,0.0001,1704,19
0.508,0.0001,886,918,25,50,0.0001,1804,19
0.508,0.0001,944,960,25,50,0.0001,1904,19
0.51,0.0001,993,1011,25,50,0.0001,2004,19
0.536,0.0001,53,51,25,50,0.0001,104,20
0.536,0.0001,98,106,25,50,0.0001,204,20
0.536,0.0001,151,153,25,50,0.0001,304,20
0.536,0.0001,195,209,25,50,0.0001,404,20
0.536,0.0001,245,259,25,50,0.0001,504,20
0.536,0.0001,296,308,25,50,0.0001,604,20
0.54,0.0001,342,362,25,50,0.0001,704,20
0.54,0.0001,395,409,25,50,0.0001,804,20
0.54,0.0001,447,457,25,50,0.0001,904,20
0.542,0.0001,487,517,25,50,0.0001,1004,20
0.544,0.0001,544,560,25,50,0.0001,1104,20
0.548,0.0001,597,607,25,50,0.0001,1204,20
0.554,0.0001,643,661,25,50,0.0001,1304,20
0.558,0.0001,687,717,25,50,0.0001,1404,20
0.56,0.0001,738,766,25,50,0.0001,1504,20
0.564,0.0001,787,817,25,50,0.0001,1604,20
0.568,0.0001,841,863,25,50,0.0001,1704,20
0.57,0.0001,898,906,25,50,0.0001,1804,20
0.574,0.0001,954,950,25,50,0.0001,1904,20
0.576,0.0001,1003,1001,25,50,0.0001,2004,20
0.51,0.0001,51,53,25,50,0.001,104,1
0.51,0.0001,111,93,25,50,0.001,204,1
0.51,0.0001,161,143,25,50,0.001,304,1
0.512,0.0001,209,195,25,50,0.001,404,1
0.514,0.0001,265,239,25,50,0.001,504,1
0.516,0.0001,308,296,25,50,0.001,604,1
0.522,0.0001,354,350,25,50,0.001,704,1
0.528,0.0001,407,397,25,50,0.001,804,1
0.542,0.0001,451,453,25,50,0.001,904,1
0.56,0.0001,499,505,25,50,0.001,1004,1
0.562,0.0001,545,559,25,50,0.001,1104,1
0.566,0.0001,596,608,25,50,0.001,1204,1
0.59,0.0001,644,660,25,50,0.001,1304,1
0.596,0.0001,697,707,25,50,0.001,1404,1
0.614,0.0001,756,748,25,50,0.001,1504,1
0.64,0.0001,797,807,25,50,0.001,1604,1
0.674,0.0001,852,852,25,50,0.001,1704,1
0.704,0.0001,905,899,25,50,0.001,1804,1
0.726,0.0001,951,953,25,50,0.001,1904,1
0.75,0.0001,1006,998,25,50,0.001,2004,1
0.476,0.0001,59,45,25,50,0.001,104,2
0.476,0.0001,113,91,25,50,0.001,204,2
0.486,0.0001,165,139,25,50,0.001,304,2
0.486,0.0001,210,194,25,50,0.001,404,2
0.494,0.0001,256,248,25,50,0.001,504,2
0.5,0.0001,301,303,25,50,0.001,604,2
0.506,0.0001,353,351,25,50,0.001,704,2
0.522,0.0001,409,395,25,50,0.001,804,2
0.536,0.0001,449,455,25,50,0.001,904,2
0.552,0.0001,504,500,25,50,0.001,1004,2
0.568,0.0001,551,553,25,50,0.001,1104,2
0.594,0.0001,598,606,25,50,0.001,1204,2
0.608,0.0001,639,665,25,50,0.001,1304,2
0.624,0.0001,693,711,25,50,0.001,1404,2
0.636,0.0001,742,762,25,50,0.001,1504,2
0.678,0.0001,795,809,25,50,0.001,1604,2
0.712,0.0001,844,860,25,50,0.001,1704,2
0.746,0.0001,898,906,25,50,0.001,1804,2
0.772,0.0001,951,953,25,50,0.001,1904,2
0.81,0.0001,998,1006,25,50,0.001,2004,2
0.504,0.0001,55,49,25,50,0.001,104,3
0.502,0.0001,99,105,25,50,0.001,204,3
0.494,0.0001,148,156,25,50,0.001,304,3
0.5,0.0001,191,213,25,50,0.001,404,3
0.504,0.0001,238,266,25,50,0.001,504,3
0.506,0.0001,296,308,25,50,0.001,604,3
0.524,0.0001,335,369,25,50,0.001,704,3
0.52,0.0001,396,408,25,50,0.001,804,3
0.528,0.0001,443,461,25,50,0.001,904,3
0.532,0.0001,494,510,25,50,0.001,1004,3
0.54,0.0001,542,562,25,50,0.001,1104,3
0.566,0.0001,591,613,25,50,0.001,1204,3
0.6,0.0001,632,672,25,50,0.001,1304,3
0.62,0.0001,677,727,25,50,0.001,1404,3
0.642,0.0001,737,767,25,50,0.001,1504,3
0.668,0.0001,789,815,25,50,0.001,1604,3
0.692,0.0001,836,868,25,50,0.001,1704,3
0.714,0.0001,891,913,25,50,0.001,1804,3
0.736,0.0001,942,962,25,50,0.001,1904,3
0.754,0.0001,1002,1002,25,50,0.001,2004,3
0.5,0.0001,47,57,25,50,0.001,104,4
0.504,0.0001,99,105,25,50,0.001,204,4
0.514,0.0001,144,160,25,50,0.001,304,4
0.522,0.0001,198,206,25,50,0.001,404,4
0.528,0.0001,256,248,25,50,0.001,504,4
0.538,0.0001,304,300,25,50,0.001,604,4
0.56,0.0001,355,349,25,50,0.001,704,4
0.56,0.0001,403,401,25,50,0.001,804,4
0.562,0.0001,455,449,25,50,0.001,904,4
0.57,0.0001,509,495,25,50,0.001,1004,4
0.584,0.0001,563,541,25,50,0.001,1104,4
0.594,0.0001,612,592,25,50,0.001,1204,4
0.614,0.0001,661,643,25,50,0.001,1304,4
0.634,0.0001,711,693,25,50,0.001,1404,4
0.65,0.0001,756,748,25,50,0.001,1504,4
0.672,0.0001,812,792,25,50,0.001,1604,4
0.698,0.0001,853,851,25,50,0.001,1704,4
0.734,0.0001,904,900,25,50,0.001,1804,4
0.758,0.0001,952,952,25,50,0.001,1904,4
0.786,0.0001,1004,1000,25,50,0.001,2004,4
0.532,0.0001,46,58,25,50,0.001,104,5
0.542,0.0001,109,95,25,50,0.001,204,5
0.544,0.0001,151,153,25,50,0.001,304,5
0.556,0.0001,199,205,25,50,0.001,404,5
0.562,0.0001,254,250,25,50,0.001,504,5
0.576,0.0001,298,306,25,50,0.001,604,5
0.592,0.0001,349,355,25,50,0.001,704,5
0.604,0.0001,401,403,25,50,0.001,804,5
0.618,0.0001,446,458,25,50,0.001,904,5
0.63,0.0001,494,510,25,50,0.001,1004,5
0.636,0.0001,540,564,25,50,0.001,1104,5
0.644,0.0001,599,605,25,50,0.001,1204,5
0.654,0.0001,647,657,25,50,0.001,1304,5
0.674,0.0001,704,700,25,50,0.001,1404,5
0.682,0.0001,753,751,25,50,0.001,1504,5
0.702,0.0001,805,799,25,50,0.001,1604,5
0.72,0.0001,853,851,25,50,0.001,1704,5
0.746,0.0001,907,897,25,50,0.001,1804,5
0.762,0.0001,959,945,25,50,0.001,1904,5
0.792,0.0001,1006,998,25,50,0.001,2004,5
0.446,0.0001,53,51,25,50,0.001,104,6
0.47,0.0001,94,110,25,50,0.001,204,6
0.474,0.0001,143,161,25,50,0.001,304,6
0.486,0.0001,193,211,25,50,0.001,404,6
0.498,0.0001,250,254,25,50,0.001,504,6
0.502,0.0001,300,304,25,50,0.001,604,6
0.504,0.0001,351,353,25,50,0.001,704,6
0.516,0.0001,399,405,25,50,0.001,804,6
0.54,0.0001,454,450,25,50,0.001,904,6
0.548,0.0001,508,496,25,50,0.001,1004,6
0.556,0.0001,559,545,25,50,0.001,1104,6
0.566,0.0001,614,590,25,50,0.001,1204,6
0.584,0.0001,670,634,25,50,0.001,1304,6
0.606,0.0001,718,686,25,50,0.001,1404,6
0.632,0.0001,768,736,25,50,0.001,1504,6
0.646,0.0001,818,786,25,50,0.001,1604,6
0.654,0.0001,863,841,25,50,0.001,1704,6
0.668,0.0001,904,900,25,50,0.001,1804,6
0.692,0.0001,956,948,25,50,0.001,1904,6
0.718,0.0001,1009,995,25,50,0.001,2004,6
0.55,0.0001,51,53,25,50,0.001,104,7
0.558,0.0001,102,102,25,50,0.001,204,7
0.552,0.0001,150,154,25,50,0.001,304,7
0.556,0.0001,194,210,25,50,0.001,404,7
0.56,0.0001,246,258,25,50,0.001,504,7
0.57,0.0001,297,307,25,50,0.001,604,7
0.594,0.0001,351,353,25,50,0.001,704,7
0.608,0.0001,400,404,25,50,0.001,804,7
0.608,0.0001,453,451,25,50,0.001,904,7
0.612,0.0001,510,494,25,50,0.001,1004,7
0.63,0.0001,559,545,25,50,0.001,1104,7
0.646,0.0001,611,593,25,50,0.001,1204,7
0.656,0.0001,657,647,25,50,0.001,1304,7
0.696,0.0001,710,694,25,50,0.001,1404,7
0.732,0.0001,763,741,25,50,0.001,1504,7
0.742,0.0001,822,782,25,50,0.001,1604,7
0.764,0.0001,868,836,25,50,0.001,1704,7
0.78,0.0001,910,894,25,50,0.001,1804,7
0.796,0.0001,961,943,25,50,0.001,1904,7
0.818,0.0001,1014,990,25,50,0.001,2004,7
0.502,0.0001,45,59,25,50,0.001,104,8
0.502,0.0001,92,112,25,50,0.001,204,8
0.508,0.0001,145,159,25,50,0.001,304,8
0.516,0.0001,196,208,25,50,0.001,404,8
0.5,0.0001,246,258,25,50,0.001,504,8
0.488,0.0001,296,308,25,50,0.001,604,8
0.484,0.0001,341,363,25,50,0.001,704,8
0.496,0.0001,386,418,25,50,0.001,804,8
0.5,0.0001,442,462,25,50,0.001,904,8
0.496,0.0001,497,507,25,50,0.001,1004,8
0.514,0.0001,541,563,25,50,0.001,1104,8
0.544,0.0001,592,612,25,50,0.001,1204,8
0.578,0.0001,645,659,25,50,0.001,1304,8
0.598,0.0001,699,705,25,50,0.001,1404,8
0.606,0.0001,751,753,25,50,0.001,1504,8
0.626,0.0001,805,799,25,50,0.001,1604,8
0.644,0.0001,858,846,25,50,0.001,1704,8
0.658,0.0001,904,900,25,50,0.001,1804,8
0.67,0.0001,953,951,25,50,0.001,1904,8
0.698,0.0001,1000,1004,25,50,0.001,2004,8
0.548,0.0001,46,58,25,50,0.001,104,9
0.552,0.0001,93,111,25,50,0.001,204,9
0.56,0.0001,148,156,25,50,0.001,304,9
0.568,0.0001,205,199,25,50,0.001,404,9
0.566,0.0001,257,247,25,50,0.001,504,9
0.574,0.0001,310,294,25,50,0.001,604,9
0.586,0.0001,361,343,25,50,0.001,704,9
0.594,0.0001,419,385,25,50,0.001,804,9
0.602,0.0001,467,437,25,50,0.001,904,9
0.634,0.0001,510,494,25,50,0.001,1004,9
0.658,0.0001,556,548,25,50,0.001,1104,9
0.668,0.0001,609,595,25,50,0.001,1204,9
0.692,0.0001,656,648,25,50,0.001,1304,9
0.706,0.0001,703,701,25,50,0.001,1404,9
0.716,0.0001,745,759,25,50,0.001,1504,9
0.734,0.0001,796,808,25,50,0.001,1604,9
0.768,0.0001,846,858,25,50,0.001,1704,9
0.796,0.0001,900,904,25,50,0.001,1804,9
0.808,0.0001,945,959,25,50,0.001,1904,9
0.83,0.0001,1002,1002,25,50,0.001,2004,9
0.498,0.0001,56,48,25,50,0.001,104,10
0.502,0.0001,105,99,25,50,0.001,204,10
0.508,0.0001,158,146,25,50,0.001,304,10
0.528,0.0001,211,193,25,50,0.001,404,10
0.526,0.0001,259,245,25,50,0.001,504,10
0.53,0.0001,315,289,25,50,0.001,604,10
0.54,0.0001,362,342,25,50,0.001,704,10
0.554,0.0001,412,392,25,50,0.001,804,10
0.554,0.0001,462,442,25,50,0.001,904,10
0.566,0.0001,507,497,25,50,0.001,1004,10
0.59,0.0001,554,550,25,50,0.001,1104,10
0.598,0.0001,612,592,25,50,0.001,1204,10
0.608,0.0001,656,648,25,50,0.001,1304,10
0.624,0.0001,710,694,25,50,0.001,1404,10
0.654,0.0001,749,755,25,50,0.001,1504,10
0.678,0.0001,801,803,25,50,0.001,1604,10
0.696,0.0001,845,859,25,50,0.001,1704,10
0.71,0.0001,892,912,25,50,0.001,1804,10
0.742,0.0001,931,973,25,50,0.001,1904,10
0.772,0.0001,989,1015,25,50,0.001,2004,10
0.57,0.0001,44,60,25,50,0.001,104,11
0.57,0.0001,96,108,25,50,0.001,204,11
0.568,0.0001,145,159,25,50,0.001,304,11
0.576,0.0001,186,218,25,50,0.001,404,11
0.584,0.0001,237,267,25,50,0.001,504,11
0.592,0.0001,283,321,25,50,0.001,604,11
0.61,0.0001,338,366,25,50,0.001,704,11
0.62,0.0001,392,412,25,50,0.001,804,11
0.632,0.0001,443,461,25,50,0.001,904,11
0.646,0.0001,482,522,25,50,0.001,1004,11
0.67,0.0001,534,570,25,50,0.001,1104,11
0.684,0.0001,588,616,25,50,0.001,1204,11
0.696,0.0001,638,666,25,50,0.001,1304,11
0.712,0.0001,687,717,25,50,0.001,1404,11
0.732,0.0001,732,772,25,50,0.001,1504,11
0.75,0.0001,779,825,25,50,0.001,1604,11
0.77,0.0001,828,876,25,50,0.001,1704,11
0.796,0.0001,891,913,25,50,0.001,1804,11
0.824,0.0001,944,960,25,50,0.001,1904,11
0.854,0.0001,994,1010,25,50,0.001,2004,11
0.514,0.0001,50,54,25,50,0.001,104,12
0.52,0.0001,91,113,25,50,0.001,204,12
0.516,0.0001,141,163,25,50,0.001,304,12
0.502,0.0001,191,213,25,50,0.001,404,12
0.508,0.0001,245,259,25,50,0.001,504,12
0.52,0.0001,291,313,25,50,0.001,604,12
0.522,0.0001,344,360,25,50,0.001,704,12
0.528,0.0001,401,403,25,50,0.001,804,12
0.544,0.0001,451,453,25,50,0.001,904,12
0.554,0.0001,512,492,25,50,0.001,1004,12
0.582,0.0001,570,534,25,50,0.001,1104,12
0.592,0.0001,619,585,25,50,0.001,1204,12
0.618,0.0001,665,639,25,50,0.001,1304,12
0.628,0.0001,713,691,25,50,0.001,1404,12
0.65,0.0001,773,731,25,50,0.001,1504,12
0.674,0.0001,821,783,25,50,0.001,1604,12
0.69,0.0001,862,842,25,50,0.001,1704,12
0.712,0.0001,913,891,25,50,0.001,1804,12
0.724,0.0001,965,939,25,50,0.001,1904,12
0.756,0.0001,1011,993,25,50,0.001,2004,12
0.494,0.0001,53,51,25,50,0.001,104,13
0.492,0.0001,94,110,25,50,0.001,204,13
0.492,0.0001,138,166,25,50,0.001,304,13
0.504,0.0001,195,209,25,50,0.001,404,13
0.524,0.0001,248,256,25,50,0.001,504,13
0.536,0.0001,297,307,25,50,0.001,604,13
0.546,0.0001,350,354,25,50,0.001,704,13
0.568,0.0001,397,407,25,50,0.001,804,13
0.574,0.0001,435,469,25,50,0.001,904,13
0.594,0.0001,485,519,25,50,0.001,1004,13
0.608,0.0001,539,565,25,50,0.001,1104,13
0.622,0.0001,592,612,25,50,0.001,1204,13
0.65,0.0001,641,663,25,50,0.001,1304,13
0.662,0.0001,693,711,25,50,0.001,1404,13
0.684,0.0001,742,762,25,50,0.001,1504,13
0.7,0.0001,795,809,25,50,0.001,1604,13
0.722,0.0001,855,849,25,50,0.001,1704,13
0.734,0.0001,896,908,25,50,0.001,1804,13
0.752,0.0001,951,953,25,50,0.001,1904,13
0.774,0.0001,1002,1002,25,50,0.001,2004,13
0.498,0.0001,58,46,25,50,0.001,104,14
0.502,0.0001,110,94,25,50,0.001,204,14
0.506,0.0001,163,141,25,50,0.001,304,14
0.506,0.0001,216,188,25,50,0.001,404,14
0.506,0.0001,271,233,25,50,0.001,504,14
0.502,0.0001,318,286,25,50,0.001,604,14
0.508,0.0001,368,336,25,50,0.001,704,14
0.52,0.0001,417,387,25,50,0.001,804,14
0.534,0.0001,465,439,25,50,0.001,904,14
0.554,0.0001,518,486,25,50,0.001,1004,14
0.558,0.0001,575,529,25,50,0.001,1104,14
0.582,0.0001,633,571,25,50,0.001,1204,14
0.588,0.0001,673,631,25,50,0.001,1304,14
0.598,0.0001,729,675,25,50,0.001,1404,14
0.628,0.0001,779,725,25,50,0.001,1504,14
0.652,0.0001,824,780,25,50,0.001,1604,14
0.688,0.0001,885,819,25,50,0.001,1704,14
0.716,0.0001,933,871,25,50,0.001,1804,14
0.744,0.0001,974,930,25,50,0.001,1904,14
0.772,0.0001,1017,987,25,50,0.001,2004,14
0.522,0.0001,52,52,25,50,0.001,104,15
0.526,0.0001,106,98,25,50,0.001,204,15
0.526,0.0001,160,144,25,50,0.001,304,15
0.52,0.0001,210,194,25,50,0.001,404,15
0.534,0.0001,255,249,25,50,0.001,504,15
0.536,0.0001,304,300,25,50,0.001,604,15
0.552,0.0001,351,353,25,50,0.001,704,15
0.574,0.0001,408,396,25,50,0.001,804,15
0.596,0.0001,449,455,25,50,0.001,904,15
0.602,0.0001,505,499,25,50,0.001,1004,15
0.608,0.0001,544,560,25,50,0.001,1104,15
0.61,0.0001,600,604,25,50,0.001,1204,15
0.632,0.0001,648,656,25,50,0.001,1304,15
0.656,0.0001,695,709,25,50,0.001,1404,15
0.658,0.0001,747,757,25,50,0.001,1504,15
0.686,0.0001,793,811,25,50,0.001,1604,15
0.712,0.0001,855,849,25,50,0.001,1704,15
0.718,0.0001,910,894,25,50,0.001,1804,15
0.742,0.0001,954,950,25,50,0.001,1904,15
0.76,0.0001,1009,995,25,50,0.001,2004,15
0.486,0.0001,46,58,25,50,0.001,104,16
0.472,0.0001,97,107,25,50,0.001,204,16
0.48,0.0001,146,158,25,50,0.001,304,16
0.486,0.0001,195,209,25,50,0.001,404,16
0.49,0.0001,244,260,25,50,0.001,504,16
0.5,0.0001,295,309,25,50,0.001,604,16
0.508,0.0001,347,357,25,50,0.001,704,16
0.528,0.0001,389,415,25,50,0.001,804,16
0.544,0.0001,435,469,25,50,0.001,904,16
0.558,0.0001,485,519,25,50,0.001,1004,16
0.576,0.0001,538,566,25,50,0.001,1104,16
0.582,0.0001,599,605,25,50,0.001,1204,16
0.598,0.0001,656,648,25,50,0.001,1304,16
0.614,0.0001,706,698,25,50,0.001,1404,16
0.628,0.0001,757,747,25,50,0.001,1504,16
0.646,0.0001,809,795,25,50,0.001,1604,16
0.656,0.0001,854,850,25,50,0.001,1704,16
0.688,0.0001,893,911,25,50,0.001,1804,16
0.724,0.0001,942,962,25,50,0.001,1904,16
0.748,0.0001,997,1007,25,50,0.001,2004,16
0.518,0.0001,57,47,25,50,0.001,104,17
0.504,0.0001,108,96,25,50,0.001,204,17
0.5,0.0001,159,145,25,50,0.001,304,17
0.502,0.0001,214,190,25,50,0.001,404,17
0.494,0.0001,267,237,25,50,0.001,504,17
0.492,0.0001,312,292,25,50,0.001,604,17
0.492,0.0001,362,342,25,50,0.001,704,17
0.498,0.0001,408,396,25,50,0.001,804,17
0.518,0.0001,460,444,25,50,0.001,904,17
0.518,0.0001,505,499,25,50,0.001,1004,17
0.536,0.0001,555,549,25,50,0.001,1104,17
0.562,0.0001,594,610,25,50,0.001,1204,17
0.592,0.0001,652,652,25,50,0.001,1304,17
0.614,0.0001,700,704,25,50,0.001,1404,17
0.64,0.0001,746,758,25,50,0.001,1504,17
0.672,0.0001,803,801,25,50,0.001,1604,17
0.688,0.0001,852,852,25,50,0.001,1704,17
0.714,0.0001,909,895,25,50,0.001,1804,17
0.736,0.0001,967,937,25,50,0.001,1904,17
0.778,0.0001,1015,989,25,50,0.001,2004,17
0.508,0.0001,57,47,25,50,0.001,104,18
0.518,0.0001,114,90,25,50,0.001,204,18
0.52,0.0001,162,142,25,50,0.001,304,18
0.53,0.0001,209,195,25,50,0.001,404,18
0.546,0.0001,259,245,25,50,0.001,504,18
0.558,0.0001,304,300,25,50,0.001,604,18
0.564,0.0001,353,351,25,50,0.001,704,18
0.568,0.0001,403,401,25,50,0.001,804,18
0.58,0.0001,452,452,25,50,0.001,904,18
0.6,0.0001,501,503,25,50,0.001,1004,18
0.616,0.0001,551,553,25,50,0.001,1104,18
0.626,0.0001,595,609,25,50,0.001,1204,18
0.646,0.0001,644,660,25,50,0.001,1304,18
0.652,0.0001,700,704,25,50,0.001,1404,18
0.668,0.0001,754,750,25,50,0.001,1504,18
0.686,0.0001,803,801,25,50,0.001,1604,18
0.698,0.0001,852,852,25,50,0.001,1704,18
0.72,0.0001,903,901,25,50,0.001,1804,18
0.742,0.0001,953,951,25,50,0.001,1904,18
0.776,0.0001,1000,1004,25,50,0.001,2004,18
0.498,0.0001,41,63,25,50,0.001,104,19
0.494,0.0001,88,116,25,50,0.001,204,19
0.5,0.0001,143,161,25,50,0.001,304,19
0.504,0.0001,190,214,25,50,0.001,404,19
0.52,0.0001,231,273,25,50,0.001,504,19
0.524,0.0001,291,313,25,50,0.001,604,19
0.516,0.0001,344,360,25,50,0.001,704,19
0.556,0.0001,396,408,25,50,0.001,804,19
0.568,0.0001,442,462,25,50,0.001,904,19
0.578,0.0001,494,510,25,50,0.001,1004,19
0.584,0.0001,539,565,25,50,0.001,1104,19
0.606,0.0001,588,616,25,50,0.001,1204,19
0.634,0.0001,642,662,25,50,0.001,1304,19
0.654,0.0001,691,713,25,50,0.001,1404,19
0.662,0.0001,749,755,25,50,0.001,1504,19
0.682,0.0001,796,808,25,50,0.001,1604,19
0.708,0.0001,849,855,25,50,0.001,1704,19
0.722,0.0001,907,897,25,50,0.001,1804,19
0.748,0.0001,947,957,25,50,0.001,1904,19
0.77,0.0001,997,1007,25,50,0.001,2004,19
0.5,0.0001,52,52,25,50,0.001,104,20
0.506,0.0001,103,101,25,50,0.001,204,20
0.504,0.0001,155,149,25,50,0.001,304,20
0.498,0.0001,206,198,25,50,0.001,404,20
0.504,0.0001,251,253,25,50,0.001,504,20
0.516,0.0001,295,309,25,50,0.001,604,20
0.514,0.0001,347,357,25,50,0.001,704,20
0.526,0.0001,392,412,25,50,0.001,804,20
0.528,0.0001,445,459,25,50,0.001,904,20
0.546,0.0001,496,508,25,50,0.001,1004,20
0.56,0.0001,548,556,25,50,0.001,1104,20
0.582,0.0001,594,610,25,50,0.001,1204,20
0.604,0.0001,651,653,25,50,0.001,1304,20
0.622,0.0001,707,697,25,50,0.001,1404,20
0.638,0.0001,759,745,25,50,0.001,1504,20
0.678,0.0001,813,791,25,50,0.001,1604,20
0.708,0.0001,864,840,25,50,0.001,1704,20
0.744,0.0001,910,894,25,50,0.001,1804,20
0.764,0.0001,962,942,25,50,0.001,1904,20
0.786,0.0001,1006,998,25,50,0.001,2004,20
0.49,0.0001,41,63,25,50,0.01,104,1
0.53,0.0001,91,113,25,50,0.01,204,1
0.546,0.0001,139,165,25,50,0.01,304,1
0.578,0.0001,190,214,25,50,0.01,404,1
0.618,0.0001,250,254,25,50,0.01,504,1
0.666,0.0001,300,304,25,50,0.01,604,1
0.708,0.0001,350,354,25,50,0.01,704,1
0.756,0.0001,406,398,25,50,0.01,804,1
0.79,0.0001,456,448,25,50,0.01,904,1
0.856,0.0001,513,491,25,50,0.01,1004,1
0.896,0.0001,560,544,25,50,0.01,1104,1
0.928,0.0001,603,601,25,50,0.01,1204,1
0.924,0.0001,649,655,25,50,0.01,1304,1
0.936,0.0001,690,714,25,50,0.01,1404,1
0.95,0.0001,737,767,25,50,0.01,1504,1
0.958,0.0001,783,821,25,50,0.01,1604,1
0.962,0.0001,838,866,25,50,0.01,1704,1
0.986,0.0001,892,912,25,50,0.01,1804,1
0.988,0.0001,945,959,25,50,0.01,1904,1
0.99,0.0001,998,1006,25,50,0.01,2004,1
0.506,0.0001,51,53,25,50,0.01,104,2
0.55,0.0001,103,101,25,50,0.01,204,2
0.572,0.0001,157,147,25,50,0.01,304,2
0.61,0.0001,208,196,25,50,0.01,404,2
0.638,0.0001,257,247,25,50,0.01,504,2
0.71,0.0001,302,302,25,50,0.01,604,2
0.736,0.0001,344,360,25,50,0.01,704,2
0.792,0.0001,385,419,25,50,0.01,804,2
0.828,0.0001,440,464,25,50,0.01,904,2
0.878,0.0001,494,510,25,50,0.01,1004,2
0.902,0.0001,556,548,25,50,0.01,1104,2
0.938,0.0001,614,590,25,50,0.01,1204,2
0.952,0.0001,669,635,25,50,0.01,1304,2
0.948,0.0001,717,687,25,50,0.01,1404,2
0.95,0.0001,767,737,25,50,0.01,1504,2
0.962,0.0001,815,789,25,50,0.01,1604,2
0.966,0.0001,867,837,25,50,0.01,1704,2
0.972,0.0001,917,887,25,50,0.01,1804,2
0.972,0.0001,967,937,25,50,0.01,1904,2
0.972,0.0001,1014,990,25,50,0.01,2004,2
0.518,0.0001,53,51,25,50,0.01,104,3
0.548,0.0001,102,102,25,50,0.01,204,3
0.566,0.0001,145,159,25,50,0.01,304,3
0.578,0.0001,196,208,25,50,0.01,404,3
0.592,0.0001,246,258,25,50,0.01,504,3
0.622,0.0001,295,309,25,50,0.01,604,3
0.652,0.0001,336,368,25,50,0.01,704,3
0.724,0.0001,380,424,25,50,0.01,804,3
0.786,0.0001,443,461,25,50,0.01,904,3
0.854,0.0001,498,506,25,50,0.01,1004,3
0.882,0.0001,547,557,25,50,0.01,1104,3
0.932,0.0001,592,612,25,50,0.01,1204,3
0.942,0.0001,647,657,25,50,0.01,1304,3
0.956,0.0001,694,710,25,50,0.01,1404,3
0.97,0.0001,731,773,25,50,0.01,1504,3
0.968,0.0001,782,822,25,50,0.01,1604,3
0.97,0.0001,836,868,25,50,0.01,1704,3
0.974,0.0001,893,911,25,50,0.01,1804,3
0.974,0.0001,952,952,25,50,0.01,1904,3
0.978,0.0001,1005,999,25,50,0.01,2004,3
0.516,0.0001,50,54,25,50,0.01,104,4
0.556,0.0001,100,104,25,50,0.01,204,4
0.588,0.0001,144,160,25,50,0.01,304,4
0.61,0.0001,202,202,25,50,0.01,404,4
0.624,0.0001,257,247,25,50,0.01,504,4
0.648,0.0001,306,298,25,50,0.01,604,4
0.686,0.0001,355,349,25,50,0.01,704,4
0.738,0.0001,414,390,25,50,0.01,804,4
0.758,0.0001,464,440,25,50,0.01,904,4
0.842,0.0001,508,496,25,50,0.01,1004,4
0.88,0.0001,561,543,25,50,0.01,1104,4
0.926,0.0001,609,595,25,50,0.01,1204,4
0.938,0.0001,661,643,25,50,0.01,1304,4
0.956,0.0001,713,691,25,50,0.01,1404,4
0.964,0.0001,763,741,25,50,0.01,1504,4
0.97,0.0001,816,788,25,50,0.01,1604,4
0.972,0.0001,866,838,25,50,0.01,1704,4
0.97,0.0001,909,895,25,50,0.01,1804,4
0.97,0.0001,961,943,25,50,0.01,1904,4
0.978,0.0001,1008,996,25,50,0.01,2004,4
0.55,0.0001,50,54,25,50,0.01,104,5
0.548,0.0001,94,110,25,50,0.01,204,5
0.568,0.0001,136,168,25,50,0.01,304,5
0.596,0.0001,187,217,25,50,0.01,404,5
0.622,0.0001,245,259,25,50,0.01,504,5
0.666,0.0001,292,312,25,50,0.01,604,5
0.698,0.0001,347,357,25,50,0.01,704,5
0.744,0.0001,395,409,25,50,0.01,804,5
0.782,0.0001,449,455,25,50,0.01,904,5
0.81,0.0001,495,509,25,50,0.01,1004,5
0.84,0.0001,547,557,25,50,0.01,1104,5
0.93,0.0001,601,603,25,50,0.01,1204,5
0.94,0.0001,657,647,25,50,0.01,1304,5
0.954,0.0001,705,699,25,50,0.01,1404,5
0.954,0.0001,761,743,25,50,0.01,1504,5
0.964,0.0001,806,798,25,50,0.01,1604,5
0.966,0.0001,857,847,25,50,0.01,1704,5
0.97,0.0001,922,882,25,50,0.01,1804,5
0.974,0.0001,973,931,25,50,0.01,1904,5
0.97,0.0001,1015,989,25,50,0.01,2004,5
0.508,0.0001,49,55,25,50,0.01,104,6
0.598,0.0001,104,100,25,50,0.01,204,6
0.654,0.0001,159,145,25,50,0.01,304,6
0.664,0.0001,209,195,25,50,0.01,404,6
0.688,0.0001,256,248,25,50,0.01,504,6
0.72,0.0001,307,297,25,50,0.01,604,6
0.766,0.0001,344,360,25,50,0.01,704,6
0.824,0.0001,390,414,25,50,0.01,804,6
0.86,0.0001,433,471,25,50,0.01,904,6
0.908,0.0001,487,517,25,50,0.01,1004,6
0.924,0.0001,533,571,25,50,0.01,1104,6
0.936,0.0001,588,616,25,50,0.01,1204,6
0.942,0.0001,640,664,25,50,0.01,1304,6
0.952,0.0001,702,702,25,50,0.01,1404,6
0.952,0.0001,756,748,25,50,0.01,1504,6
0.964,0.0001,804,800,25,50,0.01,1604,6
0.96,0.0001,850,854,25,50,0.01,1704,6
0.97,0.0001,901,903,25,50,0.01,1804,6
0.972,0.0001,945,959,25,50,0.01,1904,6
0.974,0.0001,997,1007,25,50,0.01,2004,6
0.484,0.0001,53,51,25,50,0.01,104,7
0.556,0.0001,102,102,25,50,0.01,204,7
0.584,0.0001,151,153,25,50,0.01,304,7
0.618,0.0001,207,197,25,50,0.01,404,7
0.646,0.0001,259,245,25,50,0.01,504,7
0.686,0.0001,312,292,25,50,0.01,604,7
0.712,0.0001,373,331,25,50,0.01,704,7
0.766,0.0001,413,391,25,50,0.01,804,7
0.81,0.0001,458,446,25,50,0.01,904,7
0.866,0.0001,512,492,25,50,0.01,1004,7
0.9,0.0001,564,540,25,50,0.01,1104,7
0.928,0.0001,604,600,25,50,0.01,1204,7
0.956,0.0001,649,655,25,50,0.01,1304,7
0.966,0.0001,699,705,25,50,0.01,1404,7
0.976,0.0001,746,758,25,50,0.01,1504,7
0.978,0.0001,797,807,25,50,0.01,1604,7
0.974,0.0001,843,861,25,50,0.01,1704,7
0.982,0.0001,897,907,25,50,0.01,1804,7
0.984,0.0001,950,954,25,50,0.01,1904,7
0.986,0.0001,998,1006,25,50,0.01,2004,7
0.484,0.0001,50,54,25,50,0.01,104,8
0.56,0.0001,102,102,25,50,0.01,204,8
0.564,0.0001,153,151,25,50,0.01,304,8
0.612,0.0001,204,200,25,50,0.01,404,8
0.634,0.0001,255,249,25,50,0.01,504,8
0.658,0.0001,306,298,25,50,0.01,604,8
0.728,0.0001,358,346,25,50,0.01,704,8
0.766,0.0001,409,395,25,50,0.01,804,8
0.794,0.0001,458,446,25,50,0.01,904,8
0.848,0.0001,496,508,25,50,0.01,1004,8
0.878,0.0001,539,565,25,50,0.01,1104,8
0.902,0.0001,581,623,25,50,0.01,1204,8
0.926,0.0001,631,673,25,50,0.01,1304,8
0.93,0.0001,682,722,25,50,0.01,1404,8
0.938,0.0001,735,769,25,50,0.01,1504,8
0.956,0.0001,781,823,25,50,0.01,1604,8
0.956,0.0001,831,873,25,50,0.01,1704,8
0.964,0.0001,880,924,25,50,0.01,1804,8
0.968,0.0001,932,972,25,50,0.01,1904,8
0.974,0.0001,978,1026,25,50,0.01,2004,8
0.52,0.0001,46,58,25,50,0.01,104,9
0.552,0.0001,99,105,25,50,0.01,204,9
0.606,0.0001,156,148,25,50,0.01,304,9
0.618,0.0001,213,191,25,50,0.01,404,9
0.636,0.0001,260,244,25,50,0.01,504,9
0.698,0.0001,305,299,25,50,0.01,604,9
0.758,0.0001,354,350,25,50,0.01,704,9
0.846,0.0001,402,402,25,50,0.01,804,9
0.868,0.0001,455,449,25,50,0.01,904,9
0.926,0.0001,501,503,25,50,0.01,1004,9
0.954,0.0001,561,543,25,50,0.01,1104,9
0.958,0.0001,608,596,25,50,0.01,1204,9
0.96,0.0001,664,640,25,50,0.01,1304,9
0.972,0.0001,705,699,25,50,0.01,1404,9
0.962,0.0001,755,749,25,50,0.01,1504,9
0.97,0.0001,801,803,25,50,0.01,1604,9
0.974,0.0001,849,855,25,50,0.01,1704,9
0.976,0.0001,895,909,25,50,0.01,1804,9
0.978,0.0001,950,954,25,50,0.01,1904,9
0.984,0.0001,1009,995,25,50,0.01,2004,9
0.512,0.0001,42,62,25,50,0.01,104,10
0.564,0.0001,91,113,25,50,0.01,204,10
0.554,0.0001,140,164,25,50,0.01,304,10
0.562,0.0001,185,219,25,50,0.01,404,10
0.602,0.0001,239,265,25,50,0.01,504,10
0.668,0.0001,283,321,25,50,0.01,604,10
0.75,0.0001,333,371,25,50,0.01,704,10
0.802,0.0001,376,428,25,50,0.01,804,10
0.84,0.0001,433,471,25,50,0.01,904,10
0.884,0.0001,486,518,25,50,0.01,1004,10
0.912,0.0001,536,568,25,50,0.01,1104,10
0.946,0.0001,589,615,25,50,0.01,1204,10
0.95,0.0001,638,666,25,50,0.01,1304,10
0.958,0.0001,691,713,25,50,0.01,1404,10
0.954,0.0001,742,762,25,50,0.01,1504,10
0.96,0.0001,797,807,25,50,0.01,1604,10
0.966,0.0001,854,850,25,50,0.01,1704,10
0.972,0.0001,899,905,25,50,0.01,1804,10
0.978,0.0001,951,953,25,50,0.01,1904,10
0.972,0.0001,994,1010,25,50,0.01,2004,10
0.54,0.0001,42,62,25,50,0.01,104,11
0.564,0.0001,98,106,25,50,0.01,204,11
0.592,0.0001,141,163,25,50,0.01,304,11
0.648,0.0001,190,214,25,50,0.01,404,11
0.676,0.0001,247,257,25,50,0.01,504,11
0.722,0.0001,289,315,25,50,0.01,604,11
0.764,0.0001,333,371,25,50,0.01,704,11
0.85,0.0001,382,422,25,50,0.01,804,11
0.9,0.0001,435,469,25,50,0.01,904,11
0.936,0.0001,485,519,25,50,0.01,1004,11
0.944,0.0001,538,566,25,50,0.01,1104,11
0.95,0.0001,583,621,25,50,0.01,1204,11
0.962,0.0001,645,659,25,50,0.01,1304,11
0.968,0.0001,693,711,25,50,0.01,1404,11
0.972,0.0001,744,760,25,50,0.01,1504,11
0.972,0.0001,791,813,25,50,0.01,1604,11
0.974,0.0001,844,860,25,50,0.01,1704,11
0.978,0.0001,898,906,25,50,0.01,1804,11
0.978,0.0001,949,955,25,50,0.01,1904,11
0.98,0.0001,1006,998,25,50,0.01,2004,11
0.49,0.0001,48,56,25,50,0.01,104,12
0.57,0.0001,106,98,25,50,0.01,204,12
0.568,0.0001,153,151,25,50,0.01,304,12
0.572,0.0001,204,200,25,50,0.01,404,12
0.594,0.0001,250,254,25,50,0.01,504,12
0.638,0.0001,295,309,25,50,0.01,604,12
0.69,0.0001,343,361,25,50,0.01,704,12
0.736,0.0001,393,411,25,50,0.01,804,12
0.782,0.0001,445,459,25,50,0.01,904,12
0.848,0.0001,497,507,25,50,0.01,1004,12
0.9,0.0001,550,554,25,50,0.01,1104,12
0.952,0.0001,593,611,25,50,0.01,1204,12
0.95,0.0001,646,658,25,50,0.01,1304,12
0.964,0.0001,702,702,25,50,0.01,1404,12
0.972,0.0001,753,751,25,50,0.01,1504,12
0.97,0.0001,801,803,25,50,0.01,1604,12
0.972,0.0001,853,851,25,50,0.01,1704,12
0.982,0.0001,901,903,25,50,0.01,1804,12
0.98,0.0001,954,950,25,50,0.01,1904,12
0.978,0.0001,1004,1000,25,50,0.01,2004,12
0.456,0.0001,50,54,25,50,0.01,104,13
0.534,0.0001,94,110,25,50,0.01,204,13
0.596,0.0001,145,159,25,50,0.01,304,13
0.614,0.0001,193,211,25,50,0.01,404,13
0.628,0.0001,238,266,25,50,0.01,504,13
0.65,0.0001,280,324,25,50,0.01,604,13
0.664,0.0001,330,374,25,50,0.01,704,13
0.688,0.0001,385,419,25,50,0.01,804,13
0.748,0.0001,432,472,25,50,0.01,904,13
0.832,0.0001,483,521,25,50,0.01,1004,13
0.862,0.0001,533,571,25,50,0.01,1104,13
0.91,0.0001,588,616,25,50,0.01,1204,13
0.936,0.0001,638,666,25,50,0.01,1304,13
0.948,0.0001,693,711,25,50,0.01,1404,13
0.944,0.0001,754,750,25,50,0.01,1504,13
0.964,0.0001,805,799,25,50,0.01,1604,13
0.966,0.0001,850,854,25,50,0.01,1704,13
0.97,0.0001,896,908,25,50,0.01,1804,13
0.972,0.0001,954,950,25,50,0.01,1904,13
0.976,0.0001,999,1005,25,50,0.01,2004,13
0.508,0.0001,53,51,25,50,0.01,104,14
0.548,0.0001,99,105,25,50,0.01,204,14
0.574,0.0001,146,158,25,50,0.01,304,14
0.6,0.0001,198,206,25,50,0.01,404,14
0.608,0.0001,249,255,25,50,0.01,504,14
0.656,0.0001,298,306,25,50,0.01,604,14
0.716,0.0001,343,361,25,50,0.01,704,14
0.772,0.0001,385,419,25,50,0.01,804,14
0.814,0.0001,434,470,25,50,0.01,904,14
0.87,0.0001,485,519,25,50,0.01,1004,14
0.914,0.0001,530,574,25,50,0.01,1104,14
0.93,0.0001,586,618,25,50,0.01,1204,14
0.928,0.0001,633,671,25,50,0.01,1304,14
0.942,0.0001,686,718,25,50,0.01,1404,14
0.942,0.0001,737,767,25,50,0.01,1504,14
0.944,0.0001,785,819,25,50,0.01,1604,14
0.952,0.0001,840,864,25,50,0.01,1704,14
0.948,0.0001,888,916,25,50,0.01,1804,14
0.946,0.0001,937,967,25,50,0.01,1904,14
0.956,0.0001,997,1007,25,50,0.01,2004,14
0.512,0.0001,40,64,25,50,0.01,104,15
0.572,0.0001,90,114,25,50,0.01,204,15
0.618,0.0001,142,162,25,50,0.01,304,15
0.636,0.0001,192,212,25,50,0.01,404,15
0.656,0.0001,242,262,25,50,0.01,504,15
0.71,0.0001,290,314,25,50,0.01,604,15
0.77,0.0001,338,366,25,50,0.01,704,15
0.824,0.0001,389,415,25,50,0.01,804,15
0.868,0.0001,443,461,25,50,0.01,904,15
0.928,0.0001,492,512,25,50,0.01,1004,15
0.932,0.0001,537,567,25,50,0.01,1104,15
0.944,0.0001,593,611,25,50,0.01,1204,15
0.95,0.0001,644,660,25,50,0.01,1304,15
0.974,0.0001,694,710,25,50,0.01,1404,15
0.982,0.0001,750,754,25,50,0.01,1504,15
0.976,0.0001,806,798,25,50,0.01,1604,15
0.98,0.0001,855,849,25,50,0.01,1704,15
0.99,0.0001,905,899,25,50,0.01,1804,15
0.992,0.0001,953,951,25,50,0.01,1904,15
0.988,0.0001,1001,1003,25,50,0.01,2004,15
0.51,0.0001,50,54,25,50,0.01,104,16
0.582,0.0001,115,89,25,50,0.01,204,16
0.584,0.0001,162,142,25,50,0.01,304,16
0.634,0.0001,212,192,25,50,0.01,404,16
0.654,0.0001,257,247,25,50,0.01,504,16
0.692,0.0001,305,299,25,50,0.01,604,16
0.746,0.0001,360,344,25,50,0.01,704,16
0.794,0.0001,404,400,25,50,0.01,804,16
0.836,0.0001,463,441,25,50,0.01,904,16
0.87,0.0001,512,492,25,50,0.01,1004,16
0.882,0.0001,548,556,25,50,0.01,1104,16
0.918,0.0001,598,606,25,50,0.01,1204,16
0.938,0.0001,642,662,25,50,0.01,1304,16
0.938,0.0001,691,713,25,50,0.01,1404,16
0.954,0.0001,734,770,25,50,0.01,1504,16
0.976,0.0001,784,820,25,50,0.01,1604,16
0.974,0.0001,835,869,25,50,0.01,1704,16
0.98,0.0001,881,923,25,50,0.01,1804,16
0.984,0.0001,938,966,25,50,0.01,1904,16
0.984,0.0001,992,1012,25,50,0.01,2004,16
0.55,0.0001,47,57,25,50,0.01,104,17
0.588,0.0001,96,108,25,50,0.01,204,17
0.59,0.0001,145,159,25,50,0.01,304,17
0.624,0.0001,198,206,25,50,0.01,404,17
0.65,0.0001,255,249,25,50,0.01,504,17
0.69,0.0001,305,299,25,50,0.01,604,17
0.726,0.0001,357,347,25,50,0.01,704,17
0.746,0.0001,414,390,25,50,0.01,804,17
0.756,0.0001,468,436,25,50,0.01,904,17
0.83,0.0001,513,491,25,50,0.01,1004,17
0.872,0.0001,563,541,25,50,0.01,1104,17
0.91,0.0001,617,587,25,50,0.01,1204,17
0.93,0.0001,666,638,25,50,0.01,1304,17
0.934,0.0001,705,699,25,50,0.01,1404,17
0.942,0.0001,759,745,25,50,0.01,1504,17
0.952,0.0001,803,801,25,50,0.01,1604,17
0.956,0.0001,841,863,25,50,0.01,1704,17
0.96,0.0001,897,907,25,50,0.01,1804,17
0.968,0.0001,953,951,25,50,0.01,1904,17
0.974,0.0001,1014,990,25,50,0.01,2004,17
0.552,0.0001,47,57,25,50,0.01,104,18
0.54,0.0001,96,108,25,50,0.01,204,18
0.556,0.0001,150,154,25,50,0.01,304,18
0.592,0.0001,199,205,25,50,0.01,404,18
0.648,0.0001,266,238,25,50,0.01,504,18
0.694,0.0001,318,286,25,50,0.01,604,18
0.748,0.0001,365,339,25,50,0.01,704,18
0.786,0.0001,421,383,25,50,0.01,804,18
0.842,0.0001,471,433,25,50,0.01,904,18
0.894,0.0001,534,470,25,50,0.01,1004,18
0.908,0.0001,575,529,25,50,0.01,1104,18
0.946,0.0001,627,577,25,50,0.01,1204,18
0.94,0.0001,676,628,25,50,0.01,1304,18
0.95,0.0001,725,679,25,50,0.01,1404,18
0.956,0.0001,766,738,25,50,0.01,1504,18
0.964,0.0001,810,794,25,50,0.01,1604,18
0.968,0.0001,855,849,25,50,0.01,1704,18
0.972,0.0001,902,902,25,50,0.01,1804,18
0.974,0.0001,950,954,25,50,0.01,1904,18
0.976,0.0001,1004,1000,25,50,0.01,2004,18
0.5,0.0001,60,44,25,50,0.01,104,19
0.526,0.0001,103,101,25,50,0.01,204,19
0.552,0.0001,149,155,25,50,0.01,304,19
0.578,0.0001,192,212,25,50,0.01,404,19
0.6,0.0001,244,260,25,50,0.01,504,19
0.636,0.0001,297,307,25,50,0.01,604,19
0.67,0.0001,344,360,25,50,0.01,704,19
0.72,0.0001,399,405,25,50,0.01,804,19
0.756,0.0001,444,460,25,50,0.01,904,19
0.838,0.0001,494,510,25,50,0.01,1004,19
0.87,0.0001,540,564,25,50,0.01,1104,19
0.918,0.0001,592,612,25,50,0.01,1204,19
0.91,0.0001,640,664,25,50,0.01,1304,19
0.944,0.0001,692,712,25,50,0.01,1404,19
0.954,0.0001,751,753,25,50,0.01,1504,19
0.956,0.0001,802,802,25,50,0.01,1604,19
0.956,0.0001,850,854,25,50,0.01,1704,19
0.966,0.0001,903,901,25,50,0.01,1804,19
0.972,0.0001,949,955,25,50,0.01,1904,19
0.982,0.0001,993,1011,25,50,0.01,2004,19
0.57,0.0001,46,58,25,50,0.01,104,20
0.604,0.0001,95,109,25,50,0.01,204,20
0.568,0.0001,136,168,25,50,0.01,304,20
0.58,0.0001,190,214,25,50,0.01,404,20
0.622,0.0001,237,267,25,50,0.01,504,20
0.67,0.0001,283,321,25,50,0.01,604,20
0.728,0.0001,336,368,25,50,0.01,704,20
0.798,0.0001,392,412,25,50,0.01,804,20
0.828,0.0001,446,458,25,50,0.01,904,20
0.874,0.0001,501,503,25,50,0.01,1004,20
0.91,0.0001,564,540,25,50,0.01,1104,20
0.936,0.0001,611,593,25,50,0.01,1204,20
0.954,0.0001,670,634,25,50,0.01,1304,20
0.96,0.0001,710,694,25,50,0.01,1404,20
0.962,0.0001,750,754,25,50,0.01,1504,20
0.966,0.0001,791,813,25,50,0.01,1604,20
0.966,0.0001,839,865,25,50,0.01,1704,20
0.974,0.0001,889,915,25,50,0.01,1804,20
0.98,0.0001,944,960,25,50,0.01,1904,20
0.98,0.0001,1002,1002,25,50,0.01,2004,20
0.51,0.001,54,50,25,50,0.0001,104,1
0.508,0.001,103,101,25,50,0.0001,204,1
0.51,0.001,149,155,25,50,0.0001,304,1
0.512,0.001,199,205,25,50,0.0001,404,1
0.512,0.001,254,250,25,50,0.0001,504,1
0.512,0.001,304,300,25,50,0.0001,604,1
0.51,0.001,357,347,25,50,0.0001,704,1
0.512,0.001,409,395,25,50,0.0001,804,1
0.514,0.001,454,450,25,50,0.0001,904,1
0.514,0.001,515,489,25,50,0.0001,1004,1
0.512,0.001,567,537,25,50,0.0001,1104,1
0.512,0.001,614,590,25,50,0.0001,1204,1
0.516,0.001,667,637,25,50,0.0001,1304,1
0.518,0.001,717,687,25,50,0.0001,1404,1
0.52,0.001,758,746,25,50,0.0001,1504,1
0.522,0.001,805,799,25,50,0.0001,1604,1
0.522,0.001,855,849,25,50,0.0001,1704,1
0.522,0.001,911,893,25,50,0.0001,1804,1
0.52,0.001,958,946,25,50,0.0001,1904,1
0.524,0.001,1004,1000,25,50,0.0001,2004,1
0.504,0.001,51,53,25,50,0.0001,104,2
0.506,0.001,113,91,25,50,0.0001,204,2
0.508,0.001,154,150,25,50,0.0001,304,2
0.506,0.001,210,194,25,50,0.0001,404,2
0.506,0.001,261,243,25,50,0.0001,504,2
0.506,0.001,317,287,25,50,0.0001,604,2
0.51,0.001,369,335,25,50,0.0001,704,2
0.512,0.001,411,393,25,50,0.0001,804,2
0.514,0.001,458,446,25,50,0.0001,904,2
0.516,0.001,512,492,25,50,0.0001,1004,2
0.516,0.001,561,543,25,50,0.0001,1104,2
0.52,0.001,606,598,25,50,0.0001,1204,2
0.522,0.001,654,650,25,50,0.0001,1304,2
0.518,0.001,710,694,25,50,0.0001,1404,2
0.518,0.001,757,747,25,50,0.0001,1504,2
0.518,0.001,790,814,25,50,0.0001,1604,2
0.52,0.001,846,858,25,50,0.0001,1704,2
0.52,0.001,899,905,25,50,0.0001,1804,2
0.524,0.001,951,953,25,50,0.0001,1904,2
0.524,0.001,1001,1003,25,50,0.0001,2004,2
0.5,0.001,51,53,25,50,0.0001,104,3
0.498,0.001,95,109,25,50,0.0001,204,3
0.498,0.001,141,163,25,50,0.0001,304,3
0.5,0.001,192,212,25,50,0.0001,404,3
0.502,0.001,250,254,25,50,0.0001,504,3
0.504,0.001,297,307,25,50,0.0001,604,3
0.502,0.001,343,361,25,50,0.0001,704,3
0.502,0.001,382,422,25,50,0.0001,804,3
0.506,0.001,426,478,25,50,0.0001,904,3
0.508,0.001,484,520,25,50,0.0001,1004,3
0.508,0.001,537,567,25,50,0.0001,1104,3
0.512,0.001,596,608,25,50,0.0001,1204,3
0.512,0.001,646,658,25,50,0.0001,1304,3
0.512,0.001,692,712,25,50,0.0001,1404,3
0.514,0.001,739,765,25,50,0.0001,1504,3
0.516,0.001,787,817,25,50,0.0001,1604,3
0.524,0.001,835,869,25,50,0.0001,1704,3
0.526,0.001,891,913,25,50,0.0001,1804,3
0.528,0.001,940,964,25,50,0.0001,1904,3
0.526,0.001,996,1008,25,50,0.0001,2004,3
0.534,0.001,49,55,25,50,0.0001,104,4
0.534,0.001,91,113,25,50,0.0001,204,4
0.534,0.001,140,164,25,50,0.0001,304,4
0.534,0.001,186,218,25,50,0.0001,404,4
0.534,0.001,235,269,25,50,0.0001,504,4
0.534,0.001,289,315,25,50,0.0001,604,4
0.534,0.001,337,367,25,50,0.0001,704,4
0.534,0.001,396,408,25,50,0.0001,804,4
0.532,0.001,454,450,25,50,0.0001,904,4
0.534,0.001,505,499,25,50,0.0001,1004,4
0.536,0.001,556,548,25,50,0.0001,1104,4
0.534,0.001,603,601,25,50,0.0001,1204,4
0.534,0.001,660,644,25,50,0.0001,1304,4
0.536,0.001,703,701,25,50,0.0001,1404,4
0.538,0.001,753,751,25,50,0.0001,1504,4
0.532,0.001,803,801,25,50,0.0001,1604,4
0.532,0.001,853,851,25,50,0.0001,1704,4
0.536,0.001,906,898,25,50,0.0001,1804,4
0.536,0.001,967,937,25,50,0.0001,1904,4
0.536,0.001,1019,985,25,50,0.0001,2004,4
0.508,0.001,55,49,25,50,0.0001,104,5
0.512,0.001,107,97,25,50,0.0001,204,5
0.512,0.001,156,148,25,50,0.0001,304,5
0.512,0.001,205,199,25,50,0.0001,404,5
0.512,0.001,247,257,25,50,0.0001,504,5
0.51,0.001,297,307,25,50,0.0001,604,5
0.508,0.001,347,357,25,50,0.0001,704,5
0.51,0.001,394,410,25,50,0.0001,804,5
0.508,0.001,444,460,25,50,0.0001,904,5
0.508,0.001,499,505,25,50,0.0001,1004,5
0.512,0.001,554,550,25,50,0.0001,1104,5
0.51,0.001,606,598,25,50,0.0001,1204,5
0.506,0.001,658,646,25,50,0.0001,1304,5
0.504,0.001,712,692,25,50,0.0001,1404,5
0.506,0.001,762,742,25,50,0.0001,1504,5
0.508,0.001,812,792,25,50,0.0001,1604,5
0.508,0.001,860,844,25,50,0.0001,1704,5
0.514,0.001,908,896,25,50,0.0001,1804,5
0.516,0.001,952,952,25,50,0.0001,1904,5
0.524,0.001,1001,1003,25,50,0.0001,2004,5
0.508,0.001,57,47,25,50,0.0001,104,6
0.506,0.001,105,99,25,50,0.0001,204,6
0.504,0.001,153,151,25,50,0.0001,304,6
0.506,0.001,197,207,25,50,0.0001,404,6
0.508,0.001,244,260,25,50,0.0001,504,6
0.51,0.001,296,308,25,50,0.0001,604,6
0.514,0.001,354,350,25,50,0.0001,704,6
0.518,0.001,402,402,25,50,0.0001,804,6
0.518,0.001,458,446,25,50,0.0001,904,6
0.524,0.001,506,498,25,50,0.0001,1004,6
0.526,0.001,559,545,25,50,0.0001,1104,6
0.53,0.001,611,593,25,50,0.0001,1204,6
0.53,0.001,658,646,25,50,0.0001,1304,6
0.532,0.001,703,701,25,50,0.0001,1404,6
0.536,0.001,755,749,25,50,0.0001,1504,6
0.536,0.001,806,798,25,50,0.0001,1604,6
0.538,0.001,855,849,25,50,0.0001,1704,6
0.542,0.001,913,891,25,50,0.0001,1804,6
0.546,0.001,967,937,25,50,0.0001,1904,6
0.55,0.001,1018,986,25,50,0.0001,2004,6
0.51,0.001,50,54,25,50,0.0001,104,7
0.51,0.001,102,102,25,50,0.0001,204,7
0.506,0.001,144,160,25,50,0.0001,304,7
0.508,0.001,195,209,25,50,0.0001,404,7
0.508,0.001,252,252,25,50,0.0001,504,7
0.51,0.001,302,302,25,50,0.0001,604,7
0.512,0.001,354,350,25,50,0.0001,704,7
0.512,0.001,405,399,25,50,0.0001,804,7
0.514,0.001,458,446,25,50,0.0001,904,7
0.512,0.001,506,498,25,50,0.0001,1004,7
0.512,0.001,551,553,25,50,0.0001,1104,7
0.512,0.001,601,603,25,50,0.0001,1204,7
0.514,0.001,648,656,25,50,0.0001,1304,7
0.512,0.001,703,701,25,50,0.0001,1404,7
0.514,0.001,753,751,25,50,0.0001,1504,7
0.518,0.001,805,799,25,50,0.0001,1604,7
0.52,0.001,856,848,25,50,0.0001,1704,7
0.524,0.001,901,903,25,50,0.0001,1804,7
0.53,0.001,944,960,25,50,0.0001,1904,7
0.532,0.001,993,1011,25,50,0.0001,2004,7
0.502,0.001,51,53,25,50,0.0001,104,8
0.504,0.001,102,102,25,50,0.0001,204,8
0.504,0.001,158,146,25,50,0.0001,304,8
0.502,0.001,208,196,25,50,0.0001,404,8
0.502,0.001,265,239,25,50,0.0001,504,8
0.504,0.001,324,280,25,50,0.0001,604,8
0.502,0.001,370,334,25,50,0.0001,704,8
0.502,0.001,414,390,25,50,0.0001,804,8
0.502,0.001,464,440,25,50,0.0001,904,8
0.502,0.001,513,491,25,50,0.0001,1004,8
0.502,0.001,569,535,25,50,0.0001,1104,8
0.5,0.001,617,587,25,50,0.0001,1204,8
0.502,0.001,666,638,25,50,0.0001,1304,8
0.506,0.001,717,687,25,50,0.0001,1404,8
0.506,0.001,768,736,25,50,0.0001,1504,8
0.506,0.001,822,782,25,50,0.0001,1604,8
0.508,0.001,873,831,25,50,0.0001,1704,8
0.508,0.001,919,885,25,50,0.0001,1804,8
0.512,0.001,974,930,25,50,0.0001,1904,8
0.51,0.001,1021,983,25,50,0.0001,2004,8
0.514,0.001,52,52,25,50,0.0001,104,9
0.514,0.001,104,100,25,50,0.0001,204,9
0.514,0.001,167,137,25,50,0.0001,304,9
0.516,0.001,219,185,25,50,0.0001,404,9
0.516,0.001,265,239,25,50,0.0001,504,9
0.516,0.001,306,298,25,50,0.0001,604,9
0.516,0.001,351,353,25,50,0.0001,704,9
0.516,0.001,393,411,25,50,0.0001,804,9
0.52,0.001,438,466,25,50,0.0001,904,9
0.522,0.001,488,516,25,50,0.0001,1004,9
0.526,0.001,540,564,25,50,0.0001,1104,9
0.526,0.001,587,617,25,50,0.0001,1204,9
0.528,0.001,635,669,25,50,0.0001,1304,9
0.526,0.001,686,718,25,50,0.0001,1404,9
0.526,0.001,736,768,25,50,0.0001,1504,9
0.524,0.001,786,818,25,50,0.0001,1604,9
0.524,0.001,839,865,25,50,0.0001,1704,9
0.526,0.001,893,911,25,50,0.0001,1804,9
0.53,0.001,940,964,25,50,0.0001,1904,9
0.532,0.001,1002,1002,25,50,0.0001,2004,9
0.478,0.001,51,53,25,50,0.0001,104,10
0.476,0.001,105,99,25,50,0.0001,204,10
0.476,0.001,156,148,25,50,0.0001,304,10
0.476,0.001,206,198,25,50,0.0001,404,10
0.476,0.001,257,247,25,50,0.0001,504,10
0.478,0.001,302,302,25,50,0.0001,604,10
0.478,0.001,355,349,25,50,0.0001,704,10
0.476,0.001,405,399,25,50,0.0001,804,10
0.476,0.001,454,450,25,50,0.0001,904,10
0.478,0.001,509,495,25,50,0.0001,1004,10
0.478,0.001,551,553,25,50,0.0001,1104,10
0.476,0.001,602,602,25,50,0.0001,1204,10
0.476,0.001,656,648,25,50,0.0001,1304,10
0.474,0.001,699,705,25,50,0.0001,1404,10
0.476,0.001,756,748,25,50,0.0001,1504,10
0.474,0.001,816,788,25,50,0.0001,1604,10
0.474,0.001,861,843,25,50,0.0001,1704,10
0.47,0.001,915,889,25,50,0.0001,1804,10
0.474,0.001,960,944,25,50,0.0001,1904,10
0.474,0.001,1014,990,25,50,0.0001,2004,10
0.52,0.001,57,47,25,50,0.0001,104,11
0.518,0.001,107,97,25,50,0.0001,204,11
0.518,0.001,165,139,25,50,0.0001,304,11
0.518,0.001,212,192,25,50,0.0001,404,11
0.52,0.001,264,240,25,50,0.0001,504,11
0.518,0.001,311,293,25,50,0.0001,604,11
0.518,0.001,361,343,25,50,0.0001,704,11
0.518,0.001,414,390,25,50,0.0001,804,11
0.516,0.001,457,447,25,50,0.0001,904,11
0.516,0.001,519,485,25,50,0.0001,1004,11
0.516,0.001,572,532,25,50,0.0001,1104,11
0.516,0.001,620,584,25,50,0.0001,1204,11
0.518,0.001,663,641,25,50,0.0001,1304,11
0.522,0.001,708,696,25,50,0.0001,1404,11
0.52,0.001,766,738,25,50,0.0001,1504,11
0.522,0.001,820,784,25,50,0.0001,1604,11
0.524,0.001,862,842,25,50,0.0001,1704,11
0.522,0.001,902,902,25,50,0.0001,1804,11
0.522,0.001,957,947,25,50,0.0001,1904,11
0.526,0.001,1007,997,25,50,0.0001,2004,11
0.49,0.001,55,49,25,50,0.0001,104,12
0.492,0.001,101,103,25,50,0.0001,204,12
0.49,0.001,145,159,25,50,0.0001,304,12
0.49,0.001,190,214,25,50,0.0001,404,12
0.492,0.001,241,263,25,50,0.0001,504,12
0.492,0.001,294,310,25,50,0.0001,604,12
0.49,0.001,346,358,25,50,0.0001,704,12
0.492,0.001,391,413,25,50,0.0001,804,12
0.49,0.001,444,460,25,50,0.0001,904,12
0.494,0.001,491,513,25,50,0.0001,1004,12
0.494,0.001,535,569,25,50,0.0001,1104,12
0.494,0.001,586,618,25,50,0.0001,1204,12
0.496,0.001,633,671,25,50,0.0001,1304,12
0.502,0.001,682,722,25,50,0.0001,1404,12
0.504,0.001,730,774,25,50,0.0001,1504,12
0.506,0.001,790,814,25,50,0.0001,1604,12
0.506,0.001,840,864,25,50,0.0001,1704,12
0.51,0.001,883,921,25,50,0.0001,1804,12
0.514,0.001,924,980,25,50,0.0001,1904,12
0.514,0.001,985,1019,25,50,0.0001,2004,12
0.484,0.001,48,56,25,50,0.0001,104,13
0.484,0.001,100,104,25,50,0.0001,204,13
0.484,0.001,152,152,25,50,0.0001,304,13
0.486,0.001,198,206,25,50,0.0001,404,13
0.486,0.001,252,252,25,50,0.0001,504,13
0.488,0.001,306,298,25,50,0.0001,604,13
0.488,0.001,357,347,25,50,0.0001,704,13
0.49,0.001,406,398,25,50,0.0001,804,13
0.49,0.001,460,444,25,50,0.0001,904,13
0.486,0.001,505,499,25,50,0.0001,1004,13
0.488,0.001,557,547,25,50,0.0001,1104,13
0.488,0.001,600,604,25,50,0.0001,1204,13
0.482,0.001,658,646,25,50,0.0001,1304,13
0.48,0.001,713,691,25,50,0.0001,1404,13
0.476,0.001,759,745,25,50,0.0001,1504,13
0.476,0.001,805,799,25,50,0.0001,1604,13
0.476,0.001,857,847,25,50,0.0001,1704,13
0.484,0.001,907,897,25,50,0.0001,1804,13
0.488,0.001,956,948,25,50,0.0001,1904,13
0.49,0.001,1009,995,25,50,0.0001,2004,13
0.452,0.001,55,49,25,50,0.0001,104,14
0.454,0.001,106,98,25,50,0.0001,204,14
0.452,0.001,146,158,25,50,0.0001,304,14
0.454,0.001,187,217,25,50,0.0001,404,14
0.456,0.001,238,266,25,50,0.0001,504,14
0.458,0.001,285,319,25,50,0.0001,604,14
0.458,0.001,338,366,25,50,0.0001,704,14
0.46,0.001,388,416,25,50,0.0001,804,14
0.46,0.001,438,466,25,50,0.0001,904,14
0.46,0.001,483,521,25,50,0.0001,1004,14
0.466,0.001,531,573,25,50,0.0001,1104,14
0.466,0.001,580,624,25,50,0.0001,1204,14
0.466,0.001,628,676,25,50,0.0001,1304,14
0.466,0.001,676,728,25,50,0.0001,1404,14
0.466,0.001,726,778,25,50,0.0001,1504,14
0.468,0.001,781,823,25,50,0.0001,1604,14
0.468,0.001,827,877,25,50,0.0001,1704,14
0.47,0.001,878,926,25,50,0.0001,1804,14
0.47,0.001,929,975,25,50,0.0001,1904,14
0.478,0.001,978,1026,25,50,0.0001,2004,14
0.502,0.001,56,48,25,50,0.0001,104,15
0.502,0.001,109,95,25,50,0.0001,204,15
0.502,0.001,163,141,25,50,0.0001,304,15
0.502,0.001,206,198,25,50,0.0001,404,15
0.502,0.001,253,251,25,50,0.0001,504,15
0.504,0.001,289,315,25,50,0.0001,604,15
0.504,0.001,344,360,25,50,0.0001,704,15
0.506,0.001,393,411,25,50,0.0001,804,15
0.506,0.001,444,460,25,50,0.0001,904,15
0.504,0.001,490,514,25,50,0.0001,1004,15
0.506,0.001,544,560,25,50,0.0001,1104,15
0.506,0.001,604,600,25,50,0.0001,1204,15
0.504,0.001,656,648,25,50,0.0001,1304,15
0.504,0.001,705,699,25,50,0.0001,1404,15
0.506,0.001,760,744,25,50,0.0001,1504,15
0.508,0.001,807,797,25,50,0.0001,1604,15
0.51,0.001,861,843,25,50,0.0001,1704,15
0.51,0.001,913,891,25,50,0.0001,1804,15
0.514,0.001,959,945,25,50,0.0001,1904,15
0.516,0.001,999,1005,25,50,0.0001,2004,15
0.548,0.001,48,56,25,50,0.0001,104,16
0.548,0.001,106,98,25,50,0.0001,204,16
0.548,0.001,153,151,25,50,0.0001,304,16
0.55,0.001,207,197,25,50,0.0001,404,16
0.55,0.001,255,249,25,50,0.0001,504,16
0.55,0.001,305,299,25,50,0.0001,604,16
0.552,0.001,361,343,25,50,0.0001,704,16
0.55,0.001,409,395,25,50,0.0001,804,16
0.552,0.001,456,448,25,50,0.0001,904,16
0.55,0.001,509,495,25,50,0.0001,1004,16
0.552,0.001,556,548,25,50,0.0001,1104,16
0.552,0.001,599,605,25,50,0.0001,1204,16
0.552,0.001,645,659,25,50,0.0001,1304,16
0.554,0.001,692,712,25,50,0.0001,1404,16
0.558,0.001,741,763,25,50,0.0001,1504,16
0.564,0.001,793,811,25,50,0.0001,1604,16
0.57,0.001,850,854,25,50,0.0001,1704,16
0.572,0.001,897,907,25,50,0.0001,1804,16
0.574,0.001,949,955,25,50,0.0001,1904,16
0.578,0.001,993,1011,25,50,0.0001,2004,16
0.506,0.001,49,55,25,50,0.0001,104,17
0.506,0.001,104,100,25,50,0.0001,204,17
0.506,0.001,161,143,25,50,0.0001,304,17
0.506,0.001,204,200,25,50,0.0001,404,17
0.506,0.001,252,252,25,50,0.0001,504,17
0.506,0.001,305,299,25,50,0.0001,604,17
0.506,0.001,355,349,25,50,0.0001,704,17
0.506,0.001,400,404,25,50,0.0001,804,17
0.506,0.001,455,449,25,50,0.0001,904,17
0.506,0.001,505,499,25,50,0.0001,1004,17
0.506,0.001,560,544,25,50,0.0001,1104,17
0.506,0.001,612,592,25,50,0.0001,1204,17
0.506,0.001,660,644,25,50,0.0001,1304,17
0.506,0.001,706,698,25,50,0.0001,1404,17
0.506,0.001,755,749,25,50,0.0001,1504,17
0.506,0.001,798,806,25,50,0.0001,1604,17
0.504,0.001,848,856,25,50,0.0001,1704,17
0.504,0.001,899,905,25,50,0.0001,1804,17
0.508,0.001,952,952,25,50,0.0001,1904,17
0.504,0.001,999,1005,25,50,0.0001,2004,17
0.476,0.001,49,55,25,50,0.0001,104,18
0.474,0.001,106,98,25,50,0.0001,204,18
0.474,0.001,143,161,25,50,0.0001,304,18
0.476,0.001,196,208,25,50,0.0001,404,18
0.478,0.001,252,252,25,50,0.0001,504,18
0.478,0.001,305,299,25,50,0.0001,604,18
0.472,0.001,349,355,25,50,0.0001,704,18
0.468,0.001,393,411,25,50,0.0001,804,18
0.468,0.001,449,455,25,50,0.0001,904,18
0.47,0.001,505,499,25,50,0.0001,1004,18
0.47,0.001,560,544,25,50,0.0001,1104,18
0.474,0.001,609,595,25,50,0.0001,1204,18
0.474,0.001,655,649,25,50,0.0001,1304,18
0.478,0.001,713,691,25,50,0.0001,1404,18
0.478,0.001,757,747,25,50,0.0001,1504,18
0.482,0.001,807,797,25,50,0.0001,1604,18
0.488,0.001,857,847,25,50,0.0001,1704,18
0.492,0.001,911,893,25,50,0.0001,1804,18
0.496,0.001,963,941,25,50,0.0001,1904,18
0.496,0.001,1009,995,25,50,0.0001,2004,18
0.508,0.001,60,44,25,50,0.0001,104,19
0.506,0.001,107,97,25,50,0.0001,204,19
0.506,0.001,150,154,25,50,0.0001,304,19
0.506,0.001,197,207,25,50,0.0001,404,19
0.506,0.001,246,258,25,50,0.0001,504,19
0.504,0.001,297,307,25,50,0.0001,604,19
0.506,0.001,338,366,25,50,0.0001,704,19
0.508,0.001,391,413,25,50,0.0001,804,19
0.506,0.001,444,460,25,50,0.0001,904,19
0.506,0.001,498,506,25,50,0.0001,1004,19
0.508,0.001,542,562,25,50,0.0001,1104,19
0.506,0.001,593,611,25,50,0.0001,1204,19
0.506,0.001,649,655,25,50,0.0001,1304,19
0.508,0.001,696,708,25,50,0.0001,1404,19
0.514,0.001,751,753,25,50,0.0001,1504,19
0.512,0.001,802,802,25,50,0.0001,1604,19
0.518,0.001,849,855,25,50,0.0001,1704,19
0.518,0.001,900,904,25,50,0.0001,1804,19
0.522,0.001,952,952,25,50,0.0001,1904,19
0.516,0.001,999,1005,25,50,0.0001,2004,19
0.47,0.001,56,48,25,50,0.0001,104,20
0.47,0.001,107,97,25,50,0.0001,204,20
0.47,0.001,149,155,25,50,0.0001,304,20
0.466,0.001,189,215,25,50,0.0001,404,20
0.466,0.001,235,269,25,50,0.0001,504,20
0.468,0.001,293,311,25,50,0.0001,604,20
0.466,0.001,352,352,25,50,0.0001,704,20
0.468,0.001,399,405,25,50,0.0001,804,20
0.47,0.001,443,461,25,50,0.0001,904,20
0.474,0.001,489,515,25,50,0.0001,1004,20
0.472,0.001,541,563,25,50,0.0001,1104,20
0.47,0.001,589,615,25,50,0.0001,1204,20
0.472,0.001,646,658,25,50,0.0001,1304,20
0.476,0.001,692,712,25,50,0.0001,1404,20
0.474,0.001,741,763,25,50,0.0001,1504,20
0.472,0.001,794,810,25,50,0.0001,1604,20
0.48,0.001,842,862,25,50,0.0001,1704,20
0.482,0.001,895,909,25,50,0.0001,1804,20
0.484,0.001,949,955,25,50,0.0001,1904,20
0.482,0.001,993,1011,25,50,0.0001,2004,20
0.528,0.001,53,51,25,50,0.001,104,1
0.54,0.001,106,98,25,50,0.001,204,1
0.542,0.001,158,146,25,50,0.001,304,1
0.544,0.001,213,191,25,50,0.001,404,1
0.552,0.001,264,240,25,50,0.001,504,1
0.564,0.001,317,287,25,50,0.001,604,1
0.574,0.001,368,336,25,50,0.001,704,1
0.578,0.001,405,399,25,50,0.001,804,1
0.592,0.001,456,448,25,50,0.001,904,1
0.614,0.001,511,493,25,50,0.001,1004,1
0.626,0.001,567,537,25,50,0.001,1104,1
0.648,0.001,608,596,25,50,0.001,1204,1
0.662,0.001,654,650,25,50,0.001,1304,1
0.686,0.001,707,697,25,50,0.001,1404,1
0.696,0.001,749,755,25,50,0.001,1504,1
0.714,0.001,797,807,25,50,0.001,1604,1
0.732,0.001,848,856,25,50,0.001,1704,1
0.774,0.001,893,911,25,50,0.001,1804,1
0.792,0.001,948,956,25,50,0.001,1904,1
0.808,0.001,995,1009,25,50,0.001,2004,1
0.464,0.001,51,53,25,50,0.001,104,2
0.464,0.001,96,108,25,50,0.001,204,2
0.464,0.001,150,154,25,50,0.001,304,2
0.464,0.001,203,201,25,50,0.001,404,2
0.466,0.001,258,246,25,50,0.001,504,2
0.484,0.001,303,301,25,50,0.001,604,2
0.502,0.001,355,349,25,50,0.001,704,2
0.526,0.001,406,398,25,50,0.001,804,2
0.526,0.001,458,446,25,50,0.001,904,2
0.544,0.001,512,492,25,50,0.001,1004,2
0.566,0.001,561,543,25,50,0.001,1104,2
0.584,0.001,608,596,25,50,0.001,1204,2
0.598,0.001,655,649,25,50,0.001,1304,2
0.626,0.001,710,694,25,50,0.001,1404,2
0.64,0.001,762,742,25,50,0.001,1504,2
0.67,0.001,810,794,25,50,0.001,1604,2
0.702,0.001,865,839,25,50,0.001,1704,2
0.736,0.001,917,887,25,50,0.001,1804,2
0.75,0.001,970,934,25,50,0.001,1904,2
0.786,0.001,1019,985,25,50,0.001,2004,2
0.51,0.001,44,60,25,50,0.001,104,3
0.504,0.001,92,112,25,50,0.001,204,3
0.514,0.001,133,171,25,50,0.001,304,3
0.532,0.001,185,219,25,50,0.001,404,3
0.526,0.001,242,262,25,50,0.001,504,3
0.526,0.001,297,307,25,50,0.001,604,3
0.536,0.001,344,360,25,50,0.001,704,3
0.554,0.001,392,412,25,50,0.001,804,3
0.562,0.001,444,460,25,50,0.001,904,3
0.574,0.001,495,509,25,50,0.001,1004,3
0.584,0.001,552,552,25,50,0.001,1104,3
0.598,0.001,605,599,25,50,0.001,1204,3
0.628,0.001,659,645,25,50,0.001,1304,3
0.646,0.001,712,692,25,50,0.001,1404,3
0.664,0.001,758,746,25,50,0.001,1504,3
0.672,0.001,807,797,25,50,0.001,1604,3
0.706,0.001,851,853,25,50,0.001,1704,3
0.722,0.001,890,914,25,50,0.001,1804,3
0.744,0.001,938,966,25,50,0.001,1904,3
0.766,0.001,992,1012,25,50,0.001,2004,3
0.496,0.001,57,47,25,50,0.001,104,4
0.5,0.001,108,96,25,50,0.001,204,4
0.508,0.001,159,145,25,50,0.001,304,4
0.514,0.001,207,197,25,50,0.001,404,4
0.52,0.001,265,239,25,50,0.001,504,4
0.524,0.001,311,293,25,50,0.001,604,4
0.526,0.001,369,335,25,50,0.001,704,4
0.52,0.001,412,392,25,50,0.001,804,4
0.548,0.001,455,449,25,50,0.001,904,4
0.572,0.001,510,494,25,50,0.001,1004,4
0.59,0.001,564,540,25,50,0.001,1104,4
0.606,0.001,625,579,25,50,0.001,1204,4
0.62,0.001,672,632,25,50,0.001,1304,4
0.636,0.001,711,693,25,50,0.001,1404,4
0.654,0.001,764,740,25,50,0.001,1504,4
0.676,0.001,811,793,25,50,0.001,1604,4
0.694,0.001,854,850,25,50,0.001,1704,4
0.712,0.001,898,906,25,50,0.001,1804,4
0.742,0.001,949,955,25,50,0.001,1904,4
0.766,0.001,997,1007,25,50,0.001,2004,4
0.516,0.001,52,52,25,50,0.001,104,5
0.516,0.001,101,103,25,50,0.001,204,5
0.512,0.001,146,158,25,50,0.001,304,5
0.52,0.001,200,204,25,50,0.001,404,5
0.514,0.001,250,254,25,50,0.001,504,5
0.51,0.001,299,305,25,50,0.001,604,5
0.51,0.001,347,357,25,50,0.001,704,5
0.516,0.001,390,414,25,50,0.001,804,5
0.528,0.001,440,464,25,50,0.001,904,5
0.532,0.001,491,513,25,50,0.001,1004,5
0.526,0.001,541,563,25,50,0.001,1104,5
0.542,0.001,590,614,25,50,0.001,1204,5
0.572,0.001,648,656,25,50,0.001,1304,5
0.598,0.001,698,706,25,50,0.001,1404,5
0.616,0.001,751,753,25,50,0.001,1504,5
0.634,0.001,801,803,25,50,0.001,1604,5
0.646,0.001,848,856,25,50,0.001,1704,5
0.678,0.001,891,913,25,50,0.001,1804,5
0.694,0.001,941,963,25,50,0.001,1904,5
0.734,0.001,991,1013,25,50,0.001,2004,5
0.474,0.001,48,56,25,50,0.001,104,6
0.484,0.001,96,108,25,50,0.001,204,6
0.498,0.001,145,159,25,50,0.001,304,6
0.502,0.001,198,206,25,50,0.001,404,6
0.508,0.001,256,248,25,50,0.001,504,6
0.524,0.001,306,298,25,50,0.001,604,6
0.528,0.001,361,343,25,50,0.001,704,6
0.54,0.001,414,390,25,50,0.001,804,6
0.56,0.001,471,433,25,50,0.001,904,6
0.578,0.001,519,485,25,50,0.001,1004,6
0.586,0.001,567,537,25,50,0.001,1104,6
0.596,0.001,607,597,25,50,0.001,1204,6
0.618,0.001,650,654,25,50,0.001,1304,6
0.646,0.001,703,701,25,50,0.001,1404,6
0.664,0.001,758,746,25,50,0.001,1504,6
0.688,0.001,809,795,25,50,0.001,1604,6
0.706,0.001,862,842,25,50,0.001,1704,6
0.726,0.001,909,895,25,50,0.001,1804,6
0.75,0.001,955,949,25,50,0.001,1904,6
0.772,0.001,1005,999,25,50,0.001,2004,6
0.486,0.001,45,59,25,50,0.001,104,7
0.48,0.001,92,112,25,50,0.001,204,7
0.488,0.001,136,168,25,50,0.001,304,7
0.486,0.001,182,222,25,50,0.001,404,7
0.488,0.001,237,267,25,50,0.001,504,7
0.486,0.001,283,321,25,50,0.001,604,7
0.488,0.001,337,367,25,50,0.001,704,7
0.51,0.001,381,423,25,50,0.001,804,7
0.528,0.001,437,467,25,50,0.001,904,7
0.544,0.001,487,517,25,50,0.001,1004,7
0.552,0.001,540,564,25,50,0.001,1104,7
0.566,0.001,588,616,25,50,0.001,1204,7
0.568,0.001,642,662,25,50,0.001,1304,7
0.588,0.001,695,709,25,50,0.001,1404,7
0.602,0.001,747,757,25,50,0.001,1504,7
0.624,0.001,795,809,25,50,0.001,1604,7
0.636,0.001,842,862,25,50,0.001,1704,7
0.658,0.001,882,922,25,50,0.001,1804,7
0.696,0.001,934,970,25,50,0.001,1904,7
0.728,0.001,987,1017,25,50,0.001,2004,7
0.536,0.001,57,47,25,50,0.001,104,8
0.528,0.001,111,93,25,50,0.001,204,8
0.532,0.001,164,140,25,50,0.001,304,8
0.538,0.001,206,198,25,50,0.001,404,8
0.544,0.001,258,246,25,50,0.001,504,8
0.556,0.001,303,301,25,50,0.001,604,8
0.56,0.001,354,350,25,50,0.001,704,8
0.566,0.001,412,392,25,50,0.001,804,8
0.574,0.001,460,444,25,50,0.001,904,8
0.584,0.001,517,487,25,50,0.001,1004,8
0.594,0.001,573,531,25,50,0.001,1104,8
0.596,0.001,618,586,25,50,0.001,1204,8
0.608,0.001,664,640,25,50,0.001,1304,8
0.632,0.001,713,691,25,50,0.001,1404,8
0.662,0.001,756,748,25,50,0.001,1504,8
0.682,0.001,808,796,25,50,0.001,1604,8
0.712,0.001,861,843,25,50,0.001,1704,8
0.744,0.001,918,886,25,50,0.001,1804,8
0.772,0.001,969,935,25,50,0.001,1904,8
0.794,0.001,1020,984,25,50,0.001,2004,8
0.46,0.001,52,52,25,50,0.001,104,9
0.462,0.001,100,104,25,50,0.001,204,9
0.464,0.001,155,149,25,50,0.001,304,9
0.47,0.001,202,202,25,50,0.001,404,9
0.47,0.001,250,254,25,50,0.001,504,9
0.47,0.001,296,308,25,50,0.001,604,9
0.466,0.001,339,365,25,50,0.001,704,9
0.472,0.001,384,420,25,50,0.001,804,9
0.47,0.001,436,468,25,50,0.001,904,9
0.49,0.001,480,524,25,50,0.001,1004,9
0.486,0.001,528,576,25,50,0.001,1104,9
0.49,0.001,581,623,25,50,0.001,1204,9
0.498,0.001,629,675,25,50,0.001,1304,9
0.512,0.001,671,733,25,50,0.001,1404,9
0.528,0.001,727,777,25,50,0.001,1504,9
0.564,0.001,776,828,25,50,0.001,1604,9
0.594,0.001,818,886,25,50,0.001,1704,9
0.604,0.001,867,937,25,50,0.001,1804,9
0.652,0.001,931,973,25,50,0.001,1904,9
0.67,0.001,985,1019,25,50,0.001,2004,9
0.552,0.001,45,59,25,50,0.001,104,10
0.548,0.001,100,104,25,50,0.001,204,10
0.55,0.001,152,152,25,50,0.001,304,10
0.554,0.001,201,203,25,50,0.001,404,10
0.562,0.001,244,260,25,50,0.001,504,10
0.574,0.001,294,310,25,50,0.001,604,10
0.572,0.001,338,366,25,50,0.001,704,10
0.574,0.001,392,412,25,50,0.001,804,10
0.59,0.001,446,458,25,50,0.001,904,10
0.6,0.001,493,511,25,50,0.001,1004,10
0.612,0.001,546,558,25,50,0.001,1104,10
0.626,0.001,598,606,25,50,0.001,1204,10
0.648,0.001,640,664,25,50,0.001,1304,10
0.678,0.001,697,707,25,50,0.001,1404,10
0.696,0.001,742,762,25,50,0.001,1504,10
0.722,0.001,795,809,25,50,0.001,1604,10
0.74,0.001,852,852,25,50,0.001,1704,10
0.758,0.001,901,903,25,50,0.001,1804,10
0.774,0.001,942,962,25,50,0.001,1904,10
0.794,0.001,992,1012,25,50,0.001,2004,10
0.49,0.001,50,54,25,50,0.001,104,11
0.49,0.001,90,114,25,50,0.001,204,11
0.492,0.001,141,163,25,50,0.001,304,11
0.494,0.001,189,215,25,50,0.001,404,11
0.5,0.001,241,263,25,50,0.001,504,11
0.498,0.001,284,320,25,50,0.001,604,11
0.51,0.001,337,367,25,50,0.001,704,11
0.53,0.001,387,417,25,50,0.001,804,11
0.534,0.001,438,466,25,50,0.001,904,11
0.54,0.001,489,515,25,50,0.001,1004,11
0.56,0.001,535,569,25,50,0.001,1104,11
0.578,0.001,582,622,25,50,0.001,1204,11
0.612,0.001,633,671,25,50,0.001,1304,11
0.622,0.001,693,711,25,50,0.001,1404,11
0.628,0.001,743,761,25,50,0.001,1504,11
0.652,0.001,792,812,25,50,0.001,1604,11
0.662,0.001,846,858,25,50,0.001,1704,11
0.68,0.001,906,898,25,50,0.001,1804,11
0.706,0.001,956,948,25,50,0.001,1904,11
0.732,0.001,1006,998,25,50,0.001,2004,11
0.52,0.001,54,50,25,50,0.001,104,12
0.524,0.001,106,98,25,50,0.001,204,12
0.528,0.001,154,150,25,50,0.001,304,12
0.53,0.001,208,196,25,50,0.001,404,12
0.536,0.001,258,246,25,50,0.001,504,12
0.544,0.001,307,297,25,50,0.001,604,12
0.544,0.001,357,347,25,50,0.001,704,12
0.542,0.001,403,401,25,50,0.001,804,12
0.536,0.001,454,450,25,50,0.001,904,12
0.538,0.001,502,502,25,50,0.001,1004,12
0.55,0.001,555,549,25,50,0.001,1104,12
0.576,0.001,599,605,25,50,0.001,1204,12
0.602,0.001,650,654,25,50,0.001,1304,12
0.61,0.001,701,703,25,50,0.001,1404,12
0.626,0.001,750,754,25,50,0.001,1504,12
0.646,0.001,804,800,25,50,0.001,1604,12
0.69,0.001,851,853,25,50,0.001,1704,12
0.718,0.001,902,902,25,50,0.001,1804,12
0.742,0.001,947,957,25,50,0.001,1904,12
0.766,0.001,1001,1003,25,50,0.001,2004,12
0.502,0.001,57,47,25,50,0.001,104,13
0.488,0.001,112,92,25,50,0.001,204,13
0.484,0.001,164,140,25,50,0.001,304,13
0.49,0.001,213,191,25,50,0.001,404,13
0.492,0.001,267,237,25,50,0.001,504,13
0.5,0.001,308,296,25,50,0.001,604,13
0.508,0.001,360,344,25,50,0.001,704,13
0.518,0.001,399,405,25,50,0.001,804,13
0.526,0.001,452,452,25,50,0.001,904,13
0.554,0.001,503,501,25,50,0.001,1004,13
0.566,0.001,555,549,25,50,0.001,1104,13
0.578,0.001,605,599,25,50,0.001,1204,13
0.592,0.001,652,652,25,50,0.001,1304,13
0.61,0.001,693,711,25,50,0.001,1404,13
0.642,0.001,749,755,25,50,0.001,1504,13
0.662,0.001,798,806,25,50,0.001,1604,13
0.676,0.001,847,857,25,50,0.001,1704,13
0.698,0.001,901,903,25,50,0.001,1804,13
0.724,0.001,947,957,25,50,0.001,1904,13
0.742,0.001,1003,1001,25,50,0.001,2004,13
0.49,0.001,53,51,25,50,0.001,104,14
0.496,0.001,109,95,25,50,0.001,204,14
0.508,0.001,156,148,25,50,0.001,304,14
0.512,0.001,204,200,25,50,0.001,404,14
0.518,0.001,250,254,25,50,0.001,504,14
0.526,0.001,307,297,25,50,0.001,604,14
0.56,0.001,357,347,25,50,0.001,704,14
0.57,0.001,413,391,25,50,0.001,804,14
0.582,0.001,457,447,25,50,0.001,904,14
0.586,0.001,509,495,25,50,0.001,1004,14
0.6,0.001,554,550,25,50,0.001,1104,14
0.614,0.001,605,599,25,50,0.001,1204,14
0.626,0.001,654,650,25,50,0.001,1304,14
0.64,0.001,700,704,25,50,0.001,1404,14
0.662,0.001,753,751,25,50,0.001,1504,14
0.682,0.001,798,806,25,50,0.001,1604,14
0.698,0.001,839,865,25,50,0.001,1704,14
0.732,0.001,893,911,25,50,0.001,1804,14
0.748,0.001,944,960,25,50,0.001,1904,14
0.758,0.001,991,1013,25,50,0.001,2004,14
0.524,0.001,42,62,25,50,0.001,104,15
0.536,0.001,92,112,25,50,0.001,204,15
0.55,0.001,149,155,25,50,0.001,304,15
0.552,0.001,195,209,25,50,0.001,404,15
0.562,0.001,237,267,25,50,0.001,504,15
0.568,0.001,279,325,25,50,0.001,604,15
0.572,0.001,324,380,25,50,0.001,704,15
0.596,0.001,382,422,25,50,0.001,804,15
0.594,0.001,434,470,25,50,0.001,904,15
0.61,0.001,485,519,25,50,0.001,1004,15
0.638,0.001,530,574,25,50,0.001,1104,15
0.66,0.001,586,618,25,50,0.001,1204,15
0.688,0.001,640,664,25,50,0.001,1304,15
0.708,0.001,696,708,25,50,0.001,1404,15
0.722,0.001,752,752,25,50,0.001,1504,15
0.742,0.001,797,807,25,50,0.001,1604,15
0.754,0.001,851,853,25,50,0.001,1704,15
0.778,0.001,905,899,25,50,0.001,1804,15
0.792,0.001,954,950,25,50,0.001,1904,15
0.812,0.001,1015,989,25,50,0.001,2004,15
0.488,0.001,46,58,25,50,0.001,104,16
0.48,0.001,99,105,25,50,0.001,204,16
0.472,0.001,145,159,25,50,0.001,304,16
0.478,0.001,198,206,25,50,0.001,404,16
0.488,0.001,256,248,25,50,0.001,504,16
0.5,0.001,300,304,25,50,0.001,604,16
0.508,0.001,347,357,25,50,0.001,704,16
0.508,0.001,401,403,25,50,0.001,804,16
0.508,0.001,450,454,25,50,0.001,904,16
0.502,0.001,496,508,25,50,0.001,1004,16
0.516,0.001,552,552,25,50,0.001,1104,16
0.526,0.001,601,603,25,50,0.001,1204,16
0.538,0.001,652,652,25,50,0.001,1304,16
0.558,0.001,702,702,25,50,0.001,1404,16
0.582,0.001,759,745,25,50,0.001,1504,16
0.596,0.001,810,794,25,50,0.001,1604,16
0.61,0.001,861,843,25,50,0.001,1704,16
0.638,0.001,910,894,25,50,0.001,1804,16
0.656,0.001,961,943,25,50,0.001,1904,16
0.718,0.001,1012,992,25,50,0.001,2004,16
0.508,0.001,53,51,25,50,0.001,104,17
0.512,0.001,105,99,25,50,0.001,204,17
0.516,0.001,151,153,25,50,0.001,304,17
0.52,0.001,194,210,25,50,0.001,404,17
0.51,0.001,251,253,25,50,0.001,504,17
0.52,0.001,299,305,25,50,0.001,604,17
0.536,0.001,351,353,25,50,0.001,704,17
0.55,0.001,402,402,25,50,0.001,804,17
0.554,0.001,450,454,25,50,0.001,904,17
0.564,0.001,494,510,25,50,0.001,1004,17
0.58,0.001,544,560,25,50,0.001,1104,17
0.592,0.001,598,606,25,50,0.001,1204,17
0.598,0.001,655,649,25,50,0.001,1304,17
0.598,0.001,713,691,25,50,0.001,1404,17
0.608,0.001,763,741,25,50,0.001,1504,17
0.638,0.001,804,800,25,50,0.001,1604,17
0.644,0.001,857,847,25,50,0.001,1704,17
0.668,0.001,902,902,25,50,0.001,1804,17
0.694,0.001,945,959,25,50,0.001,1904,17
0.754,0.001,994,1010,25,50,0.001,2004,17
0.496,0.001,53,51,25,50,0.001,104,18
0.504,0.001,101,103,25,50,0.001,204,18
0.508,0.001,158,146,25,50,0.001,304,18
0.514,0.001,200,204,25,50,0.001,404,18
0.532,0.001,245,259,25,50,0.001,504,18
0.54,0.001,299,305,25,50,0.001,604,18
0.55,0.001,352,352,25,50,0.001,704,18
0.558,0.001,399,405,25,50,0.001,804,18
0.568,0.001,448,456,25,50,0.001,904,18
0.58,0.001,502,502,25,50,0.001,1004,18
0.592,0.001,542,562,25,50,0.001,1104,18
0.614,0.001,584,620,25,50,0.001,1204,18
0.634,0.001,639,665,25,50,0.001,1304,18
0.65,0.001,690,714,25,50,0.001,1404,18
0.676,0.001,747,757,25,50,0.001,1504,18
0.708,0.001,805,799,25,50,0.001,1604,18
0.734,0.001,854,850,25,50,0.001,1704,18
0.748,0.001,905,899,25,50,0.001,1804,18
0.764,0.001,953,951,25,50,0.001,1904,18
0.788,0.001,1003,1001,25,50,0.001,2004,18
0.476,0.001,54,50,25,50,0.001,104,19
0.484,0.001,97,107,25,50,0.001,204,19
0.476,0.001,144,160,25,50,0.001,304,19
0.494,0.001,192,212,25,50,0.001,404,19
0.498,0.001,243,261,25,50,0.001,504,19
0.522,0.001,294,310,25,50,0.001,604,19
0.526,0.001,346,358,25,50,0.001,704,19
0.538,0.001,397,407,25,50,0.001,804,19
0.554,0.001,444,460,25,50,0.001,904,19
0.57,0.001,491,513,25,50,0.001,1004,19
0.576,0.001,537,567,25,50,0.001,1104,19
0.594,0.001,585,619,25,50,0.001,1204,19
0.604,0.001,644,660,25,50,0.001,1304,19
0.62,0.001,691,713,25,50,0.001,1404,19
0.634,0.001,744,760,25,50,0.001,1504,19
0.65,0.001,801,803,25,50,0.001,1604,19
0.672,0.001,845,859,25,50,0.001,1704,19
0.702,0.001,901,903,25,50,0.001,1804,19
0.704,0.001,956,948,25,50,0.001,1904,19
0.72,0.001,1011,993,25,50,0.001,2004,19
0.522,0.001,51,53,25,50,0.001,104,20
0.52,0.001,104,100,25,50,0.001,204,20
0.514,0.001,159,145,25,50,0.001,304,20
0.506,0.001,211,193,25,50,0.001,404,20
0.508,0.001,261,243,25,50,0.001,504,20
0.514,0.001,310,294,25,50,0.001,604,20
0.526,0.001,368,336,25,50,0.001,704,20
0.536,0.001,408,396,25,50,0.001,804,20
0.548,0.001,459,445,25,50,0.001,904,20
0.554,0.001,516,488,25,50,0.001,1004,20
0.572,0.001,556,548,25,50,0.001,1104,20
0.584,0.001,609,595,25,50,0.001,1204,20
0.61,0.001,656,648,25,50,0.001,1304,20
0.626,0.001,715,689,25,50,0.001,1404,20
0.642,0.001,767,737,25,50,0.001,1504,20
0.668,0.001,820,784,25,50,0.001,1604,20
0.686,0.001,876,828,25,50,0.001,1704,20
0.704,0.001,925,879,25,50,0.001,1804,20
0.712,0.001,976,928,25,50,0.001,1904,20
0.726,0.001,1017,987,25,50,0.001,2004,20
0.522,0.001,59,45,25,50,0.01,104,1
0.588,0.001,106,98,25,50,0.01,204,1
0.594,0.001,154,150,25,50,0.01,304,1
0.606,0.001,205,199,25,50,0.01,404,1
0.63,0.001,257,247,25,50,0.01,504,1
0.67,0.001,315,289,25,50,0.01,604,1
0.698,0.001,366,338,25,50,0.01,704,1
0.722,0.001,409,395,25,50,0.01,804,1
0.774,0.001,455,449,25,50,0.01,904,1
0.842,0.001,499,505,25,50,0.01,1004,1
0.884,0.001,551,553,25,50,0.01,1104,1
0.92,0.001,596,608,25,50,0.01,1204,1
0.932,0.001,648,656,25,50,0.01,1304,1
0.942,0.001,687,717,25,50,0.01,1404,1
0.944,0.001,738,766,25,50,0.01,1504,1
0.952,0.001,788,816,25,50,0.01,1604,1
0.964,0.001,836,868,25,50,0.01,1704,1
0.956,0.001,885,919,25,50,0.01,1804,1
0.962,0.001,941,963,25,50,0.01,1904,1
0.966,0.001,988,1016,25,50,0.01,2004,1
0.512,0.001,52,52,25,50,0.01,104,2
0.542,0.001,96,108,25,50,0.01,204,2
0.588,0.001,143,161,25,50,0.01,304,2
0.614,0.001,196,208,25,50,0.01,404,2
0.64,0.001,249,255,25,50,0.01,504,2
0.666,0.001,299,305,25,50,0.01,604,2
0.706,0.001,347,357,25,50,0.01,704,2
0.784,0.001,400,404,25,50,0.01,804,2
0.832,0.001,462,442,25,50,0.01,904,2
0.88,0.001,510,494,25,50,0.01,1004,2
0.912,0.001,558,546,25,50,0.01,1104,2
0.94,0.001,608,596,25,50,0.01,1204,2
0.948,0.001,655,649,25,50,0.01,1304,2
0.956,0.001,706,698,25,50,0.01,1404,2
0.968,0.001,760,744,25,50,0.01,1504,2
0.974,0.001,812,792,25,50,0.01,1604,2
0.972,0.001,856,848,25,50,0.01,1704,2
0.974,0.001,904,900,25,50,0.01,1804,2
0.978,0.001,955,949,25,50,0.01,1904,2
0.98,0.001,1000,1004,25,50,0.01,2004,2
0.534,0.001,55,49,25,50,0.01,104,3
0.562,0.001,106,98,25,50,0.01,204,3
0.568,0.001,158,146,25,50,0.01,304,3
0.604,0.001,212,192,25,50,0.01,404,3
0.634,0.001,267,237,25,50,0.01,504,3
0.682,0.001,319,285,25,50,0.01,604,3
0.73,0.001,367,337,25,50,0.01,704,3
0.814,0.001,411,393,25,50,0.01,804,3
0.884,0.001,462,442,25,50,0.01,904,3
0.93,0.001,510,494,25,50,0.01,1004,3
0.95,0.001,559,545,25,50,0.01,1104,3
0.97,0.001,609,595,25,50,0.01,1204,3
0.972,0.001,661,643,25,50,0.01,1304,3
0.974,0.001,710,694,25,50,0.01,1404,3
0.978,0.001,761,743,25,50,0.01,1504,3
0.98,0.001,809,795,25,50,0.01,1604,3
0.982,0.001,862,842,25,50,0.01,1704,3
0.984,0.001,905,899,25,50,0.01,1804,3
0.986,0.001,950,954,25,50,0.01,1904,3
0.986,0.001,1000,1004,25,50,0.01,2004,3
0.524,0.001,46,58,25,50,0.01,104,4
0.576,0.001,95,109,25,50,0.01,204,4
0.614,0.001,138,166,25,50,0.01,304,4
0.628,0.001,186,218,25,50,0.01,404,4
0.664,0.001,242,262,25,50,0.01,504,4
0.702,0.001,284,320,25,50,0.01,604,4
0.744,0.001,337,367,25,50,0.01,704,4
0.786,0.001,389,415,25,50,0.01,804,4
0.828,0.001,431,473,25,50,0.01,904,4
0.882,0.001,482,522,25,50,0.01,1004,4
0.904,0.001,528,576,25,50,0.01,1104,4
0.926,0.001,579,625,25,50,0.01,1204,4
0.954,0.001,635,669,25,50,0.01,1304,4
0.96,0.001,684,720,25,50,0.01,1404,4
0.95,0.001,744,760,25,50,0.01,1504,4
0.962,0.001,794,810,25,50,0.01,1604,4
0.968,0.001,839,865,25,50,0.01,1704,4
0.966,0.001,882,922,25,50,0.01,1804,4
0.974,0.001,936,968,25,50,0.01,1904,4
0.978,0.001,984,1020,25,50,0.01,2004,4
0.484,0.001,51,53,25,50,0.01,104,5
0.516,0.001,105,99,25,50,0.01,204,5
0.528,0.001,154,150,25,50,0.01,304,5
0.55,0.001,203,201,25,50,0.01,404,5
0.59,0.001,248,256,25,50,0.01,504,5
0.63,0.001,302,302,25,50,0.01,604,5
0.664,0.001,353,351,25,50,0.01,704,5
0.718,0.001,406,398,25,50,0.01,804,5
0.754,0.001,458,446,25,50,0.01,904,5
0.82,0.001,509,495,25,50,0.01,1004,5
0.874,0.001,562,542,25,50,0.01,1104,5
0.914,0.001,608,596,25,50,0.01,1204,5
0.928,0.001,649,655,25,50,0.01,1304,5
0.946,0.001,695,709,25,50,0.01,1404,5
0.946,0.001,746,758,25,50,0.01,1504,5
0.958,0.001,801,803,25,50,0.01,1604,5
0.96,0.001,849,855,25,50,0.01,1704,5
0.964,0.001,912,892,25,50,0.01,1804,5
0.966,0.001,961,943,25,50,0.01,1904,5
0.966,0.001,1008,996,25,50,0.01,2004,5
0.528,0.001,45,59,25,50,0.01,104,6
0.54,0.001,92,112,25,50,0.01,204,6
0.564,0.001,145,159,25,50,0.01,304,6
0.582,0.001,199,205,25,50,0.01,404,6
0.584,0.001,246,258,25,50,0.01,504,6
0.642,0.001,301,303,25,50,0.01,604,6
0.718,0.001,350,354,25,50,0.01,704,6
0.772,0.001,403,401,25,50,0.01,804,6
0.808,0.001,454,450,25,50,0.01,904,6
0.864,0.001,498,506,25,50,0.01,1004,6
0.9,0.001,552,552,25,50,0.01,1104,6
0.928,0.001,600,604,25,50,0.01,1204,6
0.942,0.001,653,651,25,50,0.01,1304,6
0.948,0.001,698,706,25,50,0.01,1404,6
0.966,0.001,748,756,25,50,0.01,1504,6
0.972,0.001,798,806,25,50,0.01,1604,6
0.974,0.001,843,861,25,50,0.01,1704,6
0.976,0.001,898,906,25,50,0.01,1804,6
0.98,0.001,946,958,25,50,0.01,1904,6
0.978,0.001,998,1006,25,50,0.01,2004,6
0.508,0.001,42,62,25,50,0.01,104,7
0.54,0.001,102,102,25,50,0.01,204,7
0.572,0.001,148,156,25,50,0.01,304,7
0.592,0.001,196,208,25,50,0.01,404,7
0.608,0.001,248,256,25,50,0.01,504,7
0.68,0.001,306,298,25,50,0.01,604,7
0.72,0.001,353,351,25,50,0.01,704,7
0.778,0.001,404,400,25,50,0.01,804,7
0.814,0.001,439,465,25,50,0.01,904,7
0.872,0.001,488,516,25,50,0.01,1004,7
0.916,0.001,539,565,25,50,0.01,1104,7
0.942,0.001,590,614,25,50,0.01,1204,7
0.942,0.001,635,669,25,50,0.01,1304,7
0.942,0.001,693,711,25,50,0.01,1404,7
0.954,0.001,740,764,25,50,0.01,1504,7
0.96,0.001,790,814,25,50,0.01,1604,7
0.958,0.001,838,866,25,50,0.01,1704,7
0.968,0.001,885,919,25,50,0.01,1804,7
0.974,0.001,946,958,25,50,0.01,1904,7
0.976,0.001,1000,1004,25,50,0.01,2004,7
0.534,0.001,55,49,25,50,0.01,104,8
0.584,0.001,95,109,25,50,0.01,204,8
0.588,0.001,140,164,25,50,0.01,304,8
0.602,0.001,184,220,25,50,0.01,404,8
0.648,0.001,240,264,25,50,0.01,504,8
0.704,0.001,295,309,25,50,0.01,604,8
0.734,0.001,345,359,25,50,0.01,704,8
0.798,0.001,395,409,25,50,0.01,804,8
0.84,0.001,457,447,25,50,0.01,904,8
0.88,0.001,514,490,25,50,0.01,1004,8
0.918,0.001,566,538,25,50,0.01,1104,8
0.928,0.001,619,585,25,50,0.01,1204,8
0.928,0.001,669,635,25,50,0.01,1304,8
0.948,0.001,713,691,25,50,0.01,1404,8
0.946,0.001,762,742,25,50,0.01,1504,8
0.958,0.001,806,798,25,50,0.01,1604,8
0.966,0.001,855,849,25,50,0.01,1704,8
0.97,0.001,902,902,25,50,0.01,1804,8
0.97,0.001,955,949,25,50,0.01,1904,8
0.976,0.001,1003,1001,25,50,0.01,2004,8
0.492,0.001,50,54,25,50,0.01,104,9
0.546,0.001,100,104,25,50,0.01,204,9
0.588,0.001,156,148,25,50,0.01,304,9
0.672,0.001,212,192,25,50,0.01,404,9
0.694,0.001,264,240,25,50,0.01,504,9
0.724,0.001,316,288,25,50,0.01,604,9
0.756,0.001,374,330,25,50,0.01,704,9
0.796,0.001,424,380,25,50,0.01,804,9
0.812,0.001,466,438,25,50,0.01,904,9
0.866,0.001,515,489,25,50,0.01,1004,9
0.906,0.001,571,533,25,50,0.01,1104,9
0.932,0.001,627,577,25,50,0.01,1204,9
0.952,0.001,673,631,25,50,0.01,1304,9
0.954,0.001,724,680,25,50,0.01,1404,9
0.966,0.001,766,738,25,50,0.01,1504,9
0.972,0.001,807,797,25,50,0.01,1604,9
0.962,0.001,853,851,25,50,0.01,1704,9
0.974,0.001,908,896,25,50,0.01,1804,9
0.972,0.001,955,949,25,50,0.01,1904,9
0.98,0.001,1001,1003,25,50,0.01,2004,9
0.504,0.001,49,55,25,50,0.01,104,10
0.512,0.001,98,106,25,50,0.01,204,10
0.56,0.001,151,153,25,50,0.01,304,10
0.586,0.001,205,199,25,50,0.01,404,10
0.616,0.001,255,249,25,50,0.01,504,10
0.67,0.001,309,295,25,50,0.01,604,10
0.694,0.001,362,342,25,50,0.01,704,10
0.756,0.001,417,387,25,50,0.01,804,10
0.762,0.001,469,435,25,50,0.01,904,10
0.806,0.001,523,481,25,50,0.01,1004,10
0.86,0.001,570,534,25,50,0.01,1104,10
0.91,0.001,613,591,25,50,0.01,1204,10
0.914,0.001,649,655,25,50,0.01,1304,10
0.942,0.001,697,707,25,50,0.01,1404,10
0.958,0.001,748,756,25,50,0.01,1504,10
0.956,0.001,794,810,25,50,0.01,1604,10
0.966,0.001,847,857,25,50,0.01,1704,10
0.968,0.001,899,905,25,50,0.01,1804,10
0.968,0.001,948,956,25,50,0.01,1904,10
0.97,0.001,995,1009,25,50,0.01,2004,10
0.492,0.001,54,50,25,50,0.01,104,11
0.554,0.001,114,90,25,50,0.01,204,11
0.59,0.001,176,128,25,50,0.01,304,11
0.652,0.001,223,181,25,50,0.01,404,11
0.704,0.001,283,221,25,50,0.01,504,11
0.75,0.001,333,271,25,50,0.01,604,11
0.792,0.001,383,321,25,50,0.01,704,11
0.828,0.001,431,373,25,50,0.01,804,11
0.878,0.001,478,426,25,50,0.01,904,11
0.91,0.001,528,476,25,50,0.01,1004,11
0.928,0.001,577,527,25,50,0.01,1104,11
0.944,0.001,629,575,25,50,0.01,1204,11
0.946,0.001,665,639,25,50,0.01,1304,11
0.96,0.001,706,698,25,50,0.01,1404,11
0.966,0.001,752,752,25,50,0.01,1504,11
0.968,0.001,800,804,25,50,0.01,1604,11
0.97,0.001,852,852,25,50,0.01,1704,11
0.972,0.001,901,903,25,50,0.01,1804,11
0.972,0.001,950,954,25,50,0.01,1904,11
0.976,0.001,1004,1000,25,50,0.01,2004,11
0.526,0.001,42,62,25,50,0.01,104,12
0.512,0.001,89,115,25,50,0.01,204,12
0.524,0.001,134,170,25,50,0.01,304,12
0.556,0.001,184,220,25,50,0.01,404,12
0.586,0.001,232,272,25,50,0.01,504,12
0.72,0.001,282,322,25,50,0.01,604,12
0.82,0.001,329,375,25,50,0.01,704,12
0.85,0.001,387,417,25,50,0.01,804,12
0.884,0.001,442,462,25,50,0.01,904,12
0.912,0.001,492,512,25,50,0.01,1004,12
0.936,0.001,539,565,25,50,0.01,1104,12
0.96,0.001,589,615,25,50,0.01,1204,12
0.974,0.001,634,670,25,50,0.01,1304,12
0.978,0.001,688,716,25,50,0.01,1404,12
0.984,0.001,743,761,25,50,0.01,1504,12
0.984,0.001,794,810,25,50,0.01,1604,12
0.984,0.001,851,853,25,50,0.01,1704,12
0.988,0.001,903,901,25,50,0.01,1804,12
0.988,0.001,953,951,25,50,0.01,1904,12
0.984,0.001,1001,1003,25,50,0.01,2004,12
0.522,0.001,54,50,25,50,0.01,104,13
0.556,0.001,104,100,25,50,0.01,204,13
0.584,0.001,149,155,25,50,0.01,304,13
0.626,0.001,202,202,25,50,0.01,404,13
0.662,0.001,244,260,25,50,0.01,504,13
0.72,0.001,294,310,25,50,0.01,604,13
0.776,0.001,347,357,25,50,0.01,704,13
0.816,0.001,395,409,25,50,0.01,804,13
0.846,0.001,441,463,25,50,0.01,904,13
0.882,0.001,488,516,25,50,0.01,1004,13
0.916,0.001,543,561,25,50,0.01,1104,13
0.928,0.001,602,602,25,50,0.01,1204,13
0.94,0.001,658,646,25,50,0.01,1304,13
0.95,0.001,703,701,25,50,0.01,1404,13
0.952,0.001,756,748,25,50,0.01,1504,13
0.95,0.001,801,803,25,50,0.01,1604,13
0.96,0.001,855,849,25,50,0.01,1704,13
0.97,0.001,908,896,25,50,0.01,1804,13
0.976,0.001,955,949,25,50,0.01,1904,13
0.98,0.001,1000,1004,25,50,0.01,2004,13
0.52,0.001,57,47,25,50,0.01,104,14
0.564,0.001,110,94,25,50,0.01,204,14
0.606,0.001,160,144,25,50,0.01,304,14
0.642,0.001,211,193,25,50,0.01,404,14
0.69,0.001,257,247,25,50,0.01,504,14
0.71,0.001,311,293,25,50,0.01,604,14
0.73,0.001,370,334,25,50,0.01,704,14
0.788,0.001,416,388,25,50,0.01,804,14
0.83,0.001,471,433,25,50,0.01,904,14
0.906,0.001,512,492,25,50,0.01,1004,14
0.898,0.001,567,537,25,50,0.01,1104,14
0.942,0.001,613,591,25,50,0.01,1204,14
0.948,0.001,661,643,25,50,0.01,1304,14
0.954,0.001,714,690,25,50,0.01,1404,14
0.954,0.001,761,743,25,50,0.01,1504,14
0.962,0.001,810,794,25,50,0.01,1604,14
0.972,0.001,854,850,25,50,0.01,1704,14
0.972,0.001,904,900,25,50,0.01,1804,14
0.974,0.001,958,946,25,50,0.01,1904,14
0.982,0.001,1005,999,25,50,0.01,2004,14
0.51,0.001,56,48,25,50,0.01,104,15
0.546,0.001,107,97,25,50,0.01,204,15
0.544,0.001,152,152,25,50,0.01,304,15
0.566,0.001,192,212,25,50,0.01,404,15
0.6,0.001,247,257,25,50,0.01,504,15
0.68,0.001,305,299,25,50,0.01,604,15
0.74,0.001,354,350,25,50,0.01,704,15
0.784,0.001,404,400,25,50,0.01,804,15
0.802,0.001,452,452,25,50,0.01,904,15
0.846,0.001,502,502,25,50,0.01,1004,15
0.868,0.001,554,550,25,50,0.01,1104,15
0.922,0.001,610,594,25,50,0.01,1204,15
0.94,0.001,659,645,25,50,0.01,1304,15
0.958,0.001,702,702,25,50,0.01,1404,15
0.952,0.001,751,753,25,50,0.01,1504,15
0.958,0.001,794,810,25,50,0.01,1604,15
0.96,0.001,844,860,25,50,0.01,1704,15
0.968,0.001,889,915,25,50,0.01,1804,15
0.968,0.001,933,971,25,50,0.01,1904,15
0.968,0.001,985,1019,25,50,0.01,2004,15
0.514,0.001,57,47,25,50,0.01,104,16
0.564,0.001,111,93,25,50,0.01,204,16
0.604,0.001,159,145,25,50,0.01,304,16
0.65,0.001,214,190,25,50,0.01,404,16
0.702,0.001,272,232,25,50,0.01,504,16
0.72,0.001,323,281,25,50,0.01,604,16
0.768,0.001,377,327,25,50,0.01,704,16
0.814,0.001,427,377,25,50,0.01,804,16
0.866,0.001,477,427,25,50,0.01,904,16
0.928,0.001,530,474,25,50,0.01,1004,16
0.942,0.001,575,529,25,50,0.01,1104,16
0.948,0.001,630,574,25,50,0.01,1204,16
0.95,0.001,684,620,25,50,0.01,1304,16
0.962,0.001,732,672,25,50,0.01,1404,16
0.966,0.001,782,722,25,50,0.01,1504,16
0.972,0.001,825,779,25,50,0.01,1604,16
0.974,0.001,866,838,25,50,0.01,1704,16
0.974,0.001,915,889,25,50,0.01,1804,16
0.976,0.001,965,939,25,50,0.01,1904,16
0.978,0.001,1012,992,25,50,0.01,2004,16
0.504,0.001,53,51,25,50,0.01,104,17
0.556,0.001,107,97,25,50,0.01,204,17
0.568,0.001,158,146,25,50,0.01,304,17
0.59,0.001,203,201,25,50,0.01,404,17
0.638,0.001,250,254,25,50,0.01,504,17
0.674,0.001,299,305,25,50,0.01,604,17
0.698,0.001,363,341,25,50,0.01,704,17
0.762,0.001,415,389,25,50,0.01,804,17
0.778,0.001,464,440,25,50,0.01,904,17
0.834,0.001,513,491,25,50,0.01,1004,17
0.882,0.001,563,541,25,50,0.01,1104,17
0.922,0.001,611,593,25,50,0.01,1204,17
0.944,0.001,656,648,25,50,0.01,1304,17
0.95,0.001,701,703,25,50,0.01,1404,17
0.956,0.001,750,754,25,50,0.01,1504,17
0.958,0.001,803,801,25,50,0.01,1604,17
0.962,0.001,853,851,25,50,0.01,1704,17
0.964,0.001,901,903,25,50,0.01,1804,17
0.964,0.001,956,948,25,50,0.01,1904,17
0.97,0.001,1006,998,25,50,0.01,2004,17
0.516,0.001,56,48,25,50,0.01,104,18
0.59,0.001,96,108,25,50,0.01,204,18
0.648,0.001,139,165,25,50,0.01,304,18
0.634,0.001,187,217,25,50,0.01,404,18
0.656,0.001,238,266,25,50,0.01,504,18
0.69,0.001,284,320,25,50,0.01,604,18
0.712,0.001,333,371,25,50,0.01,704,18
0.778,0.001,380,424,25,50,0.01,804,18
0.808,0.001,432,472,25,50,0.01,904,18
0.884,0.001,488,516,25,50,0.01,1004,18
0.932,0.001,534,570,25,50,0.01,1104,18
0.94,0.001,591,613,25,50,0.01,1204,18
0.952,0.001,649,655,25,50,0.01,1304,18
0.964,0.001,689,715,25,50,0.01,1404,18
0.96,0.001,734,770,25,50,0.01,1504,18
0.958,0.001,787,817,25,50,0.01,1604,18
0.956,0.001,837,867,25,50,0.01,1704,18
0.978,0.001,887,917,25,50,0.01,1804,18
0.978,0.001,938,966,25,50,0.01,1904,18
0.974,0.001,984,1020,25,50,0.01,2004,18
0.528,0.001,55,49,25,50,0.01,104,19
0.558,0.001,99,105,25,50,0.01,204,19
0.568,0.001,155,149,25,50,0.01,304,19
0.588,0.001,205,199,25,50,0.01,404,19
0.596,0.001,256,248,25,50,0.01,504,19
0.642,0.001,299,305,25,50,0.01,604,19
0.684,0.001,352,352,25,50,0.01,704,19
0.776,0.001,401,403,25,50,0.01,804,19
0.824,0.001,458,446,25,50,0.01,904,19
0.87,0.001,512,492,25,50,0.01,1004,19
0.898,0.001,560,544,25,50,0.01,1104,19
0.944,0.001,602,602,25,50,0.01,1204,19
0.952,0.001,650,654,25,50,0.01,1304,19
0.976,0.001,705,699,25,50,0.01,1404,19
0.986,0.001,757,747,25,50,0.01,1504,19
0.984,0.001,802,802,25,50,0.01,1604,19
0.986,0.001,853,851,25,50,0.01,1704,19
0.986,0.001,896,908,25,50,0.01,1804,19
0.988,0.001,947,957,25,50,0.01,1904,19
0.988,0.001,997,1007,25,50,0.01,2004,19
0.516,0.001,49,55,25,50,0.01,104,20
0.536,0.001,95,109,25,50,0.01,204,20
0.556,0.001,155,149,25,50,0.01,304,20
0.602,0.001,202,202,25,50,0.01,404,20
0.618,0.001,250,254,25,50,0.01,504,20
0.664,0.001,295,309,25,50,0.01,604,20
0.72,0.001,345,359,25,50,0.01,704,20
0.792,0.001,396,408,25,50,0.01,804,20
0.834,0.001,455,449,25,50,0.01,904,20
0.888,0.001,509,495,25,50,0.01,1004,20
0.928,0.001,553,551,25,50,0.01,1104,20
0.936,0.001,593,611,25,50,0.01,1204,20
0.948,0.001,644,660,25,50,0.01,1304,20
0.952,0.001,692,712,25,50,0.01,1404,20
0.96,0.001,738,766,25,50,0.01,1504,20
0.972,0.001,789,815,25,50,0.01,1604,20
0.974,0.001,843,861,25,50,0.01,1704,20
0.976,0.001,889,915,25,50,0.01,1804,20
0.978,0.001,946,958,25,50,0.01,1904,20
0.978,0.001,1001,1003,25,50,0.01,2004,20
0.502,1e-05,47,57,25,100,0.0001,104,1
0.502,1e-05,97,107,25,100,0.0001,204,1
0.502,1e-05,141,163,25,100,0.0001,304,1
0.508,1e-05,194,210,25,100,0.0001,404,1
0.51,1e-05,242,262,25,100,0.0001,504,1
0.514,1e-05,286,318,25,100,0.0001,604,1
0.516,1e-05,331,373,25,100,0.0001,704,1
0.52,1e-05,381,423,25,100,0.0001,804,1
0.52,1e-05,432,472,25,100,0.0001,904,1
0.522,1e-05,483,521,25,100,0.0001,1004,1
0.526,1e-05,534,570,25,100,0.0001,1104,1
0.534,1e-05,585,619,25,100,0.0001,1204,1
0.532,1e-05,639,665,25,100,0.0001,1304,1
0.538,1e-05,685,719,25,100,0.0001,1404,1
0.542,1e-05,736,768,25,100,0.0001,1504,1
0.548,1e-05,773,831,25,100,0.0001,1604,1
0.554,1e-05,829,875,25,100,0.0001,1704,1
0.552,1e-05,884,920,25,100,0.0001,1804,1
0.556,1e-05,951,953,25,100,0.0001,1904,1
0.562,1e-05,1003,1001,25,100,0.0001,2004,1
0.462,1e-05,43,61,25,100,0.0001,104,2
0.462,1e-05,99,105,25,100,0.0001,204,2
0.462,1e-05,139,165,25,100,0.0001,304,2
0.46,1e-05,191,213,25,100,0.0001,404,2
0.458,1e-05,242,262,25,100,0.0001,504,2
0.464,1e-05,294,310,25,100,0.0001,604,2
0.464,1e-05,340,364,25,100,0.0001,704,2
0.464,1e-05,395,409,25,100,0.0001,804,2
0.468,1e-05,439,465,25,100,0.0001,904,2
0.468,1e-05,478,526,25,100,0.0001,1004,2
0.472,1e-05,529,575,25,100,0.0001,1104,2
0.474,1e-05,587,617,25,100,0.0001,1204,2
0.474,1e-05,646,658,25,100,0.0001,1304,2
0.476,1e-05,694,710,25,100,0.0001,1404,2
0.484,1e-05,736,768,25,100,0.0001,1504,2
0.486,1e-05,799,805,25,100,0.0001,1604,2
0.492,1e-05,853,851,25,100,0.0001,1704,2
0.496,1e-05,894,910,25,100,0.0001,1804,2
0.5,1e-05,950,954,25,100,0.0001,1904,2
0.504,1e-05,994,1010,25,100,0.0001,2004,2
0.466,1e-05,62,42,25,100,0.0001,104,3
0.464,1e-05,112,92,25,100,0.0001,204,3
0.464,1e-05,162,142,25,100,0.0001,304,3
0.462,1e-05,221,183,25,100,0.0001,404,3
0.462,1e-05,272,232,25,100,0.0001,504,3
0.468,1e-05,318,286,25,100,0.0001,604,3
0.466,1e-05,367,337,25,100,0.0001,704,3
0.462,1e-05,422,382,25,100,0.0001,804,3
0.468,1e-05,480,424,25,100,0.0001,904,3
0.464,1e-05,521,483,25,100,0.0001,1004,3
0.468,1e-05,577,527,25,100,0.0001,1104,3
0.468,1e-05,622,582,25,100,0.0001,1204,3
0.47,1e-05,672,632,25,100,0.0001,1304,3
0.47,1e-05,719,685,25,100,0.0001,1404,3
0.476,1e-05,764,740,25,100,0.0001,1504,3
0.482,1e-05,812,792,25,100,0.0001,1604,3
0.492,1e-05,860,844,25,100,0.0001,1704,3
0.494,1e-05,910,894,25,100,0.0001,1804,3
0.49,1e-05,956,948,25,100,0.0001,1904,3
0.492,1e-05,1012,992,25,100,0.0001,2004,3
0.516,1e-05,57,47,25,100,0.0001,104,4
0.518,1e-05,106,98,25,100,0.0001,204,4
0.526,1e-05,149,155,25,100,0.0001,304,4
0.526,1e-05,195,209,25,100,0.0001,404,4
0.528,1e-05,243,261,25,100,0.0001,504,4
0.53,1e-05,300,304,25,100,0.0001,604,4
0.532,1e-05,342,362,25,100,0.0001,704,4
0.532,1e-05,389,415,25,100,0.0001,804,4
0.53,1e-05,440,464,25,100,0.0001,904,4
0.53,1e-05,489,515,25,100,0.0001,1004,4
0.532,1e-05,535,569,25,100,0.0001,1104,4
0.534,1e-05,593,611,25,100,0.0001,1204,4
0.54,1e-05,647,657,25,100,0.0001,1304,4
0.546,1e-05,700,704,25,100,0.0001,1404,4
0.546,1e-05,755,749,25,100,0.0001,1504,4
0.552,1e-05,807,797,25,100,0.0001,1604,4
0.548,1e-05,851,853,25,100,0.0001,1704,4
0.554,1e-05,902,902,25,100,0.0001,1804,4
0.562,1e-05,951,953,25,100,0.0001,1904,4
0.57,1e-05,1005,999,25,100,0.0001,2004,4
0.516,1e-05,52,52,25,100,0.0001,104,5
0.516,1e-05,110,94,25,100,0.0001,204,5
0.518,1e-05,161,143,25,100,0.0001,304,5
0.524,1e-05,204,200,25,100,0.0001,404,5
0.522,1e-05,254,250,25,100,0.0001,504,5
0.522,1e-05,304,300,25,100,0.0001,604,5
0.53,1e-05,356,348,25,100,0.0001,704,5
0.528,1e-05,407,397,25,100,0.0001,804,5
0.53,1e-05,452,452,25,100,0.0001,904,5
0.536,1e-05,503,501,25,100,0.0001,1004,5
0.538,1e-05,557,547,25,100,0.0001,1104,5
0.538,1e-05,611,593,25,100,0.0001,1204,5
0.542,1e-05,654,650,25,100,0.0001,1304,5
0.548,1e-05,704,700,25,100,0.0001,1404,5
0.546,1e-05,761,743,25,100,0.0001,1504,5
0.548,1e-05,816,788,25,100,0.0001,1604,5
0.552,1e-05,867,837,25,100,0.0001,1704,5
0.554,1e-05,925,879,25,100,0.0001,1804,5
0.556,1e-05,973,931,25,100,0.0001,1904,5
0.562,1e-05,1017,987,25,100,0.0001,2004,5
0.488,1e-05,50,54,25,100,0.0001,104,6
0.486,1e-05,88,116,25,100,0.0001,204,6
0.486,1e-05,139,165,25,100,0.0001,304,6
0.488,1e-05,194,210,25,100,0.0001,404,6
0.488,1e-05,241,263,25,100,0.0001,504,6
0.492,1e-05,297,307,25,100,0.0001,604,6
0.494,1e-05,343,361,25,100,0.0001,704,6
0.496,1e-05,394,410,25,100,0.0001,804,6
0.496,1e-05,446,458,25,100,0.0001,904,6
0.5,1e-05,495,509,25,100,0.0001,1004,6
0.502,1e-05,543,561,25,100,0.0001,1104,6
0.502,1e-05,597,607,25,100,0.0001,1204,6
0.502,1e-05,646,658,25,100,0.0001,1304,6
0.502,1e-05,705,699,25,100,0.0001,1404,6
0.502,1e-05,754,750,25,100,0.0001,1504,6
0.508,1e-05,798,806,25,100,0.0001,1604,6
0.514,1e-05,842,862,25,100,0.0001,1704,6
0.514,1e-05,898,906,25,100,0.0001,1804,6
0.522,1e-05,956,948,25,100,0.0001,1904,6
0.526,1e-05,1003,1001,25,100,0.0001,2004,6
0.482,1e-05,44,60,25,100,0.0001,104,7
0.482,1e-05,94,110,25,100,0.0001,204,7
0.484,1e-05,147,157,25,100,0.0001,304,7
0.484,1e-05,199,205,25,100,0.0001,404,7
0.484,1e-05,244,260,25,100,0.0001,504,7
0.484,1e-05,293,311,25,100,0.0001,604,7
0.484,1e-05,346,358,25,100,0.0001,704,7
0.486,1e-05,392,412,25,100,0.0001,804,7
0.486,1e-05,441,463,25,100,0.0001,904,7
0.486,1e-05,491,513,25,100,0.0001,1004,7
0.486,1e-05,540,564,25,100,0.0001,1104,7
0.488,1e-05,582,622,25,100,0.0001,1204,7
0.488,1e-05,640,664,25,100,0.0001,1304,7
0.488,1e-05,694,710,25,100,0.0001,1404,7
0.494,1e-05,738,766,25,100,0.0001,1504,7
0.496,1e-05,785,819,25,100,0.0001,1604,7
0.5,1e-05,841,863,25,100,0.0001,1704,7
0.502,1e-05,895,909,25,100,0.0001,1804,7
0.51,1e-05,941,963,25,100,0.0001,1904,7
0.514,1e-05,993,1011,25,100,0.0001,2004,7
0.47,1e-05,51,53,25,100,0.0001,104,8
0.466,1e-05,100,104,25,100,0.0001,204,8
0.466,1e-05,149,155,25,100,0.0001,304,8
0.466,1e-05,200,204,25,100,0.0001,404,8
0.466,1e-05,249,255,25,100,0.0001,504,8
0.466,1e-05,294,310,25,100,0.0001,604,8
0.466,1e-05,344,360,25,100,0.0001,704,8
0.466,1e-05,388,416,25,100,0.0001,804,8
0.466,1e-05,445,459,25,100,0.0001,904,8
0.466,1e-05,498,506,25,100,0.0001,1004,8
0.47,1e-05,544,560,25,100,0.0001,1104,8
0.47,1e-05,601,603,25,100,0.0001,1204,8
0.47,1e-05,643,661,25,100,0.0001,1304,8
0.472,1e-05,696,708,25,100,0.0001,1404,8
0.47,1e-05,744,760,25,100,0.0001,1504,8
0.472,1e-05,791,813,25,100,0.0001,1604,8
0.474,1e-05,840,864,25,100,0.0001,1704,8
0.474,1e-05,895,909,25,100,0.0001,1804,8
0.478,1e-05,941,963,25,100,0.0001,1904,8
0.478,1e-05,988,1016,25,100,0.0001,2004,8
0.5,1e-05,47,57,25,100,0.0001,104,9
0.5,1e-05,89,115,25,100,0.0001,204,9
0.5,1e-05,139,165,25,100,0.0001,304,9
0.504,1e-05,189,215,25,100,0.0001,404,9
0.504,1e-05,237,267,25,100,0.0001,504,9
0.506,1e-05,290,314,25,100,0.0001,604,9
0.502,1e-05,347,357,25,100,0.0001,704,9
0.508,1e-05,405,399,25,100,0.0001,804,9
0.504,1e-05,460,444,25,100,0.0001,904,9
0.504,1e-05,509,495,25,100,0.0001,1004,9
0.508,1e-05,559,545,25,100,0.0001,1104,9
0.522,1e-05,610,594,25,100,0.0001,1204,9
0.526,1e-05,666,638,25,100,0.0001,1304,9
0.53,1e-05,715,689,25,100,0.0001,1404,9
0.534,1e-05,762,742,25,100,0.0001,1504,9
0.532,1e-05,811,793,25,100,0.0001,1604,9
0.536,1e-05,856,848,25,100,0.0001,1704,9
0.536,1e-05,904,900,25,100,0.0001,1804,9
0.544,1e-05,951,953,25,100,0.0001,1904,9
0.544,1e-05,995,1009,25,100,0.0001,2004,9
0.508,1e-05,54,50,25,100,0.0001,104,10
0.508,1e-05,104,100,25,100,0.0001,204,10
0.51,1e-05,159,145,25,100,0.0001,304,10
0.51,1e-05,212,192,25,100,0.0001,404,10
0.512,1e-05,261,243,25,100,0.0001,504,10
0.512,1e-05,302,302,25,100,0.0001,604,10
0.514,1e-05,361,343,25,100,0.0001,704,10
0.516,1e-05,414,390,25,100,0.0001,804,10
0.514,1e-05,470,434,25,100,0.0001,904,10
0.514,1e-05,516,488,25,100,0.0001,1004,10
0.518,1e-05,559,545,25,100,0.0001,1104,10
0.53,1e-05,611,593,25,100,0.0001,1204,10
0.53,1e-05,658,646,25,100,0.0001,1304,10
0.532,1e-05,720,684,25,100,0.0001,1404,10
0.538,1e-05,767,737,25,100,0.0001,1504,10
0.546,1e-05,820,784,25,100,0.0001,1604,10
0.544,1e-05,871,833,25,100,0.0001,1704,10
0.546,1e-05,920,884,25,100,0.0001,1804,10
0.542,1e-05,969,935,25,100,0.0001,1904,10
0.548,1e-05,1010,994,25,100,0.0001,2004,10
0.482,1e-05,53,51,25,100,0.0001,104,11
0.482,1e-05,103,101,25,100,0.0001,204,11
0.49,1e-05,158,146,25,100,0.0001,304,11
0.488,1e-05,205,199,25,100,0.0001,404,11
0.49,1e-05,263,241,25,100,0.0001,504,11
0.49,1e-05,309,295,25,100,0.0001,604,11
0.49,1e-05,353,351,25,100,0.0001,704,11
0.492,1e-05,395,409,25,100,0.0001,804,11
0.496,1e-05,450,454,25,100,0.0001,904,11
0.498,1e-05,501,503,25,100,0.0001,1004,11
0.502,1e-05,549,555,25,100,0.0001,1104,11
0.508,1e-05,598,606,25,100,0.0001,1204,11
0.51,1e-05,645,659,25,100,0.0001,1304,11
0.514,1e-05,699,705,25,100,0.0001,1404,11
0.51,1e-05,743,761,25,100,0.0001,1504,11
0.512,1e-05,801,803,25,100,0.0001,1604,11
0.516,1e-05,845,859,25,100,0.0001,1704,11
0.526,1e-05,898,906,25,100,0.0001,1804,11
0.532,1e-05,957,947,25,100,0.0001,1904,11
0.532,1e-05,1006,998,25,100,0.0001,2004,11
0.48,1e-05,56,48,25,100,0.0001,104,12
0.48,1e-05,105,99,25,100,0.0001,204,12
0.48,1e-05,154,150,25,100,0.0001,304,12
0.482,1e-05,209,195,25,100,0.0001,404,12
0.482,1e-05,259,245,25,100,0.0001,504,12
0.482,1e-05,312,292,25,100,0.0001,604,12
0.482,1e-05,365,339,25,100,0.0001,704,12
0.482,1e-05,414,390,25,100,0.0001,804,12
0.482,1e-05,471,433,25,100,0.0001,904,12
0.482,1e-05,515,489,25,100,0.0001,1004,12
0.482,1e-05,563,541,25,100,0.0001,1104,12
0.484,1e-05,612,592,25,100,0.0001,1204,12
0.486,1e-05,657,647,25,100,0.0001,1304,12
0.488,1e-05,712,692,25,100,0.0001,1404,12
0.486,1e-05,763,741,25,100,0.0001,1504,12
0.484,1e-05,803,801,25,100,0.0001,1604,12
0.488,1e-05,851,853,25,100,0.0001,1704,12
0.488,1e-05,894,910,25,100,0.0001,1804,12
0.496,1e-05,951,953,25,100,0.0001,1904,12
0.5,1e-05,998,1006,25,100,0.0001,2004,12
0.516,1e-05,52,52,25,100,0.0001,104,13
0.514,1e-05,105,99,25,100,0.0001,204,13
0.512,1e-05,161,143,25,100,0.0001,304,13
0.512,1e-05,213,191,25,100,0.0001,404,13
0.51,1e-05,259,245,25,100,0.0001,504,13
0.508,1e-05,302,302,25,100,0.0001,604,13
0.512,1e-05,352,352,25,100,0.0001,704,13
0.512,1e-05,400,404,25,100,0.0001,804,13
0.514,1e-05,446,458,25,100,0.0001,904,13
0.51,1e-05,501,503,25,100,0.0001,1004,13
0.506,1e-05,552,552,25,100,0.0001,1104,13
0.506,1e-05,599,605,25,100,0.0001,1204,13
0.502,1e-05,648,656,25,100,0.0001,1304,13
0.5,1e-05,699,705,25,100,0.0001,1404,13
0.508,1e-05,753,751,25,100,0.0001,1504,13
0.51,1e-05,802,802,25,100,0.0001,1604,13
0.514,1e-05,858,846,25,100,0.0001,1704,13
0.52,1e-05,900,904,25,100,0.0001,1804,13
0.516,1e-05,952,952,25,100,0.0001,1904,13
0.518,1e-05,997,1007,25,100,0.0001,2004,13
0.48,1e-05,59,45,25,100,0.0001,104,14
0.482,1e-05,106,98,25,100,0.0001,204,14
0.484,1e-05,148,156,25,100,0.0001,304,14
0.486,1e-05,194,210,25,100,0.0001,404,14
0.486,1e-05,252,252,25,100,0.0001,504,14
0.486,1e-05,305,299,25,100,0.0001,604,14
0.486,1e-05,355,349,25,100,0.0001,704,14
0.49,1e-05,405,399,25,100,0.0001,804,14
0.49,1e-05,457,447,25,100,0.0001,904,14
0.492,1e-05,506,498,25,100,0.0001,1004,14
0.492,1e-05,561,543,25,100,0.0001,1104,14
0.496,1e-05,604,600,25,100,0.0001,1204,14
0.496,1e-05,652,652,25,100,0.0001,1304,14
0.498,1e-05,699,705,25,100,0.0001,1404,14
0.498,1e-05,746,758,25,100,0.0001,1504,14
0.506,1e-05,792,812,25,100,0.0001,1604,14
0.51,1e-05,844,860,25,100,0.0001,1704,14
0.52,1e-05,897,907,25,100,0.0001,1804,14
0.52,1e-05,948,956,25,100,0.0001,1904,14
0.528,1e-05,997,1007,25,100,0.0001,2004,14
0.55,1e-05,52,52,25,100,0.0001,104,15
0.55,1e-05,106,98,25,100,0.0001,204,15
0.552,1e-05,160,144,25,100,0.0001,304,15
0.55,1e-05,212,192,25,100,0.0001,404,15
0.552,1e-05,263,241,25,100,0.0001,504,15
0.554,1e-05,309,295,25,100,0.0001,604,15
0.554,1e-05,354,350,25,100,0.0001,704,15
0.554,1e-05,401,403,25,100,0.0001,804,15
0.556,1e-05,446,458,25,100,0.0001,904,15
0.55,1e-05,489,515,25,100,0.0001,1004,15
0.552,1e-05,535,569,25,100,0.0001,1104,15
0.552,1e-05,595,609,25,100,0.0001,1204,15
0.546,1e-05,652,652,25,100,0.0001,1304,15
0.556,1e-05,700,704,25,100,0.0001,1404,15
0.556,1e-05,740,764,25,100,0.0001,1504,15
0.564,1e-05,794,810,25,100,0.0001,1604,15
0.564,1e-05,849,855,25,100,0.0001,1704,15
0.558,1e-05,898,906,25,100,0.0001,1804,15
0.574,1e-05,942,962,25,100,0.0001,1904,15
0.578,1e-05,991,1013,25,100,0.0001,2004,15
0.5,1e-05,55,49,25,100,0.0001,104,16
0.498,1e-05,101,103,25,100,0.0001,204,16
0.5,1e-05,149,155,25,100,0.0001,304,16
0.5,1e-05,205,199,25,100,0.0001,404,16
0.5,1e-05,257,247,25,100,0.0001,504,16
0.502,1e-05,312,292,25,100,0.0001,604,16
0.502,1e-05,362,342,25,100,0.0001,704,16
0.502,1e-05,419,385,25,100,0.0001,804,16
0.496,1e-05,466,438,25,100,0.0001,904,16
0.492,1e-05,516,488,25,100,0.0001,1004,16
0.492,1e-05,572,532,25,100,0.0001,1104,16
0.492,1e-05,622,582,25,100,0.0001,1204,16
0.492,1e-05,664,640,25,100,0.0001,1304,16
0.5,1e-05,706,698,25,100,0.0001,1404,16
0.504,1e-05,757,747,25,100,0.0001,1504,16
0.506,1e-05,808,796,25,100,0.0001,1604,16
0.508,1e-05,857,847,25,100,0.0001,1704,16
0.512,1e-05,899,905,25,100,0.0001,1804,16
0.514,1e-05,942,962,25,100,0.0001,1904,16
0.516,1e-05,992,1012,25,100,0.0001,2004,16
0.512,1e-05,47,57,25,100,0.0001,104,17
0.512,1e-05,99,105,25,100,0.0001,204,17
0.512,1e-05,147,157,25,100,0.0001,304,17
0.508,1e-05,193,211,25,100,0.0001,404,17
0.514,1e-05,245,259,25,100,0.0001,504,17
0.516,1e-05,293,311,25,100,0.0001,604,17
0.518,1e-05,338,366,25,100,0.0001,704,17
0.52,1e-05,380,424,25,100,0.0001,804,17
0.516,1e-05,433,471,25,100,0.0001,904,17
0.518,1e-05,488,516,25,100,0.0001,1004,17
0.518,1e-05,530,574,25,100,0.0001,1104,17
0.52,1e-05,588,616,25,100,0.0001,1204,17
0.524,1e-05,633,671,25,100,0.0001,1304,17
0.518,1e-05,684,720,25,100,0.0001,1404,17
0.506,1e-05,736,768,25,100,0.0001,1504,17
0.502,1e-05,788,816,25,100,0.0001,1604,17
0.512,1e-05,846,858,25,100,0.0001,1704,17
0.516,1e-05,890,914,25,100,0.0001,1804,17
0.522,1e-05,943,961,25,100,0.0001,1904,17
0.524,1e-05,999,1005,25,100,0.0001,2004,17
0.496,1e-05,56,48,25,100,0.0001,104,18
0.496,1e-05,109,95,25,100,0.0001,204,18
0.496,1e-05,162,142,25,100,0.0001,304,18
0.502,1e-05,205,199,25,100,0.0001,404,18
0.5,1e-05,256,248,25,100,0.0001,504,18
0.498,1e-05,308,296,25,100,0.0001,604,18
0.498,1e-05,348,356,25,100,0.0001,704,18
0.502,1e-05,394,410,25,100,0.0001,804,18
0.5,1e-05,455,449,25,100,0.0001,904,18
0.502,1e-05,513,491,25,100,0.0001,1004,18
0.498,1e-05,571,533,25,100,0.0001,1104,18
0.502,1e-05,628,576,25,100,0.0001,1204,18
0.504,1e-05,672,632,25,100,0.0001,1304,18
0.508,1e-05,716,688,25,100,0.0001,1404,18
0.506,1e-05,761,743,25,100,0.0001,1504,18
0.514,1e-05,808,796,25,100,0.0001,1604,18
0.52,1e-05,855,849,25,100,0.0001,1704,18
0.524,1e-05,909,895,25,100,0.0001,1804,18
0.53,1e-05,953,951,25,100,0.0001,1904,18
0.532,1e-05,1003,1001,25,100,0.0001,2004,18
0.51,1e-05,56,48,25,100,0.0001,104,19
0.51,1e-05,111,93,25,100,0.0001,204,19
0.508,1e-05,167,137,25,100,0.0001,304,19
0.512,1e-05,217,187,25,100,0.0001,404,19
0.512,1e-05,271,233,25,100,0.0001,504,19
0.514,1e-05,320,284,25,100,0.0001,604,19
0.514,1e-05,369,335,25,100,0.0001,704,19
0.512,1e-05,415,389,25,100,0.0001,804,19
0.512,1e-05,462,442,25,100,0.0001,904,19
0.512,1e-05,510,494,25,100,0.0001,1004,19
0.516,1e-05,558,546,25,100,0.0001,1104,19
0.52,1e-05,612,592,25,100,0.0001,1204,19
0.518,1e-05,662,642,25,100,0.0001,1304,19
0.522,1e-05,711,693,25,100,0.0001,1404,19
0.518,1e-05,756,748,25,100,0.0001,1504,19
0.52,1e-05,794,810,25,100,0.0001,1604,19
0.524,1e-05,842,862,25,100,0.0001,1704,19
0.528,1e-05,890,914,25,100,0.0001,1804,19
0.53,1e-05,946,958,25,100,0.0001,1904,19
0.534,1e-05,994,1010,25,100,0.0001,2004,19
0.444,1e-05,41,63,25,100,0.0001,104,20
0.448,1e-05,87,117,25,100,0.0001,204,20
0.45,1e-05,129,175,25,100,0.0001,304,20
0.45,1e-05,181,223,25,100,0.0001,404,20
0.452,1e-05,231,273,25,100,0.0001,504,20
0.444,1e-05,273,331,25,100,0.0001,604,20
0.448,1e-05,328,376,25,100,0.0001,704,20
0.452,1e-05,378,426,25,100,0.0001,804,20
0.45,1e-05,433,471,25,100,0.0001,904,20
0.452,1e-05,483,521,25,100,0.0001,1004,20
0.464,1e-05,534,570,25,100,0.0001,1104,20
0.46,1e-05,585,619,25,100,0.0001,1204,20
0.458,1e-05,641,663,25,100,0.0001,1304,20
0.454,1e-05,691,713,25,100,0.0001,1404,20
0.452,1e-05,747,757,25,100,0.0001,1504,20
0.46,1e-05,799,805,25,100,0.0001,1604,20
0.466,1e-05,854,850,25,100,0.0001,1704,20
0.47,1e-05,901,903,25,100,0.0001,1804,20
0.48,1e-05,957,947,25,100,0.0001,1904,20
0.486,1e-05,1014,990,25,100,0.0001,2004,20
0.516,1e-05,51,53,25,100,0.001,104,1
0.516,1e-05,103,101,25,100,0.001,204,1
0.534,1e-05,153,151,25,100,0.001,304,1
0.548,1e-05,195,209,25,100,0.001,404,1
0.548,1e-05,248,256,25,100,0.001,504,1
0.572,1e-05,298,306,25,100,0.001,604,1
0.582,1e-05,353,351,25,100,0.001,704,1
0.6,1e-05,412,392,25,100,0.001,804,1
0.612,1e-05,464,440,25,100,0.001,904,1
0.63,1e-05,510,494,25,100,0.001,1004,1
0.662,1e-05,566,538,25,100,0.001,1104,1
0.69,1e-05,615,589,25,100,0.001,1204,1
0.698,1e-05,661,643,25,100,0.001,1304,1
0.722,1e-05,715,689,25,100,0.001,1404,1
0.75,1e-05,762,742,25,100,0.001,1504,1
0.782,1e-05,804,800,25,100,0.001,1604,1
0.804,1e-05,862,842,25,100,0.001,1704,1
0.834,1e-05,920,884,25,100,0.001,1804,1
0.866,1e-05,966,938,25,100,0.001,1904,1
0.894,1e-05,1019,985,25,100,0.001,2004,1
0.52,1e-05,47,57,25,100,0.001,104,2
0.526,1e-05,103,101,25,100,0.001,204,2
0.536,1e-05,153,151,25,100,0.001,304,2
0.554,1e-05,207,197,25,100,0.001,404,2
0.564,1e-05,252,252,25,100,0.001,504,2
0.572,1e-05,299,305,25,100,0.001,604,2
0.582,1e-05,356,348,25,100,0.001,704,2
0.588,1e-05,420,384,25,100,0.001,804,2
0.62,1e-05,472,432,25,100,0.001,904,2
0.642,1e-05,512,492,25,100,0.001,1004,2
0.654,1e-05,561,543,25,100,0.001,1104,2
0.662,1e-05,609,595,25,100,0.001,1204,2
0.674,1e-05,662,642,25,100,0.001,1304,2
0.696,1e-05,711,693,25,100,0.001,1404,2
0.708,1e-05,771,733,25,100,0.001,1504,2
0.742,1e-05,820,784,25,100,0.001,1604,2
0.772,1e-05,865,839,25,100,0.001,1704,2
0.8,1e-05,919,885,25,100,0.001,1804,2
0.816,1e-05,973,931,25,100,0.001,1904,2
0.842,1e-05,1018,986,25,100,0.001,2004,2
0.514,1e-05,44,60,25,100,0.001,104,3
0.506,1e-05,101,103,25,100,0.001,204,3
0.51,1e-05,147,157,25,100,0.001,304,3
0.506,1e-05,199,205,25,100,0.001,404,3
0.532,1e-05,252,252,25,100,0.001,504,3
0.574,1e-05,296,308,25,100,0.001,604,3
0.592,1e-05,345,359,25,100,0.001,704,3
0.61,1e-05,386,418,25,100,0.001,804,3
0.622,1e-05,431,473,25,100,0.001,904,3
0.648,1e-05,489,515,25,100,0.001,1004,3
0.678,1e-05,538,566,25,100,0.001,1104,3
0.716,1e-05,590,614,25,100,0.001,1204,3
0.73,1e-05,639,665,25,100,0.001,1304,3
0.748,1e-05,687,717,25,100,0.001,1404,3
0.754,1e-05,732,772,25,100,0.001,1504,3
0.772,1e-05,789,815,25,100,0.001,1604,3
0.796,1e-05,847,857,25,100,0.001,1704,3
0.812,1e-05,895,909,25,100,0.001,1804,3
0.828,1e-05,950,954,25,100,0.001,1904,3
0.868,1e-05,1000,1004,25,100,0.001,2004,3
0.504,1e-05,48,56,25,100,0.001,104,4
0.508,1e-05,97,107,25,100,0.001,204,4
0.526,1e-05,143,161,25,100,0.001,304,4
0.526,1e-05,190,214,25,100,0.001,404,4
0.518,1e-05,241,263,25,100,0.001,504,4
0.536,1e-05,292,312,25,100,0.001,604,4
0.556,1e-05,339,365,25,100,0.001,704,4
0.576,1e-05,401,403,25,100,0.001,804,4
0.604,1e-05,459,445,25,100,0.001,904,4
0.628,1e-05,507,497,25,100,0.001,1004,4
0.658,1e-05,560,544,25,100,0.001,1104,4
0.688,1e-05,610,594,25,100,0.001,1204,4
0.712,1e-05,665,639,25,100,0.001,1304,4
0.736,1e-05,718,686,25,100,0.001,1404,4
0.754,1e-05,764,740,25,100,0.001,1504,4
0.778,1e-05,817,787,25,100,0.001,1604,4
0.772,1e-05,869,835,25,100,0.001,1704,4
0.804,1e-05,917,887,25,100,0.001,1804,4
0.832,1e-05,961,943,25,100,0.001,1904,4
0.848,1e-05,1018,986,25,100,0.001,2004,4
0.508,1e-05,46,58,25,100,0.001,104,5
0.506,1e-05,97,107,25,100,0.001,204,5
0.504,1e-05,155,149,25,100,0.001,304,5
0.524,1e-05,196,208,25,100,0.001,404,5
0.54,1e-05,252,252,25,100,0.001,504,5
0.562,1e-05,303,301,25,100,0.001,604,5
0.556,1e-05,349,355,25,100,0.001,704,5
0.562,1e-05,401,403,25,100,0.001,804,5
0.568,1e-05,451,453,25,100,0.001,904,5
0.596,1e-05,505,499,25,100,0.001,1004,5
0.608,1e-05,552,552,25,100,0.001,1104,5
0.642,1e-05,605,599,25,100,0.001,1204,5
0.654,1e-05,654,650,25,100,0.001,1304,5
0.678,1e-05,717,687,25,100,0.001,1404,5
0.718,1e-05,767,737,25,100,0.001,1504,5
0.75,1e-05,813,791,25,100,0.001,1604,5
0.778,1e-05,858,846,25,100,0.001,1704,5
0.816,1e-05,908,896,25,100,0.001,1804,5
0.826,1e-05,961,943,25,100,0.001,1904,5
0.856,1e-05,1013,991,25,100,0.001,2004,5
0.538,1e-05,58,46,25,100,0.001,104,6
0.546,1e-05,104,100,25,100,0.001,204,6
0.556,1e-05,151,153,25,100,0.001,304,6
0.57,1e-05,201,203,25,100,0.001,404,6
0.582,1e-05,247,257,25,100,0.001,504,6
0.604,1e-05,301,303,25,100,0.001,604,6
0.614,1e-05,359,345,25,100,0.001,704,6
0.626,1e-05,411,393,25,100,0.001,804,6
0.63,1e-05,464,440,25,100,0.001,904,6
0.64,1e-05,520,484,25,100,0.001,1004,6
0.644,1e-05,578,526,25,100,0.001,1104,6
0.648,1e-05,632,572,25,100,0.001,1204,6
0.666,1e-05,683,621,25,100,0.001,1304,6
0.686,1e-05,734,670,25,100,0.001,1404,6
0.704,1e-05,779,725,25,100,0.001,1504,6
0.758,1e-05,827,777,25,100,0.001,1604,6
0.8,1e-05,877,827,25,100,0.001,1704,6
0.826,1e-05,917,887,25,100,0.001,1804,6
0.838,1e-05,965,939,25,100,0.001,1904,6
0.862,1e-05,1011,993,25,100,0.001,2004,6
0.478,1e-05,57,47,25,100,0.001,104,7
0.492,1e-05,103,101,25,100,0.001,204,7
0.506,1e-05,155,149,25,100,0.001,304,7
0.518,1e-05,197,207,25,100,0.001,404,7
0.524,1e-05,253,251,25,100,0.001,504,7
0.546,1e-05,306,298,25,100,0.001,604,7
0.562,1e-05,359,345,25,100,0.001,704,7
0.582,1e-05,409,395,25,100,0.001,804,7
0.586,1e-05,461,443,25,100,0.001,904,7
0.606,1e-05,516,488,25,100,0.001,1004,7
0.632,1e-05,556,548,25,100,0.001,1104,7
0.666,1e-05,609,595,25,100,0.001,1204,7
0.696,1e-05,660,644,25,100,0.001,1304,7
0.726,1e-05,721,683,25,100,0.001,1404,7
0.752,1e-05,769,735,25,100,0.001,1504,7
0.78,1e-05,815,789,25,100,0.001,1604,7
0.816,1e-05,869,835,25,100,0.001,1704,7
0.844,1e-05,914,890,25,100,0.001,1804,7
0.86,1e-05,962,942,25,100,0.001,1904,7
0.89,1e-05,1017,987,25,100,0.001,2004,7
0.498,1e-05,50,54,25,100,0.001,104,8
0.506,1e-05,96,108,25,100,0.001,204,8
0.514,1e-05,142,162,25,100,0.001,304,8
0.518,1e-05,201,203,25,100,0.001,404,8
0.516,1e-05,242,262,25,100,0.001,504,8
0.516,1e-05,282,322,25,100,0.001,604,8
0.528,1e-05,331,373,25,100,0.001,704,8
0.548,1e-05,385,419,25,100,0.001,804,8
0.582,1e-05,435,469,25,100,0.001,904,8
0.61,1e-05,486,518,25,100,0.001,1004,8
0.626,1e-05,543,561,25,100,0.001,1104,8
0.656,1e-05,597,607,25,100,0.001,1204,8
0.672,1e-05,642,662,25,100,0.001,1304,8
0.702,1e-05,699,705,25,100,0.001,1404,8
0.728,1e-05,755,749,25,100,0.001,1504,8
0.75,1e-05,812,792,25,100,0.001,1604,8
0.794,1e-05,861,843,25,100,0.001,1704,8
0.832,1e-05,905,899,25,100,0.001,1804,8
0.856,1e-05,964,940,25,100,0.001,1904,8
0.886,1e-05,1008,996,25,100,0.001,2004,8
0.474,1e-05,48,56,25,100,0.001,104,9
0.488,1e-05,101,103,25,100,0.001,204,9
0.504,1e-05,157,147,25,100,0.001,304,9
0.51,1e-05,204,200,25,100,0.001,404,9
0.514,1e-05,257,247,25,100,0.001,504,9
0.544,1e-05,309,295,25,100,0.001,604,9
0.552,1e-05,360,344,25,100,0.001,704,9
0.58,1e-05,406,398,25,100,0.001,804,9
0.626,1e-05,452,452,25,100,0.001,904,9
0.658,1e-05,502,502,25,100,0.001,1004,9
0.68,1e-05,561,543,25,100,0.001,1104,9
0.684,1e-05,610,594,25,100,0.001,1204,9
0.7,1e-05,657,647,25,100,0.001,1304,9
0.726,1e-05,706,698,25,100,0.001,1404,9
0.752,1e-05,762,742,25,100,0.001,1504,9
0.772,1e-05,806,798,25,100,0.001,1604,9
0.798,1e-05,850,854,25,100,0.001,1704,9
0.812,1e-05,896,908,25,100,0.001,1804,9
0.824,1e-05,941,963,25,100,0.001,1904,9
0.84,1e-05,996,1008,25,100,0.001,2004,9
0.55,1e-05,53,51,25,100,0.001,104,10
0.566,1e-05,102,102,25,100,0.001,204,10
0.572,1e-05,157,147,25,100,0.001,304,10
0.578,1e-05,206,198,25,100,0.001,404,10
0.59,1e-05,253,251,25,100,0.001,504,10
0.598,1e-05,304,300,25,100,0.001,604,10
0.592,1e-05,344,360,25,100,0.001,704,10
0.612,1e-05,400,404,25,100,0.001,804,10
0.624,1e-05,450,454,25,100,0.001,904,10
0.648,1e-05,499,505,25,100,0.001,1004,10
0.674,1e-05,554,550,25,100,0.001,1104,10
0.69,1e-05,600,604,25,100,0.001,1204,10
0.712,1e-05,655,649,25,100,0.001,1304,10
0.74,1e-05,701,703,25,100,0.001,1404,10
0.756,1e-05,752,752,25,100,0.001,1504,10
0.808,1e-05,795,809,25,100,0.001,1604,10
0.834,1e-05,857,847,25,100,0.001,1704,10
0.85,1e-05,900,904,25,100,0.001,1804,10
0.858,1e-05,942,962,25,100,0.001,1904,10
0.868,1e-05,992,1012,25,100,0.001,2004,10
0.52,1e-05,50,54,25,100,0.001,104,11
0.522,1e-05,105,99,25,100,0.001,204,11
0.526,1e-05,156,148,25,100,0.001,304,11
0.524,1e-05,204,200,25,100,0.001,404,11
0.532,1e-05,264,240,25,100,0.001,504,11
0.542,1e-05,313,291,25,100,0.001,604,11
0.546,1e-05,367,337,25,100,0.001,704,11
0.542,1e-05,418,386,25,100,0.001,804,11
0.564,1e-05,473,431,25,100,0.001,904,11
0.564,1e-05,526,478,25,100,0.001,1004,11
0.604,1e-05,571,533,25,100,0.001,1104,11
0.64,1e-05,618,586,25,100,0.001,1204,11
0.67,1e-05,670,634,25,100,0.001,1304,11
0.71,1e-05,725,679,25,100,0.001,1404,11
0.736,1e-05,773,731,25,100,0.001,1504,11
0.764,1e-05,821,783,25,100,0.001,1604,11
0.798,1e-05,870,834,25,100,0.001,1704,11
0.816,1e-05,912,892,25,100,0.001,1804,11
0.836,1e-05,964,940,25,100,0.001,1904,11
0.872,1e-05,1011,993,25,100,0.001,2004,11
0.488,1e-05,44,60,25,100,0.001,104,12
0.486,1e-05,98,106,25,100,0.001,204,12
0.476,1e-05,147,157,25,100,0.001,304,12
0.488,1e-05,193,211,25,100,0.001,404,12
0.496,1e-05,246,258,25,100,0.001,504,12
0.512,1e-05,289,315,25,100,0.001,604,12
0.526,1e-05,341,363,25,100,0.001,704,12
0.562,1e-05,395,409,25,100,0.001,804,12
0.598,1e-05,443,461,25,100,0.001,904,12
0.632,1e-05,497,507,25,100,0.001,1004,12
0.63,1e-05,545,559,25,100,0.001,1104,12
0.642,1e-05,600,604,25,100,0.001,1204,12
0.668,1e-05,651,653,25,100,0.001,1304,12
0.712,1e-05,705,699,25,100,0.001,1404,12
0.744,1e-05,753,751,25,100,0.001,1504,12
0.772,1e-05,802,802,25,100,0.001,1604,12
0.808,1e-05,848,856,25,100,0.001,1704,12
0.83,1e-05,898,906,25,100,0.001,1804,12
0.84,1e-05,949,955,25,100,0.001,1904,12
0.86,1e-05,989,1015,25,100,0.001,2004,12
0.496,1e-05,49,55,25,100,0.001,104,13
0.492,1e-05,97,107,25,100,0.001,204,13
0.494,1e-05,143,161,25,100,0.001,304,13
0.52,1e-05,190,214,25,100,0.001,404,13
0.51,1e-05,242,262,25,100,0.001,504,13
0.52,1e-05,300,304,25,100,0.001,604,13
0.528,1e-05,348,356,25,100,0.001,704,13
0.57,1e-05,409,395,25,100,0.001,804,13
0.58,1e-05,445,459,25,100,0.001,904,13
0.594,1e-05,493,511,25,100,0.001,1004,13
0.624,1e-05,543,561,25,100,0.001,1104,13
0.658,1e-05,596,608,25,100,0.001,1204,13
0.684,1e-05,660,644,25,100,0.001,1304,13
0.696,1e-05,712,692,25,100,0.001,1404,13
0.724,1e-05,765,739,25,100,0.001,1504,13
0.74,1e-05,819,785,25,100,0.001,1604,13
0.76,1e-05,863,841,25,100,0.001,1704,13
0.79,1e-05,910,894,25,100,0.001,1804,13
0.808,1e-05,953,951,25,100,0.001,1904,13
0.83,1e-05,990,1014,25,100,0.001,2004,13
0.552,1e-05,55,49,25,100,0.001,104,14
0.574,1e-05,103,101,25,100,0.001,204,14
0.576,1e-05,160,144,25,100,0.001,304,14
0.578,1e-05,206,198,25,100,0.001,404,14
0.596,1e-05,259,245,25,100,0.001,504,14
0.602,1e-05,309,295,25,100,0.001,604,14
0.624,1e-05,362,342,25,100,0.001,704,14
0.626,1e-05,412,392,25,100,0.001,804,14
0.624,1e-05,457,447,25,100,0.001,904,14
0.66,1e-05,510,494,25,100,0.001,1004,14
0.656,1e-05,554,550,25,100,0.001,1104,14
0.678,1e-05,606,598,25,100,0.001,1204,14
0.706,1e-05,653,651,25,100,0.001,1304,14
0.744,1e-05,693,711,25,100,0.001,1404,14
0.772,1e-05,744,760,25,100,0.001,1504,14
0.81,1e-05,795,809,25,100,0.001,1604,14
0.852,1e-05,842,862,25,100,0.001,1704,14
0.864,1e-05,898,906,25,100,0.001,1804,14
0.88,1e-05,950,954,25,100,0.001,1904,14
0.898,1e-05,1001,1003,25,100,0.001,2004,14
0.49,1e-05,54,50,25,100,0.001,104,15
0.492,1e-05,103,101,25,100,0.001,204,15
0.488,1e-05,157,147,25,100,0.001,304,15
0.494,1e-05,201,203,25,100,0.001,404,15
0.512,1e-05,261,243,25,100,0.001,504,15
0.512,1e-05,306,298,25,100,0.001,604,15
0.532,1e-05,341,363,25,100,0.001,704,15
0.554,1e-05,386,418,25,100,0.001,804,15
0.574,1e-05,445,459,25,100,0.001,904,15
0.594,1e-05,487,517,25,100,0.001,1004,15
0.612,1e-05,539,565,25,100,0.001,1104,15
0.626,1e-05,595,609,25,100,0.001,1204,15
0.65,1e-05,643,661,25,100,0.001,1304,15
0.678,1e-05,695,709,25,100,0.001,1404,15
0.716,1e-05,751,753,25,100,0.001,1504,15
0.75,1e-05,800,804,25,100,0.001,1604,15
0.748,1e-05,852,852,25,100,0.001,1704,15
0.766,1e-05,892,912,25,100,0.001,1804,15
0.794,1e-05,942,962,25,100,0.001,1904,15
0.808,1e-05,989,1015,25,100,0.001,2004,15
0.52,1e-05,56,48,25,100,0.001,104,16
0.54,1e-05,107,97,25,100,0.001,204,16
0.548,1e-05,148,156,25,100,0.001,304,16
0.56,1e-05,199,205,25,100,0.001,404,16
0.57,1e-05,245,259,25,100,0.001,504,16
0.566,1e-05,297,307,25,100,0.001,604,16
0.568,1e-05,342,362,25,100,0.001,704,16
0.582,1e-05,390,414,25,100,0.001,804,16
0.596,1e-05,435,469,25,100,0.001,904,16
0.604,1e-05,486,518,25,100,0.001,1004,16
0.618,1e-05,543,561,25,100,0.001,1104,16
0.634,1e-05,595,609,25,100,0.001,1204,16
0.654,1e-05,642,662,25,100,0.001,1304,16
0.68,1e-05,695,709,25,100,0.001,1404,16
0.714,1e-05,741,763,25,100,0.001,1504,16
0.748,1e-05,799,805,25,100,0.001,1604,16
0.784,1e-05,845,859,25,100,0.001,1704,16
0.804,1e-05,898,906,25,100,0.001,1804,16
0.832,1e-05,948,956,25,100,0.001,1904,16
0.862,1e-05,1000,1004,25,100,0.001,2004,16
0.514,1e-05,51,53,25,100,0.001,104,17
0.518,1e-05,88,116,25,100,0.001,204,17
0.524,1e-05,135,169,25,100,0.001,304,17
0.532,1e-05,184,220,25,100,0.001,404,17
0.54,1e-05,246,258,25,100,0.001,504,17
0.558,1e-05,299,305,25,100,0.001,604,17
0.58,1e-05,346,358,25,100,0.001,704,17
0.6,1e-05,400,404,25,100,0.001,804,17
0.61,1e-05,451,453,25,100,0.001,904,17
0.644,1e-05,497,507,25,100,0.001,1004,17
0.66,1e-05,547,557,25,100,0.001,1104,17
0.69,1e-05,593,611,25,100,0.001,1204,17
0.734,1e-05,645,659,25,100,0.001,1304,17
0.776,1e-05,697,707,25,100,0.001,1404,17
0.79,1e-05,745,759,25,100,0.001,1504,17
0.802,1e-05,800,804,25,100,0.001,1604,17
0.816,1e-05,847,857,25,100,0.001,1704,17
0.842,1e-05,890,914,25,100,0.001,1804,17
0.866,1e-05,948,956,25,100,0.001,1904,17
0.89,1e-05,997,1007,25,100,0.001,2004,17
0.524,1e-05,62,42,25,100,0.001,104,18
0.532,1e-05,108,96,25,100,0.001,204,18
0.538,1e-05,148,156,25,100,0.001,304,18
0.532,1e-05,207,197,25,100,0.001,404,18
0.544,1e-05,257,247,25,100,0.001,504,18
0.552,1e-05,300,304,25,100,0.001,604,18
0.56,1e-05,353,351,25,100,0.001,704,18
0.568,1e-05,404,400,25,100,0.001,804,18
0.582,1e-05,451,453,25,100,0.001,904,18
0.594,1e-05,503,501,25,100,0.001,1004,18
0.606,1e-05,550,554,25,100,0.001,1104,18
0.632,1e-05,607,597,25,100,0.001,1204,18
0.654,1e-05,658,646,25,100,0.001,1304,18
0.686,1e-05,704,700,25,100,0.001,1404,18
0.734,1e-05,755,749,25,100,0.001,1504,18
0.772,1e-05,804,800,25,100,0.001,1604,18
0.804,1e-05,856,848,25,100,0.001,1704,18
0.81,1e-05,903,901,25,100,0.001,1804,18
0.84,1e-05,958,946,25,100,0.001,1904,18
0.852,1e-05,1002,1002,25,100,0.001,2004,18
0.512,1e-05,54,50,25,100,0.001,104,19
0.516,1e-05,106,98,25,100,0.001,204,19
0.522,1e-05,158,146,25,100,0.001,304,19
0.526,1e-05,202,202,25,100,0.001,404,19
0.51,1e-05,256,248,25,100,0.001,504,19
0.53,1e-05,302,302,25,100,0.001,604,19
0.534,1e-05,351,353,25,100,0.001,704,19
0.546,1e-05,404,400,25,100,0.001,804,19
0.554,1e-05,456,448,25,100,0.001,904,19
0.576,1e-05,508,496,25,100,0.001,1004,19
0.578,1e-05,551,553,25,100,0.001,1104,19
0.588,1e-05,606,598,25,100,0.001,1204,19
0.608,1e-05,660,644,25,100,0.001,1304,19
0.636,1e-05,709,695,25,100,0.001,1404,19
0.66,1e-05,756,748,25,100,0.001,1504,19
0.696,1e-05,805,799,25,100,0.001,1604,19
0.722,1e-05,852,852,25,100,0.001,1704,19
0.76,1e-05,905,899,25,100,0.001,1804,19
0.792,1e-05,960,944,25,100,0.001,1904,19
0.814,1e-05,1004,1000,25,100,0.001,2004,19
0.476,1e-05,59,45,25,100,0.001,104,20
0.486,1e-05,111,93,25,100,0.001,204,20
0.492,1e-05,166,138,25,100,0.001,304,20
0.504,1e-05,216,188,25,100,0.001,404,20
0.524,1e-05,259,245,25,100,0.001,504,20
0.552,1e-05,318,286,25,100,0.001,604,20
0.57,1e-05,372,332,25,100,0.001,704,20
0.594,1e-05,420,384,25,100,0.001,804,20
0.602,1e-05,468,436,25,100,0.001,904,20
0.62,1e-05,530,474,25,100,0.001,1004,20
0.634,1e-05,581,523,25,100,0.001,1104,20
0.646,1e-05,635,569,25,100,0.001,1204,20
0.654,1e-05,678,626,25,100,0.001,1304,20
0.674,1e-05,723,681,25,100,0.001,1404,20
0.704,1e-05,775,729,25,100,0.001,1504,20
0.752,1e-05,824,780,25,100,0.001,1604,20
0.782,1e-05,872,832,25,100,0.001,1704,20
0.816,1e-05,924,880,25,100,0.001,1804,20
0.832,1e-05,973,931,25,100,0.001,1904,20
0.85,1e-05,1016,988,25,100,0.001,2004,20
0.576,1e-05,48,56,25,100,0.01,104,1
0.578,1e-05,102,102,25,100,0.01,204,1
0.594,1e-05,149,155,25,100,0.01,304,1
0.634,1e-05,201,203,25,100,0.01,404,1
0.654,1e-05,246,258,25,100,0.01,504,1
0.686,1e-05,291,313,25,100,0.01,604,1
0.724,1e-05,341,363,25,100,0.01,704,1
0.814,1e-05,395,409,25,100,0.01,804,1
0.858,1e-05,443,461,25,100,0.01,904,1
0.906,1e-05,489,515,25,100,0.01,1004,1
0.918,1e-05,536,568,25,100,0.01,1104,1
0.936,1e-05,591,613,25,100,0.01,1204,1
0.956,1e-05,640,664,25,100,0.01,1304,1
0.954,1e-05,690,714,25,100,0.01,1404,1
0.966,1e-05,741,763,25,100,0.01,1504,1
0.976,1e-05,798,806,25,100,0.01,1604,1
0.982,1e-05,857,847,25,100,0.01,1704,1
0.982,1e-05,909,895,25,100,0.01,1804,1
0.986,1e-05,958,946,25,100,0.01,1904,1
0.992,1e-05,1010,994,25,100,0.01,2004,1
0.498,1e-05,47,57,25,100,0.01,104,2
0.552,1e-05,90,114,25,100,0.01,204,2
0.602,1e-05,146,158,25,100,0.01,304,2
0.638,1e-05,204,200,25,100,0.01,404,2
0.68,1e-05,249,255,25,100,0.01,504,2
0.738,1e-05,298,306,25,100,0.01,604,2
0.786,1e-05,349,355,25,100,0.01,704,2
0.864,1e-05,409,395,25,100,0.01,804,2
0.894,1e-05,454,450,25,100,0.01,904,2
0.93,1e-05,507,497,25,100,0.01,1004,2
0.944,1e-05,555,549,25,100,0.01,1104,2
0.96,1e-05,605,599,25,100,0.01,1204,2
0.968,1e-05,651,653,25,100,0.01,1304,2
0.974,1e-05,699,705,25,100,0.01,1404,2
0.984,1e-05,753,751,25,100,0.01,1504,2
0.978,1e-05,798,806,25,100,0.01,1604,2
0.982,1e-05,840,864,25,100,0.01,1704,2
0.982,1e-05,890,914,25,100,0.01,1804,2
0.986,1e-05,947,957,25,100,0.01,1904,2
0.99,1e-05,999,1005,25,100,0.01,2004,2
0.546,1e-05,43,61,25,100,0.01,104,3
0.562,1e-05,96,108,25,100,0.01,204,3
0.558,1e-05,134,170,25,100,0.01,304,3
0.61,1e-05,187,217,25,100,0.01,404,3
0.68,1e-05,239,265,25,100,0.01,504,3
0.756,1e-05,294,310,25,100,0.01,604,3
0.818,1e-05,351,353,25,100,0.01,704,3
0.868,1e-05,391,413,25,100,0.01,804,3
0.898,1e-05,443,461,25,100,0.01,904,3
0.936,1e-05,500,504,25,100,0.01,1004,3
0.962,1e-05,555,549,25,100,0.01,1104,3
0.948,1e-05,606,598,25,100,0.01,1204,3
0.952,1e-05,659,645,25,100,0.01,1304,3
0.974,1e-05,706,698,25,100,0.01,1404,3
0.976,1e-05,764,740,25,100,0.01,1504,3
0.976,1e-05,819,785,25,100,0.01,1604,3
0.978,1e-05,863,841,25,100,0.01,1704,3
0.988,1e-05,903,901,25,100,0.01,1804,3
0.99,1e-05,955,949,25,100,0.01,1904,3
0.992,1e-05,1003,1001,25,100,0.01,2004,3
0.538,1e-05,52,52,25,100,0.01,104,4
0.626,1e-05,104,100,25,100,0.01,204,4
0.644,1e-05,148,156,25,100,0.01,304,4
0.66,1e-05,195,209,25,100,0.01,404,4
0.694,1e-05,237,267,25,100,0.01,504,4
0.74,1e-05,274,330,25,100,0.01,604,4
0.804,1e-05,329,375,25,100,0.01,704,4
0.884,1e-05,391,413,25,100,0.01,804,4
0.926,1e-05,439,465,25,100,0.01,904,4
0.954,1e-05,480,524,25,100,0.01,1004,4
0.944,1e-05,532,572,25,100,0.01,1104,4
0.946,1e-05,584,620,25,100,0.01,1204,4
0.952,1e-05,630,674,25,100,0.01,1304,4
0.958,1e-05,682,722,25,100,0.01,1404,4
0.968,1e-05,739,765,25,100,0.01,1504,4
0.976,1e-05,793,811,25,100,0.01,1604,4
0.972,1e-05,852,852,25,100,0.01,1704,4
0.96,1e-05,903,901,25,100,0.01,1804,4
0.966,1e-05,959,945,25,100,0.01,1904,4
0.982,1e-05,1002,1002,25,100,0.01,2004,4
0.576,1e-05,55,49,25,100,0.01,104,5
0.618,1e-05,97,107,25,100,0.01,204,5
0.648,1e-05,147,157,25,100,0.01,304,5
0.672,1e-05,202,202,25,100,0.01,404,5
0.694,1e-05,250,254,25,100,0.01,504,5
0.76,1e-05,306,298,25,100,0.01,604,5
0.794,1e-05,348,356,25,100,0.01,704,5
0.846,1e-05,395,409,25,100,0.01,804,5
0.892,1e-05,445,459,25,100,0.01,904,5
0.916,1e-05,492,512,25,100,0.01,1004,5
0.914,1e-05,541,563,25,100,0.01,1104,5
0.942,1e-05,591,613,25,100,0.01,1204,5
0.952,1e-05,646,658,25,100,0.01,1304,5
0.958,1e-05,690,714,25,100,0.01,1404,5
0.964,1e-05,738,766,25,100,0.01,1504,5
0.97,1e-05,790,814,25,100,0.01,1604,5
0.954,1e-05,840,864,25,100,0.01,1704,5
0.968,1e-05,886,918,25,100,0.01,1804,5
0.966,1e-05,939,965,25,100,0.01,1904,5
0.97,1e-05,977,1027,25,100,0.01,2004,5
0.548,1e-05,46,58,25,100,0.01,104,6
0.56,1e-05,95,109,25,100,0.01,204,6
0.588,1e-05,144,160,25,100,0.01,304,6
0.59,1e-05,192,212,25,100,0.01,404,6
0.62,1e-05,244,260,25,100,0.01,504,6
0.674,1e-05,285,319,25,100,0.01,604,6
0.716,1e-05,336,368,25,100,0.01,704,6
0.774,1e-05,380,424,25,100,0.01,804,6
0.812,1e-05,428,476,25,100,0.01,904,6
0.884,1e-05,481,523,25,100,0.01,1004,6
0.912,1e-05,530,574,25,100,0.01,1104,6
0.928,1e-05,581,623,25,100,0.01,1204,6
0.932,1e-05,631,673,25,100,0.01,1304,6
0.952,1e-05,682,722,25,100,0.01,1404,6
0.95,1e-05,733,771,25,100,0.01,1504,6
0.958,1e-05,790,814,25,100,0.01,1604,6
0.964,1e-05,836,868,25,100,0.01,1704,6
0.97,1e-05,889,915,25,100,0.01,1804,6
0.972,1e-05,935,969,25,100,0.01,1904,6
0.978,1e-05,993,1011,25,100,0.01,2004,6
0.5,1e-05,53,51,25,100,0.01,104,7
0.6,1e-05,103,101,25,100,0.01,204,7
0.62,1e-05,158,146,25,100,0.01,304,7
0.606,1e-05,214,190,25,100,0.01,404,7
0.62,1e-05,268,236,25,100,0.01,504,7
0.674,1e-05,315,289,25,100,0.01,604,7
0.75,1e-05,369,335,25,100,0.01,704,7
0.836,1e-05,426,378,25,100,0.01,804,7
0.86,1e-05,471,433,25,100,0.01,904,7
0.902,1e-05,515,489,25,100,0.01,1004,7
0.938,1e-05,570,534,25,100,0.01,1104,7
0.962,1e-05,618,586,25,100,0.01,1204,7
0.962,1e-05,670,634,25,100,0.01,1304,7
0.97,1e-05,722,682,25,100,0.01,1404,7
0.976,1e-05,772,732,25,100,0.01,1504,7
0.974,1e-05,827,777,25,100,0.01,1604,7
0.978,1e-05,873,831,25,100,0.01,1704,7
0.982,1e-05,925,879,25,100,0.01,1804,7
0.982,1e-05,976,928,25,100,0.01,1904,7
0.984,1e-05,1025,979,25,100,0.01,2004,7
0.58,1e-05,49,55,25,100,0.01,104,8
0.57,1e-05,102,102,25,100,0.01,204,8
0.568,1e-05,158,146,25,100,0.01,304,8
0.648,1e-05,201,203,25,100,0.01,404,8
0.696,1e-05,250,254,25,100,0.01,504,8
0.772,1e-05,298,306,25,100,0.01,604,8
0.824,1e-05,345,359,25,100,0.01,704,8
0.87,1e-05,400,404,25,100,0.01,804,8
0.906,1e-05,441,463,25,100,0.01,904,8
0.938,1e-05,498,506,25,100,0.01,1004,8
0.956,1e-05,541,563,25,100,0.01,1104,8
0.962,1e-05,593,611,25,100,0.01,1204,8
0.976,1e-05,648,656,25,100,0.01,1304,8
0.986,1e-05,691,713,25,100,0.01,1404,8
0.986,1e-05,741,763,25,100,0.01,1504,8
0.992,1e-05,793,811,25,100,0.01,1604,8
0.992,1e-05,842,862,25,100,0.01,1704,8
0.99,1e-05,893,911,25,100,0.01,1804,8
0.994,1e-05,938,966,25,100,0.01,1904,8
0.996,1e-05,988,1016,25,100,0.01,2004,8
0.514,1e-05,49,55,25,100,0.01,104,9
0.554,1e-05,105,99,25,100,0.01,204,9
0.594,1e-05,155,149,25,100,0.01,304,9
0.63,1e-05,208,196,25,100,0.01,404,9
0.656,1e-05,257,247,25,100,0.01,504,9
0.754,1e-05,303,301,25,100,0.01,604,9
0.824,1e-05,352,352,25,100,0.01,704,9
0.89,1e-05,402,402,25,100,0.01,804,9
0.888,1e-05,445,459,25,100,0.01,904,9
0.936,1e-05,489,515,25,100,0.01,1004,9
0.95,1e-05,536,568,25,100,0.01,1104,9
0.956,1e-05,587,617,25,100,0.01,1204,9
0.956,1e-05,632,672,25,100,0.01,1304,9
0.964,1e-05,685,719,25,100,0.01,1404,9
0.968,1e-05,744,760,25,100,0.01,1504,9
0.976,1e-05,791,813,25,100,0.01,1604,9
0.974,1e-05,837,867,25,100,0.01,1704,9
0.982,1e-05,889,915,25,100,0.01,1804,9
0.984,1e-05,941,963,25,100,0.01,1904,9
0.986,1e-05,994,1010,25,100,0.01,2004,9
0.63,1e-05,46,58,25,100,0.01,104,10
0.66,1e-05,100,104,25,100,0.01,204,10
0.646,1e-05,142,162,25,100,0.01,304,10
0.686,1e-05,194,210,25,100,0.01,404,10
0.734,1e-05,240,264,25,100,0.01,504,10
0.768,1e-05,293,311,25,100,0.01,604,10
0.812,1e-05,339,365,25,100,0.01,704,10
0.88,1e-05,390,414,25,100,0.01,804,10
0.914,1e-05,437,467,25,100,0.01,904,10
0.934,1e-05,483,521,25,100,0.01,1004,10
0.94,1e-05,539,565,25,100,0.01,1104,10
0.95,1e-05,595,609,25,100,0.01,1204,10
0.958,1e-05,646,658,25,100,0.01,1304,10
0.958,1e-05,700,704,25,100,0.01,1404,10
0.964,1e-05,764,740,25,100,0.01,1504,10
0.976,1e-05,809,795,25,100,0.01,1604,10
0.978,1e-05,859,845,25,100,0.01,1704,10
0.976,1e-05,918,886,25,100,0.01,1804,10
0.978,1e-05,967,937,25,100,0.01,1904,10
0.98,1e-05,1015,989,25,100,0.01,2004,10
0.538,1e-05,54,50,25,100,0.01,104,11
0.56,1e-05,107,97,25,100,0.01,204,11
0.58,1e-05,162,142,25,100,0.01,304,11
0.576,1e-05,215,189,25,100,0.01,404,11
0.612,1e-05,265,239,25,100,0.01,504,11
0.668,1e-05,317,287,25,100,0.01,604,11
0.728,1e-05,361,343,25,100,0.01,704,11
0.81,1e-05,413,391,25,100,0.01,804,11
0.858,1e-05,470,434,25,100,0.01,904,11
0.902,1e-05,510,494,25,100,0.01,1004,11
0.936,1e-05,559,545,25,100,0.01,1104,11
0.942,1e-05,606,598,25,100,0.01,1204,11
0.95,1e-05,646,658,25,100,0.01,1304,11
0.974,1e-05,699,705,25,100,0.01,1404,11
0.982,1e-05,750,754,25,100,0.01,1504,11
0.986,1e-05,802,802,25,100,0.01,1604,11
0.992,1e-05,850,854,25,100,0.01,1704,11
0.99,1e-05,911,893,25,100,0.01,1804,11
0.992,1e-05,968,936,25,100,0.01,1904,11
0.996,1e-05,1022,982,25,100,0.01,2004,11
0.524,1e-05,53,51,25,100,0.01,104,12
0.556,1e-05,95,109,25,100,0.01,204,12
0.564,1e-05,149,155,25,100,0.01,304,12
0.61,1e-05,193,211,25,100,0.01,404,12
0.632,1e-05,239,265,25,100,0.01,504,12
0.732,1e-05,296,308,25,100,0.01,604,12
0.838,1e-05,345,359,25,100,0.01,704,12
0.89,1e-05,392,412,25,100,0.01,804,12
0.886,1e-05,453,451,25,100,0.01,904,12
0.912,1e-05,505,499,25,100,0.01,1004,12
0.916,1e-05,560,544,25,100,0.01,1104,12
0.958,1e-05,612,592,25,100,0.01,1204,12
0.964,1e-05,667,637,25,100,0.01,1304,12
0.972,1e-05,710,694,25,100,0.01,1404,12
0.972,1e-05,757,747,25,100,0.01,1504,12
0.98,1e-05,805,799,25,100,0.01,1604,12
0.984,1e-05,855,849,25,100,0.01,1704,12
0.982,1e-05,902,902,25,100,0.01,1804,12
0.986,1e-05,963,941,25,100,0.01,1904,12
0.992,1e-05,1008,996,25,100,0.01,2004,12
0.52,1e-05,52,52,25,100,0.01,104,13
0.56,1e-05,104,100,25,100,0.01,204,13
0.556,1e-05,161,143,25,100,0.01,304,13
0.574,1e-05,215,189,25,100,0.01,404,13
0.638,1e-05,269,235,25,100,0.01,504,13
0.746,1e-05,327,277,25,100,0.01,604,13
0.782,1e-05,370,334,25,100,0.01,704,13
0.824,1e-05,423,381,25,100,0.01,804,13
0.856,1e-05,473,431,25,100,0.01,904,13
0.93,1e-05,521,483,25,100,0.01,1004,13
0.924,1e-05,563,541,25,100,0.01,1104,13
0.952,1e-05,607,597,25,100,0.01,1204,13
0.958,1e-05,660,644,25,100,0.01,1304,13
0.962,1e-05,714,690,25,100,0.01,1404,13
0.972,1e-05,770,734,25,100,0.01,1504,13
0.978,1e-05,815,789,25,100,0.01,1604,13
0.982,1e-05,862,842,25,100,0.01,1704,13
0.99,1e-05,907,897,25,100,0.01,1804,13
0.99,1e-05,953,951,25,100,0.01,1904,13
0.99,1e-05,1010,994,25,100,0.01,2004,13
0.516,1e-05,59,45,25,100,0.01,104,14
0.546,1e-05,108,96,25,100,0.01,204,14
0.58,1e-05,159,145,25,100,0.01,304,14
0.614,1e-05,215,189,25,100,0.01,404,14
0.64,1e-05,269,235,25,100,0.01,504,14
0.676,1e-05,311,293,25,100,0.01,604,14
0.73,1e-05,359,345,25,100,0.01,704,14
0.82,1e-05,405,399,25,100,0.01,804,14
0.858,1e-05,452,452,25,100,0.01,904,14
0.91,1e-05,496,508,25,100,0.01,1004,14
0.93,1e-05,547,557,25,100,0.01,1104,14
0.956,1e-05,605,599,25,100,0.01,1204,14
0.958,1e-05,657,647,25,100,0.01,1304,14
0.966,1e-05,712,692,25,100,0.01,1404,14
0.97,1e-05,752,752,25,100,0.01,1504,14
0.974,1e-05,790,814,25,100,0.01,1604,14
0.978,1e-05,842,862,25,100,0.01,1704,14
0.984,1e-05,887,917,25,100,0.01,1804,14
0.99,1e-05,936,968,25,100,0.01,1904,14
0.984,1e-05,986,1018,25,100,0.01,2004,14
0.584,1e-05,56,48,25,100,0.01,104,15
0.624,1e-05,113,91,25,100,0.01,204,15
0.644,1e-05,165,139,25,100,0.01,304,15
0.66,1e-05,209,195,25,100,0.01,404,15
0.692,1e-05,259,245,25,100,0.01,504,15
0.744,1e-05,312,292,25,100,0.01,604,15
0.766,1e-05,364,340,25,100,0.01,704,15
0.836,1e-05,416,388,25,100,0.01,804,15
0.898,1e-05,469,435,25,100,0.01,904,15
0.958,1e-05,516,488,25,100,0.01,1004,15
0.95,1e-05,561,543,25,100,0.01,1104,15
0.962,1e-05,616,588,25,100,0.01,1204,15
0.97,1e-05,670,634,25,100,0.01,1304,15
0.978,1e-05,714,690,25,100,0.01,1404,15
0.976,1e-05,757,747,25,100,0.01,1504,15
0.986,1e-05,811,793,25,100,0.01,1604,15
0.988,1e-05,860,844,25,100,0.01,1704,15
0.992,1e-05,908,896,25,100,0.01,1804,15
0.992,1e-05,963,941,25,100,0.01,1904,15
0.994,1e-05,1010,994,25,100,0.01,2004,15
0.598,1e-05,54,50,25,100,0.01,104,16
0.574,1e-05,99,105,25,100,0.01,204,16
0.536,1e-05,150,154,25,100,0.01,304,16
0.596,1e-05,192,212,25,100,0.01,404,16
0.652,1e-05,247,257,25,100,0.01,504,16
0.73,1e-05,290,314,25,100,0.01,604,16
0.792,1e-05,340,364,25,100,0.01,704,16
0.836,1e-05,394,410,25,100,0.01,804,16
0.864,1e-05,450,454,25,100,0.01,904,16
0.938,1e-05,502,502,25,100,0.01,1004,16
0.966,1e-05,545,559,25,100,0.01,1104,16
0.968,1e-05,602,602,25,100,0.01,1204,16
0.972,1e-05,653,651,25,100,0.01,1304,16
0.978,1e-05,691,713,25,100,0.01,1404,16
0.978,1e-05,745,759,25,100,0.01,1504,16
0.984,1e-05,789,815,25,100,0.01,1604,16
0.986,1e-05,827,877,25,100,0.01,1704,16
0.984,1e-05,881,923,25,100,0.01,1804,16
0.988,1e-05,931,973,25,100,0.01,1904,16
0.988,1e-05,986,1018,25,100,0.01,2004,16
0.574,1e-05,51,53,25,100,0.01,104,17
0.596,1e-05,108,96,25,100,0.01,204,17
0.606,1e-05,158,146,25,100,0.01,304,17
0.626,1e-05,212,192,25,100,0.01,404,17
0.644,1e-05,268,236,25,100,0.01,504,17
0.692,1e-05,318,286,25,100,0.01,604,17
0.738,1e-05,370,334,25,100,0.01,704,17
0.81,1e-05,423,381,25,100,0.01,804,17
0.864,1e-05,463,441,25,100,0.01,904,17
0.902,1e-05,522,482,25,100,0.01,1004,17
0.918,1e-05,574,530,25,100,0.01,1104,17
0.968,1e-05,631,573,25,100,0.01,1204,17
0.976,1e-05,680,624,25,100,0.01,1304,17
0.976,1e-05,731,673,25,100,0.01,1404,17
0.982,1e-05,767,737,25,100,0.01,1504,17
0.99,1e-05,810,794,25,100,0.01,1604,17
0.992,1e-05,854,850,25,100,0.01,1704,17
0.992,1e-05,902,902,25,100,0.01,1804,17
0.992,1e-05,952,952,25,100,0.01,1904,17
0.994,1e-05,1005,999,25,100,0.01,2004,17
0.514,1e-05,50,54,25,100,0.01,104,18
0.544,1e-05,105,99,25,100,0.01,204,18
0.59,1e-05,153,151,25,100,0.01,304,18
0.636,1e-05,205,199,25,100,0.01,404,18
0.642,1e-05,262,242,25,100,0.01,504,18
0.722,1e-05,310,294,25,100,0.01,604,18
0.782,1e-05,363,341,25,100,0.01,704,18
0.86,1e-05,419,385,25,100,0.01,804,18
0.888,1e-05,464,440,25,100,0.01,904,18
0.916,1e-05,509,495,25,100,0.01,1004,18
0.948,1e-05,559,545,25,100,0.01,1104,18
0.962,1e-05,616,588,25,100,0.01,1204,18
0.968,1e-05,670,634,25,100,0.01,1304,18
0.982,1e-05,716,688,25,100,0.01,1404,18
0.978,1e-05,766,738,25,100,0.01,1504,18
0.986,1e-05,821,783,25,100,0.01,1604,18
0.988,1e-05,877,827,25,100,0.01,1704,18
0.992,1e-05,926,878,25,100,0.01,1804,18
0.99,1e-05,965,939,25,100,0.01,1904,18
0.992,1e-05,1014,990,25,100,0.01,2004,18
0.506,1e-05,61,43,25,100,0.01,104,19
0.578,1e-05,106,98,25,100,0.01,204,19
0.614,1e-05,160,144,25,100,0.01,304,19
0.672,1e-05,206,198,25,100,0.01,404,19
0.68,1e-05,258,246,25,100,0.01,504,19
0.754,1e-05,312,292,25,100,0.01,604,19
0.79,1e-05,353,351,25,100,0.01,704,19
0.834,1e-05,408,396,25,100,0.01,804,19
0.882,1e-05,457,447,25,100,0.01,904,19
0.934,1e-05,503,501,25,100,0.01,1004,19
0.954,1e-05,550,554,25,100,0.01,1104,19
0.976,1e-05,604,600,25,100,0.01,1204,19
0.976,1e-05,659,645,25,100,0.01,1304,19
0.988,1e-05,704,700,25,100,0.01,1404,19
0.99,1e-05,751,753,25,100,0.01,1504,19
0.986,1e-05,795,809,25,100,0.01,1604,19
0.99,1e-05,849,855,25,100,0.01,1704,19
0.996,1e-05,904,900,25,100,0.01,1804,19
0.998,1e-05,953,951,25,100,0.01,1904,19
0.998,1e-05,996,1008,25,100,0.01,2004,19
0.594,1e-05,52,52,25,100,0.01,104,20
0.598,1e-05,100,104,25,100,0.01,204,20
0.57,1e-05,150,154,25,100,0.01,304,20
0.6,1e-05,200,204,25,100,0.01,404,20
0.634,1e-05,250,254,25,100,0.01,504,20
0.696,1e-05,309,295,25,100,0.01,604,20
0.746,1e-05,364,340,25,100,0.01,704,20
0.788,1e-05,421,383,25,100,0.01,804,20
0.836,1e-05,477,427,25,100,0.01,904,20
0.916,1e-05,527,477,25,100,0.01,1004,20
0.93,1e-05,578,526,25,100,0.01,1104,20
0.956,1e-05,629,575,25,100,0.01,1204,20
0.96,1e-05,677,627,25,100,0.01,1304,20
0.968,1e-05,729,675,25,100,0.01,1404,20
0.97,1e-05,777,727,25,100,0.01,1504,20
0.978,1e-05,825,779,25,100,0.01,1604,20
0.972,1e-05,865,839,25,100,0.01,1704,20
0.976,1e-05,918,886,25,100,0.01,1804,20
0.982,1e-05,959,945,25,100,0.01,1904,20
0.978,1e-05,1007,997,25,100,0.01,2004,20
0.526,0.0001,49,55,25,100,0.0001,104,1
0.526,0.0001,102,102,25,100,0.0001,204,1
0.526,0.0001,154,150,25,100,0.0001,304,1
0.526,0.0001,209,195,25,100,0.0001,404,1
0.524,0.0001,255,249,25,100,0.0001,504,1
0.524,0.0001,296,308,25,100,0.0001,604,1
0.52,0.0001,341,363,25,100,0.0001,704,1
0.522,0.0001,395,409,25,100,0.0001,804,1
0.524,0.0001,442,462,25,100,0.0001,904,1
0.534,0.0001,486,518,25,100,0.0001,1004,1
0.532,0.0001,538,566,25,100,0.0001,1104,1
0.532,0.0001,590,614,25,100,0.0001,1204,1
0.532,0.0001,642,662,25,100,0.0001,1304,1
0.534,0.0001,692,712,25,100,0.0001,1404,1
0.536,0.0001,742,762,25,100,0.0001,1504,1
0.536,0.0001,788,816,25,100,0.0001,1604,1
0.54,0.0001,833,871,25,100,0.0001,1704,1
0.538,0.0001,887,917,25,100,0.0001,1804,1
0.532,0.0001,953,951,25,100,0.0001,1904,1
0.532,0.0001,996,1008,25,100,0.0001,2004,1
0.452,0.0001,62,42,25,100,0.0001,104,2
0.456,0.0001,113,91,25,100,0.0001,204,2
0.458,0.0001,160,144,25,100,0.0001,304,2
0.458,0.0001,204,200,25,100,0.0001,404,2
0.458,0.0001,258,246,25,100,0.0001,504,2
0.456,0.0001,312,292,25,100,0.0001,604,2
0.466,0.0001,356,348,25,100,0.0001,704,2
0.464,0.0001,408,396,25,100,0.0001,804,2
0.468,0.0001,461,443,25,100,0.0001,904,2
0.47,0.0001,515,489,25,100,0.0001,1004,2
0.48,0.0001,562,542,25,100,0.0001,1104,2
0.482,0.0001,609,595,25,100,0.0001,1204,2
0.49,0.0001,661,643,25,100,0.0001,1304,2
0.494,0.0001,708,696,25,100,0.0001,1404,2
0.504,0.0001,760,744,25,100,0.0001,1504,2
0.506,0.0001,810,794,25,100,0.0001,1604,2
0.512,0.0001,857,847,25,100,0.0001,1704,2
0.514,0.0001,907,897,25,100,0.0001,1804,2
0.52,0.0001,958,946,25,100,0.0001,1904,2
0.522,0.0001,1008,996,25,100,0.0001,2004,2
0.48,0.0001,52,52,25,100,0.0001,104,3
0.478,0.0001,97,107,25,100,0.0001,204,3
0.476,0.0001,144,160,25,100,0.0001,304,3
0.478,0.0001,196,208,25,100,0.0001,404,3
0.478,0.0001,247,257,25,100,0.0001,504,3
0.478,0.0001,302,302,25,100,0.0001,604,3
0.48,0.0001,354,350,25,100,0.0001,704,3
0.478,0.0001,401,403,25,100,0.0001,804,3
0.478,0.0001,443,461,25,100,0.0001,904,3
0.48,0.0001,493,511,25,100,0.0001,1004,3
0.48,0.0001,548,556,25,100,0.0001,1104,3
0.482,0.0001,602,602,25,100,0.0001,1204,3
0.48,0.0001,662,642,25,100,0.0001,1304,3
0.486,0.0001,713,691,25,100,0.0001,1404,3
0.488,0.0001,758,746,25,100,0.0001,1504,3
0.49,0.0001,806,798,25,100,0.0001,1604,3
0.496,0.0001,867,837,25,100,0.0001,1704,3
0.496,0.0001,917,887,25,100,0.0001,1804,3
0.502,0.0001,959,945,25,100,0.0001,1904,3
0.51,0.0001,1008,996,25,100,0.0001,2004,3
0.452,0.0001,47,57,25,100,0.0001,104,4
0.452,0.0001,102,102,25,100,0.0001,204,4
0.452,0.0001,149,155,25,100,0.0001,304,4
0.452,0.0001,199,205,25,100,0.0001,404,4
0.452,0.0001,251,253,25,100,0.0001,504,4
0.454,0.0001,313,291,25,100,0.0001,604,4
0.454,0.0001,363,341,25,100,0.0001,704,4
0.452,0.0001,409,395,25,100,0.0001,804,4
0.452,0.0001,451,453,25,100,0.0001,904,4
0.46,0.0001,507,497,25,100,0.0001,1004,4
0.462,0.0001,546,558,25,100,0.0001,1104,4
0.464,0.0001,605,599,25,100,0.0001,1204,4
0.462,0.0001,660,644,25,100,0.0001,1304,4
0.462,0.0001,711,693,25,100,0.0001,1404,4
0.464,0.0001,762,742,25,100,0.0001,1504,4
0.472,0.0001,807,797,25,100,0.0001,1604,4
0.472,0.0001,860,844,25,100,0.0001,1704,4
0.474,0.0001,907,897,25,100,0.0001,1804,4
0.48,0.0001,954,950,25,100,0.0001,1904,4
0.482,0.0001,1006,998,25,100,0.0001,2004,4
0.496,0.0001,60,44,25,100,0.0001,104,5
0.496,0.0001,110,94,25,100,0.0001,204,5
0.494,0.0001,152,152,25,100,0.0001,304,5
0.494,0.0001,207,197,25,100,0.0001,404,5
0.494,0.0001,256,248,25,100,0.0001,504,5
0.494,0.0001,305,299,25,100,0.0001,604,5
0.496,0.0001,357,347,25,100,0.0001,704,5
0.498,0.0001,402,402,25,100,0.0001,804,5
0.496,0.0001,446,458,25,100,0.0001,904,5
0.498,0.0001,493,511,25,100,0.0001,1004,5
0.496,0.0001,547,557,25,100,0.0001,1104,5
0.498,0.0001,594,610,25,100,0.0001,1204,5
0.498,0.0001,644,660,25,100,0.0001,1304,5
0.502,0.0001,698,706,25,100,0.0001,1404,5
0.506,0.0001,753,751,25,100,0.0001,1504,5
0.51,0.0001,799,805,25,100,0.0001,1604,5
0.508,0.0001,847,857,25,100,0.0001,1704,5
0.51,0.0001,903,901,25,100,0.0001,1804,5
0.512,0.0001,955,949,25,100,0.0001,1904,5
0.508,0.0001,1002,1002,25,100,0.0001,2004,5
0.464,0.0001,54,50,25,100,0.0001,104,6
0.464,0.0001,104,100,25,100,0.0001,204,6
0.464,0.0001,156,148,25,100,0.0001,304,6
0.464,0.0001,208,196,25,100,0.0001,404,6
0.466,0.0001,254,250,25,100,0.0001,504,6
0.472,0.0001,299,305,25,100,0.0001,604,6
0.472,0.0001,350,354,25,100,0.0001,704,6
0.474,0.0001,405,399,25,100,0.0001,804,6
0.474,0.0001,462,442,25,100,0.0001,904,6
0.476,0.0001,514,490,25,100,0.0001,1004,6
0.472,0.0001,565,539,25,100,0.0001,1104,6
0.468,0.0001,618,586,25,100,0.0001,1204,6
0.466,0.0001,657,647,25,100,0.0001,1304,6
0.466,0.0001,710,694,25,100,0.0001,1404,6
0.466,0.0001,756,748,25,100,0.0001,1504,6
0.472,0.0001,808,796,25,100,0.0001,1604,6
0.476,0.0001,858,846,25,100,0.0001,1704,6
0.476,0.0001,897,907,25,100,0.0001,1804,6
0.48,0.0001,942,962,25,100,0.0001,1904,6
0.484,0.0001,986,1018,25,100,0.0001,2004,6
0.532,0.0001,58,46,25,100,0.0001,104,7
0.532,0.0001,105,99,25,100,0.0001,204,7
0.53,0.0001,166,138,25,100,0.0001,304,7
0.528,0.0001,216,188,25,100,0.0001,404,7
0.526,0.0001,261,243,25,100,0.0001,504,7
0.526,0.0001,312,292,25,100,0.0001,604,7
0.526,0.0001,361,343,25,100,0.0001,704,7
0.528,0.0001,410,394,25,100,0.0001,804,7
0.53,0.0001,469,435,25,100,0.0001,904,7
0.528,0.0001,520,484,25,100,0.0001,1004,7
0.528,0.0001,563,541,25,100,0.0001,1104,7
0.53,0.0001,621,583,25,100,0.0001,1204,7
0.53,0.0001,672,632,25,100,0.0001,1304,7
0.536,0.0001,718,686,25,100,0.0001,1404,7
0.532,0.0001,768,736,25,100,0.0001,1504,7
0.528,0.0001,812,792,25,100,0.0001,1604,7
0.534,0.0001,861,843,25,100,0.0001,1704,7
0.534,0.0001,911,893,25,100,0.0001,1804,7
0.53,0.0001,959,945,25,100,0.0001,1904,7
0.538,0.0001,1006,998,25,100,0.0001,2004,7
0.5,0.0001,66,38,25,100,0.0001,104,8
0.498,0.0001,111,93,25,100,0.0001,204,8
0.498,0.0001,153,151,25,100,0.0001,304,8
0.496,0.0001,208,196,25,100,0.0001,404,8
0.5,0.0001,260,244,25,100,0.0001,504,8
0.498,0.0001,303,301,25,100,0.0001,604,8
0.498,0.0001,355,349,25,100,0.0001,704,8
0.498,0.0001,404,400,25,100,0.0001,804,8
0.506,0.0001,451,453,25,100,0.0001,904,8
0.506,0.0001,495,509,25,100,0.0001,1004,8
0.506,0.0001,540,564,25,100,0.0001,1104,8
0.51,0.0001,594,610,25,100,0.0001,1204,8
0.516,0.0001,657,647,25,100,0.0001,1304,8
0.52,0.0001,712,692,25,100,0.0001,1404,8
0.52,0.0001,762,742,25,100,0.0001,1504,8
0.526,0.0001,815,789,25,100,0.0001,1604,8
0.53,0.0001,862,842,25,100,0.0001,1704,8
0.536,0.0001,909,895,25,100,0.0001,1804,8
0.538,0.0001,966,938,25,100,0.0001,1904,8
0.544,0.0001,1013,991,25,100,0.0001,2004,8
0.494,0.0001,40,64,25,100,0.0001,104,9
0.492,0.0001,92,112,25,100,0.0001,204,9
0.496,0.0001,145,159,25,100,0.0001,304,9
0.498,0.0001,202,202,25,100,0.0001,404,9
0.5,0.0001,251,253,25,100,0.0001,504,9
0.504,0.0001,293,311,25,100,0.0001,604,9
0.508,0.0001,344,360,25,100,0.0001,704,9
0.504,0.0001,392,412,25,100,0.0001,804,9
0.5,0.0001,453,451,25,100,0.0001,904,9
0.502,0.0001,508,496,25,100,0.0001,1004,9
0.506,0.0001,548,556,25,100,0.0001,1104,9
0.504,0.0001,586,618,25,100,0.0001,1204,9
0.508,0.0001,644,660,25,100,0.0001,1304,9
0.506,0.0001,701,703,25,100,0.0001,1404,9
0.512,0.0001,752,752,25,100,0.0001,1504,9
0.508,0.0001,801,803,25,100,0.0001,1604,9
0.506,0.0001,848,856,25,100,0.0001,1704,9
0.508,0.0001,898,906,25,100,0.0001,1804,9
0.504,0.0001,940,964,25,100,0.0001,1904,9
0.504,0.0001,999,1005,25,100,0.0001,2004,9
0.504,0.0001,51,53,25,100,0.0001,104,10
0.504,0.0001,103,101,25,100,0.0001,204,10
0.504,0.0001,148,156,25,100,0.0001,304,10
0.504,0.0001,196,208,25,100,0.0001,404,10
0.51,0.0001,244,260,25,100,0.0001,504,10
0.52,0.0001,292,312,25,100,0.0001,604,10
0.52,0.0001,336,368,25,100,0.0001,704,10
0.518,0.0001,380,424,25,100,0.0001,804,10
0.522,0.0001,432,472,25,100,0.0001,904,10
0.514,0.0001,491,513,25,100,0.0001,1004,10
0.514,0.0001,539,565,25,100,0.0001,1104,10
0.51,0.0001,584,620,25,100,0.0001,1204,10
0.522,0.0001,635,669,25,100,0.0001,1304,10
0.528,0.0001,676,728,25,100,0.0001,1404,10
0.532,0.0001,720,784,25,100,0.0001,1504,10
0.536,0.0001,772,832,25,100,0.0001,1604,10
0.544,0.0001,825,879,25,100,0.0001,1704,10
0.544,0.0001,880,924,25,100,0.0001,1804,10
0.542,0.0001,935,969,25,100,0.0001,1904,10
0.548,0.0001,989,1015,25,100,0.0001,2004,10
0.506,0.0001,53,51,25,100,0.0001,104,11
0.506,0.0001,104,100,25,100,0.0001,204,11
0.506,0.0001,145,159,25,100,0.0001,304,11
0.506,0.0001,194,210,25,100,0.0001,404,11
0.506,0.0001,244,260,25,100,0.0001,504,11
0.504,0.0001,292,312,25,100,0.0001,604,11
0.504,0.0001,346,358,25,100,0.0001,704,11
0.504,0.0001,396,408,25,100,0.0001,804,11
0.5,0.0001,439,465,25,100,0.0001,904,11
0.502,0.0001,496,508,25,100,0.0001,1004,11
0.506,0.0001,540,564,25,100,0.0001,1104,11
0.5,0.0001,591,613,25,100,0.0001,1204,11
0.502,0.0001,636,668,25,100,0.0001,1304,11
0.5,0.0001,684,720,25,100,0.0001,1404,11
0.502,0.0001,731,773,25,100,0.0001,1504,11
0.516,0.0001,788,816,25,100,0.0001,1604,11
0.52,0.0001,838,866,25,100,0.0001,1704,11
0.528,0.0001,895,909,25,100,0.0001,1804,11
0.532,0.0001,943,961,25,100,0.0001,1904,11
0.54,0.0001,988,1016,25,100,0.0001,2004,11
0.484,0.0001,52,52,25,100,0.0001,104,12
0.488,0.0001,110,94,25,100,0.0001,204,12
0.488,0.0001,161,143,25,100,0.0001,304,12
0.488,0.0001,215,189,25,100,0.0001,404,12
0.49,0.0001,259,245,25,100,0.0001,504,12
0.492,0.0001,312,292,25,100,0.0001,604,12
0.492,0.0001,353,351,25,100,0.0001,704,12
0.494,0.0001,401,403,25,100,0.0001,804,12
0.492,0.0001,453,451,25,100,0.0001,904,12
0.492,0.0001,504,500,25,100,0.0001,1004,12
0.496,0.0001,553,551,25,100,0.0001,1104,12
0.496,0.0001,605,599,25,100,0.0001,1204,12
0.498,0.0001,653,651,25,100,0.0001,1304,12
0.5,0.0001,698,706,25,100,0.0001,1404,12
0.502,0.0001,751,753,25,100,0.0001,1504,12
0.508,0.0001,802,802,25,100,0.0001,1604,12
0.508,0.0001,847,857,25,100,0.0001,1704,12
0.508,0.0001,889,915,25,100,0.0001,1804,12
0.51,0.0001,950,954,25,100,0.0001,1904,12
0.516,0.0001,1004,1000,25,100,0.0001,2004,12
0.522,0.0001,52,52,25,100,0.0001,104,13
0.528,0.0001,103,101,25,100,0.0001,204,13
0.528,0.0001,152,152,25,100,0.0001,304,13
0.53,0.0001,205,199,25,100,0.0001,404,13
0.526,0.0001,255,249,25,100,0.0001,504,13
0.524,0.0001,299,305,25,100,0.0001,604,13
0.534,0.0001,347,357,25,100,0.0001,704,13
0.54,0.0001,397,407,25,100,0.0001,804,13
0.544,0.0001,453,451,25,100,0.0001,904,13
0.546,0.0001,510,494,25,100,0.0001,1004,13
0.548,0.0001,560,544,25,100,0.0001,1104,13
0.548,0.0001,615,589,25,100,0.0001,1204,13
0.552,0.0001,657,647,25,100,0.0001,1304,13
0.556,0.0001,709,695,25,100,0.0001,1404,13
0.558,0.0001,757,747,25,100,0.0001,1504,13
0.558,0.0001,813,791,25,100,0.0001,1604,13
0.56,0.0001,858,846,25,100,0.0001,1704,13
0.564,0.0001,903,901,25,100,0.0001,1804,13
0.562,0.0001,954,950,25,100,0.0001,1904,13
0.566,0.0001,1002,1002,25,100,0.0001,2004,13
0.52,0.0001,58,46,25,100,0.0001,104,14
0.518,0.0001,109,95,25,100,0.0001,204,14
0.522,0.0001,163,141,25,100,0.0001,304,14
0.522,0.0001,213,191,25,100,0.0001,404,14
0.524,0.0001,261,243,25,100,0.0001,504,14
0.526,0.0001,308,296,25,100,0.0001,604,14
0.528,0.0001,352,352,25,100,0.0001,704,14
0.528,0.0001,410,394,25,100,0.0001,804,14
0.528,0.0001,457,447,25,100,0.0001,904,14
0.528,0.0001,515,489,25,100,0.0001,1004,14
0.528,0.0001,561,543,25,100,0.0001,1104,14
0.528,0.0001,612,592,25,100,0.0001,1204,14
0.526,0.0001,659,645,25,100,0.0001,1304,14
0.528,0.0001,708,696,25,100,0.0001,1404,14
0.53,0.0001,755,749,25,100,0.0001,1504,14
0.528,0.0001,802,802,25,100,0.0001,1604,14
0.526,0.0001,856,848,25,100,0.0001,1704,14
0.526,0.0001,906,898,25,100,0.0001,1804,14
0.534,0.0001,962,942,25,100,0.0001,1904,14
0.532,0.0001,1013,991,25,100,0.0001,2004,14
0.514,0.0001,51,53,25,100,0.0001,104,15
0.516,0.0001,96,108,25,100,0.0001,204,15
0.52,0.0001,145,159,25,100,0.0001,304,15
0.518,0.0001,191,213,25,100,0.0001,404,15
0.518,0.0001,242,262,25,100,0.0001,504,15
0.518,0.0001,287,317,25,100,0.0001,604,15
0.516,0.0001,342,362,25,100,0.0001,704,15
0.518,0.0001,390,414,25,100,0.0001,804,15
0.522,0.0001,441,463,25,100,0.0001,904,15
0.516,0.0001,497,507,25,100,0.0001,1004,15
0.516,0.0001,557,547,25,100,0.0001,1104,15
0.516,0.0001,604,600,25,100,0.0001,1204,15
0.52,0.0001,652,652,25,100,0.0001,1304,15
0.526,0.0001,711,693,25,100,0.0001,1404,15
0.526,0.0001,756,748,25,100,0.0001,1504,15
0.526,0.0001,798,806,25,100,0.0001,1604,15
0.528,0.0001,848,856,25,100,0.0001,1704,15
0.534,0.0001,906,898,25,100,0.0001,1804,15
0.54,0.0001,952,952,25,100,0.0001,1904,15
0.544,0.0001,1003,1001,25,100,0.0001,2004,15
0.492,0.0001,47,57,25,100,0.0001,104,16
0.492,0.0001,93,111,25,100,0.0001,204,16
0.492,0.0001,133,171,25,100,0.0001,304,16
0.498,0.0001,185,219,25,100,0.0001,404,16
0.5,0.0001,236,268,25,100,0.0001,504,16
0.496,0.0001,282,322,25,100,0.0001,604,16
0.498,0.0001,334,370,25,100,0.0001,704,16
0.498,0.0001,381,423,25,100,0.0001,804,16
0.498,0.0001,427,477,25,100,0.0001,904,16
0.5,0.0001,483,521,25,100,0.0001,1004,16
0.498,0.0001,533,571,25,100,0.0001,1104,16
0.504,0.0001,585,619,25,100,0.0001,1204,16
0.506,0.0001,627,677,25,100,0.0001,1304,16
0.508,0.0001,681,723,25,100,0.0001,1404,16
0.506,0.0001,737,767,25,100,0.0001,1504,16
0.506,0.0001,788,816,25,100,0.0001,1604,16
0.51,0.0001,832,872,25,100,0.0001,1704,16
0.514,0.0001,886,918,25,100,0.0001,1804,16
0.518,0.0001,940,964,25,100,0.0001,1904,16
0.532,0.0001,991,1013,25,100,0.0001,2004,16
0.516,0.0001,54,50,25,100,0.0001,104,17
0.516,0.0001,100,104,25,100,0.0001,204,17
0.516,0.0001,149,155,25,100,0.0001,304,17
0.516,0.0001,199,205,25,100,0.0001,404,17
0.514,0.0001,243,261,25,100,0.0001,504,17
0.514,0.0001,294,310,25,100,0.0001,604,17
0.516,0.0001,342,362,25,100,0.0001,704,17
0.518,0.0001,385,419,25,100,0.0001,804,17
0.528,0.0001,435,469,25,100,0.0001,904,17
0.528,0.0001,486,518,25,100,0.0001,1004,17
0.524,0.0001,536,568,25,100,0.0001,1104,17
0.526,0.0001,582,622,25,100,0.0001,1204,17
0.528,0.0001,630,674,25,100,0.0001,1304,17
0.534,0.0001,672,732,25,100,0.0001,1404,17
0.536,0.0001,731,773,25,100,0.0001,1504,17
0.538,0.0001,782,822,25,100,0.0001,1604,17
0.532,0.0001,833,871,25,100,0.0001,1704,17
0.532,0.0001,877,927,25,100,0.0001,1804,17
0.534,0.0001,929,975,25,100,0.0001,1904,17
0.536,0.0001,979,1025,25,100,0.0001,2004,17
0.45,0.0001,62,42,25,100,0.0001,104,18
0.448,0.0001,109,95,25,100,0.0001,204,18
0.45,0.0001,168,136,25,100,0.0001,304,18
0.448,0.0001,209,195,25,100,0.0001,404,18
0.452,0.0001,264,240,25,100,0.0001,504,18
0.452,0.0001,324,280,25,100,0.0001,604,18
0.458,0.0001,381,323,25,100,0.0001,704,18
0.454,0.0001,430,374,25,100,0.0001,804,18
0.454,0.0001,485,419,25,100,0.0001,904,18
0.45,0.0001,523,481,25,100,0.0001,1004,18
0.458,0.0001,570,534,25,100,0.0001,1104,18
0.47,0.0001,620,584,25,100,0.0001,1204,18
0.476,0.0001,671,633,25,100,0.0001,1304,18
0.478,0.0001,716,688,25,100,0.0001,1404,18
0.48,0.0001,761,743,25,100,0.0001,1504,18
0.492,0.0001,813,791,25,100,0.0001,1604,18
0.502,0.0001,862,842,25,100,0.0001,1704,18
0.504,0.0001,905,899,25,100,0.0001,1804,18
0.512,0.0001,965,939,25,100,0.0001,1904,18
0.52,0.0001,1009,995,25,100,0.0001,2004,18
0.55,0.0001,48,56,25,100,0.0001,104,19
0.554,0.0001,102,102,25,100,0.0001,204,19
0.556,0.0001,148,156,25,100,0.0001,304,19
0.566,0.0001,198,206,25,100,0.0001,404,19
0.568,0.0001,246,258,25,100,0.0001,504,19
0.568,0.0001,286,318,25,100,0.0001,604,19
0.568,0.0001,339,365,25,100,0.0001,704,19
0.566,0.0001,390,414,25,100,0.0001,804,19
0.566,0.0001,435,469,25,100,0.0001,904,19
0.56,0.0001,486,518,25,100,0.0001,1004,19
0.568,0.0001,542,562,25,100,0.0001,1104,19
0.57,0.0001,593,611,25,100,0.0001,1204,19
0.57,0.0001,651,653,25,100,0.0001,1304,19
0.574,0.0001,710,694,25,100,0.0001,1404,19
0.574,0.0001,767,737,25,100,0.0001,1504,19
0.578,0.0001,818,786,25,100,0.0001,1604,19
0.58,0.0001,861,843,25,100,0.0001,1704,19
0.584,0.0001,912,892,25,100,0.0001,1804,19
0.588,0.0001,959,945,25,100,0.0001,1904,19
0.592,0.0001,1008,996,25,100,0.0001,2004,19
0.538,0.0001,53,51,25,100,0.0001,104,20
0.536,0.0001,113,91,25,100,0.0001,204,20
0.534,0.0001,166,138,25,100,0.0001,304,20
0.534,0.0001,212,192,25,100,0.0001,404,20
0.534,0.0001,261,243,25,100,0.0001,504,20
0.534,0.0001,310,294,25,100,0.0001,604,20
0.532,0.0001,358,346,25,100,0.0001,704,20
0.532,0.0001,411,393,25,100,0.0001,804,20
0.536,0.0001,467,437,25,100,0.0001,904,20
0.53,0.0001,514,490,25,100,0.0001,1004,20
0.528,0.0001,560,544,25,100,0.0001,1104,20
0.532,0.0001,611,593,25,100,0.0001,1204,20
0.53,0.0001,663,641,25,100,0.0001,1304,20
0.534,0.0001,716,688,25,100,0.0001,1404,20
0.534,0.0001,764,740,25,100,0.0001,1504,20
0.534,0.0001,816,788,25,100,0.0001,1604,20
0.54,0.0001,867,837,25,100,0.0001,1704,20
0.544,0.0001,920,884,25,100,0.0001,1804,20
0.542,0.0001,973,931,25,100,0.0001,1904,20
0.544,0.0001,1019,985,25,100,0.0001,2004,20
0.48,0.0001,46,58,25,100,0.001,104,1
0.486,0.0001,92,112,25,100,0.001,204,1
0.492,0.0001,142,162,25,100,0.001,304,1
0.498,0.0001,190,214,25,100,0.001,404,1
0.508,0.0001,242,262,25,100,0.001,504,1
0.52,0.0001,291,313,25,100,0.001,604,1
0.534,0.0001,339,365,25,100,0.001,704,1
0.566,0.0001,393,411,25,100,0.001,804,1
0.578,0.0001,438,466,25,100,0.001,904,1
0.604,0.0001,489,515,25,100,0.001,1004,1
0.62,0.0001,534,570,25,100,0.001,1104,1
0.634,0.0001,587,617,25,100,0.001,1204,1
0.674,0.0001,642,662,25,100,0.001,1304,1
0.706,0.0001,705,699,25,100,0.001,1404,1
0.736,0.0001,751,753,25,100,0.001,1504,1
0.762,0.0001,803,801,25,100,0.001,1604,1
0.784,0.0001,845,859,25,100,0.001,1704,1
0.82,0.0001,893,911,25,100,0.001,1804,1
0.852,0.0001,943,961,25,100,0.001,1904,1
0.878,0.0001,994,1010,25,100,0.001,2004,1
0.498,0.0001,49,55,25,100,0.001,104,2
0.504,0.0001,95,109,25,100,0.001,204,2
0.514,0.0001,149,155,25,100,0.001,304,2
0.526,0.0001,204,200,25,100,0.001,404,2
0.528,0.0001,253,251,25,100,0.001,504,2
0.544,0.0001,309,295,25,100,0.001,604,2
0.574,0.0001,362,342,25,100,0.001,704,2
0.582,0.0001,416,388,25,100,0.001,804,2
0.6,0.0001,469,435,25,100,0.001,904,2
0.622,0.0001,506,498,25,100,0.001,1004,2
0.644,0.0001,557,547,25,100,0.001,1104,2
0.676,0.0001,606,598,25,100,0.001,1204,2
0.718,0.0001,658,646,25,100,0.001,1304,2
0.756,0.0001,705,699,25,100,0.001,1404,2
0.778,0.0001,751,753,25,100,0.001,1504,2
0.81,0.0001,796,808,25,100,0.001,1604,2
0.828,0.0001,851,853,25,100,0.001,1704,2
0.85,0.0001,903,901,25,100,0.001,1804,2
0.856,0.0001,953,951,25,100,0.001,1904,2
0.886,0.0001,1010,994,25,100,0.001,2004,2
0.466,0.0001,52,52,25,100,0.001,104,3
0.472,0.0001,106,98,25,100,0.001,204,3
0.476,0.0001,153,151,25,100,0.001,304,3
0.492,0.0001,204,200,25,100,0.001,404,3
0.5,0.0001,243,261,25,100,0.001,504,3
0.506,0.0001,297,307,25,100,0.001,604,3
0.52,0.0001,346,358,25,100,0.001,704,3
0.538,0.0001,407,397,25,100,0.001,804,3
0.554,0.0001,454,450,25,100,0.001,904,3
0.572,0.0001,501,503,25,100,0.001,1004,3
0.594,0.0001,553,551,25,100,0.001,1104,3
0.618,0.0001,600,604,25,100,0.001,1204,3
0.656,0.0001,648,656,25,100,0.001,1304,3
0.694,0.0001,698,706,25,100,0.001,1404,3
0.722,0.0001,756,748,25,100,0.001,1504,3
0.738,0.0001,803,801,25,100,0.001,1604,3
0.762,0.0001,857,847,25,100,0.001,1704,3
0.798,0.0001,907,897,25,100,0.001,1804,3
0.85,0.0001,954,950,25,100,0.001,1904,3
0.87,0.0001,1007,997,25,100,0.001,2004,3
0.492,0.0001,49,55,25,100,0.001,104,4
0.494,0.0001,109,95,25,100,0.001,204,4
0.498,0.0001,158,146,25,100,0.001,304,4
0.5,0.0001,206,198,25,100,0.001,404,4
0.516,0.0001,258,246,25,100,0.001,504,4
0.528,0.0001,308,296,25,100,0.001,604,4
0.532,0.0001,357,347,25,100,0.001,704,4
0.564,0.0001,413,391,25,100,0.001,804,4
0.576,0.0001,468,436,25,100,0.001,904,4
0.6,0.0001,515,489,25,100,0.001,1004,4
0.628,0.0001,570,534,25,100,0.001,1104,4
0.664,0.0001,619,585,25,100,0.001,1204,4
0.682,0.0001,677,627,25,100,0.001,1304,4
0.698,0.0001,728,676,25,100,0.001,1404,4
0.716,0.0001,783,721,25,100,0.001,1504,4
0.74,0.0001,830,774,25,100,0.001,1604,4
0.766,0.0001,882,822,25,100,0.001,1704,4
0.792,0.0001,929,875,25,100,0.001,1804,4
0.814,0.0001,976,928,25,100,0.001,1904,4
0.83,0.0001,1024,980,25,100,0.001,2004,4
0.482,0.0001,49,55,25,100,0.001,104,5
0.488,0.0001,100,104,25,100,0.001,204,5
0.486,0.0001,147,157,25,100,0.001,304,5
0.5,0.0001,203,201,25,100,0.001,404,5
0.504,0.0001,254,250,25,100,0.001,504,5
0.52,0.0001,302,302,25,100,0.001,604,5
0.548,0.0001,358,346,25,100,0.001,704,5
0.57,0.0001,408,396,25,100,0.001,804,5
0.608,0.0001,454,450,25,100,0.001,904,5
0.624,0.0001,507,497,25,100,0.001,1004,5
0.652,0.0001,559,545,25,100,0.001,1104,5
0.672,0.0001,605,599,25,100,0.001,1204,5
0.684,0.0001,658,646,25,100,0.001,1304,5
0.71,0.0001,697,707,25,100,0.001,1404,5
0.75,0.0001,736,768,25,100,0.001,1504,5
0.782,0.0001,781,823,25,100,0.001,1604,5
0.8,0.0001,837,867,25,100,0.001,1704,5
0.836,0.0001,890,914,25,100,0.001,1804,5
0.846,0.0001,945,959,25,100,0.001,1904,5
0.864,0.0001,989,1015,25,100,0.001,2004,5
0.484,0.0001,57,47,25,100,0.001,104,6
0.486,0.0001,100,104,25,100,0.001,204,6
0.49,0.0001,152,152,25,100,0.001,304,6
0.49,0.0001,199,205,25,100,0.001,404,6
0.492,0.0001,252,252,25,100,0.001,504,6
0.492,0.0001,305,299,25,100,0.001,604,6
0.494,0.0001,358,346,25,100,0.001,704,6
0.518,0.0001,414,390,25,100,0.001,804,6
0.546,0.0001,467,437,25,100,0.001,904,6
0.584,0.0001,512,492,25,100,0.001,1004,6
0.628,0.0001,564,540,25,100,0.001,1104,6
0.654,0.0001,624,580,25,100,0.001,1204,6
0.682,0.0001,676,628,25,100,0.001,1304,6
0.716,0.0001,725,679,25,100,0.001,1404,6
0.734,0.0001,774,730,25,100,0.001,1504,6
0.75,0.0001,822,782,25,100,0.001,1604,6
0.784,0.0001,864,840,25,100,0.001,1704,6
0.822,0.0001,914,890,25,100,0.001,1804,6
0.856,0.0001,964,940,25,100,0.001,1904,6
0.878,0.0001,1016,988,25,100,0.001,2004,6
0.498,0.0001,40,64,25,100,0.001,104,7
0.508,0.0001,92,112,25,100,0.001,204,7
0.516,0.0001,145,159,25,100,0.001,304,7
0.526,0.0001,187,217,25,100,0.001,404,7
0.522,0.0001,238,266,25,100,0.001,504,7
0.544,0.0001,289,315,25,100,0.001,604,7
0.55,0.0001,339,365,25,100,0.001,704,7
0.558,0.0001,397,407,25,100,0.001,804,7
0.598,0.0001,454,450,25,100,0.001,904,7
0.626,0.0001,504,500,25,100,0.001,1004,7
0.646,0.0001,555,549,25,100,0.001,1104,7
0.67,0.0001,595,609,25,100,0.001,1204,7
0.704,0.0001,648,656,25,100,0.001,1304,7
0.73,0.0001,700,704,25,100,0.001,1404,7
0.764,0.0001,755,749,25,100,0.001,1504,7
0.788,0.0001,804,800,25,100,0.001,1604,7
0.818,0.0001,843,861,25,100,0.001,1704,7
0.854,0.0001,898,906,25,100,0.001,1804,7
0.884,0.0001,945,959,25,100,0.001,1904,7
0.898,0.0001,999,1005,25,100,0.001,2004,7
0.462,0.0001,65,39,25,100,0.001,104,8
0.468,0.0001,129,75,25,100,0.001,204,8
0.482,0.0001,180,124,25,100,0.001,304,8
0.498,0.0001,229,175,25,100,0.001,404,8
0.5,0.0001,281,223,25,100,0.001,504,8
0.52,0.0001,322,282,25,100,0.001,604,8
0.532,0.0001,378,326,25,100,0.001,704,8
0.542,0.0001,422,382,25,100,0.001,804,8
0.55,0.0001,473,431,25,100,0.001,904,8
0.562,0.0001,524,480,25,100,0.001,1004,8
0.608,0.0001,568,536,25,100,0.001,1104,8
0.624,0.0001,622,582,25,100,0.001,1204,8
0.658,0.0001,667,637,25,100,0.001,1304,8
0.688,0.0001,716,688,25,100,0.001,1404,8
0.704,0.0001,759,745,25,100,0.001,1504,8
0.742,0.0001,816,788,25,100,0.001,1604,8
0.77,0.0001,861,843,25,100,0.001,1704,8
0.8,0.0001,913,891,25,100,0.001,1804,8
0.822,0.0001,960,944,25,100,0.001,1904,8
0.862,0.0001,1013,991,25,100,0.001,2004,8
0.49,0.0001,55,49,25,100,0.001,104,9
0.504,0.0001,98,106,25,100,0.001,204,9
0.516,0.0001,148,156,25,100,0.001,304,9
0.524,0.0001,205,199,25,100,0.001,404,9
0.53,0.0001,252,252,25,100,0.001,504,9
0.538,0.0001,301,303,25,100,0.001,604,9
0.548,0.0001,361,343,25,100,0.001,704,9
0.558,0.0001,417,387,25,100,0.001,804,9
0.578,0.0001,472,432,25,100,0.001,904,9
0.594,0.0001,519,485,25,100,0.001,1004,9
0.63,0.0001,578,526,25,100,0.001,1104,9
0.65,0.0001,626,578,25,100,0.001,1204,9
0.682,0.0001,685,619,25,100,0.001,1304,9
0.708,0.0001,736,668,25,100,0.001,1404,9
0.732,0.0001,784,720,25,100,0.001,1504,9
0.772,0.0001,833,771,25,100,0.001,1604,9
0.79,0.0001,883,821,25,100,0.001,1704,9
0.83,0.0001,928,876,25,100,0.001,1804,9
0.868,0.0001,971,933,25,100,0.001,1904,9
0.884,0.0001,1018,986,25,100,0.001,2004,9
0.496,0.0001,57,47,25,100,0.001,104,10
0.504,0.0001,116,88,25,100,0.001,204,10
0.51,0.0001,164,140,25,100,0.001,304,10
0.512,0.0001,207,197,25,100,0.001,404,10
0.518,0.0001,256,248,25,100,0.001,504,10
0.54,0.0001,317,287,25,100,0.001,604,10
0.558,0.0001,369,335,25,100,0.001,704,10
0.582,0.0001,423,381,25,100,0.001,804,10
0.6,0.0001,471,433,25,100,0.001,904,10
0.626,0.0001,524,480,25,100,0.001,1004,10
0.642,0.0001,577,527,25,100,0.001,1104,10
0.66,0.0001,631,573,25,100,0.001,1204,10
0.692,0.0001,682,622,25,100,0.001,1304,10
0.716,0.0001,728,676,25,100,0.001,1404,10
0.742,0.0001,777,727,25,100,0.001,1504,10
0.784,0.0001,818,786,25,100,0.001,1604,10
0.812,0.0001,864,840,25,100,0.001,1704,10
0.826,0.0001,911,893,25,100,0.001,1804,10
0.832,0.0001,958,946,25,100,0.001,1904,10
0.85,0.0001,998,1006,25,100,0.001,2004,10
0.548,0.0001,59,45,25,100,0.001,104,11
0.564,0.0001,105,99,25,100,0.001,204,11
0.554,0.0001,165,139,25,100,0.001,304,11
0.544,0.0001,211,193,25,100,0.001,404,11
0.556,0.0001,266,238,25,100,0.001,504,11
0.544,0.0001,325,279,25,100,0.001,604,11
0.55,0.0001,375,329,25,100,0.001,704,11
0.556,0.0001,425,379,25,100,0.001,804,11
0.562,0.0001,474,430,25,100,0.001,904,11
0.582,0.0001,517,487,25,100,0.001,1004,11
0.602,0.0001,564,540,25,100,0.001,1104,11
0.64,0.0001,611,593,25,100,0.001,1204,11
0.656,0.0001,651,653,25,100,0.001,1304,11
0.69,0.0001,703,701,25,100,0.001,1404,11
0.716,0.0001,758,746,25,100,0.001,1504,11
0.784,0.0001,806,798,25,100,0.001,1604,11
0.808,0.0001,853,851,25,100,0.001,1704,11
0.828,0.0001,906,898,25,100,0.001,1804,11
0.854,0.0001,960,944,25,100,0.001,1904,11
0.874,0.0001,1006,998,25,100,0.001,2004,11
0.564,0.0001,51,53,25,100,0.001,104,12
0.558,0.0001,97,107,25,100,0.001,204,12
0.562,0.0001,149,155,25,100,0.001,304,12
0.572,0.0001,207,197,25,100,0.001,404,12
0.57,0.0001,260,244,25,100,0.001,504,12
0.574,0.0001,320,284,25,100,0.001,604,12
0.592,0.0001,368,336,25,100,0.001,704,12
0.586,0.0001,420,384,25,100,0.001,804,12
0.604,0.0001,479,425,25,100,0.001,904,12
0.618,0.0001,528,476,25,100,0.001,1004,12
0.638,0.0001,586,518,25,100,0.001,1104,12
0.654,0.0001,642,562,25,100,0.001,1204,12
0.686,0.0001,688,616,25,100,0.001,1304,12
0.696,0.0001,736,668,25,100,0.001,1404,12
0.706,0.0001,783,721,25,100,0.001,1504,12
0.732,0.0001,823,781,25,100,0.001,1604,12
0.75,0.0001,869,835,25,100,0.001,1704,12
0.788,0.0001,918,886,25,100,0.001,1804,12
0.816,0.0001,969,935,25,100,0.001,1904,12
0.848,0.0001,1011,993,25,100,0.001,2004,12
0.504,0.0001,54,50,25,100,0.001,104,13
0.506,0.0001,97,107,25,100,0.001,204,13
0.508,0.0001,155,149,25,100,0.001,304,13
0.518,0.0001,200,204,25,100,0.001,404,13
0.534,0.0001,254,250,25,100,0.001,504,13
0.552,0.0001,302,302,25,100,0.001,604,13
0.566,0.0001,353,351,25,100,0.001,704,13
0.57,0.0001,405,399,25,100,0.001,804,13
0.59,0.0001,451,453,25,100,0.001,904,13
0.612,0.0001,497,507,25,100,0.001,1004,13
0.622,0.0001,549,555,25,100,0.001,1104,13
0.654,0.0001,602,602,25,100,0.001,1204,13
0.668,0.0001,650,654,25,100,0.001,1304,13
0.694,0.0001,699,705,25,100,0.001,1404,13
0.736,0.0001,755,749,25,100,0.001,1504,13
0.786,0.0001,802,802,25,100,0.001,1604,13
0.802,0.0001,853,851,25,100,0.001,1704,13
0.816,0.0001,900,904,25,100,0.001,1804,13
0.824,0.0001,944,960,25,100,0.001,1904,13
0.86,0.0001,998,1006,25,100,0.001,2004,13
0.52,0.0001,47,57,25,100,0.001,104,14
0.516,0.0001,91,113,25,100,0.001,204,14
0.514,0.0001,151,153,25,100,0.001,304,14
0.532,0.0001,207,197,25,100,0.001,404,14
0.544,0.0001,253,251,25,100,0.001,504,14
0.568,0.0001,306,298,25,100,0.001,604,14
0.572,0.0001,358,346,25,100,0.001,704,14
0.592,0.0001,413,391,25,100,0.001,804,14
0.64,0.0001,464,440,25,100,0.001,904,14
0.648,0.0001,506,498,25,100,0.001,1004,14
0.664,0.0001,556,548,25,100,0.001,1104,14
0.696,0.0001,602,602,25,100,0.001,1204,14
0.722,0.0001,660,644,25,100,0.001,1304,14
0.732,0.0001,705,699,25,100,0.001,1404,14
0.734,0.0001,744,760,25,100,0.001,1504,14
0.742,0.0001,794,810,25,100,0.001,1604,14
0.76,0.0001,850,854,25,100,0.001,1704,14
0.796,0.0001,898,906,25,100,0.001,1804,14
0.81,0.0001,947,957,25,100,0.001,1904,14
0.856,0.0001,1001,1003,25,100,0.001,2004,14
0.536,0.0001,48,56,25,100,0.001,104,15
0.546,0.0001,93,111,25,100,0.001,204,15
0.552,0.0001,148,156,25,100,0.001,304,15
0.56,0.0001,199,205,25,100,0.001,404,15
0.57,0.0001,250,254,25,100,0.001,504,15
0.596,0.0001,300,304,25,100,0.001,604,15
0.618,0.0001,354,350,25,100,0.001,704,15
0.632,0.0001,401,403,25,100,0.001,804,15
0.66,0.0001,458,446,25,100,0.001,904,15
0.69,0.0001,507,497,25,100,0.001,1004,15
0.708,0.0001,558,546,25,100,0.001,1104,15
0.724,0.0001,602,602,25,100,0.001,1204,15
0.732,0.0001,655,649,25,100,0.001,1304,15
0.76,0.0001,710,694,25,100,0.001,1404,15
0.762,0.0001,755,749,25,100,0.001,1504,15
0.796,0.0001,796,808,25,100,0.001,1604,15
0.812,0.0001,846,858,25,100,0.001,1704,15
0.838,0.0001,895,909,25,100,0.001,1804,15
0.856,0.0001,948,956,25,100,0.001,1904,15
0.874,0.0001,992,1012,25,100,0.001,2004,15
0.476,0.0001,41,63,25,100,0.001,104,16
0.49,0.0001,92,112,25,100,0.001,204,16
0.486,0.0001,144,160,25,100,0.001,304,16
0.494,0.0001,185,219,25,100,0.001,404,16
0.494,0.0001,234,270,25,100,0.001,504,16
0.514,0.0001,287,317,25,100,0.001,604,16
0.538,0.0001,351,353,25,100,0.001,704,16
0.564,0.0001,407,397,25,100,0.001,804,16
0.582,0.0001,462,442,25,100,0.001,904,16
0.604,0.0001,513,491,25,100,0.001,1004,16
0.648,0.0001,568,536,25,100,0.001,1104,16
0.698,0.0001,621,583,25,100,0.001,1204,16
0.738,0.0001,666,638,25,100,0.001,1304,16
0.76,0.0001,718,686,25,100,0.001,1404,16
0.776,0.0001,760,744,25,100,0.001,1504,16
0.788,0.0001,793,811,25,100,0.001,1604,16
0.814,0.0001,847,857,25,100,0.001,1704,16
0.838,0.0001,898,906,25,100,0.001,1804,16
0.862,0.0001,948,956,25,100,0.001,1904,16
0.878,0.0001,996,1008,25,100,0.001,2004,16
0.464,0.0001,51,53,25,100,0.001,104,17
0.478,0.0001,102,102,25,100,0.001,204,17
0.47,0.0001,150,154,25,100,0.001,304,17
0.486,0.0001,201,203,25,100,0.001,404,17
0.496,0.0001,249,255,25,100,0.001,504,17
0.512,0.0001,296,308,25,100,0.001,604,17
0.534,0.0001,348,356,25,100,0.001,704,17
0.558,0.0001,391,413,25,100,0.001,804,17
0.594,0.0001,442,462,25,100,0.001,904,17
0.618,0.0001,495,509,25,100,0.001,1004,17
0.64,0.0001,539,565,25,100,0.001,1104,17
0.656,0.0001,586,618,25,100,0.001,1204,17
0.668,0.0001,647,657,25,100,0.001,1304,17
0.694,0.0001,701,703,25,100,0.001,1404,17
0.714,0.0001,753,751,25,100,0.001,1504,17
0.734,0.0001,807,797,25,100,0.001,1604,17
0.748,0.0001,858,846,25,100,0.001,1704,17
0.79,0.0001,905,899,25,100,0.001,1804,17
0.808,0.0001,957,947,25,100,0.001,1904,17
0.838,0.0001,1012,992,25,100,0.001,2004,17
0.538,0.0001,58,46,25,100,0.001,104,18
0.544,0.0001,104,100,25,100,0.001,204,18
0.548,0.0001,156,148,25,100,0.001,304,18
0.534,0.0001,196,208,25,100,0.001,404,18
0.54,0.0001,245,259,25,100,0.001,504,18
0.546,0.0001,295,309,25,100,0.001,604,18
0.558,0.0001,352,352,25,100,0.001,704,18
0.566,0.0001,401,403,25,100,0.001,804,18
0.58,0.0001,440,464,25,100,0.001,904,18
0.592,0.0001,486,518,25,100,0.001,1004,18
0.586,0.0001,537,567,25,100,0.001,1104,18
0.62,0.0001,590,614,25,100,0.001,1204,18
0.644,0.0001,635,669,25,100,0.001,1304,18
0.666,0.0001,684,720,25,100,0.001,1404,18
0.7,0.0001,742,762,25,100,0.001,1504,18
0.738,0.0001,792,812,25,100,0.001,1604,18
0.758,0.0001,848,856,25,100,0.001,1704,18
0.8,0.0001,892,912,25,100,0.001,1804,18
0.824,0.0001,937,967,25,100,0.001,1904,18
0.854,0.0001,986,1018,25,100,0.001,2004,18
0.486,0.0001,50,54,25,100,0.001,104,19
0.492,0.0001,96,108,25,100,0.001,204,19
0.492,0.0001,141,163,25,100,0.001,304,19
0.498,0.0001,196,208,25,100,0.001,404,19
0.526,0.0001,249,255,25,100,0.001,504,19
0.54,0.0001,300,304,25,100,0.001,604,19
0.56,0.0001,352,352,25,100,0.001,704,19
0.592,0.0001,404,400,25,100,0.001,804,19
0.614,0.0001,455,449,25,100,0.001,904,19
0.624,0.0001,502,502,25,100,0.001,1004,19
0.636,0.0001,552,552,25,100,0.001,1104,19
0.656,0.0001,604,600,25,100,0.001,1204,19
0.684,0.0001,653,651,25,100,0.001,1304,19
0.718,0.0001,699,705,25,100,0.001,1404,19
0.756,0.0001,747,757,25,100,0.001,1504,19
0.796,0.0001,792,812,25,100,0.001,1604,19
0.822,0.0001,843,861,25,100,0.001,1704,19
0.85,0.0001,893,911,25,100,0.001,1804,19
0.858,0.0001,948,956,25,100,0.001,1904,19
0.874,0.0001,1004,1000,25,100,0.001,2004,19
0.514,0.0001,45,59,25,100,0.001,104,20
0.514,0.0001,93,111,25,100,0.001,204,20
0.518,0.0001,135,169,25,100,0.001,304,20
0.52,0.0001,180,224,25,100,0.001,404,20
0.52,0.0001,231,273,25,100,0.001,504,20
0.52,0.0001,288,316,25,100,0.001,604,20
0.534,0.0001,348,356,25,100,0.001,704,20
0.558,0.0001,396,408,25,100,0.001,804,20
0.562,0.0001,450,454,25,100,0.001,904,20
0.578,0.0001,499,505,25,100,0.001,1004,20
0.6,0.0001,550,554,25,100,0.001,1104,20
0.62,0.0001,598,606,25,100,0.001,1204,20
0.634,0.0001,661,643,25,100,0.001,1304,20
0.652,0.0001,716,688,25,100,0.001,1404,20
0.668,0.0001,765,739,25,100,0.001,1504,20
0.704,0.0001,811,793,25,100,0.001,1604,20
0.718,0.0001,861,843,25,100,0.001,1704,20
0.736,0.0001,911,893,25,100,0.001,1804,20
0.752,0.0001,960,944,25,100,0.001,1904,20
0.792,0.0001,1008,996,25,100,0.001,2004,20
0.536,0.0001,50,54,25,100,0.01,104,1
0.566,0.0001,96,108,25,100,0.01,204,1
0.562,0.0001,150,154,25,100,0.01,304,1
0.634,0.0001,199,205,25,100,0.01,404,1
0.676,0.0001,244,260,25,100,0.01,504,1
0.742,0.0001,302,302,25,100,0.01,604,1
0.792,0.0001,342,362,25,100,0.01,704,1
0.872,0.0001,399,405,25,100,0.01,804,1
0.914,0.0001,453,451,25,100,0.01,904,1
0.932,0.0001,508,496,25,100,0.01,1004,1
0.914,0.0001,555,549,25,100,0.01,1104,1
0.946,0.0001,605,599,25,100,0.01,1204,1
0.958,0.0001,652,652,25,100,0.01,1304,1
0.962,0.0001,702,702,25,100,0.01,1404,1
0.97,0.0001,765,739,25,100,0.01,1504,1
0.974,0.0001,805,799,25,100,0.01,1604,1
0.97,0.0001,867,837,25,100,0.01,1704,1
0.976,0.0001,908,896,25,100,0.01,1804,1
0.976,0.0001,955,949,25,100,0.01,1904,1
0.976,0.0001,1005,999,25,100,0.01,2004,1
0.576,0.0001,48,56,25,100,0.01,104,2
0.624,0.0001,100,104,25,100,0.01,204,2
0.668,0.0001,159,145,25,100,0.01,304,2
0.692,0.0001,211,193,25,100,0.01,404,2
0.722,0.0001,260,244,25,100,0.01,504,2
0.76,0.0001,317,287,25,100,0.01,604,2
0.788,0.0001,372,332,25,100,0.01,704,2
0.824,0.0001,425,379,25,100,0.01,804,2
0.882,0.0001,484,420,25,100,0.01,904,2
0.93,0.0001,532,472,25,100,0.01,1004,2
0.946,0.0001,584,520,25,100,0.01,1104,2
0.96,0.0001,633,571,25,100,0.01,1204,2
0.952,0.0001,680,624,25,100,0.01,1304,2
0.958,0.0001,719,685,25,100,0.01,1404,2
0.962,0.0001,769,735,25,100,0.01,1504,2
0.974,0.0001,812,792,25,100,0.01,1604,2
0.976,0.0001,869,835,25,100,0.01,1704,2
0.98,0.0001,916,888,25,100,0.01,1804,2
0.98,0.0001,965,939,25,100,0.01,1904,2
0.982,0.0001,1006,998,25,100,0.01,2004,2
0.576,0.0001,56,48,25,100,0.01,104,3
0.61,0.0001,100,104,25,100,0.01,204,3
0.628,0.0001,150,154,25,100,0.01,304,3
0.666,0.0001,204,200,25,100,0.01,404,3
0.704,0.0001,253,251,25,100,0.01,504,3
0.75,0.0001,300,304,25,100,0.01,604,3
0.798,0.0001,350,354,25,100,0.01,704,3
0.832,0.0001,399,405,25,100,0.01,804,3
0.852,0.0001,445,459,25,100,0.01,904,3
0.9,0.0001,501,503,25,100,0.01,1004,3
0.938,0.0001,553,551,25,100,0.01,1104,3
0.946,0.0001,598,606,25,100,0.01,1204,3
0.952,0.0001,645,659,25,100,0.01,1304,3
0.96,0.0001,693,711,25,100,0.01,1404,3
0.966,0.0001,745,759,25,100,0.01,1504,3
0.964,0.0001,794,810,25,100,0.01,1604,3
0.97,0.0001,853,851,25,100,0.01,1704,3
0.978,0.0001,910,894,25,100,0.01,1804,3
0.974,0.0001,957,947,25,100,0.01,1904,3
0.976,0.0001,1006,998,25,100,0.01,2004,3
0.532,0.0001,55,49,25,100,0.01,104,4
0.576,0.0001,102,102,25,100,0.01,204,4
0.602,0.0001,151,153,25,100,0.01,304,4
0.624,0.0001,200,204,25,100,0.01,404,4
0.662,0.0001,252,252,25,100,0.01,504,4
0.72,0.0001,304,300,25,100,0.01,604,4
0.766,0.0001,353,351,25,100,0.01,704,4
0.8,0.0001,399,405,25,100,0.01,804,4
0.856,0.0001,445,459,25,100,0.01,904,4
0.902,0.0001,490,514,25,100,0.01,1004,4
0.926,0.0001,539,565,25,100,0.01,1104,4
0.946,0.0001,583,621,25,100,0.01,1204,4
0.96,0.0001,633,671,25,100,0.01,1304,4
0.972,0.0001,683,721,25,100,0.01,1404,4
0.976,0.0001,740,764,25,100,0.01,1504,4
0.98,0.0001,790,814,25,100,0.01,1604,4
0.986,0.0001,840,864,25,100,0.01,1704,4
0.988,0.0001,895,909,25,100,0.01,1804,4
0.992,0.0001,950,954,25,100,0.01,1904,4
0.992,0.0001,997,1007,25,100,0.01,2004,4
0.554,0.0001,52,52,25,100,0.01,104,5
0.62,0.0001,103,101,25,100,0.01,204,5
0.594,0.0001,158,146,25,100,0.01,304,5
0.614,0.0001,211,193,25,100,0.01,404,5
0.636,0.0001,258,246,25,100,0.01,504,5
0.7,0.0001,310,294,25,100,0.01,604,5
0.76,0.0001,368,336,25,100,0.01,704,5
0.806,0.0001,421,383,25,100,0.01,804,5
0.83,0.0001,467,437,25,100,0.01,904,5
0.94,0.0001,519,485,25,100,0.01,1004,5
0.948,0.0001,561,543,25,100,0.01,1104,5
0.946,0.0001,609,595,25,100,0.01,1204,5
0.954,0.0001,651,653,25,100,0.01,1304,5
0.956,0.0001,705,699,25,100,0.01,1404,5
0.958,0.0001,772,732,25,100,0.01,1504,5
0.97,0.0001,816,788,25,100,0.01,1604,5
0.966,0.0001,865,839,25,100,0.01,1704,5
0.976,0.0001,921,883,25,100,0.01,1804,5
0.978,0.0001,969,935,25,100,0.01,1904,5
0.984,0.0001,1016,988,25,100,0.01,2004,5
0.56,0.0001,52,52,25,100,0.01,104,6
0.598,0.0001,107,97,25,100,0.01,204,6
0.626,0.0001,154,150,25,100,0.01,304,6
0.638,0.0001,211,193,25,100,0.01,404,6
0.636,0.0001,262,242,25,100,0.01,504,6
0.73,0.0001,315,289,25,100,0.01,604,6
0.784,0.0001,368,336,25,100,0.01,704,6
0.846,0.0001,424,380,25,100,0.01,804,6
0.874,0.0001,473,431,25,100,0.01,904,6
0.92,0.0001,522,482,25,100,0.01,1004,6
0.944,0.0001,576,528,25,100,0.01,1104,6
0.962,0.0001,639,565,25,100,0.01,1204,6
0.966,0.0001,683,621,25,100,0.01,1304,6
0.968,0.0001,742,662,25,100,0.01,1404,6
0.972,0.0001,783,721,25,100,0.01,1504,6
0.978,0.0001,828,776,25,100,0.01,1604,6
0.982,0.0001,881,823,25,100,0.01,1704,6
0.986,0.0001,921,883,25,100,0.01,1804,6
0.986,0.0001,965,939,25,100,0.01,1904,6
0.992,0.0001,1014,990,25,100,0.01,2004,6
0.536,0.0001,57,47,25,100,0.01,104,7
0.564,0.0001,105,99,25,100,0.01,204,7
0.66,0.0001,150,154,25,100,0.01,304,7
0.672,0.0001,197,207,25,100,0.01,404,7
0.668,0.0001,240,264,25,100,0.01,504,7
0.73,0.0001,293,311,25,100,0.01,604,7
0.776,0.0001,349,355,25,100,0.01,704,7
0.832,0.0001,405,399,25,100,0.01,804,7
0.892,0.0001,458,446,25,100,0.01,904,7
0.898,0.0001,506,498,25,100,0.01,1004,7
0.94,0.0001,551,553,25,100,0.01,1104,7
0.958,0.0001,598,606,25,100,0.01,1204,7
0.958,0.0001,650,654,25,100,0.01,1304,7
0.968,0.0001,700,704,25,100,0.01,1404,7
0.972,0.0001,754,750,25,100,0.01,1504,7
0.974,0.0001,799,805,25,100,0.01,1604,7
0.974,0.0001,848,856,25,100,0.01,1704,7
0.972,0.0001,898,906,25,100,0.01,1804,7
0.978,0.0001,946,958,25,100,0.01,1904,7
0.982,0.0001,996,1008,25,100,0.01,2004,7
0.506,0.0001,57,47,25,100,0.01,104,8
0.536,0.0001,104,100,25,100,0.01,204,8
0.564,0.0001,159,145,25,100,0.01,304,8
0.658,0.0001,212,192,25,100,0.01,404,8
0.686,0.0001,252,252,25,100,0.01,504,8
0.77,0.0001,301,303,25,100,0.01,604,8
0.78,0.0001,349,355,25,100,0.01,704,8
0.816,0.0001,397,407,25,100,0.01,804,8
0.87,0.0001,446,458,25,100,0.01,904,8
0.924,0.0001,484,520,25,100,0.01,1004,8
0.942,0.0001,529,575,25,100,0.01,1104,8
0.954,0.0001,574,630,25,100,0.01,1204,8
0.962,0.0001,616,688,25,100,0.01,1304,8
0.95,0.0001,661,743,25,100,0.01,1404,8
0.956,0.0001,708,796,25,100,0.01,1504,8
0.968,0.0001,765,839,25,100,0.01,1604,8
0.966,0.0001,825,879,25,100,0.01,1704,8
0.972,0.0001,879,925,25,100,0.01,1804,8
0.978,0.0001,926,978,25,100,0.01,1904,8
0.978,0.0001,976,1028,25,100,0.01,2004,8
0.5,0.0001,53,51,25,100,0.01,104,9
0.62,0.0001,106,98,25,100,0.01,204,9
0.648,0.0001,148,156,25,100,0.01,304,9
0.676,0.0001,200,204,25,100,0.01,404,9
0.7,0.0001,258,246,25,100,0.01,504,9
0.744,0.0001,317,287,25,100,0.01,604,9
0.752,0.0001,368,336,25,100,0.01,704,9
0.786,0.0001,419,385,25,100,0.01,804,9
0.834,0.0001,468,436,25,100,0.01,904,9
0.89,0.0001,512,492,25,100,0.01,1004,9
0.912,0.0001,556,548,25,100,0.01,1104,9
0.942,0.0001,603,601,25,100,0.01,1204,9
0.938,0.0001,654,650,25,100,0.01,1304,9
0.944,0.0001,708,696,25,100,0.01,1404,9
0.948,0.0001,751,753,25,100,0.01,1504,9
0.962,0.0001,802,802,25,100,0.01,1604,9
0.964,0.0001,855,849,25,100,0.01,1704,9
0.97,0.0001,899,905,25,100,0.01,1804,9
0.97,0.0001,941,963,25,100,0.01,1904,9
0.982,0.0001,989,1015,25,100,0.01,2004,9
0.53,0.0001,49,55,25,100,0.01,104,10
0.572,0.0001,92,112,25,100,0.01,204,10
0.582,0.0001,141,163,25,100,0.01,304,10
0.64,0.0001,195,209,25,100,0.01,404,10
0.668,0.0001,243,261,25,100,0.01,504,10
0.712,0.0001,292,312,25,100,0.01,604,10
0.786,0.0001,349,355,25,100,0.01,704,10
0.812,0.0001,398,406,25,100,0.01,804,10
0.866,0.0001,451,453,25,100,0.01,904,10
0.896,0.0001,494,510,25,100,0.01,1004,10
0.926,0.0001,544,560,25,100,0.01,1104,10
0.948,0.0001,599,605,25,100,0.01,1204,10
0.952,0.0001,643,661,25,100,0.01,1304,10
0.96,0.0001,697,707,25,100,0.01,1404,10
0.966,0.0001,742,762,25,100,0.01,1504,10
0.974,0.0001,796,808,25,100,0.01,1604,10
0.97,0.0001,842,862,25,100,0.01,1704,10
0.974,0.0001,895,909,25,100,0.01,1804,10
0.976,0.0001,950,954,25,100,0.01,1904,10
0.984,0.0001,1005,999,25,100,0.01,2004,10
0.542,0.0001,48,56,25,100,0.01,104,11
0.576,0.0001,106,98,25,100,0.01,204,11
0.592,0.0001,157,147,25,100,0.01,304,11
0.638,0.0001,206,198,25,100,0.01,404,11
0.698,0.0001,257,247,25,100,0.01,504,11
0.75,0.0001,301,303,25,100,0.01,604,11
0.782,0.0001,345,359,25,100,0.01,704,11
0.83,0.0001,397,407,25,100,0.01,804,11
0.862,0.0001,451,453,25,100,0.01,904,11
0.9,0.0001,502,502,25,100,0.01,1004,11
0.932,0.0001,544,560,25,100,0.01,1104,11
0.958,0.0001,599,605,25,100,0.01,1204,11
0.962,0.0001,647,657,25,100,0.01,1304,11
0.964,0.0001,700,704,25,100,0.01,1404,11
0.96,0.0001,755,749,25,100,0.01,1504,11
0.968,0.0001,798,806,25,100,0.01,1604,11
0.97,0.0001,845,859,25,100,0.01,1704,11
0.98,0.0001,898,906,25,100,0.01,1804,11
0.98,0.0001,953,951,25,100,0.01,1904,11
0.986,0.0001,1002,1002,25,100,0.01,2004,11
0.504,0.0001,55,49,25,100,0.01,104,12
0.548,0.0001,101,103,25,100,0.01,204,12
0.568,0.0001,150,154,25,100,0.01,304,12
0.61,0.0001,199,205,25,100,0.01,404,12
0.632,0.0001,250,254,25,100,0.01,504,12
0.68,0.0001,304,300,25,100,0.01,604,12
0.734,0.0001,348,356,25,100,0.01,704,12
0.804,0.0001,404,400,25,100,0.01,804,12
0.872,0.0001,456,448,25,100,0.01,904,12
0.908,0.0001,512,492,25,100,0.01,1004,12
0.936,0.0001,560,544,25,100,0.01,1104,12
0.956,0.0001,613,591,25,100,0.01,1204,12
0.962,0.0001,667,637,25,100,0.01,1304,12
0.97,0.0001,718,686,25,100,0.01,1404,12
0.968,0.0001,760,744,25,100,0.01,1504,12
0.984,0.0001,809,795,25,100,0.01,1604,12
0.982,0.0001,859,845,25,100,0.01,1704,12
0.976,0.0001,908,896,25,100,0.01,1804,12
0.984,0.0001,959,945,25,100,0.01,1904,12
0.984,0.0001,999,1005,25,100,0.01,2004,12
0.584,0.0001,46,58,25,100,0.01,104,13
0.534,0.0001,93,111,25,100,0.01,204,13
0.558,0.0001,138,166,25,100,0.01,304,13
0.648,0.0001,181,223,25,100,0.01,404,13
0.71,0.0001,232,272,25,100,0.01,504,13
0.756,0.0001,285,319,25,100,0.01,604,13
0.786,0.0001,332,372,25,100,0.01,704,13
0.814,0.0001,375,429,25,100,0.01,804,13
0.856,0.0001,425,479,25,100,0.01,904,13
0.916,0.0001,472,532,25,100,0.01,1004,13
0.944,0.0001,515,589,25,100,0.01,1104,13
0.95,0.0001,570,634,25,100,0.01,1204,13
0.95,0.0001,625,679,25,100,0.01,1304,13
0.96,0.0001,678,726,25,100,0.01,1404,13
0.964,0.0001,739,765,25,100,0.01,1504,13
0.982,0.0001,790,814,25,100,0.01,1604,13
0.978,0.0001,841,863,25,100,0.01,1704,13
0.982,0.0001,887,917,25,100,0.01,1804,13
0.982,0.0001,934,970,25,100,0.01,1904,13
0.988,0.0001,980,1024,25,100,0.01,2004,13
0.59,0.0001,50,54,25,100,0.01,104,14
0.612,0.0001,102,102,25,100,0.01,204,14
0.626,0.0001,162,142,25,100,0.01,304,14
0.636,0.0001,202,202,25,100,0.01,404,14
0.644,0.0001,246,258,25,100,0.01,504,14
0.704,0.0001,299,305,25,100,0.01,604,14
0.748,0.0001,352,352,25,100,0.01,704,14
0.808,0.0001,410,394,25,100,0.01,804,14
0.892,0.0001,467,437,25,100,0.01,904,14
0.922,0.0001,524,480,25,100,0.01,1004,14
0.942,0.0001,570,534,25,100,0.01,1104,14
0.95,0.0001,612,592,25,100,0.01,1204,14
0.952,0.0001,661,643,25,100,0.01,1304,14
0.966,0.0001,709,695,25,100,0.01,1404,14
0.966,0.0001,759,745,25,100,0.01,1504,14
0.966,0.0001,805,799,25,100,0.01,1604,14
0.97,0.0001,853,851,25,100,0.01,1704,14
0.98,0.0001,902,902,25,100,0.01,1804,14
0.978,0.0001,952,952,25,100,0.01,1904,14
0.986,0.0001,1006,998,25,100,0.01,2004,14
0.55,0.0001,52,52,25,100,0.01,104,15
0.588,0.0001,108,96,25,100,0.01,204,15
0.614,0.0001,166,138,25,100,0.01,304,15
0.624,0.0001,218,186,25,100,0.01,404,15
0.686,0.0001,266,238,25,100,0.01,504,15
0.776,0.0001,314,290,25,100,0.01,604,15
0.818,0.0001,365,339,25,100,0.01,704,15
0.87,0.0001,412,392,25,100,0.01,804,15
0.886,0.0001,460,444,25,100,0.01,904,15
0.926,0.0001,512,492,25,100,0.01,1004,15
0.934,0.0001,555,549,25,100,0.01,1104,15
0.946,0.0001,603,601,25,100,0.01,1204,15
0.958,0.0001,649,655,25,100,0.01,1304,15
0.966,0.0001,697,707,25,100,0.01,1404,15
0.97,0.0001,748,756,25,100,0.01,1504,15
0.972,0.0001,803,801,25,100,0.01,1604,15
0.978,0.0001,851,853,25,100,0.01,1704,15
0.982,0.0001,905,899,25,100,0.01,1804,15
0.976,0.0001,950,954,25,100,0.01,1904,15
0.982,0.0001,1005,999,25,100,0.01,2004,15
0.57,0.0001,49,55,25,100,0.01,104,16
0.622,0.0001,101,103,25,100,0.01,204,16
0.638,0.0001,150,154,25,100,0.01,304,16
0.686,0.0001,203,201,25,100,0.01,404,16
0.694,0.0001,263,241,25,100,0.01,504,16
0.722,0.0001,319,285,25,100,0.01,604,16
0.758,0.0001,368,336,25,100,0.01,704,16
0.876,0.0001,420,384,25,100,0.01,804,16
0.894,0.0001,463,441,25,100,0.01,904,16
0.936,0.0001,512,492,25,100,0.01,1004,16
0.946,0.0001,559,545,25,100,0.01,1104,16
0.962,0.0001,600,604,25,100,0.01,1204,16
0.968,0.0001,643,661,25,100,0.01,1304,16
0.972,0.0001,699,705,25,100,0.01,1404,16
0.976,0.0001,763,741,25,100,0.01,1504,16
0.98,0.0001,810,794,25,100,0.01,1604,16
0.982,0.0001,864,840,25,100,0.01,1704,16
0.988,0.0001,908,896,25,100,0.01,1804,16
0.994,0.0001,959,945,25,100,0.01,1904,16
0.996,0.0001,1008,996,25,100,0.01,2004,16
0.568,0.0001,49,55,25,100,0.01,104,17
0.58,0.0001,107,97,25,100,0.01,204,17
0.622,0.0001,160,144,25,100,0.01,304,17
0.656,0.0001,217,187,25,100,0.01,404,17
0.684,0.0001,267,237,25,100,0.01,504,17
0.756,0.0001,316,288,25,100,0.01,604,17
0.82,0.0001,369,335,25,100,0.01,704,17
0.88,0.0001,416,388,25,100,0.01,804,17
0.914,0.0001,460,444,25,100,0.01,904,17
0.936,0.0001,508,496,25,100,0.01,1004,17
0.942,0.0001,560,544,25,100,0.01,1104,17
0.954,0.0001,598,606,25,100,0.01,1204,17
0.964,0.0001,656,648,25,100,0.01,1304,17
0.966,0.0001,709,695,25,100,0.01,1404,17
0.976,0.0001,763,741,25,100,0.01,1504,17
0.968,0.0001,818,786,25,100,0.01,1604,17
0.98,0.0001,867,837,25,100,0.01,1704,17
0.984,0.0001,909,895,25,100,0.01,1804,17
0.982,0.0001,951,953,25,100,0.01,1904,17
0.99,0.0001,995,1009,25,100,0.01,2004,17
0.594,0.0001,52,52,25,100,0.01,104,18
0.612,0.0001,100,104,25,100,0.01,204,18
0.632,0.0001,153,151,25,100,0.01,304,18
0.658,0.0001,206,198,25,100,0.01,404,18
0.702,0.0001,253,251,25,100,0.01,504,18
0.754,0.0001,304,300,25,100,0.01,604,18
0.76,0.0001,358,346,25,100,0.01,704,18
0.854,0.0001,408,396,25,100,0.01,804,18
0.876,0.0001,457,447,25,100,0.01,904,18
0.93,0.0001,508,496,25,100,0.01,1004,18
0.948,0.0001,557,547,25,100,0.01,1104,18
0.962,0.0001,605,599,25,100,0.01,1204,18
0.942,0.0001,647,657,25,100,0.01,1304,18
0.97,0.0001,697,707,25,100,0.01,1404,18
0.972,0.0001,742,762,25,100,0.01,1504,18
0.98,0.0001,789,815,25,100,0.01,1604,18
0.984,0.0001,841,863,25,100,0.01,1704,18
0.984,0.0001,895,909,25,100,0.01,1804,18
0.982,0.0001,945,959,25,100,0.01,1904,18
0.992,0.0001,995,1009,25,100,0.01,2004,18
0.532,0.0001,54,50,25,100,0.01,104,19
0.538,0.0001,102,102,25,100,0.01,204,19
0.546,0.0001,156,148,25,100,0.01,304,19
0.578,0.0001,212,192,25,100,0.01,404,19
0.592,0.0001,252,252,25,100,0.01,504,19
0.674,0.0001,299,305,25,100,0.01,604,19
0.726,0.0001,339,365,25,100,0.01,704,19
0.808,0.0001,392,412,25,100,0.01,804,19
0.854,0.0001,438,466,25,100,0.01,904,19
0.928,0.0001,487,517,25,100,0.01,1004,19
0.958,0.0001,546,558,25,100,0.01,1104,19
0.956,0.0001,592,612,25,100,0.01,1204,19
0.984,0.0001,640,664,25,100,0.01,1304,19
0.972,0.0001,677,727,25,100,0.01,1404,19
0.978,0.0001,737,767,25,100,0.01,1504,19
0.984,0.0001,791,813,25,100,0.01,1604,19
0.99,0.0001,842,862,25,100,0.01,1704,19
0.996,0.0001,900,904,25,100,0.01,1804,19
0.992,0.0001,954,950,25,100,0.01,1904,19
0.994,0.0001,1008,996,25,100,0.01,2004,19
0.51,0.0001,47,57,25,100,0.01,104,20
0.546,0.0001,97,107,25,100,0.01,204,20
0.57,0.0001,154,150,25,100,0.01,304,20
0.602,0.0001,207,197,25,100,0.01,404,20
0.62,0.0001,248,256,25,100,0.01,504,20
0.72,0.0001,297,307,25,100,0.01,604,20
0.768,0.0001,348,356,25,100,0.01,704,20
0.836,0.0001,394,410,25,100,0.01,804,20
0.886,0.0001,443,461,25,100,0.01,904,20
0.926,0.0001,499,505,25,100,0.01,1004,20
0.946,0.0001,553,551,25,100,0.01,1104,20
0.95,0.0001,601,603,25,100,0.01,1204,20
0.95,0.0001,651,653,25,100,0.01,1304,20
0.97,0.0001,710,694,25,100,0.01,1404,20
0.974,0.0001,757,747,25,100,0.01,1504,20
0.982,0.0001,808,796,25,100,0.01,1604,20
0.986,0.0001,857,847,25,100,0.01,1704,20
0.986,0.0001,902,902,25,100,0.01,1804,20
0.99,0.0001,954,950,25,100,0.01,1904,20
0.994,0.0001,999,1005,25,100,0.01,2004,20
0.486,0.001,50,54,25,100,0.0001,104,1
0.486,0.001,95,109,25,100,0.0001,204,1
0.488,0.001,137,167,25,100,0.0001,304,1
0.486,0.001,179,225,25,100,0.0001,404,1
0.486,0.001,240,264,25,100,0.0001,504,1
0.486,0.001,288,316,25,100,0.0001,604,1
0.486,0.001,339,365,25,100,0.0001,704,1
0.486,0.001,383,421,25,100,0.0001,804,1
0.486,0.001,434,470,25,100,0.0001,904,1
0.486,0.001,490,514,25,100,0.0001,1004,1
0.484,0.001,546,558,25,100,0.0001,1104,1
0.484,0.001,599,605,25,100,0.0001,1204,1
0.484,0.001,642,662,25,100,0.0001,1304,1
0.482,0.001,689,715,25,100,0.0001,1404,1
0.48,0.001,725,779,25,100,0.0001,1504,1
0.48,0.001,780,824,25,100,0.0001,1604,1
0.484,0.001,831,873,25,100,0.0001,1704,1
0.484,0.001,887,917,25,100,0.0001,1804,1
0.488,0.001,945,959,25,100,0.0001,1904,1
0.49,0.001,998,1006,25,100,0.0001,2004,1
0.47,0.001,51,53,25,100,0.0001,104,2
0.47,0.001,95,109,25,100,0.0001,204,2
0.47,0.001,148,156,25,100,0.0001,304,2
0.47,0.001,200,204,25,100,0.0001,404,2
0.472,0.001,246,258,25,100,0.0001,504,2
0.472,0.001,292,312,25,100,0.0001,604,2
0.472,0.001,338,366,25,100,0.0001,704,2
0.472,0.001,388,416,25,100,0.0001,804,2
0.472,0.001,437,467,25,100,0.0001,904,2
0.474,0.001,494,510,25,100,0.0001,1004,2
0.474,0.001,548,556,25,100,0.0001,1104,2
0.472,0.001,593,611,25,100,0.0001,1204,2
0.472,0.001,651,653,25,100,0.0001,1304,2
0.472,0.001,700,704,25,100,0.0001,1404,2
0.472,0.001,748,756,25,100,0.0001,1504,2
0.476,0.001,789,815,25,100,0.0001,1604,2
0.476,0.001,843,861,25,100,0.0001,1704,2
0.476,0.001,885,919,25,100,0.0001,1804,2
0.48,0.001,936,968,25,100,0.0001,1904,2
0.482,0.001,985,1019,25,100,0.0001,2004,2
0.504,0.001,59,45,25,100,0.0001,104,3
0.506,0.001,107,97,25,100,0.0001,204,3
0.506,0.001,155,149,25,100,0.0001,304,3
0.504,0.001,197,207,25,100,0.0001,404,3
0.504,0.001,245,259,25,100,0.0001,504,3
0.502,0.001,287,317,25,100,0.0001,604,3
0.504,0.001,334,370,25,100,0.0001,704,3
0.504,0.001,385,419,25,100,0.0001,804,3
0.502,0.001,442,462,25,100,0.0001,904,3
0.502,0.001,488,516,25,100,0.0001,1004,3
0.504,0.001,540,564,25,100,0.0001,1104,3
0.5,0.001,585,619,25,100,0.0001,1204,3
0.498,0.001,629,675,25,100,0.0001,1304,3
0.5,0.001,683,721,25,100,0.0001,1404,3
0.502,0.001,739,765,25,100,0.0001,1504,3
0.506,0.001,786,818,25,100,0.0001,1604,3
0.508,0.001,836,868,25,100,0.0001,1704,3
0.508,0.001,888,916,25,100,0.0001,1804,3
0.51,0.001,935,969,25,100,0.0001,1904,3
0.51,0.001,997,1007,25,100,0.0001,2004,3
0.47,0.001,53,51,25,100,0.0001,104,4
0.472,0.001,102,102,25,100,0.0001,204,4
0.474,0.001,138,166,25,100,0.0001,304,4
0.48,0.001,195,209,25,100,0.0001,404,4
0.48,0.001,243,261,25,100,0.0001,504,4
0.482,0.001,284,320,25,100,0.0001,604,4
0.484,0.001,329,375,25,100,0.0001,704,4
0.484,0.001,382,422,25,100,0.0001,804,4
0.486,0.001,432,472,25,100,0.0001,904,4
0.49,0.001,489,515,25,100,0.0001,1004,4
0.494,0.001,534,570,25,100,0.0001,1104,4
0.494,0.001,591,613,25,100,0.0001,1204,4
0.496,0.001,643,661,25,100,0.0001,1304,4
0.496,0.001,691,713,25,100,0.0001,1404,4
0.498,0.001,744,760,25,100,0.0001,1504,4
0.5,0.001,795,809,25,100,0.0001,1604,4
0.51,0.001,847,857,25,100,0.0001,1704,4
0.514,0.001,894,910,25,100,0.0001,1804,4
0.522,0.001,942,962,25,100,0.0001,1904,4
0.526,0.001,991,1013,25,100,0.0001,2004,4
0.494,0.001,59,45,25,100,0.0001,104,5
0.494,0.001,99,105,25,100,0.0001,204,5
0.494,0.001,158,146,25,100,0.0001,304,5
0.5,0.001,213,191,25,100,0.0001,404,5
0.496,0.001,264,240,25,100,0.0001,504,5
0.496,0.001,315,289,25,100,0.0001,604,5
0.498,0.001,373,331,25,100,0.0001,704,5
0.496,0.001,419,385,25,100,0.0001,804,5
0.498,0.001,470,434,25,100,0.0001,904,5
0.504,0.001,515,489,25,100,0.0001,1004,5
0.508,0.001,569,535,25,100,0.0001,1104,5
0.514,0.001,613,591,25,100,0.0001,1204,5
0.518,0.001,655,649,25,100,0.0001,1304,5
0.524,0.001,712,692,25,100,0.0001,1404,5
0.528,0.001,765,739,25,100,0.0001,1504,5
0.528,0.001,807,797,25,100,0.0001,1604,5
0.538,0.001,846,858,25,100,0.0001,1704,5
0.538,0.001,894,910,25,100,0.0001,1804,5
0.536,0.001,935,969,25,100,0.0001,1904,5
0.548,0.001,985,1019,25,100,0.0001,2004,5
0.474,0.001,53,51,25,100,0.0001,104,6
0.47,0.001,100,104,25,100,0.0001,204,6
0.47,0.001,138,166,25,100,0.0001,304,6
0.472,0.001,198,206,25,100,0.0001,404,6
0.474,0.001,249,255,25,100,0.0001,504,6
0.472,0.001,305,299,25,100,0.0001,604,6
0.478,0.001,358,346,25,100,0.0001,704,6
0.474,0.001,408,396,25,100,0.0001,804,6
0.47,0.001,466,438,25,100,0.0001,904,6
0.472,0.001,509,495,25,100,0.0001,1004,6
0.478,0.001,556,548,25,100,0.0001,1104,6
0.474,0.001,615,589,25,100,0.0001,1204,6
0.476,0.001,665,639,25,100,0.0001,1304,6
0.482,0.001,708,696,25,100,0.0001,1404,6
0.482,0.001,765,739,25,100,0.0001,1504,6
0.484,0.001,816,788,25,100,0.0001,1604,6
0.498,0.001,860,844,25,100,0.0001,1704,6
0.502,0.001,908,896,25,100,0.0001,1804,6
0.516,0.001,957,947,25,100,0.0001,1904,6
0.516,0.001,1000,1004,25,100,0.0001,2004,6
0.538,0.001,55,49,25,100,0.0001,104,7
0.538,0.001,104,100,25,100,0.0001,204,7
0.54,0.001,154,150,25,100,0.0001,304,7
0.538,0.001,205,199,25,100,0.0001,404,7
0.54,0.001,257,247,25,100,0.0001,504,7
0.542,0.001,302,302,25,100,0.0001,604,7
0.544,0.001,362,342,25,100,0.0001,704,7
0.546,0.001,419,385,25,100,0.0001,804,7
0.544,0.001,472,432,25,100,0.0001,904,7
0.546,0.001,525,479,25,100,0.0001,1004,7
0.548,0.001,571,533,25,100,0.0001,1104,7
0.548,0.001,627,577,25,100,0.0001,1204,7
0.55,0.001,672,632,25,100,0.0001,1304,7
0.554,0.001,716,688,25,100,0.0001,1404,7
0.57,0.001,758,746,25,100,0.0001,1504,7
0.568,0.001,811,793,25,100,0.0001,1604,7
0.572,0.001,861,843,25,100,0.0001,1704,7
0.576,0.001,916,888,25,100,0.0001,1804,7
0.582,0.001,969,935,25,100,0.0001,1904,7
0.586,0.001,1014,990,25,100,0.0001,2004,7
0.524,0.001,51,53,25,100,0.0001,104,8
0.526,0.001,106,98,25,100,0.0001,204,8
0.526,0.001,162,142,25,100,0.0001,304,8
0.528,0.001,213,191,25,100,0.0001,404,8
0.528,0.001,271,233,25,100,0.0001,504,8
0.528,0.001,326,278,25,100,0.0001,604,8
0.53,0.001,370,334,25,100,0.0001,704,8
0.532,0.001,424,380,25,100,0.0001,804,8
0.532,0.001,470,434,25,100,0.0001,904,8
0.534,0.001,520,484,25,100,0.0001,1004,8
0.536,0.001,560,544,25,100,0.0001,1104,8
0.538,0.001,606,598,25,100,0.0001,1204,8
0.54,0.001,662,642,25,100,0.0001,1304,8
0.54,0.001,708,696,25,100,0.0001,1404,8
0.542,0.001,759,745,25,100,0.0001,1504,8
0.542,0.001,807,797,25,100,0.0001,1604,8
0.546,0.001,851,853,25,100,0.0001,1704,8
0.546,0.001,901,903,25,100,0.0001,1804,8
0.55,0.001,946,958,25,100,0.0001,1904,8
0.56,0.001,996,1008,25,100,0.0001,2004,8
0.484,0.001,43,61,25,100,0.0001,104,9
0.484,0.001,89,115,25,100,0.0001,204,9
0.482,0.001,147,157,25,100,0.0001,304,9
0.48,0.001,207,197,25,100,0.0001,404,9
0.48,0.001,251,253,25,100,0.0001,504,9
0.48,0.001,304,300,25,100,0.0001,604,9
0.484,0.001,350,354,25,100,0.0001,704,9
0.488,0.001,403,401,25,100,0.0001,804,9
0.486,0.001,448,456,25,100,0.0001,904,9
0.488,0.001,488,516,25,100,0.0001,1004,9
0.49,0.001,541,563,25,100,0.0001,1104,9
0.492,0.001,595,609,25,100,0.0001,1204,9
0.492,0.001,636,668,25,100,0.0001,1304,9
0.494,0.001,687,717,25,100,0.0001,1404,9
0.498,0.001,736,768,25,100,0.0001,1504,9
0.502,0.001,789,815,25,100,0.0001,1604,9
0.502,0.001,841,863,25,100,0.0001,1704,9
0.506,0.001,891,913,25,100,0.0001,1804,9
0.504,0.001,940,964,25,100,0.0001,1904,9
0.518,0.001,994,1010,25,100,0.0001,2004,9
0.434,0.001,58,46,25,100,0.0001,104,10
0.434,0.001,105,99,25,100,0.0001,204,10
0.434,0.001,162,142,25,100,0.0001,304,10
0.434,0.001,203,201,25,100,0.0001,404,10
0.442,0.001,251,253,25,100,0.0001,504,10
0.44,0.001,307,297,25,100,0.0001,604,10
0.44,0.001,362,342,25,100,0.0001,704,10
0.444,0.001,405,399,25,100,0.0001,804,10
0.444,0.001,450,454,25,100,0.0001,904,10
0.448,0.001,493,511,25,100,0.0001,1004,10
0.454,0.001,548,556,25,100,0.0001,1104,10
0.456,0.001,594,610,25,100,0.0001,1204,10
0.456,0.001,641,663,25,100,0.0001,1304,10
0.458,0.001,696,708,25,100,0.0001,1404,10
0.458,0.001,748,756,25,100,0.0001,1504,10
0.46,0.001,805,799,25,100,0.0001,1604,10
0.472,0.001,858,846,25,100,0.0001,1704,10
0.474,0.001,901,903,25,100,0.0001,1804,10
0.474,0.001,951,953,25,100,0.0001,1904,10
0.482,0.001,1000,1004,25,100,0.0001,2004,10
0.47,0.001,49,55,25,100,0.0001,104,11
0.472,0.001,100,104,25,100,0.0001,204,11
0.47,0.001,151,153,25,100,0.0001,304,11
0.474,0.001,206,198,25,100,0.0001,404,11
0.476,0.001,256,248,25,100,0.0001,504,11
0.476,0.001,307,297,25,100,0.0001,604,11
0.476,0.001,349,355,25,100,0.0001,704,11
0.482,0.001,401,403,25,100,0.0001,804,11
0.482,0.001,458,446,25,100,0.0001,904,11
0.484,0.001,499,505,25,100,0.0001,1004,11
0.49,0.001,547,557,25,100,0.0001,1104,11
0.492,0.001,599,605,25,100,0.0001,1204,11
0.494,0.001,653,651,25,100,0.0001,1304,11
0.498,0.001,709,695,25,100,0.0001,1404,11
0.498,0.001,759,745,25,100,0.0001,1504,11
0.502,0.001,812,792,25,100,0.0001,1604,11
0.504,0.001,867,837,25,100,0.0001,1704,11
0.508,0.001,917,887,25,100,0.0001,1804,11
0.51,0.001,958,946,25,100,0.0001,1904,11
0.512,0.001,1001,1003,25,100,0.0001,2004,11
0.484,0.001,55,49,25,100,0.0001,104,12
0.484,0.001,106,98,25,100,0.0001,204,12
0.484,0.001,158,146,25,100,0.0001,304,12
0.486,0.001,216,188,25,100,0.0001,404,12
0.488,0.001,263,241,25,100,0.0001,504,12
0.496,0.001,316,288,25,100,0.0001,604,12
0.5,0.001,370,334,25,100,0.0001,704,12
0.504,0.001,423,381,25,100,0.0001,804,12
0.504,0.001,472,432,25,100,0.0001,904,12
0.508,0.001,517,487,25,100,0.0001,1004,12
0.51,0.001,569,535,25,100,0.0001,1104,12
0.516,0.001,626,578,25,100,0.0001,1204,12
0.518,0.001,670,634,25,100,0.0001,1304,12
0.524,0.001,706,698,25,100,0.0001,1404,12
0.532,0.001,753,751,25,100,0.0001,1504,12
0.534,0.001,799,805,25,100,0.0001,1604,12
0.54,0.001,850,854,25,100,0.0001,1704,12
0.538,0.001,897,907,25,100,0.0001,1804,12
0.542,0.001,950,954,25,100,0.0001,1904,12
0.54,0.001,1007,997,25,100,0.0001,2004,12
0.504,0.001,44,60,25,100,0.0001,104,13
0.506,0.001,91,113,25,100,0.0001,204,13
0.506,0.001,144,160,25,100,0.0001,304,13
0.504,0.001,194,210,25,100,0.0001,404,13
0.504,0.001,240,264,25,100,0.0001,504,13
0.504,0.001,287,317,25,100,0.0001,604,13
0.504,0.001,336,368,25,100,0.0001,704,13
0.504,0.001,393,411,25,100,0.0001,804,13
0.506,0.001,439,465,25,100,0.0001,904,13
0.5,0.001,495,509,25,100,0.0001,1004,13
0.5,0.001,548,556,25,100,0.0001,1104,13
0.498,0.001,598,606,25,100,0.0001,1204,13
0.5,0.001,652,652,25,100,0.0001,1304,13
0.498,0.001,699,705,25,100,0.0001,1404,13
0.492,0.001,758,746,25,100,0.0001,1504,13
0.492,0.001,809,795,25,100,0.0001,1604,13
0.498,0.001,858,846,25,100,0.0001,1704,13
0.504,0.001,901,903,25,100,0.0001,1804,13
0.514,0.001,948,956,25,100,0.0001,1904,13
0.514,0.001,1004,1000,25,100,0.0001,2004,13
0.53,0.001,49,55,25,100,0.0001,104,14
0.534,0.001,94,110,25,100,0.0001,204,14
0.534,0.001,145,159,25,100,0.0001,304,14
0.536,0.001,196,208,25,100,0.0001,404,14
0.536,0.001,239,265,25,100,0.0001,504,14
0.538,0.001,290,314,25,100,0.0001,604,14
0.54,0.001,336,368,25,100,0.0001,704,14
0.542,0.001,391,413,25,100,0.0001,804,14
0.544,0.001,441,463,25,100,0.0001,904,14
0.542,0.001,490,514,25,100,0.0001,1004,14
0.542,0.001,539,565,25,100,0.0001,1104,14
0.542,0.001,587,617,25,100,0.0001,1204,14
0.544,0.001,638,666,25,100,0.0001,1304,14
0.548,0.001,690,714,25,100,0.0001,1404,14
0.55,0.001,739,765,25,100,0.0001,1504,14
0.556,0.001,791,813,25,100,0.0001,1604,14
0.558,0.001,848,856,25,100,0.0001,1704,14
0.56,0.001,899,905,25,100,0.0001,1804,14
0.568,0.001,949,955,25,100,0.0001,1904,14
0.572,0.001,1002,1002,25,100,0.0001,2004,14
0.528,0.001,54,50,25,100,0.0001,104,15
0.528,0.001,109,95,25,100,0.0001,204,15
0.528,0.001,154,150,25,100,0.0001,304,15
0.53,0.001,206,198,25,100,0.0001,404,15
0.528,0.001,254,250,25,100,0.0001,504,15
0.536,0.001,297,307,25,100,0.0001,604,15
0.534,0.001,339,365,25,100,0.0001,704,15
0.532,0.001,391,413,25,100,0.0001,804,15
0.532,0.001,444,460,25,100,0.0001,904,15
0.534,0.001,499,505,25,100,0.0001,1004,15
0.532,0.001,547,557,25,100,0.0001,1104,15
0.536,0.001,593,611,25,100,0.0001,1204,15
0.538,0.001,644,660,25,100,0.0001,1304,15
0.55,0.001,695,709,25,100,0.0001,1404,15
0.552,0.001,743,761,25,100,0.0001,1504,15
0.556,0.001,797,807,25,100,0.0001,1604,15
0.558,0.001,845,859,25,100,0.0001,1704,15
0.558,0.001,896,908,25,100,0.0001,1804,15
0.554,0.001,950,954,25,100,0.0001,1904,15
0.562,0.001,985,1019,25,100,0.0001,2004,15
0.504,0.001,45,59,25,100,0.0001,104,16
0.504,0.001,92,112,25,100,0.0001,204,16
0.504,0.001,136,168,25,100,0.0001,304,16
0.506,0.001,188,216,25,100,0.0001,404,16
0.506,0.001,234,270,25,100,0.0001,504,16
0.51,0.001,282,322,25,100,0.0001,604,16
0.51,0.001,340,364,25,100,0.0001,704,16
0.512,0.001,392,412,25,100,0.0001,804,16
0.512,0.001,443,461,25,100,0.0001,904,16
0.516,0.001,489,515,25,100,0.0001,1004,16
0.518,0.001,533,571,25,100,0.0001,1104,16
0.526,0.001,584,620,25,100,0.0001,1204,16
0.532,0.001,635,669,25,100,0.0001,1304,16
0.532,0.001,692,712,25,100,0.0001,1404,16
0.534,0.001,741,763,25,100,0.0001,1504,16
0.536,0.001,797,807,25,100,0.0001,1604,16
0.544,0.001,840,864,25,100,0.0001,1704,16
0.542,0.001,886,918,25,100,0.0001,1804,16
0.544,0.001,939,965,25,100,0.0001,1904,16
0.546,0.001,985,1019,25,100,0.0001,2004,16
0.502,0.001,61,43,25,100,0.0001,104,17
0.504,0.001,105,99,25,100,0.0001,204,17
0.504,0.001,153,151,25,100,0.0001,304,17
0.504,0.001,197,207,25,100,0.0001,404,17
0.502,0.001,247,257,25,100,0.0001,504,17
0.506,0.001,291,313,25,100,0.0001,604,17
0.508,0.001,342,362,25,100,0.0001,704,17
0.51,0.001,393,411,25,100,0.0001,804,17
0.51,0.001,443,461,25,100,0.0001,904,17
0.512,0.001,481,523,25,100,0.0001,1004,17
0.512,0.001,533,571,25,100,0.0001,1104,17
0.522,0.001,585,619,25,100,0.0001,1204,17
0.524,0.001,631,673,25,100,0.0001,1304,17
0.522,0.001,682,722,25,100,0.0001,1404,17
0.528,0.001,731,773,25,100,0.0001,1504,17
0.536,0.001,783,821,25,100,0.0001,1604,17
0.544,0.001,840,864,25,100,0.0001,1704,17
0.546,0.001,895,909,25,100,0.0001,1804,17
0.548,0.001,946,958,25,100,0.0001,1904,17
0.548,0.001,1000,1004,25,100,0.0001,2004,17
0.496,0.001,61,43,25,100,0.0001,104,18
0.49,0.001,115,89,25,100,0.0001,204,18
0.49,0.001,172,132,25,100,0.0001,304,18
0.498,0.001,226,178,25,100,0.0001,404,18
0.496,0.001,272,232,25,100,0.0001,504,18
0.5,0.001,323,281,25,100,0.0001,604,18
0.492,0.001,376,328,25,100,0.0001,704,18
0.492,0.001,426,378,25,100,0.0001,804,18
0.488,0.001,474,430,25,100,0.0001,904,18
0.49,0.001,521,483,25,100,0.0001,1004,18
0.494,0.001,575,529,25,100,0.0001,1104,18
0.498,0.001,614,590,25,100,0.0001,1204,18
0.506,0.001,665,639,25,100,0.0001,1304,18
0.512,0.001,711,693,25,100,0.0001,1404,18
0.516,0.001,761,743,25,100,0.0001,1504,18
0.526,0.001,805,799,25,100,0.0001,1604,18
0.524,0.001,855,849,25,100,0.0001,1704,18
0.528,0.001,903,901,25,100,0.0001,1804,18
0.536,0.001,952,952,25,100,0.0001,1904,18
0.55,0.001,1009,995,25,100,0.0001,2004,18
0.472,0.001,53,51,25,100,0.0001,104,19
0.472,0.001,115,89,25,100,0.0001,204,19
0.468,0.001,167,137,25,100,0.0001,304,19
0.474,0.001,215,189,25,100,0.0001,404,19
0.476,0.001,261,243,25,100,0.0001,504,19
0.474,0.001,315,289,25,100,0.0001,604,19
0.468,0.001,360,344,25,100,0.0001,704,19
0.472,0.001,411,393,25,100,0.0001,804,19
0.472,0.001,453,451,25,100,0.0001,904,19
0.472,0.001,500,504,25,100,0.0001,1004,19
0.476,0.001,547,557,25,100,0.0001,1104,19
0.476,0.001,595,609,25,100,0.0001,1204,19
0.478,0.001,642,662,25,100,0.0001,1304,19
0.48,0.001,696,708,25,100,0.0001,1404,19
0.482,0.001,749,755,25,100,0.0001,1504,19
0.482,0.001,800,804,25,100,0.0001,1604,19
0.498,0.001,847,857,25,100,0.0001,1704,19
0.498,0.001,901,903,25,100,0.0001,1804,19
0.51,0.001,951,953,25,100,0.0001,1904,19
0.516,0.001,1000,1004,25,100,0.0001,2004,19
0.526,0.001,47,57,25,100,0.0001,104,20
0.524,0.001,96,108,25,100,0.0001,204,20
0.526,0.001,146,158,25,100,0.0001,304,20
0.53,0.001,200,204,25,100,0.0001,404,20
0.53,0.001,253,251,25,100,0.0001,504,20
0.532,0.001,305,299,25,100,0.0001,604,20
0.534,0.001,350,354,25,100,0.0001,704,20
0.532,0.001,402,402,25,100,0.0001,804,20
0.53,0.001,448,456,25,100,0.0001,904,20
0.536,0.001,494,510,25,100,0.0001,1004,20
0.546,0.001,538,566,25,100,0.0001,1104,20
0.552,0.001,583,621,25,100,0.0001,1204,20
0.564,0.001,639,665,25,100,0.0001,1304,20
0.562,0.001,688,716,25,100,0.0001,1404,20
0.57,0.001,746,758,25,100,0.0001,1504,20
0.57,0.001,794,810,25,100,0.0001,1604,20
0.58,0.001,836,868,25,100,0.0001,1704,20
0.582,0.001,887,917,25,100,0.0001,1804,20
0.6,0.001,946,958,25,100,0.0001,1904,20
0.61,0.001,992,1012,25,100,0.0001,2004,20
0.492,0.001,53,51,25,100,0.001,104,1
0.498,0.001,104,100,25,100,0.001,204,1
0.504,0.001,149,155,25,100,0.001,304,1
0.504,0.001,203,201,25,100,0.001,404,1
0.518,0.001,259,245,25,100,0.001,504,1
0.54,0.001,306,298,25,100,0.001,604,1
0.568,0.001,354,350,25,100,0.001,704,1
0.586,0.001,401,403,25,100,0.001,804,1
0.614,0.001,454,450,25,100,0.001,904,1
0.664,0.001,508,496,25,100,0.001,1004,1
0.682,0.001,559,545,25,100,0.001,1104,1
0.724,0.001,611,593,25,100,0.001,1204,1
0.746,0.001,654,650,25,100,0.001,1304,1
0.764,0.001,705,699,25,100,0.001,1404,1
0.774,0.001,748,756,25,100,0.001,1504,1
0.788,0.001,792,812,25,100,0.001,1604,1
0.804,0.001,840,864,25,100,0.001,1704,1
0.822,0.001,884,920,25,100,0.001,1804,1
0.838,0.001,935,969,25,100,0.001,1904,1
0.864,0.001,986,1018,25,100,0.001,2004,1
0.5,0.001,52,52,25,100,0.001,104,2
0.502,0.001,102,102,25,100,0.001,204,2
0.518,0.001,151,153,25,100,0.001,304,2
0.534,0.001,206,198,25,100,0.001,404,2
0.542,0.001,252,252,25,100,0.001,504,2
0.546,0.001,306,298,25,100,0.001,604,2
0.558,0.001,353,351,25,100,0.001,704,2
0.576,0.001,400,404,25,100,0.001,804,2
0.6,0.001,452,452,25,100,0.001,904,2
0.628,0.001,504,500,25,100,0.001,1004,2
0.644,0.001,553,551,25,100,0.001,1104,2
0.684,0.001,607,597,25,100,0.001,1204,2
0.704,0.001,656,648,25,100,0.001,1304,2
0.736,0.001,703,701,25,100,0.001,1404,2
0.76,0.001,746,758,25,100,0.001,1504,2
0.778,0.001,801,803,25,100,0.001,1604,2
0.814,0.001,847,857,25,100,0.001,1704,2
0.832,0.001,904,900,25,100,0.001,1804,2
0.844,0.001,952,952,25,100,0.001,1904,2
0.854,0.001,1008,996,25,100,0.001,2004,2
0.518,0.001,57,47,25,100,0.001,104,3
0.532,0.001,110,94,25,100,0.001,204,3
0.554,0.001,158,146,25,100,0.001,304,3
0.562,0.001,204,200,25,100,0.001,404,3
0.56,0.001,265,239,25,100,0.001,504,3
0.572,0.001,315,289,25,100,0.001,604,3
0.588,0.001,362,342,25,100,0.001,704,3
0.606,0.001,408,396,25,100,0.001,804,3
0.638,0.001,467,437,25,100,0.001,904,3
0.664,0.001,514,490,25,100,0.001,1004,3
0.68,0.001,564,540,25,100,0.001,1104,3
0.698,0.001,613,591,25,100,0.001,1204,3
0.708,0.001,654,650,25,100,0.001,1304,3
0.728,0.001,709,695,25,100,0.001,1404,3
0.766,0.001,754,750,25,100,0.001,1504,3
0.8,0.001,805,799,25,100,0.001,1604,3
0.802,0.001,852,852,25,100,0.001,1704,3
0.832,0.001,900,904,25,100,0.001,1804,3
0.842,0.001,957,947,25,100,0.001,1904,3
0.856,0.001,1009,995,25,100,0.001,2004,3
0.524,0.001,49,55,25,100,0.001,104,4
0.526,0.001,109,95,25,100,0.001,204,4
0.526,0.001,166,138,25,100,0.001,304,4
0.54,0.001,225,179,25,100,0.001,404,4
0.548,0.001,277,227,25,100,0.001,504,4
0.538,0.001,331,273,25,100,0.001,604,4
0.55,0.001,378,326,25,100,0.001,704,4
0.562,0.001,425,379,25,100,0.001,804,4
0.576,0.001,472,432,25,100,0.001,904,4
0.606,0.001,530,474,25,100,0.001,1004,4
0.638,0.001,574,530,25,100,0.001,1104,4
0.666,0.001,624,580,25,100,0.001,1204,4
0.68,0.001,681,623,25,100,0.001,1304,4
0.704,0.001,732,672,25,100,0.001,1404,4
0.736,0.001,786,718,25,100,0.001,1504,4
0.78,0.001,834,770,25,100,0.001,1604,4
0.79,0.001,886,818,25,100,0.001,1704,4
0.82,0.001,923,881,25,100,0.001,1804,4
0.872,0.001,970,934,25,100,0.001,1904,4
0.888,0.001,1017,987,25,100,0.001,2004,4
0.516,0.001,48,56,25,100,0.001,104,5
0.524,0.001,95,109,25,100,0.001,204,5
0.524,0.001,153,151,25,100,0.001,304,5
0.546,0.001,206,198,25,100,0.001,404,5
0.536,0.001,245,259,25,100,0.001,504,5
0.54,0.001,295,309,25,100,0.001,604,5
0.55,0.001,350,354,25,100,0.001,704,5
0.556,0.001,402,402,25,100,0.001,804,5
0.578,0.001,449,455,25,100,0.001,904,5
0.604,0.001,498,506,25,100,0.001,1004,5
0.63,0.001,542,562,25,100,0.001,1104,5
0.644,0.001,601,603,25,100,0.001,1204,5
0.662,0.001,652,652,25,100,0.001,1304,5
0.678,0.001,701,703,25,100,0.001,1404,5
0.686,0.001,753,751,25,100,0.001,1504,5
0.712,0.001,804,800,25,100,0.001,1604,5
0.748,0.001,855,849,25,100,0.001,1704,5
0.772,0.001,905,899,25,100,0.001,1804,5
0.81,0.001,962,942,25,100,0.001,1904,5
0.836,0.001,1003,1001,25,100,0.001,2004,5
0.526,0.001,57,47,25,100,0.001,104,6
0.542,0.001,102,102,25,100,0.001,204,6
0.552,0.001,160,144,25,100,0.001,304,6
0.566,0.001,210,194,25,100,0.001,404,6
0.572,0.001,254,250,25,100,0.001,504,6
0.594,0.001,307,297,25,100,0.001,604,6
0.586,0.001,364,340,25,100,0.001,704,6
0.612,0.001,414,390,25,100,0.001,804,6
0.64,0.001,458,446,25,100,0.001,904,6
0.668,0.001,503,501,25,100,0.001,1004,6
0.686,0.001,554,550,25,100,0.001,1104,6
0.706,0.001,603,601,25,100,0.001,1204,6
0.734,0.001,653,651,25,100,0.001,1304,6
0.744,0.001,704,700,25,100,0.001,1404,6
0.768,0.001,752,752,25,100,0.001,1504,6
0.798,0.001,804,800,25,100,0.001,1604,6
0.818,0.001,853,851,25,100,0.001,1704,6
0.836,0.001,898,906,25,100,0.001,1804,6
0.866,0.001,946,958,25,100,0.001,1904,6
0.88,0.001,999,1005,25,100,0.001,2004,6
0.48,0.001,54,50,25,100,0.001,104,7
0.488,0.001,117,87,25,100,0.001,204,7
0.492,0.001,163,141,25,100,0.001,304,7
0.494,0.001,219,185,25,100,0.001,404,7
0.5,0.001,274,230,25,100,0.001,504,7
0.51,0.001,319,285,25,100,0.001,604,7
0.51,0.001,360,344,25,100,0.001,704,7
0.538,0.001,407,397,25,100,0.001,804,7
0.556,0.001,456,448,25,100,0.001,904,7
0.574,0.001,510,494,25,100,0.001,1004,7
0.588,0.001,558,546,25,100,0.001,1104,7
0.636,0.001,607,597,25,100,0.001,1204,7
0.648,0.001,658,646,25,100,0.001,1304,7
0.688,0.001,709,695,25,100,0.001,1404,7
0.716,0.001,760,744,25,100,0.001,1504,7
0.734,0.001,807,797,25,100,0.001,1604,7
0.75,0.001,855,849,25,100,0.001,1704,7
0.784,0.001,899,905,25,100,0.001,1804,7
0.796,0.001,949,955,25,100,0.001,1904,7
0.826,0.001,992,1012,25,100,0.001,2004,7
0.502,0.001,48,56,25,100,0.001,104,8
0.508,0.001,102,102,25,100,0.001,204,8
0.51,0.001,157,147,25,100,0.001,304,8
0.528,0.001,200,204,25,100,0.001,404,8
0.536,0.001,250,254,25,100,0.001,504,8
0.552,0.001,297,307,25,100,0.001,604,8
0.55,0.001,355,349,25,100,0.001,704,8
0.566,0.001,398,406,25,100,0.001,804,8
0.608,0.001,444,460,25,100,0.001,904,8
0.634,0.001,507,497,25,100,0.001,1004,8
0.658,0.001,559,545,25,100,0.001,1104,8
0.676,0.001,615,589,25,100,0.001,1204,8
0.674,0.001,667,637,25,100,0.001,1304,8
0.692,0.001,719,685,25,100,0.001,1404,8
0.694,0.001,774,730,25,100,0.001,1504,8
0.728,0.001,823,781,25,100,0.001,1604,8
0.75,0.001,874,830,25,100,0.001,1704,8
0.776,0.001,921,883,25,100,0.001,1804,8
0.8,0.001,972,932,25,100,0.001,1904,8
0.822,0.001,1009,995,25,100,0.001,2004,8
0.528,0.001,56,48,25,100,0.001,104,9
0.528,0.001,96,108,25,100,0.001,204,9
0.522,0.001,134,170,25,100,0.001,304,9
0.52,0.001,187,217,25,100,0.001,404,9
0.532,0.001,238,266,25,100,0.001,504,9
0.534,0.001,289,315,25,100,0.001,604,9
0.548,0.001,341,363,25,100,0.001,704,9
0.56,0.001,389,415,25,100,0.001,804,9
0.566,0.001,440,464,25,100,0.001,904,9
0.602,0.001,494,510,25,100,0.001,1004,9
0.624,0.001,544,560,25,100,0.001,1104,9
0.648,0.001,591,613,25,100,0.001,1204,9
0.682,0.001,631,673,25,100,0.001,1304,9
0.71,0.001,680,724,25,100,0.001,1404,9
0.728,0.001,737,767,25,100,0.001,1504,9
0.752,0.001,788,816,25,100,0.001,1604,9
0.778,0.001,843,861,25,100,0.001,1704,9
0.806,0.001,886,918,25,100,0.001,1804,9
0.816,0.001,942,962,25,100,0.001,1904,9
0.838,0.001,998,1006,25,100,0.001,2004,9
0.574,0.001,48,56,25,100,0.001,104,10
0.576,0.001,103,101,25,100,0.001,204,10
0.582,0.001,149,155,25,100,0.001,304,10
0.594,0.001,197,207,25,100,0.001,404,10
0.604,0.001,249,255,25,100,0.001,504,10
0.618,0.001,295,309,25,100,0.001,604,10
0.63,0.001,342,362,25,100,0.001,704,10
0.646,0.001,387,417,25,100,0.001,804,10
0.658,0.001,434,470,25,100,0.001,904,10
0.686,0.001,489,515,25,100,0.001,1004,10
0.698,0.001,542,562,25,100,0.001,1104,10
0.71,0.001,591,613,25,100,0.001,1204,10
0.726,0.001,647,657,25,100,0.001,1304,10
0.738,0.001,697,707,25,100,0.001,1404,10
0.754,0.001,745,759,25,100,0.001,1504,10
0.778,0.001,796,808,25,100,0.001,1604,10
0.8,0.001,853,851,25,100,0.001,1704,10
0.82,0.001,903,901,25,100,0.001,1804,10
0.832,0.001,944,960,25,100,0.001,1904,10
0.854,0.001,991,1013,25,100,0.001,2004,10
0.516,0.001,48,56,25,100,0.001,104,11
0.518,0.001,95,109,25,100,0.001,204,11
0.512,0.001,150,154,25,100,0.001,304,11
0.524,0.001,203,201,25,100,0.001,404,11
0.542,0.001,248,256,25,100,0.001,504,11
0.548,0.001,291,313,25,100,0.001,604,11
0.56,0.001,338,366,25,100,0.001,704,11
0.59,0.001,388,416,25,100,0.001,804,11
0.616,0.001,438,466,25,100,0.001,904,11
0.614,0.001,491,513,25,100,0.001,1004,11
0.636,0.001,540,564,25,100,0.001,1104,11
0.664,0.001,591,613,25,100,0.001,1204,11
0.692,0.001,632,672,25,100,0.001,1304,11
0.728,0.001,677,727,25,100,0.001,1404,11
0.73,0.001,725,779,25,100,0.001,1504,11
0.762,0.001,778,826,25,100,0.001,1604,11
0.776,0.001,827,877,25,100,0.001,1704,11
0.798,0.001,874,930,25,100,0.001,1804,11
0.818,0.001,921,983,25,100,0.001,1904,11
0.834,0.001,983,1021,25,100,0.001,2004,11
0.484,0.001,59,45,25,100,0.001,104,12
0.492,0.001,108,96,25,100,0.001,204,12
0.5,0.001,161,143,25,100,0.001,304,12
0.496,0.001,211,193,25,100,0.001,404,12
0.516,0.001,263,241,25,100,0.001,504,12
0.522,0.001,306,298,25,100,0.001,604,12
0.534,0.001,350,354,25,100,0.001,704,12
0.556,0.001,402,402,25,100,0.001,804,12
0.58,0.001,445,459,25,100,0.001,904,12
0.592,0.001,494,510,25,100,0.001,1004,12
0.638,0.001,541,563,25,100,0.001,1104,12
0.668,0.001,591,613,25,100,0.001,1204,12
0.688,0.001,642,662,25,100,0.001,1304,12
0.72,0.001,688,716,25,100,0.001,1404,12
0.754,0.001,737,767,25,100,0.001,1504,12
0.778,0.001,788,816,25,100,0.001,1604,12
0.8,0.001,839,865,25,100,0.001,1704,12
0.822,0.001,890,914,25,100,0.001,1804,12
0.84,0.001,952,952,25,100,0.001,1904,12
0.87,0.001,1000,1004,25,100,0.001,2004,12
0.474,0.001,57,47,25,100,0.001,104,13
0.494,0.001,113,91,25,100,0.001,204,13
0.5,0.001,166,138,25,100,0.001,304,13
0.526,0.001,214,190,25,100,0.001,404,13
0.54,0.001,263,241,25,100,0.001,504,13
0.55,0.001,313,291,25,100,0.001,604,13
0.548,0.001,369,335,25,100,0.001,704,13
0.572,0.001,414,390,25,100,0.001,804,13
0.582,0.001,457,447,25,100,0.001,904,13
0.594,0.001,505,499,25,100,0.001,1004,13
0.608,0.001,555,549,25,100,0.001,1104,13
0.634,0.001,612,592,25,100,0.001,1204,13
0.65,0.001,654,650,25,100,0.001,1304,13
0.682,0.001,712,692,25,100,0.001,1404,13
0.708,0.001,760,744,25,100,0.001,1504,13
0.736,0.001,807,797,25,100,0.001,1604,13
0.756,0.001,849,855,25,100,0.001,1704,13
0.774,0.001,902,902,25,100,0.001,1804,13
0.812,0.001,954,950,25,100,0.001,1904,13
0.828,0.001,1004,1000,25,100,0.001,2004,13
0.478,0.001,51,53,25,100,0.001,104,14
0.482,0.001,102,102,25,100,0.001,204,14
0.484,0.001,154,150,25,100,0.001,304,14
0.49,0.001,204,200,25,100,0.001,404,14
0.494,0.001,262,242,25,100,0.001,504,14
0.506,0.001,323,281,25,100,0.001,604,14
0.522,0.001,376,328,25,100,0.001,704,14
0.54,0.001,422,382,25,100,0.001,804,14
0.57,0.001,470,434,25,100,0.001,904,14
0.606,0.001,521,483,25,100,0.001,1004,14
0.62,0.001,572,532,25,100,0.001,1104,14
0.648,0.001,617,587,25,100,0.001,1204,14
0.688,0.001,661,643,25,100,0.001,1304,14
0.74,0.001,711,693,25,100,0.001,1404,14
0.77,0.001,757,747,25,100,0.001,1504,14
0.806,0.001,811,793,25,100,0.001,1604,14
0.824,0.001,863,841,25,100,0.001,1704,14
0.844,0.001,918,886,25,100,0.001,1804,14
0.868,0.001,960,944,25,100,0.001,1904,14
0.888,0.001,1011,993,25,100,0.001,2004,14
0.498,0.001,56,48,25,100,0.001,104,15
0.498,0.001,119,85,25,100,0.001,204,15
0.498,0.001,158,146,25,100,0.001,304,15
0.502,0.001,213,191,25,100,0.001,404,15
0.508,0.001,262,242,25,100,0.001,504,15
0.512,0.001,317,287,25,100,0.001,604,15
0.52,0.001,362,342,25,100,0.001,704,15
0.518,0.001,412,392,25,100,0.001,804,15
0.536,0.001,470,434,25,100,0.001,904,15
0.56,0.001,518,486,25,100,0.001,1004,15
0.57,0.001,561,543,25,100,0.001,1104,15
0.596,0.001,611,593,25,100,0.001,1204,15
0.61,0.001,662,642,25,100,0.001,1304,15
0.646,0.001,703,701,25,100,0.001,1404,15
0.682,0.001,756,748,25,100,0.001,1504,15
0.714,0.001,807,797,25,100,0.001,1604,15
0.748,0.001,855,849,25,100,0.001,1704,15
0.776,0.001,909,895,25,100,0.001,1804,15
0.806,0.001,959,945,25,100,0.001,1904,15
0.836,0.001,1014,990,25,100,0.001,2004,15
0.504,0.001,50,54,25,100,0.001,104,16
0.51,0.001,99,105,25,100,0.001,204,16
0.51,0.001,144,160,25,100,0.001,304,16
0.512,0.001,192,212,25,100,0.001,404,16
0.522,0.001,242,262,25,100,0.001,504,16
0.538,0.001,293,311,25,100,0.001,604,16
0.566,0.001,347,357,25,100,0.001,704,16
0.598,0.001,397,407,25,100,0.001,804,16
0.612,0.001,440,464,25,100,0.001,904,16
0.65,0.001,489,515,25,100,0.001,1004,16
0.672,0.001,542,562,25,100,0.001,1104,16
0.696,0.001,594,610,25,100,0.001,1204,16
0.708,0.001,650,654,25,100,0.001,1304,16
0.732,0.001,711,693,25,100,0.001,1404,16
0.756,0.001,759,745,25,100,0.001,1504,16
0.786,0.001,809,795,25,100,0.001,1604,16
0.806,0.001,859,845,25,100,0.001,1704,16
0.82,0.001,910,894,25,100,0.001,1804,16
0.84,0.001,953,951,25,100,0.001,1904,16
0.874,0.001,1001,1003,25,100,0.001,2004,16
0.518,0.001,51,53,25,100,0.001,104,17
0.534,0.001,102,102,25,100,0.001,204,17
0.54,0.001,140,164,25,100,0.001,304,17
0.546,0.001,193,211,25,100,0.001,404,17
0.556,0.001,247,257,25,100,0.001,504,17
0.584,0.001,288,316,25,100,0.001,604,17
0.584,0.001,336,368,25,100,0.001,704,17
0.582,0.001,387,417,25,100,0.001,804,17
0.588,0.001,439,465,25,100,0.001,904,17
0.598,0.001,490,514,25,100,0.001,1004,17
0.618,0.001,548,556,25,100,0.001,1104,17
0.658,0.001,600,604,25,100,0.001,1204,17
0.672,0.001,646,658,25,100,0.001,1304,17
0.706,0.001,704,700,25,100,0.001,1404,17
0.744,0.001,760,744,25,100,0.001,1504,17
0.774,0.001,801,803,25,100,0.001,1604,17
0.79,0.001,858,846,25,100,0.001,1704,17
0.81,0.001,912,892,25,100,0.001,1804,17
0.83,0.001,957,947,25,100,0.001,1904,17
0.848,0.001,1013,991,25,100,0.001,2004,17
0.496,0.001,65,39,25,100,0.001,104,18
0.5,0.001,117,87,25,100,0.001,204,18
0.504,0.001,165,139,25,100,0.001,304,18
0.514,0.001,220,184,25,100,0.001,404,18
0.526,0.001,264,240,25,100,0.001,504,18
0.548,0.001,314,290,25,100,0.001,604,18
0.56,0.001,356,348,25,100,0.001,704,18
0.576,0.001,408,396,25,100,0.001,804,18
0.608,0.001,457,447,25,100,0.001,904,18
0.652,0.001,512,492,25,100,0.001,1004,18
0.666,0.001,565,539,25,100,0.001,1104,18
0.7,0.001,612,592,25,100,0.001,1204,18
0.732,0.001,665,639,25,100,0.001,1304,18
0.758,0.001,714,690,25,100,0.001,1404,18
0.77,0.001,773,731,25,100,0.001,1504,18
0.794,0.001,823,781,25,100,0.001,1604,18
0.814,0.001,869,835,25,100,0.001,1704,18
0.836,0.001,909,895,25,100,0.001,1804,18
0.846,0.001,960,944,25,100,0.001,1904,18
0.868,0.001,1006,998,25,100,0.001,2004,18
0.492,0.001,61,43,25,100,0.001,104,19
0.496,0.001,115,89,25,100,0.001,204,19
0.502,0.001,156,148,25,100,0.001,304,19
0.514,0.001,202,202,25,100,0.001,404,19
0.524,0.001,246,258,25,100,0.001,504,19
0.558,0.001,287,317,25,100,0.001,604,19
0.564,0.001,344,360,25,100,0.001,704,19
0.602,0.001,391,413,25,100,0.001,804,19
0.626,0.001,438,466,25,100,0.001,904,19
0.644,0.001,492,512,25,100,0.001,1004,19
0.65,0.001,544,560,25,100,0.001,1104,19
0.682,0.001,602,602,25,100,0.001,1204,19
0.686,0.001,648,656,25,100,0.001,1304,19
0.708,0.001,695,709,25,100,0.001,1404,19
0.738,0.001,748,756,25,100,0.001,1504,19
0.772,0.001,797,807,25,100,0.001,1604,19
0.8,0.001,850,854,25,100,0.001,1704,19
0.82,0.001,900,904,25,100,0.001,1804,19
0.848,0.001,958,946,25,100,0.001,1904,19
0.864,0.001,1004,1000,25,100,0.001,2004,19
0.492,0.001,49,55,25,100,0.001,104,20
0.492,0.001,100,104,25,100,0.001,204,20
0.508,0.001,146,158,25,100,0.001,304,20
0.518,0.001,189,215,25,100,0.001,404,20
0.54,0.001,246,258,25,100,0.001,504,20
0.556,0.001,302,302,25,100,0.001,604,20
0.564,0.001,350,354,25,100,0.001,704,20
0.562,0.001,402,402,25,100,0.001,804,20
0.598,0.001,452,452,25,100,0.001,904,20
0.616,0.001,510,494,25,100,0.001,1004,20
0.626,0.001,561,543,25,100,0.001,1104,20
0.64,0.001,604,600,25,100,0.001,1204,20
0.654,0.001,661,643,25,100,0.001,1304,20
0.674,0.001,699,705,25,100,0.001,1404,20
0.684,0.001,750,754,25,100,0.001,1504,20
0.712,0.001,796,808,25,100,0.001,1604,20
0.728,0.001,846,858,25,100,0.001,1704,20
0.76,0.001,895,909,25,100,0.001,1804,20
0.802,0.001,948,956,25,100,0.001,1904,20
0.83,0.001,1005,999,25,100,0.001,2004,20
0.578,0.001,51,53,25,100,0.01,104,1
0.634,0.001,104,100,25,100,0.01,204,1
0.638,0.001,145,159,25,100,0.01,304,1
0.66,0.001,198,206,25,100,0.01,404,1
0.676,0.001,248,256,25,100,0.01,504,1
0.72,0.001,301,303,25,100,0.01,604,1
0.792,0.001,353,351,25,100,0.01,704,1
0.844,0.001,408,396,25,100,0.01,804,1
0.866,0.001,455,449,25,100,0.01,904,1
0.916,0.001,502,502,25,100,0.01,1004,1
0.942,0.001,556,548,25,100,0.01,1104,1
0.96,0.001,606,598,25,100,0.01,1204,1
0.956,0.001,660,644,25,100,0.01,1304,1
0.976,0.001,707,697,25,100,0.01,1404,1
0.976,0.001,757,747,25,100,0.01,1504,1
0.982,0.001,804,800,25,100,0.01,1604,1
0.982,0.001,849,855,25,100,0.01,1704,1
0.986,0.001,903,901,25,100,0.01,1804,1
0.984,0.001,956,948,25,100,0.01,1904,1
0.984,0.001,999,1005,25,100,0.01,2004,1
0.588,0.001,54,50,25,100,0.01,104,2
0.6,0.001,106,98,25,100,0.01,204,2
0.616,0.001,158,146,25,100,0.01,304,2
0.67,0.001,203,201,25,100,0.01,404,2
0.726,0.001,255,249,25,100,0.01,504,2
0.764,0.001,305,299,25,100,0.01,604,2
0.78,0.001,355,349,25,100,0.01,704,2
0.824,0.001,405,399,25,100,0.01,804,2
0.886,0.001,452,452,25,100,0.01,904,2
0.926,0.001,509,495,25,100,0.01,1004,2
0.952,0.001,544,560,25,100,0.01,1104,2
0.966,0.001,598,606,25,100,0.01,1204,2
0.968,0.001,653,651,25,100,0.01,1304,2
0.968,0.001,693,711,25,100,0.01,1404,2
0.978,0.001,750,754,25,100,0.01,1504,2
0.986,0.001,797,807,25,100,0.01,1604,2
0.988,0.001,848,856,25,100,0.01,1704,2
0.99,0.001,897,907,25,100,0.01,1804,2
0.992,0.001,944,960,25,100,0.01,1904,2
0.994,0.001,994,1010,25,100,0.01,2004,2
0.592,0.001,54,50,25,100,0.01,104,3
0.628,0.001,107,97,25,100,0.01,204,3
0.638,0.001,154,150,25,100,0.01,304,3
0.658,0.001,203,201,25,100,0.01,404,3
0.698,0.001,251,253,25,100,0.01,504,3
0.764,0.001,299,305,25,100,0.01,604,3
0.794,0.001,346,358,25,100,0.01,704,3
0.848,0.001,393,411,25,100,0.01,804,3
0.886,0.001,442,462,25,100,0.01,904,3
0.932,0.001,497,507,25,100,0.01,1004,3
0.946,0.001,543,561,25,100,0.01,1104,3
0.954,0.001,601,603,25,100,0.01,1204,3
0.956,0.001,641,663,25,100,0.01,1304,3
0.966,0.001,688,716,25,100,0.01,1404,3
0.966,0.001,732,772,25,100,0.01,1504,3
0.972,0.001,780,824,25,100,0.01,1604,3
0.978,0.001,831,873,25,100,0.01,1704,3
0.982,0.001,886,918,25,100,0.01,1804,3
0.984,0.001,937,967,25,100,0.01,1904,3
0.984,0.001,995,1009,25,100,0.01,2004,3
0.532,0.001,50,54,25,100,0.01,104,4
0.574,0.001,91,113,25,100,0.01,204,4
0.56,0.001,143,161,25,100,0.01,304,4
0.62,0.001,200,204,25,100,0.01,404,4
0.668,0.001,257,247,25,100,0.01,504,4
0.686,0.001,304,300,25,100,0.01,604,4
0.706,0.001,356,348,25,100,0.01,704,4
0.786,0.001,404,400,25,100,0.01,804,4
0.858,0.001,460,444,25,100,0.01,904,4
0.914,0.001,514,490,25,100,0.01,1004,4
0.938,0.001,561,543,25,100,0.01,1104,4
0.946,0.001,608,596,25,100,0.01,1204,4
0.956,0.001,658,646,25,100,0.01,1304,4
0.968,0.001,703,701,25,100,0.01,1404,4
0.97,0.001,752,752,25,100,0.01,1504,4
0.966,0.001,799,805,25,100,0.01,1604,4
0.972,0.001,841,863,25,100,0.01,1704,4
0.984,0.001,894,910,25,100,0.01,1804,4
0.984,0.001,943,961,25,100,0.01,1904,4
0.986,0.001,990,1014,25,100,0.01,2004,4
0.51,0.001,45,59,25,100,0.01,104,5
0.576,0.001,91,113,25,100,0.01,204,5
0.584,0.001,143,161,25,100,0.01,304,5
0.626,0.001,195,209,25,100,0.01,404,5
0.674,0.001,250,254,25,100,0.01,504,5
0.744,0.001,301,303,25,100,0.01,604,5
0.774,0.001,355,349,25,100,0.01,704,5
0.814,0.001,403,401,25,100,0.01,804,5
0.84,0.001,456,448,25,100,0.01,904,5
0.908,0.001,496,508,25,100,0.01,1004,5
0.934,0.001,547,557,25,100,0.01,1104,5
0.95,0.001,596,608,25,100,0.01,1204,5
0.958,0.001,653,651,25,100,0.01,1304,5
0.962,0.001,699,705,25,100,0.01,1404,5
0.964,0.001,751,753,25,100,0.01,1504,5
0.962,0.001,802,802,25,100,0.01,1604,5
0.968,0.001,852,852,25,100,0.01,1704,5
0.972,0.001,897,907,25,100,0.01,1804,5
0.968,0.001,939,965,25,100,0.01,1904,5
0.98,0.001,992,1012,25,100,0.01,2004,5
0.502,0.001,49,55,25,100,0.01,104,6
0.516,0.001,95,109,25,100,0.01,204,6
0.508,0.001,148,156,25,100,0.01,304,6
0.61,0.001,206,198,25,100,0.01,404,6
0.648,0.001,257,247,25,100,0.01,504,6
0.676,0.001,306,298,25,100,0.01,604,6
0.71,0.001,358,346,25,100,0.01,704,6
0.794,0.001,409,395,25,100,0.01,804,6
0.87,0.001,463,441,25,100,0.01,904,6
0.906,0.001,510,494,25,100,0.01,1004,6
0.932,0.001,558,546,25,100,0.01,1104,6
0.944,0.001,607,597,25,100,0.01,1204,6
0.952,0.001,652,652,25,100,0.01,1304,6
0.962,0.001,707,697,25,100,0.01,1404,6
0.964,0.001,753,751,25,100,0.01,1504,6
0.974,0.001,798,806,25,100,0.01,1604,6
0.974,0.001,847,857,25,100,0.01,1704,6
0.97,0.001,897,907,25,100,0.01,1804,6
0.972,0.001,948,956,25,100,0.01,1904,6
0.98,0.001,1000,1004,25,100,0.01,2004,6
0.576,0.001,44,60,25,100,0.01,104,7
0.582,0.001,92,112,25,100,0.01,204,7
0.578,0.001,134,170,25,100,0.01,304,7
0.624,0.001,188,216,25,100,0.01,404,7
0.668,0.001,243,261,25,100,0.01,504,7
0.764,0.001,292,312,25,100,0.01,604,7
0.794,0.001,345,359,25,100,0.01,704,7
0.866,0.001,393,411,25,100,0.01,804,7
0.894,0.001,445,459,25,100,0.01,904,7
0.9,0.001,496,508,25,100,0.01,1004,7
0.908,0.001,552,552,25,100,0.01,1104,7
0.926,0.001,604,600,25,100,0.01,1204,7
0.936,0.001,655,649,25,100,0.01,1304,7
0.94,0.001,702,702,25,100,0.01,1404,7
0.944,0.001,751,753,25,100,0.01,1504,7
0.954,0.001,796,808,25,100,0.01,1604,7
0.956,0.001,848,856,25,100,0.01,1704,7
0.962,0.001,897,907,25,100,0.01,1804,7
0.97,0.001,941,963,25,100,0.01,1904,7
0.974,0.001,991,1013,25,100,0.01,2004,7
0.538,0.001,43,61,25,100,0.01,104,8
0.576,0.001,93,111,25,100,0.01,204,8
0.598,0.001,150,154,25,100,0.01,304,8
0.624,0.001,196,208,25,100,0.01,404,8
0.646,0.001,247,257,25,100,0.01,504,8
0.66,0.001,297,307,25,100,0.01,604,8
0.714,0.001,344,360,25,100,0.01,704,8
0.808,0.001,393,411,25,100,0.01,804,8
0.854,0.001,448,456,25,100,0.01,904,8
0.926,0.001,494,510,25,100,0.01,1004,8
0.962,0.001,544,560,25,100,0.01,1104,8
0.982,0.001,597,607,25,100,0.01,1204,8
0.98,0.001,648,656,25,100,0.01,1304,8
0.986,0.001,695,709,25,100,0.01,1404,8
0.986,0.001,738,766,25,100,0.01,1504,8
0.99,0.001,790,814,25,100,0.01,1604,8
0.992,0.001,842,862,25,100,0.01,1704,8
0.992,0.001,900,904,25,100,0.01,1804,8
0.99,0.001,951,953,25,100,0.01,1904,8
0.992,0.001,1006,998,25,100,0.01,2004,8
0.592,0.001,56,48,25,100,0.01,104,9
0.622,0.001,104,100,25,100,0.01,204,9
0.64,0.001,156,148,25,100,0.01,304,9
0.688,0.001,210,194,25,100,0.01,404,9
0.712,0.001,266,238,25,100,0.01,504,9
0.728,0.001,315,289,25,100,0.01,604,9
0.774,0.001,367,337,25,100,0.01,704,9
0.828,0.001,420,384,25,100,0.01,804,9
0.866,0.001,472,432,25,100,0.01,904,9
0.916,0.001,520,484,25,100,0.01,1004,9
0.946,0.001,569,535,25,100,0.01,1104,9
0.952,0.001,626,578,25,100,0.01,1204,9
0.96,0.001,673,631,25,100,0.01,1304,9
0.954,0.001,717,687,25,100,0.01,1404,9
0.964,0.001,761,743,25,100,0.01,1504,9
0.972,0.001,809,795,25,100,0.01,1604,9
0.976,0.001,853,851,25,100,0.01,1704,9
0.978,0.001,903,901,25,100,0.01,1804,9
0.984,0.001,946,958,25,100,0.01,1904,9
0.986,0.001,992,1012,25,100,0.01,2004,9
0.516,0.001,52,52,25,100,0.01,104,10
0.552,0.001,110,94,25,100,0.01,204,10
0.55,0.001,157,147,25,100,0.01,304,10
0.57,0.001,213,191,25,100,0.01,404,10
0.604,0.001,260,244,25,100,0.01,504,10
0.67,0.001,311,293,25,100,0.01,604,10
0.726,0.001,363,341,25,100,0.01,704,10
0.814,0.001,411,393,25,100,0.01,804,10
0.852,0.001,464,440,25,100,0.01,904,10
0.904,0.001,514,490,25,100,0.01,1004,10
0.94,0.001,566,538,25,100,0.01,1104,10
0.95,0.001,621,583,25,100,0.01,1204,10
0.946,0.001,675,629,25,100,0.01,1304,10
0.96,0.001,723,681,25,100,0.01,1404,10
0.966,0.001,784,720,25,100,0.01,1504,10
0.972,0.001,827,777,25,100,0.01,1604,10
0.956,0.001,871,833,25,100,0.01,1704,10
0.968,0.001,922,882,25,100,0.01,1804,10
0.968,0.001,968,936,25,100,0.01,1904,10
0.972,0.001,1015,989,25,100,0.01,2004,10
0.552,0.001,49,55,25,100,0.01,104,11
0.582,0.001,99,105,25,100,0.01,204,11
0.582,0.001,155,149,25,100,0.01,304,11
0.606,0.001,208,196,25,100,0.01,404,11
0.668,0.001,256,248,25,100,0.01,504,11
0.708,0.001,306,298,25,100,0.01,604,11
0.752,0.001,351,353,25,100,0.01,704,11
0.804,0.001,395,409,25,100,0.01,804,11
0.818,0.001,443,461,25,100,0.01,904,11
0.878,0.001,499,505,25,100,0.01,1004,11
0.904,0.001,548,556,25,100,0.01,1104,11
0.922,0.001,593,611,25,100,0.01,1204,11
0.918,0.001,641,663,25,100,0.01,1304,11
0.936,0.001,693,711,25,100,0.01,1404,11
0.934,0.001,741,763,25,100,0.01,1504,11
0.936,0.001,799,805,25,100,0.01,1604,11
0.954,0.001,849,855,25,100,0.01,1704,11
0.95,0.001,897,907,25,100,0.01,1804,11
0.962,0.001,946,958,25,100,0.01,1904,11
0.964,0.001,991,1013,25,100,0.01,2004,11
0.586,0.001,49,55,25,100,0.01,104,12
0.592,0.001,94,110,25,100,0.01,204,12
0.592,0.001,142,162,25,100,0.01,304,12
0.626,0.001,200,204,25,100,0.01,404,12
0.646,0.001,248,256,25,100,0.01,504,12
0.692,0.001,296,308,25,100,0.01,604,12
0.764,0.001,353,351,25,100,0.01,704,12
0.848,0.001,408,396,25,100,0.01,804,12
0.894,0.001,454,450,25,100,0.01,904,12
0.944,0.001,505,499,25,100,0.01,1004,12
0.95,0.001,557,547,25,100,0.01,1104,12
0.974,0.001,605,599,25,100,0.01,1204,12
0.976,0.001,665,639,25,100,0.01,1304,12
0.982,0.001,712,692,25,100,0.01,1404,12
0.982,0.001,753,751,25,100,0.01,1504,12
0.98,0.001,800,804,25,100,0.01,1604,12
0.99,0.001,856,848,25,100,0.01,1704,12
0.99,0.001,907,897,25,100,0.01,1804,12
0.992,0.001,957,947,25,100,0.01,1904,12
0.994,0.001,1014,990,25,100,0.01,2004,12
0.522,0.001,55,49,25,100,0.01,104,13
0.536,0.001,105,99,25,100,0.01,204,13
0.524,0.001,162,142,25,100,0.01,304,13
0.544,0.001,205,199,25,100,0.01,404,13
0.61,0.001,261,243,25,100,0.01,504,13
0.724,0.001,312,292,25,100,0.01,604,13
0.77,0.001,364,340,25,100,0.01,704,13
0.842,0.001,416,388,25,100,0.01,804,13
0.89,0.001,457,447,25,100,0.01,904,13
0.932,0.001,505,499,25,100,0.01,1004,13
0.952,0.001,556,548,25,100,0.01,1104,13
0.968,0.001,598,606,25,100,0.01,1204,13
0.978,0.001,653,651,25,100,0.01,1304,13
0.974,0.001,695,709,25,100,0.01,1404,13
0.98,0.001,745,759,25,100,0.01,1504,13
0.982,0.001,806,798,25,100,0.01,1604,13
0.984,0.001,849,855,25,100,0.01,1704,13
0.982,0.001,901,903,25,100,0.01,1804,13
0.986,0.001,956,948,25,100,0.01,1904,13
0.99,0.001,1004,1000,25,100,0.01,2004,13
0.55,0.001,55,49,25,100,0.01,104,14
0.592,0.001,111,93,25,100,0.01,204,14
0.586,0.001,166,138,25,100,0.01,304,14
0.62,0.001,216,188,25,100,0.01,404,14
0.68,0.001,265,239,25,100,0.01,504,14
0.718,0.001,313,291,25,100,0.01,604,14
0.772,0.001,359,345,25,100,0.01,704,14
0.81,0.001,416,388,25,100,0.01,804,14
0.84,0.001,464,440,25,100,0.01,904,14
0.888,0.001,515,489,25,100,0.01,1004,14
0.928,0.001,569,535,25,100,0.01,1104,14
0.942,0.001,623,581,25,100,0.01,1204,14
0.958,0.001,665,639,25,100,0.01,1304,14
0.968,0.001,713,691,25,100,0.01,1404,14
0.97,0.001,755,749,25,100,0.01,1504,14
0.976,0.001,803,801,25,100,0.01,1604,14
0.976,0.001,848,856,25,100,0.01,1704,14
0.974,0.001,892,912,25,100,0.01,1804,14
0.978,0.001,952,952,25,100,0.01,1904,14
0.98,0.001,994,1010,25,100,0.01,2004,14
0.528,0.001,53,51,25,100,0.01,104,15
0.586,0.001,105,99,25,100,0.01,204,15
0.612,0.001,157,147,25,100,0.01,304,15
0.662,0.001,201,203,25,100,0.01,404,15
0.706,0.001,247,257,25,100,0.01,504,15
0.754,0.001,300,304,25,100,0.01,604,15
0.802,0.001,355,349,25,100,0.01,704,15
0.864,0.001,399,405,25,100,0.01,804,15
0.91,0.001,447,457,25,100,0.01,904,15
0.92,0.001,505,499,25,100,0.01,1004,15
0.936,0.001,561,543,25,100,0.01,1104,15
0.966,0.001,614,590,25,100,0.01,1204,15
0.97,0.001,660,644,25,100,0.01,1304,15
0.966,0.001,710,694,25,100,0.01,1404,15
0.972,0.001,761,743,25,100,0.01,1504,15
0.976,0.001,817,787,25,100,0.01,1604,15
0.972,0.001,863,841,25,100,0.01,1704,15
0.98,0.001,910,894,25,100,0.01,1804,15
0.984,0.001,949,955,25,100,0.01,1904,15
0.984,0.001,996,1008,25,100,0.01,2004,15
0.528,0.001,44,60,25,100,0.01,104,16
0.59,0.001,89,115,25,100,0.01,204,16
0.624,0.001,143,161,25,100,0.01,304,16
0.66,0.001,194,210,25,100,0.01,404,16
0.706,0.001,238,266,25,100,0.01,504,16
0.74,0.001,292,312,25,100,0.01,604,16
0.79,0.001,341,363,25,100,0.01,704,16
0.848,0.001,395,409,25,100,0.01,804,16
0.884,0.001,452,452,25,100,0.01,904,16
0.916,0.001,500,504,25,100,0.01,1004,16
0.932,0.001,550,554,25,100,0.01,1104,16
0.958,0.001,609,595,25,100,0.01,1204,16
0.968,0.001,660,644,25,100,0.01,1304,16
0.98,0.001,712,692,25,100,0.01,1404,16
0.978,0.001,754,750,25,100,0.01,1504,16
0.982,0.001,806,798,25,100,0.01,1604,16
0.984,0.001,847,857,25,100,0.01,1704,16
0.98,0.001,899,905,25,100,0.01,1804,16
0.986,0.001,948,956,25,100,0.01,1904,16
0.988,0.001,998,1006,25,100,0.01,2004,16
0.542,0.001,56,48,25,100,0.01,104,17
0.594,0.001,102,102,25,100,0.01,204,17
0.592,0.001,150,154,25,100,0.01,304,17
0.602,0.001,203,201,25,100,0.01,404,17
0.614,0.001,247,257,25,100,0.01,504,17
0.658,0.001,297,307,25,100,0.01,604,17
0.692,0.001,349,355,25,100,0.01,704,17
0.794,0.001,392,412,25,100,0.01,804,17
0.85,0.001,443,461,25,100,0.01,904,17
0.9,0.001,494,510,25,100,0.01,1004,17
0.93,0.001,546,558,25,100,0.01,1104,17
0.946,0.001,595,609,25,100,0.01,1204,17
0.96,0.001,649,655,25,100,0.01,1304,17
0.97,0.001,695,709,25,100,0.01,1404,17
0.974,0.001,743,761,25,100,0.01,1504,17
0.978,0.001,792,812,25,100,0.01,1604,17
0.982,0.001,851,853,25,100,0.01,1704,17
0.986,0.001,902,902,25,100,0.01,1804,17
0.99,0.001,954,950,25,100,0.01,1904,17
0.99,0.001,1003,1001,25,100,0.01,2004,17
0.554,0.001,60,44,25,100,0.01,104,18
0.618,0.001,100,104,25,100,0.01,204,18
0.62,0.001,139,165,25,100,0.01,304,18
0.658,0.001,195,209,25,100,0.01,404,18
0.664,0.001,241,263,25,100,0.01,504,18
0.722,0.001,297,307,25,100,0.01,604,18
0.758,0.001,358,346,25,100,0.01,704,18
0.834,0.001,407,397,25,100,0.01,804,18
0.88,0.001,451,453,25,100,0.01,904,18
0.926,0.001,497,507,25,100,0.01,1004,18
0.944,0.001,542,562,25,100,0.01,1104,18
0.962,0.001,596,608,25,100,0.01,1204,18
0.966,0.001,648,656,25,100,0.01,1304,18
0.972,0.001,699,705,25,100,0.01,1404,18
0.978,0.001,746,758,25,100,0.01,1504,18
0.978,0.001,791,813,25,100,0.01,1604,18
0.978,0.001,832,872,25,100,0.01,1704,18
0.986,0.001,885,919,25,100,0.01,1804,18
0.986,0.001,933,971,25,100,0.01,1904,18
0.992,0.001,991,1013,25,100,0.01,2004,18
0.522,0.001,46,58,25,100,0.01,104,19
0.57,0.001,96,108,25,100,0.01,204,19
0.556,0.001,145,159,25,100,0.01,304,19
0.626,0.001,199,205,25,100,0.01,404,19
0.692,0.001,249,255,25,100,0.01,504,19
0.724,0.001,299,305,25,100,0.01,604,19
0.756,0.001,345,359,25,100,0.01,704,19
0.854,0.001,394,410,25,100,0.01,804,19
0.888,0.001,442,462,25,100,0.01,904,19
0.93,0.001,494,510,25,100,0.01,1004,19
0.942,0.001,547,557,25,100,0.01,1104,19
0.958,0.001,596,608,25,100,0.01,1204,19
0.958,0.001,644,660,25,100,0.01,1304,19
0.952,0.001,688,716,25,100,0.01,1404,19
0.966,0.001,739,765,25,100,0.01,1504,19
0.97,0.001,782,822,25,100,0.01,1604,19
0.976,0.001,840,864,25,100,0.01,1704,19
0.98,0.001,896,908,25,100,0.01,1804,19
0.98,0.001,946,958,25,100,0.01,1904,19
0.982,0.001,1000,1004,25,100,0.01,2004,19
0.568,0.001,50,54,25,100,0.01,104,20
0.596,0.001,105,99,25,100,0.01,204,20
0.596,0.001,159,145,25,100,0.01,304,20
0.61,0.001,200,204,25,100,0.01,404,20
0.64,0.001,257,247,25,100,0.01,504,20
0.714,0.001,304,300,25,100,0.01,604,20
0.736,0.001,354,350,25,100,0.01,704,20
0.796,0.001,408,396,25,100,0.01,804,20
0.82,0.001,453,451,25,100,0.01,904,20
0.87,0.001,499,505,25,100,0.01,1004,20
0.898,0.001,546,558,25,100,0.01,1104,20
0.924,0.001,592,612,25,100,0.01,1204,20
0.956,0.001,645,659,25,100,0.01,1304,20
0.966,0.001,696,708,25,100,0.01,1404,20
0.966,0.001,746,758,25,100,0.01,1504,20
0.976,0.001,796,808,25,100,0.01,1604,20
0.982,0.001,842,862,25,100,0.01,1704,20
0.98,0.001,894,910,25,100,0.01,1804,20
0.982,0.001,945,959,25,100,0.01,1904,20
0.982,0.001,996,1008,25,100,0.01,2004,20
0.496,1e-05,52,52,50,2,0.0001,104,1
0.496,1e-05,94,110,50,2,0.0001,204,1
0.496,1e-05,141,163,50,2,0.0001,304,1
0.496,1e-05,193,211,50,2,0.0001,404,1
0.496,1e-05,236,268,50,2,0.0001,504,1
0.496,1e-05,293,311,50,2,0.0001,604,1
0.496,1e-05,357,347,50,2,0.0001,704,1
0.496,1e-05,407,397,50,2,0.0001,804,1
0.496,1e-05,451,453,50,2,0.0001,904,1
0.496,1e-05,504,500,50,2,0.0001,1004,1
0.496,1e-05,551,553,50,2,0.0001,1104,1
0.496,1e-05,600,604,50,2,0.0001,1204,1
0.496,1e-05,648,656,50,2,0.0001,1304,1
0.496,1e-05,702,702,50,2,0.0001,1404,1
0.496,1e-05,758,746,50,2,0.0001,1504,1
0.496,1e-05,810,794,50,2,0.0001,1604,1
0.496,1e-05,856,848,50,2,0.0001,1704,1
0.496,1e-05,908,896,50,2,0.0001,1804,1
0.496,1e-05,956,948,50,2,0.0001,1904,1
0.496,1e-05,1004,1000,50,2,0.0001,2004,1
0.498,1e-05,50,54,50,2,0.0001,104,2
0.498,1e-05,102,102,50,2,0.0001,204,2
0.498,1e-05,151,153,50,2,0.0001,304,2
0.498,1e-05,214,190,50,2,0.0001,404,2
0.498,1e-05,267,237,50,2,0.0001,504,2
0.498,1e-05,319,285,50,2,0.0001,604,2
0.498,1e-05,372,332,50,2,0.0001,704,2
0.498,1e-05,418,386,50,2,0.0001,804,2
0.498,1e-05,468,436,50,2,0.0001,904,2
0.498,1e-05,518,486,50,2,0.0001,1004,2
0.498,1e-05,559,545,50,2,0.0001,1104,2
0.498,1e-05,611,593,50,2,0.0001,1204,2
0.498,1e-05,658,646,50,2,0.0001,1304,2
0.498,1e-05,718,686,50,2,0.0001,1404,2
0.498,1e-05,774,730,50,2,0.0001,1504,2
0.498,1e-05,827,777,50,2,0.0001,1604,2
0.498,1e-05,871,833,50,2,0.0001,1704,2
0.498,1e-05,912,892,50,2,0.0001,1804,2
0.498,1e-05,962,942,50,2,0.0001,1904,2
0.498,1e-05,1003,1001,50,2,0.0001,2004,2
0.49,1e-05,55,49,50,2,0.0001,104,3
0.49,1e-05,107,97,50,2,0.0001,204,3
0.49,1e-05,158,146,50,2,0.0001,304,3
0.49,1e-05,212,192,50,2,0.0001,404,3
0.49,1e-05,267,237,50,2,0.0001,504,3
0.49,1e-05,322,282,50,2,0.0001,604,3
0.49,1e-05,372,332,50,2,0.0001,704,3
0.49,1e-05,425,379,50,2,0.0001,804,3
0.49,1e-05,475,429,50,2,0.0001,904,3
0.49,1e-05,532,472,50,2,0.0001,1004,3
0.49,1e-05,580,524,50,2,0.0001,1104,3
0.49,1e-05,632,572,50,2,0.0001,1204,3
0.49,1e-05,680,624,50,2,0.0001,1304,3
0.49,1e-05,725,679,50,2,0.0001,1404,3
0.49,1e-05,771,733,50,2,0.0001,1504,3
0.49,1e-05,819,785,50,2,0.0001,1604,3
0.49,1e-05,865,839,50,2,0.0001,1704,3
0.49,1e-05,915,889,50,2,0.0001,1804,3
0.49,1e-05,954,950,50,2,0.0001,1904,3
0.49,1e-05,1007,997,50,2,0.0001,2004,3
0.488,1e-05,49,55,50,2,0.0001,104,4
0.486,1e-05,103,101,50,2,0.0001,204,4
0.486,1e-05,153,151,50,2,0.0001,304,4
0.486,1e-05,196,208,50,2,0.0001,404,4
0.486,1e-05,252,252,50,2,0.0001,504,4
0.488,1e-05,305,299,50,2,0.0001,604,4
0.49,1e-05,355,349,50,2,0.0001,704,4
0.49,1e-05,402,402,50,2,0.0001,804,4
0.49,1e-05,453,451,50,2,0.0001,904,4
0.488,1e-05,496,508,50,2,0.0001,1004,4
0.488,1e-05,553,551,50,2,0.0001,1104,4
0.488,1e-05,601,603,50,2,0.0001,1204,4
0.49,1e-05,655,649,50,2,0.0001,1304,4
0.49,1e-05,708,696,50,2,0.0001,1404,4
0.49,1e-05,759,745,50,2,0.0001,1504,4
0.492,1e-05,810,794,50,2,0.0001,1604,4
0.492,1e-05,864,840,50,2,0.0001,1704,4
0.492,1e-05,917,887,50,2,0.0001,1804,4
0.492,1e-05,966,938,50,2,0.0001,1904,4
0.492,1e-05,1005,999,50,2,0.0001,2004,4
0.512,1e-05,57,47,50,2,0.0001,104,5
0.512,1e-05,104,100,50,2,0.0001,204,5
0.512,1e-05,150,154,50,2,0.0001,304,5
0.512,1e-05,203,201,50,2,0.0001,404,5
0.512,1e-05,247,257,50,2,0.0001,504,5
0.512,1e-05,288,316,50,2,0.0001,604,5
0.512,1e-05,337,367,50,2,0.0001,704,5
0.512,1e-05,389,415,50,2,0.0001,804,5
0.512,1e-05,444,460,50,2,0.0001,904,5
0.512,1e-05,490,514,50,2,0.0001,1004,5
0.512,1e-05,542,562,50,2,0.0001,1104,5
0.512,1e-05,597,607,50,2,0.0001,1204,5
0.512,1e-05,647,657,50,2,0.0001,1304,5
0.512,1e-05,698,706,50,2,0.0001,1404,5
0.512,1e-05,750,754,50,2,0.0001,1504,5
0.512,1e-05,799,805,50,2,0.0001,1604,5
0.512,1e-05,856,848,50,2,0.0001,1704,5
0.512,1e-05,904,900,50,2,0.0001,1804,5
0.512,1e-05,951,953,50,2,0.0001,1904,5
0.512,1e-05,996,1008,50,2,0.0001,2004,5
0.466,1e-05,48,56,50,2,0.0001,104,6
0.466,1e-05,95,109,50,2,0.0001,204,6
0.466,1e-05,146,158,50,2,0.0001,304,6
0.466,1e-05,198,206,50,2,0.0001,404,6
0.466,1e-05,254,250,50,2,0.0001,504,6
0.466,1e-05,301,303,50,2,0.0001,604,6
0.466,1e-05,354,350,50,2,0.0001,704,6
0.466,1e-05,403,401,50,2,0.0001,804,6
0.466,1e-05,451,453,50,2,0.0001,904,6
0.466,1e-05,504,500,50,2,0.0001,1004,6
0.464,1e-05,549,555,50,2,0.0001,1104,6
0.462,1e-05,598,606,50,2,0.0001,1204,6
0.466,1e-05,643,661,50,2,0.0001,1304,6
0.466,1e-05,693,711,50,2,0.0001,1404,6
0.466,1e-05,743,761,50,2,0.0001,1504,6
0.464,1e-05,798,806,50,2,0.0001,1604,6
0.464,1e-05,851,853,50,2,0.0001,1704,6
0.466,1e-05,896,908,50,2,0.0001,1804,6
0.464,1e-05,946,958,50,2,0.0001,1904,6
0.466,1e-05,995,1009,50,2,0.0001,2004,6
0.482,1e-05,54,50,50,2,0.0001,104,7
0.482,1e-05,103,101,50,2,0.0001,204,7
0.482,1e-05,157,147,50,2,0.0001,304,7
0.482,1e-05,208,196,50,2,0.0001,404,7
0.482,1e-05,252,252,50,2,0.0001,504,7
0.482,1e-05,293,311,50,2,0.0001,604,7
0.48,1e-05,347,357,50,2,0.0001,704,7
0.48,1e-05,400,404,50,2,0.0001,804,7
0.48,1e-05,458,446,50,2,0.0001,904,7
0.482,1e-05,509,495,50,2,0.0001,1004,7
0.48,1e-05,555,549,50,2,0.0001,1104,7
0.48,1e-05,601,603,50,2,0.0001,1204,7
0.48,1e-05,657,647,50,2,0.0001,1304,7
0.482,1e-05,705,699,50,2,0.0001,1404,7
0.482,1e-05,758,746,50,2,0.0001,1504,7
0.482,1e-05,805,799,50,2,0.0001,1604,7
0.482,1e-05,859,845,50,2,0.0001,1704,7
0.482,1e-05,904,900,50,2,0.0001,1804,7
0.484,1e-05,952,952,50,2,0.0001,1904,7
0.482,1e-05,1005,999,50,2,0.0001,2004,7
0.514,1e-05,58,46,50,2,0.0001,104,8
0.514,1e-05,111,93,50,2,0.0001,204,8
0.514,1e-05,163,141,50,2,0.0001,304,8
0.514,1e-05,216,188,50,2,0.0001,404,8
0.514,1e-05,264,240,50,2,0.0001,504,8
0.516,1e-05,319,285,50,2,0.0001,604,8
0.516,1e-05,372,332,50,2,0.0001,704,8
0.516,1e-05,416,388,50,2,0.0001,804,8
0.516,1e-05,467,437,50,2,0.0001,904,8
0.52,1e-05,518,486,50,2,0.0001,1004,8
0.522,1e-05,565,539,50,2,0.0001,1104,8
0.522,1e-05,611,593,50,2,0.0001,1204,8
0.524,1e-05,658,646,50,2,0.0001,1304,8
0.522,1e-05,710,694,50,2,0.0001,1404,8
0.524,1e-05,764,740,50,2,0.0001,1504,8
0.524,1e-05,817,787,50,2,0.0001,1604,8
0.52,1e-05,865,839,50,2,0.0001,1704,8
0.52,1e-05,913,891,50,2,0.0001,1804,8
0.526,1e-05,962,942,50,2,0.0001,1904,8
0.532,1e-05,1009,995,50,2,0.0001,2004,8
0.512,1e-05,52,52,50,2,0.0001,104,9
0.512,1e-05,98,106,50,2,0.0001,204,9
0.512,1e-05,147,157,50,2,0.0001,304,9
0.512,1e-05,202,202,50,2,0.0001,404,9
0.512,1e-05,252,252,50,2,0.0001,504,9
0.512,1e-05,299,305,50,2,0.0001,604,9
0.512,1e-05,341,363,50,2,0.0001,704,9
0.514,1e-05,391,413,50,2,0.0001,804,9
0.514,1e-05,447,457,50,2,0.0001,904,9
0.514,1e-05,498,506,50,2,0.0001,1004,9
0.514,1e-05,549,555,50,2,0.0001,1104,9
0.514,1e-05,604,600,50,2,0.0001,1204,9
0.512,1e-05,657,647,50,2,0.0001,1304,9
0.512,1e-05,709,695,50,2,0.0001,1404,9
0.512,1e-05,756,748,50,2,0.0001,1504,9
0.512,1e-05,810,794,50,2,0.0001,1604,9
0.514,1e-05,862,842,50,2,0.0001,1704,9
0.514,1e-05,910,894,50,2,0.0001,1804,9
0.514,1e-05,958,946,50,2,0.0001,1904,9
0.514,1e-05,1001,1003,50,2,0.0001,2004,9
0.506,1e-05,57,47,50,2,0.0001,104,10
0.506,1e-05,102,102,50,2,0.0001,204,10
0.506,1e-05,155,149,50,2,0.0001,304,10
0.506,1e-05,202,202,50,2,0.0001,404,10
0.506,1e-05,249,255,50,2,0.0001,504,10
0.506,1e-05,302,302,50,2,0.0001,604,10
0.506,1e-05,350,354,50,2,0.0001,704,10
0.506,1e-05,396,408,50,2,0.0001,804,10
0.506,1e-05,448,456,50,2,0.0001,904,10
0.506,1e-05,499,505,50,2,0.0001,1004,10
0.506,1e-05,548,556,50,2,0.0001,1104,10
0.506,1e-05,602,602,50,2,0.0001,1204,10
0.506,1e-05,649,655,50,2,0.0001,1304,10
0.506,1e-05,684,720,50,2,0.0001,1404,10
0.506,1e-05,739,765,50,2,0.0001,1504,10
0.506,1e-05,795,809,50,2,0.0001,1604,10
0.504,1e-05,842,862,50,2,0.0001,1704,10
0.504,1e-05,895,909,50,2,0.0001,1804,10
0.504,1e-05,946,958,50,2,0.0001,1904,10
0.504,1e-05,1000,1004,50,2,0.0001,2004,10
0.49,1e-05,53,51,50,2,0.0001,104,11
0.49,1e-05,98,106,50,2,0.0001,204,11
0.49,1e-05,151,153,50,2,0.0001,304,11
0.49,1e-05,205,199,50,2,0.0001,404,11
0.49,1e-05,248,256,50,2,0.0001,504,11
0.49,1e-05,294,310,50,2,0.0001,604,11
0.49,1e-05,339,365,50,2,0.0001,704,11
0.49,1e-05,398,406,50,2,0.0001,804,11
0.49,1e-05,446,458,50,2,0.0001,904,11
0.49,1e-05,496,508,50,2,0.0001,1004,11
0.49,1e-05,547,557,50,2,0.0001,1104,11
0.49,1e-05,589,615,50,2,0.0001,1204,11
0.49,1e-05,646,658,50,2,0.0001,1304,11
0.49,1e-05,701,703,50,2,0.0001,1404,11
0.49,1e-05,755,749,50,2,0.0001,1504,11
0.49,1e-05,805,799,50,2,0.0001,1604,11
0.49,1e-05,851,853,50,2,0.0001,1704,11
0.49,1e-05,908,896,50,2,0.0001,1804,11
0.49,1e-05,959,945,50,2,0.0001,1904,11
0.49,1e-05,1007,997,50,2,0.0001,2004,11
0.49,1e-05,50,54,50,2,0.0001,104,12
0.49,1e-05,101,103,50,2,0.0001,204,12
0.49,1e-05,150,154,50,2,0.0001,304,12
0.49,1e-05,193,211,50,2,0.0001,404,12
0.49,1e-05,239,265,50,2,0.0001,504,12
0.49,1e-05,294,310,50,2,0.0001,604,12
0.49,1e-05,338,366,50,2,0.0001,704,12
0.49,1e-05,394,410,50,2,0.0001,804,12
0.49,1e-05,445,459,50,2,0.0001,904,12
0.49,1e-05,496,508,50,2,0.0001,1004,12
0.49,1e-05,541,563,50,2,0.0001,1104,12
0.49,1e-05,590,614,50,2,0.0001,1204,12
0.49,1e-05,639,665,50,2,0.0001,1304,12
0.488,1e-05,688,716,50,2,0.0001,1404,12
0.488,1e-05,742,762,50,2,0.0001,1504,12
0.488,1e-05,787,817,50,2,0.0001,1604,12
0.492,1e-05,839,865,50,2,0.0001,1704,12
0.492,1e-05,896,908,50,2,0.0001,1804,12
0.494,1e-05,950,954,50,2,0.0001,1904,12
0.494,1e-05,996,1008,50,2,0.0001,2004,12
0.49,1e-05,55,49,50,2,0.0001,104,13
0.49,1e-05,101,103,50,2,0.0001,204,13
0.49,1e-05,139,165,50,2,0.0001,304,13
0.49,1e-05,186,218,50,2,0.0001,404,13
0.49,1e-05,235,269,50,2,0.0001,504,13
0.49,1e-05,287,317,50,2,0.0001,604,13
0.49,1e-05,331,373,50,2,0.0001,704,13
0.49,1e-05,387,417,50,2,0.0001,804,13
0.49,1e-05,434,470,50,2,0.0001,904,13
0.49,1e-05,487,517,50,2,0.0001,1004,13
0.49,1e-05,532,572,50,2,0.0001,1104,13
0.49,1e-05,577,627,50,2,0.0001,1204,13
0.49,1e-05,637,667,50,2,0.0001,1304,13
0.49,1e-05,693,711,50,2,0.0001,1404,13
0.49,1e-05,747,757,50,2,0.0001,1504,13
0.49,1e-05,803,801,50,2,0.0001,1604,13
0.49,1e-05,856,848,50,2,0.0001,1704,13
0.49,1e-05,901,903,50,2,0.0001,1804,13
0.49,1e-05,951,953,50,2,0.0001,1904,13
0.49,1e-05,997,1007,50,2,0.0001,2004,13
0.49,1e-05,57,47,50,2,0.0001,104,14
0.49,1e-05,106,98,50,2,0.0001,204,14
0.49,1e-05,153,151,50,2,0.0001,304,14
0.49,1e-05,206,198,50,2,0.0001,404,14
0.49,1e-05,256,248,50,2,0.0001,504,14
0.49,1e-05,311,293,50,2,0.0001,604,14
0.49,1e-05,355,349,50,2,0.0001,704,14
0.49,1e-05,398,406,50,2,0.0001,804,14
0.49,1e-05,454,450,50,2,0.0001,904,14
0.49,1e-05,501,503,50,2,0.0001,1004,14
0.49,1e-05,552,552,50,2,0.0001,1104,14
0.49,1e-05,609,595,50,2,0.0001,1204,14
0.49,1e-05,664,640,50,2,0.0001,1304,14
0.49,1e-05,708,696,50,2,0.0001,1404,14
0.49,1e-05,762,742,50,2,0.0001,1504,14
0.49,1e-05,810,794,50,2,0.0001,1604,14
0.49,1e-05,865,839,50,2,0.0001,1704,14
0.49,1e-05,902,902,50,2,0.0001,1804,14
0.49,1e-05,948,956,50,2,0.0001,1904,14
0.49,1e-05,997,1007,50,2,0.0001,2004,14
0.518,1e-05,45,59,50,2,0.0001,104,15
0.518,1e-05,93,111,50,2,0.0001,204,15
0.516,1e-05,137,167,50,2,0.0001,304,15
0.516,1e-05,179,225,50,2,0.0001,404,15
0.516,1e-05,231,273,50,2,0.0001,504,15
0.516,1e-05,280,324,50,2,0.0001,604,15
0.516,1e-05,336,368,50,2,0.0001,704,15
0.516,1e-05,384,420,50,2,0.0001,804,15
0.516,1e-05,427,477,50,2,0.0001,904,15
0.516,1e-05,479,525,50,2,0.0001,1004,15
0.516,1e-05,537,567,50,2,0.0001,1104,15
0.516,1e-05,586,618,50,2,0.0001,1204,15
0.516,1e-05,633,671,50,2,0.0001,1304,15
0.522,1e-05,679,725,50,2,0.0001,1404,15
0.522,1e-05,732,772,50,2,0.0001,1504,15
0.522,1e-05,788,816,50,2,0.0001,1604,15
0.52,1e-05,837,867,50,2,0.0001,1704,15
0.52,1e-05,896,908,50,2,0.0001,1804,15
0.522,1e-05,951,953,50,2,0.0001,1904,15
0.522,1e-05,994,1010,50,2,0.0001,2004,15
0.508,1e-05,49,55,50,2,0.0001,104,16
0.51,1e-05,108,96,50,2,0.0001,204,16
0.51,1e-05,160,144,50,2,0.0001,304,16
0.51,1e-05,208,196,50,2,0.0001,404,16
0.51,1e-05,262,242,50,2,0.0001,504,16
0.51,1e-05,309,295,50,2,0.0001,604,16
0.51,1e-05,365,339,50,2,0.0001,704,16
0.51,1e-05,411,393,50,2,0.0001,804,16
0.51,1e-05,460,444,50,2,0.0001,904,16
0.51,1e-05,511,493,50,2,0.0001,1004,16
0.51,1e-05,552,552,50,2,0.0001,1104,16
0.51,1e-05,599,605,50,2,0.0001,1204,16
0.508,1e-05,652,652,50,2,0.0001,1304,16
0.508,1e-05,698,706,50,2,0.0001,1404,16
0.51,1e-05,748,756,50,2,0.0001,1504,16
0.51,1e-05,798,806,50,2,0.0001,1604,16
0.51,1e-05,845,859,50,2,0.0001,1704,16
0.51,1e-05,892,912,50,2,0.0001,1804,16
0.51,1e-05,951,953,50,2,0.0001,1904,16
0.51,1e-05,995,1009,50,2,0.0001,2004,16
0.506,1e-05,46,58,50,2,0.0001,104,17
0.506,1e-05,101,103,50,2,0.0001,204,17
0.506,1e-05,147,157,50,2,0.0001,304,17
0.506,1e-05,202,202,50,2,0.0001,404,17
0.506,1e-05,261,243,50,2,0.0001,504,17
0.506,1e-05,308,296,50,2,0.0001,604,17
0.506,1e-05,363,341,50,2,0.0001,704,17
0.506,1e-05,411,393,50,2,0.0001,804,17
0.506,1e-05,459,445,50,2,0.0001,904,17
0.506,1e-05,506,498,50,2,0.0001,1004,17
0.506,1e-05,554,550,50,2,0.0001,1104,17
0.506,1e-05,601,603,50,2,0.0001,1204,17
0.506,1e-05,646,658,50,2,0.0001,1304,17
0.506,1e-05,700,704,50,2,0.0001,1404,17
0.506,1e-05,752,752,50,2,0.0001,1504,17
0.506,1e-05,807,797,50,2,0.0001,1604,17
0.506,1e-05,855,849,50,2,0.0001,1704,17
0.506,1e-05,902,902,50,2,0.0001,1804,17
0.506,1e-05,955,949,50,2,0.0001,1904,17
0.506,1e-05,1005,999,50,2,0.0001,2004,17
0.49,1e-05,61,43,50,2,0.0001,104,18
0.49,1e-05,121,83,50,2,0.0001,204,18
0.49,1e-05,173,131,50,2,0.0001,304,18
0.49,1e-05,217,187,50,2,0.0001,404,18
0.49,1e-05,271,233,50,2,0.0001,504,18
0.49,1e-05,327,277,50,2,0.0001,604,18
0.49,1e-05,379,325,50,2,0.0001,704,18
0.49,1e-05,430,374,50,2,0.0001,804,18
0.49,1e-05,482,422,50,2,0.0001,904,18
0.49,1e-05,539,465,50,2,0.0001,1004,18
0.49,1e-05,581,523,50,2,0.0001,1104,18
0.49,1e-05,632,572,50,2,0.0001,1204,18
0.49,1e-05,679,625,50,2,0.0001,1304,18
0.49,1e-05,734,670,50,2,0.0001,1404,18
0.49,1e-05,782,722,50,2,0.0001,1504,18
0.49,1e-05,838,766,50,2,0.0001,1604,18
0.49,1e-05,882,822,50,2,0.0001,1704,18
0.49,1e-05,927,877,50,2,0.0001,1804,18
0.49,1e-05,967,937,50,2,0.0001,1904,18
0.49,1e-05,1007,997,50,2,0.0001,2004,18
0.496,1e-05,62,42,50,2,0.0001,104,19
0.496,1e-05,116,88,50,2,0.0001,204,19
0.496,1e-05,155,149,50,2,0.0001,304,19
0.496,1e-05,196,208,50,2,0.0001,404,19
0.496,1e-05,252,252,50,2,0.0001,504,19
0.496,1e-05,296,308,50,2,0.0001,604,19
0.496,1e-05,346,358,50,2,0.0001,704,19
0.496,1e-05,401,403,50,2,0.0001,804,19
0.496,1e-05,443,461,50,2,0.0001,904,19
0.496,1e-05,496,508,50,2,0.0001,1004,19
0.496,1e-05,549,555,50,2,0.0001,1104,19
0.496,1e-05,598,606,50,2,0.0001,1204,19
0.496,1e-05,649,655,50,2,0.0001,1304,19
0.496,1e-05,707,697,50,2,0.0001,1404,19
0.496,1e-05,761,743,50,2,0.0001,1504,19
0.496,1e-05,807,797,50,2,0.0001,1604,19
0.496,1e-05,855,849,50,2,0.0001,1704,19
0.496,1e-05,905,899,50,2,0.0001,1804,19
0.496,1e-05,956,948,50,2,0.0001,1904,19
0.496,1e-05,1004,1000,50,2,0.0001,2004,19
0.454,1e-05,52,52,50,2,0.0001,104,20
0.454,1e-05,103,101,50,2,0.0001,204,20
0.454,1e-05,155,149,50,2,0.0001,304,20
0.454,1e-05,212,192,50,2,0.0001,404,20
0.454,1e-05,260,244,50,2,0.0001,504,20
0.454,1e-05,314,290,50,2,0.0001,604,20
0.454,1e-05,373,331,50,2,0.0001,704,20
0.454,1e-05,429,375,50,2,0.0001,804,20
0.454,1e-05,474,430,50,2,0.0001,904,20
0.454,1e-05,524,480,50,2,0.0001,1004,20
0.454,1e-05,579,525,50,2,0.0001,1104,20
0.454,1e-05,627,577,50,2,0.0001,1204,20
0.454,1e-05,671,633,50,2,0.0001,1304,20
0.454,1e-05,729,675,50,2,0.0001,1404,20
0.454,1e-05,777,727,50,2,0.0001,1504,20
0.454,1e-05,826,778,50,2,0.0001,1604,20
0.454,1e-05,878,826,50,2,0.0001,1704,20
0.456,1e-05,927,877,50,2,0.0001,1804,20
0.458,1e-05,976,928,50,2,0.0001,1904,20
0.46,1e-05,1028,976,50,2,0.0001,2004,20
0.464,1e-05,50,54,50,2,0.001,104,1
0.468,1e-05,105,99,50,2,0.001,204,1
0.468,1e-05,153,151,50,2,0.001,304,1
0.468,1e-05,205,199,50,2,0.001,404,1
0.47,1e-05,254,250,50,2,0.001,504,1
0.468,1e-05,302,302,50,2,0.001,604,1
0.468,1e-05,348,356,50,2,0.001,704,1
0.468,1e-05,397,407,50,2,0.001,804,1
0.468,1e-05,444,460,50,2,0.001,904,1
0.47,1e-05,498,506,50,2,0.001,1004,1
0.47,1e-05,550,554,50,2,0.001,1104,1
0.468,1e-05,597,607,50,2,0.001,1204,1
0.47,1e-05,643,661,50,2,0.001,1304,1
0.472,1e-05,691,713,50,2,0.001,1404,1
0.472,1e-05,740,764,50,2,0.001,1504,1
0.476,1e-05,793,811,50,2,0.001,1604,1
0.48,1e-05,840,864,50,2,0.001,1704,1
0.484,1e-05,882,922,50,2,0.001,1804,1
0.482,1e-05,939,965,50,2,0.001,1904,1
0.484,1e-05,987,1017,50,2,0.001,2004,1
0.5,1e-05,51,53,50,2,0.001,104,2
0.5,1e-05,106,98,50,2,0.001,204,2
0.502,1e-05,155,149,50,2,0.001,304,2
0.504,1e-05,211,193,50,2,0.001,404,2
0.504,1e-05,254,250,50,2,0.001,504,2
0.504,1e-05,300,304,50,2,0.001,604,2
0.504,1e-05,352,352,50,2,0.001,704,2
0.51,1e-05,396,408,50,2,0.001,804,2
0.512,1e-05,446,458,50,2,0.001,904,2
0.516,1e-05,500,504,50,2,0.001,1004,2
0.518,1e-05,548,556,50,2,0.001,1104,2
0.518,1e-05,599,605,50,2,0.001,1204,2
0.52,1e-05,641,663,50,2,0.001,1304,2
0.526,1e-05,701,703,50,2,0.001,1404,2
0.528,1e-05,752,752,50,2,0.001,1504,2
0.536,1e-05,794,810,50,2,0.001,1604,2
0.538,1e-05,853,851,50,2,0.001,1704,2
0.544,1e-05,904,900,50,2,0.001,1804,2
0.546,1e-05,956,948,50,2,0.001,1904,2
0.556,1e-05,1007,997,50,2,0.001,2004,2
0.482,1e-05,46,58,50,2,0.001,104,3
0.482,1e-05,102,102,50,2,0.001,204,3
0.482,1e-05,150,154,50,2,0.001,304,3
0.486,1e-05,196,208,50,2,0.001,404,3
0.49,1e-05,239,265,50,2,0.001,504,3
0.494,1e-05,297,307,50,2,0.001,604,3
0.5,1e-05,349,355,50,2,0.001,704,3
0.498,1e-05,396,408,50,2,0.001,804,3
0.494,1e-05,447,457,50,2,0.001,904,3
0.496,1e-05,496,508,50,2,0.001,1004,3
0.496,1e-05,531,573,50,2,0.001,1104,3
0.492,1e-05,572,632,50,2,0.001,1204,3
0.494,1e-05,625,679,50,2,0.001,1304,3
0.492,1e-05,668,736,50,2,0.001,1404,3
0.498,1e-05,728,776,50,2,0.001,1504,3
0.5,1e-05,778,826,50,2,0.001,1604,3
0.506,1e-05,836,868,50,2,0.001,1704,3
0.504,1e-05,883,921,50,2,0.001,1804,3
0.51,1e-05,941,963,50,2,0.001,1904,3
0.516,1e-05,988,1016,50,2,0.001,2004,3
0.468,1e-05,43,61,50,2,0.001,104,4
0.468,1e-05,89,115,50,2,0.001,204,4
0.468,1e-05,140,164,50,2,0.001,304,4
0.468,1e-05,190,214,50,2,0.001,404,4
0.468,1e-05,239,265,50,2,0.001,504,4
0.468,1e-05,289,315,50,2,0.001,604,4
0.468,1e-05,339,365,50,2,0.001,704,4
0.468,1e-05,393,411,50,2,0.001,804,4
0.468,1e-05,444,460,50,2,0.001,904,4
0.468,1e-05,504,500,50,2,0.001,1004,4
0.468,1e-05,554,550,50,2,0.001,1104,4
0.468,1e-05,599,605,50,2,0.001,1204,4
0.468,1e-05,644,660,50,2,0.001,1304,4
0.468,1e-05,689,715,50,2,0.001,1404,4
0.468,1e-05,737,767,50,2,0.001,1504,4
0.468,1e-05,792,812,50,2,0.001,1604,4
0.468,1e-05,836,868,50,2,0.001,1704,4
0.468,1e-05,891,913,50,2,0.001,1804,4
0.468,1e-05,939,965,50,2,0.001,1904,4
0.468,1e-05,986,1018,50,2,0.001,2004,4
0.488,1e-05,51,53,50,2,0.001,104,5
0.488,1e-05,99,105,50,2,0.001,204,5
0.492,1e-05,156,148,50,2,0.001,304,5
0.492,1e-05,201,203,50,2,0.001,404,5
0.49,1e-05,249,255,50,2,0.001,504,5
0.498,1e-05,297,307,50,2,0.001,604,5
0.502,1e-05,349,355,50,2,0.001,704,5
0.504,1e-05,399,405,50,2,0.001,804,5
0.51,1e-05,451,453,50,2,0.001,904,5
0.514,1e-05,504,500,50,2,0.001,1004,5
0.512,1e-05,548,556,50,2,0.001,1104,5
0.518,1e-05,597,607,50,2,0.001,1204,5
0.524,1e-05,645,659,50,2,0.001,1304,5
0.53,1e-05,697,707,50,2,0.001,1404,5
0.532,1e-05,745,759,50,2,0.001,1504,5
0.532,1e-05,793,811,50,2,0.001,1604,5
0.534,1e-05,844,860,50,2,0.001,1704,5
0.538,1e-05,901,903,50,2,0.001,1804,5
0.5,1e-05,958,946,50,2,0.001,1904,5
0.5,1e-05,1016,988,50,2,0.001,2004,5
0.452,1e-05,55,49,50,2,0.001,104,6
0.452,1e-05,111,93,50,2,0.001,204,6
0.45,1e-05,164,140,50,2,0.001,304,6
0.452,1e-05,218,186,50,2,0.001,404,6
0.45,1e-05,259,245,50,2,0.001,504,6
0.45,1e-05,311,293,50,2,0.001,604,6
0.454,1e-05,366,338,50,2,0.001,704,6
0.45,1e-05,416,388,50,2,0.001,804,6
0.452,1e-05,470,434,50,2,0.001,904,6
0.454,1e-05,520,484,50,2,0.001,1004,6
0.45,1e-05,561,543,50,2,0.001,1104,6
0.452,1e-05,603,601,50,2,0.001,1204,6
0.452,1e-05,652,652,50,2,0.001,1304,6
0.46,1e-05,697,707,50,2,0.001,1404,6
0.47,1e-05,749,755,50,2,0.001,1504,6
0.466,1e-05,801,803,50,2,0.001,1604,6
0.47,1e-05,851,853,50,2,0.001,1704,6
0.474,1e-05,902,902,50,2,0.001,1804,6
0.476,1e-05,965,939,50,2,0.001,1904,6
0.482,1e-05,1011,993,50,2,0.001,2004,6
0.446,1e-05,51,53,50,2,0.001,104,7
0.448,1e-05,96,108,50,2,0.001,204,7
0.448,1e-05,150,154,50,2,0.001,304,7
0.448,1e-05,210,194,50,2,0.001,404,7
0.45,1e-05,269,235,50,2,0.001,504,7
0.45,1e-05,318,286,50,2,0.001,604,7
0.452,1e-05,365,339,50,2,0.001,704,7
0.45,1e-05,418,386,50,2,0.001,804,7
0.448,1e-05,475,429,50,2,0.001,904,7
0.452,1e-05,523,481,50,2,0.001,1004,7
0.456,1e-05,564,540,50,2,0.001,1104,7
0.458,1e-05,614,590,50,2,0.001,1204,7
0.46,1e-05,663,641,50,2,0.001,1304,7
0.462,1e-05,715,689,50,2,0.001,1404,7
0.462,1e-05,763,741,50,2,0.001,1504,7
0.46,1e-05,816,788,50,2,0.001,1604,7
0.462,1e-05,870,834,50,2,0.001,1704,7
0.468,1e-05,931,873,50,2,0.001,1804,7
0.476,1e-05,982,922,50,2,0.001,1904,7
0.472,1e-05,1030,974,50,2,0.001,2004,7
0.508,1e-05,45,59,50,2,0.001,104,8
0.508,1e-05,97,107,50,2,0.001,204,8
0.508,1e-05,144,160,50,2,0.001,304,8
0.508,1e-05,197,207,50,2,0.001,404,8
0.508,1e-05,251,253,50,2,0.001,504,8
0.508,1e-05,305,299,50,2,0.001,604,8
0.508,1e-05,345,359,50,2,0.001,704,8
0.508,1e-05,397,407,50,2,0.001,804,8
0.508,1e-05,450,454,50,2,0.001,904,8
0.508,1e-05,493,511,50,2,0.001,1004,8
0.508,1e-05,539,565,50,2,0.001,1104,8
0.508,1e-05,589,615,50,2,0.001,1204,8
0.508,1e-05,643,661,50,2,0.001,1304,8
0.508,1e-05,692,712,50,2,0.001,1404,8
0.508,1e-05,742,762,50,2,0.001,1504,8
0.508,1e-05,799,805,50,2,0.001,1604,8
0.508,1e-05,851,853,50,2,0.001,1704,8
0.508,1e-05,891,913,50,2,0.001,1804,8
0.508,1e-05,947,957,50,2,0.001,1904,8
0.508,1e-05,1006,998,50,2,0.001,2004,8
0.552,1e-05,45,59,50,2,0.001,104,9
0.552,1e-05,96,108,50,2,0.001,204,9
0.552,1e-05,151,153,50,2,0.001,304,9
0.558,1e-05,210,194,50,2,0.001,404,9
0.558,1e-05,258,246,50,2,0.001,504,9
0.56,1e-05,309,295,50,2,0.001,604,9
0.558,1e-05,354,350,50,2,0.001,704,9
0.56,1e-05,402,402,50,2,0.001,804,9
0.562,1e-05,445,459,50,2,0.001,904,9
0.56,1e-05,487,517,50,2,0.001,1004,9
0.558,1e-05,541,563,50,2,0.001,1104,9
0.566,1e-05,597,607,50,2,0.001,1204,9
0.572,1e-05,646,658,50,2,0.001,1304,9
0.572,1e-05,699,705,50,2,0.001,1404,9
0.568,1e-05,749,755,50,2,0.001,1504,9
0.568,1e-05,788,816,50,2,0.001,1604,9
0.572,1e-05,843,861,50,2,0.001,1704,9
0.582,1e-05,892,912,50,2,0.001,1804,9
0.588,1e-05,938,966,50,2,0.001,1904,9
0.596,1e-05,981,1023,50,2,0.001,2004,9
0.514,1e-05,52,52,50,2,0.001,104,10
0.514,1e-05,97,107,50,2,0.001,204,10
0.514,1e-05,149,155,50,2,0.001,304,10
0.514,1e-05,195,209,50,2,0.001,404,10
0.514,1e-05,245,259,50,2,0.001,504,10
0.514,1e-05,304,300,50,2,0.001,604,10
0.514,1e-05,362,342,50,2,0.001,704,10
0.514,1e-05,416,388,50,2,0.001,804,10
0.514,1e-05,467,437,50,2,0.001,904,10
0.514,1e-05,509,495,50,2,0.001,1004,10
0.514,1e-05,554,550,50,2,0.001,1104,10
0.514,1e-05,601,603,50,2,0.001,1204,10
0.514,1e-05,650,654,50,2,0.001,1304,10
0.514,1e-05,699,705,50,2,0.001,1404,10
0.514,1e-05,748,756,50,2,0.001,1504,10
0.514,1e-05,797,807,50,2,0.001,1604,10
0.514,1e-05,847,857,50,2,0.001,1704,10
0.514,1e-05,893,911,50,2,0.001,1804,10
0.514,1e-05,942,962,50,2,0.001,1904,10
0.514,1e-05,995,1009,50,2,0.001,2004,10
0.482,1e-05,43,61,50,2,0.001,104,11
0.482,1e-05,102,102,50,2,0.001,204,11
0.482,1e-05,151,153,50,2,0.001,304,11
0.486,1e-05,209,195,50,2,0.001,404,11
0.484,1e-05,265,239,50,2,0.001,504,11
0.486,1e-05,316,288,50,2,0.001,604,11
0.486,1e-05,368,336,50,2,0.001,704,11
0.488,1e-05,422,382,50,2,0.001,804,11
0.492,1e-05,476,428,50,2,0.001,904,11
0.492,1e-05,518,486,50,2,0.001,1004,11
0.494,1e-05,569,535,50,2,0.001,1104,11
0.494,1e-05,618,586,50,2,0.001,1204,11
0.496,1e-05,666,638,50,2,0.001,1304,11
0.494,1e-05,708,696,50,2,0.001,1404,11
0.494,1e-05,759,745,50,2,0.001,1504,11
0.498,1e-05,811,793,50,2,0.001,1604,11
0.496,1e-05,863,841,50,2,0.001,1704,11
0.494,1e-05,904,900,50,2,0.001,1804,11
0.502,1e-05,957,947,50,2,0.001,1904,11
0.508,1e-05,1011,993,50,2,0.001,2004,11
0.492,1e-05,42,62,50,2,0.001,104,12
0.492,1e-05,94,110,50,2,0.001,204,12
0.492,1e-05,156,148,50,2,0.001,304,12
0.492,1e-05,213,191,50,2,0.001,404,12
0.492,1e-05,266,238,50,2,0.001,504,12
0.492,1e-05,314,290,50,2,0.001,604,12
0.492,1e-05,366,338,50,2,0.001,704,12
0.492,1e-05,409,395,50,2,0.001,804,12
0.492,1e-05,457,447,50,2,0.001,904,12
0.492,1e-05,514,490,50,2,0.001,1004,12
0.492,1e-05,561,543,50,2,0.001,1104,12
0.492,1e-05,611,593,50,2,0.001,1204,12
0.492,1e-05,662,642,50,2,0.001,1304,12
0.492,1e-05,714,690,50,2,0.001,1404,12
0.492,1e-05,760,744,50,2,0.001,1504,12
0.492,1e-05,809,795,50,2,0.001,1604,12
0.492,1e-05,856,848,50,2,0.001,1704,12
0.492,1e-05,904,900,50,2,0.001,1804,12
0.492,1e-05,957,947,50,2,0.001,1904,12
0.492,1e-05,1006,998,50,2,0.001,2004,12
0.5,1e-05,52,52,50,2,0.001,104,13
0.5,1e-05,109,95,50,2,0.001,204,13
0.502,1e-05,157,147,50,2,0.001,304,13
0.502,1e-05,211,193,50,2,0.001,404,13
0.508,1e-05,254,250,50,2,0.001,504,13
0.512,1e-05,298,306,50,2,0.001,604,13
0.518,1e-05,346,358,50,2,0.001,704,13
0.52,1e-05,396,408,50,2,0.001,804,13
0.52,1e-05,454,450,50,2,0.001,904,13
0.526,1e-05,502,502,50,2,0.001,1004,13
0.528,1e-05,551,553,50,2,0.001,1104,13
0.53,1e-05,602,602,50,2,0.001,1204,13
0.534,1e-05,650,654,50,2,0.001,1304,13
0.548,1e-05,693,711,50,2,0.001,1404,13
0.546,1e-05,741,763,50,2,0.001,1504,13
0.544,1e-05,793,811,50,2,0.001,1604,13
0.56,1e-05,844,860,50,2,0.001,1704,13
0.574,1e-05,900,904,50,2,0.001,1804,13
0.568,1e-05,946,958,50,2,0.001,1904,13
0.566,1e-05,1000,1004,50,2,0.001,2004,13
0.486,1e-05,54,50,50,2,0.001,104,14
0.486,1e-05,108,96,50,2,0.001,204,14
0.486,1e-05,160,144,50,2,0.001,304,14
0.486,1e-05,207,197,50,2,0.001,404,14
0.486,1e-05,250,254,50,2,0.001,504,14
0.486,1e-05,303,301,50,2,0.001,604,14
0.486,1e-05,354,350,50,2,0.001,704,14
0.486,1e-05,401,403,50,2,0.001,804,14
0.486,1e-05,451,453,50,2,0.001,904,14
0.486,1e-05,496,508,50,2,0.001,1004,14
0.486,1e-05,544,560,50,2,0.001,1104,14
0.486,1e-05,597,607,50,2,0.001,1204,14
0.486,1e-05,650,654,50,2,0.001,1304,14
0.486,1e-05,703,701,50,2,0.001,1404,14
0.486,1e-05,752,752,50,2,0.001,1504,14
0.486,1e-05,801,803,50,2,0.001,1604,14
0.486,1e-05,843,861,50,2,0.001,1704,14
0.486,1e-05,891,913,50,2,0.001,1804,14
0.486,1e-05,948,956,50,2,0.001,1904,14
0.486,1e-05,1009,995,50,2,0.001,2004,14
0.518,1e-05,51,53,50,2,0.001,104,15
0.522,1e-05,98,106,50,2,0.001,204,15
0.524,1e-05,151,153,50,2,0.001,304,15
0.524,1e-05,204,200,50,2,0.001,404,15
0.524,1e-05,259,245,50,2,0.001,504,15
0.524,1e-05,307,297,50,2,0.001,604,15
0.522,1e-05,357,347,50,2,0.001,704,15
0.524,1e-05,400,404,50,2,0.001,804,15
0.522,1e-05,456,448,50,2,0.001,904,15
0.524,1e-05,505,499,50,2,0.001,1004,15
0.528,1e-05,557,547,50,2,0.001,1104,15
0.532,1e-05,598,606,50,2,0.001,1204,15
0.532,1e-05,654,650,50,2,0.001,1304,15
0.53,1e-05,710,694,50,2,0.001,1404,15
0.534,1e-05,754,750,50,2,0.001,1504,15
0.534,1e-05,806,798,50,2,0.001,1604,15
0.538,1e-05,860,844,50,2,0.001,1704,15
0.54,1e-05,910,894,50,2,0.001,1804,15
0.542,1e-05,958,946,50,2,0.001,1904,15
0.542,1e-05,1005,999,50,2,0.001,2004,15
0.508,1e-05,55,49,50,2,0.001,104,16
0.51,1e-05,114,90,50,2,0.001,204,16
0.512,1e-05,167,137,50,2,0.001,304,16
0.512,1e-05,220,184,50,2,0.001,404,16
0.51,1e-05,270,234,50,2,0.001,504,16
0.512,1e-05,317,287,50,2,0.001,604,16
0.514,1e-05,361,343,50,2,0.001,704,16
0.516,1e-05,411,393,50,2,0.001,804,16
0.514,1e-05,459,445,50,2,0.001,904,16
0.516,1e-05,514,490,50,2,0.001,1004,16
0.514,1e-05,559,545,50,2,0.001,1104,16
0.518,1e-05,609,595,50,2,0.001,1204,16
0.522,1e-05,662,642,50,2,0.001,1304,16
0.526,1e-05,709,695,50,2,0.001,1404,16
0.526,1e-05,753,751,50,2,0.001,1504,16
0.536,1e-05,804,800,50,2,0.001,1604,16
0.546,1e-05,852,852,50,2,0.001,1704,16
0.55,1e-05,905,899,50,2,0.001,1804,16
0.55,1e-05,953,951,50,2,0.001,1904,16
0.56,1e-05,1005,999,50,2,0.001,2004,16
0.532,1e-05,52,52,50,2,0.001,104,17
0.53,1e-05,98,106,50,2,0.001,204,17
0.53,1e-05,147,157,50,2,0.001,304,17
0.53,1e-05,193,211,50,2,0.001,404,17
0.532,1e-05,247,257,50,2,0.001,504,17
0.536,1e-05,299,305,50,2,0.001,604,17
0.536,1e-05,350,354,50,2,0.001,704,17
0.538,1e-05,399,405,50,2,0.001,804,17
0.54,1e-05,449,455,50,2,0.001,904,17
0.54,1e-05,500,504,50,2,0.001,1004,17
0.54,1e-05,551,553,50,2,0.001,1104,17
0.54,1e-05,599,605,50,2,0.001,1204,17
0.542,1e-05,648,656,50,2,0.001,1304,17
0.55,1e-05,700,704,50,2,0.001,1404,17
0.546,1e-05,751,753,50,2,0.001,1504,17
0.55,1e-05,801,803,50,2,0.001,1604,17
0.558,1e-05,849,855,50,2,0.001,1704,17
0.572,1e-05,907,897,50,2,0.001,1804,17
0.576,1e-05,962,942,50,2,0.001,1904,17
0.58,1e-05,1013,991,50,2,0.001,2004,17
0.486,1e-05,45,59,50,2,0.001,104,18
0.486,1e-05,95,109,50,2,0.001,204,18
0.486,1e-05,132,172,50,2,0.001,304,18
0.486,1e-05,183,221,50,2,0.001,404,18
0.486,1e-05,239,265,50,2,0.001,504,18
0.486,1e-05,291,313,50,2,0.001,604,18
0.486,1e-05,340,364,50,2,0.001,704,18
0.486,1e-05,396,408,50,2,0.001,804,18
0.486,1e-05,447,457,50,2,0.001,904,18
0.486,1e-05,494,510,50,2,0.001,1004,18
0.486,1e-05,538,566,50,2,0.001,1104,18
0.486,1e-05,584,620,50,2,0.001,1204,18
0.486,1e-05,644,660,50,2,0.001,1304,18
0.486,1e-05,688,716,50,2,0.001,1404,18
0.486,1e-05,738,766,50,2,0.001,1504,18
0.486,1e-05,796,808,50,2,0.001,1604,18
0.486,1e-05,839,865,50,2,0.001,1704,18
0.486,1e-05,894,910,50,2,0.001,1804,18
0.486,1e-05,942,962,50,2,0.001,1904,18
0.486,1e-05,995,1009,50,2,0.001,2004,18
0.512,1e-05,58,46,50,2,0.001,104,19
0.514,1e-05,103,101,50,2,0.001,204,19
0.508,1e-05,151,153,50,2,0.001,304,19
0.51,1e-05,202,202,50,2,0.001,404,19
0.51,1e-05,247,257,50,2,0.001,504,19
0.508,1e-05,302,302,50,2,0.001,604,19
0.512,1e-05,352,352,50,2,0.001,704,19
0.508,1e-05,397,407,50,2,0.001,804,19
0.502,1e-05,441,463,50,2,0.001,904,19
0.504,1e-05,492,512,50,2,0.001,1004,19
0.506,1e-05,547,557,50,2,0.001,1104,19
0.51,1e-05,603,601,50,2,0.001,1204,19
0.504,1e-05,655,649,50,2,0.001,1304,19
0.508,1e-05,701,703,50,2,0.001,1404,19
0.51,1e-05,747,757,50,2,0.001,1504,19
0.508,1e-05,798,806,50,2,0.001,1604,19
0.512,1e-05,851,853,50,2,0.001,1704,19
0.52,1e-05,900,904,50,2,0.001,1804,19
0.524,1e-05,953,951,50,2,0.001,1904,19
0.532,1e-05,1001,1003,50,2,0.001,2004,19
0.52,1e-05,55,49,50,2,0.001,104,20
0.52,1e-05,107,97,50,2,0.001,204,20
0.52,1e-05,156,148,50,2,0.001,304,20
0.524,1e-05,198,206,50,2,0.001,404,20
0.528,1e-05,252,252,50,2,0.001,504,20
0.528,1e-05,304,300,50,2,0.001,604,20
0.526,1e-05,358,346,50,2,0.001,704,20
0.528,1e-05,410,394,50,2,0.001,804,20
0.528,1e-05,456,448,50,2,0.001,904,20
0.528,1e-05,508,496,50,2,0.001,1004,20
0.532,1e-05,554,550,50,2,0.001,1104,20
0.53,1e-05,595,609,50,2,0.001,1204,20
0.53,1e-05,642,662,50,2,0.001,1304,20
0.526,1e-05,691,713,50,2,0.001,1404,20
0.522,1e-05,741,763,50,2,0.001,1504,20
0.522,1e-05,794,810,50,2,0.001,1604,20
0.53,1e-05,844,860,50,2,0.001,1704,20
0.538,1e-05,901,903,50,2,0.001,1804,20
0.55,1e-05,947,957,50,2,0.001,1904,20
0.556,1e-05,986,1018,50,2,0.001,2004,20
0.546,1e-05,59,45,50,2,0.01,104,1
0.554,1e-05,106,98,50,2,0.01,204,1
0.56,1e-05,156,148,50,2,0.01,304,1
0.562,1e-05,213,191,50,2,0.01,404,1
0.57,1e-05,262,242,50,2,0.01,504,1
0.588,1e-05,312,292,50,2,0.01,604,1
0.596,1e-05,358,346,50,2,0.01,704,1
0.616,1e-05,398,406,50,2,0.01,804,1
0.628,1e-05,451,453,50,2,0.01,904,1
0.65,1e-05,508,496,50,2,0.01,1004,1
0.654,1e-05,549,555,50,2,0.01,1104,1
0.684,1e-05,603,601,50,2,0.01,1204,1
0.694,1e-05,655,649,50,2,0.01,1304,1
0.7,1e-05,702,702,50,2,0.01,1404,1
0.708,1e-05,759,745,50,2,0.01,1504,1
0.73,1e-05,814,790,50,2,0.01,1604,1
0.73,1e-05,873,831,50,2,0.01,1704,1
0.744,1e-05,917,887,50,2,0.01,1804,1
0.738,1e-05,959,945,50,2,0.01,1904,1
0.744,1e-05,1016,988,50,2,0.01,2004,1
0.46,1e-05,43,61,50,2,0.01,104,2
0.46,1e-05,91,113,50,2,0.01,204,2
0.46,1e-05,144,160,50,2,0.01,304,2
0.46,1e-05,198,206,50,2,0.01,404,2
0.46,1e-05,246,258,50,2,0.01,504,2
0.464,1e-05,298,306,50,2,0.01,604,2
0.476,1e-05,346,358,50,2,0.01,704,2
0.5,1e-05,387,417,50,2,0.01,804,2
0.538,1e-05,433,471,50,2,0.01,904,2
0.546,1e-05,489,515,50,2,0.01,1004,2
0.574,1e-05,543,561,50,2,0.01,1104,2
0.596,1e-05,590,614,50,2,0.01,1204,2
0.6,1e-05,642,662,50,2,0.01,1304,2
0.616,1e-05,688,716,50,2,0.01,1404,2
0.62,1e-05,727,777,50,2,0.01,1504,2
0.628,1e-05,774,830,50,2,0.01,1604,2
0.636,1e-05,830,874,50,2,0.01,1704,2
0.648,1e-05,876,928,50,2,0.01,1804,2
0.654,1e-05,925,979,50,2,0.01,1904,2
0.658,1e-05,982,1022,50,2,0.01,2004,2
0.49,1e-05,50,54,50,2,0.01,104,3
0.502,1e-05,104,100,50,2,0.01,204,3
0.51,1e-05,155,149,50,2,0.01,304,3
0.522,1e-05,200,204,50,2,0.01,404,3
0.53,1e-05,248,256,50,2,0.01,504,3
0.532,1e-05,295,309,50,2,0.01,604,3
0.544,1e-05,343,361,50,2,0.01,704,3
0.544,1e-05,399,405,50,2,0.01,804,3
0.536,1e-05,453,451,50,2,0.01,904,3
0.546,1e-05,506,498,50,2,0.01,1004,3
0.544,1e-05,555,549,50,2,0.01,1104,3
0.542,1e-05,612,592,50,2,0.01,1204,3
0.552,1e-05,668,636,50,2,0.01,1304,3
0.564,1e-05,714,690,50,2,0.01,1404,3
0.584,1e-05,758,746,50,2,0.01,1504,3
0.596,1e-05,804,800,50,2,0.01,1604,3
0.606,1e-05,859,845,50,2,0.01,1704,3
0.624,1e-05,904,900,50,2,0.01,1804,3
0.622,1e-05,949,955,50,2,0.01,1904,3
0.628,1e-05,1000,1004,50,2,0.01,2004,3
0.54,1e-05,59,45,50,2,0.01,104,4
0.54,1e-05,118,86,50,2,0.01,204,4
0.54,1e-05,172,132,50,2,0.01,304,4
0.538,1e-05,226,178,50,2,0.01,404,4
0.532,1e-05,283,221,50,2,0.01,504,4
0.518,1e-05,327,277,50,2,0.01,604,4
0.514,1e-05,380,324,50,2,0.01,704,4
0.508,1e-05,429,375,50,2,0.01,804,4
0.514,1e-05,478,426,50,2,0.01,904,4
0.504,1e-05,535,469,50,2,0.01,1004,4
0.514,1e-05,587,517,50,2,0.01,1104,4
0.54,1e-05,641,563,50,2,0.01,1204,4
0.542,1e-05,689,615,50,2,0.01,1304,4
0.572,1e-05,734,670,50,2,0.01,1404,4
0.588,1e-05,778,726,50,2,0.01,1504,4
0.62,1e-05,831,773,50,2,0.01,1604,4
0.668,1e-05,877,827,50,2,0.01,1704,4
0.714,1e-05,933,871,50,2,0.01,1804,4
0.736,1e-05,976,928,50,2,0.01,1904,4
0.81,1e-05,1022,982,50,2,0.01,2004,4
0.494,1e-05,45,59,50,2,0.01,104,5
0.494,1e-05,103,101,50,2,0.01,204,5
0.494,1e-05,154,150,50,2,0.01,304,5
0.494,1e-05,198,206,50,2,0.01,404,5
0.494,1e-05,254,250,50,2,0.01,504,5
0.494,1e-05,304,300,50,2,0.01,604,5
0.494,1e-05,348,356,50,2,0.01,704,5
0.494,1e-05,396,408,50,2,0.01,804,5
0.494,1e-05,451,453,50,2,0.01,904,5
0.494,1e-05,500,504,50,2,0.01,1004,5
0.494,1e-05,542,562,50,2,0.01,1104,5
0.494,1e-05,584,620,50,2,0.01,1204,5
0.494,1e-05,631,673,50,2,0.01,1304,5
0.494,1e-05,681,723,50,2,0.01,1404,5
0.494,1e-05,740,764,50,2,0.01,1504,5
0.494,1e-05,792,812,50,2,0.01,1604,5
0.494,1e-05,846,858,50,2,0.01,1704,5
0.828,1e-05,895,909,50,2,0.01,1804,5
0.898,1e-05,953,951,50,2,0.01,1904,5
0.926,1e-05,1005,999,50,2,0.01,2004,5
0.494,1e-05,48,56,50,2,0.01,104,6
0.508,1e-05,96,108,50,2,0.01,204,6
0.524,1e-05,143,161,50,2,0.01,304,6
0.538,1e-05,191,213,50,2,0.01,404,6
0.532,1e-05,254,250,50,2,0.01,504,6
0.542,1e-05,299,305,50,2,0.01,604,6
0.528,1e-05,347,357,50,2,0.01,704,6
0.546,1e-05,387,417,50,2,0.01,804,6
0.55,1e-05,441,463,50,2,0.01,904,6
0.554,1e-05,498,506,50,2,0.01,1004,6
0.568,1e-05,541,563,50,2,0.01,1104,6
0.58,1e-05,582,622,50,2,0.01,1204,6
0.592,1e-05,634,670,50,2,0.01,1304,6
0.586,1e-05,692,712,50,2,0.01,1404,6
0.62,1e-05,737,767,50,2,0.01,1504,6
0.616,1e-05,778,826,50,2,0.01,1604,6
0.632,1e-05,834,870,50,2,0.01,1704,6
0.632,1e-05,886,918,50,2,0.01,1804,6
0.648,1e-05,935,969,50,2,0.01,1904,6
0.662,1e-05,991,1013,50,2,0.01,2004,6
0.518,1e-05,52,52,50,2,0.01,104,7
0.512,1e-05,101,103,50,2,0.01,204,7
0.51,1e-05,150,154,50,2,0.01,304,7
0.51,1e-05,202,202,50,2,0.01,404,7
0.498,1e-05,248,256,50,2,0.01,504,7
0.514,1e-05,300,304,50,2,0.01,604,7
0.522,1e-05,343,361,50,2,0.01,704,7
0.53,1e-05,388,416,50,2,0.01,804,7
0.548,1e-05,433,471,50,2,0.01,904,7
0.566,1e-05,491,513,50,2,0.01,1004,7
0.586,1e-05,540,564,50,2,0.01,1104,7
0.6,1e-05,588,616,50,2,0.01,1204,7
0.626,1e-05,637,667,50,2,0.01,1304,7
0.674,1e-05,694,710,50,2,0.01,1404,7
0.686,1e-05,748,756,50,2,0.01,1504,7
0.714,1e-05,798,806,50,2,0.01,1604,7
0.72,1e-05,856,848,50,2,0.01,1704,7
0.728,1e-05,910,894,50,2,0.01,1804,7
0.74,1e-05,962,942,50,2,0.01,1904,7
0.746,1e-05,1007,997,50,2,0.01,2004,7
0.494,1e-05,45,59,50,2,0.01,104,8
0.494,1e-05,95,109,50,2,0.01,204,8
0.494,1e-05,148,156,50,2,0.01,304,8
0.494,1e-05,198,206,50,2,0.01,404,8
0.494,1e-05,250,254,50,2,0.01,504,8
0.492,1e-05,299,305,50,2,0.01,604,8
0.492,1e-05,350,354,50,2,0.01,704,8
0.5,1e-05,395,409,50,2,0.01,804,8
0.51,1e-05,452,452,50,2,0.01,904,8
0.534,1e-05,499,505,50,2,0.01,1004,8
0.558,1e-05,545,559,50,2,0.01,1104,8
0.572,1e-05,588,616,50,2,0.01,1204,8
0.594,1e-05,640,664,50,2,0.01,1304,8
0.634,1e-05,699,705,50,2,0.01,1404,8
0.69,1e-05,754,750,50,2,0.01,1504,8
0.748,1e-05,798,806,50,2,0.01,1604,8
0.79,1e-05,849,855,50,2,0.01,1704,8
0.84,1e-05,899,905,50,2,0.01,1804,8
0.85,1e-05,945,959,50,2,0.01,1904,8
0.872,1e-05,999,1005,50,2,0.01,2004,8
0.446,1e-05,36,68,50,2,0.01,104,9
0.446,1e-05,80,124,50,2,0.01,204,9
0.446,1e-05,130,174,50,2,0.01,304,9
0.446,1e-05,175,229,50,2,0.01,404,9
0.446,1e-05,227,277,50,2,0.01,504,9
0.448,1e-05,281,323,50,2,0.01,604,9
0.45,1e-05,334,370,50,2,0.01,704,9
0.458,1e-05,383,421,50,2,0.01,804,9
0.462,1e-05,427,477,50,2,0.01,904,9
0.474,1e-05,480,524,50,2,0.01,1004,9
0.492,1e-05,530,574,50,2,0.01,1104,9
0.528,1e-05,583,621,50,2,0.01,1204,9
0.546,1e-05,633,671,50,2,0.01,1304,9
0.59,1e-05,682,722,50,2,0.01,1404,9
0.604,1e-05,733,771,50,2,0.01,1504,9
0.626,1e-05,783,821,50,2,0.01,1604,9
0.63,1e-05,834,870,50,2,0.01,1704,9
0.662,1e-05,883,921,50,2,0.01,1804,9
0.66,1e-05,929,975,50,2,0.01,1904,9
0.67,1e-05,975,1029,50,2,0.01,2004,9
0.48,1e-05,54,50,50,2,0.01,104,10
0.486,1e-05,109,95,50,2,0.01,204,10
0.504,1e-05,151,153,50,2,0.01,304,10
0.536,1e-05,194,210,50,2,0.01,404,10
0.558,1e-05,243,261,50,2,0.01,504,10
0.562,1e-05,295,309,50,2,0.01,604,10
0.582,1e-05,341,363,50,2,0.01,704,10
0.6,1e-05,399,405,50,2,0.01,804,10
0.608,1e-05,443,461,50,2,0.01,904,10
0.614,1e-05,493,511,50,2,0.01,1004,10
0.604,1e-05,543,561,50,2,0.01,1104,10
0.622,1e-05,592,612,50,2,0.01,1204,10
0.614,1e-05,640,664,50,2,0.01,1304,10
0.616,1e-05,691,713,50,2,0.01,1404,10
0.636,1e-05,732,772,50,2,0.01,1504,10
0.654,1e-05,783,821,50,2,0.01,1604,10
0.662,1e-05,839,865,50,2,0.01,1704,10
0.66,1e-05,891,913,50,2,0.01,1804,10
0.668,1e-05,943,961,50,2,0.01,1904,10
0.668,1e-05,994,1010,50,2,0.01,2004,10
0.49,1e-05,49,55,50,2,0.01,104,11
0.506,1e-05,92,112,50,2,0.01,204,11
0.502,1e-05,133,171,50,2,0.01,304,11
0.506,1e-05,188,216,50,2,0.01,404,11
0.512,1e-05,230,274,50,2,0.01,504,11
0.524,1e-05,279,325,50,2,0.01,604,11
0.526,1e-05,330,374,50,2,0.01,704,11
0.538,1e-05,382,422,50,2,0.01,804,11
0.528,1e-05,443,461,50,2,0.01,904,11
0.524,1e-05,488,516,50,2,0.01,1004,11
0.516,1e-05,540,564,50,2,0.01,1104,11
0.53,1e-05,598,606,50,2,0.01,1204,11
0.54,1e-05,646,658,50,2,0.01,1304,11
0.54,1e-05,691,713,50,2,0.01,1404,11
0.54,1e-05,740,764,50,2,0.01,1504,11
0.556,1e-05,788,816,50,2,0.01,1604,11
0.574,1e-05,838,866,50,2,0.01,1704,11
0.6,1e-05,893,911,50,2,0.01,1804,11
0.61,1e-05,944,960,50,2,0.01,1904,11
0.654,1e-05,995,1009,50,2,0.01,2004,11
0.516,1e-05,52,52,50,2,0.01,104,12
0.532,1e-05,100,104,50,2,0.01,204,12
0.532,1e-05,159,145,50,2,0.01,304,12
0.544,1e-05,210,194,50,2,0.01,404,12
0.554,1e-05,251,253,50,2,0.01,504,12
0.56,1e-05,302,302,50,2,0.01,604,12
0.574,1e-05,360,344,50,2,0.01,704,12
0.574,1e-05,406,398,50,2,0.01,804,12
0.578,1e-05,459,445,50,2,0.01,904,12
0.582,1e-05,508,496,50,2,0.01,1004,12
0.578,1e-05,557,547,50,2,0.01,1104,12
0.58,1e-05,605,599,50,2,0.01,1204,12
0.576,1e-05,658,646,50,2,0.01,1304,12
0.592,1e-05,711,693,50,2,0.01,1404,12
0.59,1e-05,773,731,50,2,0.01,1504,12
0.6,1e-05,822,782,50,2,0.01,1604,12
0.61,1e-05,877,827,50,2,0.01,1704,12
0.608,1e-05,921,883,50,2,0.01,1804,12
0.604,1e-05,977,927,50,2,0.01,1904,12
0.6,1e-05,1024,980,50,2,0.01,2004,12
0.504,1e-05,61,43,50,2,0.01,104,13
0.508,1e-05,119,85,50,2,0.01,204,13
0.516,1e-05,181,123,50,2,0.01,304,13
0.53,1e-05,235,169,50,2,0.01,404,13
0.534,1e-05,284,220,50,2,0.01,504,13
0.548,1e-05,325,279,50,2,0.01,604,13
0.552,1e-05,373,331,50,2,0.01,704,13
0.558,1e-05,415,389,50,2,0.01,804,13
0.556,1e-05,456,448,50,2,0.01,904,13
0.586,1e-05,508,496,50,2,0.01,1004,13
0.616,1e-05,558,546,50,2,0.01,1104,13
0.67,1e-05,596,608,50,2,0.01,1204,13
0.67,1e-05,650,654,50,2,0.01,1304,13
0.722,1e-05,699,705,50,2,0.01,1404,13
0.758,1e-05,743,761,50,2,0.01,1504,13
0.806,1e-05,800,804,50,2,0.01,1604,13
0.822,1e-05,845,859,50,2,0.01,1704,13
0.86,1e-05,896,908,50,2,0.01,1804,13
0.882,1e-05,942,962,50,2,0.01,1904,13
0.888,1e-05,992,1012,50,2,0.01,2004,13
0.496,1e-05,51,53,50,2,0.01,104,14
0.496,1e-05,98,106,50,2,0.01,204,14
0.496,1e-05,150,154,50,2,0.01,304,14
0.496,1e-05,194,210,50,2,0.01,404,14
0.496,1e-05,246,258,50,2,0.01,504,14
0.496,1e-05,297,307,50,2,0.01,604,14
0.496,1e-05,359,345,50,2,0.01,704,14
0.496,1e-05,417,387,50,2,0.01,804,14
0.496,1e-05,456,448,50,2,0.01,904,14
0.496,1e-05,496,508,50,2,0.01,1004,14
0.496,1e-05,548,556,50,2,0.01,1104,14
0.496,1e-05,604,600,50,2,0.01,1204,14
0.496,1e-05,657,647,50,2,0.01,1304,14
0.496,1e-05,710,694,50,2,0.01,1404,14
0.496,1e-05,755,749,50,2,0.01,1504,14
0.496,1e-05,806,798,50,2,0.01,1604,14
0.496,1e-05,850,854,50,2,0.01,1704,14
0.496,1e-05,902,902,50,2,0.01,1804,14
0.496,1e-05,955,949,50,2,0.01,1904,14
0.496,1e-05,1004,1000,50,2,0.01,2004,14
0.552,1e-05,52,52,50,2,0.01,104,15
0.554,1e-05,105,99,50,2,0.01,204,15
0.54,1e-05,153,151,50,2,0.01,304,15
0.532,1e-05,206,198,50,2,0.01,404,15
0.506,1e-05,252,252,50,2,0.01,504,15
0.512,1e-05,308,296,50,2,0.01,604,15
0.522,1e-05,351,353,50,2,0.01,704,15
0.534,1e-05,401,403,50,2,0.01,804,15
0.56,1e-05,452,452,50,2,0.01,904,15
0.572,1e-05,496,508,50,2,0.01,1004,15
0.558,1e-05,550,554,50,2,0.01,1104,15
0.56,1e-05,604,600,50,2,0.01,1204,15
0.588,1e-05,653,651,50,2,0.01,1304,15
0.604,1e-05,698,706,50,2,0.01,1404,15
0.63,1e-05,753,751,50,2,0.01,1504,15
0.686,1e-05,800,804,50,2,0.01,1604,15
0.692,1e-05,846,858,50,2,0.01,1704,15
0.714,1e-05,893,911,50,2,0.01,1804,15
0.726,1e-05,945,959,50,2,0.01,1904,15
0.734,1e-05,993,1011,50,2,0.01,2004,15
0.526,1e-05,50,54,50,2,0.01,104,16
0.54,1e-05,100,104,50,2,0.01,204,16
0.554,1e-05,150,154,50,2,0.01,304,16
0.564,1e-05,197,207,50,2,0.01,404,16
0.582,1e-05,248,256,50,2,0.01,504,16
0.602,1e-05,292,312,50,2,0.01,604,16
0.616,1e-05,347,357,50,2,0.01,704,16
0.636,1e-05,402,402,50,2,0.01,804,16
0.654,1e-05,456,448,50,2,0.01,904,16
0.68,1e-05,513,491,50,2,0.01,1004,16
0.706,1e-05,552,552,50,2,0.01,1104,16
0.728,1e-05,612,592,50,2,0.01,1204,16
0.766,1e-05,663,641,50,2,0.01,1304,16
0.808,1e-05,713,691,50,2,0.01,1404,16
0.82,1e-05,768,736,50,2,0.01,1504,16
0.824,1e-05,817,787,50,2,0.01,1604,16
0.83,1e-05,852,852,50,2,0.01,1704,16
0.84,1e-05,907,897,50,2,0.01,1804,16
0.848,1e-05,955,949,50,2,0.01,1904,16
0.856,1e-05,1011,993,50,2,0.01,2004,16
0.518,1e-05,45,59,50,2,0.01,104,17
0.514,1e-05,93,111,50,2,0.01,204,17
0.512,1e-05,141,163,50,2,0.01,304,17
0.514,1e-05,195,209,50,2,0.01,404,17
0.512,1e-05,253,251,50,2,0.01,504,17
0.522,1e-05,309,295,50,2,0.01,604,17
0.526,1e-05,364,340,50,2,0.01,704,17
0.568,1e-05,415,389,50,2,0.01,804,17
0.57,1e-05,465,439,50,2,0.01,904,17
0.57,1e-05,516,488,50,2,0.01,1004,17
0.582,1e-05,561,543,50,2,0.01,1104,17
0.584,1e-05,617,587,50,2,0.01,1204,17
0.606,1e-05,670,634,50,2,0.01,1304,17
0.616,1e-05,722,682,50,2,0.01,1404,17
0.622,1e-05,767,737,50,2,0.01,1504,17
0.624,1e-05,811,793,50,2,0.01,1604,17
0.636,1e-05,860,844,50,2,0.01,1704,17
0.656,1e-05,920,884,50,2,0.01,1804,17
0.678,1e-05,974,930,50,2,0.01,1904,17
0.714,1e-05,1025,979,50,2,0.01,2004,17
0.486,1e-05,48,56,50,2,0.01,104,18
0.486,1e-05,94,110,50,2,0.01,204,18
0.486,1e-05,148,156,50,2,0.01,304,18
0.486,1e-05,197,207,50,2,0.01,404,18
0.486,1e-05,244,260,50,2,0.01,504,18
0.486,1e-05,290,314,50,2,0.01,604,18
0.486,1e-05,337,367,50,2,0.01,704,18
0.486,1e-05,399,405,50,2,0.01,804,18
0.486,1e-05,453,451,50,2,0.01,904,18
0.486,1e-05,511,493,50,2,0.01,1004,18
0.486,1e-05,564,540,50,2,0.01,1104,18
0.486,1e-05,624,580,50,2,0.01,1204,18
0.486,1e-05,672,632,50,2,0.01,1304,18
0.486,1e-05,721,683,50,2,0.01,1404,18
0.486,1e-05,766,738,50,2,0.01,1504,18
0.486,1e-05,811,793,50,2,0.01,1604,18
0.486,1e-05,865,839,50,2,0.01,1704,18
0.486,1e-05,917,887,50,2,0.01,1804,18
0.486,1e-05,966,938,50,2,0.01,1904,18
0.486,1e-05,1009,995,50,2,0.01,2004,18
0.488,1e-05,62,42,50,2,0.01,104,19
0.486,1e-05,109,95,50,2,0.01,204,19
0.494,1e-05,158,146,50,2,0.01,304,19
0.508,1e-05,208,196,50,2,0.01,404,19
0.514,1e-05,267,237,50,2,0.01,504,19
0.498,1e-05,324,280,50,2,0.01,604,19
0.504,1e-05,374,330,50,2,0.01,704,19
0.516,1e-05,412,392,50,2,0.01,804,19
0.52,1e-05,464,440,50,2,0.01,904,19
0.536,1e-05,514,490,50,2,0.01,1004,19
0.552,1e-05,556,548,50,2,0.01,1104,19
0.582,1e-05,604,600,50,2,0.01,1204,19
0.592,1e-05,652,652,50,2,0.01,1304,19
0.606,1e-05,698,706,50,2,0.01,1404,19
0.65,1e-05,749,755,50,2,0.01,1504,19
0.68,1e-05,804,800,50,2,0.01,1604,19
0.728,1e-05,857,847,50,2,0.01,1704,19
0.728,1e-05,914,890,50,2,0.01,1804,19
0.718,1e-05,961,943,50,2,0.01,1904,19
0.738,1e-05,1005,999,50,2,0.01,2004,19
0.526,1e-05,54,50,50,2,0.01,104,20
0.526,1e-05,106,98,50,2,0.01,204,20
0.512,1e-05,154,150,50,2,0.01,304,20
0.514,1e-05,210,194,50,2,0.01,404,20
0.532,1e-05,254,250,50,2,0.01,504,20
0.494,1e-05,301,303,50,2,0.01,604,20
0.504,1e-05,349,355,50,2,0.01,704,20
0.504,1e-05,397,407,50,2,0.01,804,20
0.522,1e-05,449,455,50,2,0.01,904,20
0.534,1e-05,494,510,50,2,0.01,1004,20
0.552,1e-05,540,564,50,2,0.01,1104,20
0.566,1e-05,591,613,50,2,0.01,1204,20
0.582,1e-05,641,663,50,2,0.01,1304,20
0.606,1e-05,691,713,50,2,0.01,1404,20
0.618,1e-05,741,763,50,2,0.01,1504,20
0.652,1e-05,793,811,50,2,0.01,1604,20
0.676,1e-05,849,855,50,2,0.01,1704,20
0.718,1e-05,902,902,50,2,0.01,1804,20
0.708,1e-05,957,947,50,2,0.01,1904,20
0.722,1e-05,1010,994,50,2,0.01,2004,20
0.494,0.0001,42,62,50,2,0.0001,104,1
0.494,0.0001,90,114,50,2,0.0001,204,1
0.494,0.0001,145,159,50,2,0.0001,304,1
0.494,0.0001,202,202,50,2,0.0001,404,1
0.494,0.0001,251,253,50,2,0.0001,504,1
0.494,0.0001,300,304,50,2,0.0001,604,1
0.494,0.0001,348,356,50,2,0.0001,704,1
0.494,0.0001,399,405,50,2,0.0001,804,1
0.494,0.0001,448,456,50,2,0.0001,904,1
0.494,0.0001,501,503,50,2,0.0001,1004,1
0.494,0.0001,544,560,50,2,0.0001,1104,1
0.494,0.0001,597,607,50,2,0.0001,1204,1
0.494,0.0001,652,652,50,2,0.0001,1304,1
0.494,0.0001,696,708,50,2,0.0001,1404,1
0.494,0.0001,747,757,50,2,0.0001,1504,1
0.494,0.0001,800,804,50,2,0.0001,1604,1
0.494,0.0001,850,854,50,2,0.0001,1704,1
0.494,0.0001,908,896,50,2,0.0001,1804,1
0.494,0.0001,959,945,50,2,0.0001,1904,1
0.494,0.0001,1005,999,50,2,0.0001,2004,1
0.494,0.0001,52,52,50,2,0.0001,104,2
0.494,0.0001,100,104,50,2,0.0001,204,2
0.494,0.0001,158,146,50,2,0.0001,304,2
0.492,0.0001,211,193,50,2,0.0001,404,2
0.492,0.0001,260,244,50,2,0.0001,504,2
0.492,0.0001,302,302,50,2,0.0001,604,2
0.492,0.0001,354,350,50,2,0.0001,704,2
0.492,0.0001,398,406,50,2,0.0001,804,2
0.492,0.0001,449,455,50,2,0.0001,904,2
0.494,0.0001,498,506,50,2,0.0001,1004,2
0.494,0.0001,550,554,50,2,0.0001,1104,2
0.496,0.0001,599,605,50,2,0.0001,1204,2
0.498,0.0001,650,654,50,2,0.0001,1304,2
0.496,0.0001,695,709,50,2,0.0001,1404,2
0.496,0.0001,747,757,50,2,0.0001,1504,2
0.496,0.0001,790,814,50,2,0.0001,1604,2
0.496,0.0001,846,858,50,2,0.0001,1704,2
0.496,0.0001,897,907,50,2,0.0001,1804,2
0.498,0.0001,947,957,50,2,0.0001,1904,2
0.5,0.0001,1001,1003,50,2,0.0001,2004,2
0.464,0.0001,52,52,50,2,0.0001,104,3
0.464,0.0001,101,103,50,2,0.0001,204,3
0.464,0.0001,157,147,50,2,0.0001,304,3
0.464,0.0001,202,202,50,2,0.0001,404,3
0.464,0.0001,253,251,50,2,0.0001,504,3
0.464,0.0001,292,312,50,2,0.0001,604,3
0.464,0.0001,341,363,50,2,0.0001,704,3
0.464,0.0001,396,408,50,2,0.0001,804,3
0.464,0.0001,444,460,50,2,0.0001,904,3
0.464,0.0001,495,509,50,2,0.0001,1004,3
0.466,0.0001,545,559,50,2,0.0001,1104,3
0.466,0.0001,590,614,50,2,0.0001,1204,3
0.466,0.0001,645,659,50,2,0.0001,1304,3
0.466,0.0001,693,711,50,2,0.0001,1404,3
0.466,0.0001,739,765,50,2,0.0001,1504,3
0.468,0.0001,784,820,50,2,0.0001,1604,3
0.468,0.0001,833,871,50,2,0.0001,1704,3
0.468,0.0001,878,926,50,2,0.0001,1804,3
0.468,0.0001,925,979,50,2,0.0001,1904,3
0.47,0.0001,984,1020,50,2,0.0001,2004,3
0.524,0.0001,49,55,50,2,0.0001,104,4
0.524,0.0001,99,105,50,2,0.0001,204,4
0.524,0.0001,154,150,50,2,0.0001,304,4
0.524,0.0001,211,193,50,2,0.0001,404,4
0.524,0.0001,261,243,50,2,0.0001,504,4
0.524,0.0001,309,295,50,2,0.0001,604,4
0.524,0.0001,362,342,50,2,0.0001,704,4
0.524,0.0001,403,401,50,2,0.0001,804,4
0.524,0.0001,452,452,50,2,0.0001,904,4
0.524,0.0001,506,498,50,2,0.0001,1004,4
0.524,0.0001,561,543,50,2,0.0001,1104,4
0.524,0.0001,609,595,50,2,0.0001,1204,4
0.524,0.0001,655,649,50,2,0.0001,1304,4
0.524,0.0001,706,698,50,2,0.0001,1404,4
0.524,0.0001,746,758,50,2,0.0001,1504,4
0.524,0.0001,803,801,50,2,0.0001,1604,4
0.524,0.0001,854,850,50,2,0.0001,1704,4
0.524,0.0001,909,895,50,2,0.0001,1804,4
0.524,0.0001,956,948,50,2,0.0001,1904,4
0.522,0.0001,1000,1004,50,2,0.0001,2004,4
0.5,0.0001,51,53,50,2,0.0001,104,5
0.5,0.0001,105,99,50,2,0.0001,204,5
0.5,0.0001,155,149,50,2,0.0001,304,5
0.5,0.0001,196,208,50,2,0.0001,404,5
0.5,0.0001,248,256,50,2,0.0001,504,5
0.5,0.0001,297,307,50,2,0.0001,604,5
0.5,0.0001,341,363,50,2,0.0001,704,5
0.5,0.0001,386,418,50,2,0.0001,804,5
0.5,0.0001,433,471,50,2,0.0001,904,5
0.5,0.0001,485,519,50,2,0.0001,1004,5
0.5,0.0001,534,570,50,2,0.0001,1104,5
0.5,0.0001,579,625,50,2,0.0001,1204,5
0.5,0.0001,634,670,50,2,0.0001,1304,5
0.5,0.0001,689,715,50,2,0.0001,1404,5
0.5,0.0001,740,764,50,2,0.0001,1504,5
0.5,0.0001,788,816,50,2,0.0001,1604,5
0.5,0.0001,841,863,50,2,0.0001,1704,5
0.5,0.0001,895,909,50,2,0.0001,1804,5
0.5,0.0001,951,953,50,2,0.0001,1904,5
0.5,0.0001,1002,1002,50,2,0.0001,2004,5
0.52,0.0001,52,52,50,2,0.0001,104,6
0.52,0.0001,107,97,50,2,0.0001,204,6
0.52,0.0001,156,148,50,2,0.0001,304,6
0.52,0.0001,208,196,50,2,0.0001,404,6
0.52,0.0001,257,247,50,2,0.0001,504,6
0.52,0.0001,308,296,50,2,0.0001,604,6
0.522,0.0001,362,342,50,2,0.0001,704,6
0.522,0.0001,408,396,50,2,0.0001,804,6
0.522,0.0001,460,444,50,2,0.0001,904,6
0.522,0.0001,514,490,50,2,0.0001,1004,6
0.522,0.0001,574,530,50,2,0.0001,1104,6
0.522,0.0001,627,577,50,2,0.0001,1204,6
0.522,0.0001,676,628,50,2,0.0001,1304,6
0.522,0.0001,725,679,50,2,0.0001,1404,6
0.522,0.0001,763,741,50,2,0.0001,1504,6
0.52,0.0001,809,795,50,2,0.0001,1604,6
0.52,0.0001,861,843,50,2,0.0001,1704,6
0.518,0.0001,912,892,50,2,0.0001,1804,6
0.52,0.0001,961,943,50,2,0.0001,1904,6
0.522,0.0001,1008,996,50,2,0.0001,2004,6
0.494,0.0001,57,47,50,2,0.0001,104,7
0.494,0.0001,108,96,50,2,0.0001,204,7
0.494,0.0001,162,142,50,2,0.0001,304,7
0.494,0.0001,209,195,50,2,0.0001,404,7
0.494,0.0001,263,241,50,2,0.0001,504,7
0.494,0.0001,313,291,50,2,0.0001,604,7
0.494,0.0001,369,335,50,2,0.0001,704,7
0.494,0.0001,422,382,50,2,0.0001,804,7
0.494,0.0001,468,436,50,2,0.0001,904,7
0.494,0.0001,519,485,50,2,0.0001,1004,7
0.494,0.0001,561,543,50,2,0.0001,1104,7
0.494,0.0001,605,599,50,2,0.0001,1204,7
0.494,0.0001,649,655,50,2,0.0001,1304,7
0.492,0.0001,700,704,50,2,0.0001,1404,7
0.492,0.0001,750,754,50,2,0.0001,1504,7
0.492,0.0001,803,801,50,2,0.0001,1604,7
0.492,0.0001,850,854,50,2,0.0001,1704,7
0.492,0.0001,902,902,50,2,0.0001,1804,7
0.492,0.0001,952,952,50,2,0.0001,1904,7
0.494,0.0001,1006,998,50,2,0.0001,2004,7
0.49,0.0001,50,54,50,2,0.0001,104,8
0.49,0.0001,104,100,50,2,0.0001,204,8
0.488,0.0001,151,153,50,2,0.0001,304,8
0.488,0.0001,202,202,50,2,0.0001,404,8
0.49,0.0001,258,246,50,2,0.0001,504,8
0.49,0.0001,315,289,50,2,0.0001,604,8
0.49,0.0001,365,339,50,2,0.0001,704,8
0.49,0.0001,417,387,50,2,0.0001,804,8
0.49,0.0001,461,443,50,2,0.0001,904,8
0.49,0.0001,517,487,50,2,0.0001,1004,8
0.49,0.0001,565,539,50,2,0.0001,1104,8
0.49,0.0001,614,590,50,2,0.0001,1204,8
0.49,0.0001,657,647,50,2,0.0001,1304,8
0.49,0.0001,705,699,50,2,0.0001,1404,8
0.49,0.0001,751,753,50,2,0.0001,1504,8
0.488,0.0001,803,801,50,2,0.0001,1604,8
0.488,0.0001,856,848,50,2,0.0001,1704,8
0.488,0.0001,912,892,50,2,0.0001,1804,8
0.49,0.0001,963,941,50,2,0.0001,1904,8
0.492,0.0001,1009,995,50,2,0.0001,2004,8
0.494,0.0001,58,46,50,2,0.0001,104,9
0.494,0.0001,103,101,50,2,0.0001,204,9
0.494,0.0001,157,147,50,2,0.0001,304,9
0.494,0.0001,204,200,50,2,0.0001,404,9
0.494,0.0001,252,252,50,2,0.0001,504,9
0.494,0.0001,304,300,50,2,0.0001,604,9
0.494,0.0001,355,349,50,2,0.0001,704,9
0.494,0.0001,407,397,50,2,0.0001,804,9
0.494,0.0001,449,455,50,2,0.0001,904,9
0.494,0.0001,493,511,50,2,0.0001,1004,9
0.494,0.0001,541,563,50,2,0.0001,1104,9
0.494,0.0001,596,608,50,2,0.0001,1204,9
0.494,0.0001,640,664,50,2,0.0001,1304,9
0.494,0.0001,692,712,50,2,0.0001,1404,9
0.494,0.0001,740,764,50,2,0.0001,1504,9
0.494,0.0001,790,814,50,2,0.0001,1604,9
0.494,0.0001,836,868,50,2,0.0001,1704,9
0.494,0.0001,895,909,50,2,0.0001,1804,9
0.494,0.0001,944,960,50,2,0.0001,1904,9
0.494,0.0001,999,1005,50,2,0.0001,2004,9
0.482,0.0001,54,50,50,2,0.0001,104,10
0.482,0.0001,105,99,50,2,0.0001,204,10
0.482,0.0001,153,151,50,2,0.0001,304,10
0.482,0.0001,202,202,50,2,0.0001,404,10
0.482,0.0001,259,245,50,2,0.0001,504,10
0.482,0.0001,308,296,50,2,0.0001,604,10
0.482,0.0001,351,353,50,2,0.0001,704,10
0.482,0.0001,400,404,50,2,0.0001,804,10
0.482,0.0001,452,452,50,2,0.0001,904,10
0.482,0.0001,499,505,50,2,0.0001,1004,10
0.482,0.0001,549,555,50,2,0.0001,1104,10
0.482,0.0001,590,614,50,2,0.0001,1204,10
0.482,0.0001,628,676,50,2,0.0001,1304,10
0.482,0.0001,679,725,50,2,0.0001,1404,10
0.482,0.0001,722,782,50,2,0.0001,1504,10
0.482,0.0001,779,825,50,2,0.0001,1604,10
0.482,0.0001,826,878,50,2,0.0001,1704,10
0.482,0.0001,885,919,50,2,0.0001,1804,10
0.482,0.0001,941,963,50,2,0.0001,1904,10
0.482,0.0001,993,1011,50,2,0.0001,2004,10
0.496,0.0001,58,46,50,2,0.0001,104,11
0.496,0.0001,101,103,50,2,0.0001,204,11
0.496,0.0001,153,151,50,2,0.0001,304,11
0.496,0.0001,202,202,50,2,0.0001,404,11
0.496,0.0001,254,250,50,2,0.0001,504,11
0.496,0.0001,301,303,50,2,0.0001,604,11
0.496,0.0001,352,352,50,2,0.0001,704,11
0.496,0.0001,403,401,50,2,0.0001,804,11
0.496,0.0001,453,451,50,2,0.0001,904,11
0.496,0.0001,503,501,50,2,0.0001,1004,11
0.496,0.0001,562,542,50,2,0.0001,1104,11
0.496,0.0001,616,588,50,2,0.0001,1204,11
0.496,0.0001,670,634,50,2,0.0001,1304,11
0.496,0.0001,721,683,50,2,0.0001,1404,11
0.496,0.0001,769,735,50,2,0.0001,1504,11
0.496,0.0001,818,786,50,2,0.0001,1604,11
0.496,0.0001,865,839,50,2,0.0001,1704,11
0.496,0.0001,916,888,50,2,0.0001,1804,11
0.496,0.0001,961,943,50,2,0.0001,1904,11
0.496,0.0001,1004,1000,50,2,0.0001,2004,11
0.552,0.0001,44,60,50,2,0.0001,104,12
0.552,0.0001,89,115,50,2,0.0001,204,12
0.552,0.0001,135,169,50,2,0.0001,304,12
0.552,0.0001,185,219,50,2,0.0001,404,12
0.552,0.0001,234,270,50,2,0.0001,504,12
0.552,0.0001,288,316,50,2,0.0001,604,12
0.552,0.0001,339,365,50,2,0.0001,704,12
0.552,0.0001,391,413,50,2,0.0001,804,12
0.552,0.0001,443,461,50,2,0.0001,904,12
0.552,0.0001,490,514,50,2,0.0001,1004,12
0.552,0.0001,542,562,50,2,0.0001,1104,12
0.552,0.0001,592,612,50,2,0.0001,1204,12
0.552,0.0001,641,663,50,2,0.0001,1304,12
0.552,0.0001,692,712,50,2,0.0001,1404,12
0.552,0.0001,734,770,50,2,0.0001,1504,12
0.552,0.0001,784,820,50,2,0.0001,1604,12
0.552,0.0001,839,865,50,2,0.0001,1704,12
0.552,0.0001,885,919,50,2,0.0001,1804,12
0.552,0.0001,928,976,50,2,0.0001,1904,12
0.552,0.0001,976,1028,50,2,0.0001,2004,12
0.564,0.0001,45,59,50,2,0.0001,104,13
0.564,0.0001,96,108,50,2,0.0001,204,13
0.564,0.0001,150,154,50,2,0.0001,304,13
0.564,0.0001,194,210,50,2,0.0001,404,13
0.564,0.0001,243,261,50,2,0.0001,504,13
0.562,0.0001,297,307,50,2,0.0001,604,13
0.562,0.0001,345,359,50,2,0.0001,704,13
0.562,0.0001,393,411,50,2,0.0001,804,13
0.564,0.0001,442,462,50,2,0.0001,904,13
0.566,0.0001,492,512,50,2,0.0001,1004,13
0.566,0.0001,537,567,50,2,0.0001,1104,13
0.566,0.0001,602,602,50,2,0.0001,1204,13
0.568,0.0001,659,645,50,2,0.0001,1304,13
0.568,0.0001,708,696,50,2,0.0001,1404,13
0.568,0.0001,762,742,50,2,0.0001,1504,13
0.566,0.0001,814,790,50,2,0.0001,1604,13
0.566,0.0001,866,838,50,2,0.0001,1704,13
0.568,0.0001,922,882,50,2,0.0001,1804,13
0.568,0.0001,978,926,50,2,0.0001,1904,13
0.568,0.0001,1023,981,50,2,0.0001,2004,13
0.516,0.0001,53,51,50,2,0.0001,104,14
0.516,0.0001,98,106,50,2,0.0001,204,14
0.516,0.0001,145,159,50,2,0.0001,304,14
0.518,0.0001,201,203,50,2,0.0001,404,14
0.516,0.0001,256,248,50,2,0.0001,504,14
0.516,0.0001,301,303,50,2,0.0001,604,14
0.516,0.0001,354,350,50,2,0.0001,704,14
0.516,0.0001,406,398,50,2,0.0001,804,14
0.516,0.0001,462,442,50,2,0.0001,904,14
0.516,0.0001,511,493,50,2,0.0001,1004,14
0.516,0.0001,568,536,50,2,0.0001,1104,14
0.516,0.0001,609,595,50,2,0.0001,1204,14
0.516,0.0001,655,649,50,2,0.0001,1304,14
0.516,0.0001,709,695,50,2,0.0001,1404,14
0.516,0.0001,755,749,50,2,0.0001,1504,14
0.516,0.0001,802,802,50,2,0.0001,1604,14
0.518,0.0001,848,856,50,2,0.0001,1704,14
0.518,0.0001,899,905,50,2,0.0001,1804,14
0.514,0.0001,949,955,50,2,0.0001,1904,14
0.514,0.0001,1002,1002,50,2,0.0001,2004,14
0.524,0.0001,45,59,50,2,0.0001,104,15
0.524,0.0001,99,105,50,2,0.0001,204,15
0.524,0.0001,138,166,50,2,0.0001,304,15
0.524,0.0001,195,209,50,2,0.0001,404,15
0.524,0.0001,250,254,50,2,0.0001,504,15
0.524,0.0001,307,297,50,2,0.0001,604,15
0.524,0.0001,355,349,50,2,0.0001,704,15
0.524,0.0001,406,398,50,2,0.0001,804,15
0.524,0.0001,459,445,50,2,0.0001,904,15
0.524,0.0001,500,504,50,2,0.0001,1004,15
0.524,0.0001,544,560,50,2,0.0001,1104,15
0.524,0.0001,590,614,50,2,0.0001,1204,15
0.524,0.0001,638,666,50,2,0.0001,1304,15
0.524,0.0001,690,714,50,2,0.0001,1404,15
0.524,0.0001,734,770,50,2,0.0001,1504,15
0.524,0.0001,782,822,50,2,0.0001,1604,15
0.524,0.0001,833,871,50,2,0.0001,1704,15
0.524,0.0001,892,912,50,2,0.0001,1804,15
0.524,0.0001,941,963,50,2,0.0001,1904,15
0.524,0.0001,990,1014,50,2,0.0001,2004,15
0.496,0.0001,56,48,50,2,0.0001,104,16
0.496,0.0001,118,86,50,2,0.0001,204,16
0.496,0.0001,166,138,50,2,0.0001,304,16
0.496,0.0001,215,189,50,2,0.0001,404,16
0.496,0.0001,266,238,50,2,0.0001,504,16
0.496,0.0001,310,294,50,2,0.0001,604,16
0.496,0.0001,358,346,50,2,0.0001,704,16
0.496,0.0001,410,394,50,2,0.0001,804,16
0.496,0.0001,461,443,50,2,0.0001,904,16
0.496,0.0001,499,505,50,2,0.0001,1004,16
0.496,0.0001,543,561,50,2,0.0001,1104,16
0.496,0.0001,593,611,50,2,0.0001,1204,16
0.496,0.0001,641,663,50,2,0.0001,1304,16
0.496,0.0001,690,714,50,2,0.0001,1404,16
0.496,0.0001,738,766,50,2,0.0001,1504,16
0.496,0.0001,786,818,50,2,0.0001,1604,16
0.496,0.0001,838,866,50,2,0.0001,1704,16
0.496,0.0001,883,921,50,2,0.0001,1804,16
0.496,0.0001,937,967,50,2,0.0001,1904,16
0.496,0.0001,1000,1004,50,2,0.0001,2004,16
0.5,0.0001,60,44,50,2,0.0001,104,17
0.5,0.0001,109,95,50,2,0.0001,204,17
0.5,0.0001,156,148,50,2,0.0001,304,17
0.5,0.0001,201,203,50,2,0.0001,404,17
0.5,0.0001,244,260,50,2,0.0001,504,17
0.5,0.0001,290,314,50,2,0.0001,604,17
0.5,0.0001,337,367,50,2,0.0001,704,17
0.5,0.0001,387,417,50,2,0.0001,804,17
0.5,0.0001,445,459,50,2,0.0001,904,17
0.5,0.0001,492,512,50,2,0.0001,1004,17
0.5,0.0001,542,562,50,2,0.0001,1104,17
0.5,0.0001,584,620,50,2,0.0001,1204,17
0.5,0.0001,639,665,50,2,0.0001,1304,17
0.5,0.0001,696,708,50,2,0.0001,1404,17
0.5,0.0001,745,759,50,2,0.0001,1504,17
0.5,0.0001,789,815,50,2,0.0001,1604,17
0.5,0.0001,833,871,50,2,0.0001,1704,17
0.5,0.0001,882,922,50,2,0.0001,1804,17
0.5,0.0001,943,961,50,2,0.0001,1904,17
0.5,0.0001,999,1005,50,2,0.0001,2004,17
0.502,0.0001,60,44,50,2,0.0001,104,18
0.502,0.0001,116,88,50,2,0.0001,204,18
0.502,0.0001,170,134,50,2,0.0001,304,18
0.502,0.0001,222,182,50,2,0.0001,404,18
0.502,0.0001,267,237,50,2,0.0001,504,18
0.502,0.0001,319,285,50,2,0.0001,604,18
0.502,0.0001,364,340,50,2,0.0001,704,18
0.502,0.0001,419,385,50,2,0.0001,804,18
0.502,0.0001,462,442,50,2,0.0001,904,18
0.502,0.0001,508,496,50,2,0.0001,1004,18
0.502,0.0001,562,542,50,2,0.0001,1104,18
0.502,0.0001,604,600,50,2,0.0001,1204,18
0.502,0.0001,656,648,50,2,0.0001,1304,18
0.502,0.0001,712,692,50,2,0.0001,1404,18
0.502,0.0001,751,753,50,2,0.0001,1504,18
0.5,0.0001,810,794,50,2,0.0001,1604,18
0.5,0.0001,852,852,50,2,0.0001,1704,18
0.5,0.0001,904,900,50,2,0.0001,1804,18
0.5,0.0001,950,954,50,2,0.0001,1904,18
0.5,0.0001,1002,1002,50,2,0.0001,2004,18
0.506,0.0001,49,55,50,2,0.0001,104,19
0.506,0.0001,100,104,50,2,0.0001,204,19
0.506,0.0001,156,148,50,2,0.0001,304,19
0.506,0.0001,209,195,50,2,0.0001,404,19
0.506,0.0001,263,241,50,2,0.0001,504,19
0.506,0.0001,315,289,50,2,0.0001,604,19
0.506,0.0001,364,340,50,2,0.0001,704,19
0.506,0.0001,413,391,50,2,0.0001,804,19
0.506,0.0001,475,429,50,2,0.0001,904,19
0.506,0.0001,525,479,50,2,0.0001,1004,19
0.506,0.0001,567,537,50,2,0.0001,1104,19
0.506,0.0001,619,585,50,2,0.0001,1204,19
0.506,0.0001,667,637,50,2,0.0001,1304,19
0.506,0.0001,714,690,50,2,0.0001,1404,19
0.506,0.0001,764,740,50,2,0.0001,1504,19
0.508,0.0001,818,786,50,2,0.0001,1604,19
0.508,0.0001,868,836,50,2,0.0001,1704,19
0.508,0.0001,919,885,50,2,0.0001,1804,19
0.508,0.0001,964,940,50,2,0.0001,1904,19
0.508,0.0001,1005,999,50,2,0.0001,2004,19
0.548,0.0001,54,50,50,2,0.0001,104,20
0.55,0.0001,110,94,50,2,0.0001,204,20
0.55,0.0001,159,145,50,2,0.0001,304,20
0.55,0.0001,203,201,50,2,0.0001,404,20
0.55,0.0001,258,246,50,2,0.0001,504,20
0.55,0.0001,300,304,50,2,0.0001,604,20
0.55,0.0001,366,338,50,2,0.0001,704,20
0.552,0.0001,416,388,50,2,0.0001,804,20
0.552,0.0001,472,432,50,2,0.0001,904,20
0.552,0.0001,522,482,50,2,0.0001,1004,20
0.552,0.0001,570,534,50,2,0.0001,1104,20
0.552,0.0001,617,587,50,2,0.0001,1204,20
0.552,0.0001,665,639,50,2,0.0001,1304,20
0.552,0.0001,719,685,50,2,0.0001,1404,20
0.552,0.0001,769,735,50,2,0.0001,1504,20
0.552,0.0001,823,781,50,2,0.0001,1604,20
0.552,0.0001,873,831,50,2,0.0001,1704,20
0.552,0.0001,923,881,50,2,0.0001,1804,20
0.552,0.0001,971,933,50,2,0.0001,1904,20
0.554,0.0001,1013,991,50,2,0.0001,2004,20
0.472,0.0001,57,47,50,2,0.001,104,1
0.472,0.0001,116,88,50,2,0.001,204,1
0.472,0.0001,168,136,50,2,0.001,304,1
0.472,0.0001,214,190,50,2,0.001,404,1
0.472,0.0001,264,240,50,2,0.001,504,1
0.472,0.0001,312,292,50,2,0.001,604,1
0.472,0.0001,351,353,50,2,0.001,704,1
0.472,0.0001,400,404,50,2,0.001,804,1
0.472,0.0001,443,461,50,2,0.001,904,1
0.472,0.0001,490,514,50,2,0.001,1004,1
0.472,0.0001,537,567,50,2,0.001,1104,1
0.472,0.0001,583,621,50,2,0.001,1204,1
0.472,0.0001,634,670,50,2,0.001,1304,1
0.472,0.0001,683,721,50,2,0.001,1404,1
0.472,0.0001,739,765,50,2,0.001,1504,1
0.472,0.0001,783,821,50,2,0.001,1604,1
0.472,0.0001,839,865,50,2,0.001,1704,1
0.472,0.0001,892,912,50,2,0.001,1804,1
0.472,0.0001,935,969,50,2,0.001,1904,1
0.472,0.0001,988,1016,50,2,0.001,2004,1
0.498,0.0001,54,50,50,2,0.001,104,2
0.498,0.0001,100,104,50,2,0.001,204,2
0.498,0.0001,150,154,50,2,0.001,304,2
0.498,0.0001,200,204,50,2,0.001,404,2
0.498,0.0001,245,259,50,2,0.001,504,2
0.498,0.0001,292,312,50,2,0.001,604,2
0.498,0.0001,344,360,50,2,0.001,704,2
0.498,0.0001,401,403,50,2,0.001,804,2
0.498,0.0001,452,452,50,2,0.001,904,2
0.498,0.0001,508,496,50,2,0.001,1004,2
0.498,0.0001,563,541,50,2,0.001,1104,2
0.498,0.0001,618,586,50,2,0.001,1204,2
0.498,0.0001,665,639,50,2,0.001,1304,2
0.498,0.0001,716,688,50,2,0.001,1404,2
0.504,0.0001,758,746,50,2,0.001,1504,2
0.502,0.0001,804,800,50,2,0.001,1604,2
0.506,0.0001,854,850,50,2,0.001,1704,2
0.494,0.0001,907,897,50,2,0.001,1804,2
0.496,0.0001,954,950,50,2,0.001,1904,2
0.506,0.0001,1003,1001,50,2,0.001,2004,2
0.544,0.0001,52,52,50,2,0.001,104,3
0.546,0.0001,108,96,50,2,0.001,204,3
0.548,0.0001,162,142,50,2,0.001,304,3
0.548,0.0001,213,191,50,2,0.001,404,3
0.546,0.0001,264,240,50,2,0.001,504,3
0.54,0.0001,315,289,50,2,0.001,604,3
0.544,0.0001,365,339,50,2,0.001,704,3
0.544,0.0001,414,390,50,2,0.001,804,3
0.542,0.0001,468,436,50,2,0.001,904,3
0.544,0.0001,513,491,50,2,0.001,1004,3
0.548,0.0001,556,548,50,2,0.001,1104,3
0.548,0.0001,610,594,50,2,0.001,1204,3
0.548,0.0001,658,646,50,2,0.001,1304,3
0.548,0.0001,703,701,50,2,0.001,1404,3
0.544,0.0001,743,761,50,2,0.001,1504,3
0.542,0.0001,793,811,50,2,0.001,1604,3
0.542,0.0001,844,860,50,2,0.001,1704,3
0.542,0.0001,896,908,50,2,0.001,1804,3
0.55,0.0001,951,953,50,2,0.001,1904,3
0.556,0.0001,1005,999,50,2,0.001,2004,3
0.514,0.0001,53,51,50,2,0.001,104,4
0.514,0.0001,107,97,50,2,0.001,204,4
0.514,0.0001,165,139,50,2,0.001,304,4
0.514,0.0001,203,201,50,2,0.001,404,4
0.514,0.0001,258,246,50,2,0.001,504,4
0.514,0.0001,301,303,50,2,0.001,604,4
0.514,0.0001,347,357,50,2,0.001,704,4
0.514,0.0001,399,405,50,2,0.001,804,4
0.514,0.0001,448,456,50,2,0.001,904,4
0.514,0.0001,494,510,50,2,0.001,1004,4
0.514,0.0001,549,555,50,2,0.001,1104,4
0.514,0.0001,594,610,50,2,0.001,1204,4
0.514,0.0001,649,655,50,2,0.001,1304,4
0.514,0.0001,694,710,50,2,0.001,1404,4
0.514,0.0001,739,765,50,2,0.001,1504,4
0.514,0.0001,783,821,50,2,0.001,1604,4
0.514,0.0001,837,867,50,2,0.001,1704,4
0.514,0.0001,885,919,50,2,0.001,1804,4
0.514,0.0001,938,966,50,2,0.001,1904,4
0.514,0.0001,995,1009,50,2,0.001,2004,4
0.49,0.0001,55,49,50,2,0.001,104,5
0.49,0.0001,99,105,50,2,0.001,204,5
0.49,0.0001,148,156,50,2,0.001,304,5
0.49,0.0001,207,197,50,2,0.001,404,5
0.49,0.0001,251,253,50,2,0.001,504,5
0.49,0.0001,300,304,50,2,0.001,604,5
0.49,0.0001,344,360,50,2,0.001,704,5
0.49,0.0001,383,421,50,2,0.001,804,5
0.49,0.0001,447,457,50,2,0.001,904,5
0.494,0.0001,489,515,50,2,0.001,1004,5
0.494,0.0001,537,567,50,2,0.001,1104,5
0.498,0.0001,586,618,50,2,0.001,1204,5
0.498,0.0001,635,669,50,2,0.001,1304,5
0.498,0.0001,689,715,50,2,0.001,1404,5
0.498,0.0001,739,765,50,2,0.001,1504,5
0.496,0.0001,788,816,50,2,0.001,1604,5
0.496,0.0001,844,860,50,2,0.001,1704,5
0.506,0.0001,897,907,50,2,0.001,1804,5
0.506,0.0001,957,947,50,2,0.001,1904,5
0.514,0.0001,999,1005,50,2,0.001,2004,5
0.502,0.0001,53,51,50,2,0.001,104,6
0.504,0.0001,110,94,50,2,0.001,204,6
0.506,0.0001,156,148,50,2,0.001,304,6
0.506,0.0001,208,196,50,2,0.001,404,6
0.506,0.0001,249,255,50,2,0.001,504,6
0.508,0.0001,304,300,50,2,0.001,604,6
0.508,0.0001,351,353,50,2,0.001,704,6
0.508,0.0001,398,406,50,2,0.001,804,6
0.508,0.0001,441,463,50,2,0.001,904,6
0.504,0.0001,487,517,50,2,0.001,1004,6
0.504,0.0001,533,571,50,2,0.001,1104,6
0.502,0.0001,591,613,50,2,0.001,1204,6
0.514,0.0001,644,660,50,2,0.001,1304,6
0.51,0.0001,700,704,50,2,0.001,1404,6
0.514,0.0001,752,752,50,2,0.001,1504,6
0.514,0.0001,800,804,50,2,0.001,1604,6
0.506,0.0001,836,868,50,2,0.001,1704,6
0.52,0.0001,890,914,50,2,0.001,1804,6
0.53,0.0001,950,954,50,2,0.001,1904,6
0.536,0.0001,997,1007,50,2,0.001,2004,6
0.528,0.0001,48,56,50,2,0.001,104,7
0.526,0.0001,95,109,50,2,0.001,204,7
0.528,0.0001,153,151,50,2,0.001,304,7
0.526,0.0001,217,187,50,2,0.001,404,7
0.526,0.0001,264,240,50,2,0.001,504,7
0.524,0.0001,310,294,50,2,0.001,604,7
0.526,0.0001,356,348,50,2,0.001,704,7
0.53,0.0001,406,398,50,2,0.001,804,7
0.532,0.0001,454,450,50,2,0.001,904,7
0.534,0.0001,505,499,50,2,0.001,1004,7
0.536,0.0001,552,552,50,2,0.001,1104,7
0.538,0.0001,593,611,50,2,0.001,1204,7
0.538,0.0001,653,651,50,2,0.001,1304,7
0.534,0.0001,700,704,50,2,0.001,1404,7
0.54,0.0001,756,748,50,2,0.001,1504,7
0.544,0.0001,802,802,50,2,0.001,1604,7
0.542,0.0001,847,857,50,2,0.001,1704,7
0.536,0.0001,897,907,50,2,0.001,1804,7
0.528,0.0001,947,957,50,2,0.001,1904,7
0.528,0.0001,989,1015,50,2,0.001,2004,7
0.486,0.0001,50,54,50,2,0.001,104,8
0.486,0.0001,100,104,50,2,0.001,204,8
0.486,0.0001,144,160,50,2,0.001,304,8
0.486,0.0001,197,207,50,2,0.001,404,8
0.486,0.0001,257,247,50,2,0.001,504,8
0.486,0.0001,304,300,50,2,0.001,604,8
0.486,0.0001,360,344,50,2,0.001,704,8
0.486,0.0001,411,393,50,2,0.001,804,8
0.486,0.0001,460,444,50,2,0.001,904,8
0.486,0.0001,507,497,50,2,0.001,1004,8
0.486,0.0001,560,544,50,2,0.001,1104,8
0.486,0.0001,614,590,50,2,0.001,1204,8
0.486,0.0001,662,642,50,2,0.001,1304,8
0.486,0.0001,708,696,50,2,0.001,1404,8
0.486,0.0001,759,745,50,2,0.001,1504,8
0.486,0.0001,812,792,50,2,0.001,1604,8
0.486,0.0001,866,838,50,2,0.001,1704,8
0.486,0.0001,915,889,50,2,0.001,1804,8
0.486,0.0001,963,941,50,2,0.001,1904,8
0.486,0.0001,1009,995,50,2,0.001,2004,8
0.558,0.0001,53,51,50,2,0.001,104,9
0.56,0.0001,103,101,50,2,0.001,204,9
0.566,0.0001,157,147,50,2,0.001,304,9
0.566,0.0001,207,197,50,2,0.001,404,9
0.562,0.0001,251,253,50,2,0.001,504,9
0.566,0.0001,303,301,50,2,0.001,604,9
0.574,0.0001,344,360,50,2,0.001,704,9
0.576,0.0001,402,402,50,2,0.001,804,9
0.574,0.0001,455,449,50,2,0.001,904,9
0.574,0.0001,506,498,50,2,0.001,1004,9
0.572,0.0001,560,544,50,2,0.001,1104,9
0.572,0.0001,610,594,50,2,0.001,1204,9
0.576,0.0001,657,647,50,2,0.001,1304,9
0.578,0.0001,705,699,50,2,0.001,1404,9
0.582,0.0001,756,748,50,2,0.001,1504,9
0.584,0.0001,802,802,50,2,0.001,1604,9
0.584,0.0001,858,846,50,2,0.001,1704,9
0.588,0.0001,909,895,50,2,0.001,1804,9
0.592,0.0001,963,941,50,2,0.001,1904,9
0.602,0.0001,1005,999,50,2,0.001,2004,9
0.532,0.0001,51,53,50,2,0.001,104,10
0.532,0.0001,101,103,50,2,0.001,204,10
0.532,0.0001,152,152,50,2,0.001,304,10
0.532,0.0001,200,204,50,2,0.001,404,10
0.532,0.0001,249,255,50,2,0.001,504,10
0.532,0.0001,292,312,50,2,0.001,604,10
0.532,0.0001,344,360,50,2,0.001,704,10
0.532,0.0001,395,409,50,2,0.001,804,10
0.532,0.0001,442,462,50,2,0.001,904,10
0.532,0.0001,493,511,50,2,0.001,1004,10
0.532,0.0001,553,551,50,2,0.001,1104,10
0.532,0.0001,604,600,50,2,0.001,1204,10
0.532,0.0001,652,652,50,2,0.001,1304,10
0.532,0.0001,707,697,50,2,0.001,1404,10
0.532,0.0001,756,748,50,2,0.001,1504,10
0.534,0.0001,795,809,50,2,0.001,1604,10
0.536,0.0001,842,862,50,2,0.001,1704,10
0.542,0.0001,888,916,50,2,0.001,1804,10
0.544,0.0001,939,965,50,2,0.001,1904,10
0.552,0.0001,986,1018,50,2,0.001,2004,10
0.542,0.0001,49,55,50,2,0.001,104,11
0.542,0.0001,106,98,50,2,0.001,204,11
0.542,0.0001,156,148,50,2,0.001,304,11
0.544,0.0001,210,194,50,2,0.001,404,11
0.542,0.0001,254,250,50,2,0.001,504,11
0.542,0.0001,301,303,50,2,0.001,604,11
0.544,0.0001,347,357,50,2,0.001,704,11
0.54,0.0001,395,409,50,2,0.001,804,11
0.55,0.0001,451,453,50,2,0.001,904,11
0.554,0.0001,493,511,50,2,0.001,1004,11
0.56,0.0001,554,550,50,2,0.001,1104,11
0.558,0.0001,606,598,50,2,0.001,1204,11
0.56,0.0001,650,654,50,2,0.001,1304,11
0.564,0.0001,710,694,50,2,0.001,1404,11
0.56,0.0001,764,740,50,2,0.001,1504,11
0.56,0.0001,807,797,50,2,0.001,1604,11
0.556,0.0001,855,849,50,2,0.001,1704,11
0.56,0.0001,893,911,50,2,0.001,1804,11
0.562,0.0001,939,965,50,2,0.001,1904,11
0.558,0.0001,990,1014,50,2,0.001,2004,11
0.5,0.0001,52,52,50,2,0.001,104,12
0.5,0.0001,100,104,50,2,0.001,204,12
0.5,0.0001,150,154,50,2,0.001,304,12
0.5,0.0001,202,202,50,2,0.001,404,12
0.5,0.0001,244,260,50,2,0.001,504,12
0.5,0.0001,291,313,50,2,0.001,604,12
0.5,0.0001,339,365,50,2,0.001,704,12
0.5,0.0001,392,412,50,2,0.001,804,12
0.5,0.0001,453,451,50,2,0.001,904,12
0.5,0.0001,498,506,50,2,0.001,1004,12
0.5,0.0001,556,548,50,2,0.001,1104,12
0.5,0.0001,608,596,50,2,0.001,1204,12
0.5,0.0001,660,644,50,2,0.001,1304,12
0.5,0.0001,704,700,50,2,0.001,1404,12
0.5,0.0001,753,751,50,2,0.001,1504,12
0.5,0.0001,808,796,50,2,0.001,1604,12
0.5,0.0001,861,843,50,2,0.001,1704,12
0.5,0.0001,916,888,50,2,0.001,1804,12
0.5,0.0001,965,939,50,2,0.001,1904,12
0.5,0.0001,1002,1002,50,2,0.001,2004,12
0.53,0.0001,55,49,50,2,0.001,104,13
0.53,0.0001,107,97,50,2,0.001,204,13
0.53,0.0001,152,152,50,2,0.001,304,13
0.53,0.0001,202,202,50,2,0.001,404,13
0.53,0.0001,248,256,50,2,0.001,504,13
0.53,0.0001,291,313,50,2,0.001,604,13
0.53,0.0001,337,367,50,2,0.001,704,13
0.53,0.0001,391,413,50,2,0.001,804,13
0.53,0.0001,436,468,50,2,0.001,904,13
0.53,0.0001,492,512,50,2,0.001,1004,13
0.53,0.0001,541,563,50,2,0.001,1104,13
0.53,0.0001,591,613,50,2,0.001,1204,13
0.53,0.0001,635,669,50,2,0.001,1304,13
0.53,0.0001,684,720,50,2,0.001,1404,13
0.502,0.0001,736,768,50,2,0.001,1504,13
0.498,0.0001,786,818,50,2,0.001,1604,13
0.486,0.0001,843,861,50,2,0.001,1704,13
0.492,0.0001,887,917,50,2,0.001,1804,13
0.492,0.0001,940,964,50,2,0.001,1904,13
0.494,0.0001,987,1017,50,2,0.001,2004,13
0.506,0.0001,56,48,50,2,0.001,104,14
0.508,0.0001,104,100,50,2,0.001,204,14
0.506,0.0001,164,140,50,2,0.001,304,14
0.504,0.0001,214,190,50,2,0.001,404,14
0.5,0.0001,260,244,50,2,0.001,504,14
0.506,0.0001,304,300,50,2,0.001,604,14
0.508,0.0001,355,349,50,2,0.001,704,14
0.506,0.0001,408,396,50,2,0.001,804,14
0.504,0.0001,461,443,50,2,0.001,904,14
0.508,0.0001,515,489,50,2,0.001,1004,14
0.506,0.0001,562,542,50,2,0.001,1104,14
0.512,0.0001,605,599,50,2,0.001,1204,14
0.51,0.0001,666,638,50,2,0.001,1304,14
0.512,0.0001,720,684,50,2,0.001,1404,14
0.52,0.0001,775,729,50,2,0.001,1504,14
0.524,0.0001,821,783,50,2,0.001,1604,14
0.522,0.0001,861,843,50,2,0.001,1704,14
0.52,0.0001,907,897,50,2,0.001,1804,14
0.522,0.0001,955,949,50,2,0.001,1904,14
0.526,0.0001,1006,998,50,2,0.001,2004,14
0.492,0.0001,53,51,50,2,0.001,104,15
0.492,0.0001,112,92,50,2,0.001,204,15
0.494,0.0001,172,132,50,2,0.001,304,15
0.5,0.0001,226,178,50,2,0.001,404,15
0.5,0.0001,275,229,50,2,0.001,504,15
0.5,0.0001,323,281,50,2,0.001,604,15
0.5,0.0001,367,337,50,2,0.001,704,15
0.504,0.0001,424,380,50,2,0.001,804,15
0.502,0.0001,474,430,50,2,0.001,904,15
0.5,0.0001,528,476,50,2,0.001,1004,15
0.51,0.0001,571,533,50,2,0.001,1104,15
0.52,0.0001,617,587,50,2,0.001,1204,15
0.514,0.0001,674,630,50,2,0.001,1304,15
0.516,0.0001,729,675,50,2,0.001,1404,15
0.52,0.0001,776,728,50,2,0.001,1504,15
0.528,0.0001,826,778,50,2,0.001,1604,15
0.526,0.0001,884,820,50,2,0.001,1704,15
0.526,0.0001,929,875,50,2,0.001,1804,15
0.524,0.0001,968,936,50,2,0.001,1904,15
0.522,0.0001,1012,992,50,2,0.001,2004,15
0.484,0.0001,48,56,50,2,0.001,104,16
0.484,0.0001,103,101,50,2,0.001,204,16
0.484,0.0001,148,156,50,2,0.001,304,16
0.482,0.0001,198,206,50,2,0.001,404,16
0.482,0.0001,248,256,50,2,0.001,504,16
0.482,0.0001,298,306,50,2,0.001,604,16
0.484,0.0001,346,358,50,2,0.001,704,16
0.484,0.0001,402,402,50,2,0.001,804,16
0.484,0.0001,450,454,50,2,0.001,904,16
0.488,0.0001,500,504,50,2,0.001,1004,16
0.488,0.0001,548,556,50,2,0.001,1104,16
0.486,0.0001,599,605,50,2,0.001,1204,16
0.494,0.0001,643,661,50,2,0.001,1304,16
0.5,0.0001,699,705,50,2,0.001,1404,16
0.5,0.0001,745,759,50,2,0.001,1504,16
0.504,0.0001,788,816,50,2,0.001,1604,16
0.508,0.0001,843,861,50,2,0.001,1704,16
0.51,0.0001,904,900,50,2,0.001,1804,16
0.516,0.0001,959,945,50,2,0.001,1904,16
0.522,0.0001,1004,1000,50,2,0.001,2004,16
0.486,0.0001,50,54,50,2,0.001,104,17
0.486,0.0001,106,98,50,2,0.001,204,17
0.484,0.0001,151,153,50,2,0.001,304,17
0.484,0.0001,202,202,50,2,0.001,404,17
0.484,0.0001,255,249,50,2,0.001,504,17
0.484,0.0001,312,292,50,2,0.001,604,17
0.484,0.0001,359,345,50,2,0.001,704,17
0.484,0.0001,414,390,50,2,0.001,804,17
0.486,0.0001,468,436,50,2,0.001,904,17
0.486,0.0001,520,484,50,2,0.001,1004,17
0.486,0.0001,566,538,50,2,0.001,1104,17
0.488,0.0001,619,585,50,2,0.001,1204,17
0.49,0.0001,670,634,50,2,0.001,1304,17
0.49,0.0001,724,680,50,2,0.001,1404,17
0.494,0.0001,781,723,50,2,0.001,1504,17
0.496,0.0001,819,785,50,2,0.001,1604,17
0.498,0.0001,869,835,50,2,0.001,1704,17
0.498,0.0001,913,891,50,2,0.001,1804,17
0.51,0.0001,952,952,50,2,0.001,1904,17
0.52,0.0001,996,1008,50,2,0.001,2004,17
0.526,0.0001,54,50,50,2,0.001,104,18
0.526,0.0001,112,92,50,2,0.001,204,18
0.526,0.0001,161,143,50,2,0.001,304,18
0.528,0.0001,211,193,50,2,0.001,404,18
0.528,0.0001,269,235,50,2,0.001,504,18
0.532,0.0001,325,279,50,2,0.001,604,18
0.532,0.0001,371,333,50,2,0.001,704,18
0.532,0.0001,423,381,50,2,0.001,804,18
0.532,0.0001,467,437,50,2,0.001,904,18
0.532,0.0001,519,485,50,2,0.001,1004,18
0.53,0.0001,570,534,50,2,0.001,1104,18
0.528,0.0001,616,588,50,2,0.001,1204,18
0.528,0.0001,668,636,50,2,0.001,1304,18
0.524,0.0001,719,685,50,2,0.001,1404,18
0.526,0.0001,773,731,50,2,0.001,1504,18
0.526,0.0001,825,779,50,2,0.001,1604,18
0.524,0.0001,878,826,50,2,0.001,1704,18
0.524,0.0001,936,868,50,2,0.001,1804,18
0.528,0.0001,984,920,50,2,0.001,1904,18
0.526,0.0001,1019,985,50,2,0.001,2004,18
0.506,0.0001,56,48,50,2,0.001,104,19
0.508,0.0001,104,100,50,2,0.001,204,19
0.508,0.0001,154,150,50,2,0.001,304,19
0.508,0.0001,206,198,50,2,0.001,404,19
0.508,0.0001,259,245,50,2,0.001,504,19
0.508,0.0001,313,291,50,2,0.001,604,19
0.506,0.0001,364,340,50,2,0.001,704,19
0.506,0.0001,419,385,50,2,0.001,804,19
0.508,0.0001,467,437,50,2,0.001,904,19
0.506,0.0001,509,495,50,2,0.001,1004,19
0.508,0.0001,564,540,50,2,0.001,1104,19
0.512,0.0001,611,593,50,2,0.001,1204,19
0.512,0.0001,658,646,50,2,0.001,1304,19
0.516,0.0001,709,695,50,2,0.001,1404,19
0.52,0.0001,766,738,50,2,0.001,1504,19
0.526,0.0001,813,791,50,2,0.001,1604,19
0.532,0.0001,867,837,50,2,0.001,1704,19
0.536,0.0001,913,891,50,2,0.001,1804,19
0.538,0.0001,957,947,50,2,0.001,1904,19
0.548,0.0001,1009,995,50,2,0.001,2004,19
0.494,0.0001,50,54,50,2,0.001,104,20
0.494,0.0001,97,107,50,2,0.001,204,20
0.494,0.0001,153,151,50,2,0.001,304,20
0.494,0.0001,206,198,50,2,0.001,404,20
0.494,0.0001,256,248,50,2,0.001,504,20
0.494,0.0001,294,310,50,2,0.001,604,20
0.494,0.0001,348,356,50,2,0.001,704,20
0.494,0.0001,398,406,50,2,0.001,804,20
0.494,0.0001,451,453,50,2,0.001,904,20
0.494,0.0001,507,497,50,2,0.001,1004,20
0.494,0.0001,548,556,50,2,0.001,1104,20
0.498,0.0001,591,613,50,2,0.001,1204,20
0.498,0.0001,641,663,50,2,0.001,1304,20
0.498,0.0001,696,708,50,2,0.001,1404,20
0.498,0.0001,751,753,50,2,0.001,1504,20
0.5,0.0001,791,813,50,2,0.001,1604,20
0.5,0.0001,846,858,50,2,0.001,1704,20
0.5,0.0001,902,902,50,2,0.001,1804,20
0.502,0.0001,951,953,50,2,0.001,1904,20
0.508,0.0001,999,1005,50,2,0.001,2004,20
0.508,0.0001,56,48,50,2,0.01,104,1
0.508,0.0001,110,94,50,2,0.01,204,1
0.508,0.0001,160,144,50,2,0.01,304,1
0.512,0.0001,215,189,50,2,0.01,404,1
0.51,0.0001,271,233,50,2,0.01,504,1
0.518,0.0001,324,280,50,2,0.01,604,1
0.506,0.0001,367,337,50,2,0.01,704,1
0.52,0.0001,415,389,50,2,0.01,804,1
0.502,0.0001,463,441,50,2,0.01,904,1
0.518,0.0001,505,499,50,2,0.01,1004,1
0.528,0.0001,556,548,50,2,0.01,1104,1
0.538,0.0001,609,595,50,2,0.01,1204,1
0.532,0.0001,655,649,50,2,0.01,1304,1
0.558,0.0001,696,708,50,2,0.01,1404,1
0.598,0.0001,741,763,50,2,0.01,1504,1
0.676,0.0001,797,807,50,2,0.01,1604,1
0.714,0.0001,843,861,50,2,0.01,1704,1
0.772,0.0001,898,906,50,2,0.01,1804,1
0.812,0.0001,952,952,50,2,0.01,1904,1
0.846,0.0001,1006,998,50,2,0.01,2004,1
0.468,0.0001,47,57,50,2,0.01,104,2
0.468,0.0001,103,101,50,2,0.01,204,2
0.468,0.0001,155,149,50,2,0.01,304,2
0.468,0.0001,202,202,50,2,0.01,404,2
0.468,0.0001,245,259,50,2,0.01,504,2
0.468,0.0001,291,313,50,2,0.01,604,2
0.466,0.0001,340,364,50,2,0.01,704,2
0.466,0.0001,386,418,50,2,0.01,804,2
0.472,0.0001,439,465,50,2,0.01,904,2
0.482,0.0001,499,505,50,2,0.01,1004,2
0.49,0.0001,556,548,50,2,0.01,1104,2
0.514,0.0001,604,600,50,2,0.01,1204,2
0.548,0.0001,643,661,50,2,0.01,1304,2
0.6,0.0001,698,706,50,2,0.01,1404,2
0.638,0.0001,740,764,50,2,0.01,1504,2
0.642,0.0001,790,814,50,2,0.01,1604,2
0.642,0.0001,833,871,50,2,0.01,1704,2
0.654,0.0001,880,924,50,2,0.01,1804,2
0.682,0.0001,930,974,50,2,0.01,1904,2
0.698,0.0001,986,1018,50,2,0.01,2004,2
0.51,0.0001,50,54,50,2,0.01,104,3
0.51,0.0001,103,101,50,2,0.01,204,3
0.51,0.0001,151,153,50,2,0.01,304,3
0.51,0.0001,206,198,50,2,0.01,404,3
0.51,0.0001,257,247,50,2,0.01,504,3
0.512,0.0001,309,295,50,2,0.01,604,3
0.516,0.0001,364,340,50,2,0.01,704,3
0.536,0.0001,414,390,50,2,0.01,804,3
0.562,0.0001,461,443,50,2,0.01,904,3
0.588,0.0001,509,495,50,2,0.01,1004,3
0.616,0.0001,560,544,50,2,0.01,1104,3
0.64,0.0001,612,592,50,2,0.01,1204,3
0.656,0.0001,657,647,50,2,0.01,1304,3
0.682,0.0001,707,697,50,2,0.01,1404,3
0.688,0.0001,756,748,50,2,0.01,1504,3
0.7,0.0001,815,789,50,2,0.01,1604,3
0.712,0.0001,850,854,50,2,0.01,1704,3
0.716,0.0001,900,904,50,2,0.01,1804,3
0.718,0.0001,955,949,50,2,0.01,1904,3
0.722,0.0001,1007,997,50,2,0.01,2004,3
0.52,0.0001,49,55,50,2,0.01,104,4
0.526,0.0001,88,116,50,2,0.01,204,4
0.532,0.0001,133,171,50,2,0.01,304,4
0.544,0.0001,190,214,50,2,0.01,404,4
0.548,0.0001,236,268,50,2,0.01,504,4
0.554,0.0001,283,321,50,2,0.01,604,4
0.572,0.0001,331,373,50,2,0.01,704,4
0.594,0.0001,381,423,50,2,0.01,804,4
0.61,0.0001,434,470,50,2,0.01,904,4
0.648,0.0001,490,514,50,2,0.01,1004,4
0.686,0.0001,536,568,50,2,0.01,1104,4
0.718,0.0001,576,628,50,2,0.01,1204,4
0.748,0.0001,635,669,50,2,0.01,1304,4
0.804,0.0001,688,716,50,2,0.01,1404,4
0.852,0.0001,742,762,50,2,0.01,1504,4
0.878,0.0001,787,817,50,2,0.01,1604,4
0.894,0.0001,841,863,50,2,0.01,1704,4
0.9,0.0001,897,907,50,2,0.01,1804,4
0.908,0.0001,953,951,50,2,0.01,1904,4
0.906,0.0001,1012,992,50,2,0.01,2004,4
0.496,0.0001,53,51,50,2,0.01,104,5
0.506,0.0001,102,102,50,2,0.01,204,5
0.504,0.0001,147,157,50,2,0.01,304,5
0.508,0.0001,204,200,50,2,0.01,404,5
0.514,0.0001,257,247,50,2,0.01,504,5
0.522,0.0001,305,299,50,2,0.01,604,5
0.532,0.0001,359,345,50,2,0.01,704,5
0.542,0.0001,399,405,50,2,0.01,804,5
0.54,0.0001,456,448,50,2,0.01,904,5
0.532,0.0001,499,505,50,2,0.01,1004,5
0.558,0.0001,551,553,50,2,0.01,1104,5
0.554,0.0001,608,596,50,2,0.01,1204,5
0.562,0.0001,660,644,50,2,0.01,1304,5
0.586,0.0001,706,698,50,2,0.01,1404,5
0.616,0.0001,753,751,50,2,0.01,1504,5
0.636,0.0001,799,805,50,2,0.01,1604,5
0.654,0.0001,853,851,50,2,0.01,1704,5
0.664,0.0001,893,911,50,2,0.01,1804,5
0.668,0.0001,947,957,50,2,0.01,1904,5
0.672,0.0001,990,1014,50,2,0.01,2004,5
0.48,0.0001,55,49,50,2,0.01,104,6
0.484,0.0001,103,101,50,2,0.01,204,6
0.484,0.0001,148,156,50,2,0.01,304,6
0.478,0.0001,203,201,50,2,0.01,404,6
0.48,0.0001,252,252,50,2,0.01,504,6
0.494,0.0001,312,292,50,2,0.01,604,6
0.492,0.0001,353,351,50,2,0.01,704,6
0.492,0.0001,408,396,50,2,0.01,804,6
0.494,0.0001,458,446,50,2,0.01,904,6
0.502,0.0001,513,491,50,2,0.01,1004,6
0.51,0.0001,559,545,50,2,0.01,1104,6
0.514,0.0001,598,606,50,2,0.01,1204,6
0.522,0.0001,651,653,50,2,0.01,1304,6
0.526,0.0001,704,700,50,2,0.01,1404,6
0.538,0.0001,762,742,50,2,0.01,1504,6
0.55,0.0001,805,799,50,2,0.01,1604,6
0.554,0.0001,859,845,50,2,0.01,1704,6
0.568,0.0001,909,895,50,2,0.01,1804,6
0.574,0.0001,959,945,50,2,0.01,1904,6
0.586,0.0001,1016,988,50,2,0.01,2004,6
0.486,0.0001,42,62,50,2,0.01,104,7
0.486,0.0001,88,116,50,2,0.01,204,7
0.486,0.0001,139,165,50,2,0.01,304,7
0.486,0.0001,197,207,50,2,0.01,404,7
0.486,0.0001,240,264,50,2,0.01,504,7
0.486,0.0001,292,312,50,2,0.01,604,7
0.518,0.0001,342,362,50,2,0.01,704,7
0.546,0.0001,393,411,50,2,0.01,804,7
0.544,0.0001,439,465,50,2,0.01,904,7
0.52,0.0001,493,511,50,2,0.01,1004,7
0.522,0.0001,537,567,50,2,0.01,1104,7
0.544,0.0001,588,616,50,2,0.01,1204,7
0.578,0.0001,642,662,50,2,0.01,1304,7
0.572,0.0001,695,709,50,2,0.01,1404,7
0.556,0.0001,743,761,50,2,0.01,1504,7
0.55,0.0001,800,804,50,2,0.01,1604,7
0.592,0.0001,848,856,50,2,0.01,1704,7
0.656,0.0001,896,908,50,2,0.01,1804,7
0.686,0.0001,947,957,50,2,0.01,1904,7
0.716,0.0001,995,1009,50,2,0.01,2004,7
0.49,0.0001,52,52,50,2,0.01,104,8
0.49,0.0001,104,100,50,2,0.01,204,8
0.49,0.0001,159,145,50,2,0.01,304,8
0.49,0.0001,216,188,50,2,0.01,404,8
0.49,0.0001,260,244,50,2,0.01,504,8
0.496,0.0001,306,298,50,2,0.01,604,8
0.494,0.0001,354,350,50,2,0.01,704,8
0.53,0.0001,396,408,50,2,0.01,804,8
0.534,0.0001,446,458,50,2,0.01,904,8
0.528,0.0001,505,499,50,2,0.01,1004,8
0.54,0.0001,558,546,50,2,0.01,1104,8
0.55,0.0001,606,598,50,2,0.01,1204,8
0.566,0.0001,658,646,50,2,0.01,1304,8
0.57,0.0001,708,696,50,2,0.01,1404,8
0.576,0.0001,762,742,50,2,0.01,1504,8
0.6,0.0001,813,791,50,2,0.01,1604,8
0.614,0.0001,864,840,50,2,0.01,1704,8
0.642,0.0001,909,895,50,2,0.01,1804,8
0.658,0.0001,958,946,50,2,0.01,1904,8
0.668,0.0001,1007,997,50,2,0.01,2004,8
0.516,0.0001,57,47,50,2,0.01,104,9
0.526,0.0001,108,96,50,2,0.01,204,9
0.524,0.0001,147,157,50,2,0.01,304,9
0.536,0.0001,204,200,50,2,0.01,404,9
0.544,0.0001,263,241,50,2,0.01,504,9
0.556,0.0001,313,291,50,2,0.01,604,9
0.566,0.0001,362,342,50,2,0.01,704,9
0.58,0.0001,416,388,50,2,0.01,804,9
0.598,0.0001,461,443,50,2,0.01,904,9
0.602,0.0001,507,497,50,2,0.01,1004,9
0.608,0.0001,555,549,50,2,0.01,1104,9
0.628,0.0001,608,596,50,2,0.01,1204,9
0.644,0.0001,656,648,50,2,0.01,1304,9
0.664,0.0001,703,701,50,2,0.01,1404,9
0.656,0.0001,756,748,50,2,0.01,1504,9
0.694,0.0001,808,796,50,2,0.01,1604,9
0.706,0.0001,856,848,50,2,0.01,1704,9
0.716,0.0001,910,894,50,2,0.01,1804,9
0.722,0.0001,963,941,50,2,0.01,1904,9
0.726,0.0001,1008,996,50,2,0.01,2004,9
0.528,0.0001,55,49,50,2,0.01,104,10
0.53,0.0001,108,96,50,2,0.01,204,10
0.528,0.0001,158,146,50,2,0.01,304,10
0.534,0.0001,211,193,50,2,0.01,404,10
0.532,0.0001,258,246,50,2,0.01,504,10
0.552,0.0001,300,304,50,2,0.01,604,10
0.544,0.0001,345,359,50,2,0.01,704,10
0.518,0.0001,396,408,50,2,0.01,804,10
0.512,0.0001,447,457,50,2,0.01,904,10
0.52,0.0001,501,503,50,2,0.01,1004,10
0.52,0.0001,551,553,50,2,0.01,1104,10
0.54,0.0001,604,600,50,2,0.01,1204,10
0.546,0.0001,643,661,50,2,0.01,1304,10
0.558,0.0001,692,712,50,2,0.01,1404,10
0.556,0.0001,738,766,50,2,0.01,1504,10
0.576,0.0001,788,816,50,2,0.01,1604,10
0.57,0.0001,844,860,50,2,0.01,1704,10
0.592,0.0001,893,911,50,2,0.01,1804,10
0.67,0.0001,940,964,50,2,0.01,1904,10
0.666,0.0001,991,1013,50,2,0.01,2004,10
0.472,0.0001,53,51,50,2,0.01,104,11
0.49,0.0001,97,107,50,2,0.01,204,11
0.52,0.0001,144,160,50,2,0.01,304,11
0.542,0.0001,195,209,50,2,0.01,404,11
0.572,0.0001,236,268,50,2,0.01,504,11
0.586,0.0001,287,317,50,2,0.01,604,11
0.586,0.0001,347,357,50,2,0.01,704,11
0.594,0.0001,399,405,50,2,0.01,804,11
0.626,0.0001,443,461,50,2,0.01,904,11
0.66,0.0001,488,516,50,2,0.01,1004,11
0.69,0.0001,543,561,50,2,0.01,1104,11
0.73,0.0001,593,611,50,2,0.01,1204,11
0.744,0.0001,644,660,50,2,0.01,1304,11
0.78,0.0001,690,714,50,2,0.01,1404,11
0.81,0.0001,734,770,50,2,0.01,1504,11
0.822,0.0001,794,810,50,2,0.01,1604,11
0.832,0.0001,859,845,50,2,0.01,1704,11
0.838,0.0001,908,896,50,2,0.01,1804,11
0.828,0.0001,954,950,50,2,0.01,1904,11
0.832,0.0001,1000,1004,50,2,0.01,2004,11
0.504,0.0001,58,46,50,2,0.01,104,12
0.5,0.0001,106,98,50,2,0.01,204,12
0.504,0.0001,150,154,50,2,0.01,304,12
0.55,0.0001,197,207,50,2,0.01,404,12
0.556,0.0001,253,251,50,2,0.01,504,12
0.572,0.0001,305,299,50,2,0.01,604,12
0.576,0.0001,357,347,50,2,0.01,704,12
0.568,0.0001,406,398,50,2,0.01,804,12
0.554,0.0001,459,445,50,2,0.01,904,12
0.572,0.0001,511,493,50,2,0.01,1004,12
0.592,0.0001,553,551,50,2,0.01,1104,12
0.618,0.0001,596,608,50,2,0.01,1204,12
0.648,0.0001,647,657,50,2,0.01,1304,12
0.668,0.0001,705,699,50,2,0.01,1404,12
0.688,0.0001,765,739,50,2,0.01,1504,12
0.7,0.0001,822,782,50,2,0.01,1604,12
0.708,0.0001,871,833,50,2,0.01,1704,12
0.708,0.0001,920,884,50,2,0.01,1804,12
0.706,0.0001,962,942,50,2,0.01,1904,12
0.704,0.0001,1012,992,50,2,0.01,2004,12
0.486,0.0001,58,46,50,2,0.01,104,13
0.486,0.0001,113,91,50,2,0.01,204,13
0.486,0.0001,158,146,50,2,0.01,304,13
0.486,0.0001,202,202,50,2,0.01,404,13
0.486,0.0001,246,258,50,2,0.01,504,13
0.486,0.0001,297,307,50,2,0.01,604,13
0.486,0.0001,346,358,50,2,0.01,704,13
0.486,0.0001,401,403,50,2,0.01,804,13
0.486,0.0001,453,451,50,2,0.01,904,13
0.486,0.0001,499,505,50,2,0.01,1004,13
0.486,0.0001,555,549,50,2,0.01,1104,13
0.608,0.0001,604,600,50,2,0.01,1204,13
0.67,0.0001,657,647,50,2,0.01,1304,13
0.716,0.0001,707,697,50,2,0.01,1404,13
0.742,0.0001,758,746,50,2,0.01,1504,13
0.758,0.0001,811,793,50,2,0.01,1604,13
0.764,0.0001,859,845,50,2,0.01,1704,13
0.766,0.0001,911,893,50,2,0.01,1804,13
0.778,0.0001,961,943,50,2,0.01,1904,13
0.792,0.0001,1009,995,50,2,0.01,2004,13
0.498,0.0001,52,52,50,2,0.01,104,14
0.498,0.0001,110,94,50,2,0.01,204,14
0.498,0.0001,161,143,50,2,0.01,304,14
0.498,0.0001,202,202,50,2,0.01,404,14
0.498,0.0001,237,267,50,2,0.01,504,14
0.496,0.0001,296,308,50,2,0.01,604,14
0.496,0.0001,350,354,50,2,0.01,704,14
0.504,0.0001,393,411,50,2,0.01,804,14
0.504,0.0001,435,469,50,2,0.01,904,14
0.538,0.0001,482,522,50,2,0.01,1004,14
0.566,0.0001,538,566,50,2,0.01,1104,14
0.592,0.0001,593,611,50,2,0.01,1204,14
0.602,0.0001,642,662,50,2,0.01,1304,14
0.608,0.0001,694,710,50,2,0.01,1404,14
0.622,0.0001,744,760,50,2,0.01,1504,14
0.632,0.0001,796,808,50,2,0.01,1604,14
0.652,0.0001,845,859,50,2,0.01,1704,14
0.664,0.0001,897,907,50,2,0.01,1804,14
0.66,0.0001,946,958,50,2,0.01,1904,14
0.674,0.0001,1001,1003,50,2,0.01,2004,14
0.504,0.0001,48,56,50,2,0.01,104,15
0.514,0.0001,98,106,50,2,0.01,204,15
0.516,0.0001,146,158,50,2,0.01,304,15
0.516,0.0001,200,204,50,2,0.01,404,15
0.528,0.0001,245,259,50,2,0.01,504,15
0.528,0.0001,295,309,50,2,0.01,604,15
0.544,0.0001,345,359,50,2,0.01,704,15
0.544,0.0001,392,412,50,2,0.01,804,15
0.552,0.0001,453,451,50,2,0.01,904,15
0.542,0.0001,502,502,50,2,0.01,1004,15
0.548,0.0001,554,550,50,2,0.01,1104,15
0.578,0.0001,599,605,50,2,0.01,1204,15
0.576,0.0001,646,658,50,2,0.01,1304,15
0.586,0.0001,697,707,50,2,0.01,1404,15
0.614,0.0001,742,762,50,2,0.01,1504,15
0.674,0.0001,798,806,50,2,0.01,1604,15
0.692,0.0001,845,859,50,2,0.01,1704,15
0.692,0.0001,894,910,50,2,0.01,1804,15
0.716,0.0001,938,966,50,2,0.01,1904,15
0.722,0.0001,992,1012,50,2,0.01,2004,15
0.482,0.0001,60,44,50,2,0.01,104,16
0.494,0.0001,117,87,50,2,0.01,204,16
0.498,0.0001,165,139,50,2,0.01,304,16
0.502,0.0001,217,187,50,2,0.01,404,16
0.504,0.0001,264,240,50,2,0.01,504,16
0.506,0.0001,311,293,50,2,0.01,604,16
0.502,0.0001,360,344,50,2,0.01,704,16
0.512,0.0001,411,393,50,2,0.01,804,16
0.52,0.0001,463,441,50,2,0.01,904,16
0.518,0.0001,509,495,50,2,0.01,1004,16
0.52,0.0001,562,542,50,2,0.01,1104,16
0.528,0.0001,615,589,50,2,0.01,1204,16
0.54,0.0001,668,636,50,2,0.01,1304,16
0.556,0.0001,715,689,50,2,0.01,1404,16
0.554,0.0001,762,742,50,2,0.01,1504,16
0.574,0.0001,815,789,50,2,0.01,1604,16
0.584,0.0001,861,843,50,2,0.01,1704,16
0.62,0.0001,909,895,50,2,0.01,1804,16
0.63,0.0001,954,950,50,2,0.01,1904,16
0.658,0.0001,1003,1001,50,2,0.01,2004,16
0.504,0.0001,54,50,50,2,0.01,104,17
0.504,0.0001,108,96,50,2,0.01,204,17
0.504,0.0001,158,146,50,2,0.01,304,17
0.504,0.0001,210,194,50,2,0.01,404,17
0.504,0.0001,255,249,50,2,0.01,504,17
0.504,0.0001,309,295,50,2,0.01,604,17
0.504,0.0001,361,343,50,2,0.01,704,17
0.504,0.0001,410,394,50,2,0.01,804,17
0.504,0.0001,455,449,50,2,0.01,904,17
0.534,0.0001,502,502,50,2,0.01,1004,17
0.576,0.0001,560,544,50,2,0.01,1104,17
0.582,0.0001,609,595,50,2,0.01,1204,17
0.588,0.0001,668,636,50,2,0.01,1304,17
0.602,0.0001,715,689,50,2,0.01,1404,17
0.608,0.0001,758,746,50,2,0.01,1504,17
0.624,0.0001,814,790,50,2,0.01,1604,17
0.626,0.0001,862,842,50,2,0.01,1704,17
0.628,0.0001,905,899,50,2,0.01,1804,17
0.64,0.0001,945,959,50,2,0.01,1904,17
0.642,0.0001,1000,1004,50,2,0.01,2004,17
0.49,0.0001,52,52,50,2,0.01,104,18
0.49,0.0001,98,106,50,2,0.01,204,18
0.49,0.0001,149,155,50,2,0.01,304,18
0.49,0.0001,200,204,50,2,0.01,404,18
0.49,0.0001,245,259,50,2,0.01,504,18
0.49,0.0001,296,308,50,2,0.01,604,18
0.49,0.0001,343,361,50,2,0.01,704,18
0.49,0.0001,393,411,50,2,0.01,804,18
0.49,0.0001,443,461,50,2,0.01,904,18
0.49,0.0001,490,514,50,2,0.01,1004,18
0.49,0.0001,537,567,50,2,0.01,1104,18
0.49,0.0001,582,622,50,2,0.01,1204,18
0.49,0.0001,638,666,50,2,0.01,1304,18
0.49,0.0001,687,717,50,2,0.01,1404,18
0.49,0.0001,732,772,50,2,0.01,1504,18
0.49,0.0001,782,822,50,2,0.01,1604,18
0.49,0.0001,839,865,50,2,0.01,1704,18
0.49,0.0001,896,908,50,2,0.01,1804,18
0.49,0.0001,952,952,50,2,0.01,1904,18
0.49,0.0001,1007,997,50,2,0.01,2004,18
0.526,0.0001,47,57,50,2,0.01,104,19
0.526,0.0001,100,104,50,2,0.01,204,19
0.526,0.0001,155,149,50,2,0.01,304,19
0.526,0.0001,204,200,50,2,0.01,404,19
0.526,0.0001,261,243,50,2,0.01,504,19
0.526,0.0001,312,292,50,2,0.01,604,19
0.526,0.0001,366,338,50,2,0.01,704,19
0.526,0.0001,414,390,50,2,0.01,804,19
0.526,0.0001,466,438,50,2,0.01,904,19
0.526,0.0001,515,489,50,2,0.01,1004,19
0.526,0.0001,561,543,50,2,0.01,1104,19
0.526,0.0001,608,596,50,2,0.01,1204,19
0.526,0.0001,653,651,50,2,0.01,1304,19
0.526,0.0001,698,706,50,2,0.01,1404,19
0.526,0.0001,747,757,50,2,0.01,1504,19
0.526,0.0001,787,817,50,2,0.01,1604,19
0.526,0.0001,839,865,50,2,0.01,1704,19
0.526,0.0001,888,916,50,2,0.01,1804,19
0.526,0.0001,937,967,50,2,0.01,1904,19
0.526,0.0001,989,1015,50,2,0.01,2004,19
0.516,0.0001,47,57,50,2,0.01,104,20
0.514,0.0001,95,109,50,2,0.01,204,20
0.524,0.0001,152,152,50,2,0.01,304,20
0.538,0.0001,210,194,50,2,0.01,404,20
0.542,0.0001,251,253,50,2,0.01,504,20
0.548,0.0001,302,302,50,2,0.01,604,20
0.554,0.0001,353,351,50,2,0.01,704,20
0.574,0.0001,398,406,50,2,0.01,804,20
0.572,0.0001,452,452,50,2,0.01,904,20
0.576,0.0001,497,507,50,2,0.01,1004,20
0.578,0.0001,548,556,50,2,0.01,1104,20
0.584,0.0001,602,602,50,2,0.01,1204,20
0.6,0.0001,647,657,50,2,0.01,1304,20
0.616,0.0001,696,708,50,2,0.01,1404,20
0.634,0.0001,747,757,50,2,0.01,1504,20
0.644,0.0001,796,808,50,2,0.01,1604,20
0.652,0.0001,847,857,50,2,0.01,1704,20
0.662,0.0001,900,904,50,2,0.01,1804,20
0.668,0.0001,954,950,50,2,0.01,1904,20
0.672,0.0001,994,1010,50,2,0.01,2004,20
0.532,0.001,54,50,50,2,0.0001,104,1
0.532,0.001,102,102,50,2,0.0001,204,1
0.532,0.001,155,149,50,2,0.0001,304,1
0.532,0.001,198,206,50,2,0.0001,404,1
0.532,0.001,258,246,50,2,0.0001,504,1
0.532,0.001,313,291,50,2,0.0001,604,1
0.534,0.001,358,346,50,2,0.0001,704,1
0.534,0.001,414,390,50,2,0.0001,804,1
0.534,0.001,462,442,50,2,0.0001,904,1
0.534,0.001,511,493,50,2,0.0001,1004,1
0.534,0.001,556,548,50,2,0.0001,1104,1
0.534,0.001,602,602,50,2,0.0001,1204,1
0.536,0.001,652,652,50,2,0.0001,1304,1
0.536,0.001,706,698,50,2,0.0001,1404,1
0.538,0.001,755,749,50,2,0.0001,1504,1
0.536,0.001,813,791,50,2,0.0001,1604,1
0.536,0.001,863,841,50,2,0.0001,1704,1
0.534,0.001,906,898,50,2,0.0001,1804,1
0.534,0.001,952,952,50,2,0.0001,1904,1
0.534,0.001,1000,1004,50,2,0.0001,2004,1
0.49,0.001,48,56,50,2,0.0001,104,2
0.49,0.001,91,113,50,2,0.0001,204,2
0.49,0.001,146,158,50,2,0.0001,304,2
0.49,0.001,200,204,50,2,0.0001,404,2
0.49,0.001,248,256,50,2,0.0001,504,2
0.488,0.001,293,311,50,2,0.0001,604,2
0.488,0.001,340,364,50,2,0.0001,704,2
0.49,0.001,387,417,50,2,0.0001,804,2
0.492,0.001,432,472,50,2,0.0001,904,2
0.492,0.001,474,530,50,2,0.0001,1004,2
0.492,0.001,523,581,50,2,0.0001,1104,2
0.492,0.001,570,634,50,2,0.0001,1204,2
0.492,0.001,628,676,50,2,0.0001,1304,2
0.488,0.001,678,726,50,2,0.0001,1404,2
0.486,0.001,723,781,50,2,0.0001,1504,2
0.484,0.001,777,827,50,2,0.0001,1604,2
0.484,0.001,838,866,50,2,0.0001,1704,2
0.486,0.001,885,919,50,2,0.0001,1804,2
0.486,0.001,940,964,50,2,0.0001,1904,2
0.486,0.001,997,1007,50,2,0.0001,2004,2
0.514,0.001,47,57,50,2,0.0001,104,3
0.514,0.001,94,110,50,2,0.0001,204,3
0.514,0.001,144,160,50,2,0.0001,304,3
0.514,0.001,205,199,50,2,0.0001,404,3
0.514,0.001,256,248,50,2,0.0001,504,3
0.514,0.001,300,304,50,2,0.0001,604,3
0.514,0.001,342,362,50,2,0.0001,704,3
0.514,0.001,387,417,50,2,0.0001,804,3
0.514,0.001,434,470,50,2,0.0001,904,3
0.514,0.001,484,520,50,2,0.0001,1004,3
0.514,0.001,535,569,50,2,0.0001,1104,3
0.514,0.001,591,613,50,2,0.0001,1204,3
0.514,0.001,640,664,50,2,0.0001,1304,3
0.516,0.001,690,714,50,2,0.0001,1404,3
0.516,0.001,736,768,50,2,0.0001,1504,3
0.516,0.001,789,815,50,2,0.0001,1604,3
0.516,0.001,841,863,50,2,0.0001,1704,3
0.516,0.001,898,906,50,2,0.0001,1804,3
0.514,0.001,951,953,50,2,0.0001,1904,3
0.516,0.001,1003,1001,50,2,0.0001,2004,3
0.496,0.001,63,41,50,2,0.0001,104,4
0.496,0.001,115,89,50,2,0.0001,204,4
0.496,0.001,155,149,50,2,0.0001,304,4
0.496,0.001,195,209,50,2,0.0001,404,4
0.496,0.001,251,253,50,2,0.0001,504,4
0.496,0.001,299,305,50,2,0.0001,604,4
0.496,0.001,350,354,50,2,0.0001,704,4
0.496,0.001,408,396,50,2,0.0001,804,4
0.496,0.001,455,449,50,2,0.0001,904,4
0.496,0.001,506,498,50,2,0.0001,1004,4
0.496,0.001,560,544,50,2,0.0001,1104,4
0.496,0.001,608,596,50,2,0.0001,1204,4
0.496,0.001,653,651,50,2,0.0001,1304,4
0.496,0.001,711,693,50,2,0.0001,1404,4
0.496,0.001,757,747,50,2,0.0001,1504,4
0.496,0.001,813,791,50,2,0.0001,1604,4
0.496,0.001,861,843,50,2,0.0001,1704,4
0.496,0.001,917,887,50,2,0.0001,1804,4
0.496,0.001,956,948,50,2,0.0001,1904,4
0.496,0.001,1004,1000,50,2,0.0001,2004,4
0.502,0.001,43,61,50,2,0.0001,104,5
0.502,0.001,93,111,50,2,0.0001,204,5
0.502,0.001,149,155,50,2,0.0001,304,5
0.502,0.001,197,207,50,2,0.0001,404,5
0.502,0.001,248,256,50,2,0.0001,504,5
0.502,0.001,301,303,50,2,0.0001,604,5
0.502,0.001,351,353,50,2,0.0001,704,5
0.502,0.001,399,405,50,2,0.0001,804,5
0.502,0.001,442,462,50,2,0.0001,904,5
0.502,0.001,499,505,50,2,0.0001,1004,5
0.502,0.001,551,553,50,2,0.0001,1104,5
0.502,0.001,600,604,50,2,0.0001,1204,5
0.502,0.001,646,658,50,2,0.0001,1304,5
0.502,0.001,693,711,50,2,0.0001,1404,5
0.502,0.001,744,760,50,2,0.0001,1504,5
0.502,0.001,792,812,50,2,0.0001,1604,5
0.502,0.001,844,860,50,2,0.0001,1704,5
0.502,0.001,897,907,50,2,0.0001,1804,5
0.502,0.001,952,952,50,2,0.0001,1904,5
0.502,0.001,1002,1002,50,2,0.0001,2004,5
0.474,0.001,53,51,50,2,0.0001,104,6
0.474,0.001,105,99,50,2,0.0001,204,6
0.474,0.001,153,151,50,2,0.0001,304,6
0.474,0.001,206,198,50,2,0.0001,404,6
0.474,0.001,255,249,50,2,0.0001,504,6
0.474,0.001,304,300,50,2,0.0001,604,6
0.476,0.001,344,360,50,2,0.0001,704,6
0.478,0.001,393,411,50,2,0.0001,804,6
0.478,0.001,442,462,50,2,0.0001,904,6
0.478,0.001,490,514,50,2,0.0001,1004,6
0.478,0.001,542,562,50,2,0.0001,1104,6
0.476,0.001,586,618,50,2,0.0001,1204,6
0.476,0.001,640,664,50,2,0.0001,1304,6
0.474,0.001,686,718,50,2,0.0001,1404,6
0.474,0.001,740,764,50,2,0.0001,1504,6
0.472,0.001,796,808,50,2,0.0001,1604,6
0.472,0.001,834,870,50,2,0.0001,1704,6
0.472,0.001,877,927,50,2,0.0001,1804,6
0.472,0.001,935,969,50,2,0.0001,1904,6
0.474,0.001,992,1012,50,2,0.0001,2004,6
0.502,0.001,58,46,50,2,0.0001,104,7
0.502,0.001,105,99,50,2,0.0001,204,7
0.502,0.001,163,141,50,2,0.0001,304,7
0.502,0.001,214,190,50,2,0.0001,404,7
0.504,0.001,264,240,50,2,0.0001,504,7
0.504,0.001,306,298,50,2,0.0001,604,7
0.504,0.001,358,346,50,2,0.0001,704,7
0.504,0.001,413,391,50,2,0.0001,804,7
0.504,0.001,469,435,50,2,0.0001,904,7
0.504,0.001,510,494,50,2,0.0001,1004,7
0.504,0.001,565,539,50,2,0.0001,1104,7
0.504,0.001,618,586,50,2,0.0001,1204,7
0.504,0.001,670,634,50,2,0.0001,1304,7
0.504,0.001,718,686,50,2,0.0001,1404,7
0.504,0.001,775,729,50,2,0.0001,1504,7
0.504,0.001,826,778,50,2,0.0001,1604,7
0.506,0.001,864,840,50,2,0.0001,1704,7
0.506,0.001,915,889,50,2,0.0001,1804,7
0.506,0.001,953,951,50,2,0.0001,1904,7
0.506,0.001,1007,997,50,2,0.0001,2004,7
0.496,0.001,48,56,50,2,0.0001,104,8
0.496,0.001,93,111,50,2,0.0001,204,8
0.496,0.001,138,166,50,2,0.0001,304,8
0.496,0.001,185,219,50,2,0.0001,404,8
0.496,0.001,237,267,50,2,0.0001,504,8
0.496,0.001,287,317,50,2,0.0001,604,8
0.496,0.001,339,365,50,2,0.0001,704,8
0.496,0.001,391,413,50,2,0.0001,804,8
0.496,0.001,436,468,50,2,0.0001,904,8
0.496,0.001,492,512,50,2,0.0001,1004,8
0.496,0.001,540,564,50,2,0.0001,1104,8
0.496,0.001,590,614,50,2,0.0001,1204,8
0.496,0.001,637,667,50,2,0.0001,1304,8
0.496,0.001,686,718,50,2,0.0001,1404,8
0.496,0.001,742,762,50,2,0.0001,1504,8
0.496,0.001,793,811,50,2,0.0001,1604,8
0.496,0.001,848,856,50,2,0.0001,1704,8
0.496,0.001,902,902,50,2,0.0001,1804,8
0.496,0.001,953,951,50,2,0.0001,1904,8
0.496,0.001,1000,1004,50,2,0.0001,2004,8
0.498,0.001,51,53,50,2,0.0001,104,9
0.498,0.001,103,101,50,2,0.0001,204,9
0.498,0.001,157,147,50,2,0.0001,304,9
0.498,0.001,203,201,50,2,0.0001,404,9
0.498,0.001,257,247,50,2,0.0001,504,9
0.498,0.001,304,300,50,2,0.0001,604,9
0.498,0.001,356,348,50,2,0.0001,704,9
0.498,0.001,407,397,50,2,0.0001,804,9
0.498,0.001,456,448,50,2,0.0001,904,9
0.498,0.001,502,502,50,2,0.0001,1004,9
0.498,0.001,556,548,50,2,0.0001,1104,9
0.498,0.001,600,604,50,2,0.0001,1204,9
0.498,0.001,652,652,50,2,0.0001,1304,9
0.498,0.001,697,707,50,2,0.0001,1404,9
0.498,0.001,747,757,50,2,0.0001,1504,9
0.498,0.001,800,804,50,2,0.0001,1604,9
0.498,0.001,847,857,50,2,0.0001,1704,9
0.498,0.001,905,899,50,2,0.0001,1804,9
0.498,0.001,949,955,50,2,0.0001,1904,9
0.498,0.001,1001,1003,50,2,0.0001,2004,9
0.508,0.001,52,52,50,2,0.0001,104,10
0.508,0.001,105,99,50,2,0.0001,204,10
0.508,0.001,148,156,50,2,0.0001,304,10
0.508,0.001,196,208,50,2,0.0001,404,10
0.508,0.001,252,252,50,2,0.0001,504,10
0.508,0.001,302,302,50,2,0.0001,604,10
0.508,0.001,350,354,50,2,0.0001,704,10
0.508,0.001,401,403,50,2,0.0001,804,10
0.508,0.001,458,446,50,2,0.0001,904,10
0.508,0.001,514,490,50,2,0.0001,1004,10
0.51,0.001,564,540,50,2,0.0001,1104,10
0.51,0.001,604,600,50,2,0.0001,1204,10
0.51,0.001,654,650,50,2,0.0001,1304,10
0.51,0.001,699,705,50,2,0.0001,1404,10
0.512,0.001,757,747,50,2,0.0001,1504,10
0.512,0.001,799,805,50,2,0.0001,1604,10
0.516,0.001,846,858,50,2,0.0001,1704,10
0.516,0.001,892,912,50,2,0.0001,1804,10
0.518,0.001,941,963,50,2,0.0001,1904,10
0.518,0.001,1000,1004,50,2,0.0001,2004,10
0.506,0.001,51,53,50,2,0.0001,104,11
0.506,0.001,108,96,50,2,0.0001,204,11
0.506,0.001,160,144,50,2,0.0001,304,11
0.506,0.001,210,194,50,2,0.0001,404,11
0.506,0.001,260,244,50,2,0.0001,504,11
0.506,0.001,306,298,50,2,0.0001,604,11
0.506,0.001,351,353,50,2,0.0001,704,11
0.506,0.001,404,400,50,2,0.0001,804,11
0.506,0.001,444,460,50,2,0.0001,904,11
0.506,0.001,496,508,50,2,0.0001,1004,11
0.506,0.001,543,561,50,2,0.0001,1104,11
0.506,0.001,595,609,50,2,0.0001,1204,11
0.506,0.001,648,656,50,2,0.0001,1304,11
0.506,0.001,706,698,50,2,0.0001,1404,11
0.506,0.001,752,752,50,2,0.0001,1504,11
0.506,0.001,803,801,50,2,0.0001,1604,11
0.506,0.001,852,852,50,2,0.0001,1704,11
0.506,0.001,901,903,50,2,0.0001,1804,11
0.506,0.001,953,951,50,2,0.0001,1904,11
0.506,0.001,1005,999,50,2,0.0001,2004,11
0.518,0.001,53,51,50,2,0.0001,104,12
0.518,0.001,104,100,50,2,0.0001,204,12
0.518,0.001,161,143,50,2,0.0001,304,12
0.518,0.001,207,197,50,2,0.0001,404,12
0.518,0.001,263,241,50,2,0.0001,504,12
0.518,0.001,314,290,50,2,0.0001,604,12
0.516,0.001,359,345,50,2,0.0001,704,12
0.514,0.001,411,393,50,2,0.0001,804,12
0.516,0.001,449,455,50,2,0.0001,904,12
0.516,0.001,495,509,50,2,0.0001,1004,12
0.516,0.001,547,557,50,2,0.0001,1104,12
0.518,0.001,593,611,50,2,0.0001,1204,12
0.518,0.001,653,651,50,2,0.0001,1304,12
0.518,0.001,699,705,50,2,0.0001,1404,12
0.518,0.001,748,756,50,2,0.0001,1504,12
0.518,0.001,802,802,50,2,0.0001,1604,12
0.518,0.001,852,852,50,2,0.0001,1704,12
0.518,0.001,896,908,50,2,0.0001,1804,12
0.518,0.001,947,957,50,2,0.0001,1904,12
0.518,0.001,997,1007,50,2,0.0001,2004,12
0.488,0.001,52,52,50,2,0.0001,104,13
0.488,0.001,97,107,50,2,0.0001,204,13
0.488,0.001,147,157,50,2,0.0001,304,13
0.488,0.001,196,208,50,2,0.0001,404,13
0.488,0.001,248,256,50,2,0.0001,504,13
0.488,0.001,305,299,50,2,0.0001,604,13
0.488,0.001,364,340,50,2,0.0001,704,13
0.488,0.001,416,388,50,2,0.0001,804,13
0.488,0.001,464,440,50,2,0.0001,904,13
0.488,0.001,516,488,50,2,0.0001,1004,13
0.488,0.001,566,538,50,2,0.0001,1104,13
0.488,0.001,612,592,50,2,0.0001,1204,13
0.488,0.001,664,640,50,2,0.0001,1304,13
0.488,0.001,712,692,50,2,0.0001,1404,13
0.488,0.001,765,739,50,2,0.0001,1504,13
0.488,0.001,809,795,50,2,0.0001,1604,13
0.488,0.001,862,842,50,2,0.0001,1704,13
0.488,0.001,913,891,50,2,0.0001,1804,13
0.488,0.001,969,935,50,2,0.0001,1904,13
0.488,0.001,1008,996,50,2,0.0001,2004,13
0.5,0.001,52,52,50,2,0.0001,104,14
0.5,0.001,99,105,50,2,0.0001,204,14
0.5,0.001,150,154,50,2,0.0001,304,14
0.5,0.001,196,208,50,2,0.0001,404,14
0.5,0.001,247,257,50,2,0.0001,504,14
0.5,0.001,302,302,50,2,0.0001,604,14
0.5,0.001,357,347,50,2,0.0001,704,14
0.5,0.001,412,392,50,2,0.0001,804,14
0.5,0.001,464,440,50,2,0.0001,904,14
0.5,0.001,513,491,50,2,0.0001,1004,14
0.5,0.001,555,549,50,2,0.0001,1104,14
0.5,0.001,609,595,50,2,0.0001,1204,14
0.5,0.001,659,645,50,2,0.0001,1304,14
0.5,0.001,710,694,50,2,0.0001,1404,14
0.5,0.001,760,744,50,2,0.0001,1504,14
0.5,0.001,812,792,50,2,0.0001,1604,14
0.5,0.001,861,843,50,2,0.0001,1704,14
0.5,0.001,908,896,50,2,0.0001,1804,14
0.5,0.001,955,949,50,2,0.0001,1904,14
0.5,0.001,1002,1002,50,2,0.0001,2004,14
0.494,0.001,55,49,50,2,0.0001,104,15
0.496,0.001,114,90,50,2,0.0001,204,15
0.496,0.001,167,137,50,2,0.0001,304,15
0.496,0.001,228,176,50,2,0.0001,404,15
0.496,0.001,272,232,50,2,0.0001,504,15
0.498,0.001,320,284,50,2,0.0001,604,15
0.498,0.001,368,336,50,2,0.0001,704,15
0.498,0.001,411,393,50,2,0.0001,804,15
0.498,0.001,457,447,50,2,0.0001,904,15
0.498,0.001,512,492,50,2,0.0001,1004,15
0.498,0.001,564,540,50,2,0.0001,1104,15
0.498,0.001,613,591,50,2,0.0001,1204,15
0.498,0.001,657,647,50,2,0.0001,1304,15
0.5,0.001,709,695,50,2,0.0001,1404,15
0.5,0.001,762,742,50,2,0.0001,1504,15
0.502,0.001,807,797,50,2,0.0001,1604,15
0.504,0.001,870,834,50,2,0.0001,1704,15
0.504,0.001,921,883,50,2,0.0001,1804,15
0.504,0.001,961,943,50,2,0.0001,1904,15
0.504,0.001,1013,991,50,2,0.0001,2004,15
0.476,0.001,43,61,50,2,0.0001,104,16
0.476,0.001,91,113,50,2,0.0001,204,16
0.476,0.001,132,172,50,2,0.0001,304,16
0.476,0.001,179,225,50,2,0.0001,404,16
0.476,0.001,233,271,50,2,0.0001,504,16
0.476,0.001,290,314,50,2,0.0001,604,16
0.476,0.001,339,365,50,2,0.0001,704,16
0.476,0.001,387,417,50,2,0.0001,804,16
0.476,0.001,440,464,50,2,0.0001,904,16
0.476,0.001,490,514,50,2,0.0001,1004,16
0.476,0.001,537,567,50,2,0.0001,1104,16
0.476,0.001,594,610,50,2,0.0001,1204,16
0.476,0.001,646,658,50,2,0.0001,1304,16
0.476,0.001,694,710,50,2,0.0001,1404,16
0.476,0.001,745,759,50,2,0.0001,1504,16
0.476,0.001,793,811,50,2,0.0001,1604,16
0.476,0.001,841,863,50,2,0.0001,1704,16
0.476,0.001,890,914,50,2,0.0001,1804,16
0.476,0.001,941,963,50,2,0.0001,1904,16
0.476,0.001,990,1014,50,2,0.0001,2004,16
0.524,0.001,48,56,50,2,0.0001,104,17
0.526,0.001,108,96,50,2,0.0001,204,17
0.528,0.001,156,148,50,2,0.0001,304,17
0.53,0.001,199,205,50,2,0.0001,404,17
0.53,0.001,237,267,50,2,0.0001,504,17
0.53,0.001,291,313,50,2,0.0001,604,17
0.53,0.001,343,361,50,2,0.0001,704,17
0.53,0.001,398,406,50,2,0.0001,804,17
0.53,0.001,452,452,50,2,0.0001,904,17
0.53,0.001,498,506,50,2,0.0001,1004,17
0.532,0.001,555,549,50,2,0.0001,1104,17
0.532,0.001,596,608,50,2,0.0001,1204,17
0.53,0.001,646,658,50,2,0.0001,1304,17
0.528,0.001,694,710,50,2,0.0001,1404,17
0.53,0.001,740,764,50,2,0.0001,1504,17
0.53,0.001,786,818,50,2,0.0001,1604,17
0.53,0.001,840,864,50,2,0.0001,1704,17
0.53,0.001,891,913,50,2,0.0001,1804,17
0.53,0.001,946,958,50,2,0.0001,1904,17
0.532,0.001,998,1006,50,2,0.0001,2004,17
0.486,0.001,56,48,50,2,0.0001,104,18
0.486,0.001,111,93,50,2,0.0001,204,18
0.486,0.001,155,149,50,2,0.0001,304,18
0.486,0.001,210,194,50,2,0.0001,404,18
0.486,0.001,266,238,50,2,0.0001,504,18
0.486,0.001,314,290,50,2,0.0001,604,18
0.486,0.001,356,348,50,2,0.0001,704,18
0.486,0.001,408,396,50,2,0.0001,804,18
0.486,0.001,454,450,50,2,0.0001,904,18
0.486,0.001,513,491,50,2,0.0001,1004,18
0.486,0.001,566,538,50,2,0.0001,1104,18
0.486,0.001,618,586,50,2,0.0001,1204,18
0.486,0.001,669,635,50,2,0.0001,1304,18
0.486,0.001,718,686,50,2,0.0001,1404,18
0.486,0.001,768,736,50,2,0.0001,1504,18
0.486,0.001,811,793,50,2,0.0001,1604,18
0.486,0.001,868,836,50,2,0.0001,1704,18
0.486,0.001,917,887,50,2,0.0001,1804,18
0.486,0.001,962,942,50,2,0.0001,1904,18
0.486,0.001,1009,995,50,2,0.0001,2004,18
0.506,0.001,49,55,50,2,0.0001,104,19
0.506,0.001,97,107,50,2,0.0001,204,19
0.506,0.001,148,156,50,2,0.0001,304,19
0.506,0.001,205,199,50,2,0.0001,404,19
0.506,0.001,263,241,50,2,0.0001,504,19
0.506,0.001,318,286,50,2,0.0001,604,19
0.506,0.001,373,331,50,2,0.0001,704,19
0.506,0.001,414,390,50,2,0.0001,804,19
0.506,0.001,466,438,50,2,0.0001,904,19
0.506,0.001,523,481,50,2,0.0001,1004,19
0.506,0.001,568,536,50,2,0.0001,1104,19
0.506,0.001,617,587,50,2,0.0001,1204,19
0.506,0.001,667,637,50,2,0.0001,1304,19
0.506,0.001,709,695,50,2,0.0001,1404,19
0.506,0.001,760,744,50,2,0.0001,1504,19
0.506,0.001,809,795,50,2,0.0001,1604,19
0.506,0.001,850,854,50,2,0.0001,1704,19
0.506,0.001,893,911,50,2,0.0001,1804,19
0.506,0.001,952,952,50,2,0.0001,1904,19
0.506,0.001,1005,999,50,2,0.0001,2004,19
0.496,0.001,56,48,50,2,0.0001,104,20
0.496,0.001,106,98,50,2,0.0001,204,20
0.496,0.001,155,149,50,2,0.0001,304,20
0.496,0.001,205,199,50,2,0.0001,404,20
0.496,0.001,261,243,50,2,0.0001,504,20
0.496,0.001,310,294,50,2,0.0001,604,20
0.496,0.001,358,346,50,2,0.0001,704,20
0.496,0.001,416,388,50,2,0.0001,804,20
0.496,0.001,462,442,50,2,0.0001,904,20
0.496,0.001,506,498,50,2,0.0001,1004,20
0.496,0.001,562,542,50,2,0.0001,1104,20
0.496,0.001,610,594,50,2,0.0001,1204,20
0.496,0.001,662,642,50,2,0.0001,1304,20
0.496,0.001,709,695,50,2,0.0001,1404,20
0.496,0.001,750,754,50,2,0.0001,1504,20
0.496,0.001,795,809,50,2,0.0001,1604,20
0.496,0.001,849,855,50,2,0.0001,1704,20
0.496,0.001,905,899,50,2,0.0001,1804,20
0.496,0.001,957,947,50,2,0.0001,1904,20
0.496,0.001,1004,1000,50,2,0.0001,2004,20
0.508,0.001,44,60,50,2,0.001,104,1
0.508,0.001,91,113,50,2,0.001,204,1
0.508,0.001,143,161,50,2,0.001,304,1
0.508,0.001,201,203,50,2,0.001,404,1
0.508,0.001,248,256,50,2,0.001,504,1
0.508,0.001,302,302,50,2,0.001,604,1
0.508,0.001,349,355,50,2,0.001,704,1
0.508,0.001,403,401,50,2,0.001,804,1
0.508,0.001,459,445,50,2,0.001,904,1
0.508,0.001,512,492,50,2,0.001,1004,1
0.508,0.001,560,544,50,2,0.001,1104,1
0.508,0.001,612,592,50,2,0.001,1204,1
0.508,0.001,661,643,50,2,0.001,1304,1
0.508,0.001,710,694,50,2,0.001,1404,1
0.508,0.001,752,752,50,2,0.001,1504,1
0.508,0.001,804,800,50,2,0.001,1604,1
0.508,0.001,855,849,50,2,0.001,1704,1
0.508,0.001,896,908,50,2,0.001,1804,1
0.508,0.001,949,955,50,2,0.001,1904,1
0.508,0.001,998,1006,50,2,0.001,2004,1
0.498,0.001,51,53,50,2,0.001,104,2
0.498,0.001,105,99,50,2,0.001,204,2
0.498,0.001,165,139,50,2,0.001,304,2
0.498,0.001,214,190,50,2,0.001,404,2
0.498,0.001,269,235,50,2,0.001,504,2
0.498,0.001,308,296,50,2,0.001,604,2
0.498,0.001,362,342,50,2,0.001,704,2
0.498,0.001,411,393,50,2,0.001,804,2
0.498,0.001,457,447,50,2,0.001,904,2
0.498,0.001,510,494,50,2,0.001,1004,2
0.498,0.001,558,546,50,2,0.001,1104,2
0.498,0.001,610,594,50,2,0.001,1204,2
0.498,0.001,656,648,50,2,0.001,1304,2
0.498,0.001,709,695,50,2,0.001,1404,2
0.498,0.001,760,744,50,2,0.001,1504,2
0.498,0.001,811,793,50,2,0.001,1604,2
0.498,0.001,860,844,50,2,0.001,1704,2
0.498,0.001,896,908,50,2,0.001,1804,2
0.5,0.001,947,957,50,2,0.001,1904,2
0.502,0.001,1001,1003,50,2,0.001,2004,2
0.47,0.001,49,55,50,2,0.001,104,3
0.468,0.001,100,104,50,2,0.001,204,3
0.468,0.001,157,147,50,2,0.001,304,3
0.468,0.001,209,195,50,2,0.001,404,3
0.468,0.001,258,246,50,2,0.001,504,3
0.462,0.001,302,302,50,2,0.001,604,3
0.464,0.001,349,355,50,2,0.001,704,3
0.462,0.001,406,398,50,2,0.001,804,3
0.46,0.001,452,452,50,2,0.001,904,3
0.46,0.001,504,500,50,2,0.001,1004,3
0.464,0.001,550,554,50,2,0.001,1104,3
0.46,0.001,597,607,50,2,0.001,1204,3
0.456,0.001,647,657,50,2,0.001,1304,3
0.456,0.001,689,715,50,2,0.001,1404,3
0.456,0.001,741,763,50,2,0.001,1504,3
0.458,0.001,789,815,50,2,0.001,1604,3
0.466,0.001,838,866,50,2,0.001,1704,3
0.466,0.001,888,916,50,2,0.001,1804,3
0.47,0.001,943,961,50,2,0.001,1904,3
0.46,0.001,995,1009,50,2,0.001,2004,3
0.458,0.001,49,55,50,2,0.001,104,4
0.458,0.001,90,114,50,2,0.001,204,4
0.458,0.001,143,161,50,2,0.001,304,4
0.458,0.001,193,211,50,2,0.001,404,4
0.458,0.001,243,261,50,2,0.001,504,4
0.458,0.001,296,308,50,2,0.001,604,4
0.458,0.001,348,356,50,2,0.001,704,4
0.456,0.001,405,399,50,2,0.001,804,4
0.456,0.001,452,452,50,2,0.001,904,4
0.456,0.001,503,501,50,2,0.001,1004,4
0.456,0.001,555,549,50,2,0.001,1104,4
0.456,0.001,603,601,50,2,0.001,1204,4
0.456,0.001,650,654,50,2,0.001,1304,4
0.46,0.001,694,710,50,2,0.001,1404,4
0.458,0.001,747,757,50,2,0.001,1504,4
0.46,0.001,793,811,50,2,0.001,1604,4
0.458,0.001,834,870,50,2,0.001,1704,4
0.458,0.001,890,914,50,2,0.001,1804,4
0.462,0.001,941,963,50,2,0.001,1904,4
0.464,0.001,981,1023,50,2,0.001,2004,4
0.512,0.001,50,54,50,2,0.001,104,5
0.512,0.001,97,107,50,2,0.001,204,5
0.512,0.001,147,157,50,2,0.001,304,5
0.512,0.001,199,205,50,2,0.001,404,5
0.512,0.001,244,260,50,2,0.001,504,5
0.512,0.001,297,307,50,2,0.001,604,5
0.512,0.001,345,359,50,2,0.001,704,5
0.512,0.001,393,411,50,2,0.001,804,5
0.512,0.001,441,463,50,2,0.001,904,5
0.512,0.001,493,511,50,2,0.001,1004,5
0.512,0.001,536,568,50,2,0.001,1104,5
0.512,0.001,587,617,50,2,0.001,1204,5
0.512,0.001,640,664,50,2,0.001,1304,5
0.512,0.001,691,713,50,2,0.001,1404,5
0.512,0.001,749,755,50,2,0.001,1504,5
0.512,0.001,804,800,50,2,0.001,1604,5
0.512,0.001,855,849,50,2,0.001,1704,5
0.512,0.001,906,898,50,2,0.001,1804,5
0.512,0.001,959,945,50,2,0.001,1904,5
0.512,0.001,1008,996,50,2,0.001,2004,5
0.516,0.001,42,62,50,2,0.001,104,6
0.512,0.001,96,108,50,2,0.001,204,6
0.514,0.001,138,166,50,2,0.001,304,6
0.512,0.001,184,220,50,2,0.001,404,6
0.512,0.001,239,265,50,2,0.001,504,6
0.51,0.001,294,310,50,2,0.001,604,6
0.512,0.001,344,360,50,2,0.001,704,6
0.514,0.001,396,408,50,2,0.001,804,6
0.512,0.001,438,466,50,2,0.001,904,6
0.508,0.001,487,517,50,2,0.001,1004,6
0.514,0.001,542,562,50,2,0.001,1104,6
0.518,0.001,578,626,50,2,0.001,1204,6
0.524,0.001,628,676,50,2,0.001,1304,6
0.524,0.001,679,725,50,2,0.001,1404,6
0.524,0.001,728,776,50,2,0.001,1504,6
0.522,0.001,777,827,50,2,0.001,1604,6
0.52,0.001,834,870,50,2,0.001,1704,6
0.526,0.001,887,917,50,2,0.001,1804,6
0.532,0.001,936,968,50,2,0.001,1904,6
0.528,0.001,982,1022,50,2,0.001,2004,6
0.506,0.001,47,57,50,2,0.001,104,7
0.512,0.001,92,112,50,2,0.001,204,7
0.516,0.001,138,166,50,2,0.001,304,7
0.518,0.001,190,214,50,2,0.001,404,7
0.516,0.001,242,262,50,2,0.001,504,7
0.518,0.001,290,314,50,2,0.001,604,7
0.518,0.001,344,360,50,2,0.001,704,7
0.518,0.001,401,403,50,2,0.001,804,7
0.518,0.001,445,459,50,2,0.001,904,7
0.52,0.001,495,509,50,2,0.001,1004,7
0.524,0.001,551,553,50,2,0.001,1104,7
0.522,0.001,604,600,50,2,0.001,1204,7
0.522,0.001,655,649,50,2,0.001,1304,7
0.532,0.001,700,704,50,2,0.001,1404,7
0.534,0.001,747,757,50,2,0.001,1504,7
0.532,0.001,806,798,50,2,0.001,1604,7
0.534,0.001,862,842,50,2,0.001,1704,7
0.538,0.001,915,889,50,2,0.001,1804,7
0.544,0.001,965,939,50,2,0.001,1904,7
0.542,0.001,1014,990,50,2,0.001,2004,7
0.544,0.001,49,55,50,2,0.001,104,8
0.544,0.001,94,110,50,2,0.001,204,8
0.544,0.001,149,155,50,2,0.001,304,8
0.544,0.001,197,207,50,2,0.001,404,8
0.544,0.001,245,259,50,2,0.001,504,8
0.544,0.001,294,310,50,2,0.001,604,8
0.544,0.001,336,368,50,2,0.001,704,8
0.544,0.001,390,414,50,2,0.001,804,8
0.544,0.001,438,466,50,2,0.001,904,8
0.544,0.001,481,523,50,2,0.001,1004,8
0.544,0.001,523,581,50,2,0.001,1104,8
0.544,0.001,579,625,50,2,0.001,1204,8
0.544,0.001,629,675,50,2,0.001,1304,8
0.544,0.001,677,727,50,2,0.001,1404,8
0.544,0.001,733,771,50,2,0.001,1504,8
0.544,0.001,783,821,50,2,0.001,1604,8
0.544,0.001,826,878,50,2,0.001,1704,8
0.544,0.001,876,928,50,2,0.001,1804,8
0.544,0.001,929,975,50,2,0.001,1904,8
0.544,0.001,980,1024,50,2,0.001,2004,8
0.508,0.001,55,49,50,2,0.001,104,9
0.508,0.001,105,99,50,2,0.001,204,9
0.508,0.001,158,146,50,2,0.001,304,9
0.508,0.001,205,199,50,2,0.001,404,9
0.508,0.001,252,252,50,2,0.001,504,9
0.51,0.001,308,296,50,2,0.001,604,9
0.51,0.001,354,350,50,2,0.001,704,9
0.508,0.001,406,398,50,2,0.001,804,9
0.508,0.001,452,452,50,2,0.001,904,9
0.512,0.001,502,502,50,2,0.001,1004,9
0.512,0.001,555,549,50,2,0.001,1104,9
0.512,0.001,601,603,50,2,0.001,1204,9
0.512,0.001,652,652,50,2,0.001,1304,9
0.512,0.001,709,695,50,2,0.001,1404,9
0.514,0.001,756,748,50,2,0.001,1504,9
0.516,0.001,803,801,50,2,0.001,1604,9
0.518,0.001,854,850,50,2,0.001,1704,9
0.528,0.001,912,892,50,2,0.001,1804,9
0.534,0.001,964,940,50,2,0.001,1904,9
0.546,0.001,1007,997,50,2,0.001,2004,9
0.504,0.001,59,45,50,2,0.001,104,10
0.504,0.001,109,95,50,2,0.001,204,10
0.504,0.001,161,143,50,2,0.001,304,10
0.508,0.001,214,190,50,2,0.001,404,10
0.506,0.001,269,235,50,2,0.001,504,10
0.504,0.001,314,290,50,2,0.001,604,10
0.504,0.001,363,341,50,2,0.001,704,10
0.51,0.001,409,395,50,2,0.001,804,10
0.512,0.001,462,442,50,2,0.001,904,10
0.512,0.001,508,496,50,2,0.001,1004,10
0.518,0.001,560,544,50,2,0.001,1104,10
0.518,0.001,613,591,50,2,0.001,1204,10
0.518,0.001,662,642,50,2,0.001,1304,10
0.52,0.001,716,688,50,2,0.001,1404,10
0.524,0.001,766,738,50,2,0.001,1504,10
0.526,0.001,815,789,50,2,0.001,1604,10
0.538,0.001,856,848,50,2,0.001,1704,10
0.55,0.001,906,898,50,2,0.001,1804,10
0.558,0.001,950,954,50,2,0.001,1904,10
0.564,0.001,1001,1003,50,2,0.001,2004,10
0.488,0.001,46,58,50,2,0.001,104,11
0.488,0.001,105,99,50,2,0.001,204,11
0.488,0.001,157,147,50,2,0.001,304,11
0.488,0.001,213,191,50,2,0.001,404,11
0.488,0.001,267,237,50,2,0.001,504,11
0.488,0.001,318,286,50,2,0.001,604,11
0.488,0.001,372,332,50,2,0.001,704,11
0.488,0.001,423,381,50,2,0.001,804,11
0.488,0.001,474,430,50,2,0.001,904,11
0.488,0.001,520,484,50,2,0.001,1004,11
0.488,0.001,561,543,50,2,0.001,1104,11
0.488,0.001,608,596,50,2,0.001,1204,11
0.488,0.001,656,648,50,2,0.001,1304,11
0.488,0.001,705,699,50,2,0.001,1404,11
0.488,0.001,763,741,50,2,0.001,1504,11
0.488,0.001,811,793,50,2,0.001,1604,11
0.488,0.001,856,848,50,2,0.001,1704,11
0.488,0.001,908,896,50,2,0.001,1804,11
0.488,0.001,958,946,50,2,0.001,1904,11
0.488,0.001,1008,996,50,2,0.001,2004,11
0.534,0.001,45,59,50,2,0.001,104,12
0.534,0.001,97,107,50,2,0.001,204,12
0.534,0.001,135,169,50,2,0.001,304,12
0.534,0.001,185,219,50,2,0.001,404,12
0.534,0.001,238,266,50,2,0.001,504,12
0.534,0.001,291,313,50,2,0.001,604,12
0.534,0.001,337,367,50,2,0.001,704,12
0.534,0.001,381,423,50,2,0.001,804,12
0.534,0.001,430,474,50,2,0.001,904,12
0.534,0.001,480,524,50,2,0.001,1004,12
0.534,0.001,531,573,50,2,0.001,1104,12
0.534,0.001,584,620,50,2,0.001,1204,12
0.534,0.001,637,667,50,2,0.001,1304,12
0.534,0.001,691,713,50,2,0.001,1404,12
0.534,0.001,739,765,50,2,0.001,1504,12
0.534,0.001,778,826,50,2,0.001,1604,12
0.534,0.001,827,877,50,2,0.001,1704,12
0.534,0.001,883,921,50,2,0.001,1804,12
0.534,0.001,942,962,50,2,0.001,1904,12
0.534,0.001,985,1019,50,2,0.001,2004,12
0.456,0.001,55,49,50,2,0.001,104,13
0.456,0.001,104,100,50,2,0.001,204,13
0.452,0.001,153,151,50,2,0.001,304,13
0.452,0.001,205,199,50,2,0.001,404,13
0.452,0.001,259,245,50,2,0.001,504,13
0.458,0.001,301,303,50,2,0.001,604,13
0.462,0.001,353,351,50,2,0.001,704,13
0.472,0.001,409,395,50,2,0.001,804,13
0.476,0.001,461,443,50,2,0.001,904,13
0.478,0.001,515,489,50,2,0.001,1004,13
0.478,0.001,565,539,50,2,0.001,1104,13
0.478,0.001,613,591,50,2,0.001,1204,13
0.476,0.001,658,646,50,2,0.001,1304,13
0.482,0.001,722,682,50,2,0.001,1404,13
0.486,0.001,773,731,50,2,0.001,1504,13
0.484,0.001,815,789,50,2,0.001,1604,13
0.492,0.001,873,831,50,2,0.001,1704,13
0.5,0.001,927,877,50,2,0.001,1804,13
0.508,0.001,971,933,50,2,0.001,1904,13
0.51,0.001,1019,985,50,2,0.001,2004,13
0.496,0.001,49,55,50,2,0.001,104,14
0.496,0.001,99,105,50,2,0.001,204,14
0.496,0.001,147,157,50,2,0.001,304,14
0.496,0.001,191,213,50,2,0.001,404,14
0.496,0.001,238,266,50,2,0.001,504,14
0.496,0.001,293,311,50,2,0.001,604,14
0.496,0.001,349,355,50,2,0.001,704,14
0.496,0.001,404,400,50,2,0.001,804,14
0.496,0.001,458,446,50,2,0.001,904,14
0.496,0.001,508,496,50,2,0.001,1004,14
0.496,0.001,561,543,50,2,0.001,1104,14
0.496,0.001,607,597,50,2,0.001,1204,14
0.496,0.001,655,649,50,2,0.001,1304,14
0.496,0.001,707,697,50,2,0.001,1404,14
0.496,0.001,753,751,50,2,0.001,1504,14
0.496,0.001,800,804,50,2,0.001,1604,14
0.496,0.001,847,857,50,2,0.001,1704,14
0.496,0.001,897,907,50,2,0.001,1804,14
0.496,0.001,954,950,50,2,0.001,1904,14
0.496,0.001,1004,1000,50,2,0.001,2004,14
0.512,0.001,44,60,50,2,0.001,104,15
0.51,0.001,91,113,50,2,0.001,204,15
0.51,0.001,142,162,50,2,0.001,304,15
0.51,0.001,195,209,50,2,0.001,404,15
0.51,0.001,244,260,50,2,0.001,504,15
0.512,0.001,284,320,50,2,0.001,604,15
0.512,0.001,340,364,50,2,0.001,704,15
0.514,0.001,395,409,50,2,0.001,804,15
0.508,0.001,448,456,50,2,0.001,904,15
0.512,0.001,499,505,50,2,0.001,1004,15
0.514,0.001,552,552,50,2,0.001,1104,15
0.52,0.001,589,615,50,2,0.001,1204,15
0.522,0.001,642,662,50,2,0.001,1304,15
0.522,0.001,695,709,50,2,0.001,1404,15
0.52,0.001,745,759,50,2,0.001,1504,15
0.522,0.001,804,800,50,2,0.001,1604,15
0.518,0.001,857,847,50,2,0.001,1704,15
0.518,0.001,913,891,50,2,0.001,1804,15
0.514,0.001,962,942,50,2,0.001,1904,15
0.52,0.001,1014,990,50,2,0.001,2004,15
0.486,0.001,51,53,50,2,0.001,104,16
0.486,0.001,105,99,50,2,0.001,204,16
0.486,0.001,162,142,50,2,0.001,304,16
0.486,0.001,198,206,50,2,0.001,404,16
0.486,0.001,245,259,50,2,0.001,504,16
0.486,0.001,293,311,50,2,0.001,604,16
0.486,0.001,341,363,50,2,0.001,704,16
0.486,0.001,387,417,50,2,0.001,804,16
0.486,0.001,434,470,50,2,0.001,904,16
0.486,0.001,492,512,50,2,0.001,1004,16
0.486,0.001,542,562,50,2,0.001,1104,16
0.486,0.001,596,608,50,2,0.001,1204,16
0.486,0.001,649,655,50,2,0.001,1304,16
0.486,0.001,701,703,50,2,0.001,1404,16
0.486,0.001,754,750,50,2,0.001,1504,16
0.486,0.001,802,802,50,2,0.001,1604,16
0.486,0.001,855,849,50,2,0.001,1704,16
0.486,0.001,908,896,50,2,0.001,1804,16
0.486,0.001,954,950,50,2,0.001,1904,16
0.49,0.001,1009,995,50,2,0.001,2004,16
0.442,0.001,63,41,50,2,0.001,104,17
0.446,0.001,114,90,50,2,0.001,204,17
0.45,0.001,160,144,50,2,0.001,304,17
0.448,0.001,214,190,50,2,0.001,404,17
0.45,0.001,267,237,50,2,0.001,504,17
0.456,0.001,315,289,50,2,0.001,604,17
0.458,0.001,365,339,50,2,0.001,704,17
0.458,0.001,411,393,50,2,0.001,804,17
0.454,0.001,461,443,50,2,0.001,904,17
0.456,0.001,513,491,50,2,0.001,1004,17
0.458,0.001,570,534,50,2,0.001,1104,17
0.46,0.001,613,591,50,2,0.001,1204,17
0.464,0.001,658,646,50,2,0.001,1304,17
0.47,0.001,711,693,50,2,0.001,1404,17
0.47,0.001,758,746,50,2,0.001,1504,17
0.478,0.001,812,792,50,2,0.001,1604,17
0.48,0.001,866,838,50,2,0.001,1704,17
0.484,0.001,921,883,50,2,0.001,1804,17
0.492,0.001,967,937,50,2,0.001,1904,17
0.508,0.001,1011,993,50,2,0.001,2004,17
0.502,0.001,52,52,50,2,0.001,104,18
0.502,0.001,97,107,50,2,0.001,204,18
0.502,0.001,158,146,50,2,0.001,304,18
0.502,0.001,220,184,50,2,0.001,404,18
0.502,0.001,264,240,50,2,0.001,504,18
0.502,0.001,314,290,50,2,0.001,604,18
0.502,0.001,364,340,50,2,0.001,704,18
0.502,0.001,407,397,50,2,0.001,804,18
0.502,0.001,460,444,50,2,0.001,904,18
0.502,0.001,508,496,50,2,0.001,1004,18
0.502,0.001,555,549,50,2,0.001,1104,18
0.502,0.001,603,601,50,2,0.001,1204,18
0.502,0.001,655,649,50,2,0.001,1304,18
0.502,0.001,705,699,50,2,0.001,1404,18
0.502,0.001,748,756,50,2,0.001,1504,18
0.502,0.001,794,810,50,2,0.001,1604,18
0.502,0.001,853,851,50,2,0.001,1704,18
0.502,0.001,902,902,50,2,0.001,1804,18
0.502,0.001,952,952,50,2,0.001,1904,18
0.504,0.001,1003,1001,50,2,0.001,2004,18
0.528,0.001,61,43,50,2,0.001,104,19
0.528,0.001,108,96,50,2,0.001,204,19
0.528,0.001,155,149,50,2,0.001,304,19
0.528,0.001,206,198,50,2,0.001,404,19
0.528,0.001,251,253,50,2,0.001,504,19
0.528,0.001,293,311,50,2,0.001,604,19
0.526,0.001,349,355,50,2,0.001,704,19
0.528,0.001,394,410,50,2,0.001,804,19
0.528,0.001,441,463,50,2,0.001,904,19
0.528,0.001,497,507,50,2,0.001,1004,19
0.522,0.001,555,549,50,2,0.001,1104,19
0.522,0.001,600,604,50,2,0.001,1204,19
0.52,0.001,649,655,50,2,0.001,1304,19
0.52,0.001,698,706,50,2,0.001,1404,19
0.522,0.001,746,758,50,2,0.001,1504,19
0.522,0.001,796,808,50,2,0.001,1604,19
0.528,0.001,841,863,50,2,0.001,1704,19
0.526,0.001,888,916,50,2,0.001,1804,19
0.528,0.001,941,963,50,2,0.001,1904,19
0.532,0.001,987,1017,50,2,0.001,2004,19
0.514,0.001,58,46,50,2,0.001,104,20
0.514,0.001,104,100,50,2,0.001,204,20
0.514,0.001,156,148,50,2,0.001,304,20
0.514,0.001,200,204,50,2,0.001,404,20
0.514,0.001,248,256,50,2,0.001,504,20
0.514,0.001,299,305,50,2,0.001,604,20
0.514,0.001,349,355,50,2,0.001,704,20
0.514,0.001,397,407,50,2,0.001,804,20
0.514,0.001,442,462,50,2,0.001,904,20
0.514,0.001,498,506,50,2,0.001,1004,20
0.514,0.001,559,545,50,2,0.001,1104,20
0.51,0.001,604,600,50,2,0.001,1204,20
0.51,0.001,656,648,50,2,0.001,1304,20
0.51,0.001,712,692,50,2,0.001,1404,20
0.512,0.001,759,745,50,2,0.001,1504,20
0.512,0.001,814,790,50,2,0.001,1604,20
0.514,0.001,862,842,50,2,0.001,1704,20
0.514,0.001,908,896,50,2,0.001,1804,20
0.518,0.001,959,945,50,2,0.001,1904,20
0.52,0.001,1011,993,50,2,0.001,2004,20
0.494,0.001,47,57,50,2,0.01,104,1
0.494,0.001,94,110,50,2,0.01,204,1
0.494,0.001,144,160,50,2,0.01,304,1
0.494,0.001,193,211,50,2,0.01,404,1
0.494,0.001,240,264,50,2,0.01,504,1
0.494,0.001,289,315,50,2,0.01,604,1
0.494,0.001,343,361,50,2,0.01,704,1
0.494,0.001,395,409,50,2,0.01,804,1
0.494,0.001,444,460,50,2,0.01,904,1
0.494,0.001,494,510,50,2,0.01,1004,1
0.494,0.001,543,561,50,2,0.01,1104,1
0.494,0.001,598,606,50,2,0.01,1204,1
0.494,0.001,654,650,50,2,0.01,1304,1
0.494,0.001,705,699,50,2,0.01,1404,1
0.494,0.001,754,750,50,2,0.01,1504,1
0.494,0.001,800,804,50,2,0.01,1604,1
0.494,0.001,857,847,50,2,0.01,1704,1
0.494,0.001,905,899,50,2,0.01,1804,1
0.926,0.001,950,954,50,2,0.01,1904,1
0.932,0.001,1005,999,50,2,0.01,2004,1
0.512,0.001,60,44,50,2,0.01,104,2
0.514,0.001,123,81,50,2,0.01,204,2
0.514,0.001,179,125,50,2,0.01,304,2
0.506,0.001,231,173,50,2,0.01,404,2
0.5,0.001,292,212,50,2,0.01,504,2
0.514,0.001,345,259,50,2,0.01,604,2
0.52,0.001,395,309,50,2,0.01,704,2
0.518,0.001,443,361,50,2,0.01,804,2
0.518,0.001,489,415,50,2,0.01,904,2
0.534,0.001,545,459,50,2,0.01,1004,2
0.542,0.001,590,514,50,2,0.01,1104,2
0.572,0.001,636,568,50,2,0.01,1204,2
0.626,0.001,684,620,50,2,0.01,1304,2
0.682,0.001,734,670,50,2,0.01,1404,2
0.712,0.001,787,717,50,2,0.01,1504,2
0.794,0.001,840,764,50,2,0.01,1604,2
0.832,0.001,882,822,50,2,0.01,1704,2
0.876,0.001,934,870,50,2,0.01,1804,2
0.88,0.001,973,931,50,2,0.01,1904,2
0.888,0.001,1008,996,50,2,0.01,2004,2
0.536,0.001,56,48,50,2,0.01,104,3
0.54,0.001,102,102,50,2,0.01,204,3
0.554,0.001,149,155,50,2,0.01,304,3
0.566,0.001,199,205,50,2,0.01,404,3
0.578,0.001,252,252,50,2,0.01,504,3
0.582,0.001,307,297,50,2,0.01,604,3
0.594,0.001,365,339,50,2,0.01,704,3
0.608,0.001,420,384,50,2,0.01,804,3
0.596,0.001,467,437,50,2,0.01,904,3
0.582,0.001,519,485,50,2,0.01,1004,3
0.614,0.001,564,540,50,2,0.01,1104,3
0.67,0.001,623,581,50,2,0.01,1204,3
0.692,0.001,672,632,50,2,0.01,1304,3
0.742,0.001,723,681,50,2,0.01,1404,3
0.766,0.001,767,737,50,2,0.01,1504,3
0.79,0.001,817,787,50,2,0.01,1604,3
0.794,0.001,867,837,50,2,0.01,1704,3
0.802,0.001,915,889,50,2,0.01,1804,3
0.804,0.001,961,943,50,2,0.01,1904,3
0.808,0.001,1013,991,50,2,0.01,2004,3
0.484,0.001,58,46,50,2,0.01,104,4
0.488,0.001,105,99,50,2,0.01,204,4
0.498,0.001,155,149,50,2,0.01,304,4
0.496,0.001,207,197,50,2,0.01,404,4
0.504,0.001,264,240,50,2,0.01,504,4
0.51,0.001,316,288,50,2,0.01,604,4
0.518,0.001,361,343,50,2,0.01,704,4
0.516,0.001,416,388,50,2,0.01,804,4
0.534,0.001,473,431,50,2,0.01,904,4
0.536,0.001,515,489,50,2,0.01,1004,4
0.514,0.001,570,534,50,2,0.01,1104,4
0.534,0.001,614,590,50,2,0.01,1204,4
0.54,0.001,664,640,50,2,0.01,1304,4
0.542,0.001,717,687,50,2,0.01,1404,4
0.55,0.001,770,734,50,2,0.01,1504,4
0.64,0.001,827,777,50,2,0.01,1604,4
0.636,0.001,876,828,50,2,0.01,1704,4
0.654,0.001,922,882,50,2,0.01,1804,4
0.692,0.001,959,945,50,2,0.01,1904,4
0.702,0.001,1004,1000,50,2,0.01,2004,4
0.48,0.001,50,54,50,2,0.01,104,5
0.474,0.001,108,96,50,2,0.01,204,5
0.472,0.001,162,142,50,2,0.01,304,5
0.486,0.001,205,199,50,2,0.01,404,5
0.498,0.001,252,252,50,2,0.01,504,5
0.514,0.001,309,295,50,2,0.01,604,5
0.526,0.001,360,344,50,2,0.01,704,5
0.566,0.001,405,399,50,2,0.01,804,5
0.586,0.001,450,454,50,2,0.01,904,5
0.632,0.001,495,509,50,2,0.01,1004,5
0.67,0.001,548,556,50,2,0.01,1104,5
0.716,0.001,597,607,50,2,0.01,1204,5
0.726,0.001,646,658,50,2,0.01,1304,5
0.766,0.001,696,708,50,2,0.01,1404,5
0.812,0.001,748,756,50,2,0.01,1504,5
0.844,0.001,806,798,50,2,0.01,1604,5
0.856,0.001,848,856,50,2,0.01,1704,5
0.878,0.001,898,906,50,2,0.01,1804,5
0.888,0.001,946,958,50,2,0.01,1904,5
0.89,0.001,997,1007,50,2,0.01,2004,5
0.516,0.001,52,52,50,2,0.01,104,6
0.524,0.001,97,107,50,2,0.01,204,6
0.532,0.001,152,152,50,2,0.01,304,6
0.532,0.001,193,211,50,2,0.01,404,6
0.542,0.001,244,260,50,2,0.01,504,6
0.542,0.001,295,309,50,2,0.01,604,6
0.534,0.001,349,355,50,2,0.01,704,6
0.526,0.001,403,401,50,2,0.01,804,6
0.536,0.001,451,453,50,2,0.01,904,6
0.548,0.001,504,500,50,2,0.01,1004,6
0.55,0.001,570,534,50,2,0.01,1104,6
0.578,0.001,604,600,50,2,0.01,1204,6
0.584,0.001,650,654,50,2,0.01,1304,6
0.586,0.001,694,710,50,2,0.01,1404,6
0.612,0.001,737,767,50,2,0.01,1504,6
0.612,0.001,790,814,50,2,0.01,1604,6
0.624,0.001,845,859,50,2,0.01,1704,6
0.64,0.001,901,903,50,2,0.01,1804,6
0.644,0.001,945,959,50,2,0.01,1904,6
0.664,0.001,989,1015,50,2,0.01,2004,6
0.554,0.001,59,45,50,2,0.01,104,7
0.554,0.001,105,99,50,2,0.01,204,7
0.554,0.001,158,146,50,2,0.01,304,7
0.554,0.001,213,191,50,2,0.01,404,7
0.554,0.001,261,243,50,2,0.01,504,7
0.574,0.001,317,287,50,2,0.01,604,7
0.584,0.001,373,331,50,2,0.01,704,7
0.596,0.001,424,380,50,2,0.01,804,7
0.592,0.001,483,421,50,2,0.01,904,7
0.568,0.001,533,471,50,2,0.01,1004,7
0.562,0.001,579,525,50,2,0.01,1104,7
0.576,0.001,628,576,50,2,0.01,1204,7
0.65,0.001,671,633,50,2,0.01,1304,7
0.698,0.001,722,682,50,2,0.01,1404,7
0.748,0.001,766,738,50,2,0.01,1504,7
0.802,0.001,827,777,50,2,0.01,1604,7
0.822,0.001,878,826,50,2,0.01,1704,7
0.844,0.001,934,870,50,2,0.01,1804,7
0.86,0.001,977,927,50,2,0.01,1904,7
0.866,0.001,1029,975,50,2,0.01,2004,7
0.486,0.001,58,46,50,2,0.01,104,8
0.492,0.001,112,92,50,2,0.01,204,8
0.496,0.001,165,139,50,2,0.01,304,8
0.506,0.001,219,185,50,2,0.01,404,8
0.516,0.001,274,230,50,2,0.01,504,8
0.534,0.001,318,286,50,2,0.01,604,8
0.548,0.001,358,346,50,2,0.01,704,8
0.56,0.001,403,401,50,2,0.01,804,8
0.578,0.001,448,456,50,2,0.01,904,8
0.586,0.001,500,504,50,2,0.01,1004,8
0.598,0.001,556,548,50,2,0.01,1104,8
0.596,0.001,608,596,50,2,0.01,1204,8
0.606,0.001,665,639,50,2,0.01,1304,8
0.624,0.001,719,685,50,2,0.01,1404,8
0.664,0.001,764,740,50,2,0.01,1504,8
0.672,0.001,807,797,50,2,0.01,1604,8
0.672,0.001,845,859,50,2,0.01,1704,8
0.676,0.001,889,915,50,2,0.01,1804,8
0.68,0.001,942,962,50,2,0.01,1904,8
0.68,0.001,991,1013,50,2,0.01,2004,8
0.498,0.001,51,53,50,2,0.01,104,9
0.508,0.001,99,105,50,2,0.01,204,9
0.498,0.001,144,160,50,2,0.01,304,9
0.5,0.001,186,218,50,2,0.01,404,9
0.524,0.001,235,269,50,2,0.01,504,9
0.534,0.001,282,322,50,2,0.01,604,9
0.534,0.001,327,377,50,2,0.01,704,9
0.542,0.001,378,426,50,2,0.01,804,9
0.564,0.001,432,472,50,2,0.01,904,9
0.59,0.001,495,509,50,2,0.01,1004,9
0.612,0.001,547,557,50,2,0.01,1104,9
0.636,0.001,601,603,50,2,0.01,1204,9
0.668,0.001,649,655,50,2,0.01,1304,9
0.684,0.001,702,702,50,2,0.01,1404,9
0.696,0.001,752,752,50,2,0.01,1504,9
0.712,0.001,802,802,50,2,0.01,1604,9
0.716,0.001,857,847,50,2,0.01,1704,9
0.728,0.001,906,898,50,2,0.01,1804,9
0.73,0.001,956,948,50,2,0.01,1904,9
0.732,0.001,999,1005,50,2,0.01,2004,9
0.502,0.001,57,47,50,2,0.01,104,10
0.496,0.001,105,99,50,2,0.01,204,10
0.496,0.001,152,152,50,2,0.01,304,10
0.508,0.001,203,201,50,2,0.01,404,10
0.514,0.001,258,246,50,2,0.01,504,10
0.512,0.001,299,305,50,2,0.01,604,10
0.51,0.001,356,348,50,2,0.01,704,10
0.53,0.001,408,396,50,2,0.01,804,10
0.53,0.001,460,444,50,2,0.01,904,10
0.546,0.001,506,498,50,2,0.01,1004,10
0.566,0.001,562,542,50,2,0.01,1104,10
0.608,0.001,616,588,50,2,0.01,1204,10
0.656,0.001,675,629,50,2,0.01,1304,10
0.724,0.001,718,686,50,2,0.01,1404,10
0.766,0.001,771,733,50,2,0.01,1504,10
0.83,0.001,818,786,50,2,0.01,1604,10
0.876,0.001,868,836,50,2,0.01,1704,10
0.902,0.001,913,891,50,2,0.01,1804,10
0.916,0.001,959,945,50,2,0.01,1904,10
0.924,0.001,1011,993,50,2,0.01,2004,10
0.494,0.001,54,50,50,2,0.01,104,11
0.494,0.001,108,96,50,2,0.01,204,11
0.494,0.001,162,142,50,2,0.01,304,11
0.494,0.001,206,198,50,2,0.01,404,11
0.494,0.001,257,247,50,2,0.01,504,11
0.494,0.001,311,293,50,2,0.01,604,11
0.494,0.001,358,346,50,2,0.01,704,11
0.494,0.001,409,395,50,2,0.01,804,11
0.494,0.001,453,451,50,2,0.01,904,11
0.494,0.001,505,499,50,2,0.01,1004,11
0.634,0.001,561,543,50,2,0.01,1104,11
0.638,0.001,614,590,50,2,0.01,1204,11
0.662,0.001,664,640,50,2,0.01,1304,11
0.714,0.001,709,695,50,2,0.01,1404,11
0.772,0.001,759,745,50,2,0.01,1504,11
0.856,0.001,816,788,50,2,0.01,1604,11
0.888,0.001,865,839,50,2,0.01,1704,11
0.914,0.001,914,890,50,2,0.01,1804,11
0.924,0.001,957,947,50,2,0.01,1904,11
0.93,0.001,1005,999,50,2,0.01,2004,11
0.486,0.001,62,42,50,2,0.01,104,12
0.486,0.001,108,96,50,2,0.01,204,12
0.486,0.001,161,143,50,2,0.01,304,12
0.486,0.001,203,201,50,2,0.01,404,12
0.486,0.001,249,255,50,2,0.01,504,12
0.486,0.001,302,302,50,2,0.01,604,12
0.486,0.001,349,355,50,2,0.01,704,12
0.486,0.001,403,401,50,2,0.01,804,12
0.486,0.001,449,455,50,2,0.01,904,12
0.486,0.001,498,506,50,2,0.01,1004,12
0.486,0.001,551,553,50,2,0.01,1104,12
0.486,0.001,600,604,50,2,0.01,1204,12
0.486,0.001,656,648,50,2,0.01,1304,12
0.7,0.001,706,698,50,2,0.01,1404,12
0.812,0.001,758,746,50,2,0.01,1504,12
0.94,0.001,802,802,50,2,0.01,1604,12
0.942,0.001,852,852,50,2,0.01,1704,12
0.948,0.001,907,897,50,2,0.01,1804,12
0.944,0.001,962,942,50,2,0.01,1904,12
0.946,0.001,1009,995,50,2,0.01,2004,12
0.514,0.001,49,55,50,2,0.01,104,13
0.514,0.001,103,101,50,2,0.01,204,13
0.514,0.001,155,149,50,2,0.01,304,13
0.516,0.001,207,197,50,2,0.01,404,13
0.516,0.001,259,245,50,2,0.01,504,13
0.532,0.001,310,294,50,2,0.01,604,13
0.532,0.001,355,349,50,2,0.01,704,13
0.546,0.001,405,399,50,2,0.01,804,13
0.568,0.001,446,458,50,2,0.01,904,13
0.56,0.001,487,517,50,2,0.01,1004,13
0.566,0.001,542,562,50,2,0.01,1104,13
0.558,0.001,601,603,50,2,0.01,1204,13
0.562,0.001,654,650,50,2,0.01,1304,13
0.57,0.001,703,701,50,2,0.01,1404,13
0.576,0.001,751,753,50,2,0.01,1504,13
0.594,0.001,796,808,50,2,0.01,1604,13
0.636,0.001,848,856,50,2,0.01,1704,13
0.66,0.001,906,898,50,2,0.01,1804,13
0.674,0.001,951,953,50,2,0.01,1904,13
0.716,0.001,1009,995,50,2,0.01,2004,13
0.524,0.001,59,45,50,2,0.01,104,14
0.524,0.001,110,94,50,2,0.01,204,14
0.524,0.001,153,151,50,2,0.01,304,14
0.524,0.001,203,201,50,2,0.01,404,14
0.524,0.001,256,248,50,2,0.01,504,14
0.524,0.001,304,300,50,2,0.01,604,14
0.524,0.001,359,345,50,2,0.01,704,14
0.524,0.001,415,389,50,2,0.01,804,14
0.524,0.001,469,435,50,2,0.01,904,14
0.524,0.001,514,490,50,2,0.01,1004,14
0.524,0.001,566,538,50,2,0.01,1104,14
0.532,0.001,605,599,50,2,0.01,1204,14
0.59,0.001,650,654,50,2,0.01,1304,14
0.644,0.001,695,709,50,2,0.01,1404,14
0.668,0.001,749,755,50,2,0.01,1504,14
0.668,0.001,794,810,50,2,0.01,1604,14
0.68,0.001,857,847,50,2,0.01,1704,14
0.702,0.001,908,896,50,2,0.01,1804,14
0.706,0.001,965,939,50,2,0.01,1904,14
0.718,0.001,1014,990,50,2,0.01,2004,14
0.524,0.001,62,42,50,2,0.01,104,15
0.524,0.001,108,96,50,2,0.01,204,15
0.53,0.001,149,155,50,2,0.01,304,15
0.546,0.001,201,203,50,2,0.01,404,15
0.558,0.001,263,241,50,2,0.01,504,15
0.576,0.001,316,288,50,2,0.01,604,15
0.584,0.001,358,346,50,2,0.01,704,15
0.602,0.001,410,394,50,2,0.01,804,15
0.618,0.001,463,441,50,2,0.01,904,15
0.624,0.001,512,492,50,2,0.01,1004,15
0.636,0.001,560,544,50,2,0.01,1104,15
0.65,0.001,615,589,50,2,0.01,1204,15
0.654,0.001,658,646,50,2,0.01,1304,15
0.666,0.001,715,689,50,2,0.01,1404,15
0.68,0.001,766,738,50,2,0.01,1504,15
0.69,0.001,812,792,50,2,0.01,1604,15
0.706,0.001,862,842,50,2,0.01,1704,15
0.72,0.001,914,890,50,2,0.01,1804,15
0.726,0.001,967,937,50,2,0.01,1904,15
0.732,0.001,1019,985,50,2,0.01,2004,15
0.544,0.001,50,54,50,2,0.01,104,16
0.558,0.001,100,104,50,2,0.01,204,16
0.556,0.001,145,159,50,2,0.01,304,16
0.564,0.001,199,205,50,2,0.01,404,16
0.568,0.001,255,249,50,2,0.01,504,16
0.572,0.001,304,300,50,2,0.01,604,16
0.582,0.001,359,345,50,2,0.01,704,16
0.574,0.001,409,395,50,2,0.01,804,16
0.574,0.001,459,445,50,2,0.01,904,16
0.584,0.001,503,501,50,2,0.01,1004,16
0.59,0.001,552,552,50,2,0.01,1104,16
0.602,0.001,603,601,50,2,0.01,1204,16
0.61,0.001,660,644,50,2,0.01,1304,16
0.622,0.001,710,694,50,2,0.01,1404,16
0.622,0.001,753,751,50,2,0.01,1504,16
0.624,0.001,806,798,50,2,0.01,1604,16
0.624,0.001,862,842,50,2,0.01,1704,16
0.62,0.001,908,896,50,2,0.01,1804,16
0.694,0.001,952,952,50,2,0.01,1904,16
0.678,0.001,1001,1003,50,2,0.01,2004,16
0.478,0.001,50,54,50,2,0.01,104,17
0.482,0.001,99,105,50,2,0.01,204,17
0.484,0.001,150,154,50,2,0.01,304,17
0.494,0.001,191,213,50,2,0.01,404,17
0.496,0.001,240,264,50,2,0.01,504,17
0.504,0.001,288,316,50,2,0.01,604,17
0.51,0.001,337,367,50,2,0.01,704,17
0.53,0.001,390,414,50,2,0.01,804,17
0.54,0.001,440,464,50,2,0.01,904,17
0.542,0.001,493,511,50,2,0.01,1004,17
0.562,0.001,544,560,50,2,0.01,1104,17
0.574,0.001,595,609,50,2,0.01,1204,17
0.58,0.001,647,657,50,2,0.01,1304,17
0.59,0.001,695,709,50,2,0.01,1404,17
0.544,0.001,751,753,50,2,0.01,1504,17
0.55,0.001,798,806,50,2,0.01,1604,17
0.596,0.001,847,857,50,2,0.01,1704,17
0.634,0.001,904,900,50,2,0.01,1804,17
0.628,0.001,954,950,50,2,0.01,1904,17
0.676,0.001,1004,1000,50,2,0.01,2004,17
0.472,0.001,55,49,50,2,0.01,104,18
0.49,0.001,106,98,50,2,0.01,204,18
0.494,0.001,150,154,50,2,0.01,304,18
0.492,0.001,199,205,50,2,0.01,404,18
0.496,0.001,251,253,50,2,0.01,504,18
0.502,0.001,293,311,50,2,0.01,604,18
0.51,0.001,347,357,50,2,0.01,704,18
0.526,0.001,401,403,50,2,0.01,804,18
0.538,0.001,447,457,50,2,0.01,904,18
0.554,0.001,499,505,50,2,0.01,1004,18
0.554,0.001,543,561,50,2,0.01,1104,18
0.56,0.001,595,609,50,2,0.01,1204,18
0.572,0.001,648,656,50,2,0.01,1304,18
0.584,0.001,691,713,50,2,0.01,1404,18
0.592,0.001,732,772,50,2,0.01,1504,18
0.608,0.001,787,817,50,2,0.01,1604,18
0.614,0.001,833,871,50,2,0.01,1704,18
0.63,0.001,881,923,50,2,0.01,1804,18
0.632,0.001,931,973,50,2,0.01,1904,18
0.64,0.001,983,1021,50,2,0.01,2004,18
0.496,0.001,49,55,50,2,0.01,104,19
0.502,0.001,90,114,50,2,0.01,204,19
0.508,0.001,151,153,50,2,0.01,304,19
0.52,0.001,198,206,50,2,0.01,404,19
0.524,0.001,245,259,50,2,0.01,504,19
0.53,0.001,300,304,50,2,0.01,604,19
0.538,0.001,349,355,50,2,0.01,704,19
0.544,0.001,396,408,50,2,0.01,804,19
0.55,0.001,449,455,50,2,0.01,904,19
0.55,0.001,502,502,50,2,0.01,1004,19
0.556,0.001,550,554,50,2,0.01,1104,19
0.582,0.001,600,604,50,2,0.01,1204,19
0.592,0.001,655,649,50,2,0.01,1304,19
0.592,0.001,702,702,50,2,0.01,1404,19
0.588,0.001,752,752,50,2,0.01,1504,19
0.598,0.001,797,807,50,2,0.01,1604,19
0.622,0.001,844,860,50,2,0.01,1704,19
0.616,0.001,896,908,50,2,0.01,1804,19
0.612,0.001,950,954,50,2,0.01,1904,19
0.63,0.001,1005,999,50,2,0.01,2004,19
0.486,0.001,51,53,50,2,0.01,104,20
0.494,0.001,108,96,50,2,0.01,204,20
0.51,0.001,154,150,50,2,0.01,304,20
0.508,0.001,208,196,50,2,0.01,404,20
0.49,0.001,255,249,50,2,0.01,504,20
0.502,0.001,294,310,50,2,0.01,604,20
0.494,0.001,340,364,50,2,0.01,704,20
0.504,0.001,393,411,50,2,0.01,804,20
0.514,0.001,438,466,50,2,0.01,904,20
0.524,0.001,492,512,50,2,0.01,1004,20
0.53,0.001,543,561,50,2,0.01,1104,20
0.538,0.001,591,613,50,2,0.01,1204,20
0.558,0.001,640,664,50,2,0.01,1304,20
0.57,0.001,693,711,50,2,0.01,1404,20
0.59,0.001,745,759,50,2,0.01,1504,20
0.598,0.001,790,814,50,2,0.01,1604,20
0.602,0.001,840,864,50,2,0.01,1704,20
0.616,0.001,889,915,50,2,0.01,1804,20
0.634,0.001,940,964,50,2,0.01,1904,20
0.648,0.001,989,1015,50,2,0.01,2004,20
0.502,1e-05,42,62,50,10,0.0001,104,1
0.502,1e-05,80,124,50,10,0.0001,204,1
0.5,1e-05,131,173,50,10,0.0001,304,1
0.5,1e-05,186,218,50,10,0.0001,404,1
0.5,1e-05,242,262,50,10,0.0001,504,1
0.5,1e-05,296,308,50,10,0.0001,604,1
0.5,1e-05,348,356,50,10,0.0001,704,1
0.5,1e-05,398,406,50,10,0.0001,804,1
0.502,1e-05,455,449,50,10,0.0001,904,1
0.502,1e-05,500,504,50,10,0.0001,1004,1
0.502,1e-05,547,557,50,10,0.0001,1104,1
0.504,1e-05,607,597,50,10,0.0001,1204,1
0.504,1e-05,660,644,50,10,0.0001,1304,1
0.502,1e-05,711,693,50,10,0.0001,1404,1
0.502,1e-05,757,747,50,10,0.0001,1504,1
0.504,1e-05,808,796,50,10,0.0001,1604,1
0.512,1e-05,863,841,50,10,0.0001,1704,1
0.512,1e-05,917,887,50,10,0.0001,1804,1
0.512,1e-05,963,941,50,10,0.0001,1904,1
0.512,1e-05,1017,987,50,10,0.0001,2004,1
0.482,1e-05,50,54,50,10,0.0001,104,2
0.482,1e-05,96,108,50,10,0.0001,204,2
0.482,1e-05,147,157,50,10,0.0001,304,2
0.482,1e-05,197,207,50,10,0.0001,404,2
0.482,1e-05,239,265,50,10,0.0001,504,2
0.482,1e-05,289,315,50,10,0.0001,604,2
0.482,1e-05,333,371,50,10,0.0001,704,2
0.482,1e-05,384,420,50,10,0.0001,804,2
0.482,1e-05,433,471,50,10,0.0001,904,2
0.482,1e-05,474,530,50,10,0.0001,1004,2
0.482,1e-05,531,573,50,10,0.0001,1104,2
0.482,1e-05,585,619,50,10,0.0001,1204,2
0.482,1e-05,640,664,50,10,0.0001,1304,2
0.482,1e-05,686,718,50,10,0.0001,1404,2
0.482,1e-05,733,771,50,10,0.0001,1504,2
0.482,1e-05,786,818,50,10,0.0001,1604,2
0.482,1e-05,840,864,50,10,0.0001,1704,2
0.482,1e-05,889,915,50,10,0.0001,1804,2
0.482,1e-05,941,963,50,10,0.0001,1904,2
0.482,1e-05,995,1009,50,10,0.0001,2004,2
0.48,1e-05,53,51,50,10,0.0001,104,3
0.48,1e-05,101,103,50,10,0.0001,204,3
0.48,1e-05,149,155,50,10,0.0001,304,3
0.48,1e-05,205,199,50,10,0.0001,404,3
0.48,1e-05,266,238,50,10,0.0001,504,3
0.482,1e-05,316,288,50,10,0.0001,604,3
0.482,1e-05,362,342,50,10,0.0001,704,3
0.482,1e-05,411,393,50,10,0.0001,804,3
0.482,1e-05,454,450,50,10,0.0001,904,3
0.484,1e-05,502,502,50,10,0.0001,1004,3
0.486,1e-05,555,549,50,10,0.0001,1104,3
0.486,1e-05,598,606,50,10,0.0001,1204,3
0.486,1e-05,639,665,50,10,0.0001,1304,3
0.488,1e-05,691,713,50,10,0.0001,1404,3
0.488,1e-05,739,765,50,10,0.0001,1504,3
0.486,1e-05,791,813,50,10,0.0001,1604,3
0.484,1e-05,848,856,50,10,0.0001,1704,3
0.484,1e-05,900,904,50,10,0.0001,1804,3
0.484,1e-05,955,949,50,10,0.0001,1904,3
0.484,1e-05,1009,995,50,10,0.0001,2004,3
0.512,1e-05,58,46,50,10,0.0001,104,4
0.512,1e-05,115,89,50,10,0.0001,204,4
0.512,1e-05,159,145,50,10,0.0001,304,4
0.512,1e-05,210,194,50,10,0.0001,404,4
0.512,1e-05,267,237,50,10,0.0001,504,4
0.51,1e-05,319,285,50,10,0.0001,604,4
0.51,1e-05,364,340,50,10,0.0001,704,4
0.51,1e-05,414,390,50,10,0.0001,804,4
0.51,1e-05,474,430,50,10,0.0001,904,4
0.51,1e-05,524,480,50,10,0.0001,1004,4
0.512,1e-05,571,533,50,10,0.0001,1104,4
0.51,1e-05,631,573,50,10,0.0001,1204,4
0.51,1e-05,673,631,50,10,0.0001,1304,4
0.512,1e-05,714,690,50,10,0.0001,1404,4
0.512,1e-05,759,745,50,10,0.0001,1504,4
0.514,1e-05,815,789,50,10,0.0001,1604,4
0.514,1e-05,864,840,50,10,0.0001,1704,4
0.514,1e-05,913,891,50,10,0.0001,1804,4
0.514,1e-05,957,947,50,10,0.0001,1904,4
0.514,1e-05,1004,1000,50,10,0.0001,2004,4
0.51,1e-05,46,58,50,10,0.0001,104,5
0.51,1e-05,107,97,50,10,0.0001,204,5
0.51,1e-05,154,150,50,10,0.0001,304,5
0.51,1e-05,194,210,50,10,0.0001,404,5
0.51,1e-05,245,259,50,10,0.0001,504,5
0.51,1e-05,299,305,50,10,0.0001,604,5
0.51,1e-05,346,358,50,10,0.0001,704,5
0.51,1e-05,410,394,50,10,0.0001,804,5
0.51,1e-05,463,441,50,10,0.0001,904,5
0.51,1e-05,511,493,50,10,0.0001,1004,5
0.51,1e-05,559,545,50,10,0.0001,1104,5
0.51,1e-05,616,588,50,10,0.0001,1204,5
0.51,1e-05,672,632,50,10,0.0001,1304,5
0.514,1e-05,716,688,50,10,0.0001,1404,5
0.514,1e-05,759,745,50,10,0.0001,1504,5
0.514,1e-05,815,789,50,10,0.0001,1604,5
0.514,1e-05,860,844,50,10,0.0001,1704,5
0.518,1e-05,910,894,50,10,0.0001,1804,5
0.52,1e-05,964,940,50,10,0.0001,1904,5
0.52,1e-05,1010,994,50,10,0.0001,2004,5
0.478,1e-05,55,49,50,10,0.0001,104,6
0.478,1e-05,115,89,50,10,0.0001,204,6
0.478,1e-05,165,139,50,10,0.0001,304,6
0.478,1e-05,204,200,50,10,0.0001,404,6
0.478,1e-05,254,250,50,10,0.0001,504,6
0.478,1e-05,297,307,50,10,0.0001,604,6
0.478,1e-05,350,354,50,10,0.0001,704,6
0.478,1e-05,392,412,50,10,0.0001,804,6
0.48,1e-05,443,461,50,10,0.0001,904,6
0.48,1e-05,491,513,50,10,0.0001,1004,6
0.48,1e-05,541,563,50,10,0.0001,1104,6
0.48,1e-05,595,609,50,10,0.0001,1204,6
0.48,1e-05,643,661,50,10,0.0001,1304,6
0.48,1e-05,689,715,50,10,0.0001,1404,6
0.48,1e-05,745,759,50,10,0.0001,1504,6
0.48,1e-05,796,808,50,10,0.0001,1604,6
0.48,1e-05,846,858,50,10,0.0001,1704,6
0.48,1e-05,898,906,50,10,0.0001,1804,6
0.48,1e-05,955,949,50,10,0.0001,1904,6
0.48,1e-05,1019,985,50,10,0.0001,2004,6
0.538,1e-05,59,45,50,10,0.0001,104,7
0.538,1e-05,110,94,50,10,0.0001,204,7
0.538,1e-05,162,142,50,10,0.0001,304,7
0.54,1e-05,215,189,50,10,0.0001,404,7
0.542,1e-05,268,236,50,10,0.0001,504,7
0.54,1e-05,321,283,50,10,0.0001,604,7
0.54,1e-05,360,344,50,10,0.0001,704,7
0.542,1e-05,411,393,50,10,0.0001,804,7
0.544,1e-05,461,443,50,10,0.0001,904,7
0.544,1e-05,512,492,50,10,0.0001,1004,7
0.544,1e-05,552,552,50,10,0.0001,1104,7
0.544,1e-05,600,604,50,10,0.0001,1204,7
0.546,1e-05,652,652,50,10,0.0001,1304,7
0.548,1e-05,696,708,50,10,0.0001,1404,7
0.552,1e-05,744,760,50,10,0.0001,1504,7
0.552,1e-05,788,816,50,10,0.0001,1604,7
0.552,1e-05,841,863,50,10,0.0001,1704,7
0.552,1e-05,884,920,50,10,0.0001,1804,7
0.554,1e-05,933,971,50,10,0.0001,1904,7
0.554,1e-05,988,1016,50,10,0.0001,2004,7
0.464,1e-05,56,48,50,10,0.0001,104,8
0.464,1e-05,106,98,50,10,0.0001,204,8
0.464,1e-05,148,156,50,10,0.0001,304,8
0.464,1e-05,201,203,50,10,0.0001,404,8
0.464,1e-05,260,244,50,10,0.0001,504,8
0.464,1e-05,307,297,50,10,0.0001,604,8
0.464,1e-05,361,343,50,10,0.0001,704,8
0.464,1e-05,414,390,50,10,0.0001,804,8
0.464,1e-05,458,446,50,10,0.0001,904,8
0.464,1e-05,508,496,50,10,0.0001,1004,8
0.462,1e-05,555,549,50,10,0.0001,1104,8
0.464,1e-05,608,596,50,10,0.0001,1204,8
0.466,1e-05,653,651,50,10,0.0001,1304,8
0.466,1e-05,701,703,50,10,0.0001,1404,8
0.466,1e-05,748,756,50,10,0.0001,1504,8
0.466,1e-05,796,808,50,10,0.0001,1604,8
0.468,1e-05,842,862,50,10,0.0001,1704,8
0.468,1e-05,887,917,50,10,0.0001,1804,8
0.47,1e-05,936,968,50,10,0.0001,1904,8
0.472,1e-05,990,1014,50,10,0.0001,2004,8
0.548,1e-05,49,55,50,10,0.0001,104,9
0.548,1e-05,111,93,50,10,0.0001,204,9
0.548,1e-05,159,145,50,10,0.0001,304,9
0.542,1e-05,197,207,50,10,0.0001,404,9
0.542,1e-05,257,247,50,10,0.0001,504,9
0.54,1e-05,309,295,50,10,0.0001,604,9
0.54,1e-05,356,348,50,10,0.0001,704,9
0.538,1e-05,404,400,50,10,0.0001,804,9
0.538,1e-05,455,449,50,10,0.0001,904,9
0.536,1e-05,503,501,50,10,0.0001,1004,9
0.536,1e-05,548,556,50,10,0.0001,1104,9
0.536,1e-05,599,605,50,10,0.0001,1204,9
0.536,1e-05,646,658,50,10,0.0001,1304,9
0.536,1e-05,695,709,50,10,0.0001,1404,9
0.536,1e-05,745,759,50,10,0.0001,1504,9
0.534,1e-05,797,807,50,10,0.0001,1604,9
0.534,1e-05,843,861,50,10,0.0001,1704,9
0.538,1e-05,897,907,50,10,0.0001,1804,9
0.54,1e-05,942,962,50,10,0.0001,1904,9
0.54,1e-05,988,1016,50,10,0.0001,2004,9
0.494,1e-05,50,54,50,10,0.0001,104,10
0.496,1e-05,93,111,50,10,0.0001,204,10
0.496,1e-05,146,158,50,10,0.0001,304,10
0.496,1e-05,197,207,50,10,0.0001,404,10
0.498,1e-05,246,258,50,10,0.0001,504,10
0.498,1e-05,298,306,50,10,0.0001,604,10
0.494,1e-05,348,356,50,10,0.0001,704,10
0.494,1e-05,403,401,50,10,0.0001,804,10
0.496,1e-05,446,458,50,10,0.0001,904,10
0.498,1e-05,492,512,50,10,0.0001,1004,10
0.498,1e-05,536,568,50,10,0.0001,1104,10
0.496,1e-05,590,614,50,10,0.0001,1204,10
0.498,1e-05,652,652,50,10,0.0001,1304,10
0.504,1e-05,700,704,50,10,0.0001,1404,10
0.506,1e-05,743,761,50,10,0.0001,1504,10
0.506,1e-05,798,806,50,10,0.0001,1604,10
0.508,1e-05,862,842,50,10,0.0001,1704,10
0.504,1e-05,910,894,50,10,0.0001,1804,10
0.508,1e-05,959,945,50,10,0.0001,1904,10
0.506,1e-05,996,1008,50,10,0.0001,2004,10
0.504,1e-05,49,55,50,10,0.0001,104,11
0.504,1e-05,103,101,50,10,0.0001,204,11
0.506,1e-05,146,158,50,10,0.0001,304,11
0.506,1e-05,196,208,50,10,0.0001,404,11
0.508,1e-05,249,255,50,10,0.0001,504,11
0.508,1e-05,300,304,50,10,0.0001,604,11
0.512,1e-05,351,353,50,10,0.0001,704,11
0.514,1e-05,396,408,50,10,0.0001,804,11
0.516,1e-05,441,463,50,10,0.0001,904,11
0.514,1e-05,491,513,50,10,0.0001,1004,11
0.514,1e-05,547,557,50,10,0.0001,1104,11
0.514,1e-05,597,607,50,10,0.0001,1204,11
0.518,1e-05,650,654,50,10,0.0001,1304,11
0.52,1e-05,697,707,50,10,0.0001,1404,11
0.516,1e-05,744,760,50,10,0.0001,1504,11
0.518,1e-05,796,808,50,10,0.0001,1604,11
0.518,1e-05,847,857,50,10,0.0001,1704,11
0.522,1e-05,901,903,50,10,0.0001,1804,11
0.524,1e-05,953,951,50,10,0.0001,1904,11
0.526,1e-05,1001,1003,50,10,0.0001,2004,11
0.502,1e-05,52,52,50,10,0.0001,104,12
0.502,1e-05,102,102,50,10,0.0001,204,12
0.504,1e-05,156,148,50,10,0.0001,304,12
0.506,1e-05,211,193,50,10,0.0001,404,12
0.506,1e-05,266,238,50,10,0.0001,504,12
0.506,1e-05,315,289,50,10,0.0001,604,12
0.504,1e-05,365,339,50,10,0.0001,704,12
0.504,1e-05,419,385,50,10,0.0001,804,12
0.504,1e-05,463,441,50,10,0.0001,904,12
0.504,1e-05,512,492,50,10,0.0001,1004,12
0.502,1e-05,562,542,50,10,0.0001,1104,12
0.502,1e-05,609,595,50,10,0.0001,1204,12
0.498,1e-05,665,639,50,10,0.0001,1304,12
0.498,1e-05,721,683,50,10,0.0001,1404,12
0.5,1e-05,772,732,50,10,0.0001,1504,12
0.502,1e-05,818,786,50,10,0.0001,1604,12
0.506,1e-05,863,841,50,10,0.0001,1704,12
0.508,1e-05,905,899,50,10,0.0001,1804,12
0.508,1e-05,958,946,50,10,0.0001,1904,12
0.514,1e-05,1005,999,50,10,0.0001,2004,12
0.518,1e-05,53,51,50,10,0.0001,104,13
0.518,1e-05,100,104,50,10,0.0001,204,13
0.522,1e-05,147,157,50,10,0.0001,304,13
0.522,1e-05,196,208,50,10,0.0001,404,13
0.522,1e-05,241,263,50,10,0.0001,504,13
0.522,1e-05,298,306,50,10,0.0001,604,13
0.522,1e-05,355,349,50,10,0.0001,704,13
0.524,1e-05,409,395,50,10,0.0001,804,13
0.524,1e-05,454,450,50,10,0.0001,904,13
0.522,1e-05,501,503,50,10,0.0001,1004,13
0.524,1e-05,546,558,50,10,0.0001,1104,13
0.52,1e-05,595,609,50,10,0.0001,1204,13
0.526,1e-05,638,666,50,10,0.0001,1304,13
0.528,1e-05,692,712,50,10,0.0001,1404,13
0.528,1e-05,745,759,50,10,0.0001,1504,13
0.524,1e-05,803,801,50,10,0.0001,1604,13
0.524,1e-05,855,849,50,10,0.0001,1704,13
0.524,1e-05,900,904,50,10,0.0001,1804,13
0.526,1e-05,956,948,50,10,0.0001,1904,13
0.526,1e-05,1004,1000,50,10,0.0001,2004,13
0.498,1e-05,58,46,50,10,0.0001,104,14
0.498,1e-05,102,102,50,10,0.0001,204,14
0.498,1e-05,160,144,50,10,0.0001,304,14
0.498,1e-05,208,196,50,10,0.0001,404,14
0.498,1e-05,248,256,50,10,0.0001,504,14
0.498,1e-05,302,302,50,10,0.0001,604,14
0.498,1e-05,339,365,50,10,0.0001,704,14
0.498,1e-05,396,408,50,10,0.0001,804,14
0.498,1e-05,447,457,50,10,0.0001,904,14
0.498,1e-05,491,513,50,10,0.0001,1004,14
0.498,1e-05,543,561,50,10,0.0001,1104,14
0.498,1e-05,598,606,50,10,0.0001,1204,14
0.498,1e-05,643,661,50,10,0.0001,1304,14
0.498,1e-05,691,713,50,10,0.0001,1404,14
0.498,1e-05,743,761,50,10,0.0001,1504,14
0.498,1e-05,792,812,50,10,0.0001,1604,14
0.498,1e-05,844,860,50,10,0.0001,1704,14
0.498,1e-05,900,904,50,10,0.0001,1804,14
0.498,1e-05,953,951,50,10,0.0001,1904,14
0.498,1e-05,1003,1001,50,10,0.0001,2004,14
0.464,1e-05,52,52,50,10,0.0001,104,15
0.468,1e-05,104,100,50,10,0.0001,204,15
0.466,1e-05,163,141,50,10,0.0001,304,15
0.466,1e-05,214,190,50,10,0.0001,404,15
0.468,1e-05,261,243,50,10,0.0001,504,15
0.468,1e-05,306,298,50,10,0.0001,604,15
0.468,1e-05,356,348,50,10,0.0001,704,15
0.47,1e-05,409,395,50,10,0.0001,804,15
0.47,1e-05,459,445,50,10,0.0001,904,15
0.47,1e-05,516,488,50,10,0.0001,1004,15
0.472,1e-05,563,541,50,10,0.0001,1104,15
0.476,1e-05,610,594,50,10,0.0001,1204,15
0.474,1e-05,663,641,50,10,0.0001,1304,15
0.476,1e-05,716,688,50,10,0.0001,1404,15
0.478,1e-05,768,736,50,10,0.0001,1504,15
0.478,1e-05,810,794,50,10,0.0001,1604,15
0.478,1e-05,860,844,50,10,0.0001,1704,15
0.478,1e-05,903,901,50,10,0.0001,1804,15
0.478,1e-05,950,954,50,10,0.0001,1904,15
0.478,1e-05,999,1005,50,10,0.0001,2004,15
0.518,1e-05,52,52,50,10,0.0001,104,16
0.518,1e-05,94,110,50,10,0.0001,204,16
0.518,1e-05,144,160,50,10,0.0001,304,16
0.52,1e-05,195,209,50,10,0.0001,404,16
0.522,1e-05,249,255,50,10,0.0001,504,16
0.522,1e-05,298,306,50,10,0.0001,604,16
0.522,1e-05,346,358,50,10,0.0001,704,16
0.52,1e-05,395,409,50,10,0.0001,804,16
0.52,1e-05,449,455,50,10,0.0001,904,16
0.518,1e-05,499,505,50,10,0.0001,1004,16
0.518,1e-05,544,560,50,10,0.0001,1104,16
0.518,1e-05,596,608,50,10,0.0001,1204,16
0.516,1e-05,656,648,50,10,0.0001,1304,16
0.516,1e-05,711,693,50,10,0.0001,1404,16
0.516,1e-05,764,740,50,10,0.0001,1504,16
0.516,1e-05,804,800,50,10,0.0001,1604,16
0.516,1e-05,858,846,50,10,0.0001,1704,16
0.514,1e-05,900,904,50,10,0.0001,1804,16
0.518,1e-05,946,958,50,10,0.0001,1904,16
0.518,1e-05,999,1005,50,10,0.0001,2004,16
0.46,1e-05,46,58,50,10,0.0001,104,17
0.46,1e-05,87,117,50,10,0.0001,204,17
0.462,1e-05,146,158,50,10,0.0001,304,17
0.462,1e-05,194,210,50,10,0.0001,404,17
0.462,1e-05,246,258,50,10,0.0001,504,17
0.462,1e-05,286,318,50,10,0.0001,604,17
0.462,1e-05,340,364,50,10,0.0001,704,17
0.46,1e-05,391,413,50,10,0.0001,804,17
0.46,1e-05,446,458,50,10,0.0001,904,17
0.46,1e-05,490,514,50,10,0.0001,1004,17
0.458,1e-05,539,565,50,10,0.0001,1104,17
0.462,1e-05,603,601,50,10,0.0001,1204,17
0.464,1e-05,657,647,50,10,0.0001,1304,17
0.462,1e-05,709,695,50,10,0.0001,1404,17
0.464,1e-05,753,751,50,10,0.0001,1504,17
0.466,1e-05,795,809,50,10,0.0001,1604,17
0.472,1e-05,844,860,50,10,0.0001,1704,17
0.472,1e-05,898,906,50,10,0.0001,1804,17
0.47,1e-05,939,965,50,10,0.0001,1904,17
0.476,1e-05,997,1007,50,10,0.0001,2004,17
0.51,1e-05,47,57,50,10,0.0001,104,18
0.51,1e-05,111,93,50,10,0.0001,204,18
0.51,1e-05,167,137,50,10,0.0001,304,18
0.51,1e-05,223,181,50,10,0.0001,404,18
0.51,1e-05,273,231,50,10,0.0001,504,18
0.51,1e-05,322,282,50,10,0.0001,604,18
0.51,1e-05,375,329,50,10,0.0001,704,18
0.51,1e-05,425,379,50,10,0.0001,804,18
0.51,1e-05,471,433,50,10,0.0001,904,18
0.51,1e-05,522,482,50,10,0.0001,1004,18
0.51,1e-05,576,528,50,10,0.0001,1104,18
0.51,1e-05,626,578,50,10,0.0001,1204,18
0.51,1e-05,674,630,50,10,0.0001,1304,18
0.512,1e-05,716,688,50,10,0.0001,1404,18
0.512,1e-05,763,741,50,10,0.0001,1504,18
0.512,1e-05,814,790,50,10,0.0001,1604,18
0.512,1e-05,861,843,50,10,0.0001,1704,18
0.512,1e-05,905,899,50,10,0.0001,1804,18
0.512,1e-05,950,954,50,10,0.0001,1904,18
0.512,1e-05,998,1006,50,10,0.0001,2004,18
0.514,1e-05,54,50,50,10,0.0001,104,19
0.514,1e-05,103,101,50,10,0.0001,204,19
0.514,1e-05,152,152,50,10,0.0001,304,19
0.516,1e-05,196,208,50,10,0.0001,404,19
0.518,1e-05,245,259,50,10,0.0001,504,19
0.518,1e-05,296,308,50,10,0.0001,604,19
0.52,1e-05,345,359,50,10,0.0001,704,19
0.518,1e-05,400,404,50,10,0.0001,804,19
0.518,1e-05,456,448,50,10,0.0001,904,19
0.518,1e-05,512,492,50,10,0.0001,1004,19
0.518,1e-05,562,542,50,10,0.0001,1104,19
0.518,1e-05,612,592,50,10,0.0001,1204,19
0.518,1e-05,657,647,50,10,0.0001,1304,19
0.52,1e-05,701,703,50,10,0.0001,1404,19
0.52,1e-05,753,751,50,10,0.0001,1504,19
0.52,1e-05,807,797,50,10,0.0001,1604,19
0.52,1e-05,851,853,50,10,0.0001,1704,19
0.522,1e-05,898,906,50,10,0.0001,1804,19
0.522,1e-05,942,962,50,10,0.0001,1904,19
0.52,1e-05,1000,1004,50,10,0.0001,2004,19
0.464,1e-05,53,51,50,10,0.0001,104,20
0.464,1e-05,99,105,50,10,0.0001,204,20
0.464,1e-05,143,161,50,10,0.0001,304,20
0.464,1e-05,187,217,50,10,0.0001,404,20
0.464,1e-05,238,266,50,10,0.0001,504,20
0.464,1e-05,280,324,50,10,0.0001,604,20
0.46,1e-05,329,375,50,10,0.0001,704,20
0.462,1e-05,380,424,50,10,0.0001,804,20
0.462,1e-05,430,474,50,10,0.0001,904,20
0.464,1e-05,484,520,50,10,0.0001,1004,20
0.462,1e-05,539,565,50,10,0.0001,1104,20
0.462,1e-05,584,620,50,10,0.0001,1204,20
0.462,1e-05,631,673,50,10,0.0001,1304,20
0.46,1e-05,682,722,50,10,0.0001,1404,20
0.462,1e-05,737,767,50,10,0.0001,1504,20
0.464,1e-05,791,813,50,10,0.0001,1604,20
0.464,1e-05,851,853,50,10,0.0001,1704,20
0.464,1e-05,905,899,50,10,0.0001,1804,20
0.462,1e-05,955,949,50,10,0.0001,1904,20
0.46,1e-05,1019,985,50,10,0.0001,2004,20
0.498,1e-05,39,65,50,10,0.001,104,1
0.496,1e-05,85,119,50,10,0.001,204,1
0.494,1e-05,137,167,50,10,0.001,304,1
0.504,1e-05,187,217,50,10,0.001,404,1
0.508,1e-05,236,268,50,10,0.001,504,1
0.51,1e-05,290,314,50,10,0.001,604,1
0.512,1e-05,339,365,50,10,0.001,704,1
0.524,1e-05,383,421,50,10,0.001,804,1
0.53,1e-05,429,475,50,10,0.001,904,1
0.532,1e-05,475,529,50,10,0.001,1004,1
0.534,1e-05,520,584,50,10,0.001,1104,1
0.538,1e-05,577,627,50,10,0.001,1204,1
0.544,1e-05,619,685,50,10,0.001,1304,1
0.548,1e-05,671,733,50,10,0.001,1404,1
0.554,1e-05,727,777,50,10,0.001,1504,1
0.554,1e-05,777,827,50,10,0.001,1604,1
0.564,1e-05,828,876,50,10,0.001,1704,1
0.568,1e-05,880,924,50,10,0.001,1804,1
0.584,1e-05,937,967,50,10,0.001,1904,1
0.6,1e-05,990,1014,50,10,0.001,2004,1
0.5,1e-05,48,56,50,10,0.001,104,2
0.5,1e-05,96,108,50,10,0.001,204,2
0.502,1e-05,156,148,50,10,0.001,304,2
0.502,1e-05,206,198,50,10,0.001,404,2
0.506,1e-05,259,245,50,10,0.001,504,2
0.506,1e-05,316,288,50,10,0.001,604,2
0.506,1e-05,374,330,50,10,0.001,704,2
0.508,1e-05,419,385,50,10,0.001,804,2
0.506,1e-05,460,444,50,10,0.001,904,2
0.506,1e-05,518,486,50,10,0.001,1004,2
0.508,1e-05,569,535,50,10,0.001,1104,2
0.512,1e-05,613,591,50,10,0.001,1204,2
0.508,1e-05,663,641,50,10,0.001,1304,2
0.512,1e-05,708,696,50,10,0.001,1404,2
0.506,1e-05,755,749,50,10,0.001,1504,2
0.508,1e-05,803,801,50,10,0.001,1604,2
0.52,1e-05,844,860,50,10,0.001,1704,2
0.518,1e-05,897,907,50,10,0.001,1804,2
0.52,1e-05,951,953,50,10,0.001,1904,2
0.532,1e-05,1001,1003,50,10,0.001,2004,2
0.492,1e-05,46,58,50,10,0.001,104,3
0.492,1e-05,98,106,50,10,0.001,204,3
0.492,1e-05,150,154,50,10,0.001,304,3
0.494,1e-05,199,205,50,10,0.001,404,3
0.498,1e-05,248,256,50,10,0.001,504,3
0.496,1e-05,296,308,50,10,0.001,604,3
0.496,1e-05,338,366,50,10,0.001,704,3
0.496,1e-05,384,420,50,10,0.001,804,3
0.498,1e-05,430,474,50,10,0.001,904,3
0.482,1e-05,479,525,50,10,0.001,1004,3
0.488,1e-05,526,578,50,10,0.001,1104,3
0.496,1e-05,581,623,50,10,0.001,1204,3
0.496,1e-05,635,669,50,10,0.001,1304,3
0.504,1e-05,693,711,50,10,0.001,1404,3
0.508,1e-05,752,752,50,10,0.001,1504,3
0.524,1e-05,794,810,50,10,0.001,1604,3
0.546,1e-05,849,855,50,10,0.001,1704,3
0.574,1e-05,905,899,50,10,0.001,1804,3
0.592,1e-05,954,950,50,10,0.001,1904,3
0.602,1e-05,999,1005,50,10,0.001,2004,3
0.484,1e-05,54,50,50,10,0.001,104,4
0.484,1e-05,106,98,50,10,0.001,204,4
0.484,1e-05,153,151,50,10,0.001,304,4
0.484,1e-05,209,195,50,10,0.001,404,4
0.486,1e-05,252,252,50,10,0.001,504,4
0.486,1e-05,300,304,50,10,0.001,604,4
0.486,1e-05,361,343,50,10,0.001,704,4
0.486,1e-05,412,392,50,10,0.001,804,4
0.488,1e-05,466,438,50,10,0.001,904,4
0.492,1e-05,521,483,50,10,0.001,1004,4
0.498,1e-05,567,537,50,10,0.001,1104,4
0.508,1e-05,616,588,50,10,0.001,1204,4
0.512,1e-05,671,633,50,10,0.001,1304,4
0.514,1e-05,722,682,50,10,0.001,1404,4
0.526,1e-05,765,739,50,10,0.001,1504,4
0.53,1e-05,817,787,50,10,0.001,1604,4
0.532,1e-05,868,836,50,10,0.001,1704,4
0.53,1e-05,915,889,50,10,0.001,1804,4
0.536,1e-05,967,937,50,10,0.001,1904,4
0.544,1e-05,1011,993,50,10,0.001,2004,4
0.53,1e-05,52,52,50,10,0.001,104,5
0.53,1e-05,95,109,50,10,0.001,204,5
0.534,1e-05,141,163,50,10,0.001,304,5
0.538,1e-05,188,216,50,10,0.001,404,5
0.542,1e-05,234,270,50,10,0.001,504,5
0.542,1e-05,286,318,50,10,0.001,604,5
0.538,1e-05,339,365,50,10,0.001,704,5
0.54,1e-05,386,418,50,10,0.001,804,5
0.548,1e-05,436,468,50,10,0.001,904,5
0.562,1e-05,491,513,50,10,0.001,1004,5
0.568,1e-05,540,564,50,10,0.001,1104,5
0.572,1e-05,590,614,50,10,0.001,1204,5
0.582,1e-05,649,655,50,10,0.001,1304,5
0.596,1e-05,707,697,50,10,0.001,1404,5
0.6,1e-05,752,752,50,10,0.001,1504,5
0.612,1e-05,809,795,50,10,0.001,1604,5
0.61,1e-05,853,851,50,10,0.001,1704,5
0.618,1e-05,906,898,50,10,0.001,1804,5
0.622,1e-05,954,950,50,10,0.001,1904,5
0.622,1e-05,1004,1000,50,10,0.001,2004,5
0.478,1e-05,54,50,50,10,0.001,104,6
0.476,1e-05,99,105,50,10,0.001,204,6
0.476,1e-05,149,155,50,10,0.001,304,6
0.478,1e-05,196,208,50,10,0.001,404,6
0.48,1e-05,249,255,50,10,0.001,504,6
0.48,1e-05,304,300,50,10,0.001,604,6
0.482,1e-05,355,349,50,10,0.001,704,6
0.482,1e-05,401,403,50,10,0.001,804,6
0.48,1e-05,449,455,50,10,0.001,904,6
0.484,1e-05,496,508,50,10,0.001,1004,6
0.484,1e-05,536,568,50,10,0.001,1104,6
0.488,1e-05,587,617,50,10,0.001,1204,6
0.482,1e-05,634,670,50,10,0.001,1304,6
0.492,1e-05,684,720,50,10,0.001,1404,6
0.496,1e-05,727,777,50,10,0.001,1504,6
0.502,1e-05,775,829,50,10,0.001,1604,6
0.502,1e-05,828,876,50,10,0.001,1704,6
0.504,1e-05,878,926,50,10,0.001,1804,6
0.516,1e-05,933,971,50,10,0.001,1904,6
0.532,1e-05,990,1014,50,10,0.001,2004,6
0.494,1e-05,59,45,50,10,0.001,104,7
0.498,1e-05,102,102,50,10,0.001,204,7
0.498,1e-05,148,156,50,10,0.001,304,7
0.502,1e-05,200,204,50,10,0.001,404,7
0.508,1e-05,248,256,50,10,0.001,504,7
0.514,1e-05,302,302,50,10,0.001,604,7
0.514,1e-05,354,350,50,10,0.001,704,7
0.514,1e-05,398,406,50,10,0.001,804,7
0.516,1e-05,444,460,50,10,0.001,904,7
0.518,1e-05,493,511,50,10,0.001,1004,7
0.514,1e-05,535,569,50,10,0.001,1104,7
0.51,1e-05,591,613,50,10,0.001,1204,7
0.518,1e-05,642,662,50,10,0.001,1304,7
0.512,1e-05,698,706,50,10,0.001,1404,7
0.514,1e-05,744,760,50,10,0.001,1504,7
0.52,1e-05,795,809,50,10,0.001,1604,7
0.526,1e-05,845,859,50,10,0.001,1704,7
0.532,1e-05,899,905,50,10,0.001,1804,7
0.546,1e-05,956,948,50,10,0.001,1904,7
0.56,1e-05,1002,1002,50,10,0.001,2004,7
0.464,1e-05,50,54,50,10,0.001,104,8
0.466,1e-05,101,103,50,10,0.001,204,8
0.466,1e-05,154,150,50,10,0.001,304,8
0.468,1e-05,209,195,50,10,0.001,404,8
0.474,1e-05,265,239,50,10,0.001,504,8
0.476,1e-05,318,286,50,10,0.001,604,8
0.482,1e-05,370,334,50,10,0.001,704,8
0.474,1e-05,414,390,50,10,0.001,804,8
0.488,1e-05,455,449,50,10,0.001,904,8
0.492,1e-05,511,493,50,10,0.001,1004,8
0.496,1e-05,554,550,50,10,0.001,1104,8
0.514,1e-05,610,594,50,10,0.001,1204,8
0.516,1e-05,668,636,50,10,0.001,1304,8
0.532,1e-05,713,691,50,10,0.001,1404,8
0.554,1e-05,763,741,50,10,0.001,1504,8
0.56,1e-05,814,790,50,10,0.001,1604,8
0.57,1e-05,866,838,50,10,0.001,1704,8
0.584,1e-05,910,894,50,10,0.001,1804,8
0.608,1e-05,955,949,50,10,0.001,1904,8
0.628,1e-05,1000,1004,50,10,0.001,2004,8
0.5,1e-05,46,58,50,10,0.001,104,9
0.498,1e-05,98,106,50,10,0.001,204,9
0.5,1e-05,157,147,50,10,0.001,304,9
0.498,1e-05,205,199,50,10,0.001,404,9
0.5,1e-05,247,257,50,10,0.001,504,9
0.502,1e-05,295,309,50,10,0.001,604,9
0.502,1e-05,346,358,50,10,0.001,704,9
0.508,1e-05,404,400,50,10,0.001,804,9
0.508,1e-05,464,440,50,10,0.001,904,9
0.508,1e-05,502,502,50,10,0.001,1004,9
0.51,1e-05,549,555,50,10,0.001,1104,9
0.508,1e-05,610,594,50,10,0.001,1204,9
0.51,1e-05,660,644,50,10,0.001,1304,9
0.522,1e-05,705,699,50,10,0.001,1404,9
0.524,1e-05,751,753,50,10,0.001,1504,9
0.524,1e-05,804,800,50,10,0.001,1604,9
0.532,1e-05,845,859,50,10,0.001,1704,9
0.532,1e-05,897,907,50,10,0.001,1804,9
0.538,1e-05,948,956,50,10,0.001,1904,9
0.556,1e-05,1005,999,50,10,0.001,2004,9
0.492,1e-05,53,51,50,10,0.001,104,10
0.496,1e-05,106,98,50,10,0.001,204,10
0.498,1e-05,162,142,50,10,0.001,304,10
0.5,1e-05,209,195,50,10,0.001,404,10
0.506,1e-05,255,249,50,10,0.001,504,10
0.52,1e-05,303,301,50,10,0.001,604,10
0.528,1e-05,348,356,50,10,0.001,704,10
0.528,1e-05,405,399,50,10,0.001,804,10
0.53,1e-05,443,461,50,10,0.001,904,10
0.534,1e-05,490,514,50,10,0.001,1004,10
0.54,1e-05,540,564,50,10,0.001,1104,10
0.546,1e-05,595,609,50,10,0.001,1204,10
0.55,1e-05,645,659,50,10,0.001,1304,10
0.554,1e-05,697,707,50,10,0.001,1404,10
0.562,1e-05,742,762,50,10,0.001,1504,10
0.564,1e-05,793,811,50,10,0.001,1604,10
0.57,1e-05,845,859,50,10,0.001,1704,10
0.582,1e-05,903,901,50,10,0.001,1804,10
0.582,1e-05,959,945,50,10,0.001,1904,10
0.588,1e-05,1003,1001,50,10,0.001,2004,10
0.484,1e-05,48,56,50,10,0.001,104,11
0.484,1e-05,95,109,50,10,0.001,204,11
0.484,1e-05,145,159,50,10,0.001,304,11
0.482,1e-05,190,214,50,10,0.001,404,11
0.482,1e-05,240,264,50,10,0.001,504,11
0.484,1e-05,289,315,50,10,0.001,604,11
0.49,1e-05,341,363,50,10,0.001,704,11
0.488,1e-05,398,406,50,10,0.001,804,11
0.486,1e-05,446,458,50,10,0.001,904,11
0.486,1e-05,494,510,50,10,0.001,1004,11
0.486,1e-05,543,561,50,10,0.001,1104,11
0.492,1e-05,596,608,50,10,0.001,1204,11
0.49,1e-05,644,660,50,10,0.001,1304,11
0.484,1e-05,690,714,50,10,0.001,1404,11
0.486,1e-05,743,761,50,10,0.001,1504,11
0.48,1e-05,797,807,50,10,0.001,1604,11
0.474,1e-05,839,865,50,10,0.001,1704,11
0.476,1e-05,896,908,50,10,0.001,1804,11
0.484,1e-05,949,955,50,10,0.001,1904,11
0.5,1e-05,994,1010,50,10,0.001,2004,11
0.45,1e-05,57,47,50,10,0.001,104,12
0.45,1e-05,111,93,50,10,0.001,204,12
0.452,1e-05,158,146,50,10,0.001,304,12
0.45,1e-05,202,202,50,10,0.001,404,12
0.452,1e-05,245,259,50,10,0.001,504,12
0.452,1e-05,299,305,50,10,0.001,604,12
0.454,1e-05,344,360,50,10,0.001,704,12
0.454,1e-05,396,408,50,10,0.001,804,12
0.45,1e-05,439,465,50,10,0.001,904,12
0.46,1e-05,478,526,50,10,0.001,1004,12
0.462,1e-05,528,576,50,10,0.001,1104,12
0.464,1e-05,581,623,50,10,0.001,1204,12
0.478,1e-05,634,670,50,10,0.001,1304,12
0.484,1e-05,678,726,50,10,0.001,1404,12
0.488,1e-05,730,774,50,10,0.001,1504,12
0.49,1e-05,784,820,50,10,0.001,1604,12
0.506,1e-05,829,875,50,10,0.001,1704,12
0.514,1e-05,879,925,50,10,0.001,1804,12
0.522,1e-05,928,976,50,10,0.001,1904,12
0.544,1e-05,981,1023,50,10,0.001,2004,12
0.482,1e-05,49,55,50,10,0.001,104,13
0.478,1e-05,109,95,50,10,0.001,204,13
0.48,1e-05,161,143,50,10,0.001,304,13
0.484,1e-05,212,192,50,10,0.001,404,13
0.488,1e-05,266,238,50,10,0.001,504,13
0.488,1e-05,317,287,50,10,0.001,604,13
0.496,1e-05,378,326,50,10,0.001,704,13
0.5,1e-05,415,389,50,10,0.001,804,13
0.49,1e-05,460,444,50,10,0.001,904,13
0.504,1e-05,505,499,50,10,0.001,1004,13
0.512,1e-05,551,553,50,10,0.001,1104,13
0.506,1e-05,595,609,50,10,0.001,1204,13
0.518,1e-05,650,654,50,10,0.001,1304,13
0.524,1e-05,701,703,50,10,0.001,1404,13
0.53,1e-05,754,750,50,10,0.001,1504,13
0.524,1e-05,804,800,50,10,0.001,1604,13
0.534,1e-05,850,854,50,10,0.001,1704,13
0.538,1e-05,900,904,50,10,0.001,1804,13
0.554,1e-05,952,952,50,10,0.001,1904,13
0.58,1e-05,1001,1003,50,10,0.001,2004,13
0.508,1e-05,50,54,50,10,0.001,104,14
0.51,1e-05,94,110,50,10,0.001,204,14
0.51,1e-05,145,159,50,10,0.001,304,14
0.516,1e-05,197,207,50,10,0.001,404,14
0.518,1e-05,246,258,50,10,0.001,504,14
0.518,1e-05,293,311,50,10,0.001,604,14
0.51,1e-05,343,361,50,10,0.001,704,14
0.51,1e-05,387,417,50,10,0.001,804,14
0.514,1e-05,431,473,50,10,0.001,904,14
0.516,1e-05,484,520,50,10,0.001,1004,14
0.52,1e-05,539,565,50,10,0.001,1104,14
0.532,1e-05,585,619,50,10,0.001,1204,14
0.548,1e-05,638,666,50,10,0.001,1304,14
0.55,1e-05,688,716,50,10,0.001,1404,14
0.544,1e-05,733,771,50,10,0.001,1504,14
0.542,1e-05,782,822,50,10,0.001,1604,14
0.548,1e-05,837,867,50,10,0.001,1704,14
0.542,1e-05,887,917,50,10,0.001,1804,14
0.55,1e-05,940,964,50,10,0.001,1904,14
0.56,1e-05,992,1012,50,10,0.001,2004,14
0.532,1e-05,45,59,50,10,0.001,104,15
0.534,1e-05,95,109,50,10,0.001,204,15
0.536,1e-05,132,172,50,10,0.001,304,15
0.538,1e-05,187,217,50,10,0.001,404,15
0.538,1e-05,242,262,50,10,0.001,504,15
0.532,1e-05,288,316,50,10,0.001,604,15
0.536,1e-05,336,368,50,10,0.001,704,15
0.536,1e-05,393,411,50,10,0.001,804,15
0.542,1e-05,449,455,50,10,0.001,904,15
0.544,1e-05,501,503,50,10,0.001,1004,15
0.548,1e-05,550,554,50,10,0.001,1104,15
0.558,1e-05,603,601,50,10,0.001,1204,15
0.56,1e-05,660,644,50,10,0.001,1304,15
0.56,1e-05,712,692,50,10,0.001,1404,15
0.568,1e-05,761,743,50,10,0.001,1504,15
0.57,1e-05,811,793,50,10,0.001,1604,15
0.584,1e-05,861,843,50,10,0.001,1704,15
0.596,1e-05,916,888,50,10,0.001,1804,15
0.608,1e-05,973,931,50,10,0.001,1904,15
0.634,1e-05,1020,984,50,10,0.001,2004,15
0.548,1e-05,41,63,50,10,0.001,104,16
0.548,1e-05,101,103,50,10,0.001,204,16
0.546,1e-05,156,148,50,10,0.001,304,16
0.546,1e-05,212,192,50,10,0.001,404,16
0.546,1e-05,261,243,50,10,0.001,504,16
0.546,1e-05,299,305,50,10,0.001,604,16
0.546,1e-05,348,356,50,10,0.001,704,16
0.542,1e-05,391,413,50,10,0.001,804,16
0.548,1e-05,439,465,50,10,0.001,904,16
0.544,1e-05,496,508,50,10,0.001,1004,16
0.546,1e-05,550,554,50,10,0.001,1104,16
0.556,1e-05,606,598,50,10,0.001,1204,16
0.558,1e-05,660,644,50,10,0.001,1304,16
0.554,1e-05,703,701,50,10,0.001,1404,16
0.562,1e-05,746,758,50,10,0.001,1504,16
0.57,1e-05,797,807,50,10,0.001,1604,16
0.57,1e-05,852,852,50,10,0.001,1704,16
0.598,1e-05,907,897,50,10,0.001,1804,16
0.61,1e-05,965,939,50,10,0.001,1904,16
0.626,1e-05,1021,983,50,10,0.001,2004,16
0.506,1e-05,50,54,50,10,0.001,104,17
0.51,1e-05,99,105,50,10,0.001,204,17
0.51,1e-05,153,151,50,10,0.001,304,17
0.516,1e-05,208,196,50,10,0.001,404,17
0.52,1e-05,260,244,50,10,0.001,504,17
0.52,1e-05,313,291,50,10,0.001,604,17
0.524,1e-05,359,345,50,10,0.001,704,17
0.528,1e-05,412,392,50,10,0.001,804,17
0.53,1e-05,453,451,50,10,0.001,904,17
0.534,1e-05,511,493,50,10,0.001,1004,17
0.53,1e-05,555,549,50,10,0.001,1104,17
0.532,1e-05,602,602,50,10,0.001,1204,17
0.538,1e-05,653,651,50,10,0.001,1304,17
0.544,1e-05,701,703,50,10,0.001,1404,17
0.548,1e-05,744,760,50,10,0.001,1504,17
0.554,1e-05,797,807,50,10,0.001,1604,17
0.57,1e-05,846,858,50,10,0.001,1704,17
0.578,1e-05,895,909,50,10,0.001,1804,17
0.578,1e-05,950,954,50,10,0.001,1904,17
0.594,1e-05,995,1009,50,10,0.001,2004,17
0.516,1e-05,44,60,50,10,0.001,104,18
0.512,1e-05,91,113,50,10,0.001,204,18
0.512,1e-05,145,159,50,10,0.001,304,18
0.516,1e-05,194,210,50,10,0.001,404,18
0.514,1e-05,246,258,50,10,0.001,504,18
0.516,1e-05,298,306,50,10,0.001,604,18
0.52,1e-05,349,355,50,10,0.001,704,18
0.52,1e-05,398,406,50,10,0.001,804,18
0.524,1e-05,447,457,50,10,0.001,904,18
0.53,1e-05,495,509,50,10,0.001,1004,18
0.532,1e-05,539,565,50,10,0.001,1104,18
0.538,1e-05,598,606,50,10,0.001,1204,18
0.544,1e-05,646,658,50,10,0.001,1304,18
0.552,1e-05,693,711,50,10,0.001,1404,18
0.56,1e-05,739,765,50,10,0.001,1504,18
0.574,1e-05,794,810,50,10,0.001,1604,18
0.576,1e-05,848,856,50,10,0.001,1704,18
0.584,1e-05,898,906,50,10,0.001,1804,18
0.586,1e-05,944,960,50,10,0.001,1904,18
0.592,1e-05,996,1008,50,10,0.001,2004,18
0.472,1e-05,51,53,50,10,0.001,104,19
0.468,1e-05,110,94,50,10,0.001,204,19
0.476,1e-05,161,143,50,10,0.001,304,19
0.48,1e-05,214,190,50,10,0.001,404,19
0.476,1e-05,266,238,50,10,0.001,504,19
0.478,1e-05,309,295,50,10,0.001,604,19
0.478,1e-05,352,352,50,10,0.001,704,19
0.484,1e-05,396,408,50,10,0.001,804,19
0.488,1e-05,436,468,50,10,0.001,904,19
0.482,1e-05,492,512,50,10,0.001,1004,19
0.49,1e-05,543,561,50,10,0.001,1104,19
0.486,1e-05,599,605,50,10,0.001,1204,19
0.496,1e-05,654,650,50,10,0.001,1304,19
0.514,1e-05,706,698,50,10,0.001,1404,19
0.536,1e-05,751,753,50,10,0.001,1504,19
0.55,1e-05,799,805,50,10,0.001,1604,19
0.57,1e-05,854,850,50,10,0.001,1704,19
0.582,1e-05,902,902,50,10,0.001,1804,19
0.594,1e-05,951,953,50,10,0.001,1904,19
0.61,1e-05,996,1008,50,10,0.001,2004,19
0.47,1e-05,53,51,50,10,0.001,104,20
0.47,1e-05,107,97,50,10,0.001,204,20
0.464,1e-05,153,151,50,10,0.001,304,20
0.466,1e-05,204,200,50,10,0.001,404,20
0.474,1e-05,250,254,50,10,0.001,504,20
0.484,1e-05,302,302,50,10,0.001,604,20
0.492,1e-05,358,346,50,10,0.001,704,20
0.51,1e-05,407,397,50,10,0.001,804,20
0.514,1e-05,452,452,50,10,0.001,904,20
0.522,1e-05,510,494,50,10,0.001,1004,20
0.528,1e-05,558,546,50,10,0.001,1104,20
0.542,1e-05,605,599,50,10,0.001,1204,20
0.554,1e-05,651,653,50,10,0.001,1304,20
0.57,1e-05,702,702,50,10,0.001,1404,20
0.578,1e-05,764,740,50,10,0.001,1504,20
0.586,1e-05,806,798,50,10,0.001,1604,20
0.6,1e-05,867,837,50,10,0.001,1704,20
0.61,1e-05,919,885,50,10,0.001,1804,20
0.618,1e-05,971,933,50,10,0.001,1904,20
0.632,1e-05,1018,986,50,10,0.001,2004,20
0.556,1e-05,56,48,50,10,0.01,104,1
0.572,1e-05,105,99,50,10,0.01,204,1
0.58,1e-05,157,147,50,10,0.01,304,1
0.6,1e-05,194,210,50,10,0.01,404,1
0.618,1e-05,250,254,50,10,0.01,504,1
0.654,1e-05,288,316,50,10,0.01,604,1
0.664,1e-05,339,365,50,10,0.01,704,1
0.676,1e-05,391,413,50,10,0.01,804,1
0.686,1e-05,440,464,50,10,0.01,904,1
0.694,1e-05,492,512,50,10,0.01,1004,1
0.752,1e-05,538,566,50,10,0.01,1104,1
0.792,1e-05,587,617,50,10,0.01,1204,1
0.828,1e-05,636,668,50,10,0.01,1304,1
0.888,1e-05,693,711,50,10,0.01,1404,1
0.906,1e-05,747,757,50,10,0.01,1504,1
0.93,1e-05,795,809,50,10,0.01,1604,1
0.924,1e-05,843,861,50,10,0.01,1704,1
0.934,1e-05,893,911,50,10,0.01,1804,1
0.944,1e-05,942,962,50,10,0.01,1904,1
0.954,1e-05,988,1016,50,10,0.01,2004,1
0.502,1e-05,54,50,50,10,0.01,104,2
0.52,1e-05,103,101,50,10,0.01,204,2
0.536,1e-05,148,156,50,10,0.01,304,2
0.554,1e-05,198,206,50,10,0.01,404,2
0.556,1e-05,249,255,50,10,0.01,504,2
0.588,1e-05,299,305,50,10,0.01,604,2
0.582,1e-05,354,350,50,10,0.01,704,2
0.594,1e-05,405,399,50,10,0.01,804,2
0.596,1e-05,456,448,50,10,0.01,904,2
0.606,1e-05,510,494,50,10,0.01,1004,2
0.65,1e-05,561,543,50,10,0.01,1104,2
0.686,1e-05,611,593,50,10,0.01,1204,2
0.722,1e-05,656,648,50,10,0.01,1304,2
0.772,1e-05,704,700,50,10,0.01,1404,2
0.8,1e-05,750,754,50,10,0.01,1504,2
0.84,1e-05,803,801,50,10,0.01,1604,2
0.878,1e-05,854,850,50,10,0.01,1704,2
0.908,1e-05,906,898,50,10,0.01,1804,2
0.918,1e-05,960,944,50,10,0.01,1904,2
0.928,1e-05,1008,996,50,10,0.01,2004,2
0.504,1e-05,46,58,50,10,0.01,104,3
0.498,1e-05,93,111,50,10,0.01,204,3
0.508,1e-05,133,171,50,10,0.01,304,3
0.538,1e-05,173,231,50,10,0.01,404,3
0.532,1e-05,225,279,50,10,0.01,504,3
0.556,1e-05,272,332,50,10,0.01,604,3
0.568,1e-05,316,388,50,10,0.01,704,3
0.6,1e-05,373,431,50,10,0.01,804,3
0.6,1e-05,423,481,50,10,0.01,904,3
0.638,1e-05,481,523,50,10,0.01,1004,3
0.672,1e-05,537,567,50,10,0.01,1104,3
0.742,1e-05,592,612,50,10,0.01,1204,3
0.798,1e-05,643,661,50,10,0.01,1304,3
0.858,1e-05,701,703,50,10,0.01,1404,3
0.918,1e-05,751,753,50,10,0.01,1504,3
0.952,1e-05,804,800,50,10,0.01,1604,3
0.96,1e-05,844,860,50,10,0.01,1704,3
0.97,1e-05,901,903,50,10,0.01,1804,3
0.972,1e-05,951,953,50,10,0.01,1904,3
0.978,1e-05,1002,1002,50,10,0.01,2004,3
0.478,1e-05,55,49,50,10,0.01,104,4
0.508,1e-05,100,104,50,10,0.01,204,4
0.518,1e-05,155,149,50,10,0.01,304,4
0.558,1e-05,212,192,50,10,0.01,404,4
0.58,1e-05,262,242,50,10,0.01,504,4
0.596,1e-05,309,295,50,10,0.01,604,4
0.63,1e-05,366,338,50,10,0.01,704,4
0.65,1e-05,423,381,50,10,0.01,804,4
0.672,1e-05,463,441,50,10,0.01,904,4
0.716,1e-05,506,498,50,10,0.01,1004,4
0.732,1e-05,561,543,50,10,0.01,1104,4
0.778,1e-05,608,596,50,10,0.01,1204,4
0.81,1e-05,648,656,50,10,0.01,1304,4
0.86,1e-05,687,717,50,10,0.01,1404,4
0.886,1e-05,734,770,50,10,0.01,1504,4
0.92,1e-05,788,816,50,10,0.01,1604,4
0.936,1e-05,840,864,50,10,0.01,1704,4
0.95,1e-05,900,904,50,10,0.01,1804,4
0.954,1e-05,956,948,50,10,0.01,1904,4
0.964,1e-05,1010,994,50,10,0.01,2004,4
0.46,1e-05,57,47,50,10,0.01,104,5
0.484,1e-05,111,93,50,10,0.01,204,5
0.532,1e-05,155,149,50,10,0.01,304,5
0.54,1e-05,200,204,50,10,0.01,404,5
0.566,1e-05,248,256,50,10,0.01,504,5
0.584,1e-05,299,305,50,10,0.01,604,5
0.588,1e-05,352,352,50,10,0.01,704,5
0.612,1e-05,405,399,50,10,0.01,804,5
0.646,1e-05,450,454,50,10,0.01,904,5
0.702,1e-05,506,498,50,10,0.01,1004,5
0.758,1e-05,550,554,50,10,0.01,1104,5
0.82,1e-05,601,603,50,10,0.01,1204,5
0.856,1e-05,642,662,50,10,0.01,1304,5
0.894,1e-05,695,709,50,10,0.01,1404,5
0.928,1e-05,759,745,50,10,0.01,1504,5
0.936,1e-05,806,798,50,10,0.01,1604,5
0.94,1e-05,863,841,50,10,0.01,1704,5
0.94,1e-05,903,901,50,10,0.01,1804,5
0.944,1e-05,947,957,50,10,0.01,1904,5
0.948,1e-05,992,1012,50,10,0.01,2004,5
0.494,1e-05,51,53,50,10,0.01,104,6
0.502,1e-05,107,97,50,10,0.01,204,6
0.51,1e-05,154,150,50,10,0.01,304,6
0.536,1e-05,208,196,50,10,0.01,404,6
0.554,1e-05,259,245,50,10,0.01,504,6
0.568,1e-05,304,300,50,10,0.01,604,6
0.568,1e-05,344,360,50,10,0.01,704,6
0.576,1e-05,393,411,50,10,0.01,804,6
0.608,1e-05,436,468,50,10,0.01,904,6
0.648,1e-05,490,514,50,10,0.01,1004,6
0.67,1e-05,545,559,50,10,0.01,1104,6
0.732,1e-05,595,609,50,10,0.01,1204,6
0.774,1e-05,647,657,50,10,0.01,1304,6
0.81,1e-05,701,703,50,10,0.01,1404,6
0.844,1e-05,746,758,50,10,0.01,1504,6
0.886,1e-05,797,807,50,10,0.01,1604,6
0.9,1e-05,846,858,50,10,0.01,1704,6
0.93,1e-05,897,907,50,10,0.01,1804,6
0.934,1e-05,947,957,50,10,0.01,1904,6
0.94,1e-05,1003,1001,50,10,0.01,2004,6
0.484,1e-05,41,63,50,10,0.01,104,7
0.498,1e-05,85,119,50,10,0.01,204,7
0.518,1e-05,133,171,50,10,0.01,304,7
0.532,1e-05,187,217,50,10,0.01,404,7
0.544,1e-05,235,269,50,10,0.01,504,7
0.568,1e-05,287,317,50,10,0.01,604,7
0.582,1e-05,337,367,50,10,0.01,704,7
0.606,1e-05,384,420,50,10,0.01,804,7
0.63,1e-05,434,470,50,10,0.01,904,7
0.682,1e-05,483,521,50,10,0.01,1004,7
0.716,1e-05,543,561,50,10,0.01,1104,7
0.752,1e-05,592,612,50,10,0.01,1204,7
0.8,1e-05,646,658,50,10,0.01,1304,7
0.866,1e-05,704,700,50,10,0.01,1404,7
0.898,1e-05,752,752,50,10,0.01,1504,7
0.922,1e-05,800,804,50,10,0.01,1604,7
0.934,1e-05,849,855,50,10,0.01,1704,7
0.938,1e-05,899,905,50,10,0.01,1804,7
0.942,1e-05,954,950,50,10,0.01,1904,7
0.948,1e-05,1007,997,50,10,0.01,2004,7
0.534,1e-05,55,49,50,10,0.01,104,8
0.544,1e-05,107,97,50,10,0.01,204,8
0.538,1e-05,159,145,50,10,0.01,304,8
0.556,1e-05,200,204,50,10,0.01,404,8
0.586,1e-05,250,254,50,10,0.01,504,8
0.614,1e-05,294,310,50,10,0.01,604,8
0.616,1e-05,341,363,50,10,0.01,704,8
0.642,1e-05,394,410,50,10,0.01,804,8
0.686,1e-05,444,460,50,10,0.01,904,8
0.684,1e-05,488,516,50,10,0.01,1004,8
0.684,1e-05,533,571,50,10,0.01,1104,8
0.716,1e-05,585,619,50,10,0.01,1204,8
0.742,1e-05,643,661,50,10,0.01,1304,8
0.784,1e-05,695,709,50,10,0.01,1404,8
0.792,1e-05,738,766,50,10,0.01,1504,8
0.826,1e-05,795,809,50,10,0.01,1604,8
0.854,1e-05,841,863,50,10,0.01,1704,8
0.894,1e-05,903,901,50,10,0.01,1804,8
0.908,1e-05,952,952,50,10,0.01,1904,8
0.922,1e-05,1008,996,50,10,0.01,2004,8
0.506,1e-05,56,48,50,10,0.01,104,9
0.508,1e-05,110,94,50,10,0.01,204,9
0.498,1e-05,153,151,50,10,0.01,304,9
0.524,1e-05,203,201,50,10,0.01,404,9
0.542,1e-05,253,251,50,10,0.01,504,9
0.576,1e-05,298,306,50,10,0.01,604,9
0.606,1e-05,343,361,50,10,0.01,704,9
0.624,1e-05,398,406,50,10,0.01,804,9
0.658,1e-05,443,461,50,10,0.01,904,9
0.71,1e-05,501,503,50,10,0.01,1004,9
0.744,1e-05,554,550,50,10,0.01,1104,9
0.79,1e-05,607,597,50,10,0.01,1204,9
0.834,1e-05,663,641,50,10,0.01,1304,9
0.864,1e-05,708,696,50,10,0.01,1404,9
0.868,1e-05,755,749,50,10,0.01,1504,9
0.898,1e-05,805,799,50,10,0.01,1604,9
0.908,1e-05,849,855,50,10,0.01,1704,9
0.918,1e-05,899,905,50,10,0.01,1804,9
0.932,1e-05,962,942,50,10,0.01,1904,9
0.932,1e-05,1005,999,50,10,0.01,2004,9
0.508,1e-05,52,52,50,10,0.01,104,10
0.53,1e-05,102,102,50,10,0.01,204,10
0.552,1e-05,157,147,50,10,0.01,304,10
0.558,1e-05,202,202,50,10,0.01,404,10
0.558,1e-05,257,247,50,10,0.01,504,10
0.558,1e-05,310,294,50,10,0.01,604,10
0.566,1e-05,366,338,50,10,0.01,704,10
0.59,1e-05,414,390,50,10,0.01,804,10
0.62,1e-05,466,438,50,10,0.01,904,10
0.67,1e-05,515,489,50,10,0.01,1004,10
0.724,1e-05,562,542,50,10,0.01,1104,10
0.792,1e-05,618,586,50,10,0.01,1204,10
0.858,1e-05,669,635,50,10,0.01,1304,10
0.896,1e-05,718,686,50,10,0.01,1404,10
0.92,1e-05,763,741,50,10,0.01,1504,10
0.95,1e-05,804,800,50,10,0.01,1604,10
0.956,1e-05,858,846,50,10,0.01,1704,10
0.956,1e-05,912,892,50,10,0.01,1804,10
0.962,1e-05,970,934,50,10,0.01,1904,10
0.964,1e-05,1012,992,50,10,0.01,2004,10
0.542,1e-05,52,52,50,10,0.01,104,11
0.566,1e-05,105,99,50,10,0.01,204,11
0.562,1e-05,147,157,50,10,0.01,304,11
0.568,1e-05,199,205,50,10,0.01,404,11
0.576,1e-05,245,259,50,10,0.01,504,11
0.608,1e-05,291,313,50,10,0.01,604,11
0.644,1e-05,341,363,50,10,0.01,704,11
0.668,1e-05,397,407,50,10,0.01,804,11
0.696,1e-05,447,457,50,10,0.01,904,11
0.74,1e-05,497,507,50,10,0.01,1004,11
0.758,1e-05,545,559,50,10,0.01,1104,11
0.782,1e-05,598,606,50,10,0.01,1204,11
0.82,1e-05,647,657,50,10,0.01,1304,11
0.874,1e-05,700,704,50,10,0.01,1404,11
0.89,1e-05,757,747,50,10,0.01,1504,11
0.918,1e-05,805,799,50,10,0.01,1604,11
0.928,1e-05,853,851,50,10,0.01,1704,11
0.936,1e-05,908,896,50,10,0.01,1804,11
0.942,1e-05,945,959,50,10,0.01,1904,11
0.942,1e-05,1000,1004,50,10,0.01,2004,11
0.488,1e-05,57,47,50,10,0.01,104,12
0.526,1e-05,101,103,50,10,0.01,204,12
0.538,1e-05,159,145,50,10,0.01,304,12
0.552,1e-05,209,195,50,10,0.01,404,12
0.536,1e-05,261,243,50,10,0.01,504,12
0.532,1e-05,314,290,50,10,0.01,604,12
0.556,1e-05,372,332,50,10,0.01,704,12
0.598,1e-05,410,394,50,10,0.01,804,12
0.628,1e-05,455,449,50,10,0.01,904,12
0.674,1e-05,510,494,50,10,0.01,1004,12
0.7,1e-05,565,539,50,10,0.01,1104,12
0.75,1e-05,616,588,50,10,0.01,1204,12
0.83,1e-05,663,641,50,10,0.01,1304,12
0.902,1e-05,720,684,50,10,0.01,1404,12
0.94,1e-05,771,733,50,10,0.01,1504,12
0.952,1e-05,819,785,50,10,0.01,1604,12
0.956,1e-05,865,839,50,10,0.01,1704,12
0.962,1e-05,912,892,50,10,0.01,1804,12
0.962,1e-05,960,944,50,10,0.01,1904,12
0.972,1e-05,1008,996,50,10,0.01,2004,12
0.51,1e-05,58,46,50,10,0.01,104,13
0.534,1e-05,108,96,50,10,0.01,204,13
0.534,1e-05,155,149,50,10,0.01,304,13
0.54,1e-05,209,195,50,10,0.01,404,13
0.554,1e-05,260,244,50,10,0.01,504,13
0.562,1e-05,318,286,50,10,0.01,604,13
0.584,1e-05,357,347,50,10,0.01,704,13
0.608,1e-05,407,397,50,10,0.01,804,13
0.622,1e-05,459,445,50,10,0.01,904,13
0.664,1e-05,514,490,50,10,0.01,1004,13
0.708,1e-05,557,547,50,10,0.01,1104,13
0.778,1e-05,601,603,50,10,0.01,1204,13
0.832,1e-05,647,657,50,10,0.01,1304,13
0.862,1e-05,698,706,50,10,0.01,1404,13
0.894,1e-05,742,762,50,10,0.01,1504,13
0.906,1e-05,785,819,50,10,0.01,1604,13
0.922,1e-05,840,864,50,10,0.01,1704,13
0.928,1e-05,893,911,50,10,0.01,1804,13
0.93,1e-05,946,958,50,10,0.01,1904,13
0.942,1e-05,996,1008,50,10,0.01,2004,13
0.494,1e-05,55,49,50,10,0.01,104,14
0.512,1e-05,99,105,50,10,0.01,204,14
0.534,1e-05,153,151,50,10,0.01,304,14
0.564,1e-05,201,203,50,10,0.01,404,14
0.592,1e-05,253,251,50,10,0.01,504,14
0.626,1e-05,314,290,50,10,0.01,604,14
0.648,1e-05,366,338,50,10,0.01,704,14
0.692,1e-05,413,391,50,10,0.01,804,14
0.726,1e-05,463,441,50,10,0.01,904,14
0.75,1e-05,524,480,50,10,0.01,1004,14
0.782,1e-05,579,525,50,10,0.01,1104,14
0.824,1e-05,628,576,50,10,0.01,1204,14
0.834,1e-05,673,631,50,10,0.01,1304,14
0.874,1e-05,723,681,50,10,0.01,1404,14
0.894,1e-05,773,731,50,10,0.01,1504,14
0.914,1e-05,813,791,50,10,0.01,1604,14
0.918,1e-05,863,841,50,10,0.01,1704,14
0.92,1e-05,904,900,50,10,0.01,1804,14
0.93,1e-05,960,944,50,10,0.01,1904,14
0.93,1e-05,1007,997,50,10,0.01,2004,14
0.488,1e-05,55,49,50,10,0.01,104,15
0.518,1e-05,101,103,50,10,0.01,204,15
0.536,1e-05,154,150,50,10,0.01,304,15
0.56,1e-05,197,207,50,10,0.01,404,15
0.576,1e-05,245,259,50,10,0.01,504,15
0.624,1e-05,298,306,50,10,0.01,604,15
0.652,1e-05,349,355,50,10,0.01,704,15
0.686,1e-05,401,403,50,10,0.01,804,15
0.726,1e-05,454,450,50,10,0.01,904,15
0.776,1e-05,503,501,50,10,0.01,1004,15
0.806,1e-05,552,552,50,10,0.01,1104,15
0.87,1e-05,599,605,50,10,0.01,1204,15
0.902,1e-05,651,653,50,10,0.01,1304,15
0.93,1e-05,703,701,50,10,0.01,1404,15
0.942,1e-05,753,751,50,10,0.01,1504,15
0.958,1e-05,806,798,50,10,0.01,1604,15
0.956,1e-05,856,848,50,10,0.01,1704,15
0.958,1e-05,904,900,50,10,0.01,1804,15
0.956,1e-05,956,948,50,10,0.01,1904,15
0.95,1e-05,1002,1002,50,10,0.01,2004,15
0.524,1e-05,45,59,50,10,0.01,104,16
0.528,1e-05,83,121,50,10,0.01,204,16
0.55,1e-05,130,174,50,10,0.01,304,16
0.544,1e-05,189,215,50,10,0.01,404,16
0.516,1e-05,241,263,50,10,0.01,504,16
0.528,1e-05,290,314,50,10,0.01,604,16
0.524,1e-05,337,367,50,10,0.01,704,16
0.54,1e-05,393,411,50,10,0.01,804,16
0.574,1e-05,445,459,50,10,0.01,904,16
0.63,1e-05,493,511,50,10,0.01,1004,16
0.676,1e-05,538,566,50,10,0.01,1104,16
0.734,1e-05,586,618,50,10,0.01,1204,16
0.738,1e-05,634,670,50,10,0.01,1304,16
0.778,1e-05,682,722,50,10,0.01,1404,16
0.822,1e-05,732,772,50,10,0.01,1504,16
0.854,1e-05,786,818,50,10,0.01,1604,16
0.872,1e-05,836,868,50,10,0.01,1704,16
0.888,1e-05,888,916,50,10,0.01,1804,16
0.908,1e-05,946,958,50,10,0.01,1904,16
0.92,1e-05,994,1010,50,10,0.01,2004,16
0.494,1e-05,42,62,50,10,0.01,104,17
0.52,1e-05,93,111,50,10,0.01,204,17
0.524,1e-05,142,162,50,10,0.01,304,17
0.564,1e-05,189,215,50,10,0.01,404,17
0.598,1e-05,233,271,50,10,0.01,504,17
0.618,1e-05,290,314,50,10,0.01,604,17
0.622,1e-05,341,363,50,10,0.01,704,17
0.644,1e-05,397,407,50,10,0.01,804,17
0.66,1e-05,447,457,50,10,0.01,904,17
0.736,1e-05,490,514,50,10,0.01,1004,17
0.774,1e-05,537,567,50,10,0.01,1104,17
0.802,1e-05,582,622,50,10,0.01,1204,17
0.83,1e-05,630,674,50,10,0.01,1304,17
0.888,1e-05,694,710,50,10,0.01,1404,17
0.892,1e-05,742,762,50,10,0.01,1504,17
0.906,1e-05,796,808,50,10,0.01,1604,17
0.934,1e-05,843,861,50,10,0.01,1704,17
0.952,1e-05,897,907,50,10,0.01,1804,17
0.956,1e-05,946,958,50,10,0.01,1904,17
0.96,1e-05,996,1008,50,10,0.01,2004,17
0.524,1e-05,48,56,50,10,0.01,104,18
0.526,1e-05,98,106,50,10,0.01,204,18
0.53,1e-05,151,153,50,10,0.01,304,18
0.538,1e-05,192,212,50,10,0.01,404,18
0.56,1e-05,248,256,50,10,0.01,504,18
0.574,1e-05,299,305,50,10,0.01,604,18
0.576,1e-05,350,354,50,10,0.01,704,18
0.598,1e-05,403,401,50,10,0.01,804,18
0.61,1e-05,458,446,50,10,0.01,904,18
0.658,1e-05,510,494,50,10,0.01,1004,18
0.706,1e-05,562,542,50,10,0.01,1104,18
0.742,1e-05,613,591,50,10,0.01,1204,18
0.8,1e-05,659,645,50,10,0.01,1304,18
0.84,1e-05,705,699,50,10,0.01,1404,18
0.88,1e-05,754,750,50,10,0.01,1504,18
0.914,1e-05,799,805,50,10,0.01,1604,18
0.934,1e-05,861,843,50,10,0.01,1704,18
0.932,1e-05,909,895,50,10,0.01,1804,18
0.938,1e-05,959,945,50,10,0.01,1904,18
0.944,1e-05,1014,990,50,10,0.01,2004,18
0.516,1e-05,48,56,50,10,0.01,104,19
0.534,1e-05,102,102,50,10,0.01,204,19
0.548,1e-05,151,153,50,10,0.01,304,19
0.568,1e-05,204,200,50,10,0.01,404,19
0.578,1e-05,248,256,50,10,0.01,504,19
0.586,1e-05,295,309,50,10,0.01,604,19
0.602,1e-05,348,356,50,10,0.01,704,19
0.624,1e-05,407,397,50,10,0.01,804,19
0.654,1e-05,450,454,50,10,0.01,904,19
0.698,1e-05,511,493,50,10,0.01,1004,19
0.744,1e-05,563,541,50,10,0.01,1104,19
0.798,1e-05,620,584,50,10,0.01,1204,19
0.842,1e-05,675,629,50,10,0.01,1304,19
0.886,1e-05,733,671,50,10,0.01,1404,19
0.912,1e-05,780,724,50,10,0.01,1504,19
0.938,1e-05,823,781,50,10,0.01,1604,19
0.936,1e-05,871,833,50,10,0.01,1704,19
0.942,1e-05,917,887,50,10,0.01,1804,19
0.95,1e-05,959,945,50,10,0.01,1904,19
0.96,1e-05,1004,1000,50,10,0.01,2004,19
0.518,1e-05,44,60,50,10,0.01,104,20
0.524,1e-05,86,118,50,10,0.01,204,20
0.54,1e-05,136,168,50,10,0.01,304,20
0.558,1e-05,181,223,50,10,0.01,404,20
0.564,1e-05,232,272,50,10,0.01,504,20
0.588,1e-05,281,323,50,10,0.01,604,20
0.612,1e-05,338,366,50,10,0.01,704,20
0.63,1e-05,389,415,50,10,0.01,804,20
0.668,1e-05,436,468,50,10,0.01,904,20
0.694,1e-05,491,513,50,10,0.01,1004,20
0.726,1e-05,543,561,50,10,0.01,1104,20
0.772,1e-05,592,612,50,10,0.01,1204,20
0.834,1e-05,642,662,50,10,0.01,1304,20
0.868,1e-05,686,718,50,10,0.01,1404,20
0.904,1e-05,744,760,50,10,0.01,1504,20
0.93,1e-05,806,798,50,10,0.01,1604,20
0.942,1e-05,866,838,50,10,0.01,1704,20
0.954,1e-05,916,888,50,10,0.01,1804,20
0.966,1e-05,960,944,50,10,0.01,1904,20
0.966,1e-05,1007,997,50,10,0.01,2004,20
0.484,0.0001,49,55,50,10,0.0001,104,1
0.484,0.0001,95,109,50,10,0.0001,204,1
0.482,0.0001,149,155,50,10,0.0001,304,1
0.482,0.0001,199,205,50,10,0.0001,404,1
0.482,0.0001,252,252,50,10,0.0001,504,1
0.48,0.0001,298,306,50,10,0.0001,604,1
0.48,0.0001,349,355,50,10,0.0001,704,1
0.48,0.0001,397,407,50,10,0.0001,804,1
0.48,0.0001,446,458,50,10,0.0001,904,1
0.48,0.0001,494,510,50,10,0.0001,1004,1
0.482,0.0001,550,554,50,10,0.0001,1104,1
0.482,0.0001,598,606,50,10,0.0001,1204,1
0.482,0.0001,658,646,50,10,0.0001,1304,1
0.482,0.0001,709,695,50,10,0.0001,1404,1
0.482,0.0001,765,739,50,10,0.0001,1504,1
0.484,0.0001,819,785,50,10,0.0001,1604,1
0.484,0.0001,863,841,50,10,0.0001,1704,1
0.482,0.0001,913,891,50,10,0.0001,1804,1
0.482,0.0001,958,946,50,10,0.0001,1904,1
0.482,0.0001,1009,995,50,10,0.0001,2004,1
0.516,0.0001,53,51,50,10,0.0001,104,2
0.516,0.0001,105,99,50,10,0.0001,204,2
0.516,0.0001,158,146,50,10,0.0001,304,2
0.516,0.0001,202,202,50,10,0.0001,404,2
0.514,0.0001,252,252,50,10,0.0001,504,2
0.512,0.0001,302,302,50,10,0.0001,604,2
0.512,0.0001,347,357,50,10,0.0001,704,2
0.514,0.0001,391,413,50,10,0.0001,804,2
0.514,0.0001,442,462,50,10,0.0001,904,2
0.516,0.0001,491,513,50,10,0.0001,1004,2
0.516,0.0001,539,565,50,10,0.0001,1104,2
0.52,0.0001,590,614,50,10,0.0001,1204,2
0.52,0.0001,644,660,50,10,0.0001,1304,2
0.516,0.0001,698,706,50,10,0.0001,1404,2
0.516,0.0001,740,764,50,10,0.0001,1504,2
0.52,0.0001,792,812,50,10,0.0001,1604,2
0.522,0.0001,845,859,50,10,0.0001,1704,2
0.524,0.0001,892,912,50,10,0.0001,1804,2
0.524,0.0001,940,964,50,10,0.0001,1904,2
0.526,0.0001,994,1010,50,10,0.0001,2004,2
0.48,0.0001,53,51,50,10,0.0001,104,3
0.48,0.0001,113,91,50,10,0.0001,204,3
0.48,0.0001,164,140,50,10,0.0001,304,3
0.48,0.0001,213,191,50,10,0.0001,404,3
0.48,0.0001,270,234,50,10,0.0001,504,3
0.48,0.0001,316,288,50,10,0.0001,604,3
0.484,0.0001,362,342,50,10,0.0001,704,3
0.482,0.0001,410,394,50,10,0.0001,804,3
0.48,0.0001,459,445,50,10,0.0001,904,3
0.478,0.0001,511,493,50,10,0.0001,1004,3
0.476,0.0001,560,544,50,10,0.0001,1104,3
0.476,0.0001,609,595,50,10,0.0001,1204,3
0.474,0.0001,665,639,50,10,0.0001,1304,3
0.474,0.0001,713,691,50,10,0.0001,1404,3
0.472,0.0001,761,743,50,10,0.0001,1504,3
0.472,0.0001,814,790,50,10,0.0001,1604,3
0.472,0.0001,866,838,50,10,0.0001,1704,3
0.472,0.0001,917,887,50,10,0.0001,1804,3
0.474,0.0001,966,938,50,10,0.0001,1904,3
0.478,0.0001,1010,994,50,10,0.0001,2004,3
0.488,0.0001,50,54,50,10,0.0001,104,4
0.488,0.0001,103,101,50,10,0.0001,204,4
0.488,0.0001,149,155,50,10,0.0001,304,4
0.49,0.0001,199,205,50,10,0.0001,404,4
0.49,0.0001,247,257,50,10,0.0001,504,4
0.49,0.0001,288,316,50,10,0.0001,604,4
0.49,0.0001,333,371,50,10,0.0001,704,4
0.49,0.0001,390,414,50,10,0.0001,804,4
0.49,0.0001,439,465,50,10,0.0001,904,4
0.488,0.0001,493,511,50,10,0.0001,1004,4
0.486,0.0001,547,557,50,10,0.0001,1104,4
0.486,0.0001,598,606,50,10,0.0001,1204,4
0.486,0.0001,644,660,50,10,0.0001,1304,4
0.486,0.0001,695,709,50,10,0.0001,1404,4
0.488,0.0001,750,754,50,10,0.0001,1504,4
0.488,0.0001,803,801,50,10,0.0001,1604,4
0.486,0.0001,842,862,50,10,0.0001,1704,4
0.486,0.0001,904,900,50,10,0.0001,1804,4
0.482,0.0001,957,947,50,10,0.0001,1904,4
0.482,0.0001,1001,1003,50,10,0.0001,2004,4
0.514,0.0001,49,55,50,10,0.0001,104,5
0.514,0.0001,101,103,50,10,0.0001,204,5
0.514,0.0001,150,154,50,10,0.0001,304,5
0.514,0.0001,193,211,50,10,0.0001,404,5
0.514,0.0001,238,266,50,10,0.0001,504,5
0.514,0.0001,286,318,50,10,0.0001,604,5
0.514,0.0001,338,366,50,10,0.0001,704,5
0.514,0.0001,385,419,50,10,0.0001,804,5
0.514,0.0001,440,464,50,10,0.0001,904,5
0.514,0.0001,495,509,50,10,0.0001,1004,5
0.514,0.0001,544,560,50,10,0.0001,1104,5
0.514,0.0001,593,611,50,10,0.0001,1204,5
0.514,0.0001,637,667,50,10,0.0001,1304,5
0.514,0.0001,696,708,50,10,0.0001,1404,5
0.514,0.0001,741,763,50,10,0.0001,1504,5
0.514,0.0001,786,818,50,10,0.0001,1604,5
0.514,0.0001,843,861,50,10,0.0001,1704,5
0.514,0.0001,896,908,50,10,0.0001,1804,5
0.514,0.0001,953,951,50,10,0.0001,1904,5
0.514,0.0001,1009,995,50,10,0.0001,2004,5
0.452,0.0001,45,59,50,10,0.0001,104,6
0.452,0.0001,97,107,50,10,0.0001,204,6
0.452,0.0001,149,155,50,10,0.0001,304,6
0.452,0.0001,203,201,50,10,0.0001,404,6
0.452,0.0001,259,245,50,10,0.0001,504,6
0.454,0.0001,309,295,50,10,0.0001,604,6
0.456,0.0001,351,353,50,10,0.0001,704,6
0.46,0.0001,402,402,50,10,0.0001,804,6
0.458,0.0001,444,460,50,10,0.0001,904,6
0.458,0.0001,493,511,50,10,0.0001,1004,6
0.458,0.0001,541,563,50,10,0.0001,1104,6
0.458,0.0001,595,609,50,10,0.0001,1204,6
0.46,0.0001,644,660,50,10,0.0001,1304,6
0.46,0.0001,697,707,50,10,0.0001,1404,6
0.46,0.0001,744,760,50,10,0.0001,1504,6
0.458,0.0001,790,814,50,10,0.0001,1604,6
0.458,0.0001,848,856,50,10,0.0001,1704,6
0.46,0.0001,902,902,50,10,0.0001,1804,6
0.458,0.0001,960,944,50,10,0.0001,1904,6
0.462,0.0001,1002,1002,50,10,0.0001,2004,6
0.518,0.0001,46,58,50,10,0.0001,104,7
0.518,0.0001,101,103,50,10,0.0001,204,7
0.516,0.0001,158,146,50,10,0.0001,304,7
0.518,0.0001,211,193,50,10,0.0001,404,7
0.518,0.0001,262,242,50,10,0.0001,504,7
0.518,0.0001,315,289,50,10,0.0001,604,7
0.518,0.0001,368,336,50,10,0.0001,704,7
0.514,0.0001,420,384,50,10,0.0001,804,7
0.516,0.0001,470,434,50,10,0.0001,904,7
0.514,0.0001,514,490,50,10,0.0001,1004,7
0.514,0.0001,561,543,50,10,0.0001,1104,7
0.514,0.0001,608,596,50,10,0.0001,1204,7
0.514,0.0001,661,643,50,10,0.0001,1304,7
0.518,0.0001,708,696,50,10,0.0001,1404,7
0.522,0.0001,756,748,50,10,0.0001,1504,7
0.524,0.0001,805,799,50,10,0.0001,1604,7
0.534,0.0001,861,843,50,10,0.0001,1704,7
0.534,0.0001,908,896,50,10,0.0001,1804,7
0.534,0.0001,958,946,50,10,0.0001,1904,7
0.532,0.0001,1004,1000,50,10,0.0001,2004,7
0.514,0.0001,54,50,50,10,0.0001,104,8
0.514,0.0001,115,89,50,10,0.0001,204,8
0.514,0.0001,163,141,50,10,0.0001,304,8
0.514,0.0001,215,189,50,10,0.0001,404,8
0.514,0.0001,261,243,50,10,0.0001,504,8
0.514,0.0001,306,298,50,10,0.0001,604,8
0.514,0.0001,355,349,50,10,0.0001,704,8
0.516,0.0001,406,398,50,10,0.0001,804,8
0.516,0.0001,455,449,50,10,0.0001,904,8
0.52,0.0001,503,501,50,10,0.0001,1004,8
0.522,0.0001,550,554,50,10,0.0001,1104,8
0.524,0.0001,596,608,50,10,0.0001,1204,8
0.524,0.0001,652,652,50,10,0.0001,1304,8
0.524,0.0001,699,705,50,10,0.0001,1404,8
0.524,0.0001,749,755,50,10,0.0001,1504,8
0.524,0.0001,791,813,50,10,0.0001,1604,8
0.524,0.0001,845,859,50,10,0.0001,1704,8
0.524,0.0001,902,902,50,10,0.0001,1804,8
0.526,0.0001,952,952,50,10,0.0001,1904,8
0.526,0.0001,996,1008,50,10,0.0001,2004,8
0.518,0.0001,50,54,50,10,0.0001,104,9
0.518,0.0001,94,110,50,10,0.0001,204,9
0.518,0.0001,146,158,50,10,0.0001,304,9
0.518,0.0001,203,201,50,10,0.0001,404,9
0.518,0.0001,251,253,50,10,0.0001,504,9
0.518,0.0001,308,296,50,10,0.0001,604,9
0.518,0.0001,361,343,50,10,0.0001,704,9
0.518,0.0001,415,389,50,10,0.0001,804,9
0.518,0.0001,466,438,50,10,0.0001,904,9
0.518,0.0001,513,491,50,10,0.0001,1004,9
0.518,0.0001,568,536,50,10,0.0001,1104,9
0.518,0.0001,612,592,50,10,0.0001,1204,9
0.52,0.0001,665,639,50,10,0.0001,1304,9
0.52,0.0001,717,687,50,10,0.0001,1404,9
0.52,0.0001,761,743,50,10,0.0001,1504,9
0.52,0.0001,803,801,50,10,0.0001,1604,9
0.52,0.0001,851,853,50,10,0.0001,1704,9
0.52,0.0001,910,894,50,10,0.0001,1804,9
0.52,0.0001,955,949,50,10,0.0001,1904,9
0.52,0.0001,1011,993,50,10,0.0001,2004,9
0.496,0.0001,53,51,50,10,0.0001,104,10
0.496,0.0001,107,97,50,10,0.0001,204,10
0.496,0.0001,157,147,50,10,0.0001,304,10
0.496,0.0001,201,203,50,10,0.0001,404,10
0.496,0.0001,249,255,50,10,0.0001,504,10
0.496,0.0001,297,307,50,10,0.0001,604,10
0.496,0.0001,344,360,50,10,0.0001,704,10
0.496,0.0001,396,408,50,10,0.0001,804,10
0.496,0.0001,434,470,50,10,0.0001,904,10
0.496,0.0001,478,526,50,10,0.0001,1004,10
0.496,0.0001,527,577,50,10,0.0001,1104,10
0.496,0.0001,578,626,50,10,0.0001,1204,10
0.498,0.0001,632,672,50,10,0.0001,1304,10
0.498,0.0001,692,712,50,10,0.0001,1404,10
0.496,0.0001,745,759,50,10,0.0001,1504,10
0.498,0.0001,793,811,50,10,0.0001,1604,10
0.498,0.0001,843,861,50,10,0.0001,1704,10
0.498,0.0001,894,910,50,10,0.0001,1804,10
0.498,0.0001,952,952,50,10,0.0001,1904,10
0.498,0.0001,1003,1001,50,10,0.0001,2004,10
0.478,0.0001,46,58,50,10,0.0001,104,11
0.476,0.0001,93,111,50,10,0.0001,204,11
0.476,0.0001,136,168,50,10,0.0001,304,11
0.476,0.0001,184,220,50,10,0.0001,404,11
0.476,0.0001,236,268,50,10,0.0001,504,11
0.476,0.0001,281,323,50,10,0.0001,604,11
0.476,0.0001,333,371,50,10,0.0001,704,11
0.478,0.0001,382,422,50,10,0.0001,804,11
0.48,0.0001,441,463,50,10,0.0001,904,11
0.482,0.0001,493,511,50,10,0.0001,1004,11
0.484,0.0001,550,554,50,10,0.0001,1104,11
0.484,0.0001,599,605,50,10,0.0001,1204,11
0.484,0.0001,655,649,50,10,0.0001,1304,11
0.486,0.0001,697,707,50,10,0.0001,1404,11
0.486,0.0001,745,759,50,10,0.0001,1504,11
0.488,0.0001,792,812,50,10,0.0001,1604,11
0.488,0.0001,843,861,50,10,0.0001,1704,11
0.49,0.0001,898,906,50,10,0.0001,1804,11
0.486,0.0001,938,966,50,10,0.0001,1904,11
0.488,0.0001,986,1018,50,10,0.0001,2004,11
0.484,0.0001,53,51,50,10,0.0001,104,12
0.484,0.0001,101,103,50,10,0.0001,204,12
0.486,0.0001,153,151,50,10,0.0001,304,12
0.488,0.0001,203,201,50,10,0.0001,404,12
0.488,0.0001,254,250,50,10,0.0001,504,12
0.488,0.0001,306,298,50,10,0.0001,604,12
0.488,0.0001,352,352,50,10,0.0001,704,12
0.49,0.0001,395,409,50,10,0.0001,804,12
0.492,0.0001,441,463,50,10,0.0001,904,12
0.492,0.0001,499,505,50,10,0.0001,1004,12
0.492,0.0001,554,550,50,10,0.0001,1104,12
0.492,0.0001,599,605,50,10,0.0001,1204,12
0.492,0.0001,658,646,50,10,0.0001,1304,12
0.49,0.0001,706,698,50,10,0.0001,1404,12
0.49,0.0001,750,754,50,10,0.0001,1504,12
0.492,0.0001,802,802,50,10,0.0001,1604,12
0.492,0.0001,861,843,50,10,0.0001,1704,12
0.494,0.0001,912,892,50,10,0.0001,1804,12
0.496,0.0001,963,941,50,10,0.0001,1904,12
0.498,0.0001,1008,996,50,10,0.0001,2004,12
0.544,0.0001,49,55,50,10,0.0001,104,13
0.544,0.0001,98,106,50,10,0.0001,204,13
0.544,0.0001,144,160,50,10,0.0001,304,13
0.542,0.0001,193,211,50,10,0.0001,404,13
0.542,0.0001,241,263,50,10,0.0001,504,13
0.544,0.0001,285,319,50,10,0.0001,604,13
0.546,0.0001,338,366,50,10,0.0001,704,13
0.546,0.0001,392,412,50,10,0.0001,804,13
0.548,0.0001,440,464,50,10,0.0001,904,13
0.548,0.0001,489,515,50,10,0.0001,1004,13
0.55,0.0001,541,563,50,10,0.0001,1104,13
0.552,0.0001,594,610,50,10,0.0001,1204,13
0.552,0.0001,654,650,50,10,0.0001,1304,13
0.552,0.0001,705,699,50,10,0.0001,1404,13
0.55,0.0001,757,747,50,10,0.0001,1504,13
0.55,0.0001,807,797,50,10,0.0001,1604,13
0.55,0.0001,860,844,50,10,0.0001,1704,13
0.552,0.0001,910,894,50,10,0.0001,1804,13
0.552,0.0001,965,939,50,10,0.0001,1904,13
0.554,0.0001,1015,989,50,10,0.0001,2004,13
0.484,0.0001,43,61,50,10,0.0001,104,14
0.484,0.0001,92,112,50,10,0.0001,204,14
0.484,0.0001,141,163,50,10,0.0001,304,14
0.484,0.0001,194,210,50,10,0.0001,404,14
0.484,0.0001,238,266,50,10,0.0001,504,14
0.484,0.0001,286,318,50,10,0.0001,604,14
0.484,0.0001,339,365,50,10,0.0001,704,14
0.484,0.0001,392,412,50,10,0.0001,804,14
0.484,0.0001,450,454,50,10,0.0001,904,14
0.484,0.0001,496,508,50,10,0.0001,1004,14
0.486,0.0001,543,561,50,10,0.0001,1104,14
0.486,0.0001,591,613,50,10,0.0001,1204,14
0.486,0.0001,643,661,50,10,0.0001,1304,14
0.486,0.0001,701,703,50,10,0.0001,1404,14
0.486,0.0001,753,751,50,10,0.0001,1504,14
0.486,0.0001,802,802,50,10,0.0001,1604,14
0.486,0.0001,850,854,50,10,0.0001,1704,14
0.484,0.0001,893,911,50,10,0.0001,1804,14
0.486,0.0001,944,960,50,10,0.0001,1904,14
0.486,0.0001,995,1009,50,10,0.0001,2004,14
0.468,0.0001,51,53,50,10,0.0001,104,15
0.468,0.0001,99,105,50,10,0.0001,204,15
0.468,0.0001,152,152,50,10,0.0001,304,15
0.468,0.0001,203,201,50,10,0.0001,404,15
0.468,0.0001,252,252,50,10,0.0001,504,15
0.468,0.0001,296,308,50,10,0.0001,604,15
0.468,0.0001,341,363,50,10,0.0001,704,15
0.466,0.0001,395,409,50,10,0.0001,804,15
0.466,0.0001,445,459,50,10,0.0001,904,15
0.468,0.0001,488,516,50,10,0.0001,1004,15
0.47,0.0001,536,568,50,10,0.0001,1104,15
0.474,0.0001,593,611,50,10,0.0001,1204,15
0.472,0.0001,636,668,50,10,0.0001,1304,15
0.474,0.0001,690,714,50,10,0.0001,1404,15
0.474,0.0001,740,764,50,10,0.0001,1504,15
0.476,0.0001,796,808,50,10,0.0001,1604,15
0.478,0.0001,842,862,50,10,0.0001,1704,15
0.48,0.0001,895,909,50,10,0.0001,1804,15
0.48,0.0001,946,958,50,10,0.0001,1904,15
0.484,0.0001,995,1009,50,10,0.0001,2004,15
0.526,0.0001,55,49,50,10,0.0001,104,16
0.528,0.0001,101,103,50,10,0.0001,204,16
0.528,0.0001,156,148,50,10,0.0001,304,16
0.53,0.0001,210,194,50,10,0.0001,404,16
0.53,0.0001,261,243,50,10,0.0001,504,16
0.53,0.0001,303,301,50,10,0.0001,604,16
0.53,0.0001,352,352,50,10,0.0001,704,16
0.53,0.0001,405,399,50,10,0.0001,804,16
0.53,0.0001,453,451,50,10,0.0001,904,16
0.528,0.0001,511,493,50,10,0.0001,1004,16
0.526,0.0001,568,536,50,10,0.0001,1104,16
0.524,0.0001,611,593,50,10,0.0001,1204,16
0.526,0.0001,663,641,50,10,0.0001,1304,16
0.524,0.0001,716,688,50,10,0.0001,1404,16
0.526,0.0001,760,744,50,10,0.0001,1504,16
0.526,0.0001,812,792,50,10,0.0001,1604,16
0.53,0.0001,863,841,50,10,0.0001,1704,16
0.53,0.0001,912,892,50,10,0.0001,1804,16
0.528,0.0001,954,950,50,10,0.0001,1904,16
0.53,0.0001,1008,996,50,10,0.0001,2004,16
0.506,0.0001,56,48,50,10,0.0001,104,17
0.506,0.0001,101,103,50,10,0.0001,204,17
0.506,0.0001,158,146,50,10,0.0001,304,17
0.506,0.0001,205,199,50,10,0.0001,404,17
0.506,0.0001,254,250,50,10,0.0001,504,17
0.506,0.0001,296,308,50,10,0.0001,604,17
0.506,0.0001,350,354,50,10,0.0001,704,17
0.506,0.0001,396,408,50,10,0.0001,804,17
0.508,0.0001,449,455,50,10,0.0001,904,17
0.51,0.0001,499,505,50,10,0.0001,1004,17
0.504,0.0001,550,554,50,10,0.0001,1104,17
0.506,0.0001,598,606,50,10,0.0001,1204,17
0.508,0.0001,644,660,50,10,0.0001,1304,17
0.508,0.0001,693,711,50,10,0.0001,1404,17
0.508,0.0001,749,755,50,10,0.0001,1504,17
0.51,0.0001,804,800,50,10,0.0001,1604,17
0.51,0.0001,858,846,50,10,0.0001,1704,17
0.512,0.0001,908,896,50,10,0.0001,1804,17
0.514,0.0001,953,951,50,10,0.0001,1904,17
0.514,0.0001,1008,996,50,10,0.0001,2004,17
0.49,0.0001,62,42,50,10,0.0001,104,18
0.492,0.0001,121,83,50,10,0.0001,204,18
0.492,0.0001,171,133,50,10,0.0001,304,18
0.494,0.0001,212,192,50,10,0.0001,404,18
0.494,0.0001,260,244,50,10,0.0001,504,18
0.494,0.0001,307,297,50,10,0.0001,604,18
0.496,0.0001,354,350,50,10,0.0001,704,18
0.494,0.0001,402,402,50,10,0.0001,804,18
0.496,0.0001,443,461,50,10,0.0001,904,18
0.498,0.0001,498,506,50,10,0.0001,1004,18
0.498,0.0001,548,556,50,10,0.0001,1104,18
0.5,0.0001,594,610,50,10,0.0001,1204,18
0.502,0.0001,634,670,50,10,0.0001,1304,18
0.5,0.0001,677,727,50,10,0.0001,1404,18
0.498,0.0001,725,779,50,10,0.0001,1504,18
0.498,0.0001,770,834,50,10,0.0001,1604,18
0.506,0.0001,829,875,50,10,0.0001,1704,18
0.506,0.0001,879,925,50,10,0.0001,1804,18
0.506,0.0001,930,974,50,10,0.0001,1904,18
0.508,0.0001,990,1014,50,10,0.0001,2004,18
0.498,0.0001,36,68,50,10,0.0001,104,19
0.498,0.0001,85,119,50,10,0.0001,204,19
0.5,0.0001,132,172,50,10,0.0001,304,19
0.5,0.0001,174,230,50,10,0.0001,404,19
0.506,0.0001,227,277,50,10,0.0001,504,19
0.506,0.0001,283,321,50,10,0.0001,604,19
0.506,0.0001,331,373,50,10,0.0001,704,19
0.506,0.0001,384,420,50,10,0.0001,804,19
0.506,0.0001,434,470,50,10,0.0001,904,19
0.508,0.0001,484,520,50,10,0.0001,1004,19
0.508,0.0001,536,568,50,10,0.0001,1104,19
0.508,0.0001,586,618,50,10,0.0001,1204,19
0.51,0.0001,639,665,50,10,0.0001,1304,19
0.512,0.0001,691,713,50,10,0.0001,1404,19
0.512,0.0001,745,759,50,10,0.0001,1504,19
0.51,0.0001,796,808,50,10,0.0001,1604,19
0.512,0.0001,846,858,50,10,0.0001,1704,19
0.514,0.0001,899,905,50,10,0.0001,1804,19
0.518,0.0001,954,950,50,10,0.0001,1904,19
0.518,0.0001,999,1005,50,10,0.0001,2004,19
0.552,0.0001,43,61,50,10,0.0001,104,20
0.552,0.0001,97,107,50,10,0.0001,204,20
0.552,0.0001,146,158,50,10,0.0001,304,20
0.552,0.0001,201,203,50,10,0.0001,404,20
0.552,0.0001,264,240,50,10,0.0001,504,20
0.552,0.0001,327,277,50,10,0.0001,604,20
0.552,0.0001,388,316,50,10,0.0001,704,20
0.552,0.0001,442,362,50,10,0.0001,804,20
0.552,0.0001,487,417,50,10,0.0001,904,20
0.552,0.0001,539,465,50,10,0.0001,1004,20
0.552,0.0001,589,515,50,10,0.0001,1104,20
0.552,0.0001,634,570,50,10,0.0001,1204,20
0.552,0.0001,682,622,50,10,0.0001,1304,20
0.552,0.0001,731,673,50,10,0.0001,1404,20
0.552,0.0001,782,722,50,10,0.0001,1504,20
0.55,0.0001,834,770,50,10,0.0001,1604,20
0.55,0.0001,883,821,50,10,0.0001,1704,20
0.548,0.0001,924,880,50,10,0.0001,1804,20
0.548,0.0001,982,922,50,10,0.0001,1904,20
0.548,0.0001,1029,975,50,10,0.0001,2004,20
0.478,0.0001,43,61,50,10,0.001,104,1
0.476,0.0001,92,112,50,10,0.001,204,1
0.476,0.0001,144,160,50,10,0.001,304,1
0.478,0.0001,196,208,50,10,0.001,404,1
0.476,0.0001,240,264,50,10,0.001,504,1
0.48,0.0001,289,315,50,10,0.001,604,1
0.478,0.0001,343,361,50,10,0.001,704,1
0.478,0.0001,400,404,50,10,0.001,804,1
0.474,0.0001,447,457,50,10,0.001,904,1
0.48,0.0001,496,508,50,10,0.001,1004,1
0.484,0.0001,549,555,50,10,0.001,1104,1
0.482,0.0001,608,596,50,10,0.001,1204,1
0.486,0.0001,654,650,50,10,0.001,1304,1
0.492,0.0001,696,708,50,10,0.001,1404,1
0.502,0.0001,743,761,50,10,0.001,1504,1
0.502,0.0001,791,813,50,10,0.001,1604,1
0.504,0.0001,843,861,50,10,0.001,1704,1
0.506,0.0001,892,912,50,10,0.001,1804,1
0.514,0.0001,947,957,50,10,0.001,1904,1
0.522,0.0001,996,1008,50,10,0.001,2004,1
0.494,0.0001,54,50,50,10,0.001,104,2
0.494,0.0001,105,99,50,10,0.001,204,2
0.494,0.0001,154,150,50,10,0.001,304,2
0.494,0.0001,205,199,50,10,0.001,404,2
0.494,0.0001,253,251,50,10,0.001,504,2
0.494,0.0001,313,291,50,10,0.001,604,2
0.494,0.0001,356,348,50,10,0.001,704,2
0.494,0.0001,396,408,50,10,0.001,804,2
0.496,0.0001,441,463,50,10,0.001,904,2
0.496,0.0001,497,507,50,10,0.001,1004,2
0.496,0.0001,553,551,50,10,0.001,1104,2
0.496,0.0001,595,609,50,10,0.001,1204,2
0.496,0.0001,645,659,50,10,0.001,1304,2
0.496,0.0001,685,719,50,10,0.001,1404,2
0.5,0.0001,741,763,50,10,0.001,1504,2
0.5,0.0001,791,813,50,10,0.001,1604,2
0.502,0.0001,845,859,50,10,0.001,1704,2
0.506,0.0001,897,907,50,10,0.001,1804,2
0.504,0.0001,944,960,50,10,0.001,1904,2
0.508,0.0001,999,1005,50,10,0.001,2004,2
0.504,0.0001,54,50,50,10,0.001,104,3
0.504,0.0001,106,98,50,10,0.001,204,3
0.506,0.0001,158,146,50,10,0.001,304,3
0.506,0.0001,205,199,50,10,0.001,404,3
0.506,0.0001,252,252,50,10,0.001,504,3
0.502,0.0001,295,309,50,10,0.001,604,3
0.502,0.0001,344,360,50,10,0.001,704,3
0.5,0.0001,395,409,50,10,0.001,804,3
0.498,0.0001,449,455,50,10,0.001,904,3
0.498,0.0001,511,493,50,10,0.001,1004,3
0.502,0.0001,561,543,50,10,0.001,1104,3
0.5,0.0001,612,592,50,10,0.001,1204,3
0.496,0.0001,671,633,50,10,0.001,1304,3
0.496,0.0001,715,689,50,10,0.001,1404,3
0.502,0.0001,766,738,50,10,0.001,1504,3
0.51,0.0001,809,795,50,10,0.001,1604,3
0.52,0.0001,861,843,50,10,0.001,1704,3
0.53,0.0001,908,896,50,10,0.001,1804,3
0.546,0.0001,951,953,50,10,0.001,1904,3
0.564,0.0001,996,1008,50,10,0.001,2004,3
0.476,0.0001,53,51,50,10,0.001,104,4
0.476,0.0001,100,104,50,10,0.001,204,4
0.476,0.0001,155,149,50,10,0.001,304,4
0.474,0.0001,213,191,50,10,0.001,404,4
0.466,0.0001,258,246,50,10,0.001,504,4
0.462,0.0001,315,289,50,10,0.001,604,4
0.462,0.0001,358,346,50,10,0.001,704,4
0.464,0.0001,405,399,50,10,0.001,804,4
0.464,0.0001,446,458,50,10,0.001,904,4
0.476,0.0001,490,514,50,10,0.001,1004,4
0.484,0.0001,537,567,50,10,0.001,1104,4
0.492,0.0001,581,623,50,10,0.001,1204,4
0.496,0.0001,643,661,50,10,0.001,1304,4
0.506,0.0001,692,712,50,10,0.001,1404,4
0.508,0.0001,745,759,50,10,0.001,1504,4
0.514,0.0001,792,812,50,10,0.001,1604,4
0.52,0.0001,843,861,50,10,0.001,1704,4
0.526,0.0001,894,910,50,10,0.001,1804,4
0.54,0.0001,948,956,50,10,0.001,1904,4
0.544,0.0001,1003,1001,50,10,0.001,2004,4
0.514,0.0001,54,50,50,10,0.001,104,5
0.512,0.0001,99,105,50,10,0.001,204,5
0.514,0.0001,146,158,50,10,0.001,304,5
0.514,0.0001,197,207,50,10,0.001,404,5
0.514,0.0001,250,254,50,10,0.001,504,5
0.518,0.0001,303,301,50,10,0.001,604,5
0.522,0.0001,345,359,50,10,0.001,704,5
0.522,0.0001,396,408,50,10,0.001,804,5
0.526,0.0001,437,467,50,10,0.001,904,5
0.528,0.0001,489,515,50,10,0.001,1004,5
0.528,0.0001,553,551,50,10,0.001,1104,5
0.534,0.0001,604,600,50,10,0.001,1204,5
0.542,0.0001,654,650,50,10,0.001,1304,5
0.54,0.0001,692,712,50,10,0.001,1404,5
0.542,0.0001,748,756,50,10,0.001,1504,5
0.552,0.0001,797,807,50,10,0.001,1604,5
0.548,0.0001,855,849,50,10,0.001,1704,5
0.57,0.0001,908,896,50,10,0.001,1804,5
0.572,0.0001,960,944,50,10,0.001,1904,5
0.584,0.0001,1003,1001,50,10,0.001,2004,5
0.542,0.0001,57,47,50,10,0.001,104,6
0.54,0.0001,99,105,50,10,0.001,204,6
0.542,0.0001,146,158,50,10,0.001,304,6
0.544,0.0001,197,207,50,10,0.001,404,6
0.546,0.0001,248,256,50,10,0.001,504,6
0.546,0.0001,296,308,50,10,0.001,604,6
0.544,0.0001,345,359,50,10,0.001,704,6
0.538,0.0001,397,407,50,10,0.001,804,6
0.538,0.0001,447,457,50,10,0.001,904,6
0.54,0.0001,506,498,50,10,0.001,1004,6
0.54,0.0001,551,553,50,10,0.001,1104,6
0.542,0.0001,610,594,50,10,0.001,1204,6
0.542,0.0001,664,640,50,10,0.001,1304,6
0.542,0.0001,716,688,50,10,0.001,1404,6
0.542,0.0001,766,738,50,10,0.001,1504,6
0.542,0.0001,820,784,50,10,0.001,1604,6
0.548,0.0001,862,842,50,10,0.001,1704,6
0.546,0.0001,909,895,50,10,0.001,1804,6
0.556,0.0001,963,941,50,10,0.001,1904,6
0.56,0.0001,1019,985,50,10,0.001,2004,6
0.494,0.0001,50,54,50,10,0.001,104,7
0.496,0.0001,99,105,50,10,0.001,204,7
0.496,0.0001,152,152,50,10,0.001,304,7
0.498,0.0001,201,203,50,10,0.001,404,7
0.504,0.0001,248,256,50,10,0.001,504,7
0.502,0.0001,294,310,50,10,0.001,604,7
0.51,0.0001,336,368,50,10,0.001,704,7
0.51,0.0001,396,408,50,10,0.001,804,7
0.508,0.0001,450,454,50,10,0.001,904,7
0.522,0.0001,500,504,50,10,0.001,1004,7
0.518,0.0001,558,546,50,10,0.001,1104,7
0.526,0.0001,610,594,50,10,0.001,1204,7
0.53,0.0001,660,644,50,10,0.001,1304,7
0.548,0.0001,709,695,50,10,0.001,1404,7
0.556,0.0001,758,746,50,10,0.001,1504,7
0.57,0.0001,805,799,50,10,0.001,1604,7
0.588,0.0001,850,854,50,10,0.001,1704,7
0.59,0.0001,906,898,50,10,0.001,1804,7
0.606,0.0001,957,947,50,10,0.001,1904,7
0.618,0.0001,1003,1001,50,10,0.001,2004,7
0.458,0.0001,52,52,50,10,0.001,104,8
0.46,0.0001,104,100,50,10,0.001,204,8
0.464,0.0001,149,155,50,10,0.001,304,8
0.472,0.0001,194,210,50,10,0.001,404,8
0.482,0.0001,247,257,50,10,0.001,504,8
0.494,0.0001,302,302,50,10,0.001,604,8
0.49,0.0001,350,354,50,10,0.001,704,8
0.494,0.0001,400,404,50,10,0.001,804,8
0.49,0.0001,445,459,50,10,0.001,904,8
0.494,0.0001,493,511,50,10,0.001,1004,8
0.5,0.0001,541,563,50,10,0.001,1104,8
0.51,0.0001,588,616,50,10,0.001,1204,8
0.52,0.0001,638,666,50,10,0.001,1304,8
0.532,0.0001,676,728,50,10,0.001,1404,8
0.536,0.0001,727,777,50,10,0.001,1504,8
0.54,0.0001,776,828,50,10,0.001,1604,8
0.564,0.0001,818,886,50,10,0.001,1704,8
0.568,0.0001,873,931,50,10,0.001,1804,8
0.584,0.0001,927,977,50,10,0.001,1904,8
0.614,0.0001,979,1025,50,10,0.001,2004,8
0.494,0.0001,60,44,50,10,0.001,104,9
0.496,0.0001,106,98,50,10,0.001,204,9
0.502,0.0001,148,156,50,10,0.001,304,9
0.508,0.0001,204,200,50,10,0.001,404,9
0.506,0.0001,256,248,50,10,0.001,504,9
0.504,0.0001,306,298,50,10,0.001,604,9
0.504,0.0001,354,350,50,10,0.001,704,9
0.508,0.0001,402,402,50,10,0.001,804,9
0.512,0.0001,455,449,50,10,0.001,904,9
0.518,0.0001,512,492,50,10,0.001,1004,9
0.526,0.0001,557,547,50,10,0.001,1104,9
0.532,0.0001,603,601,50,10,0.001,1204,9
0.538,0.0001,646,658,50,10,0.001,1304,9
0.542,0.0001,704,700,50,10,0.001,1404,9
0.542,0.0001,758,746,50,10,0.001,1504,9
0.548,0.0001,811,793,50,10,0.001,1604,9
0.552,0.0001,865,839,50,10,0.001,1704,9
0.576,0.0001,916,888,50,10,0.001,1804,9
0.574,0.0001,961,943,50,10,0.001,1904,9
0.58,0.0001,1010,994,50,10,0.001,2004,9
0.456,0.0001,56,48,50,10,0.001,104,10
0.456,0.0001,107,97,50,10,0.001,204,10
0.456,0.0001,158,146,50,10,0.001,304,10
0.458,0.0001,211,193,50,10,0.001,404,10
0.462,0.0001,260,244,50,10,0.001,504,10
0.464,0.0001,309,295,50,10,0.001,604,10
0.462,0.0001,361,343,50,10,0.001,704,10
0.458,0.0001,413,391,50,10,0.001,804,10
0.458,0.0001,466,438,50,10,0.001,904,10
0.46,0.0001,515,489,50,10,0.001,1004,10
0.46,0.0001,563,541,50,10,0.001,1104,10
0.472,0.0001,609,595,50,10,0.001,1204,10
0.49,0.0001,659,645,50,10,0.001,1304,10
0.5,0.0001,712,692,50,10,0.001,1404,10
0.5,0.0001,759,745,50,10,0.001,1504,10
0.508,0.0001,809,795,50,10,0.001,1604,10
0.528,0.0001,850,854,50,10,0.001,1704,10
0.532,0.0001,901,903,50,10,0.001,1804,10
0.552,0.0001,945,959,50,10,0.001,1904,10
0.564,0.0001,993,1011,50,10,0.001,2004,10
0.44,0.0001,53,51,50,10,0.001,104,11
0.44,0.0001,102,102,50,10,0.001,204,11
0.44,0.0001,149,155,50,10,0.001,304,11
0.44,0.0001,199,205,50,10,0.001,404,11
0.44,0.0001,248,256,50,10,0.001,504,11
0.44,0.0001,291,313,50,10,0.001,604,11
0.44,0.0001,333,371,50,10,0.001,704,11
0.44,0.0001,383,421,50,10,0.001,804,11
0.44,0.0001,422,482,50,10,0.001,904,11
0.442,0.0001,474,530,50,10,0.001,1004,11
0.442,0.0001,528,576,50,10,0.001,1104,11
0.442,0.0001,577,627,50,10,0.001,1204,11
0.442,0.0001,623,681,50,10,0.001,1304,11
0.444,0.0001,670,734,50,10,0.001,1404,11
0.448,0.0001,722,782,50,10,0.001,1504,11
0.45,0.0001,770,834,50,10,0.001,1604,11
0.45,0.0001,818,886,50,10,0.001,1704,11
0.45,0.0001,872,932,50,10,0.001,1804,11
0.45,0.0001,922,982,50,10,0.001,1904,11
0.452,0.0001,972,1032,50,10,0.001,2004,11
0.532,0.0001,50,54,50,10,0.001,104,12
0.532,0.0001,96,108,50,10,0.001,204,12
0.534,0.0001,135,169,50,10,0.001,304,12
0.536,0.0001,184,220,50,10,0.001,404,12
0.536,0.0001,236,268,50,10,0.001,504,12
0.536,0.0001,274,330,50,10,0.001,604,12
0.536,0.0001,317,387,50,10,0.001,704,12
0.536,0.0001,365,439,50,10,0.001,804,12
0.534,0.0001,419,485,50,10,0.001,904,12
0.534,0.0001,465,539,50,10,0.001,1004,12
0.542,0.0001,516,588,50,10,0.001,1104,12
0.554,0.0001,563,641,50,10,0.001,1204,12
0.546,0.0001,623,681,50,10,0.001,1304,12
0.552,0.0001,680,724,50,10,0.001,1404,12
0.544,0.0001,735,769,50,10,0.001,1504,12
0.552,0.0001,787,817,50,10,0.001,1604,12
0.544,0.0001,835,869,50,10,0.001,1704,12
0.556,0.0001,890,914,50,10,0.001,1804,12
0.57,0.0001,939,965,50,10,0.001,1904,12
0.58,0.0001,985,1019,50,10,0.001,2004,12
0.51,0.0001,55,49,50,10,0.001,104,13
0.508,0.0001,109,95,50,10,0.001,204,13
0.51,0.0001,154,150,50,10,0.001,304,13
0.512,0.0001,200,204,50,10,0.001,404,13
0.51,0.0001,252,252,50,10,0.001,504,13
0.512,0.0001,302,302,50,10,0.001,604,13
0.52,0.0001,357,347,50,10,0.001,704,13
0.522,0.0001,401,403,50,10,0.001,804,13
0.518,0.0001,455,449,50,10,0.001,904,13
0.52,0.0001,501,503,50,10,0.001,1004,13
0.52,0.0001,549,555,50,10,0.001,1104,13
0.526,0.0001,594,610,50,10,0.001,1204,13
0.522,0.0001,643,661,50,10,0.001,1304,13
0.534,0.0001,690,714,50,10,0.001,1404,13
0.546,0.0001,746,758,50,10,0.001,1504,13
0.556,0.0001,795,809,50,10,0.001,1604,13
0.558,0.0001,842,862,50,10,0.001,1704,13
0.556,0.0001,891,913,50,10,0.001,1804,13
0.558,0.0001,945,959,50,10,0.001,1904,13
0.568,0.0001,1008,996,50,10,0.001,2004,13
0.48,0.0001,52,52,50,10,0.001,104,14
0.482,0.0001,107,97,50,10,0.001,204,14
0.484,0.0001,159,145,50,10,0.001,304,14
0.482,0.0001,208,196,50,10,0.001,404,14
0.484,0.0001,259,245,50,10,0.001,504,14
0.486,0.0001,300,304,50,10,0.001,604,14
0.486,0.0001,348,356,50,10,0.001,704,14
0.488,0.0001,392,412,50,10,0.001,804,14
0.49,0.0001,444,460,50,10,0.001,904,14
0.492,0.0001,495,509,50,10,0.001,1004,14
0.496,0.0001,543,561,50,10,0.001,1104,14
0.496,0.0001,593,611,50,10,0.001,1204,14
0.498,0.0001,644,660,50,10,0.001,1304,14
0.512,0.0001,693,711,50,10,0.001,1404,14
0.528,0.0001,746,758,50,10,0.001,1504,14
0.546,0.0001,798,806,50,10,0.001,1604,14
0.554,0.0001,855,849,50,10,0.001,1704,14
0.558,0.0001,897,907,50,10,0.001,1804,14
0.562,0.0001,942,962,50,10,0.001,1904,14
0.578,0.0001,1004,1000,50,10,0.001,2004,14
0.512,0.0001,51,53,50,10,0.001,104,15
0.506,0.0001,107,97,50,10,0.001,204,15
0.51,0.0001,172,132,50,10,0.001,304,15
0.514,0.0001,211,193,50,10,0.001,404,15
0.52,0.0001,249,255,50,10,0.001,504,15
0.518,0.0001,298,306,50,10,0.001,604,15
0.518,0.0001,348,356,50,10,0.001,704,15
0.516,0.0001,396,408,50,10,0.001,804,15
0.52,0.0001,459,445,50,10,0.001,904,15
0.522,0.0001,506,498,50,10,0.001,1004,15
0.532,0.0001,564,540,50,10,0.001,1104,15
0.542,0.0001,608,596,50,10,0.001,1204,15
0.552,0.0001,651,653,50,10,0.001,1304,15
0.548,0.0001,701,703,50,10,0.001,1404,15
0.558,0.0001,748,756,50,10,0.001,1504,15
0.568,0.0001,797,807,50,10,0.001,1604,15
0.576,0.0001,850,854,50,10,0.001,1704,15
0.584,0.0001,898,906,50,10,0.001,1804,15
0.596,0.0001,947,957,50,10,0.001,1904,15
0.616,0.0001,998,1006,50,10,0.001,2004,15
0.466,0.0001,51,53,50,10,0.001,104,16
0.474,0.0001,104,100,50,10,0.001,204,16
0.476,0.0001,151,153,50,10,0.001,304,16
0.48,0.0001,203,201,50,10,0.001,404,16
0.484,0.0001,251,253,50,10,0.001,504,16
0.482,0.0001,302,302,50,10,0.001,604,16
0.486,0.0001,360,344,50,10,0.001,704,16
0.486,0.0001,412,392,50,10,0.001,804,16
0.496,0.0001,461,443,50,10,0.001,904,16
0.498,0.0001,509,495,50,10,0.001,1004,16
0.496,0.0001,566,538,50,10,0.001,1104,16
0.486,0.0001,617,587,50,10,0.001,1204,16
0.496,0.0001,668,636,50,10,0.001,1304,16
0.514,0.0001,707,697,50,10,0.001,1404,16
0.51,0.0001,757,747,50,10,0.001,1504,16
0.524,0.0001,799,805,50,10,0.001,1604,16
0.532,0.0001,849,855,50,10,0.001,1704,16
0.538,0.0001,894,910,50,10,0.001,1804,16
0.542,0.0001,950,954,50,10,0.001,1904,16
0.556,0.0001,998,1006,50,10,0.001,2004,16
0.49,0.0001,55,49,50,10,0.001,104,17
0.498,0.0001,109,95,50,10,0.001,204,17
0.502,0.0001,163,141,50,10,0.001,304,17
0.508,0.0001,204,200,50,10,0.001,404,17
0.508,0.0001,251,253,50,10,0.001,504,17
0.504,0.0001,301,303,50,10,0.001,604,17
0.508,0.0001,351,353,50,10,0.001,704,17
0.512,0.0001,407,397,50,10,0.001,804,17
0.524,0.0001,464,440,50,10,0.001,904,17
0.526,0.0001,505,499,50,10,0.001,1004,17
0.528,0.0001,555,549,50,10,0.001,1104,17
0.538,0.0001,605,599,50,10,0.001,1204,17
0.544,0.0001,653,651,50,10,0.001,1304,17
0.546,0.0001,703,701,50,10,0.001,1404,17
0.554,0.0001,752,752,50,10,0.001,1504,17
0.574,0.0001,802,802,50,10,0.001,1604,17
0.574,0.0001,851,853,50,10,0.001,1704,17
0.58,0.0001,899,905,50,10,0.001,1804,17
0.594,0.0001,943,961,50,10,0.001,1904,17
0.616,0.0001,998,1006,50,10,0.001,2004,17
0.43,0.0001,52,52,50,10,0.001,104,18
0.43,0.0001,106,98,50,10,0.001,204,18
0.432,0.0001,146,158,50,10,0.001,304,18
0.43,0.0001,198,206,50,10,0.001,404,18
0.43,0.0001,251,253,50,10,0.001,504,18
0.438,0.0001,302,302,50,10,0.001,604,18
0.438,0.0001,362,342,50,10,0.001,704,18
0.444,0.0001,406,398,50,10,0.001,804,18
0.46,0.0001,449,455,50,10,0.001,904,18
0.46,0.0001,499,505,50,10,0.001,1004,18
0.458,0.0001,554,550,50,10,0.001,1104,18
0.478,0.0001,596,608,50,10,0.001,1204,18
0.48,0.0001,646,658,50,10,0.001,1304,18
0.49,0.0001,694,710,50,10,0.001,1404,18
0.498,0.0001,730,774,50,10,0.001,1504,18
0.508,0.0001,778,826,50,10,0.001,1604,18
0.522,0.0001,828,876,50,10,0.001,1704,18
0.534,0.0001,883,921,50,10,0.001,1804,18
0.55,0.0001,935,969,50,10,0.001,1904,18
0.568,0.0001,982,1022,50,10,0.001,2004,18
0.552,0.0001,48,56,50,10,0.001,104,19
0.554,0.0001,96,108,50,10,0.001,204,19
0.558,0.0001,139,165,50,10,0.001,304,19
0.554,0.0001,192,212,50,10,0.001,404,19
0.538,0.0001,246,258,50,10,0.001,504,19
0.548,0.0001,288,316,50,10,0.001,604,19
0.546,0.0001,338,366,50,10,0.001,704,19
0.546,0.0001,385,419,50,10,0.001,804,19
0.554,0.0001,440,464,50,10,0.001,904,19
0.552,0.0001,485,519,50,10,0.001,1004,19
0.558,0.0001,538,566,50,10,0.001,1104,19
0.562,0.0001,593,611,50,10,0.001,1204,19
0.57,0.0001,642,662,50,10,0.001,1304,19
0.576,0.0001,694,710,50,10,0.001,1404,19
0.578,0.0001,749,755,50,10,0.001,1504,19
0.584,0.0001,798,806,50,10,0.001,1604,19
0.586,0.0001,848,856,50,10,0.001,1704,19
0.594,0.0001,902,902,50,10,0.001,1804,19
0.608,0.0001,951,953,50,10,0.001,1904,19
0.614,0.0001,999,1005,50,10,0.001,2004,19
0.506,0.0001,56,48,50,10,0.001,104,20
0.504,0.0001,104,100,50,10,0.001,204,20
0.504,0.0001,151,153,50,10,0.001,304,20
0.504,0.0001,198,206,50,10,0.001,404,20
0.502,0.0001,254,250,50,10,0.001,504,20
0.506,0.0001,302,302,50,10,0.001,604,20
0.508,0.0001,346,358,50,10,0.001,704,20
0.516,0.0001,399,405,50,10,0.001,804,20
0.518,0.0001,450,454,50,10,0.001,904,20
0.528,0.0001,495,509,50,10,0.001,1004,20
0.53,0.0001,547,557,50,10,0.001,1104,20
0.538,0.0001,599,605,50,10,0.001,1204,20
0.55,0.0001,651,653,50,10,0.001,1304,20
0.582,0.0001,695,709,50,10,0.001,1404,20
0.582,0.0001,748,756,50,10,0.001,1504,20
0.594,0.0001,806,798,50,10,0.001,1604,20
0.586,0.0001,851,853,50,10,0.001,1704,20
0.606,0.0001,902,902,50,10,0.001,1804,20
0.62,0.0001,945,959,50,10,0.001,1904,20
0.638,0.0001,992,1012,50,10,0.001,2004,20
0.526,0.0001,53,51,50,10,0.01,104,1
0.548,0.0001,101,103,50,10,0.01,204,1
0.564,0.0001,144,160,50,10,0.01,304,1
0.572,0.0001,195,209,50,10,0.01,404,1
0.598,0.0001,245,259,50,10,0.01,504,1
0.582,0.0001,293,311,50,10,0.01,604,1
0.614,0.0001,346,358,50,10,0.01,704,1
0.632,0.0001,403,401,50,10,0.01,804,1
0.652,0.0001,449,455,50,10,0.01,904,1
0.684,0.0001,501,503,50,10,0.01,1004,1
0.716,0.0001,543,561,50,10,0.01,1104,1
0.766,0.0001,594,610,50,10,0.01,1204,1
0.82,0.0001,631,673,50,10,0.01,1304,1
0.86,0.0001,684,720,50,10,0.01,1404,1
0.914,0.0001,736,768,50,10,0.01,1504,1
0.93,0.0001,788,816,50,10,0.01,1604,1
0.936,0.0001,842,862,50,10,0.01,1704,1
0.95,0.0001,900,904,50,10,0.01,1804,1
0.954,0.0001,950,954,50,10,0.01,1904,1
0.96,0.0001,1005,999,50,10,0.01,2004,1
0.474,0.0001,58,46,50,10,0.01,104,2
0.482,0.0001,117,87,50,10,0.01,204,2
0.486,0.0001,176,128,50,10,0.01,304,2
0.504,0.0001,233,171,50,10,0.01,404,2
0.514,0.0001,290,214,50,10,0.01,504,2
0.554,0.0001,335,269,50,10,0.01,604,2
0.574,0.0001,389,315,50,10,0.01,704,2
0.604,0.0001,439,365,50,10,0.01,804,2
0.638,0.0001,490,414,50,10,0.01,904,2
0.7,0.0001,544,460,50,10,0.01,1004,2
0.71,0.0001,591,513,50,10,0.01,1104,2
0.77,0.0001,638,566,50,10,0.01,1204,2
0.81,0.0001,692,612,50,10,0.01,1304,2
0.86,0.0001,743,661,50,10,0.01,1404,2
0.892,0.0001,790,714,50,10,0.01,1504,2
0.93,0.0001,828,776,50,10,0.01,1604,2
0.932,0.0001,872,832,50,10,0.01,1704,2
0.944,0.0001,922,882,50,10,0.01,1804,2
0.946,0.0001,970,934,50,10,0.01,1904,2
0.95,0.0001,1021,983,50,10,0.01,2004,2
0.53,0.0001,52,52,50,10,0.01,104,3
0.544,0.0001,104,100,50,10,0.01,204,3
0.552,0.0001,158,146,50,10,0.01,304,3
0.548,0.0001,204,200,50,10,0.01,404,3
0.572,0.0001,251,253,50,10,0.01,504,3
0.614,0.0001,301,303,50,10,0.01,604,3
0.632,0.0001,351,353,50,10,0.01,704,3
0.646,0.0001,403,401,50,10,0.01,804,3
0.668,0.0001,457,447,50,10,0.01,904,3
0.68,0.0001,500,504,50,10,0.01,1004,3
0.706,0.0001,558,546,50,10,0.01,1104,3
0.756,0.0001,612,592,50,10,0.01,1204,3
0.8,0.0001,666,638,50,10,0.01,1304,3
0.828,0.0001,714,690,50,10,0.01,1404,3
0.866,0.0001,761,743,50,10,0.01,1504,3
0.908,0.0001,810,794,50,10,0.01,1604,3
0.924,0.0001,855,849,50,10,0.01,1704,3
0.93,0.0001,911,893,50,10,0.01,1804,3
0.94,0.0001,963,941,50,10,0.01,1904,3
0.946,0.0001,1012,992,50,10,0.01,2004,3
0.522,0.0001,55,49,50,10,0.01,104,4
0.532,0.0001,105,99,50,10,0.01,204,4
0.552,0.0001,148,156,50,10,0.01,304,4
0.546,0.0001,199,205,50,10,0.01,404,4
0.544,0.0001,248,256,50,10,0.01,504,4
0.546,0.0001,305,299,50,10,0.01,604,4
0.576,0.0001,358,346,50,10,0.01,704,4
0.612,0.0001,399,405,50,10,0.01,804,4
0.662,0.0001,449,455,50,10,0.01,904,4
0.714,0.0001,500,504,50,10,0.01,1004,4
0.734,0.0001,545,559,50,10,0.01,1104,4
0.798,0.0001,599,605,50,10,0.01,1204,4
0.83,0.0001,644,660,50,10,0.01,1304,4
0.868,0.0001,698,706,50,10,0.01,1404,4
0.888,0.0001,744,760,50,10,0.01,1504,4
0.924,0.0001,793,811,50,10,0.01,1604,4
0.94,0.0001,836,868,50,10,0.01,1704,4
0.942,0.0001,888,916,50,10,0.01,1804,4
0.95,0.0001,936,968,50,10,0.01,1904,4
0.952,0.0001,977,1027,50,10,0.01,2004,4
0.478,0.0001,55,49,50,10,0.01,104,5
0.49,0.0001,98,106,50,10,0.01,204,5
0.498,0.0001,147,157,50,10,0.01,304,5
0.51,0.0001,191,213,50,10,0.01,404,5
0.51,0.0001,240,264,50,10,0.01,504,5
0.558,0.0001,290,314,50,10,0.01,604,5
0.582,0.0001,334,370,50,10,0.01,704,5
0.606,0.0001,385,419,50,10,0.01,804,5
0.65,0.0001,437,467,50,10,0.01,904,5
0.71,0.0001,485,519,50,10,0.01,1004,5
0.754,0.0001,539,565,50,10,0.01,1104,5
0.804,0.0001,589,615,50,10,0.01,1204,5
0.838,0.0001,647,657,50,10,0.01,1304,5
0.87,0.0001,688,716,50,10,0.01,1404,5
0.894,0.0001,746,758,50,10,0.01,1504,5
0.924,0.0001,791,813,50,10,0.01,1604,5
0.936,0.0001,845,859,50,10,0.01,1704,5
0.934,0.0001,898,906,50,10,0.01,1804,5
0.952,0.0001,955,949,50,10,0.01,1904,5
0.95,0.0001,1006,998,50,10,0.01,2004,5
0.52,0.0001,47,57,50,10,0.01,104,6
0.576,0.0001,90,114,50,10,0.01,204,6
0.578,0.0001,138,166,50,10,0.01,304,6
0.584,0.0001,182,222,50,10,0.01,404,6
0.586,0.0001,230,274,50,10,0.01,504,6
0.598,0.0001,285,319,50,10,0.01,604,6
0.616,0.0001,336,368,50,10,0.01,704,6
0.662,0.0001,382,422,50,10,0.01,804,6
0.668,0.0001,432,472,50,10,0.01,904,6
0.724,0.0001,488,516,50,10,0.01,1004,6
0.764,0.0001,550,554,50,10,0.01,1104,6
0.802,0.0001,594,610,50,10,0.01,1204,6
0.826,0.0001,643,661,50,10,0.01,1304,6
0.854,0.0001,696,708,50,10,0.01,1404,6
0.872,0.0001,745,759,50,10,0.01,1504,6
0.904,0.0001,794,810,50,10,0.01,1604,6
0.904,0.0001,845,859,50,10,0.01,1704,6
0.922,0.0001,893,911,50,10,0.01,1804,6
0.936,0.0001,942,962,50,10,0.01,1904,6
0.94,0.0001,992,1012,50,10,0.01,2004,6
0.466,0.0001,55,49,50,10,0.01,104,7
0.486,0.0001,116,88,50,10,0.01,204,7
0.506,0.0001,175,129,50,10,0.01,304,7
0.524,0.0001,230,174,50,10,0.01,404,7
0.552,0.0001,282,222,50,10,0.01,504,7
0.566,0.0001,330,274,50,10,0.01,604,7
0.586,0.0001,381,323,50,10,0.01,704,7
0.616,0.0001,426,378,50,10,0.01,804,7
0.644,0.0001,474,430,50,10,0.01,904,7
0.69,0.0001,531,473,50,10,0.01,1004,7
0.73,0.0001,575,529,50,10,0.01,1104,7
0.792,0.0001,625,579,50,10,0.01,1204,7
0.864,0.0001,668,636,50,10,0.01,1304,7
0.9,0.0001,718,686,50,10,0.01,1404,7
0.94,0.0001,764,740,50,10,0.01,1504,7
0.956,0.0001,816,788,50,10,0.01,1604,7
0.966,0.0001,862,842,50,10,0.01,1704,7
0.968,0.0001,918,886,50,10,0.01,1804,7
0.97,0.0001,969,935,50,10,0.01,1904,7
0.966,0.0001,1023,981,50,10,0.01,2004,7
0.544,0.0001,52,52,50,10,0.01,104,8
0.558,0.0001,101,103,50,10,0.01,204,8
0.568,0.0001,150,154,50,10,0.01,304,8
0.566,0.0001,194,210,50,10,0.01,404,8
0.572,0.0001,244,260,50,10,0.01,504,8
0.6,0.0001,298,306,50,10,0.01,604,8
0.618,0.0001,348,356,50,10,0.01,704,8
0.658,0.0001,394,410,50,10,0.01,804,8
0.698,0.0001,442,462,50,10,0.01,904,8
0.742,0.0001,500,504,50,10,0.01,1004,8
0.802,0.0001,554,550,50,10,0.01,1104,8
0.828,0.0001,597,607,50,10,0.01,1204,8
0.84,0.0001,634,670,50,10,0.01,1304,8
0.884,0.0001,688,716,50,10,0.01,1404,8
0.906,0.0001,740,764,50,10,0.01,1504,8
0.922,0.0001,804,800,50,10,0.01,1604,8
0.934,0.0001,854,850,50,10,0.01,1704,8
0.938,0.0001,900,904,50,10,0.01,1804,8
0.94,0.0001,955,949,50,10,0.01,1904,8
0.942,0.0001,1001,1003,50,10,0.01,2004,8
0.518,0.0001,58,46,50,10,0.01,104,9
0.518,0.0001,101,103,50,10,0.01,204,9
0.524,0.0001,156,148,50,10,0.01,304,9
0.53,0.0001,201,203,50,10,0.01,404,9
0.548,0.0001,253,251,50,10,0.01,504,9
0.546,0.0001,305,299,50,10,0.01,604,9
0.57,0.0001,361,343,50,10,0.01,704,9
0.58,0.0001,408,396,50,10,0.01,804,9
0.62,0.0001,462,442,50,10,0.01,904,9
0.686,0.0001,513,491,50,10,0.01,1004,9
0.754,0.0001,565,539,50,10,0.01,1104,9
0.814,0.0001,615,589,50,10,0.01,1204,9
0.844,0.0001,662,642,50,10,0.01,1304,9
0.902,0.0001,713,691,50,10,0.01,1404,9
0.926,0.0001,775,729,50,10,0.01,1504,9
0.948,0.0001,818,786,50,10,0.01,1604,9
0.956,0.0001,869,835,50,10,0.01,1704,9
0.96,0.0001,920,884,50,10,0.01,1804,9
0.968,0.0001,960,944,50,10,0.01,1904,9
0.97,0.0001,1000,1004,50,10,0.01,2004,9
0.508,0.0001,44,60,50,10,0.01,104,10
0.53,0.0001,94,110,50,10,0.01,204,10
0.542,0.0001,138,166,50,10,0.01,304,10
0.546,0.0001,182,222,50,10,0.01,404,10
0.558,0.0001,236,268,50,10,0.01,504,10
0.558,0.0001,287,317,50,10,0.01,604,10
0.562,0.0001,331,373,50,10,0.01,704,10
0.6,0.0001,386,418,50,10,0.01,804,10
0.644,0.0001,433,471,50,10,0.01,904,10
0.706,0.0001,483,521,50,10,0.01,1004,10
0.73,0.0001,534,570,50,10,0.01,1104,10
0.778,0.0001,581,623,50,10,0.01,1204,10
0.804,0.0001,643,661,50,10,0.01,1304,10
0.83,0.0001,706,698,50,10,0.01,1404,10
0.848,0.0001,755,749,50,10,0.01,1504,10
0.874,0.0001,807,797,50,10,0.01,1604,10
0.866,0.0001,855,849,50,10,0.01,1704,10
0.898,0.0001,898,906,50,10,0.01,1804,10
0.916,0.0001,942,962,50,10,0.01,1904,10
0.918,0.0001,993,1011,50,10,0.01,2004,10
0.516,0.0001,52,52,50,10,0.01,104,11
0.55,0.0001,99,105,50,10,0.01,204,11
0.536,0.0001,148,156,50,10,0.01,304,11
0.56,0.0001,190,214,50,10,0.01,404,11
0.568,0.0001,240,264,50,10,0.01,504,11
0.586,0.0001,295,309,50,10,0.01,604,11
0.598,0.0001,352,352,50,10,0.01,704,11
0.644,0.0001,404,400,50,10,0.01,804,11
0.7,0.0001,463,441,50,10,0.01,904,11
0.742,0.0001,511,493,50,10,0.01,1004,11
0.79,0.0001,558,546,50,10,0.01,1104,11
0.822,0.0001,608,596,50,10,0.01,1204,11
0.862,0.0001,660,644,50,10,0.01,1304,11
0.892,0.0001,717,687,50,10,0.01,1404,11
0.906,0.0001,766,738,50,10,0.01,1504,11
0.918,0.0001,800,804,50,10,0.01,1604,11
0.922,0.0001,849,855,50,10,0.01,1704,11
0.934,0.0001,891,913,50,10,0.01,1804,11
0.938,0.0001,943,961,50,10,0.01,1904,11
0.942,0.0001,994,1010,50,10,0.01,2004,11
0.49,0.0001,59,45,50,10,0.01,104,12
0.502,0.0001,107,97,50,10,0.01,204,12
0.516,0.0001,167,137,50,10,0.01,304,12
0.546,0.0001,210,194,50,10,0.01,404,12
0.544,0.0001,263,241,50,10,0.01,504,12
0.558,0.0001,320,284,50,10,0.01,604,12
0.572,0.0001,360,344,50,10,0.01,704,12
0.598,0.0001,409,395,50,10,0.01,804,12
0.652,0.0001,456,448,50,10,0.01,904,12
0.696,0.0001,514,490,50,10,0.01,1004,12
0.762,0.0001,564,540,50,10,0.01,1104,12
0.812,0.0001,612,592,50,10,0.01,1204,12
0.842,0.0001,655,649,50,10,0.01,1304,12
0.898,0.0001,708,696,50,10,0.01,1404,12
0.936,0.0001,764,740,50,10,0.01,1504,12
0.948,0.0001,808,796,50,10,0.01,1604,12
0.95,0.0001,854,850,50,10,0.01,1704,12
0.946,0.0001,912,892,50,10,0.01,1804,12
0.952,0.0001,960,944,50,10,0.01,1904,12
0.958,0.0001,1001,1003,50,10,0.01,2004,12
0.53,0.0001,49,55,50,10,0.01,104,13
0.524,0.0001,98,106,50,10,0.01,204,13
0.538,0.0001,146,158,50,10,0.01,304,13
0.576,0.0001,190,214,50,10,0.01,404,13
0.624,0.0001,226,278,50,10,0.01,504,13
0.612,0.0001,281,323,50,10,0.01,604,13
0.606,0.0001,338,366,50,10,0.01,704,13
0.608,0.0001,397,407,50,10,0.01,804,13
0.646,0.0001,443,461,50,10,0.01,904,13
0.71,0.0001,501,503,50,10,0.01,1004,13
0.742,0.0001,555,549,50,10,0.01,1104,13
0.772,0.0001,606,598,50,10,0.01,1204,13
0.832,0.0001,664,640,50,10,0.01,1304,13
0.854,0.0001,705,699,50,10,0.01,1404,13
0.87,0.0001,751,753,50,10,0.01,1504,13
0.9,0.0001,798,806,50,10,0.01,1604,13
0.92,0.0001,844,860,50,10,0.01,1704,13
0.928,0.0001,885,919,50,10,0.01,1804,13
0.942,0.0001,928,976,50,10,0.01,1904,13
0.95,0.0001,987,1017,50,10,0.01,2004,13
0.526,0.0001,52,52,50,10,0.01,104,14
0.548,0.0001,103,101,50,10,0.01,204,14
0.546,0.0001,156,148,50,10,0.01,304,14
0.566,0.0001,199,205,50,10,0.01,404,14
0.576,0.0001,249,255,50,10,0.01,504,14
0.602,0.0001,293,311,50,10,0.01,604,14
0.622,0.0001,340,364,50,10,0.01,704,14
0.64,0.0001,392,412,50,10,0.01,804,14
0.662,0.0001,443,461,50,10,0.01,904,14
0.708,0.0001,500,504,50,10,0.01,1004,14
0.744,0.0001,546,558,50,10,0.01,1104,14
0.786,0.0001,598,606,50,10,0.01,1204,14
0.816,0.0001,649,655,50,10,0.01,1304,14
0.87,0.0001,694,710,50,10,0.01,1404,14
0.894,0.0001,747,757,50,10,0.01,1504,14
0.928,0.0001,802,802,50,10,0.01,1604,14
0.94,0.0001,852,852,50,10,0.01,1704,14
0.948,0.0001,910,894,50,10,0.01,1804,14
0.946,0.0001,958,946,50,10,0.01,1904,14
0.952,0.0001,1007,997,50,10,0.01,2004,14
0.492,0.0001,50,54,50,10,0.01,104,15
0.492,0.0001,97,107,50,10,0.01,204,15
0.49,0.0001,138,166,50,10,0.01,304,15
0.494,0.0001,189,215,50,10,0.01,404,15
0.498,0.0001,241,263,50,10,0.01,504,15
0.512,0.0001,285,319,50,10,0.01,604,15
0.548,0.0001,330,374,50,10,0.01,704,15
0.582,0.0001,380,424,50,10,0.01,804,15
0.596,0.0001,428,476,50,10,0.01,904,15
0.618,0.0001,484,520,50,10,0.01,1004,15
0.646,0.0001,545,559,50,10,0.01,1104,15
0.69,0.0001,597,607,50,10,0.01,1204,15
0.722,0.0001,643,661,50,10,0.01,1304,15
0.788,0.0001,692,712,50,10,0.01,1404,15
0.81,0.0001,743,761,50,10,0.01,1504,15
0.848,0.0001,797,807,50,10,0.01,1604,15
0.882,0.0001,850,854,50,10,0.01,1704,15
0.882,0.0001,899,905,50,10,0.01,1804,15
0.89,0.0001,951,953,50,10,0.01,1904,15
0.904,0.0001,997,1007,50,10,0.01,2004,15
0.502,0.0001,61,43,50,10,0.01,104,16
0.518,0.0001,102,102,50,10,0.01,204,16
0.546,0.0001,154,150,50,10,0.01,304,16
0.59,0.0001,201,203,50,10,0.01,404,16
0.626,0.0001,253,251,50,10,0.01,504,16
0.654,0.0001,297,307,50,10,0.01,604,16
0.648,0.0001,348,356,50,10,0.01,704,16
0.652,0.0001,399,405,50,10,0.01,804,16
0.682,0.0001,444,460,50,10,0.01,904,16
0.72,0.0001,482,522,50,10,0.01,1004,16
0.734,0.0001,535,569,50,10,0.01,1104,16
0.782,0.0001,591,613,50,10,0.01,1204,16
0.838,0.0001,642,662,50,10,0.01,1304,16
0.88,0.0001,698,706,50,10,0.01,1404,16
0.908,0.0001,752,752,50,10,0.01,1504,16
0.938,0.0001,803,801,50,10,0.01,1604,16
0.942,0.0001,855,849,50,10,0.01,1704,16
0.962,0.0001,904,900,50,10,0.01,1804,16
0.96,0.0001,954,950,50,10,0.01,1904,16
0.964,0.0001,1001,1003,50,10,0.01,2004,16
0.468,0.0001,57,47,50,10,0.01,104,17
0.47,0.0001,114,90,50,10,0.01,204,17
0.482,0.0001,163,141,50,10,0.01,304,17
0.518,0.0001,214,190,50,10,0.01,404,17
0.546,0.0001,266,238,50,10,0.01,504,17
0.552,0.0001,312,292,50,10,0.01,604,17
0.58,0.0001,361,343,50,10,0.01,704,17
0.602,0.0001,412,392,50,10,0.01,804,17
0.616,0.0001,460,444,50,10,0.01,904,17
0.636,0.0001,504,500,50,10,0.01,1004,17
0.648,0.0001,549,555,50,10,0.01,1104,17
0.676,0.0001,596,608,50,10,0.01,1204,17
0.694,0.0001,643,661,50,10,0.01,1304,17
0.72,0.0001,694,710,50,10,0.01,1404,17
0.74,0.0001,744,760,50,10,0.01,1504,17
0.78,0.0001,787,817,50,10,0.01,1604,17
0.81,0.0001,842,862,50,10,0.01,1704,17
0.846,0.0001,892,912,50,10,0.01,1804,17
0.84,0.0001,943,961,50,10,0.01,1904,17
0.862,0.0001,996,1008,50,10,0.01,2004,17
0.514,0.0001,45,59,50,10,0.01,104,18
0.534,0.0001,97,107,50,10,0.01,204,18
0.534,0.0001,151,153,50,10,0.01,304,18
0.556,0.0001,202,202,50,10,0.01,404,18
0.57,0.0001,253,251,50,10,0.01,504,18
0.61,0.0001,307,297,50,10,0.01,604,18
0.636,0.0001,354,350,50,10,0.01,704,18
0.672,0.0001,412,392,50,10,0.01,804,18
0.674,0.0001,459,445,50,10,0.01,904,18
0.714,0.0001,502,502,50,10,0.01,1004,18
0.74,0.0001,557,547,50,10,0.01,1104,18
0.792,0.0001,601,603,50,10,0.01,1204,18
0.836,0.0001,652,652,50,10,0.01,1304,18
0.87,0.0001,693,711,50,10,0.01,1404,18
0.884,0.0001,747,757,50,10,0.01,1504,18
0.902,0.0001,796,808,50,10,0.01,1604,18
0.914,0.0001,852,852,50,10,0.01,1704,18
0.932,0.0001,906,898,50,10,0.01,1804,18
0.942,0.0001,958,946,50,10,0.01,1904,18
0.948,0.0001,1007,997,50,10,0.01,2004,18
0.49,0.0001,50,54,50,10,0.01,104,19
0.51,0.0001,99,105,50,10,0.01,204,19
0.532,0.0001,147,157,50,10,0.01,304,19
0.538,0.0001,183,221,50,10,0.01,404,19
0.538,0.0001,240,264,50,10,0.01,504,19
0.566,0.0001,290,314,50,10,0.01,604,19
0.598,0.0001,329,375,50,10,0.01,704,19
0.616,0.0001,382,422,50,10,0.01,804,19
0.65,0.0001,434,470,50,10,0.01,904,19
0.696,0.0001,488,516,50,10,0.01,1004,19
0.734,0.0001,541,563,50,10,0.01,1104,19
0.812,0.0001,592,612,50,10,0.01,1204,19
0.83,0.0001,645,659,50,10,0.01,1304,19
0.902,0.0001,696,708,50,10,0.01,1404,19
0.936,0.0001,747,757,50,10,0.01,1504,19
0.946,0.0001,803,801,50,10,0.01,1604,19
0.954,0.0001,848,856,50,10,0.01,1704,19
0.956,0.0001,901,903,50,10,0.01,1804,19
0.962,0.0001,947,957,50,10,0.01,1904,19
0.96,0.0001,1002,1002,50,10,0.01,2004,19
0.5,0.0001,46,58,50,10,0.01,104,20
0.508,0.0001,96,108,50,10,0.01,204,20
0.532,0.0001,153,151,50,10,0.01,304,20
0.546,0.0001,211,193,50,10,0.01,404,20
0.544,0.0001,256,248,50,10,0.01,504,20
0.57,0.0001,314,290,50,10,0.01,604,20
0.584,0.0001,363,341,50,10,0.01,704,20
0.616,0.0001,412,392,50,10,0.01,804,20
0.65,0.0001,456,448,50,10,0.01,904,20
0.67,0.0001,503,501,50,10,0.01,1004,20
0.726,0.0001,560,544,50,10,0.01,1104,20
0.756,0.0001,601,603,50,10,0.01,1204,20
0.77,0.0001,657,647,50,10,0.01,1304,20
0.832,0.0001,718,686,50,10,0.01,1404,20
0.866,0.0001,769,735,50,10,0.01,1504,20
0.914,0.0001,810,794,50,10,0.01,1604,20
0.92,0.0001,864,840,50,10,0.01,1704,20
0.952,0.0001,907,897,50,10,0.01,1804,20
0.956,0.0001,964,940,50,10,0.01,1904,20
0.968,0.0001,1010,994,50,10,0.01,2004,20
0.556,0.001,59,45,50,10,0.0001,104,1
0.556,0.001,102,102,50,10,0.0001,204,1
0.556,0.001,150,154,50,10,0.0001,304,1
0.556,0.001,205,199,50,10,0.0001,404,1
0.556,0.001,262,242,50,10,0.0001,504,1
0.558,0.001,320,284,50,10,0.0001,604,1
0.56,0.001,377,327,50,10,0.0001,704,1
0.56,0.001,424,380,50,10,0.0001,804,1
0.558,0.001,470,434,50,10,0.0001,904,1
0.558,0.001,517,487,50,10,0.0001,1004,1
0.558,0.001,557,547,50,10,0.0001,1104,1
0.56,0.001,609,595,50,10,0.0001,1204,1
0.562,0.001,658,646,50,10,0.0001,1304,1
0.562,0.001,712,692,50,10,0.0001,1404,1
0.562,0.001,763,741,50,10,0.0001,1504,1
0.562,0.001,811,793,50,10,0.0001,1604,1
0.56,0.001,858,846,50,10,0.0001,1704,1
0.56,0.001,910,894,50,10,0.0001,1804,1
0.56,0.001,957,947,50,10,0.0001,1904,1
0.56,0.001,1001,1003,50,10,0.0001,2004,1
0.496,0.001,64,40,50,10,0.0001,104,2
0.496,0.001,113,91,50,10,0.0001,204,2
0.496,0.001,162,142,50,10,0.0001,304,2
0.496,0.001,208,196,50,10,0.0001,404,2
0.496,0.001,254,250,50,10,0.0001,504,2
0.496,0.001,296,308,50,10,0.0001,604,2
0.496,0.001,350,354,50,10,0.0001,704,2
0.496,0.001,408,396,50,10,0.0001,804,2
0.496,0.001,454,450,50,10,0.0001,904,2
0.496,0.001,506,498,50,10,0.0001,1004,2
0.496,0.001,547,557,50,10,0.0001,1104,2
0.496,0.001,596,608,50,10,0.0001,1204,2
0.496,0.001,643,661,50,10,0.0001,1304,2
0.496,0.001,691,713,50,10,0.0001,1404,2
0.496,0.001,751,753,50,10,0.0001,1504,2
0.496,0.001,794,810,50,10,0.0001,1604,2
0.496,0.001,849,855,50,10,0.0001,1704,2
0.496,0.001,905,899,50,10,0.0001,1804,2
0.496,0.001,948,956,50,10,0.0001,1904,2
0.496,0.001,1000,1004,50,10,0.0001,2004,2
0.508,0.001,51,53,50,10,0.0001,104,3
0.508,0.001,105,99,50,10,0.0001,204,3
0.506,0.001,153,151,50,10,0.0001,304,3
0.506,0.001,205,199,50,10,0.0001,404,3
0.506,0.001,255,249,50,10,0.0001,504,3
0.506,0.001,308,296,50,10,0.0001,604,3
0.506,0.001,353,351,50,10,0.0001,704,3
0.506,0.001,405,399,50,10,0.0001,804,3
0.508,0.001,460,444,50,10,0.0001,904,3
0.508,0.001,513,491,50,10,0.0001,1004,3
0.506,0.001,567,537,50,10,0.0001,1104,3
0.506,0.001,608,596,50,10,0.0001,1204,3
0.506,0.001,662,642,50,10,0.0001,1304,3
0.506,0.001,707,697,50,10,0.0001,1404,3
0.506,0.001,760,744,50,10,0.0001,1504,3
0.506,0.001,812,792,50,10,0.0001,1604,3
0.508,0.001,861,843,50,10,0.0001,1704,3
0.51,0.001,913,891,50,10,0.0001,1804,3
0.51,0.001,957,947,50,10,0.0001,1904,3
0.51,0.001,1005,999,50,10,0.0001,2004,3
0.508,0.001,50,54,50,10,0.0001,104,4
0.508,0.001,100,104,50,10,0.0001,204,4
0.508,0.001,147,157,50,10,0.0001,304,4
0.508,0.001,192,212,50,10,0.0001,404,4
0.508,0.001,238,266,50,10,0.0001,504,4
0.508,0.001,283,321,50,10,0.0001,604,4
0.508,0.001,340,364,50,10,0.0001,704,4
0.508,0.001,383,421,50,10,0.0001,804,4
0.508,0.001,432,472,50,10,0.0001,904,4
0.51,0.001,491,513,50,10,0.0001,1004,4
0.51,0.001,536,568,50,10,0.0001,1104,4
0.51,0.001,582,622,50,10,0.0001,1204,4
0.51,0.001,628,676,50,10,0.0001,1304,4
0.508,0.001,677,727,50,10,0.0001,1404,4
0.508,0.001,729,775,50,10,0.0001,1504,4
0.508,0.001,784,820,50,10,0.0001,1604,4
0.508,0.001,842,862,50,10,0.0001,1704,4
0.508,0.001,897,907,50,10,0.0001,1804,4
0.506,0.001,951,953,50,10,0.0001,1904,4
0.506,0.001,1000,1004,50,10,0.0001,2004,4
0.488,0.001,49,55,50,10,0.0001,104,5
0.488,0.001,96,108,50,10,0.0001,204,5
0.488,0.001,148,156,50,10,0.0001,304,5
0.488,0.001,198,206,50,10,0.0001,404,5
0.488,0.001,242,262,50,10,0.0001,504,5
0.488,0.001,289,315,50,10,0.0001,604,5
0.488,0.001,339,365,50,10,0.0001,704,5
0.486,0.001,385,419,50,10,0.0001,804,5
0.486,0.001,449,455,50,10,0.0001,904,5
0.486,0.001,500,504,50,10,0.0001,1004,5
0.486,0.001,554,550,50,10,0.0001,1104,5
0.486,0.001,591,613,50,10,0.0001,1204,5
0.49,0.001,644,660,50,10,0.0001,1304,5
0.488,0.001,694,710,50,10,0.0001,1404,5
0.486,0.001,737,767,50,10,0.0001,1504,5
0.486,0.001,790,814,50,10,0.0001,1604,5
0.486,0.001,844,860,50,10,0.0001,1704,5
0.486,0.001,898,906,50,10,0.0001,1804,5
0.486,0.001,951,953,50,10,0.0001,1904,5
0.484,0.001,1007,997,50,10,0.0001,2004,5
0.44,0.001,56,48,50,10,0.0001,104,6
0.44,0.001,104,100,50,10,0.0001,204,6
0.44,0.001,152,152,50,10,0.0001,304,6
0.44,0.001,200,204,50,10,0.0001,404,6
0.44,0.001,250,254,50,10,0.0001,504,6
0.44,0.001,302,302,50,10,0.0001,604,6
0.44,0.001,352,352,50,10,0.0001,704,6
0.442,0.001,393,411,50,10,0.0001,804,6
0.444,0.001,442,462,50,10,0.0001,904,6
0.446,0.001,495,509,50,10,0.0001,1004,6
0.448,0.001,547,557,50,10,0.0001,1104,6
0.448,0.001,598,606,50,10,0.0001,1204,6
0.446,0.001,655,649,50,10,0.0001,1304,6
0.444,0.001,710,694,50,10,0.0001,1404,6
0.444,0.001,761,743,50,10,0.0001,1504,6
0.444,0.001,808,796,50,10,0.0001,1604,6
0.444,0.001,863,841,50,10,0.0001,1704,6
0.442,0.001,914,890,50,10,0.0001,1804,6
0.444,0.001,963,941,50,10,0.0001,1904,6
0.442,0.001,1024,980,50,10,0.0001,2004,6
0.51,0.001,49,55,50,10,0.0001,104,7
0.51,0.001,99,105,50,10,0.0001,204,7
0.51,0.001,149,155,50,10,0.0001,304,7
0.514,0.001,206,198,50,10,0.0001,404,7
0.514,0.001,264,240,50,10,0.0001,504,7
0.514,0.001,309,295,50,10,0.0001,604,7
0.514,0.001,361,343,50,10,0.0001,704,7
0.516,0.001,412,392,50,10,0.0001,804,7
0.516,0.001,454,450,50,10,0.0001,904,7
0.518,0.001,493,511,50,10,0.0001,1004,7
0.52,0.001,535,569,50,10,0.0001,1104,7
0.52,0.001,593,611,50,10,0.0001,1204,7
0.518,0.001,649,655,50,10,0.0001,1304,7
0.518,0.001,695,709,50,10,0.0001,1404,7
0.518,0.001,748,756,50,10,0.0001,1504,7
0.518,0.001,794,810,50,10,0.0001,1604,7
0.514,0.001,840,864,50,10,0.0001,1704,7
0.514,0.001,892,912,50,10,0.0001,1804,7
0.518,0.001,946,958,50,10,0.0001,1904,7
0.516,0.001,994,1010,50,10,0.0001,2004,7
0.472,0.001,50,54,50,10,0.0001,104,8
0.472,0.001,107,97,50,10,0.0001,204,8
0.472,0.001,162,142,50,10,0.0001,304,8
0.472,0.001,210,194,50,10,0.0001,404,8
0.472,0.001,258,246,50,10,0.0001,504,8
0.476,0.001,310,294,50,10,0.0001,604,8
0.476,0.001,367,337,50,10,0.0001,704,8
0.478,0.001,409,395,50,10,0.0001,804,8
0.478,0.001,456,448,50,10,0.0001,904,8
0.48,0.001,506,498,50,10,0.0001,1004,8
0.48,0.001,555,549,50,10,0.0001,1104,8
0.48,0.001,602,602,50,10,0.0001,1204,8
0.48,0.001,642,662,50,10,0.0001,1304,8
0.48,0.001,690,714,50,10,0.0001,1404,8
0.48,0.001,735,769,50,10,0.0001,1504,8
0.482,0.001,788,816,50,10,0.0001,1604,8
0.482,0.001,835,869,50,10,0.0001,1704,8
0.482,0.001,883,921,50,10,0.0001,1804,8
0.484,0.001,928,976,50,10,0.0001,1904,8
0.484,0.001,980,1024,50,10,0.0001,2004,8
0.474,0.001,56,48,50,10,0.0001,104,9
0.474,0.001,103,101,50,10,0.0001,204,9
0.474,0.001,155,149,50,10,0.0001,304,9
0.476,0.001,204,200,50,10,0.0001,404,9
0.474,0.001,248,256,50,10,0.0001,504,9
0.476,0.001,299,305,50,10,0.0001,604,9
0.474,0.001,347,357,50,10,0.0001,704,9
0.474,0.001,396,408,50,10,0.0001,804,9
0.474,0.001,454,450,50,10,0.0001,904,9
0.472,0.001,501,503,50,10,0.0001,1004,9
0.472,0.001,549,555,50,10,0.0001,1104,9
0.474,0.001,596,608,50,10,0.0001,1204,9
0.472,0.001,650,654,50,10,0.0001,1304,9
0.472,0.001,701,703,50,10,0.0001,1404,9
0.474,0.001,759,745,50,10,0.0001,1504,9
0.474,0.001,809,795,50,10,0.0001,1604,9
0.478,0.001,857,847,50,10,0.0001,1704,9
0.478,0.001,902,902,50,10,0.0001,1804,9
0.478,0.001,954,950,50,10,0.0001,1904,9
0.478,0.001,994,1010,50,10,0.0001,2004,9
0.506,0.001,58,46,50,10,0.0001,104,10
0.506,0.001,114,90,50,10,0.0001,204,10
0.506,0.001,167,137,50,10,0.0001,304,10
0.506,0.001,204,200,50,10,0.0001,404,10
0.506,0.001,246,258,50,10,0.0001,504,10
0.506,0.001,305,299,50,10,0.0001,604,10
0.504,0.001,349,355,50,10,0.0001,704,10
0.504,0.001,402,402,50,10,0.0001,804,10
0.504,0.001,460,444,50,10,0.0001,904,10
0.504,0.001,503,501,50,10,0.0001,1004,10
0.504,0.001,555,549,50,10,0.0001,1104,10
0.504,0.001,601,603,50,10,0.0001,1204,10
0.504,0.001,658,646,50,10,0.0001,1304,10
0.504,0.001,715,689,50,10,0.0001,1404,10
0.508,0.001,763,741,50,10,0.0001,1504,10
0.512,0.001,816,788,50,10,0.0001,1604,10
0.516,0.001,871,833,50,10,0.0001,1704,10
0.516,0.001,919,885,50,10,0.0001,1804,10
0.516,0.001,956,948,50,10,0.0001,1904,10
0.516,0.001,1002,1002,50,10,0.0001,2004,10
0.506,0.001,47,57,50,10,0.0001,104,11
0.506,0.001,96,108,50,10,0.0001,204,11
0.506,0.001,148,156,50,10,0.0001,304,11
0.506,0.001,199,205,50,10,0.0001,404,11
0.506,0.001,249,255,50,10,0.0001,504,11
0.506,0.001,293,311,50,10,0.0001,604,11
0.506,0.001,340,364,50,10,0.0001,704,11
0.506,0.001,389,415,50,10,0.0001,804,11
0.506,0.001,437,467,50,10,0.0001,904,11
0.506,0.001,485,519,50,10,0.0001,1004,11
0.506,0.001,545,559,50,10,0.0001,1104,11
0.506,0.001,599,605,50,10,0.0001,1204,11
0.506,0.001,646,658,50,10,0.0001,1304,11
0.506,0.001,704,700,50,10,0.0001,1404,11
0.506,0.001,748,756,50,10,0.0001,1504,11
0.506,0.001,796,808,50,10,0.0001,1604,11
0.506,0.001,843,861,50,10,0.0001,1704,11
0.506,0.001,889,915,50,10,0.0001,1804,11
0.506,0.001,940,964,50,10,0.0001,1904,11
0.506,0.001,999,1005,50,10,0.0001,2004,11
0.522,0.001,50,54,50,10,0.0001,104,12
0.522,0.001,107,97,50,10,0.0001,204,12
0.522,0.001,156,148,50,10,0.0001,304,12
0.522,0.001,210,194,50,10,0.0001,404,12
0.524,0.001,260,244,50,10,0.0001,504,12
0.528,0.001,306,298,50,10,0.0001,604,12
0.528,0.001,353,351,50,10,0.0001,704,12
0.528,0.001,405,399,50,10,0.0001,804,12
0.526,0.001,455,449,50,10,0.0001,904,12
0.528,0.001,506,498,50,10,0.0001,1004,12
0.528,0.001,546,558,50,10,0.0001,1104,12
0.528,0.001,595,609,50,10,0.0001,1204,12
0.53,0.001,643,661,50,10,0.0001,1304,12
0.53,0.001,690,714,50,10,0.0001,1404,12
0.53,0.001,741,763,50,10,0.0001,1504,12
0.53,0.001,795,809,50,10,0.0001,1604,12
0.532,0.001,851,853,50,10,0.0001,1704,12
0.532,0.001,901,903,50,10,0.0001,1804,12
0.532,0.001,950,954,50,10,0.0001,1904,12
0.534,0.001,996,1008,50,10,0.0001,2004,12
0.546,0.001,48,56,50,10,0.0001,104,13
0.548,0.001,94,110,50,10,0.0001,204,13
0.552,0.001,147,157,50,10,0.0001,304,13
0.552,0.001,199,205,50,10,0.0001,404,13
0.55,0.001,246,258,50,10,0.0001,504,13
0.55,0.001,299,305,50,10,0.0001,604,13
0.55,0.001,345,359,50,10,0.0001,704,13
0.554,0.001,398,406,50,10,0.0001,804,13
0.554,0.001,454,450,50,10,0.0001,904,13
0.554,0.001,508,496,50,10,0.0001,1004,13
0.552,0.001,564,540,50,10,0.0001,1104,13
0.552,0.001,616,588,50,10,0.0001,1204,13
0.552,0.001,671,633,50,10,0.0001,1304,13
0.552,0.001,716,688,50,10,0.0001,1404,13
0.55,0.001,760,744,50,10,0.0001,1504,13
0.55,0.001,817,787,50,10,0.0001,1604,13
0.548,0.001,868,836,50,10,0.0001,1704,13
0.548,0.001,917,887,50,10,0.0001,1804,13
0.55,0.001,966,938,50,10,0.0001,1904,13
0.548,0.001,1017,987,50,10,0.0001,2004,13
0.52,0.001,54,50,50,10,0.0001,104,14
0.52,0.001,100,104,50,10,0.0001,204,14
0.52,0.001,155,149,50,10,0.0001,304,14
0.52,0.001,201,203,50,10,0.0001,404,14
0.52,0.001,250,254,50,10,0.0001,504,14
0.518,0.001,298,306,50,10,0.0001,604,14
0.518,0.001,351,353,50,10,0.0001,704,14
0.518,0.001,397,407,50,10,0.0001,804,14
0.518,0.001,440,464,50,10,0.0001,904,14
0.518,0.001,495,509,50,10,0.0001,1004,14
0.518,0.001,547,557,50,10,0.0001,1104,14
0.518,0.001,594,610,50,10,0.0001,1204,14
0.518,0.001,651,653,50,10,0.0001,1304,14
0.52,0.001,701,703,50,10,0.0001,1404,14
0.52,0.001,749,755,50,10,0.0001,1504,14
0.52,0.001,797,807,50,10,0.0001,1604,14
0.518,0.001,847,857,50,10,0.0001,1704,14
0.516,0.001,897,907,50,10,0.0001,1804,14
0.518,0.001,941,963,50,10,0.0001,1904,14
0.52,0.001,992,1012,50,10,0.0001,2004,14
0.5,0.001,55,49,50,10,0.0001,104,15
0.502,0.001,105,99,50,10,0.0001,204,15
0.5,0.001,151,153,50,10,0.0001,304,15
0.5,0.001,210,194,50,10,0.0001,404,15
0.502,0.001,266,238,50,10,0.0001,504,15
0.502,0.001,318,286,50,10,0.0001,604,15
0.504,0.001,373,331,50,10,0.0001,704,15
0.504,0.001,424,380,50,10,0.0001,804,15
0.502,0.001,475,429,50,10,0.0001,904,15
0.5,0.001,529,475,50,10,0.0001,1004,15
0.5,0.001,570,534,50,10,0.0001,1104,15
0.502,0.001,619,585,50,10,0.0001,1204,15
0.5,0.001,666,638,50,10,0.0001,1304,15
0.5,0.001,721,683,50,10,0.0001,1404,15
0.502,0.001,759,745,50,10,0.0001,1504,15
0.5,0.001,799,805,50,10,0.0001,1604,15
0.502,0.001,851,853,50,10,0.0001,1704,15
0.502,0.001,894,910,50,10,0.0001,1804,15
0.502,0.001,955,949,50,10,0.0001,1904,15
0.5,0.001,1001,1003,50,10,0.0001,2004,15
0.508,0.001,54,50,50,10,0.0001,104,16
0.508,0.001,105,99,50,10,0.0001,204,16
0.51,0.001,157,147,50,10,0.0001,304,16
0.512,0.001,206,198,50,10,0.0001,404,16
0.512,0.001,250,254,50,10,0.0001,504,16
0.512,0.001,303,301,50,10,0.0001,604,16
0.51,0.001,356,348,50,10,0.0001,704,16
0.51,0.001,403,401,50,10,0.0001,804,16
0.51,0.001,455,449,50,10,0.0001,904,16
0.51,0.001,504,500,50,10,0.0001,1004,16
0.514,0.001,552,552,50,10,0.0001,1104,16
0.514,0.001,599,605,50,10,0.0001,1204,16
0.514,0.001,649,655,50,10,0.0001,1304,16
0.516,0.001,696,708,50,10,0.0001,1404,16
0.518,0.001,749,755,50,10,0.0001,1504,16
0.518,0.001,797,807,50,10,0.0001,1604,16
0.522,0.001,848,856,50,10,0.0001,1704,16
0.518,0.001,887,917,50,10,0.0001,1804,16
0.518,0.001,939,965,50,10,0.0001,1904,16
0.52,0.001,994,1010,50,10,0.0001,2004,16
0.538,0.001,54,50,50,10,0.0001,104,17
0.538,0.001,103,101,50,10,0.0001,204,17
0.538,0.001,150,154,50,10,0.0001,304,17
0.538,0.001,192,212,50,10,0.0001,404,17
0.538,0.001,244,260,50,10,0.0001,504,17
0.536,0.001,286,318,50,10,0.0001,604,17
0.534,0.001,337,367,50,10,0.0001,704,17
0.532,0.001,385,419,50,10,0.0001,804,17
0.532,0.001,438,466,50,10,0.0001,904,17
0.532,0.001,495,509,50,10,0.0001,1004,17
0.532,0.001,541,563,50,10,0.0001,1104,17
0.532,0.001,591,613,50,10,0.0001,1204,17
0.532,0.001,638,666,50,10,0.0001,1304,17
0.532,0.001,689,715,50,10,0.0001,1404,17
0.534,0.001,742,762,50,10,0.0001,1504,17
0.532,0.001,790,814,50,10,0.0001,1604,17
0.534,0.001,837,867,50,10,0.0001,1704,17
0.532,0.001,892,912,50,10,0.0001,1804,17
0.532,0.001,937,967,50,10,0.0001,1904,17
0.534,0.001,984,1020,50,10,0.0001,2004,17
0.478,0.001,50,54,50,10,0.0001,104,18
0.48,0.001,107,97,50,10,0.0001,204,18
0.48,0.001,150,154,50,10,0.0001,304,18
0.48,0.001,197,207,50,10,0.0001,404,18
0.476,0.001,247,257,50,10,0.0001,504,18
0.48,0.001,298,306,50,10,0.0001,604,18
0.48,0.001,353,351,50,10,0.0001,704,18
0.48,0.001,398,406,50,10,0.0001,804,18
0.482,0.001,443,461,50,10,0.0001,904,18
0.484,0.001,496,508,50,10,0.0001,1004,18
0.48,0.001,555,549,50,10,0.0001,1104,18
0.48,0.001,595,609,50,10,0.0001,1204,18
0.48,0.001,650,654,50,10,0.0001,1304,18
0.484,0.001,695,709,50,10,0.0001,1404,18
0.484,0.001,752,752,50,10,0.0001,1504,18
0.484,0.001,796,808,50,10,0.0001,1604,18
0.486,0.001,846,858,50,10,0.0001,1704,18
0.484,0.001,900,904,50,10,0.0001,1804,18
0.484,0.001,949,955,50,10,0.0001,1904,18
0.484,0.001,999,1005,50,10,0.0001,2004,18
0.508,0.001,52,52,50,10,0.0001,104,19
0.508,0.001,99,105,50,10,0.0001,204,19
0.508,0.001,153,151,50,10,0.0001,304,19
0.51,0.001,199,205,50,10,0.0001,404,19
0.512,0.001,259,245,50,10,0.0001,504,19
0.512,0.001,305,299,50,10,0.0001,604,19
0.512,0.001,352,352,50,10,0.0001,704,19
0.512,0.001,399,405,50,10,0.0001,804,19
0.512,0.001,444,460,50,10,0.0001,904,19
0.514,0.001,496,508,50,10,0.0001,1004,19
0.514,0.001,543,561,50,10,0.0001,1104,19
0.514,0.001,604,600,50,10,0.0001,1204,19
0.514,0.001,654,650,50,10,0.0001,1304,19
0.516,0.001,699,705,50,10,0.0001,1404,19
0.522,0.001,748,756,50,10,0.0001,1504,19
0.52,0.001,802,802,50,10,0.0001,1604,19
0.52,0.001,855,849,50,10,0.0001,1704,19
0.518,0.001,906,898,50,10,0.0001,1804,19
0.518,0.001,952,952,50,10,0.0001,1904,19
0.518,0.001,997,1007,50,10,0.0001,2004,19
0.52,0.001,54,50,50,10,0.0001,104,20
0.52,0.001,104,100,50,10,0.0001,204,20
0.52,0.001,149,155,50,10,0.0001,304,20
0.52,0.001,199,205,50,10,0.0001,404,20
0.52,0.001,256,248,50,10,0.0001,504,20
0.52,0.001,302,302,50,10,0.0001,604,20
0.52,0.001,350,354,50,10,0.0001,704,20
0.52,0.001,403,401,50,10,0.0001,804,20
0.52,0.001,451,453,50,10,0.0001,904,20
0.522,0.001,500,504,50,10,0.0001,1004,20
0.522,0.001,564,540,50,10,0.0001,1104,20
0.522,0.001,610,594,50,10,0.0001,1204,20
0.522,0.001,659,645,50,10,0.0001,1304,20
0.522,0.001,706,698,50,10,0.0001,1404,20
0.522,0.001,758,746,50,10,0.0001,1504,20
0.52,0.001,811,793,50,10,0.0001,1604,20
0.522,0.001,871,833,50,10,0.0001,1704,20
0.518,0.001,918,886,50,10,0.0001,1804,20
0.518,0.001,962,942,50,10,0.0001,1904,20
0.528,0.001,1010,994,50,10,0.0001,2004,20
0.49,0.001,53,51,50,10,0.001,104,1
0.492,0.001,109,95,50,10,0.001,204,1
0.492,0.001,166,138,50,10,0.001,304,1
0.494,0.001,223,181,50,10,0.001,404,1
0.492,0.001,273,231,50,10,0.001,504,1
0.496,0.001,322,282,50,10,0.001,604,1
0.494,0.001,368,336,50,10,0.001,704,1
0.5,0.001,417,387,50,10,0.001,804,1
0.5,0.001,471,433,50,10,0.001,904,1
0.498,0.001,523,481,50,10,0.001,1004,1
0.506,0.001,569,535,50,10,0.001,1104,1
0.514,0.001,615,589,50,10,0.001,1204,1
0.514,0.001,656,648,50,10,0.001,1304,1
0.52,0.001,700,704,50,10,0.001,1404,1
0.538,0.001,750,754,50,10,0.001,1504,1
0.548,0.001,804,800,50,10,0.001,1604,1
0.55,0.001,850,854,50,10,0.001,1704,1
0.568,0.001,902,902,50,10,0.001,1804,1
0.582,0.001,951,953,50,10,0.001,1904,1
0.588,0.001,1002,1002,50,10,0.001,2004,1
0.46,0.001,54,50,50,10,0.001,104,2
0.46,0.001,99,105,50,10,0.001,204,2
0.46,0.001,154,150,50,10,0.001,304,2
0.462,0.001,204,200,50,10,0.001,404,2
0.468,0.001,250,254,50,10,0.001,504,2
0.472,0.001,302,302,50,10,0.001,604,2
0.472,0.001,354,350,50,10,0.001,704,2
0.476,0.001,396,408,50,10,0.001,804,2
0.474,0.001,448,456,50,10,0.001,904,2
0.476,0.001,498,506,50,10,0.001,1004,2
0.478,0.001,542,562,50,10,0.001,1104,2
0.484,0.001,596,608,50,10,0.001,1204,2
0.486,0.001,642,662,50,10,0.001,1304,2
0.494,0.001,695,709,50,10,0.001,1404,2
0.498,0.001,739,765,50,10,0.001,1504,2
0.514,0.001,795,809,50,10,0.001,1604,2
0.512,0.001,837,867,50,10,0.001,1704,2
0.532,0.001,887,917,50,10,0.001,1804,2
0.54,0.001,934,970,50,10,0.001,1904,2
0.55,0.001,985,1019,50,10,0.001,2004,2
0.49,0.001,52,52,50,10,0.001,104,3
0.49,0.001,105,99,50,10,0.001,204,3
0.488,0.001,158,146,50,10,0.001,304,3
0.49,0.001,207,197,50,10,0.001,404,3
0.49,0.001,252,252,50,10,0.001,504,3
0.494,0.001,303,301,50,10,0.001,604,3
0.494,0.001,355,349,50,10,0.001,704,3
0.494,0.001,400,404,50,10,0.001,804,3
0.496,0.001,444,460,50,10,0.001,904,3
0.504,0.001,495,509,50,10,0.001,1004,3
0.5,0.001,548,556,50,10,0.001,1104,3
0.508,0.001,599,605,50,10,0.001,1204,3
0.512,0.001,650,654,50,10,0.001,1304,3
0.518,0.001,700,704,50,10,0.001,1404,3
0.52,0.001,754,750,50,10,0.001,1504,3
0.528,0.001,799,805,50,10,0.001,1604,3
0.534,0.001,854,850,50,10,0.001,1704,3
0.538,0.001,894,910,50,10,0.001,1804,3
0.546,0.001,943,961,50,10,0.001,1904,3
0.548,0.001,994,1010,50,10,0.001,2004,3
0.538,0.001,52,52,50,10,0.001,104,4
0.54,0.001,101,103,50,10,0.001,204,4
0.54,0.001,156,148,50,10,0.001,304,4
0.546,0.001,201,203,50,10,0.001,404,4
0.538,0.001,248,256,50,10,0.001,504,4
0.552,0.001,295,309,50,10,0.001,604,4
0.554,0.001,340,364,50,10,0.001,704,4
0.564,0.001,382,422,50,10,0.001,804,4
0.558,0.001,434,470,50,10,0.001,904,4
0.558,0.001,489,515,50,10,0.001,1004,4
0.562,0.001,526,578,50,10,0.001,1104,4
0.574,0.001,582,622,50,10,0.001,1204,4
0.578,0.001,639,665,50,10,0.001,1304,4
0.586,0.001,695,709,50,10,0.001,1404,4
0.584,0.001,745,759,50,10,0.001,1504,4
0.578,0.001,799,805,50,10,0.001,1604,4
0.592,0.001,855,849,50,10,0.001,1704,4
0.598,0.001,908,896,50,10,0.001,1804,4
0.608,0.001,957,947,50,10,0.001,1904,4
0.628,0.001,1008,996,50,10,0.001,2004,4
0.52,0.001,45,59,50,10,0.001,104,5
0.518,0.001,99,105,50,10,0.001,204,5
0.518,0.001,135,169,50,10,0.001,304,5
0.518,0.001,190,214,50,10,0.001,404,5
0.522,0.001,240,264,50,10,0.001,504,5
0.52,0.001,295,309,50,10,0.001,604,5
0.52,0.001,347,357,50,10,0.001,704,5
0.52,0.001,399,405,50,10,0.001,804,5
0.524,0.001,455,449,50,10,0.001,904,5
0.538,0.001,502,502,50,10,0.001,1004,5
0.534,0.001,557,547,50,10,0.001,1104,5
0.536,0.001,605,599,50,10,0.001,1204,5
0.532,0.001,657,647,50,10,0.001,1304,5
0.536,0.001,708,696,50,10,0.001,1404,5
0.536,0.001,759,745,50,10,0.001,1504,5
0.536,0.001,807,797,50,10,0.001,1604,5
0.54,0.001,854,850,50,10,0.001,1704,5
0.542,0.001,901,903,50,10,0.001,1804,5
0.564,0.001,951,953,50,10,0.001,1904,5
0.578,0.001,1001,1003,50,10,0.001,2004,5
0.524,0.001,60,44,50,10,0.001,104,6
0.526,0.001,118,86,50,10,0.001,204,6
0.522,0.001,165,139,50,10,0.001,304,6
0.524,0.001,215,189,50,10,0.001,404,6
0.522,0.001,264,240,50,10,0.001,504,6
0.522,0.001,317,287,50,10,0.001,604,6
0.528,0.001,362,342,50,10,0.001,704,6
0.528,0.001,408,396,50,10,0.001,804,6
0.532,0.001,464,440,50,10,0.001,904,6
0.536,0.001,519,485,50,10,0.001,1004,6
0.534,0.001,569,535,50,10,0.001,1104,6
0.538,0.001,610,594,50,10,0.001,1204,6
0.54,0.001,662,642,50,10,0.001,1304,6
0.54,0.001,715,689,50,10,0.001,1404,6
0.552,0.001,767,737,50,10,0.001,1504,6
0.552,0.001,812,792,50,10,0.001,1604,6
0.56,0.001,866,838,50,10,0.001,1704,6
0.566,0.001,912,892,50,10,0.001,1804,6
0.566,0.001,956,948,50,10,0.001,1904,6
0.572,0.001,1008,996,50,10,0.001,2004,6
0.464,0.001,46,58,50,10,0.001,104,7
0.466,0.001,86,118,50,10,0.001,204,7
0.468,0.001,144,160,50,10,0.001,304,7
0.464,0.001,188,216,50,10,0.001,404,7
0.468,0.001,237,267,50,10,0.001,504,7
0.47,0.001,287,317,50,10,0.001,604,7
0.472,0.001,342,362,50,10,0.001,704,7
0.47,0.001,390,414,50,10,0.001,804,7
0.482,0.001,437,467,50,10,0.001,904,7
0.48,0.001,495,509,50,10,0.001,1004,7
0.492,0.001,547,557,50,10,0.001,1104,7
0.496,0.001,595,609,50,10,0.001,1204,7
0.5,0.001,639,665,50,10,0.001,1304,7
0.504,0.001,695,709,50,10,0.001,1404,7
0.506,0.001,754,750,50,10,0.001,1504,7
0.514,0.001,810,794,50,10,0.001,1604,7
0.516,0.001,868,836,50,10,0.001,1704,7
0.526,0.001,919,885,50,10,0.001,1804,7
0.522,0.001,975,929,50,10,0.001,1904,7
0.526,0.001,1022,982,50,10,0.001,2004,7
0.56,0.001,52,52,50,10,0.001,104,8
0.558,0.001,106,98,50,10,0.001,204,8
0.558,0.001,157,147,50,10,0.001,304,8
0.556,0.001,213,191,50,10,0.001,404,8
0.564,0.001,262,242,50,10,0.001,504,8
0.566,0.001,321,283,50,10,0.001,604,8
0.566,0.001,359,345,50,10,0.001,704,8
0.568,0.001,407,397,50,10,0.001,804,8
0.574,0.001,471,433,50,10,0.001,904,8
0.586,0.001,526,478,50,10,0.001,1004,8
0.586,0.001,576,528,50,10,0.001,1104,8
0.586,0.001,622,582,50,10,0.001,1204,8
0.578,0.001,680,624,50,10,0.001,1304,8
0.58,0.001,729,675,50,10,0.001,1404,8
0.576,0.001,783,721,50,10,0.001,1504,8
0.58,0.001,832,772,50,10,0.001,1604,8
0.592,0.001,880,824,50,10,0.001,1704,8
0.598,0.001,922,882,50,10,0.001,1804,8
0.606,0.001,966,938,50,10,0.001,1904,8
0.608,0.001,1011,993,50,10,0.001,2004,8
0.542,0.001,46,58,50,10,0.001,104,9
0.544,0.001,96,108,50,10,0.001,204,9
0.548,0.001,144,160,50,10,0.001,304,9
0.552,0.001,197,207,50,10,0.001,404,9
0.546,0.001,248,256,50,10,0.001,504,9
0.544,0.001,301,303,50,10,0.001,604,9
0.54,0.001,348,356,50,10,0.001,704,9
0.542,0.001,406,398,50,10,0.001,804,9
0.542,0.001,458,446,50,10,0.001,904,9
0.55,0.001,511,493,50,10,0.001,1004,9
0.552,0.001,569,535,50,10,0.001,1104,9
0.554,0.001,624,580,50,10,0.001,1204,9
0.558,0.001,671,633,50,10,0.001,1304,9
0.562,0.001,715,689,50,10,0.001,1404,9
0.574,0.001,762,742,50,10,0.001,1504,9
0.568,0.001,813,791,50,10,0.001,1604,9
0.572,0.001,860,844,50,10,0.001,1704,9
0.574,0.001,905,899,50,10,0.001,1804,9
0.582,0.001,950,954,50,10,0.001,1904,9
0.582,0.001,1000,1004,50,10,0.001,2004,9
0.53,0.001,52,52,50,10,0.001,104,10
0.528,0.001,102,102,50,10,0.001,204,10
0.528,0.001,150,154,50,10,0.001,304,10
0.538,0.001,198,206,50,10,0.001,404,10
0.54,0.001,241,263,50,10,0.001,504,10
0.546,0.001,292,312,50,10,0.001,604,10
0.554,0.001,341,363,50,10,0.001,704,10
0.554,0.001,392,412,50,10,0.001,804,10
0.556,0.001,444,460,50,10,0.001,904,10
0.55,0.001,488,516,50,10,0.001,1004,10
0.56,0.001,536,568,50,10,0.001,1104,10
0.568,0.001,583,621,50,10,0.001,1204,10
0.574,0.001,638,666,50,10,0.001,1304,10
0.58,0.001,694,710,50,10,0.001,1404,10
0.578,0.001,753,751,50,10,0.001,1504,10
0.598,0.001,796,808,50,10,0.001,1604,10
0.62,0.001,855,849,50,10,0.001,1704,10
0.634,0.001,900,904,50,10,0.001,1804,10
0.638,0.001,965,939,50,10,0.001,1904,10
0.646,0.001,1014,990,50,10,0.001,2004,10
0.466,0.001,59,45,50,10,0.001,104,11
0.468,0.001,107,97,50,10,0.001,204,11
0.468,0.001,155,149,50,10,0.001,304,11
0.464,0.001,206,198,50,10,0.001,404,11
0.462,0.001,253,251,50,10,0.001,504,11
0.466,0.001,302,302,50,10,0.001,604,11
0.47,0.001,354,350,50,10,0.001,704,11
0.474,0.001,398,406,50,10,0.001,804,11
0.474,0.001,453,451,50,10,0.001,904,11
0.476,0.001,510,494,50,10,0.001,1004,11
0.476,0.001,562,542,50,10,0.001,1104,11
0.482,0.001,612,592,50,10,0.001,1204,11
0.492,0.001,661,643,50,10,0.001,1304,11
0.504,0.001,715,689,50,10,0.001,1404,11
0.51,0.001,752,752,50,10,0.001,1504,11
0.518,0.001,812,792,50,10,0.001,1604,11
0.522,0.001,856,848,50,10,0.001,1704,11
0.524,0.001,910,894,50,10,0.001,1804,11
0.532,0.001,953,951,50,10,0.001,1904,11
0.544,0.001,998,1006,50,10,0.001,2004,11
0.506,0.001,55,49,50,10,0.001,104,12
0.508,0.001,99,105,50,10,0.001,204,12
0.504,0.001,144,160,50,10,0.001,304,12
0.506,0.001,192,212,50,10,0.001,404,12
0.508,0.001,245,259,50,10,0.001,504,12
0.52,0.001,289,315,50,10,0.001,604,12
0.526,0.001,346,358,50,10,0.001,704,12
0.534,0.001,397,407,50,10,0.001,804,12
0.54,0.001,449,455,50,10,0.001,904,12
0.544,0.001,506,498,50,10,0.001,1004,12
0.544,0.001,554,550,50,10,0.001,1104,12
0.55,0.001,598,606,50,10,0.001,1204,12
0.552,0.001,651,653,50,10,0.001,1304,12
0.562,0.001,700,704,50,10,0.001,1404,12
0.57,0.001,758,746,50,10,0.001,1504,12
0.576,0.001,801,803,50,10,0.001,1604,12
0.584,0.001,847,857,50,10,0.001,1704,12
0.59,0.001,901,903,50,10,0.001,1804,12
0.596,0.001,954,950,50,10,0.001,1904,12
0.598,0.001,1006,998,50,10,0.001,2004,12
0.51,0.001,54,50,50,10,0.001,104,13
0.512,0.001,91,113,50,10,0.001,204,13
0.514,0.001,135,169,50,10,0.001,304,13
0.51,0.001,181,223,50,10,0.001,404,13
0.51,0.001,231,273,50,10,0.001,504,13
0.514,0.001,283,321,50,10,0.001,604,13
0.518,0.001,336,368,50,10,0.001,704,13
0.518,0.001,390,414,50,10,0.001,804,13
0.528,0.001,439,465,50,10,0.001,904,13
0.53,0.001,488,516,50,10,0.001,1004,13
0.526,0.001,542,562,50,10,0.001,1104,13
0.528,0.001,588,616,50,10,0.001,1204,13
0.544,0.001,636,668,50,10,0.001,1304,13
0.548,0.001,683,721,50,10,0.001,1404,13
0.57,0.001,735,769,50,10,0.001,1504,13
0.57,0.001,788,816,50,10,0.001,1604,13
0.582,0.001,840,864,50,10,0.001,1704,13
0.59,0.001,892,912,50,10,0.001,1804,13
0.608,0.001,943,961,50,10,0.001,1904,13
0.618,0.001,992,1012,50,10,0.001,2004,13
0.518,0.001,42,62,50,10,0.001,104,14
0.516,0.001,94,110,50,10,0.001,204,14
0.516,0.001,146,158,50,10,0.001,304,14
0.516,0.001,203,201,50,10,0.001,404,14
0.514,0.001,258,246,50,10,0.001,504,14
0.514,0.001,309,295,50,10,0.001,604,14
0.512,0.001,361,343,50,10,0.001,704,14
0.51,0.001,417,387,50,10,0.001,804,14
0.51,0.001,467,437,50,10,0.001,904,14
0.512,0.001,516,488,50,10,0.001,1004,14
0.512,0.001,564,540,50,10,0.001,1104,14
0.51,0.001,616,588,50,10,0.001,1204,14
0.514,0.001,666,638,50,10,0.001,1304,14
0.524,0.001,710,694,50,10,0.001,1404,14
0.524,0.001,758,746,50,10,0.001,1504,14
0.526,0.001,801,803,50,10,0.001,1604,14
0.528,0.001,849,855,50,10,0.001,1704,14
0.532,0.001,906,898,50,10,0.001,1804,14
0.536,0.001,960,944,50,10,0.001,1904,14
0.53,0.001,1013,991,50,10,0.001,2004,14
0.476,0.001,44,60,50,10,0.001,104,15
0.472,0.001,92,112,50,10,0.001,204,15
0.474,0.001,148,156,50,10,0.001,304,15
0.478,0.001,195,209,50,10,0.001,404,15
0.482,0.001,235,269,50,10,0.001,504,15
0.48,0.001,283,321,50,10,0.001,604,15
0.482,0.001,336,368,50,10,0.001,704,15
0.482,0.001,375,429,50,10,0.001,804,15
0.478,0.001,433,471,50,10,0.001,904,15
0.478,0.001,484,520,50,10,0.001,1004,15
0.484,0.001,530,574,50,10,0.001,1104,15
0.484,0.001,582,622,50,10,0.001,1204,15
0.482,0.001,639,665,50,10,0.001,1304,15
0.492,0.001,697,707,50,10,0.001,1404,15
0.496,0.001,741,763,50,10,0.001,1504,15
0.506,0.001,792,812,50,10,0.001,1604,15
0.518,0.001,841,863,50,10,0.001,1704,15
0.532,0.001,901,903,50,10,0.001,1804,15
0.546,0.001,948,956,50,10,0.001,1904,15
0.56,0.001,998,1006,50,10,0.001,2004,15
0.5,0.001,46,58,50,10,0.001,104,16
0.502,0.001,97,107,50,10,0.001,204,16
0.504,0.001,139,165,50,10,0.001,304,16
0.502,0.001,186,218,50,10,0.001,404,16
0.502,0.001,232,272,50,10,0.001,504,16
0.502,0.001,267,337,50,10,0.001,604,16
0.502,0.001,328,376,50,10,0.001,704,16
0.502,0.001,379,425,50,10,0.001,804,16
0.5,0.001,436,468,50,10,0.001,904,16
0.496,0.001,493,511,50,10,0.001,1004,16
0.496,0.001,547,557,50,10,0.001,1104,16
0.5,0.001,591,613,50,10,0.001,1204,16
0.492,0.001,638,666,50,10,0.001,1304,16
0.494,0.001,692,712,50,10,0.001,1404,16
0.496,0.001,736,768,50,10,0.001,1504,16
0.498,0.001,793,811,50,10,0.001,1604,16
0.506,0.001,835,869,50,10,0.001,1704,16
0.508,0.001,887,917,50,10,0.001,1804,16
0.516,0.001,946,958,50,10,0.001,1904,16
0.532,0.001,1002,1002,50,10,0.001,2004,16
0.514,0.001,57,47,50,10,0.001,104,17
0.516,0.001,102,102,50,10,0.001,204,17
0.512,0.001,163,141,50,10,0.001,304,17
0.512,0.001,209,195,50,10,0.001,404,17
0.512,0.001,256,248,50,10,0.001,504,17
0.522,0.001,306,298,50,10,0.001,604,17
0.522,0.001,348,356,50,10,0.001,704,17
0.528,0.001,402,402,50,10,0.001,804,17
0.526,0.001,456,448,50,10,0.001,904,17
0.522,0.001,499,505,50,10,0.001,1004,17
0.524,0.001,542,562,50,10,0.001,1104,17
0.524,0.001,590,614,50,10,0.001,1204,17
0.526,0.001,640,664,50,10,0.001,1304,17
0.522,0.001,695,709,50,10,0.001,1404,17
0.526,0.001,750,754,50,10,0.001,1504,17
0.524,0.001,795,809,50,10,0.001,1604,17
0.53,0.001,848,856,50,10,0.001,1704,17
0.546,0.001,899,905,50,10,0.001,1804,17
0.56,0.001,947,957,50,10,0.001,1904,17
0.562,0.001,1000,1004,50,10,0.001,2004,17
0.5,0.001,58,46,50,10,0.001,104,18
0.502,0.001,98,106,50,10,0.001,204,18
0.504,0.001,139,165,50,10,0.001,304,18
0.506,0.001,190,214,50,10,0.001,404,18
0.514,0.001,238,266,50,10,0.001,504,18
0.516,0.001,286,318,50,10,0.001,604,18
0.516,0.001,333,371,50,10,0.001,704,18
0.518,0.001,383,421,50,10,0.001,804,18
0.524,0.001,433,471,50,10,0.001,904,18
0.53,0.001,488,516,50,10,0.001,1004,18
0.53,0.001,534,570,50,10,0.001,1104,18
0.54,0.001,588,616,50,10,0.001,1204,18
0.546,0.001,640,664,50,10,0.001,1304,18
0.558,0.001,696,708,50,10,0.001,1404,18
0.566,0.001,745,759,50,10,0.001,1504,18
0.584,0.001,794,810,50,10,0.001,1604,18
0.588,0.001,841,863,50,10,0.001,1704,18
0.596,0.001,897,907,50,10,0.001,1804,18
0.604,0.001,951,953,50,10,0.001,1904,18
0.624,0.001,1000,1004,50,10,0.001,2004,18
0.492,0.001,53,51,50,10,0.001,104,19
0.492,0.001,106,98,50,10,0.001,204,19
0.492,0.001,154,150,50,10,0.001,304,19
0.492,0.001,198,206,50,10,0.001,404,19
0.492,0.001,248,256,50,10,0.001,504,19
0.492,0.001,284,320,50,10,0.001,604,19
0.492,0.001,332,372,50,10,0.001,704,19
0.492,0.001,385,419,50,10,0.001,804,19
0.492,0.001,445,459,50,10,0.001,904,19
0.492,0.001,497,507,50,10,0.001,1004,19
0.492,0.001,559,545,50,10,0.001,1104,19
0.492,0.001,605,599,50,10,0.001,1204,19
0.494,0.001,655,649,50,10,0.001,1304,19
0.502,0.001,699,705,50,10,0.001,1404,19
0.506,0.001,754,750,50,10,0.001,1504,19
0.51,0.001,811,793,50,10,0.001,1604,19
0.516,0.001,867,837,50,10,0.001,1704,19
0.526,0.001,920,884,50,10,0.001,1804,19
0.53,0.001,961,943,50,10,0.001,1904,19
0.532,0.001,1006,998,50,10,0.001,2004,19
0.528,0.001,59,45,50,10,0.001,104,20
0.528,0.001,106,98,50,10,0.001,204,20
0.526,0.001,155,149,50,10,0.001,304,20
0.528,0.001,209,195,50,10,0.001,404,20
0.53,0.001,256,248,50,10,0.001,504,20
0.53,0.001,310,294,50,10,0.001,604,20
0.53,0.001,364,340,50,10,0.001,704,20
0.536,0.001,415,389,50,10,0.001,804,20
0.536,0.001,462,442,50,10,0.001,904,20
0.542,0.001,513,491,50,10,0.001,1004,20
0.546,0.001,560,544,50,10,0.001,1104,20
0.54,0.001,611,593,50,10,0.001,1204,20
0.54,0.001,661,643,50,10,0.001,1304,20
0.548,0.001,713,691,50,10,0.001,1404,20
0.558,0.001,766,738,50,10,0.001,1504,20
0.574,0.001,818,786,50,10,0.001,1604,20
0.578,0.001,860,844,50,10,0.001,1704,20
0.594,0.001,907,897,50,10,0.001,1804,20
0.604,0.001,949,955,50,10,0.001,1904,20
0.604,0.001,1001,1003,50,10,0.001,2004,20
0.5,0.001,49,55,50,10,0.01,104,1
0.558,0.001,96,108,50,10,0.01,204,1
0.562,0.001,154,150,50,10,0.01,304,1
0.57,0.001,214,190,50,10,0.01,404,1
0.572,0.001,261,243,50,10,0.01,504,1
0.572,0.001,307,297,50,10,0.01,604,1
0.568,0.001,357,347,50,10,0.01,704,1
0.602,0.001,404,400,50,10,0.01,804,1
0.632,0.001,452,452,50,10,0.01,904,1
0.664,0.001,504,500,50,10,0.01,1004,1
0.688,0.001,551,553,50,10,0.01,1104,1
0.722,0.001,604,600,50,10,0.01,1204,1
0.758,0.001,655,649,50,10,0.01,1304,1
0.8,0.001,703,701,50,10,0.01,1404,1
0.83,0.001,757,747,50,10,0.01,1504,1
0.866,0.001,807,797,50,10,0.01,1604,1
0.892,0.001,850,854,50,10,0.01,1704,1
0.934,0.001,906,898,50,10,0.01,1804,1
0.958,0.001,954,950,50,10,0.01,1904,1
0.966,0.001,1011,993,50,10,0.01,2004,1
0.52,0.001,54,50,50,10,0.01,104,2
0.542,0.001,110,94,50,10,0.01,204,2
0.566,0.001,156,148,50,10,0.01,304,2
0.578,0.001,205,199,50,10,0.01,404,2
0.576,0.001,242,262,50,10,0.01,504,2
0.608,0.001,293,311,50,10,0.01,604,2
0.61,0.001,344,360,50,10,0.01,704,2
0.644,0.001,399,405,50,10,0.01,804,2
0.648,0.001,445,459,50,10,0.01,904,2
0.68,0.001,499,505,50,10,0.01,1004,2
0.72,0.001,551,553,50,10,0.01,1104,2
0.76,0.001,602,602,50,10,0.01,1204,2
0.8,0.001,658,646,50,10,0.01,1304,2
0.852,0.001,708,696,50,10,0.01,1404,2
0.868,0.001,762,742,50,10,0.01,1504,2
0.898,0.001,819,785,50,10,0.01,1604,2
0.924,0.001,865,839,50,10,0.01,1704,2
0.948,0.001,917,887,50,10,0.01,1804,2
0.94,0.001,958,946,50,10,0.01,1904,2
0.95,0.001,1011,993,50,10,0.01,2004,2
0.52,0.001,43,61,50,10,0.01,104,3
0.538,0.001,100,104,50,10,0.01,204,3
0.562,0.001,144,160,50,10,0.01,304,3
0.594,0.001,197,207,50,10,0.01,404,3
0.614,0.001,247,257,50,10,0.01,504,3
0.626,0.001,290,314,50,10,0.01,604,3
0.648,0.001,344,360,50,10,0.01,704,3
0.652,0.001,402,402,50,10,0.01,804,3
0.67,0.001,453,451,50,10,0.01,904,3
0.71,0.001,500,504,50,10,0.01,1004,3
0.74,0.001,555,549,50,10,0.01,1104,3
0.77,0.001,604,600,50,10,0.01,1204,3
0.798,0.001,653,651,50,10,0.01,1304,3
0.818,0.001,694,710,50,10,0.01,1404,3
0.834,0.001,751,753,50,10,0.01,1504,3
0.89,0.001,804,800,50,10,0.01,1604,3
0.902,0.001,855,849,50,10,0.01,1704,3
0.912,0.001,900,904,50,10,0.01,1804,3
0.926,0.001,945,959,50,10,0.01,1904,3
0.928,0.001,996,1008,50,10,0.01,2004,3
0.508,0.001,51,53,50,10,0.01,104,4
0.502,0.001,100,104,50,10,0.01,204,4
0.536,0.001,156,148,50,10,0.01,304,4
0.552,0.001,207,197,50,10,0.01,404,4
0.542,0.001,254,250,50,10,0.01,504,4
0.554,0.001,310,294,50,10,0.01,604,4
0.562,0.001,360,344,50,10,0.01,704,4
0.606,0.001,414,390,50,10,0.01,804,4
0.668,0.001,459,445,50,10,0.01,904,4
0.712,0.001,509,495,50,10,0.01,1004,4
0.746,0.001,564,540,50,10,0.01,1104,4
0.79,0.001,613,591,50,10,0.01,1204,4
0.824,0.001,663,641,50,10,0.01,1304,4
0.86,0.001,718,686,50,10,0.01,1404,4
0.904,0.001,768,736,50,10,0.01,1504,4
0.928,0.001,822,782,50,10,0.01,1604,4
0.944,0.001,863,841,50,10,0.01,1704,4
0.956,0.001,915,889,50,10,0.01,1804,4
0.968,0.001,968,936,50,10,0.01,1904,4
0.974,0.001,1013,991,50,10,0.01,2004,4
0.48,0.001,50,54,50,10,0.01,104,5
0.482,0.001,103,101,50,10,0.01,204,5
0.476,0.001,150,154,50,10,0.01,304,5
0.484,0.001,197,207,50,10,0.01,404,5
0.496,0.001,249,255,50,10,0.01,504,5
0.504,0.001,302,302,50,10,0.01,604,5
0.548,0.001,356,348,50,10,0.01,704,5
0.622,0.001,399,405,50,10,0.01,804,5
0.628,0.001,448,456,50,10,0.01,904,5
0.678,0.001,498,506,50,10,0.01,1004,5
0.704,0.001,539,565,50,10,0.01,1104,5
0.768,0.001,590,614,50,10,0.01,1204,5
0.814,0.001,633,671,50,10,0.01,1304,5
0.872,0.001,679,725,50,10,0.01,1404,5
0.902,0.001,734,770,50,10,0.01,1504,5
0.926,0.001,787,817,50,10,0.01,1604,5
0.94,0.001,838,866,50,10,0.01,1704,5
0.96,0.001,886,918,50,10,0.01,1804,5
0.964,0.001,944,960,50,10,0.01,1904,5
0.968,0.001,993,1011,50,10,0.01,2004,5
0.496,0.001,46,58,50,10,0.01,104,6
0.524,0.001,99,105,50,10,0.01,204,6
0.536,0.001,152,152,50,10,0.01,304,6
0.566,0.001,201,203,50,10,0.01,404,6
0.618,0.001,257,247,50,10,0.01,504,6
0.638,0.001,308,296,50,10,0.01,604,6
0.646,0.001,359,345,50,10,0.01,704,6
0.672,0.001,410,394,50,10,0.01,804,6
0.694,0.001,449,455,50,10,0.01,904,6
0.754,0.001,501,503,50,10,0.01,1004,6
0.788,0.001,552,552,50,10,0.01,1104,6
0.834,0.001,593,611,50,10,0.01,1204,6
0.84,0.001,641,663,50,10,0.01,1304,6
0.88,0.001,689,715,50,10,0.01,1404,6
0.878,0.001,739,765,50,10,0.01,1504,6
0.91,0.001,784,820,50,10,0.01,1604,6
0.928,0.001,832,872,50,10,0.01,1704,6
0.936,0.001,880,924,50,10,0.01,1804,6
0.94,0.001,935,969,50,10,0.01,1904,6
0.942,0.001,990,1014,50,10,0.01,2004,6
0.494,0.001,54,50,50,10,0.01,104,7
0.506,0.001,100,104,50,10,0.01,204,7
0.524,0.001,153,151,50,10,0.01,304,7
0.55,0.001,210,194,50,10,0.01,404,7
0.578,0.001,259,245,50,10,0.01,504,7
0.6,0.001,311,293,50,10,0.01,604,7
0.59,0.001,354,350,50,10,0.01,704,7
0.624,0.001,406,398,50,10,0.01,804,7
0.65,0.001,463,441,50,10,0.01,904,7
0.694,0.001,505,499,50,10,0.01,1004,7
0.734,0.001,549,555,50,10,0.01,1104,7
0.764,0.001,607,597,50,10,0.01,1204,7
0.778,0.001,655,649,50,10,0.01,1304,7
0.826,0.001,698,706,50,10,0.01,1404,7
0.876,0.001,738,766,50,10,0.01,1504,7
0.892,0.001,784,820,50,10,0.01,1604,7
0.918,0.001,836,868,50,10,0.01,1704,7
0.92,0.001,893,911,50,10,0.01,1804,7
0.932,0.001,944,960,50,10,0.01,1904,7
0.94,0.001,994,1010,50,10,0.01,2004,7
0.512,0.001,46,58,50,10,0.01,104,8
0.508,0.001,97,107,50,10,0.01,204,8
0.508,0.001,150,154,50,10,0.01,304,8
0.514,0.001,189,215,50,10,0.01,404,8
0.516,0.001,241,263,50,10,0.01,504,8
0.552,0.001,293,311,50,10,0.01,604,8
0.58,0.001,346,358,50,10,0.01,704,8
0.606,0.001,400,404,50,10,0.01,804,8
0.63,0.001,447,457,50,10,0.01,904,8
0.652,0.001,499,505,50,10,0.01,1004,8
0.676,0.001,548,556,50,10,0.01,1104,8
0.706,0.001,610,594,50,10,0.01,1204,8
0.736,0.001,660,644,50,10,0.01,1304,8
0.766,0.001,710,694,50,10,0.01,1404,8
0.794,0.001,749,755,50,10,0.01,1504,8
0.842,0.001,801,803,50,10,0.01,1604,8
0.872,0.001,853,851,50,10,0.01,1704,8
0.896,0.001,911,893,50,10,0.01,1804,8
0.926,0.001,960,944,50,10,0.01,1904,8
0.934,0.001,1014,990,50,10,0.01,2004,8
0.508,0.001,56,48,50,10,0.01,104,9
0.526,0.001,101,103,50,10,0.01,204,9
0.536,0.001,152,152,50,10,0.01,304,9
0.554,0.001,204,200,50,10,0.01,404,9
0.566,0.001,248,256,50,10,0.01,504,9
0.572,0.001,302,302,50,10,0.01,604,9
0.608,0.001,352,352,50,10,0.01,704,9
0.626,0.001,399,405,50,10,0.01,804,9
0.652,0.001,452,452,50,10,0.01,904,9
0.682,0.001,499,505,50,10,0.01,1004,9
0.708,0.001,556,548,50,10,0.01,1104,9
0.722,0.001,601,603,50,10,0.01,1204,9
0.746,0.001,654,650,50,10,0.01,1304,9
0.762,0.001,697,707,50,10,0.01,1404,9
0.758,0.001,755,749,50,10,0.01,1504,9
0.764,0.001,814,790,50,10,0.01,1604,9
0.77,0.001,869,835,50,10,0.01,1704,9
0.81,0.001,921,883,50,10,0.01,1804,9
0.806,0.001,966,938,50,10,0.01,1904,9
0.826,0.001,1010,994,50,10,0.01,2004,9
0.488,0.001,50,54,50,10,0.01,104,10
0.5,0.001,96,108,50,10,0.01,204,10
0.516,0.001,143,161,50,10,0.01,304,10
0.526,0.001,193,211,50,10,0.01,404,10
0.542,0.001,245,259,50,10,0.01,504,10
0.572,0.001,293,311,50,10,0.01,604,10
0.592,0.001,343,361,50,10,0.01,704,10
0.63,0.001,391,413,50,10,0.01,804,10
0.648,0.001,444,460,50,10,0.01,904,10
0.688,0.001,493,511,50,10,0.01,1004,10
0.72,0.001,549,555,50,10,0.01,1104,10
0.764,0.001,595,609,50,10,0.01,1204,10
0.82,0.001,640,664,50,10,0.01,1304,10
0.854,0.001,680,724,50,10,0.01,1404,10
0.868,0.001,731,773,50,10,0.01,1504,10
0.892,0.001,784,820,50,10,0.01,1604,10
0.904,0.001,831,873,50,10,0.01,1704,10
0.922,0.001,885,919,50,10,0.01,1804,10
0.93,0.001,942,962,50,10,0.01,1904,10
0.942,0.001,991,1013,50,10,0.01,2004,10
0.49,0.001,47,57,50,10,0.01,104,11
0.496,0.001,103,101,50,10,0.01,204,11
0.522,0.001,160,144,50,10,0.01,304,11
0.542,0.001,208,196,50,10,0.01,404,11
0.534,0.001,263,241,50,10,0.01,504,11
0.542,0.001,317,287,50,10,0.01,604,11
0.554,0.001,367,337,50,10,0.01,704,11
0.56,0.001,412,392,50,10,0.01,804,11
0.584,0.001,464,440,50,10,0.01,904,11
0.62,0.001,512,492,50,10,0.01,1004,11
0.658,0.001,558,546,50,10,0.01,1104,11
0.7,0.001,604,600,50,10,0.01,1204,11
0.748,0.001,647,657,50,10,0.01,1304,11
0.798,0.001,695,709,50,10,0.01,1404,11
0.834,0.001,741,763,50,10,0.01,1504,11
0.884,0.001,792,812,50,10,0.01,1604,11
0.892,0.001,847,857,50,10,0.01,1704,11
0.914,0.001,893,911,50,10,0.01,1804,11
0.926,0.001,948,956,50,10,0.01,1904,11
0.93,0.001,1005,999,50,10,0.01,2004,11
0.524,0.001,54,50,50,10,0.01,104,12
0.53,0.001,93,111,50,10,0.01,204,12
0.528,0.001,141,163,50,10,0.01,304,12
0.552,0.001,191,213,50,10,0.01,404,12
0.574,0.001,240,264,50,10,0.01,504,12
0.588,0.001,288,316,50,10,0.01,604,12
0.608,0.001,339,365,50,10,0.01,704,12
0.62,0.001,389,415,50,10,0.01,804,12
0.618,0.001,439,465,50,10,0.01,904,12
0.64,0.001,489,515,50,10,0.01,1004,12
0.68,0.001,533,571,50,10,0.01,1104,12
0.736,0.001,578,626,50,10,0.01,1204,12
0.79,0.001,631,673,50,10,0.01,1304,12
0.846,0.001,687,717,50,10,0.01,1404,12
0.892,0.001,740,764,50,10,0.01,1504,12
0.922,0.001,786,818,50,10,0.01,1604,12
0.928,0.001,837,867,50,10,0.01,1704,12
0.948,0.001,895,909,50,10,0.01,1804,12
0.954,0.001,941,963,50,10,0.01,1904,12
0.95,0.001,988,1016,50,10,0.01,2004,12
0.524,0.001,64,40,50,10,0.01,104,13
0.544,0.001,110,94,50,10,0.01,204,13
0.546,0.001,158,146,50,10,0.01,304,13
0.566,0.001,207,197,50,10,0.01,404,13
0.57,0.001,249,255,50,10,0.01,504,13
0.606,0.001,302,302,50,10,0.01,604,13
0.606,0.001,351,353,50,10,0.01,704,13
0.642,0.001,402,402,50,10,0.01,804,13
0.672,0.001,440,464,50,10,0.01,904,13
0.738,0.001,492,512,50,10,0.01,1004,13
0.776,0.001,556,548,50,10,0.01,1104,13
0.834,0.001,613,591,50,10,0.01,1204,13
0.88,0.001,664,640,50,10,0.01,1304,13
0.902,0.001,711,693,50,10,0.01,1404,13
0.922,0.001,756,748,50,10,0.01,1504,13
0.944,0.001,807,797,50,10,0.01,1604,13
0.952,0.001,858,846,50,10,0.01,1704,13
0.96,0.001,901,903,50,10,0.01,1804,13
0.958,0.001,948,956,50,10,0.01,1904,13
0.964,0.001,996,1008,50,10,0.01,2004,13
0.514,0.001,55,49,50,10,0.01,104,14
0.532,0.001,88,116,50,10,0.01,204,14
0.546,0.001,141,163,50,10,0.01,304,14
0.556,0.001,190,214,50,10,0.01,404,14
0.55,0.001,243,261,50,10,0.01,504,14
0.564,0.001,294,310,50,10,0.01,604,14
0.58,0.001,346,358,50,10,0.01,704,14
0.592,0.001,397,407,50,10,0.01,804,14
0.614,0.001,441,463,50,10,0.01,904,14
0.646,0.001,493,511,50,10,0.01,1004,14
0.648,0.001,546,558,50,10,0.01,1104,14
0.696,0.001,597,607,50,10,0.01,1204,14
0.75,0.001,642,662,50,10,0.01,1304,14
0.792,0.001,687,717,50,10,0.01,1404,14
0.832,0.001,744,760,50,10,0.01,1504,14
0.868,0.001,781,823,50,10,0.01,1604,14
0.886,0.001,829,875,50,10,0.01,1704,14
0.898,0.001,881,923,50,10,0.01,1804,14
0.916,0.001,936,968,50,10,0.01,1904,14
0.92,0.001,996,1008,50,10,0.01,2004,14
0.514,0.001,61,43,50,10,0.01,104,15
0.518,0.001,112,92,50,10,0.01,204,15
0.536,0.001,164,140,50,10,0.01,304,15
0.568,0.001,214,190,50,10,0.01,404,15
0.586,0.001,267,237,50,10,0.01,504,15
0.636,0.001,313,291,50,10,0.01,604,15
0.65,0.001,358,346,50,10,0.01,704,15
0.646,0.001,413,391,50,10,0.01,804,15
0.684,0.001,473,431,50,10,0.01,904,15
0.718,0.001,528,476,50,10,0.01,1004,15
0.774,0.001,577,527,50,10,0.01,1104,15
0.828,0.001,624,580,50,10,0.01,1204,15
0.868,0.001,670,634,50,10,0.01,1304,15
0.912,0.001,717,687,50,10,0.01,1404,15
0.932,0.001,757,747,50,10,0.01,1504,15
0.944,0.001,799,805,50,10,0.01,1604,15
0.954,0.001,843,861,50,10,0.01,1704,15
0.95,0.001,896,908,50,10,0.01,1804,15
0.952,0.001,943,961,50,10,0.01,1904,15
0.956,0.001,998,1006,50,10,0.01,2004,15
0.49,0.001,59,45,50,10,0.01,104,16
0.51,0.001,116,88,50,10,0.01,204,16
0.52,0.001,164,140,50,10,0.01,304,16
0.532,0.001,211,193,50,10,0.01,404,16
0.546,0.001,260,244,50,10,0.01,504,16
0.558,0.001,301,303,50,10,0.01,604,16
0.56,0.001,352,352,50,10,0.01,704,16
0.566,0.001,399,405,50,10,0.01,804,16
0.598,0.001,449,455,50,10,0.01,904,16
0.614,0.001,498,506,50,10,0.01,1004,16
0.628,0.001,543,561,50,10,0.01,1104,16
0.7,0.001,593,611,50,10,0.01,1204,16
0.762,0.001,643,661,50,10,0.01,1304,16
0.83,0.001,691,713,50,10,0.01,1404,16
0.872,0.001,742,762,50,10,0.01,1504,16
0.888,0.001,788,816,50,10,0.01,1604,16
0.898,0.001,833,871,50,10,0.01,1704,16
0.918,0.001,886,918,50,10,0.01,1804,16
0.922,0.001,947,957,50,10,0.01,1904,16
0.932,0.001,995,1009,50,10,0.01,2004,16
0.508,0.001,56,48,50,10,0.01,104,17
0.528,0.001,109,95,50,10,0.01,204,17
0.53,0.001,156,148,50,10,0.01,304,17
0.54,0.001,208,196,50,10,0.01,404,17
0.552,0.001,255,249,50,10,0.01,504,17
0.554,0.001,307,297,50,10,0.01,604,17
0.574,0.001,348,356,50,10,0.01,704,17
0.596,0.001,391,413,50,10,0.01,804,17
0.624,0.001,437,467,50,10,0.01,904,17
0.656,0.001,487,517,50,10,0.01,1004,17
0.688,0.001,531,573,50,10,0.01,1104,17
0.726,0.001,581,623,50,10,0.01,1204,17
0.748,0.001,627,677,50,10,0.01,1304,17
0.806,0.001,671,733,50,10,0.01,1404,17
0.858,0.001,724,780,50,10,0.01,1504,17
0.91,0.001,776,828,50,10,0.01,1604,17
0.932,0.001,821,883,50,10,0.01,1704,17
0.94,0.001,880,924,50,10,0.01,1804,17
0.942,0.001,937,967,50,10,0.01,1904,17
0.944,0.001,987,1017,50,10,0.01,2004,17
0.464,0.001,49,55,50,10,0.01,104,18
0.482,0.001,110,94,50,10,0.01,204,18
0.518,0.001,164,140,50,10,0.01,304,18
0.546,0.001,210,194,50,10,0.01,404,18
0.58,0.001,259,245,50,10,0.01,504,18
0.614,0.001,309,295,50,10,0.01,604,18
0.646,0.001,359,345,50,10,0.01,704,18
0.678,0.001,420,384,50,10,0.01,804,18
0.698,0.001,465,439,50,10,0.01,904,18
0.724,0.001,512,492,50,10,0.01,1004,18
0.742,0.001,562,542,50,10,0.01,1104,18
0.802,0.001,610,594,50,10,0.01,1204,18
0.84,0.001,664,640,50,10,0.01,1304,18
0.884,0.001,713,691,50,10,0.01,1404,18
0.906,0.001,756,748,50,10,0.01,1504,18
0.934,0.001,810,794,50,10,0.01,1604,18
0.944,0.001,864,840,50,10,0.01,1704,18
0.95,0.001,917,887,50,10,0.01,1804,18
0.948,0.001,959,945,50,10,0.01,1904,18
0.956,0.001,1009,995,50,10,0.01,2004,18
0.48,0.001,44,60,50,10,0.01,104,19
0.486,0.001,95,109,50,10,0.01,204,19
0.49,0.001,146,158,50,10,0.01,304,19
0.512,0.001,201,203,50,10,0.01,404,19
0.516,0.001,252,252,50,10,0.01,504,19
0.552,0.001,311,293,50,10,0.01,604,19
0.56,0.001,364,340,50,10,0.01,704,19
0.596,0.001,417,387,50,10,0.01,804,19
0.634,0.001,468,436,50,10,0.01,904,19
0.678,0.001,511,493,50,10,0.01,1004,19
0.716,0.001,557,547,50,10,0.01,1104,19
0.764,0.001,604,600,50,10,0.01,1204,19
0.796,0.001,659,645,50,10,0.01,1304,19
0.856,0.001,705,699,50,10,0.01,1404,19
0.872,0.001,759,745,50,10,0.01,1504,19
0.906,0.001,807,797,50,10,0.01,1604,19
0.936,0.001,863,841,50,10,0.01,1704,19
0.958,0.001,915,889,50,10,0.01,1804,19
0.964,0.001,959,945,50,10,0.01,1904,19
0.962,0.001,1004,1000,50,10,0.01,2004,19
0.478,0.001,50,54,50,10,0.01,104,20
0.504,0.001,108,96,50,10,0.01,204,20
0.504,0.001,164,140,50,10,0.01,304,20
0.516,0.001,220,184,50,10,0.01,404,20
0.526,0.001,271,233,50,10,0.01,504,20
0.534,0.001,316,288,50,10,0.01,604,20
0.534,0.001,367,337,50,10,0.01,704,20
0.556,0.001,418,386,50,10,0.01,804,20
0.576,0.001,459,445,50,10,0.01,904,20
0.61,0.001,509,495,50,10,0.01,1004,20
0.65,0.001,557,547,50,10,0.01,1104,20
0.676,0.001,614,590,50,10,0.01,1204,20
0.704,0.001,666,638,50,10,0.01,1304,20
0.772,0.001,717,687,50,10,0.01,1404,20
0.832,0.001,777,727,50,10,0.01,1504,20
0.88,0.001,820,784,50,10,0.01,1604,20
0.912,0.001,869,835,50,10,0.01,1704,20
0.932,0.001,912,892,50,10,0.01,1804,20
0.946,0.001,963,941,50,10,0.01,1904,20
0.94,0.001,1013,991,50,10,0.01,2004,20
0.502,1e-05,47,57,50,25,0.0001,104,1
0.502,1e-05,96,108,50,25,0.0001,204,1
0.502,1e-05,146,158,50,25,0.0001,304,1
0.504,1e-05,198,206,50,25,0.0001,404,1
0.504,1e-05,256,248,50,25,0.0001,504,1
0.504,1e-05,301,303,50,25,0.0001,604,1
0.504,1e-05,352,352,50,25,0.0001,704,1
0.504,1e-05,407,397,50,25,0.0001,804,1
0.504,1e-05,450,454,50,25,0.0001,904,1
0.504,1e-05,492,512,50,25,0.0001,1004,1
0.502,1e-05,540,564,50,25,0.0001,1104,1
0.502,1e-05,582,622,50,25,0.0001,1204,1
0.504,1e-05,633,671,50,25,0.0001,1304,1
0.504,1e-05,678,726,50,25,0.0001,1404,1
0.504,1e-05,731,773,50,25,0.0001,1504,1
0.504,1e-05,778,826,50,25,0.0001,1604,1
0.504,1e-05,833,871,50,25,0.0001,1704,1
0.504,1e-05,888,916,50,25,0.0001,1804,1
0.504,1e-05,942,962,50,25,0.0001,1904,1
0.504,1e-05,999,1005,50,25,0.0001,2004,1
0.554,1e-05,55,49,50,25,0.0001,104,2
0.554,1e-05,102,102,50,25,0.0001,204,2
0.554,1e-05,142,162,50,25,0.0001,304,2
0.552,1e-05,188,216,50,25,0.0001,404,2
0.556,1e-05,233,271,50,25,0.0001,504,2
0.56,1e-05,278,326,50,25,0.0001,604,2
0.56,1e-05,338,366,50,25,0.0001,704,2
0.558,1e-05,380,424,50,25,0.0001,804,2
0.556,1e-05,435,469,50,25,0.0001,904,2
0.556,1e-05,488,516,50,25,0.0001,1004,2
0.558,1e-05,538,566,50,25,0.0001,1104,2
0.56,1e-05,595,609,50,25,0.0001,1204,2
0.558,1e-05,639,665,50,25,0.0001,1304,2
0.56,1e-05,682,722,50,25,0.0001,1404,2
0.56,1e-05,736,768,50,25,0.0001,1504,2
0.562,1e-05,789,815,50,25,0.0001,1604,2
0.564,1e-05,837,867,50,25,0.0001,1704,2
0.566,1e-05,890,914,50,25,0.0001,1804,2
0.568,1e-05,946,958,50,25,0.0001,1904,2
0.564,1e-05,986,1018,50,25,0.0001,2004,2
0.498,1e-05,47,57,50,25,0.0001,104,3
0.498,1e-05,92,112,50,25,0.0001,204,3
0.498,1e-05,142,162,50,25,0.0001,304,3
0.498,1e-05,188,216,50,25,0.0001,404,3
0.498,1e-05,246,258,50,25,0.0001,504,3
0.498,1e-05,297,307,50,25,0.0001,604,3
0.498,1e-05,347,357,50,25,0.0001,704,3
0.498,1e-05,390,414,50,25,0.0001,804,3
0.498,1e-05,434,470,50,25,0.0001,904,3
0.498,1e-05,492,512,50,25,0.0001,1004,3
0.5,1e-05,534,570,50,25,0.0001,1104,3
0.5,1e-05,587,617,50,25,0.0001,1204,3
0.5,1e-05,649,655,50,25,0.0001,1304,3
0.502,1e-05,699,705,50,25,0.0001,1404,3
0.502,1e-05,751,753,50,25,0.0001,1504,3
0.502,1e-05,792,812,50,25,0.0001,1604,3
0.504,1e-05,846,858,50,25,0.0001,1704,3
0.504,1e-05,910,894,50,25,0.0001,1804,3
0.504,1e-05,955,949,50,25,0.0001,1904,3
0.504,1e-05,1000,1004,50,25,0.0001,2004,3
0.55,1e-05,52,52,50,25,0.0001,104,4
0.55,1e-05,98,106,50,25,0.0001,204,4
0.55,1e-05,149,155,50,25,0.0001,304,4
0.548,1e-05,193,211,50,25,0.0001,404,4
0.55,1e-05,246,258,50,25,0.0001,504,4
0.548,1e-05,295,309,50,25,0.0001,604,4
0.548,1e-05,348,356,50,25,0.0001,704,4
0.546,1e-05,397,407,50,25,0.0001,804,4
0.546,1e-05,451,453,50,25,0.0001,904,4
0.548,1e-05,501,503,50,25,0.0001,1004,4
0.556,1e-05,552,552,50,25,0.0001,1104,4
0.556,1e-05,604,600,50,25,0.0001,1204,4
0.556,1e-05,649,655,50,25,0.0001,1304,4
0.558,1e-05,692,712,50,25,0.0001,1404,4
0.558,1e-05,747,757,50,25,0.0001,1504,4
0.56,1e-05,796,808,50,25,0.0001,1604,4
0.558,1e-05,843,861,50,25,0.0001,1704,4
0.558,1e-05,899,905,50,25,0.0001,1804,4
0.558,1e-05,949,955,50,25,0.0001,1904,4
0.564,1e-05,993,1011,50,25,0.0001,2004,4
0.502,1e-05,49,55,50,25,0.0001,104,5
0.502,1e-05,106,98,50,25,0.0001,204,5
0.502,1e-05,154,150,50,25,0.0001,304,5
0.502,1e-05,197,207,50,25,0.0001,404,5
0.502,1e-05,243,261,50,25,0.0001,504,5
0.502,1e-05,295,309,50,25,0.0001,604,5
0.502,1e-05,343,361,50,25,0.0001,704,5
0.502,1e-05,396,408,50,25,0.0001,804,5
0.502,1e-05,447,457,50,25,0.0001,904,5
0.502,1e-05,493,511,50,25,0.0001,1004,5
0.502,1e-05,533,571,50,25,0.0001,1104,5
0.502,1e-05,584,620,50,25,0.0001,1204,5
0.502,1e-05,632,672,50,25,0.0001,1304,5
0.502,1e-05,685,719,50,25,0.0001,1404,5
0.5,1e-05,737,767,50,25,0.0001,1504,5
0.5,1e-05,799,805,50,25,0.0001,1604,5
0.5,1e-05,843,861,50,25,0.0001,1704,5
0.5,1e-05,894,910,50,25,0.0001,1804,5
0.5,1e-05,957,947,50,25,0.0001,1904,5
0.5,1e-05,1001,1003,50,25,0.0001,2004,5
0.5,1e-05,58,46,50,25,0.0001,104,6
0.5,1e-05,98,106,50,25,0.0001,204,6
0.5,1e-05,143,161,50,25,0.0001,304,6
0.5,1e-05,201,203,50,25,0.0001,404,6
0.5,1e-05,247,257,50,25,0.0001,504,6
0.5,1e-05,302,302,50,25,0.0001,604,6
0.5,1e-05,355,349,50,25,0.0001,704,6
0.5,1e-05,409,395,50,25,0.0001,804,6
0.5,1e-05,457,447,50,25,0.0001,904,6
0.5,1e-05,503,501,50,25,0.0001,1004,6
0.504,1e-05,546,558,50,25,0.0001,1104,6
0.506,1e-05,608,596,50,25,0.0001,1204,6
0.504,1e-05,657,647,50,25,0.0001,1304,6
0.504,1e-05,708,696,50,25,0.0001,1404,6
0.504,1e-05,758,746,50,25,0.0001,1504,6
0.506,1e-05,812,792,50,25,0.0001,1604,6
0.506,1e-05,858,846,50,25,0.0001,1704,6
0.51,1e-05,908,896,50,25,0.0001,1804,6
0.506,1e-05,953,951,50,25,0.0001,1904,6
0.508,1e-05,1005,999,50,25,0.0001,2004,6
0.478,1e-05,52,52,50,25,0.0001,104,7
0.478,1e-05,106,98,50,25,0.0001,204,7
0.48,1e-05,154,150,50,25,0.0001,304,7
0.484,1e-05,205,199,50,25,0.0001,404,7
0.488,1e-05,258,246,50,25,0.0001,504,7
0.488,1e-05,303,301,50,25,0.0001,604,7
0.492,1e-05,356,348,50,25,0.0001,704,7
0.49,1e-05,397,407,50,25,0.0001,804,7
0.49,1e-05,447,457,50,25,0.0001,904,7
0.49,1e-05,496,508,50,25,0.0001,1004,7
0.494,1e-05,544,560,50,25,0.0001,1104,7
0.494,1e-05,590,614,50,25,0.0001,1204,7
0.496,1e-05,637,667,50,25,0.0001,1304,7
0.494,1e-05,684,720,50,25,0.0001,1404,7
0.494,1e-05,738,766,50,25,0.0001,1504,7
0.492,1e-05,782,822,50,25,0.0001,1604,7
0.494,1e-05,836,868,50,25,0.0001,1704,7
0.494,1e-05,890,914,50,25,0.0001,1804,7
0.5,1e-05,939,965,50,25,0.0001,1904,7
0.502,1e-05,994,1010,50,25,0.0001,2004,7
0.554,1e-05,54,50,50,25,0.0001,104,8
0.554,1e-05,107,97,50,25,0.0001,204,8
0.556,1e-05,160,144,50,25,0.0001,304,8
0.554,1e-05,210,194,50,25,0.0001,404,8
0.556,1e-05,268,236,50,25,0.0001,504,8
0.556,1e-05,312,292,50,25,0.0001,604,8
0.558,1e-05,361,343,50,25,0.0001,704,8
0.558,1e-05,414,390,50,25,0.0001,804,8
0.558,1e-05,466,438,50,25,0.0001,904,8
0.558,1e-05,518,486,50,25,0.0001,1004,8
0.56,1e-05,565,539,50,25,0.0001,1104,8
0.56,1e-05,614,590,50,25,0.0001,1204,8
0.56,1e-05,664,640,50,25,0.0001,1304,8
0.556,1e-05,712,692,50,25,0.0001,1404,8
0.558,1e-05,756,748,50,25,0.0001,1504,8
0.558,1e-05,800,804,50,25,0.0001,1604,8
0.56,1e-05,848,856,50,25,0.0001,1704,8
0.562,1e-05,899,905,50,25,0.0001,1804,8
0.562,1e-05,955,949,50,25,0.0001,1904,8
0.564,1e-05,1009,995,50,25,0.0001,2004,8
0.528,1e-05,43,61,50,25,0.0001,104,9
0.528,1e-05,83,121,50,25,0.0001,204,9
0.528,1e-05,134,170,50,25,0.0001,304,9
0.528,1e-05,183,221,50,25,0.0001,404,9
0.526,1e-05,233,271,50,25,0.0001,504,9
0.526,1e-05,279,325,50,25,0.0001,604,9
0.526,1e-05,337,367,50,25,0.0001,704,9
0.528,1e-05,387,417,50,25,0.0001,804,9
0.53,1e-05,450,454,50,25,0.0001,904,9
0.53,1e-05,499,505,50,25,0.0001,1004,9
0.53,1e-05,550,554,50,25,0.0001,1104,9
0.53,1e-05,597,607,50,25,0.0001,1204,9
0.528,1e-05,649,655,50,25,0.0001,1304,9
0.532,1e-05,696,708,50,25,0.0001,1404,9
0.53,1e-05,752,752,50,25,0.0001,1504,9
0.528,1e-05,802,802,50,25,0.0001,1604,9
0.526,1e-05,849,855,50,25,0.0001,1704,9
0.524,1e-05,909,895,50,25,0.0001,1804,9
0.524,1e-05,957,947,50,25,0.0001,1904,9
0.526,1e-05,1007,997,50,25,0.0001,2004,9
0.488,1e-05,54,50,50,25,0.0001,104,10
0.488,1e-05,109,95,50,25,0.0001,204,10
0.49,1e-05,165,139,50,25,0.0001,304,10
0.49,1e-05,220,184,50,25,0.0001,404,10
0.49,1e-05,266,238,50,25,0.0001,504,10
0.492,1e-05,318,286,50,25,0.0001,604,10
0.492,1e-05,377,327,50,25,0.0001,704,10
0.49,1e-05,427,377,50,25,0.0001,804,10
0.488,1e-05,480,424,50,25,0.0001,904,10
0.488,1e-05,531,473,50,25,0.0001,1004,10
0.488,1e-05,579,525,50,25,0.0001,1104,10
0.486,1e-05,635,569,50,25,0.0001,1204,10
0.496,1e-05,691,613,50,25,0.0001,1304,10
0.496,1e-05,728,676,50,25,0.0001,1404,10
0.498,1e-05,783,721,50,25,0.0001,1504,10
0.504,1e-05,838,766,50,25,0.0001,1604,10
0.508,1e-05,881,823,50,25,0.0001,1704,10
0.506,1e-05,934,870,50,25,0.0001,1804,10
0.504,1e-05,977,927,50,25,0.0001,1904,10
0.504,1e-05,1018,986,50,25,0.0001,2004,10
0.49,1e-05,49,55,50,25,0.0001,104,11
0.49,1e-05,90,114,50,25,0.0001,204,11
0.49,1e-05,133,171,50,25,0.0001,304,11
0.488,1e-05,186,218,50,25,0.0001,404,11
0.486,1e-05,233,271,50,25,0.0001,504,11
0.486,1e-05,285,319,50,25,0.0001,604,11
0.486,1e-05,341,363,50,25,0.0001,704,11
0.492,1e-05,390,414,50,25,0.0001,804,11
0.492,1e-05,443,461,50,25,0.0001,904,11
0.494,1e-05,490,514,50,25,0.0001,1004,11
0.494,1e-05,530,574,50,25,0.0001,1104,11
0.498,1e-05,581,623,50,25,0.0001,1204,11
0.498,1e-05,631,673,50,25,0.0001,1304,11
0.504,1e-05,678,726,50,25,0.0001,1404,11
0.506,1e-05,722,782,50,25,0.0001,1504,11
0.51,1e-05,774,830,50,25,0.0001,1604,11
0.512,1e-05,831,873,50,25,0.0001,1704,11
0.512,1e-05,883,921,50,25,0.0001,1804,11
0.51,1e-05,934,970,50,25,0.0001,1904,11
0.514,1e-05,980,1024,50,25,0.0001,2004,11
0.496,1e-05,46,58,50,25,0.0001,104,12
0.498,1e-05,93,111,50,25,0.0001,204,12
0.498,1e-05,153,151,50,25,0.0001,304,12
0.496,1e-05,202,202,50,25,0.0001,404,12
0.496,1e-05,251,253,50,25,0.0001,504,12
0.494,1e-05,304,300,50,25,0.0001,604,12
0.494,1e-05,350,354,50,25,0.0001,704,12
0.496,1e-05,392,412,50,25,0.0001,804,12
0.496,1e-05,435,469,50,25,0.0001,904,12
0.496,1e-05,479,525,50,25,0.0001,1004,12
0.494,1e-05,522,582,50,25,0.0001,1104,12
0.492,1e-05,582,622,50,25,0.0001,1204,12
0.498,1e-05,622,682,50,25,0.0001,1304,12
0.498,1e-05,676,728,50,25,0.0001,1404,12
0.494,1e-05,730,774,50,25,0.0001,1504,12
0.496,1e-05,785,819,50,25,0.0001,1604,12
0.5,1e-05,838,866,50,25,0.0001,1704,12
0.506,1e-05,889,915,50,25,0.0001,1804,12
0.506,1e-05,941,963,50,25,0.0001,1904,12
0.51,1e-05,989,1015,50,25,0.0001,2004,12
0.514,1e-05,58,46,50,25,0.0001,104,13
0.514,1e-05,107,97,50,25,0.0001,204,13
0.514,1e-05,163,141,50,25,0.0001,304,13
0.516,1e-05,216,188,50,25,0.0001,404,13
0.518,1e-05,261,243,50,25,0.0001,504,13
0.52,1e-05,315,289,50,25,0.0001,604,13
0.52,1e-05,364,340,50,25,0.0001,704,13
0.52,1e-05,418,386,50,25,0.0001,804,13
0.518,1e-05,461,443,50,25,0.0001,904,13
0.516,1e-05,513,491,50,25,0.0001,1004,13
0.52,1e-05,564,540,50,25,0.0001,1104,13
0.522,1e-05,614,590,50,25,0.0001,1204,13
0.524,1e-05,668,636,50,25,0.0001,1304,13
0.526,1e-05,723,681,50,25,0.0001,1404,13
0.526,1e-05,772,732,50,25,0.0001,1504,13
0.524,1e-05,817,787,50,25,0.0001,1604,13
0.524,1e-05,870,834,50,25,0.0001,1704,13
0.528,1e-05,921,883,50,25,0.0001,1804,13
0.534,1e-05,961,943,50,25,0.0001,1904,13
0.536,1e-05,1012,992,50,25,0.0001,2004,13
0.538,1e-05,48,56,50,25,0.0001,104,14
0.538,1e-05,96,108,50,25,0.0001,204,14
0.538,1e-05,143,161,50,25,0.0001,304,14
0.536,1e-05,187,217,50,25,0.0001,404,14
0.534,1e-05,234,270,50,25,0.0001,504,14
0.534,1e-05,279,325,50,25,0.0001,604,14
0.534,1e-05,328,376,50,25,0.0001,704,14
0.536,1e-05,387,417,50,25,0.0001,804,14
0.534,1e-05,426,478,50,25,0.0001,904,14
0.532,1e-05,473,531,50,25,0.0001,1004,14
0.53,1e-05,530,574,50,25,0.0001,1104,14
0.528,1e-05,589,615,50,25,0.0001,1204,14
0.53,1e-05,639,665,50,25,0.0001,1304,14
0.53,1e-05,691,713,50,25,0.0001,1404,14
0.528,1e-05,739,765,50,25,0.0001,1504,14
0.526,1e-05,786,818,50,25,0.0001,1604,14
0.526,1e-05,838,866,50,25,0.0001,1704,14
0.526,1e-05,890,914,50,25,0.0001,1804,14
0.528,1e-05,939,965,50,25,0.0001,1904,14
0.528,1e-05,983,1021,50,25,0.0001,2004,14
0.486,1e-05,49,55,50,25,0.0001,104,15
0.486,1e-05,98,106,50,25,0.0001,204,15
0.486,1e-05,152,152,50,25,0.0001,304,15
0.486,1e-05,210,194,50,25,0.0001,404,15
0.486,1e-05,262,242,50,25,0.0001,504,15
0.486,1e-05,305,299,50,25,0.0001,604,15
0.486,1e-05,357,347,50,25,0.0001,704,15
0.484,1e-05,411,393,50,25,0.0001,804,15
0.484,1e-05,451,453,50,25,0.0001,904,15
0.482,1e-05,504,500,50,25,0.0001,1004,15
0.482,1e-05,564,540,50,25,0.0001,1104,15
0.482,1e-05,609,595,50,25,0.0001,1204,15
0.482,1e-05,660,644,50,25,0.0001,1304,15
0.482,1e-05,719,685,50,25,0.0001,1404,15
0.482,1e-05,765,739,50,25,0.0001,1504,15
0.484,1e-05,820,784,50,25,0.0001,1604,15
0.48,1e-05,868,836,50,25,0.0001,1704,15
0.482,1e-05,907,897,50,25,0.0001,1804,15
0.482,1e-05,955,949,50,25,0.0001,1904,15
0.482,1e-05,1011,993,50,25,0.0001,2004,15
0.52,1e-05,49,55,50,25,0.0001,104,16
0.52,1e-05,105,99,50,25,0.0001,204,16
0.516,1e-05,158,146,50,25,0.0001,304,16
0.522,1e-05,212,192,50,25,0.0001,404,16
0.524,1e-05,263,241,50,25,0.0001,504,16
0.524,1e-05,311,293,50,25,0.0001,604,16
0.526,1e-05,369,335,50,25,0.0001,704,16
0.526,1e-05,416,388,50,25,0.0001,804,16
0.528,1e-05,469,435,50,25,0.0001,904,16
0.528,1e-05,520,484,50,25,0.0001,1004,16
0.526,1e-05,569,535,50,25,0.0001,1104,16
0.528,1e-05,616,588,50,25,0.0001,1204,16
0.532,1e-05,664,640,50,25,0.0001,1304,16
0.532,1e-05,714,690,50,25,0.0001,1404,16
0.532,1e-05,765,739,50,25,0.0001,1504,16
0.536,1e-05,806,798,50,25,0.0001,1604,16
0.536,1e-05,854,850,50,25,0.0001,1704,16
0.536,1e-05,904,900,50,25,0.0001,1804,16
0.542,1e-05,944,960,50,25,0.0001,1904,16
0.544,1e-05,991,1013,50,25,0.0001,2004,16
0.488,1e-05,53,51,50,25,0.0001,104,17
0.49,1e-05,113,91,50,25,0.0001,204,17
0.49,1e-05,157,147,50,25,0.0001,304,17
0.492,1e-05,209,195,50,25,0.0001,404,17
0.492,1e-05,255,249,50,25,0.0001,504,17
0.494,1e-05,297,307,50,25,0.0001,604,17
0.494,1e-05,351,353,50,25,0.0001,704,17
0.498,1e-05,407,397,50,25,0.0001,804,17
0.498,1e-05,460,444,50,25,0.0001,904,17
0.502,1e-05,501,503,50,25,0.0001,1004,17
0.504,1e-05,558,546,50,25,0.0001,1104,17
0.508,1e-05,605,599,50,25,0.0001,1204,17
0.508,1e-05,647,657,50,25,0.0001,1304,17
0.504,1e-05,709,695,50,25,0.0001,1404,17
0.504,1e-05,759,745,50,25,0.0001,1504,17
0.504,1e-05,805,799,50,25,0.0001,1604,17
0.504,1e-05,851,853,50,25,0.0001,1704,17
0.508,1e-05,891,913,50,25,0.0001,1804,17
0.51,1e-05,937,967,50,25,0.0001,1904,17
0.512,1e-05,990,1014,50,25,0.0001,2004,17
0.482,1e-05,43,61,50,25,0.0001,104,18
0.482,1e-05,95,109,50,25,0.0001,204,18
0.48,1e-05,144,160,50,25,0.0001,304,18
0.48,1e-05,203,201,50,25,0.0001,404,18
0.48,1e-05,259,245,50,25,0.0001,504,18
0.48,1e-05,314,290,50,25,0.0001,604,18
0.478,1e-05,366,338,50,25,0.0001,704,18
0.478,1e-05,420,384,50,25,0.0001,804,18
0.478,1e-05,466,438,50,25,0.0001,904,18
0.478,1e-05,514,490,50,25,0.0001,1004,18
0.486,1e-05,558,546,50,25,0.0001,1104,18
0.486,1e-05,605,599,50,25,0.0001,1204,18
0.488,1e-05,657,647,50,25,0.0001,1304,18
0.49,1e-05,709,695,50,25,0.0001,1404,18
0.492,1e-05,755,749,50,25,0.0001,1504,18
0.498,1e-05,806,798,50,25,0.0001,1604,18
0.496,1e-05,858,846,50,25,0.0001,1704,18
0.498,1e-05,914,890,50,25,0.0001,1804,18
0.496,1e-05,964,940,50,25,0.0001,1904,18
0.5,1e-05,1013,991,50,25,0.0001,2004,18
0.49,1e-05,49,55,50,25,0.0001,104,19
0.492,1e-05,101,103,50,25,0.0001,204,19
0.492,1e-05,153,151,50,25,0.0001,304,19
0.488,1e-05,201,203,50,25,0.0001,404,19
0.488,1e-05,252,252,50,25,0.0001,504,19
0.49,1e-05,291,313,50,25,0.0001,604,19
0.488,1e-05,343,361,50,25,0.0001,704,19
0.494,1e-05,390,414,50,25,0.0001,804,19
0.496,1e-05,442,462,50,25,0.0001,904,19
0.5,1e-05,489,515,50,25,0.0001,1004,19
0.504,1e-05,537,567,50,25,0.0001,1104,19
0.508,1e-05,588,616,50,25,0.0001,1204,19
0.508,1e-05,645,659,50,25,0.0001,1304,19
0.508,1e-05,690,714,50,25,0.0001,1404,19
0.508,1e-05,742,762,50,25,0.0001,1504,19
0.508,1e-05,799,805,50,25,0.0001,1604,19
0.512,1e-05,855,849,50,25,0.0001,1704,19
0.51,1e-05,911,893,50,25,0.0001,1804,19
0.51,1e-05,950,954,50,25,0.0001,1904,19
0.514,1e-05,1000,1004,50,25,0.0001,2004,19
0.466,1e-05,49,55,50,25,0.0001,104,20
0.468,1e-05,100,104,50,25,0.0001,204,20
0.466,1e-05,156,148,50,25,0.0001,304,20
0.464,1e-05,202,202,50,25,0.0001,404,20
0.464,1e-05,252,252,50,25,0.0001,504,20
0.464,1e-05,312,292,50,25,0.0001,604,20
0.464,1e-05,366,338,50,25,0.0001,704,20
0.464,1e-05,430,374,50,25,0.0001,804,20
0.462,1e-05,473,431,50,25,0.0001,904,20
0.464,1e-05,528,476,50,25,0.0001,1004,20
0.468,1e-05,570,534,50,25,0.0001,1104,20
0.466,1e-05,619,585,50,25,0.0001,1204,20
0.464,1e-05,668,636,50,25,0.0001,1304,20
0.464,1e-05,721,683,50,25,0.0001,1404,20
0.464,1e-05,775,729,50,25,0.0001,1504,20
0.464,1e-05,817,787,50,25,0.0001,1604,20
0.468,1e-05,863,841,50,25,0.0001,1704,20
0.472,1e-05,912,892,50,25,0.0001,1804,20
0.468,1e-05,963,941,50,25,0.0001,1904,20
0.47,1e-05,1009,995,50,25,0.0001,2004,20
0.478,1e-05,47,57,50,25,0.001,104,1
0.48,1e-05,94,110,50,25,0.001,204,1
0.48,1e-05,145,159,50,25,0.001,304,1
0.486,1e-05,191,213,50,25,0.001,404,1
0.492,1e-05,245,259,50,25,0.001,504,1
0.498,1e-05,291,313,50,25,0.001,604,1
0.5,1e-05,343,361,50,25,0.001,704,1
0.504,1e-05,396,408,50,25,0.001,804,1
0.512,1e-05,451,453,50,25,0.001,904,1
0.53,1e-05,504,500,50,25,0.001,1004,1
0.538,1e-05,549,555,50,25,0.001,1104,1
0.552,1e-05,593,611,50,25,0.001,1204,1
0.554,1e-05,639,665,50,25,0.001,1304,1
0.566,1e-05,687,717,50,25,0.001,1404,1
0.572,1e-05,733,771,50,25,0.001,1504,1
0.578,1e-05,789,815,50,25,0.001,1604,1
0.592,1e-05,845,859,50,25,0.001,1704,1
0.61,1e-05,889,915,50,25,0.001,1804,1
0.62,1e-05,941,963,50,25,0.001,1904,1
0.652,1e-05,992,1012,50,25,0.001,2004,1
0.536,1e-05,53,51,50,25,0.001,104,2
0.538,1e-05,96,108,50,25,0.001,204,2
0.536,1e-05,144,160,50,25,0.001,304,2
0.536,1e-05,192,212,50,25,0.001,404,2
0.546,1e-05,246,258,50,25,0.001,504,2
0.552,1e-05,291,313,50,25,0.001,604,2
0.564,1e-05,335,369,50,25,0.001,704,2
0.56,1e-05,392,412,50,25,0.001,804,2
0.572,1e-05,441,463,50,25,0.001,904,2
0.58,1e-05,497,507,50,25,0.001,1004,2
0.588,1e-05,563,541,50,25,0.001,1104,2
0.6,1e-05,610,594,50,25,0.001,1204,2
0.618,1e-05,657,647,50,25,0.001,1304,2
0.626,1e-05,702,702,50,25,0.001,1404,2
0.634,1e-05,752,752,50,25,0.001,1504,2
0.658,1e-05,802,802,50,25,0.001,1604,2
0.678,1e-05,845,859,50,25,0.001,1704,2
0.7,1e-05,902,902,50,25,0.001,1804,2
0.714,1e-05,960,944,50,25,0.001,1904,2
0.726,1e-05,1010,994,50,25,0.001,2004,2
0.494,1e-05,50,54,50,25,0.001,104,3
0.49,1e-05,103,101,50,25,0.001,204,3
0.484,1e-05,150,154,50,25,0.001,304,3
0.496,1e-05,209,195,50,25,0.001,404,3
0.504,1e-05,260,244,50,25,0.001,504,3
0.512,1e-05,314,290,50,25,0.001,604,3
0.516,1e-05,366,338,50,25,0.001,704,3
0.516,1e-05,414,390,50,25,0.001,804,3
0.522,1e-05,465,439,50,25,0.001,904,3
0.528,1e-05,511,493,50,25,0.001,1004,3
0.548,1e-05,560,544,50,25,0.001,1104,3
0.556,1e-05,610,594,50,25,0.001,1204,3
0.56,1e-05,665,639,50,25,0.001,1304,3
0.566,1e-05,710,694,50,25,0.001,1404,3
0.582,1e-05,753,751,50,25,0.001,1504,3
0.59,1e-05,804,800,50,25,0.001,1604,3
0.602,1e-05,847,857,50,25,0.001,1704,3
0.614,1e-05,892,912,50,25,0.001,1804,3
0.64,1e-05,943,961,50,25,0.001,1904,3
0.65,1e-05,990,1014,50,25,0.001,2004,3
0.516,1e-05,50,54,50,25,0.001,104,4
0.52,1e-05,102,102,50,25,0.001,204,4
0.516,1e-05,162,142,50,25,0.001,304,4
0.516,1e-05,204,200,50,25,0.001,404,4
0.514,1e-05,255,249,50,25,0.001,504,4
0.524,1e-05,307,297,50,25,0.001,604,4
0.522,1e-05,355,349,50,25,0.001,704,4
0.532,1e-05,414,390,50,25,0.001,804,4
0.542,1e-05,464,440,50,25,0.001,904,4
0.546,1e-05,515,489,50,25,0.001,1004,4
0.548,1e-05,564,540,50,25,0.001,1104,4
0.56,1e-05,620,584,50,25,0.001,1204,4
0.578,1e-05,666,638,50,25,0.001,1304,4
0.596,1e-05,723,681,50,25,0.001,1404,4
0.61,1e-05,772,732,50,25,0.001,1504,4
0.632,1e-05,824,780,50,25,0.001,1604,4
0.652,1e-05,862,842,50,25,0.001,1704,4
0.666,1e-05,912,892,50,25,0.001,1804,4
0.678,1e-05,961,943,50,25,0.001,1904,4
0.692,1e-05,1010,994,50,25,0.001,2004,4
0.52,1e-05,52,52,50,25,0.001,104,5
0.524,1e-05,100,104,50,25,0.001,204,5
0.526,1e-05,150,154,50,25,0.001,304,5
0.53,1e-05,200,204,50,25,0.001,404,5
0.532,1e-05,245,259,50,25,0.001,504,5
0.534,1e-05,300,304,50,25,0.001,604,5
0.538,1e-05,353,351,50,25,0.001,704,5
0.542,1e-05,405,399,50,25,0.001,804,5
0.548,1e-05,447,457,50,25,0.001,904,5
0.552,1e-05,495,509,50,25,0.001,1004,5
0.558,1e-05,545,559,50,25,0.001,1104,5
0.57,1e-05,595,609,50,25,0.001,1204,5
0.578,1e-05,644,660,50,25,0.001,1304,5
0.6,1e-05,692,712,50,25,0.001,1404,5
0.61,1e-05,743,761,50,25,0.001,1504,5
0.624,1e-05,793,811,50,25,0.001,1604,5
0.642,1e-05,839,865,50,25,0.001,1704,5
0.656,1e-05,895,909,50,25,0.001,1804,5
0.666,1e-05,951,953,50,25,0.001,1904,5
0.686,1e-05,999,1005,50,25,0.001,2004,5
0.518,1e-05,53,51,50,25,0.001,104,6
0.52,1e-05,106,98,50,25,0.001,204,6
0.514,1e-05,153,151,50,25,0.001,304,6
0.514,1e-05,205,199,50,25,0.001,404,6
0.524,1e-05,256,248,50,25,0.001,504,6
0.522,1e-05,305,299,50,25,0.001,604,6
0.532,1e-05,358,346,50,25,0.001,704,6
0.532,1e-05,407,397,50,25,0.001,804,6
0.538,1e-05,457,447,50,25,0.001,904,6
0.562,1e-05,513,491,50,25,0.001,1004,6
0.566,1e-05,561,543,50,25,0.001,1104,6
0.576,1e-05,611,593,50,25,0.001,1204,6
0.588,1e-05,666,638,50,25,0.001,1304,6
0.606,1e-05,713,691,50,25,0.001,1404,6
0.616,1e-05,760,744,50,25,0.001,1504,6
0.63,1e-05,813,791,50,25,0.001,1604,6
0.638,1e-05,866,838,50,25,0.001,1704,6
0.672,1e-05,914,890,50,25,0.001,1804,6
0.706,1e-05,966,938,50,25,0.001,1904,6
0.736,1e-05,1012,992,50,25,0.001,2004,6
0.528,1e-05,51,53,50,25,0.001,104,7
0.528,1e-05,107,97,50,25,0.001,204,7
0.528,1e-05,156,148,50,25,0.001,304,7
0.528,1e-05,203,201,50,25,0.001,404,7
0.53,1e-05,258,246,50,25,0.001,504,7
0.53,1e-05,307,297,50,25,0.001,604,7
0.536,1e-05,361,343,50,25,0.001,704,7
0.544,1e-05,423,381,50,25,0.001,804,7
0.548,1e-05,473,431,50,25,0.001,904,7
0.546,1e-05,528,476,50,25,0.001,1004,7
0.55,1e-05,575,529,50,25,0.001,1104,7
0.554,1e-05,623,581,50,25,0.001,1204,7
0.556,1e-05,663,641,50,25,0.001,1304,7
0.578,1e-05,715,689,50,25,0.001,1404,7
0.59,1e-05,772,732,50,25,0.001,1504,7
0.596,1e-05,824,780,50,25,0.001,1604,7
0.608,1e-05,868,836,50,25,0.001,1704,7
0.626,1e-05,918,886,50,25,0.001,1804,7
0.64,1e-05,967,937,50,25,0.001,1904,7
0.636,1e-05,1013,991,50,25,0.001,2004,7
0.46,1e-05,45,59,50,25,0.001,104,8
0.456,1e-05,91,113,50,25,0.001,204,8
0.456,1e-05,143,161,50,25,0.001,304,8
0.462,1e-05,191,213,50,25,0.001,404,8
0.464,1e-05,237,267,50,25,0.001,504,8
0.472,1e-05,280,324,50,25,0.001,604,8
0.476,1e-05,335,369,50,25,0.001,704,8
0.476,1e-05,390,414,50,25,0.001,804,8
0.474,1e-05,438,466,50,25,0.001,904,8
0.484,1e-05,491,513,50,25,0.001,1004,8
0.494,1e-05,546,558,50,25,0.001,1104,8
0.5,1e-05,591,613,50,25,0.001,1204,8
0.502,1e-05,644,660,50,25,0.001,1304,8
0.516,1e-05,689,715,50,25,0.001,1404,8
0.544,1e-05,733,771,50,25,0.001,1504,8
0.556,1e-05,790,814,50,25,0.001,1604,8
0.58,1e-05,836,868,50,25,0.001,1704,8
0.61,1e-05,882,922,50,25,0.001,1804,8
0.648,1e-05,933,971,50,25,0.001,1904,8
0.684,1e-05,988,1016,50,25,0.001,2004,8
0.512,1e-05,59,45,50,25,0.001,104,9
0.51,1e-05,108,96,50,25,0.001,204,9
0.52,1e-05,147,157,50,25,0.001,304,9
0.524,1e-05,202,202,50,25,0.001,404,9
0.53,1e-05,254,250,50,25,0.001,504,9
0.534,1e-05,306,298,50,25,0.001,604,9
0.544,1e-05,363,341,50,25,0.001,704,9
0.55,1e-05,414,390,50,25,0.001,804,9
0.556,1e-05,462,442,50,25,0.001,904,9
0.566,1e-05,506,498,50,25,0.001,1004,9
0.578,1e-05,551,553,50,25,0.001,1104,9
0.582,1e-05,607,597,50,25,0.001,1204,9
0.592,1e-05,661,643,50,25,0.001,1304,9
0.612,1e-05,709,695,50,25,0.001,1404,9
0.616,1e-05,761,743,50,25,0.001,1504,9
0.634,1e-05,807,797,50,25,0.001,1604,9
0.642,1e-05,851,853,50,25,0.001,1704,9
0.656,1e-05,897,907,50,25,0.001,1804,9
0.664,1e-05,944,960,50,25,0.001,1904,9
0.678,1e-05,1002,1002,50,25,0.001,2004,9
0.51,1e-05,52,52,50,25,0.001,104,10
0.508,1e-05,106,98,50,25,0.001,204,10
0.516,1e-05,150,154,50,25,0.001,304,10
0.522,1e-05,196,208,50,25,0.001,404,10
0.522,1e-05,252,252,50,25,0.001,504,10
0.522,1e-05,306,298,50,25,0.001,604,10
0.518,1e-05,358,346,50,25,0.001,704,10
0.522,1e-05,401,403,50,25,0.001,804,10
0.526,1e-05,447,457,50,25,0.001,904,10
0.54,1e-05,499,505,50,25,0.001,1004,10
0.554,1e-05,547,557,50,25,0.001,1104,10
0.56,1e-05,589,615,50,25,0.001,1204,10
0.56,1e-05,641,663,50,25,0.001,1304,10
0.576,1e-05,688,716,50,25,0.001,1404,10
0.59,1e-05,741,763,50,25,0.001,1504,10
0.6,1e-05,792,812,50,25,0.001,1604,10
0.618,1e-05,835,869,50,25,0.001,1704,10
0.638,1e-05,892,912,50,25,0.001,1804,10
0.646,1e-05,936,968,50,25,0.001,1904,10
0.664,1e-05,993,1011,50,25,0.001,2004,10
0.524,1e-05,59,45,50,25,0.001,104,11
0.522,1e-05,113,91,50,25,0.001,204,11
0.526,1e-05,160,144,50,25,0.001,304,11
0.534,1e-05,208,196,50,25,0.001,404,11
0.536,1e-05,256,248,50,25,0.001,504,11
0.546,1e-05,307,297,50,25,0.001,604,11
0.564,1e-05,353,351,50,25,0.001,704,11
0.568,1e-05,394,410,50,25,0.001,804,11
0.574,1e-05,441,463,50,25,0.001,904,11
0.58,1e-05,491,513,50,25,0.001,1004,11
0.592,1e-05,551,553,50,25,0.001,1104,11
0.604,1e-05,603,601,50,25,0.001,1204,11
0.604,1e-05,651,653,50,25,0.001,1304,11
0.628,1e-05,701,703,50,25,0.001,1404,11
0.644,1e-05,753,751,50,25,0.001,1504,11
0.678,1e-05,799,805,50,25,0.001,1604,11
0.69,1e-05,850,854,50,25,0.001,1704,11
0.706,1e-05,903,901,50,25,0.001,1804,11
0.726,1e-05,954,950,50,25,0.001,1904,11
0.738,1e-05,1007,997,50,25,0.001,2004,11
0.516,1e-05,52,52,50,25,0.001,104,12
0.516,1e-05,96,108,50,25,0.001,204,12
0.51,1e-05,139,165,50,25,0.001,304,12
0.51,1e-05,191,213,50,25,0.001,404,12
0.51,1e-05,247,257,50,25,0.001,504,12
0.512,1e-05,297,307,50,25,0.001,604,12
0.508,1e-05,340,364,50,25,0.001,704,12
0.514,1e-05,394,410,50,25,0.001,804,12
0.524,1e-05,450,454,50,25,0.001,904,12
0.532,1e-05,503,501,50,25,0.001,1004,12
0.542,1e-05,557,547,50,25,0.001,1104,12
0.556,1e-05,607,597,50,25,0.001,1204,12
0.564,1e-05,652,652,50,25,0.001,1304,12
0.58,1e-05,698,706,50,25,0.001,1404,12
0.588,1e-05,753,751,50,25,0.001,1504,12
0.614,1e-05,796,808,50,25,0.001,1604,12
0.638,1e-05,847,857,50,25,0.001,1704,12
0.654,1e-05,900,904,50,25,0.001,1804,12
0.672,1e-05,948,956,50,25,0.001,1904,12
0.684,1e-05,1004,1000,50,25,0.001,2004,12
0.538,1e-05,47,57,50,25,0.001,104,13
0.546,1e-05,100,104,50,25,0.001,204,13
0.548,1e-05,150,154,50,25,0.001,304,13
0.554,1e-05,201,203,50,25,0.001,404,13
0.558,1e-05,246,258,50,25,0.001,504,13
0.562,1e-05,299,305,50,25,0.001,604,13
0.572,1e-05,349,355,50,25,0.001,704,13
0.572,1e-05,395,409,50,25,0.001,804,13
0.578,1e-05,452,452,50,25,0.001,904,13
0.584,1e-05,506,498,50,25,0.001,1004,13
0.596,1e-05,556,548,50,25,0.001,1104,13
0.614,1e-05,602,602,50,25,0.001,1204,13
0.624,1e-05,640,664,50,25,0.001,1304,13
0.636,1e-05,692,712,50,25,0.001,1404,13
0.638,1e-05,747,757,50,25,0.001,1504,13
0.648,1e-05,802,802,50,25,0.001,1604,13
0.658,1e-05,856,848,50,25,0.001,1704,13
0.68,1e-05,912,892,50,25,0.001,1804,13
0.698,1e-05,957,947,50,25,0.001,1904,13
0.726,1e-05,997,1007,50,25,0.001,2004,13
0.49,1e-05,58,46,50,25,0.001,104,14
0.496,1e-05,113,91,50,25,0.001,204,14
0.5,1e-05,161,143,50,25,0.001,304,14
0.498,1e-05,211,193,50,25,0.001,404,14
0.5,1e-05,258,246,50,25,0.001,504,14
0.504,1e-05,300,304,50,25,0.001,604,14
0.506,1e-05,354,350,50,25,0.001,704,14
0.498,1e-05,402,402,50,25,0.001,804,14
0.508,1e-05,450,454,50,25,0.001,904,14
0.536,1e-05,497,507,50,25,0.001,1004,14
0.542,1e-05,545,559,50,25,0.001,1104,14
0.55,1e-05,607,597,50,25,0.001,1204,14
0.576,1e-05,650,654,50,25,0.001,1304,14
0.582,1e-05,692,712,50,25,0.001,1404,14
0.602,1e-05,740,764,50,25,0.001,1504,14
0.608,1e-05,796,808,50,25,0.001,1604,14
0.626,1e-05,849,855,50,25,0.001,1704,14
0.63,1e-05,896,908,50,25,0.001,1804,14
0.67,1e-05,952,952,50,25,0.001,1904,14
0.68,1e-05,999,1005,50,25,0.001,2004,14
0.512,1e-05,47,57,50,25,0.001,104,15
0.516,1e-05,99,105,50,25,0.001,204,15
0.516,1e-05,154,150,50,25,0.001,304,15
0.512,1e-05,210,194,50,25,0.001,404,15
0.514,1e-05,255,249,50,25,0.001,504,15
0.518,1e-05,312,292,50,25,0.001,604,15
0.528,1e-05,356,348,50,25,0.001,704,15
0.54,1e-05,400,404,50,25,0.001,804,15
0.556,1e-05,442,462,50,25,0.001,904,15
0.56,1e-05,495,509,50,25,0.001,1004,15
0.576,1e-05,548,556,50,25,0.001,1104,15
0.588,1e-05,611,593,50,25,0.001,1204,15
0.598,1e-05,655,649,50,25,0.001,1304,15
0.628,1e-05,704,700,50,25,0.001,1404,15
0.644,1e-05,755,749,50,25,0.001,1504,15
0.658,1e-05,806,798,50,25,0.001,1604,15
0.666,1e-05,853,851,50,25,0.001,1704,15
0.662,1e-05,908,896,50,25,0.001,1804,15
0.676,1e-05,953,951,50,25,0.001,1904,15
0.708,1e-05,990,1014,50,25,0.001,2004,15
0.486,1e-05,55,49,50,25,0.001,104,16
0.49,1e-05,110,94,50,25,0.001,204,16
0.492,1e-05,160,144,50,25,0.001,304,16
0.498,1e-05,208,196,50,25,0.001,404,16
0.52,1e-05,259,245,50,25,0.001,504,16
0.534,1e-05,313,291,50,25,0.001,604,16
0.54,1e-05,353,351,50,25,0.001,704,16
0.534,1e-05,403,401,50,25,0.001,804,16
0.546,1e-05,456,448,50,25,0.001,904,16
0.562,1e-05,503,501,50,25,0.001,1004,16
0.562,1e-05,553,551,50,25,0.001,1104,16
0.572,1e-05,610,594,50,25,0.001,1204,16
0.58,1e-05,663,641,50,25,0.001,1304,16
0.594,1e-05,713,691,50,25,0.001,1404,16
0.61,1e-05,761,743,50,25,0.001,1504,16
0.632,1e-05,808,796,50,25,0.001,1604,16
0.66,1e-05,860,844,50,25,0.001,1704,16
0.674,1e-05,900,904,50,25,0.001,1804,16
0.69,1e-05,945,959,50,25,0.001,1904,16
0.712,1e-05,997,1007,50,25,0.001,2004,16
0.508,1e-05,58,46,50,25,0.001,104,17
0.508,1e-05,97,107,50,25,0.001,204,17
0.52,1e-05,135,169,50,25,0.001,304,17
0.53,1e-05,187,217,50,25,0.001,404,17
0.532,1e-05,230,274,50,25,0.001,504,17
0.56,1e-05,285,319,50,25,0.001,604,17
0.558,1e-05,339,365,50,25,0.001,704,17
0.572,1e-05,388,416,50,25,0.001,804,17
0.584,1e-05,437,467,50,25,0.001,904,17
0.584,1e-05,491,513,50,25,0.001,1004,17
0.594,1e-05,545,559,50,25,0.001,1104,17
0.602,1e-05,597,607,50,25,0.001,1204,17
0.608,1e-05,650,654,50,25,0.001,1304,17
0.624,1e-05,706,698,50,25,0.001,1404,17
0.64,1e-05,759,745,50,25,0.001,1504,17
0.652,1e-05,812,792,50,25,0.001,1604,17
0.672,1e-05,866,838,50,25,0.001,1704,17
0.694,1e-05,911,893,50,25,0.001,1804,17
0.714,1e-05,962,942,50,25,0.001,1904,17
0.73,1e-05,1011,993,50,25,0.001,2004,17
0.538,1e-05,56,48,50,25,0.001,104,18
0.538,1e-05,106,98,50,25,0.001,204,18
0.534,1e-05,153,151,50,25,0.001,304,18
0.536,1e-05,203,201,50,25,0.001,404,18
0.532,1e-05,254,250,50,25,0.001,504,18
0.534,1e-05,298,306,50,25,0.001,604,18
0.536,1e-05,358,346,50,25,0.001,704,18
0.54,1e-05,418,386,50,25,0.001,804,18
0.54,1e-05,463,441,50,25,0.001,904,18
0.558,1e-05,504,500,50,25,0.001,1004,18
0.566,1e-05,557,547,50,25,0.001,1104,18
0.562,1e-05,604,600,50,25,0.001,1204,18
0.59,1e-05,658,646,50,25,0.001,1304,18
0.606,1e-05,709,695,50,25,0.001,1404,18
0.616,1e-05,758,746,50,25,0.001,1504,18
0.628,1e-05,796,808,50,25,0.001,1604,18
0.636,1e-05,847,857,50,25,0.001,1704,18
0.648,1e-05,900,904,50,25,0.001,1804,18
0.648,1e-05,952,952,50,25,0.001,1904,18
0.648,1e-05,999,1005,50,25,0.001,2004,18
0.502,1e-05,55,49,50,25,0.001,104,19
0.502,1e-05,106,98,50,25,0.001,204,19
0.494,1e-05,157,147,50,25,0.001,304,19
0.502,1e-05,208,196,50,25,0.001,404,19
0.504,1e-05,256,248,50,25,0.001,504,19
0.506,1e-05,305,299,50,25,0.001,604,19
0.51,1e-05,344,360,50,25,0.001,704,19
0.512,1e-05,395,409,50,25,0.001,804,19
0.532,1e-05,444,460,50,25,0.001,904,19
0.548,1e-05,500,504,50,25,0.001,1004,19
0.55,1e-05,553,551,50,25,0.001,1104,19
0.552,1e-05,603,601,50,25,0.001,1204,19
0.56,1e-05,659,645,50,25,0.001,1304,19
0.566,1e-05,713,691,50,25,0.001,1404,19
0.564,1e-05,768,736,50,25,0.001,1504,19
0.584,1e-05,810,794,50,25,0.001,1604,19
0.61,1e-05,865,839,50,25,0.001,1704,19
0.618,1e-05,912,892,50,25,0.001,1804,19
0.642,1e-05,963,941,50,25,0.001,1904,19
0.656,1e-05,1013,991,50,25,0.001,2004,19
0.48,1e-05,49,55,50,25,0.001,104,20
0.486,1e-05,96,108,50,25,0.001,204,20
0.49,1e-05,147,157,50,25,0.001,304,20
0.496,1e-05,196,208,50,25,0.001,404,20
0.506,1e-05,247,257,50,25,0.001,504,20
0.502,1e-05,292,312,50,25,0.001,604,20
0.506,1e-05,344,360,50,25,0.001,704,20
0.498,1e-05,390,414,50,25,0.001,804,20
0.5,1e-05,442,462,50,25,0.001,904,20
0.504,1e-05,496,508,50,25,0.001,1004,20
0.52,1e-05,553,551,50,25,0.001,1104,20
0.518,1e-05,596,608,50,25,0.001,1204,20
0.544,1e-05,646,658,50,25,0.001,1304,20
0.552,1e-05,691,713,50,25,0.001,1404,20
0.57,1e-05,750,754,50,25,0.001,1504,20
0.572,1e-05,806,798,50,25,0.001,1604,20
0.596,1e-05,853,851,50,25,0.001,1704,20
0.614,1e-05,903,901,50,25,0.001,1804,20
0.624,1e-05,945,959,50,25,0.001,1904,20
0.64,1e-05,1001,1003,50,25,0.001,2004,20
0.508,1e-05,52,52,50,25,0.01,104,1
0.55,1e-05,94,110,50,25,0.01,204,1
0.54,1e-05,143,161,50,25,0.01,304,1
0.586,1e-05,190,214,50,25,0.01,404,1
0.572,1e-05,254,250,50,25,0.01,504,1
0.596,1e-05,303,301,50,25,0.01,604,1
0.61,1e-05,351,353,50,25,0.01,704,1
0.678,1e-05,402,402,50,25,0.01,804,1
0.704,1e-05,453,451,50,25,0.01,904,1
0.768,1e-05,506,498,50,25,0.01,1004,1
0.826,1e-05,550,554,50,25,0.01,1104,1
0.864,1e-05,599,605,50,25,0.01,1204,1
0.902,1e-05,651,653,50,25,0.01,1304,1
0.93,1e-05,695,709,50,25,0.01,1404,1
0.942,1e-05,747,757,50,25,0.01,1504,1
0.944,1e-05,797,807,50,25,0.01,1604,1
0.95,1e-05,844,860,50,25,0.01,1704,1
0.948,1e-05,893,911,50,25,0.01,1804,1
0.948,1e-05,946,958,50,25,0.01,1904,1
0.95,1e-05,997,1007,50,25,0.01,2004,1
0.516,1e-05,45,59,50,25,0.01,104,2
0.542,1e-05,97,107,50,25,0.01,204,2
0.572,1e-05,149,155,50,25,0.01,304,2
0.596,1e-05,197,207,50,25,0.01,404,2
0.604,1e-05,248,256,50,25,0.01,504,2
0.61,1e-05,291,313,50,25,0.01,604,2
0.63,1e-05,341,363,50,25,0.01,704,2
0.644,1e-05,386,418,50,25,0.01,804,2
0.704,1e-05,434,470,50,25,0.01,904,2
0.752,1e-05,484,520,50,25,0.01,1004,2
0.812,1e-05,541,563,50,25,0.01,1104,2
0.842,1e-05,596,608,50,25,0.01,1204,2
0.876,1e-05,647,657,50,25,0.01,1304,2
0.92,1e-05,699,705,50,25,0.01,1404,2
0.938,1e-05,753,751,50,25,0.01,1504,2
0.95,1e-05,807,797,50,25,0.01,1604,2
0.954,1e-05,856,848,50,25,0.01,1704,2
0.96,1e-05,913,891,50,25,0.01,1804,2
0.962,1e-05,957,947,50,25,0.01,1904,2
0.96,1e-05,1007,997,50,25,0.01,2004,2
0.502,1e-05,63,41,50,25,0.01,104,3
0.516,1e-05,110,94,50,25,0.01,204,3
0.544,1e-05,159,145,50,25,0.01,304,3
0.606,1e-05,209,195,50,25,0.01,404,3
0.62,1e-05,256,248,50,25,0.01,504,3
0.668,1e-05,306,298,50,25,0.01,604,3
0.712,1e-05,369,335,50,25,0.01,704,3
0.73,1e-05,424,380,50,25,0.01,804,3
0.758,1e-05,474,430,50,25,0.01,904,3
0.824,1e-05,517,487,50,25,0.01,1004,3
0.864,1e-05,568,536,50,25,0.01,1104,3
0.904,1e-05,608,596,50,25,0.01,1204,3
0.932,1e-05,660,644,50,25,0.01,1304,3
0.946,1e-05,702,702,50,25,0.01,1404,3
0.952,1e-05,742,762,50,25,0.01,1504,3
0.958,1e-05,805,799,50,25,0.01,1604,3
0.962,1e-05,864,840,50,25,0.01,1704,3
0.964,1e-05,917,887,50,25,0.01,1804,3
0.964,1e-05,960,944,50,25,0.01,1904,3
0.96,1e-05,1012,992,50,25,0.01,2004,3
0.512,1e-05,58,46,50,25,0.01,104,4
0.494,1e-05,101,103,50,25,0.01,204,4
0.518,1e-05,151,153,50,25,0.01,304,4
0.528,1e-05,205,199,50,25,0.01,404,4
0.556,1e-05,251,253,50,25,0.01,504,4
0.6,1e-05,303,301,50,25,0.01,604,4
0.626,1e-05,355,349,50,25,0.01,704,4
0.706,1e-05,405,399,50,25,0.01,804,4
0.766,1e-05,453,451,50,25,0.01,904,4
0.826,1e-05,504,500,50,25,0.01,1004,4
0.854,1e-05,560,544,50,25,0.01,1104,4
0.9,1e-05,612,592,50,25,0.01,1204,4
0.914,1e-05,654,650,50,25,0.01,1304,4
0.946,1e-05,696,708,50,25,0.01,1404,4
0.966,1e-05,753,751,50,25,0.01,1504,4
0.976,1e-05,801,803,50,25,0.01,1604,4
0.968,1e-05,857,847,50,25,0.01,1704,4
0.974,1e-05,911,893,50,25,0.01,1804,4
0.972,1e-05,965,939,50,25,0.01,1904,4
0.976,1e-05,1012,992,50,25,0.01,2004,4
0.504,1e-05,57,47,50,25,0.01,104,5
0.52,1e-05,109,95,50,25,0.01,204,5
0.518,1e-05,156,148,50,25,0.01,304,5
0.538,1e-05,204,200,50,25,0.01,404,5
0.556,1e-05,256,248,50,25,0.01,504,5
0.61,1e-05,297,307,50,25,0.01,604,5
0.648,1e-05,346,358,50,25,0.01,704,5
0.676,1e-05,390,414,50,25,0.01,804,5
0.708,1e-05,449,455,50,25,0.01,904,5
0.782,1e-05,505,499,50,25,0.01,1004,5
0.812,1e-05,551,553,50,25,0.01,1104,5
0.872,1e-05,604,600,50,25,0.01,1204,5
0.904,1e-05,660,644,50,25,0.01,1304,5
0.924,1e-05,709,695,50,25,0.01,1404,5
0.932,1e-05,754,750,50,25,0.01,1504,5
0.94,1e-05,806,798,50,25,0.01,1604,5
0.944,1e-05,858,846,50,25,0.01,1704,5
0.946,1e-05,905,899,50,25,0.01,1804,5
0.956,1e-05,953,951,50,25,0.01,1904,5
0.958,1e-05,1005,999,50,25,0.01,2004,5
0.538,1e-05,48,56,50,25,0.01,104,6
0.552,1e-05,101,103,50,25,0.01,204,6
0.608,1e-05,158,146,50,25,0.01,304,6
0.636,1e-05,205,199,50,25,0.01,404,6
0.658,1e-05,254,250,50,25,0.01,504,6
0.68,1e-05,309,295,50,25,0.01,604,6
0.726,1e-05,368,336,50,25,0.01,704,6
0.756,1e-05,418,386,50,25,0.01,804,6
0.792,1e-05,460,444,50,25,0.01,904,6
0.842,1e-05,504,500,50,25,0.01,1004,6
0.868,1e-05,551,553,50,25,0.01,1104,6
0.912,1e-05,603,601,50,25,0.01,1204,6
0.914,1e-05,657,647,50,25,0.01,1304,6
0.932,1e-05,714,690,50,25,0.01,1404,6
0.94,1e-05,757,747,50,25,0.01,1504,6
0.946,1e-05,807,797,50,25,0.01,1604,6
0.948,1e-05,853,851,50,25,0.01,1704,6
0.96,1e-05,904,900,50,25,0.01,1804,6
0.964,1e-05,949,955,50,25,0.01,1904,6
0.962,1e-05,1000,1004,50,25,0.01,2004,6
0.504,1e-05,46,58,50,25,0.01,104,7
0.5,1e-05,101,103,50,25,0.01,204,7
0.484,1e-05,149,155,50,25,0.01,304,7
0.512,1e-05,199,205,50,25,0.01,404,7
0.532,1e-05,247,257,50,25,0.01,504,7
0.572,1e-05,293,311,50,25,0.01,604,7
0.612,1e-05,349,355,50,25,0.01,704,7
0.67,1e-05,394,410,50,25,0.01,804,7
0.702,1e-05,439,465,50,25,0.01,904,7
0.752,1e-05,487,517,50,25,0.01,1004,7
0.778,1e-05,534,570,50,25,0.01,1104,7
0.844,1e-05,581,623,50,25,0.01,1204,7
0.864,1e-05,627,677,50,25,0.01,1304,7
0.892,1e-05,680,724,50,25,0.01,1404,7
0.92,1e-05,735,769,50,25,0.01,1504,7
0.928,1e-05,779,825,50,25,0.01,1604,7
0.94,1e-05,834,870,50,25,0.01,1704,7
0.954,1e-05,887,917,50,25,0.01,1804,7
0.956,1e-05,945,959,50,25,0.01,1904,7
0.968,1e-05,1002,1002,50,25,0.01,2004,7
0.484,1e-05,58,46,50,25,0.01,104,8
0.502,1e-05,108,96,50,25,0.01,204,8
0.534,1e-05,154,150,50,25,0.01,304,8
0.57,1e-05,211,193,50,25,0.01,404,8
0.6,1e-05,262,242,50,25,0.01,504,8
0.618,1e-05,302,302,50,25,0.01,604,8
0.624,1e-05,346,358,50,25,0.01,704,8
0.656,1e-05,398,406,50,25,0.01,804,8
0.702,1e-05,453,451,50,25,0.01,904,8
0.76,1e-05,503,501,50,25,0.01,1004,8
0.804,1e-05,557,547,50,25,0.01,1104,8
0.866,1e-05,598,606,50,25,0.01,1204,8
0.886,1e-05,652,652,50,25,0.01,1304,8
0.932,1e-05,696,708,50,25,0.01,1404,8
0.954,1e-05,743,761,50,25,0.01,1504,8
0.964,1e-05,792,812,50,25,0.01,1604,8
0.968,1e-05,840,864,50,25,0.01,1704,8
0.968,1e-05,881,923,50,25,0.01,1804,8
0.968,1e-05,933,971,50,25,0.01,1904,8
0.97,1e-05,984,1020,50,25,0.01,2004,8
0.47,1e-05,56,48,50,25,0.01,104,9
0.526,1e-05,105,99,50,25,0.01,204,9
0.55,1e-05,159,145,50,25,0.01,304,9
0.592,1e-05,199,205,50,25,0.01,404,9
0.644,1e-05,244,260,50,25,0.01,504,9
0.682,1e-05,292,312,50,25,0.01,604,9
0.688,1e-05,345,359,50,25,0.01,704,9
0.722,1e-05,397,407,50,25,0.01,804,9
0.738,1e-05,455,449,50,25,0.01,904,9
0.802,1e-05,502,502,50,25,0.01,1004,9
0.828,1e-05,560,544,50,25,0.01,1104,9
0.882,1e-05,612,592,50,25,0.01,1204,9
0.902,1e-05,653,651,50,25,0.01,1304,9
0.928,1e-05,707,697,50,25,0.01,1404,9
0.944,1e-05,753,751,50,25,0.01,1504,9
0.95,1e-05,807,797,50,25,0.01,1604,9
0.948,1e-05,850,854,50,25,0.01,1704,9
0.956,1e-05,893,911,50,25,0.01,1804,9
0.96,1e-05,937,967,50,25,0.01,1904,9
0.956,1e-05,987,1017,50,25,0.01,2004,9
0.53,1e-05,41,63,50,25,0.01,104,10
0.562,1e-05,98,106,50,25,0.01,204,10
0.562,1e-05,153,151,50,25,0.01,304,10
0.568,1e-05,198,206,50,25,0.01,404,10
0.578,1e-05,252,252,50,25,0.01,504,10
0.598,1e-05,303,301,50,25,0.01,604,10
0.622,1e-05,352,352,50,25,0.01,704,10
0.652,1e-05,403,401,50,25,0.01,804,10
0.69,1e-05,458,446,50,25,0.01,904,10
0.758,1e-05,509,495,50,25,0.01,1004,10
0.796,1e-05,564,540,50,25,0.01,1104,10
0.844,1e-05,606,598,50,25,0.01,1204,10
0.868,1e-05,660,644,50,25,0.01,1304,10
0.91,1e-05,702,702,50,25,0.01,1404,10
0.932,1e-05,756,748,50,25,0.01,1504,10
0.942,1e-05,801,803,50,25,0.01,1604,10
0.946,1e-05,847,857,50,25,0.01,1704,10
0.948,1e-05,895,909,50,25,0.01,1804,10
0.956,1e-05,945,959,50,25,0.01,1904,10
0.962,1e-05,987,1017,50,25,0.01,2004,10
0.468,1e-05,51,53,50,25,0.01,104,11
0.49,1e-05,102,102,50,25,0.01,204,11
0.512,1e-05,161,143,50,25,0.01,304,11
0.554,1e-05,211,193,50,25,0.01,404,11
0.59,1e-05,262,242,50,25,0.01,504,11
0.626,1e-05,317,287,50,25,0.01,604,11
0.658,1e-05,361,343,50,25,0.01,704,11
0.7,1e-05,410,394,50,25,0.01,804,11
0.742,1e-05,458,446,50,25,0.01,904,11
0.794,1e-05,511,493,50,25,0.01,1004,11
0.856,1e-05,564,540,50,25,0.01,1104,11
0.916,1e-05,611,593,50,25,0.01,1204,11
0.932,1e-05,658,646,50,25,0.01,1304,11
0.954,1e-05,715,689,50,25,0.01,1404,11
0.96,1e-05,768,736,50,25,0.01,1504,11
0.964,1e-05,823,781,50,25,0.01,1604,11
0.964,1e-05,872,832,50,25,0.01,1704,11
0.968,1e-05,922,882,50,25,0.01,1804,11
0.974,1e-05,966,938,50,25,0.01,1904,11
0.98,1e-05,1021,983,50,25,0.01,2004,11
0.52,1e-05,52,52,50,25,0.01,104,12
0.532,1e-05,101,103,50,25,0.01,204,12
0.556,1e-05,162,142,50,25,0.01,304,12
0.592,1e-05,210,194,50,25,0.01,404,12
0.618,1e-05,266,238,50,25,0.01,504,12
0.648,1e-05,328,276,50,25,0.01,604,12
0.666,1e-05,377,327,50,25,0.01,704,12
0.71,1e-05,431,373,50,25,0.01,804,12
0.776,1e-05,476,428,50,25,0.01,904,12
0.832,1e-05,529,475,50,25,0.01,1004,12
0.886,1e-05,586,518,50,25,0.01,1104,12
0.914,1e-05,625,579,50,25,0.01,1204,12
0.936,1e-05,675,629,50,25,0.01,1304,12
0.948,1e-05,724,680,50,25,0.01,1404,12
0.952,1e-05,775,729,50,25,0.01,1504,12
0.964,1e-05,824,780,50,25,0.01,1604,12
0.966,1e-05,872,832,50,25,0.01,1704,12
0.966,1e-05,921,883,50,25,0.01,1804,12
0.97,1e-05,970,934,50,25,0.01,1904,12
0.97,1e-05,1012,992,50,25,0.01,2004,12
0.564,1e-05,49,55,50,25,0.01,104,13
0.56,1e-05,104,100,50,25,0.01,204,13
0.548,1e-05,156,148,50,25,0.01,304,13
0.578,1e-05,214,190,50,25,0.01,404,13
0.596,1e-05,268,236,50,25,0.01,504,13
0.612,1e-05,318,286,50,25,0.01,604,13
0.604,1e-05,368,336,50,25,0.01,704,13
0.652,1e-05,423,381,50,25,0.01,804,13
0.694,1e-05,474,430,50,25,0.01,904,13
0.76,1e-05,523,481,50,25,0.01,1004,13
0.808,1e-05,575,529,50,25,0.01,1104,13
0.852,1e-05,632,572,50,25,0.01,1204,13
0.88,1e-05,681,623,50,25,0.01,1304,13
0.926,1e-05,721,683,50,25,0.01,1404,13
0.938,1e-05,773,731,50,25,0.01,1504,13
0.97,1e-05,824,780,50,25,0.01,1604,13
0.968,1e-05,881,823,50,25,0.01,1704,13
0.974,1e-05,927,877,50,25,0.01,1804,13
0.98,1e-05,975,929,50,25,0.01,1904,13
0.982,1e-05,1021,983,50,25,0.01,2004,13
0.59,1e-05,46,58,50,25,0.01,104,14
0.566,1e-05,97,107,50,25,0.01,204,14
0.576,1e-05,142,162,50,25,0.01,304,14
0.582,1e-05,193,211,50,25,0.01,404,14
0.584,1e-05,247,257,50,25,0.01,504,14
0.61,1e-05,290,314,50,25,0.01,604,14
0.646,1e-05,334,370,50,25,0.01,704,14
0.706,1e-05,380,424,50,25,0.01,804,14
0.76,1e-05,422,482,50,25,0.01,904,14
0.818,1e-05,479,525,50,25,0.01,1004,14
0.846,1e-05,527,577,50,25,0.01,1104,14
0.9,1e-05,582,622,50,25,0.01,1204,14
0.932,1e-05,636,668,50,25,0.01,1304,14
0.956,1e-05,685,719,50,25,0.01,1404,14
0.962,1e-05,738,766,50,25,0.01,1504,14
0.962,1e-05,785,819,50,25,0.01,1604,14
0.964,1e-05,844,860,50,25,0.01,1704,14
0.966,1e-05,894,910,50,25,0.01,1804,14
0.964,1e-05,943,961,50,25,0.01,1904,14
0.972,1e-05,993,1011,50,25,0.01,2004,14
0.5,1e-05,44,60,50,25,0.01,104,15
0.528,1e-05,94,110,50,25,0.01,204,15
0.526,1e-05,152,152,50,25,0.01,304,15
0.564,1e-05,210,194,50,25,0.01,404,15
0.592,1e-05,266,238,50,25,0.01,504,15
0.638,1e-05,314,290,50,25,0.01,604,15
0.7,1e-05,359,345,50,25,0.01,704,15
0.748,1e-05,402,402,50,25,0.01,804,15
0.79,1e-05,453,451,50,25,0.01,904,15
0.834,1e-05,499,505,50,25,0.01,1004,15
0.87,1e-05,549,555,50,25,0.01,1104,15
0.916,1e-05,603,601,50,25,0.01,1204,15
0.928,1e-05,653,651,50,25,0.01,1304,15
0.956,1e-05,713,691,50,25,0.01,1404,15
0.972,1e-05,764,740,50,25,0.01,1504,15
0.972,1e-05,822,782,50,25,0.01,1604,15
0.97,1e-05,868,836,50,25,0.01,1704,15
0.97,1e-05,920,884,50,25,0.01,1804,15
0.974,1e-05,956,948,50,25,0.01,1904,15
0.974,1e-05,1009,995,50,25,0.01,2004,15
0.514,1e-05,50,54,50,25,0.01,104,16
0.558,1e-05,107,97,50,25,0.01,204,16
0.562,1e-05,156,148,50,25,0.01,304,16
0.592,1e-05,212,192,50,25,0.01,404,16
0.576,1e-05,259,245,50,25,0.01,504,16
0.602,1e-05,308,296,50,25,0.01,604,16
0.646,1e-05,355,349,50,25,0.01,704,16
0.69,1e-05,405,399,50,25,0.01,804,16
0.75,1e-05,461,443,50,25,0.01,904,16
0.814,1e-05,511,493,50,25,0.01,1004,16
0.84,1e-05,562,542,50,25,0.01,1104,16
0.882,1e-05,608,596,50,25,0.01,1204,16
0.914,1e-05,660,644,50,25,0.01,1304,16
0.934,1e-05,710,694,50,25,0.01,1404,16
0.93,1e-05,762,742,50,25,0.01,1504,16
0.942,1e-05,810,794,50,25,0.01,1604,16
0.944,1e-05,855,849,50,25,0.01,1704,16
0.95,1e-05,902,902,50,25,0.01,1804,16
0.952,1e-05,949,955,50,25,0.01,1904,16
0.958,1e-05,1001,1003,50,25,0.01,2004,16
0.514,1e-05,41,63,50,25,0.01,104,17
0.52,1e-05,96,108,50,25,0.01,204,17
0.532,1e-05,150,154,50,25,0.01,304,17
0.51,1e-05,197,207,50,25,0.01,404,17
0.52,1e-05,246,258,50,25,0.01,504,17
0.542,1e-05,287,317,50,25,0.01,604,17
0.578,1e-05,346,358,50,25,0.01,704,17
0.68,1e-05,395,409,50,25,0.01,804,17
0.754,1e-05,452,452,50,25,0.01,904,17
0.81,1e-05,508,496,50,25,0.01,1004,17
0.864,1e-05,556,548,50,25,0.01,1104,17
0.9,1e-05,600,604,50,25,0.01,1204,17
0.918,1e-05,646,658,50,25,0.01,1304,17
0.942,1e-05,689,715,50,25,0.01,1404,17
0.948,1e-05,737,767,50,25,0.01,1504,17
0.954,1e-05,783,821,50,25,0.01,1604,17
0.956,1e-05,836,868,50,25,0.01,1704,17
0.954,1e-05,881,923,50,25,0.01,1804,17
0.962,1e-05,934,970,50,25,0.01,1904,17
0.968,1e-05,983,1021,50,25,0.01,2004,17
0.524,1e-05,51,53,50,25,0.01,104,18
0.52,1e-05,99,105,50,25,0.01,204,18
0.518,1e-05,148,156,50,25,0.01,304,18
0.534,1e-05,200,204,50,25,0.01,404,18
0.552,1e-05,245,259,50,25,0.01,504,18
0.59,1e-05,287,317,50,25,0.01,604,18
0.628,1e-05,332,372,50,25,0.01,704,18
0.688,1e-05,379,425,50,25,0.01,804,18
0.714,1e-05,432,472,50,25,0.01,904,18
0.762,1e-05,486,518,50,25,0.01,1004,18
0.78,1e-05,539,565,50,25,0.01,1104,18
0.814,1e-05,590,614,50,25,0.01,1204,18
0.864,1e-05,640,664,50,25,0.01,1304,18
0.912,1e-05,688,716,50,25,0.01,1404,18
0.922,1e-05,733,771,50,25,0.01,1504,18
0.938,1e-05,785,819,50,25,0.01,1604,18
0.944,1e-05,840,864,50,25,0.01,1704,18
0.954,1e-05,886,918,50,25,0.01,1804,18
0.96,1e-05,944,960,50,25,0.01,1904,18
0.964,1e-05,1001,1003,50,25,0.01,2004,18
0.542,1e-05,59,45,50,25,0.01,104,19
0.558,1e-05,114,90,50,25,0.01,204,19
0.56,1e-05,157,147,50,25,0.01,304,19
0.604,1e-05,209,195,50,25,0.01,404,19
0.624,1e-05,259,245,50,25,0.01,504,19
0.658,1e-05,309,295,50,25,0.01,604,19
0.716,1e-05,354,350,50,25,0.01,704,19
0.762,1e-05,401,403,50,25,0.01,804,19
0.79,1e-05,452,452,50,25,0.01,904,19
0.83,1e-05,510,494,50,25,0.01,1004,19
0.852,1e-05,556,548,50,25,0.01,1104,19
0.898,1e-05,606,598,50,25,0.01,1204,19
0.908,1e-05,653,651,50,25,0.01,1304,19
0.916,1e-05,693,711,50,25,0.01,1404,19
0.92,1e-05,749,755,50,25,0.01,1504,19
0.938,1e-05,792,812,50,25,0.01,1604,19
0.946,1e-05,841,863,50,25,0.01,1704,19
0.956,1e-05,887,917,50,25,0.01,1804,19
0.964,1e-05,931,973,50,25,0.01,1904,19
0.97,1e-05,991,1013,50,25,0.01,2004,19
0.506,1e-05,55,49,50,25,0.01,104,20
0.516,1e-05,105,99,50,25,0.01,204,20
0.554,1e-05,159,145,50,25,0.01,304,20
0.566,1e-05,209,195,50,25,0.01,404,20
0.582,1e-05,263,241,50,25,0.01,504,20
0.588,1e-05,307,297,50,25,0.01,604,20
0.62,1e-05,357,347,50,25,0.01,704,20
0.674,1e-05,407,397,50,25,0.01,804,20
0.728,1e-05,454,450,50,25,0.01,904,20
0.784,1e-05,502,502,50,25,0.01,1004,20
0.836,1e-05,552,552,50,25,0.01,1104,20
0.882,1e-05,611,593,50,25,0.01,1204,20
0.912,1e-05,657,647,50,25,0.01,1304,20
0.93,1e-05,710,694,50,25,0.01,1404,20
0.94,1e-05,759,745,50,25,0.01,1504,20
0.954,1e-05,810,794,50,25,0.01,1604,20
0.956,1e-05,863,841,50,25,0.01,1704,20
0.962,1e-05,898,906,50,25,0.01,1804,20
0.968,1e-05,945,959,50,25,0.01,1904,20
0.966,1e-05,1006,998,50,25,0.01,2004,20
0.524,0.0001,53,51,50,25,0.0001,104,1
0.522,0.0001,115,89,50,25,0.0001,204,1
0.522,0.0001,164,140,50,25,0.0001,304,1
0.52,0.0001,213,191,50,25,0.0001,404,1
0.52,0.0001,258,246,50,25,0.0001,504,1
0.52,0.0001,308,296,50,25,0.0001,604,1
0.52,0.0001,358,346,50,25,0.0001,704,1
0.522,0.0001,402,402,50,25,0.0001,804,1
0.522,0.0001,461,443,50,25,0.0001,904,1
0.522,0.0001,510,494,50,25,0.0001,1004,1
0.522,0.0001,553,551,50,25,0.0001,1104,1
0.524,0.0001,607,597,50,25,0.0001,1204,1
0.524,0.0001,665,639,50,25,0.0001,1304,1
0.528,0.0001,714,690,50,25,0.0001,1404,1
0.534,0.0001,773,731,50,25,0.0001,1504,1
0.532,0.0001,814,790,50,25,0.0001,1604,1
0.53,0.0001,855,849,50,25,0.0001,1704,1
0.534,0.0001,899,905,50,25,0.0001,1804,1
0.538,0.0001,955,949,50,25,0.0001,1904,1
0.538,0.0001,1007,997,50,25,0.0001,2004,1
0.502,0.0001,48,56,50,25,0.0001,104,2
0.502,0.0001,102,102,50,25,0.0001,204,2
0.502,0.0001,146,158,50,25,0.0001,304,2
0.502,0.0001,199,205,50,25,0.0001,404,2
0.502,0.0001,251,253,50,25,0.0001,504,2
0.502,0.0001,299,305,50,25,0.0001,604,2
0.502,0.0001,352,352,50,25,0.0001,704,2
0.502,0.0001,411,393,50,25,0.0001,804,2
0.502,0.0001,453,451,50,25,0.0001,904,2
0.502,0.0001,502,502,50,25,0.0001,1004,2
0.502,0.0001,552,552,50,25,0.0001,1104,2
0.502,0.0001,600,604,50,25,0.0001,1204,2
0.502,0.0001,646,658,50,25,0.0001,1304,2
0.502,0.0001,703,701,50,25,0.0001,1404,2
0.502,0.0001,751,753,50,25,0.0001,1504,2
0.502,0.0001,798,806,50,25,0.0001,1604,2
0.502,0.0001,855,849,50,25,0.0001,1704,2
0.502,0.0001,904,900,50,25,0.0001,1804,2
0.502,0.0001,949,955,50,25,0.0001,1904,2
0.502,0.0001,1003,1001,50,25,0.0001,2004,2
0.52,0.0001,50,54,50,25,0.0001,104,3
0.522,0.0001,97,107,50,25,0.0001,204,3
0.522,0.0001,148,156,50,25,0.0001,304,3
0.524,0.0001,190,214,50,25,0.0001,404,3
0.524,0.0001,247,257,50,25,0.0001,504,3
0.524,0.0001,303,301,50,25,0.0001,604,3
0.522,0.0001,357,347,50,25,0.0001,704,3
0.522,0.0001,420,384,50,25,0.0001,804,3
0.524,0.0001,469,435,50,25,0.0001,904,3
0.526,0.0001,519,485,50,25,0.0001,1004,3
0.53,0.0001,565,539,50,25,0.0001,1104,3
0.532,0.0001,620,584,50,25,0.0001,1204,3
0.536,0.0001,667,637,50,25,0.0001,1304,3
0.536,0.0001,716,688,50,25,0.0001,1404,3
0.542,0.0001,768,736,50,25,0.0001,1504,3
0.546,0.0001,817,787,50,25,0.0001,1604,3
0.546,0.0001,860,844,50,25,0.0001,1704,3
0.548,0.0001,905,899,50,25,0.0001,1804,3
0.55,0.0001,955,949,50,25,0.0001,1904,3
0.548,0.0001,1000,1004,50,25,0.0001,2004,3
0.516,0.0001,63,41,50,25,0.0001,104,4
0.518,0.0001,119,85,50,25,0.0001,204,4
0.518,0.0001,170,134,50,25,0.0001,304,4
0.52,0.0001,218,186,50,25,0.0001,404,4
0.518,0.0001,266,238,50,25,0.0001,504,4
0.518,0.0001,321,283,50,25,0.0001,604,4
0.52,0.0001,372,332,50,25,0.0001,704,4
0.522,0.0001,421,383,50,25,0.0001,804,4
0.522,0.0001,465,439,50,25,0.0001,904,4
0.52,0.0001,516,488,50,25,0.0001,1004,4
0.518,0.0001,572,532,50,25,0.0001,1104,4
0.52,0.0001,624,580,50,25,0.0001,1204,4
0.524,0.0001,670,634,50,25,0.0001,1304,4
0.524,0.0001,722,682,50,25,0.0001,1404,4
0.526,0.0001,775,729,50,25,0.0001,1504,4
0.53,0.0001,821,783,50,25,0.0001,1604,4
0.53,0.0001,874,830,50,25,0.0001,1704,4
0.534,0.0001,915,889,50,25,0.0001,1804,4
0.54,0.0001,956,948,50,25,0.0001,1904,4
0.544,0.0001,1003,1001,50,25,0.0001,2004,4
0.5,0.0001,53,51,50,25,0.0001,104,5
0.5,0.0001,102,102,50,25,0.0001,204,5
0.5,0.0001,150,154,50,25,0.0001,304,5
0.5,0.0001,197,207,50,25,0.0001,404,5
0.5,0.0001,238,266,50,25,0.0001,504,5
0.502,0.0001,283,321,50,25,0.0001,604,5
0.504,0.0001,335,369,50,25,0.0001,704,5
0.504,0.0001,400,404,50,25,0.0001,804,5
0.506,0.0001,447,457,50,25,0.0001,904,5
0.506,0.0001,485,519,50,25,0.0001,1004,5
0.506,0.0001,533,571,50,25,0.0001,1104,5
0.506,0.0001,584,620,50,25,0.0001,1204,5
0.504,0.0001,632,672,50,25,0.0001,1304,5
0.508,0.0001,683,721,50,25,0.0001,1404,5
0.512,0.0001,740,764,50,25,0.0001,1504,5
0.514,0.0001,791,813,50,25,0.0001,1604,5
0.516,0.0001,837,867,50,25,0.0001,1704,5
0.522,0.0001,888,916,50,25,0.0001,1804,5
0.518,0.0001,940,964,50,25,0.0001,1904,5
0.518,0.0001,996,1008,50,25,0.0001,2004,5
0.464,0.0001,51,53,50,25,0.0001,104,6
0.466,0.0001,102,102,50,25,0.0001,204,6
0.468,0.0001,150,154,50,25,0.0001,304,6
0.47,0.0001,200,204,50,25,0.0001,404,6
0.47,0.0001,253,251,50,25,0.0001,504,6
0.47,0.0001,291,313,50,25,0.0001,604,6
0.468,0.0001,339,365,50,25,0.0001,704,6
0.47,0.0001,382,422,50,25,0.0001,804,6
0.466,0.0001,428,476,50,25,0.0001,904,6
0.464,0.0001,486,518,50,25,0.0001,1004,6
0.466,0.0001,534,570,50,25,0.0001,1104,6
0.468,0.0001,584,620,50,25,0.0001,1204,6
0.466,0.0001,634,670,50,25,0.0001,1304,6
0.466,0.0001,690,714,50,25,0.0001,1404,6
0.466,0.0001,749,755,50,25,0.0001,1504,6
0.466,0.0001,798,806,50,25,0.0001,1604,6
0.468,0.0001,849,855,50,25,0.0001,1704,6
0.47,0.0001,903,901,50,25,0.0001,1804,6
0.47,0.0001,953,951,50,25,0.0001,1904,6
0.476,0.0001,1001,1003,50,25,0.0001,2004,6
0.532,0.0001,50,54,50,25,0.0001,104,7
0.532,0.0001,105,99,50,25,0.0001,204,7
0.532,0.0001,150,154,50,25,0.0001,304,7
0.536,0.0001,196,208,50,25,0.0001,404,7
0.536,0.0001,247,257,50,25,0.0001,504,7
0.538,0.0001,288,316,50,25,0.0001,604,7
0.534,0.0001,347,357,50,25,0.0001,704,7
0.532,0.0001,398,406,50,25,0.0001,804,7
0.534,0.0001,456,448,50,25,0.0001,904,7
0.532,0.0001,499,505,50,25,0.0001,1004,7
0.536,0.0001,548,556,50,25,0.0001,1104,7
0.538,0.0001,605,599,50,25,0.0001,1204,7
0.536,0.0001,660,644,50,25,0.0001,1304,7
0.536,0.0001,710,694,50,25,0.0001,1404,7
0.532,0.0001,751,753,50,25,0.0001,1504,7
0.53,0.0001,801,803,50,25,0.0001,1604,7
0.53,0.0001,851,853,50,25,0.0001,1704,7
0.53,0.0001,909,895,50,25,0.0001,1804,7
0.526,0.0001,961,943,50,25,0.0001,1904,7
0.524,0.0001,1015,989,50,25,0.0001,2004,7
0.484,0.0001,55,49,50,25,0.0001,104,8
0.484,0.0001,107,97,50,25,0.0001,204,8
0.486,0.0001,165,139,50,25,0.0001,304,8
0.486,0.0001,210,194,50,25,0.0001,404,8
0.486,0.0001,256,248,50,25,0.0001,504,8
0.486,0.0001,299,305,50,25,0.0001,604,8
0.486,0.0001,348,356,50,25,0.0001,704,8
0.486,0.0001,394,410,50,25,0.0001,804,8
0.49,0.0001,439,465,50,25,0.0001,904,8
0.49,0.0001,488,516,50,25,0.0001,1004,8
0.486,0.0001,535,569,50,25,0.0001,1104,8
0.484,0.0001,590,614,50,25,0.0001,1204,8
0.488,0.0001,634,670,50,25,0.0001,1304,8
0.486,0.0001,681,723,50,25,0.0001,1404,8
0.486,0.0001,733,771,50,25,0.0001,1504,8
0.488,0.0001,777,827,50,25,0.0001,1604,8
0.484,0.0001,831,873,50,25,0.0001,1704,8
0.488,0.0001,878,926,50,25,0.0001,1804,8
0.492,0.0001,937,967,50,25,0.0001,1904,8
0.496,0.0001,990,1014,50,25,0.0001,2004,8
0.538,0.0001,54,50,50,25,0.0001,104,9
0.538,0.0001,108,96,50,25,0.0001,204,9
0.538,0.0001,153,151,50,25,0.0001,304,9
0.54,0.0001,198,206,50,25,0.0001,404,9
0.54,0.0001,253,251,50,25,0.0001,504,9
0.54,0.0001,300,304,50,25,0.0001,604,9
0.542,0.0001,347,357,50,25,0.0001,704,9
0.542,0.0001,393,411,50,25,0.0001,804,9
0.542,0.0001,447,457,50,25,0.0001,904,9
0.54,0.0001,488,516,50,25,0.0001,1004,9
0.54,0.0001,540,564,50,25,0.0001,1104,9
0.544,0.0001,592,612,50,25,0.0001,1204,9
0.542,0.0001,645,659,50,25,0.0001,1304,9
0.546,0.0001,694,710,50,25,0.0001,1404,9
0.544,0.0001,744,760,50,25,0.0001,1504,9
0.542,0.0001,792,812,50,25,0.0001,1604,9
0.544,0.0001,838,866,50,25,0.0001,1704,9
0.546,0.0001,893,911,50,25,0.0001,1804,9
0.546,0.0001,945,959,50,25,0.0001,1904,9
0.548,0.0001,999,1005,50,25,0.0001,2004,9
0.462,0.0001,56,48,50,25,0.0001,104,10
0.462,0.0001,98,106,50,25,0.0001,204,10
0.462,0.0001,145,159,50,25,0.0001,304,10
0.462,0.0001,196,208,50,25,0.0001,404,10
0.462,0.0001,243,261,50,25,0.0001,504,10
0.462,0.0001,290,314,50,25,0.0001,604,10
0.462,0.0001,342,362,50,25,0.0001,704,10
0.462,0.0001,389,415,50,25,0.0001,804,10
0.462,0.0001,449,455,50,25,0.0001,904,10
0.466,0.0001,494,510,50,25,0.0001,1004,10
0.466,0.0001,551,553,50,25,0.0001,1104,10
0.468,0.0001,597,607,50,25,0.0001,1204,10
0.466,0.0001,645,659,50,25,0.0001,1304,10
0.466,0.0001,693,711,50,25,0.0001,1404,10
0.466,0.0001,732,772,50,25,0.0001,1504,10
0.466,0.0001,777,827,50,25,0.0001,1604,10
0.466,0.0001,831,873,50,25,0.0001,1704,10
0.466,0.0001,880,924,50,25,0.0001,1804,10
0.466,0.0001,934,970,50,25,0.0001,1904,10
0.468,0.0001,989,1015,50,25,0.0001,2004,10
0.54,0.0001,59,45,50,25,0.0001,104,11
0.54,0.0001,98,106,50,25,0.0001,204,11
0.544,0.0001,153,151,50,25,0.0001,304,11
0.544,0.0001,197,207,50,25,0.0001,404,11
0.544,0.0001,249,255,50,25,0.0001,504,11
0.544,0.0001,309,295,50,25,0.0001,604,11
0.544,0.0001,357,347,50,25,0.0001,704,11
0.542,0.0001,406,398,50,25,0.0001,804,11
0.54,0.0001,453,451,50,25,0.0001,904,11
0.54,0.0001,501,503,50,25,0.0001,1004,11
0.538,0.0001,560,544,50,25,0.0001,1104,11
0.536,0.0001,600,604,50,25,0.0001,1204,11
0.534,0.0001,646,658,50,25,0.0001,1304,11
0.534,0.0001,697,707,50,25,0.0001,1404,11
0.536,0.0001,749,755,50,25,0.0001,1504,11
0.54,0.0001,796,808,50,25,0.0001,1604,11
0.542,0.0001,840,864,50,25,0.0001,1704,11
0.544,0.0001,896,908,50,25,0.0001,1804,11
0.546,0.0001,948,956,50,25,0.0001,1904,11
0.546,0.0001,1000,1004,50,25,0.0001,2004,11
0.492,0.0001,54,50,50,25,0.0001,104,12
0.492,0.0001,97,107,50,25,0.0001,204,12
0.494,0.0001,146,158,50,25,0.0001,304,12
0.494,0.0001,199,205,50,25,0.0001,404,12
0.494,0.0001,249,255,50,25,0.0001,504,12
0.498,0.0001,301,303,50,25,0.0001,604,12
0.498,0.0001,356,348,50,25,0.0001,704,12
0.5,0.0001,406,398,50,25,0.0001,804,12
0.502,0.0001,451,453,50,25,0.0001,904,12
0.502,0.0001,496,508,50,25,0.0001,1004,12
0.504,0.0001,548,556,50,25,0.0001,1104,12
0.506,0.0001,596,608,50,25,0.0001,1204,12
0.508,0.0001,647,657,50,25,0.0001,1304,12
0.508,0.0001,693,711,50,25,0.0001,1404,12
0.506,0.0001,745,759,50,25,0.0001,1504,12
0.506,0.0001,794,810,50,25,0.0001,1604,12
0.502,0.0001,845,859,50,25,0.0001,1704,12
0.502,0.0001,899,905,50,25,0.0001,1804,12
0.504,0.0001,946,958,50,25,0.0001,1904,12
0.504,0.0001,1000,1004,50,25,0.0001,2004,12
0.482,0.0001,60,44,50,25,0.0001,104,13
0.484,0.0001,112,92,50,25,0.0001,204,13
0.484,0.0001,163,141,50,25,0.0001,304,13
0.484,0.0001,202,202,50,25,0.0001,404,13
0.484,0.0001,254,250,50,25,0.0001,504,13
0.484,0.0001,306,298,50,25,0.0001,604,13
0.486,0.0001,353,351,50,25,0.0001,704,13
0.486,0.0001,407,397,50,25,0.0001,804,13
0.488,0.0001,460,444,50,25,0.0001,904,13
0.488,0.0001,508,496,50,25,0.0001,1004,13
0.488,0.0001,557,547,50,25,0.0001,1104,13
0.49,0.0001,614,590,50,25,0.0001,1204,13
0.49,0.0001,667,637,50,25,0.0001,1304,13
0.494,0.0001,724,680,50,25,0.0001,1404,13
0.498,0.0001,772,732,50,25,0.0001,1504,13
0.498,0.0001,827,777,50,25,0.0001,1604,13
0.498,0.0001,879,825,50,25,0.0001,1704,13
0.5,0.0001,924,880,50,25,0.0001,1804,13
0.51,0.0001,975,929,50,25,0.0001,1904,13
0.512,0.0001,1013,991,50,25,0.0001,2004,13
0.554,0.0001,51,53,50,25,0.0001,104,14
0.552,0.0001,103,101,50,25,0.0001,204,14
0.554,0.0001,157,147,50,25,0.0001,304,14
0.556,0.0001,199,205,50,25,0.0001,404,14
0.558,0.0001,251,253,50,25,0.0001,504,14
0.558,0.0001,302,302,50,25,0.0001,604,14
0.558,0.0001,356,348,50,25,0.0001,704,14
0.558,0.0001,405,399,50,25,0.0001,804,14
0.558,0.0001,449,455,50,25,0.0001,904,14
0.558,0.0001,502,502,50,25,0.0001,1004,14
0.558,0.0001,547,557,50,25,0.0001,1104,14
0.562,0.0001,603,601,50,25,0.0001,1204,14
0.562,0.0001,644,660,50,25,0.0001,1304,14
0.568,0.0001,696,708,50,25,0.0001,1404,14
0.566,0.0001,746,758,50,25,0.0001,1504,14
0.57,0.0001,797,807,50,25,0.0001,1604,14
0.572,0.0001,848,856,50,25,0.0001,1704,14
0.57,0.0001,902,902,50,25,0.0001,1804,14
0.578,0.0001,945,959,50,25,0.0001,1904,14
0.58,0.0001,991,1013,50,25,0.0001,2004,14
0.516,0.0001,49,55,50,25,0.0001,104,15
0.51,0.0001,91,113,50,25,0.0001,204,15
0.506,0.0001,144,160,50,25,0.0001,304,15
0.506,0.0001,194,210,50,25,0.0001,404,15
0.506,0.0001,248,256,50,25,0.0001,504,15
0.506,0.0001,292,312,50,25,0.0001,604,15
0.506,0.0001,344,360,50,25,0.0001,704,15
0.508,0.0001,398,406,50,25,0.0001,804,15
0.508,0.0001,448,456,50,25,0.0001,904,15
0.51,0.0001,509,495,50,25,0.0001,1004,15
0.512,0.0001,552,552,50,25,0.0001,1104,15
0.512,0.0001,605,599,50,25,0.0001,1204,15
0.514,0.0001,659,645,50,25,0.0001,1304,15
0.52,0.0001,707,697,50,25,0.0001,1404,15
0.522,0.0001,754,750,50,25,0.0001,1504,15
0.522,0.0001,797,807,50,25,0.0001,1604,15
0.52,0.0001,854,850,50,25,0.0001,1704,15
0.52,0.0001,902,902,50,25,0.0001,1804,15
0.524,0.0001,954,950,50,25,0.0001,1904,15
0.526,0.0001,1005,999,50,25,0.0001,2004,15
0.522,0.0001,48,56,50,25,0.0001,104,16
0.522,0.0001,104,100,50,25,0.0001,204,16
0.522,0.0001,149,155,50,25,0.0001,304,16
0.52,0.0001,200,204,50,25,0.0001,404,16
0.52,0.0001,251,253,50,25,0.0001,504,16
0.524,0.0001,299,305,50,25,0.0001,604,16
0.524,0.0001,348,356,50,25,0.0001,704,16
0.52,0.0001,398,406,50,25,0.0001,804,16
0.52,0.0001,445,459,50,25,0.0001,904,16
0.518,0.0001,496,508,50,25,0.0001,1004,16
0.522,0.0001,545,559,50,25,0.0001,1104,16
0.52,0.0001,592,612,50,25,0.0001,1204,16
0.522,0.0001,646,658,50,25,0.0001,1304,16
0.524,0.0001,685,719,50,25,0.0001,1404,16
0.528,0.0001,740,764,50,25,0.0001,1504,16
0.532,0.0001,793,811,50,25,0.0001,1604,16
0.534,0.0001,848,856,50,25,0.0001,1704,16
0.532,0.0001,899,905,50,25,0.0001,1804,16
0.534,0.0001,945,959,50,25,0.0001,1904,16
0.536,0.0001,995,1009,50,25,0.0001,2004,16
0.498,0.0001,52,52,50,25,0.0001,104,17
0.496,0.0001,103,101,50,25,0.0001,204,17
0.496,0.0001,157,147,50,25,0.0001,304,17
0.496,0.0001,203,201,50,25,0.0001,404,17
0.496,0.0001,250,254,50,25,0.0001,504,17
0.498,0.0001,305,299,50,25,0.0001,604,17
0.498,0.0001,359,345,50,25,0.0001,704,17
0.498,0.0001,412,392,50,25,0.0001,804,17
0.498,0.0001,459,445,50,25,0.0001,904,17
0.502,0.0001,507,497,50,25,0.0001,1004,17
0.504,0.0001,555,549,50,25,0.0001,1104,17
0.504,0.0001,605,599,50,25,0.0001,1204,17
0.51,0.0001,652,652,50,25,0.0001,1304,17
0.512,0.0001,701,703,50,25,0.0001,1404,17
0.514,0.0001,752,752,50,25,0.0001,1504,17
0.516,0.0001,807,797,50,25,0.0001,1604,17
0.512,0.0001,857,847,50,25,0.0001,1704,17
0.508,0.0001,897,907,50,25,0.0001,1804,17
0.506,0.0001,947,957,50,25,0.0001,1904,17
0.514,0.0001,994,1010,50,25,0.0001,2004,17
0.498,0.0001,59,45,50,25,0.0001,104,18
0.498,0.0001,108,96,50,25,0.0001,204,18
0.498,0.0001,160,144,50,25,0.0001,304,18
0.498,0.0001,204,200,50,25,0.0001,404,18
0.498,0.0001,252,252,50,25,0.0001,504,18
0.498,0.0001,307,297,50,25,0.0001,604,18
0.5,0.0001,361,343,50,25,0.0001,704,18
0.5,0.0001,414,390,50,25,0.0001,804,18
0.502,0.0001,471,433,50,25,0.0001,904,18
0.502,0.0001,526,478,50,25,0.0001,1004,18
0.5,0.0001,578,526,50,25,0.0001,1104,18
0.5,0.0001,624,580,50,25,0.0001,1204,18
0.5,0.0001,667,637,50,25,0.0001,1304,18
0.504,0.0001,711,693,50,25,0.0001,1404,18
0.504,0.0001,759,745,50,25,0.0001,1504,18
0.504,0.0001,805,799,50,25,0.0001,1604,18
0.504,0.0001,855,849,50,25,0.0001,1704,18
0.504,0.0001,903,901,50,25,0.0001,1804,18
0.508,0.0001,953,951,50,25,0.0001,1904,18
0.51,0.0001,1005,999,50,25,0.0001,2004,18
0.484,0.0001,48,56,50,25,0.0001,104,19
0.486,0.0001,99,105,50,25,0.0001,204,19
0.486,0.0001,146,158,50,25,0.0001,304,19
0.486,0.0001,198,206,50,25,0.0001,404,19
0.484,0.0001,259,245,50,25,0.0001,504,19
0.486,0.0001,306,298,50,25,0.0001,604,19
0.486,0.0001,352,352,50,25,0.0001,704,19
0.484,0.0001,397,407,50,25,0.0001,804,19
0.484,0.0001,453,451,50,25,0.0001,904,19
0.484,0.0001,504,500,50,25,0.0001,1004,19
0.484,0.0001,556,548,50,25,0.0001,1104,19
0.484,0.0001,600,604,50,25,0.0001,1204,19
0.484,0.0001,655,649,50,25,0.0001,1304,19
0.484,0.0001,700,704,50,25,0.0001,1404,19
0.484,0.0001,752,752,50,25,0.0001,1504,19
0.484,0.0001,797,807,50,25,0.0001,1604,19
0.486,0.0001,851,853,50,25,0.0001,1704,19
0.488,0.0001,893,911,50,25,0.0001,1804,19
0.488,0.0001,944,960,50,25,0.0001,1904,19
0.488,0.0001,991,1013,50,25,0.0001,2004,19
0.5,0.0001,48,56,50,25,0.0001,104,20
0.502,0.0001,101,103,50,25,0.0001,204,20
0.502,0.0001,144,160,50,25,0.0001,304,20
0.502,0.0001,194,210,50,25,0.0001,404,20
0.502,0.0001,250,254,50,25,0.0001,504,20
0.502,0.0001,299,305,50,25,0.0001,604,20
0.502,0.0001,351,353,50,25,0.0001,704,20
0.502,0.0001,398,406,50,25,0.0001,804,20
0.502,0.0001,447,457,50,25,0.0001,904,20
0.502,0.0001,496,508,50,25,0.0001,1004,20
0.502,0.0001,551,553,50,25,0.0001,1104,20
0.502,0.0001,603,601,50,25,0.0001,1204,20
0.502,0.0001,655,649,50,25,0.0001,1304,20
0.502,0.0001,703,701,50,25,0.0001,1404,20
0.502,0.0001,755,749,50,25,0.0001,1504,20
0.502,0.0001,806,798,50,25,0.0001,1604,20
0.502,0.0001,856,848,50,25,0.0001,1704,20
0.502,0.0001,907,897,50,25,0.0001,1804,20
0.502,0.0001,957,947,50,25,0.0001,1904,20
0.502,0.0001,1002,1002,50,25,0.0001,2004,20
0.536,0.0001,52,52,50,25,0.001,104,1
0.536,0.0001,103,101,50,25,0.001,204,1
0.536,0.0001,147,157,50,25,0.001,304,1
0.536,0.0001,201,203,50,25,0.001,404,1
0.538,0.0001,252,252,50,25,0.001,504,1
0.54,0.0001,304,300,50,25,0.001,604,1
0.54,0.0001,361,343,50,25,0.001,704,1
0.544,0.0001,419,385,50,25,0.001,804,1
0.552,0.0001,465,439,50,25,0.001,904,1
0.558,0.0001,514,490,50,25,0.001,1004,1
0.562,0.0001,566,538,50,25,0.001,1104,1
0.562,0.0001,616,588,50,25,0.001,1204,1
0.574,0.0001,674,630,50,25,0.001,1304,1
0.586,0.0001,722,682,50,25,0.001,1404,1
0.608,0.0001,764,740,50,25,0.001,1504,1
0.622,0.0001,816,788,50,25,0.001,1604,1
0.63,0.0001,869,835,50,25,0.001,1704,1
0.638,0.0001,913,891,50,25,0.001,1804,1
0.654,0.0001,966,938,50,25,0.001,1904,1
0.686,0.0001,1020,984,50,25,0.001,2004,1
0.536,0.0001,42,62,50,25,0.001,104,2
0.526,0.0001,101,103,50,25,0.001,204,2
0.522,0.0001,145,159,50,25,0.001,304,2
0.532,0.0001,197,207,50,25,0.001,404,2
0.534,0.0001,251,253,50,25,0.001,504,2
0.538,0.0001,297,307,50,25,0.001,604,2
0.546,0.0001,344,360,50,25,0.001,704,2
0.558,0.0001,400,404,50,25,0.001,804,2
0.556,0.0001,446,458,50,25,0.001,904,2
0.564,0.0001,501,503,50,25,0.001,1004,2
0.562,0.0001,556,548,50,25,0.001,1104,2
0.564,0.0001,610,594,50,25,0.001,1204,2
0.57,0.0001,660,644,50,25,0.001,1304,2
0.588,0.0001,705,699,50,25,0.001,1404,2
0.59,0.0001,752,752,50,25,0.001,1504,2
0.608,0.0001,796,808,50,25,0.001,1604,2
0.618,0.0001,844,860,50,25,0.001,1704,2
0.644,0.0001,894,910,50,25,0.001,1804,2
0.66,0.0001,936,968,50,25,0.001,1904,2
0.678,0.0001,988,1016,50,25,0.001,2004,2
0.496,0.0001,46,58,50,25,0.001,104,3
0.496,0.0001,91,113,50,25,0.001,204,3
0.496,0.0001,141,163,50,25,0.001,304,3
0.498,0.0001,191,213,50,25,0.001,404,3
0.494,0.0001,243,261,50,25,0.001,504,3
0.488,0.0001,294,310,50,25,0.001,604,3
0.486,0.0001,342,362,50,25,0.001,704,3
0.488,0.0001,381,423,50,25,0.001,804,3
0.49,0.0001,431,473,50,25,0.001,904,3
0.492,0.0001,481,523,50,25,0.001,1004,3
0.49,0.0001,527,577,50,25,0.001,1104,3
0.494,0.0001,588,616,50,25,0.001,1204,3
0.516,0.0001,644,660,50,25,0.001,1304,3
0.546,0.0001,691,713,50,25,0.001,1404,3
0.57,0.0001,752,752,50,25,0.001,1504,3
0.586,0.0001,804,800,50,25,0.001,1604,3
0.602,0.0001,856,848,50,25,0.001,1704,3
0.616,0.0001,912,892,50,25,0.001,1804,3
0.622,0.0001,966,938,50,25,0.001,1904,3
0.638,0.0001,1005,999,50,25,0.001,2004,3
0.5,0.0001,64,40,50,25,0.001,104,4
0.5,0.0001,114,90,50,25,0.001,204,4
0.506,0.0001,151,153,50,25,0.001,304,4
0.512,0.0001,200,204,50,25,0.001,404,4
0.512,0.0001,248,256,50,25,0.001,504,4
0.51,0.0001,290,314,50,25,0.001,604,4
0.514,0.0001,339,365,50,25,0.001,704,4
0.51,0.0001,384,420,50,25,0.001,804,4
0.516,0.0001,435,469,50,25,0.001,904,4
0.52,0.0001,490,514,50,25,0.001,1004,4
0.524,0.0001,546,558,50,25,0.001,1104,4
0.534,0.0001,600,604,50,25,0.001,1204,4
0.552,0.0001,651,653,50,25,0.001,1304,4
0.57,0.0001,706,698,50,25,0.001,1404,4
0.576,0.0001,759,745,50,25,0.001,1504,4
0.594,0.0001,803,801,50,25,0.001,1604,4
0.606,0.0001,860,844,50,25,0.001,1704,4
0.63,0.0001,902,902,50,25,0.001,1804,4
0.654,0.0001,949,955,50,25,0.001,1904,4
0.676,0.0001,1005,999,50,25,0.001,2004,4
0.458,0.0001,54,50,50,25,0.001,104,5
0.462,0.0001,99,105,50,25,0.001,204,5
0.462,0.0001,150,154,50,25,0.001,304,5
0.466,0.0001,210,194,50,25,0.001,404,5
0.466,0.0001,258,246,50,25,0.001,504,5
0.474,0.0001,313,291,50,25,0.001,604,5
0.47,0.0001,362,342,50,25,0.001,704,5
0.48,0.0001,416,388,50,25,0.001,804,5
0.492,0.0001,470,434,50,25,0.001,904,5
0.5,0.0001,521,483,50,25,0.001,1004,5
0.512,0.0001,575,529,50,25,0.001,1104,5
0.528,0.0001,621,583,50,25,0.001,1204,5
0.526,0.0001,666,638,50,25,0.001,1304,5
0.542,0.0001,717,687,50,25,0.001,1404,5
0.552,0.0001,759,745,50,25,0.001,1504,5
0.56,0.0001,809,795,50,25,0.001,1604,5
0.572,0.0001,858,846,50,25,0.001,1704,5
0.59,0.0001,906,898,50,25,0.001,1804,5
0.608,0.0001,964,940,50,25,0.001,1904,5
0.648,0.0001,1016,988,50,25,0.001,2004,5
0.532,0.0001,56,48,50,25,0.001,104,6
0.534,0.0001,108,96,50,25,0.001,204,6
0.534,0.0001,156,148,50,25,0.001,304,6
0.532,0.0001,205,199,50,25,0.001,404,6
0.532,0.0001,262,242,50,25,0.001,504,6
0.532,0.0001,316,288,50,25,0.001,604,6
0.536,0.0001,364,340,50,25,0.001,704,6
0.542,0.0001,415,389,50,25,0.001,804,6
0.53,0.0001,465,439,50,25,0.001,904,6
0.54,0.0001,519,485,50,25,0.001,1004,6
0.556,0.0001,571,533,50,25,0.001,1104,6
0.562,0.0001,616,588,50,25,0.001,1204,6
0.578,0.0001,654,650,50,25,0.001,1304,6
0.592,0.0001,698,706,50,25,0.001,1404,6
0.622,0.0001,762,742,50,25,0.001,1504,6
0.644,0.0001,821,783,50,25,0.001,1604,6
0.654,0.0001,870,834,50,25,0.001,1704,6
0.664,0.0001,923,881,50,25,0.001,1804,6
0.67,0.0001,972,932,50,25,0.001,1904,6
0.686,0.0001,1015,989,50,25,0.001,2004,6
0.512,0.0001,40,64,50,25,0.001,104,7
0.522,0.0001,88,116,50,25,0.001,204,7
0.522,0.0001,139,165,50,25,0.001,304,7
0.516,0.0001,185,219,50,25,0.001,404,7
0.522,0.0001,230,274,50,25,0.001,504,7
0.532,0.0001,280,324,50,25,0.001,604,7
0.524,0.0001,326,378,50,25,0.001,704,7
0.528,0.0001,380,424,50,25,0.001,804,7
0.538,0.0001,428,476,50,25,0.001,904,7
0.552,0.0001,476,528,50,25,0.001,1004,7
0.56,0.0001,534,570,50,25,0.001,1104,7
0.57,0.0001,584,620,50,25,0.001,1204,7
0.584,0.0001,628,676,50,25,0.001,1304,7
0.598,0.0001,680,724,50,25,0.001,1404,7
0.628,0.0001,726,778,50,25,0.001,1504,7
0.642,0.0001,772,832,50,25,0.001,1604,7
0.678,0.0001,817,887,50,25,0.001,1704,7
0.7,0.0001,874,930,50,25,0.001,1804,7
0.716,0.0001,924,980,50,25,0.001,1904,7
0.732,0.0001,976,1028,50,25,0.001,2004,7
0.52,0.0001,49,55,50,25,0.001,104,8
0.514,0.0001,104,100,50,25,0.001,204,8
0.516,0.0001,152,152,50,25,0.001,304,8
0.516,0.0001,201,203,50,25,0.001,404,8
0.516,0.0001,247,257,50,25,0.001,504,8
0.512,0.0001,306,298,50,25,0.001,604,8
0.51,0.0001,362,342,50,25,0.001,704,8
0.514,0.0001,416,388,50,25,0.001,804,8
0.52,0.0001,463,441,50,25,0.001,904,8
0.522,0.0001,515,489,50,25,0.001,1004,8
0.532,0.0001,564,540,50,25,0.001,1104,8
0.536,0.0001,617,587,50,25,0.001,1204,8
0.556,0.0001,671,633,50,25,0.001,1304,8
0.57,0.0001,719,685,50,25,0.001,1404,8
0.6,0.0001,770,734,50,25,0.001,1504,8
0.62,0.0001,817,787,50,25,0.001,1604,8
0.644,0.0001,857,847,50,25,0.001,1704,8
0.656,0.0001,910,894,50,25,0.001,1804,8
0.682,0.0001,956,948,50,25,0.001,1904,8
0.704,0.0001,1006,998,50,25,0.001,2004,8
0.448,0.0001,49,55,50,25,0.001,104,9
0.456,0.0001,104,100,50,25,0.001,204,9
0.46,0.0001,156,148,50,25,0.001,304,9
0.468,0.0001,205,199,50,25,0.001,404,9
0.472,0.0001,254,250,50,25,0.001,504,9
0.48,0.0001,312,292,50,25,0.001,604,9
0.482,0.0001,367,337,50,25,0.001,704,9
0.49,0.0001,416,388,50,25,0.001,804,9
0.498,0.0001,460,444,50,25,0.001,904,9
0.512,0.0001,506,498,50,25,0.001,1004,9
0.518,0.0001,556,548,50,25,0.001,1104,9
0.532,0.0001,614,590,50,25,0.001,1204,9
0.54,0.0001,662,642,50,25,0.001,1304,9
0.558,0.0001,708,696,50,25,0.001,1404,9
0.566,0.0001,753,751,50,25,0.001,1504,9
0.588,0.0001,802,802,50,25,0.001,1604,9
0.612,0.0001,843,861,50,25,0.001,1704,9
0.63,0.0001,888,916,50,25,0.001,1804,9
0.636,0.0001,923,981,50,25,0.001,1904,9
0.666,0.0001,978,1026,50,25,0.001,2004,9
0.51,0.0001,52,52,50,25,0.001,104,10
0.514,0.0001,101,103,50,25,0.001,204,10
0.52,0.0001,157,147,50,25,0.001,304,10
0.528,0.0001,203,201,50,25,0.001,404,10
0.528,0.0001,253,251,50,25,0.001,504,10
0.534,0.0001,308,296,50,25,0.001,604,10
0.536,0.0001,365,339,50,25,0.001,704,10
0.542,0.0001,417,387,50,25,0.001,804,10
0.554,0.0001,471,433,50,25,0.001,904,10
0.566,0.0001,521,483,50,25,0.001,1004,10
0.574,0.0001,567,537,50,25,0.001,1104,10
0.586,0.0001,611,593,50,25,0.001,1204,10
0.574,0.0001,667,637,50,25,0.001,1304,10
0.596,0.0001,717,687,50,25,0.001,1404,10
0.616,0.0001,773,731,50,25,0.001,1504,10
0.634,0.0001,824,780,50,25,0.001,1604,10
0.65,0.0001,874,830,50,25,0.001,1704,10
0.678,0.0001,920,884,50,25,0.001,1804,10
0.688,0.0001,964,940,50,25,0.001,1904,10
0.706,0.0001,1006,998,50,25,0.001,2004,10
0.506,0.0001,51,53,50,25,0.001,104,11
0.51,0.0001,99,105,50,25,0.001,204,11
0.514,0.0001,147,157,50,25,0.001,304,11
0.514,0.0001,203,201,50,25,0.001,404,11
0.514,0.0001,253,251,50,25,0.001,504,11
0.514,0.0001,310,294,50,25,0.001,604,11
0.516,0.0001,356,348,50,25,0.001,704,11
0.52,0.0001,397,407,50,25,0.001,804,11
0.526,0.0001,443,461,50,25,0.001,904,11
0.53,0.0001,496,508,50,25,0.001,1004,11
0.534,0.0001,549,555,50,25,0.001,1104,11
0.544,0.0001,609,595,50,25,0.001,1204,11
0.55,0.0001,654,650,50,25,0.001,1304,11
0.548,0.0001,703,701,50,25,0.001,1404,11
0.564,0.0001,758,746,50,25,0.001,1504,11
0.572,0.0001,801,803,50,25,0.001,1604,11
0.578,0.0001,846,858,50,25,0.001,1704,11
0.598,0.0001,901,903,50,25,0.001,1804,11
0.612,0.0001,957,947,50,25,0.001,1904,11
0.632,0.0001,1006,998,50,25,0.001,2004,11
0.49,0.0001,57,47,50,25,0.001,104,12
0.5,0.0001,96,108,50,25,0.001,204,12
0.506,0.0001,146,158,50,25,0.001,304,12
0.516,0.0001,204,200,50,25,0.001,404,12
0.528,0.0001,249,255,50,25,0.001,504,12
0.542,0.0001,298,306,50,25,0.001,604,12
0.55,0.0001,343,361,50,25,0.001,704,12
0.552,0.0001,396,408,50,25,0.001,804,12
0.548,0.0001,450,454,50,25,0.001,904,12
0.556,0.0001,499,505,50,25,0.001,1004,12
0.56,0.0001,549,555,50,25,0.001,1104,12
0.57,0.0001,594,610,50,25,0.001,1204,12
0.578,0.0001,642,662,50,25,0.001,1304,12
0.59,0.0001,695,709,50,25,0.001,1404,12
0.6,0.0001,750,754,50,25,0.001,1504,12
0.606,0.0001,805,799,50,25,0.001,1604,12
0.632,0.0001,857,847,50,25,0.001,1704,12
0.65,0.0001,898,906,50,25,0.001,1804,12
0.676,0.0001,951,953,50,25,0.001,1904,12
0.706,0.0001,1002,1002,50,25,0.001,2004,12
0.47,0.0001,54,50,50,25,0.001,104,13
0.472,0.0001,116,88,50,25,0.001,204,13
0.474,0.0001,167,137,50,25,0.001,304,13
0.478,0.0001,212,192,50,25,0.001,404,13
0.482,0.0001,267,237,50,25,0.001,504,13
0.484,0.0001,314,290,50,25,0.001,604,13
0.492,0.0001,369,335,50,25,0.001,704,13
0.5,0.0001,425,379,50,25,0.001,804,13
0.504,0.0001,482,422,50,25,0.001,904,13
0.508,0.0001,534,470,50,25,0.001,1004,13
0.518,0.0001,582,522,50,25,0.001,1104,13
0.526,0.0001,638,566,50,25,0.001,1204,13
0.534,0.0001,677,627,50,25,0.001,1304,13
0.548,0.0001,724,680,50,25,0.001,1404,13
0.572,0.0001,774,730,50,25,0.001,1504,13
0.6,0.0001,821,783,50,25,0.001,1604,13
0.618,0.0001,872,832,50,25,0.001,1704,13
0.64,0.0001,915,889,50,25,0.001,1804,13
0.658,0.0001,965,939,50,25,0.001,1904,13
0.676,0.0001,1022,982,50,25,0.001,2004,13
0.512,0.0001,59,45,50,25,0.001,104,14
0.51,0.0001,107,97,50,25,0.001,204,14
0.51,0.0001,148,156,50,25,0.001,304,14
0.51,0.0001,189,215,50,25,0.001,404,14
0.51,0.0001,228,276,50,25,0.001,504,14
0.51,0.0001,281,323,50,25,0.001,604,14
0.512,0.0001,333,371,50,25,0.001,704,14
0.51,0.0001,382,422,50,25,0.001,804,14
0.51,0.0001,435,469,50,25,0.001,904,14
0.514,0.0001,486,518,50,25,0.001,1004,14
0.506,0.0001,544,560,50,25,0.001,1104,14
0.514,0.0001,597,607,50,25,0.001,1204,14
0.518,0.0001,654,650,50,25,0.001,1304,14
0.526,0.0001,705,699,50,25,0.001,1404,14
0.528,0.0001,750,754,50,25,0.001,1504,14
0.526,0.0001,801,803,50,25,0.001,1604,14
0.544,0.0001,861,843,50,25,0.001,1704,14
0.548,0.0001,913,891,50,25,0.001,1804,14
0.562,0.0001,957,947,50,25,0.001,1904,14
0.586,0.0001,1006,998,50,25,0.001,2004,14
0.458,0.0001,42,62,50,25,0.001,104,15
0.466,0.0001,96,108,50,25,0.001,204,15
0.47,0.0001,146,158,50,25,0.001,304,15
0.48,0.0001,199,205,50,25,0.001,404,15
0.476,0.0001,256,248,50,25,0.001,504,15
0.478,0.0001,308,296,50,25,0.001,604,15
0.48,0.0001,364,340,50,25,0.001,704,15
0.476,0.0001,420,384,50,25,0.001,804,15
0.478,0.0001,469,435,50,25,0.001,904,15
0.486,0.0001,521,483,50,25,0.001,1004,15
0.494,0.0001,572,532,50,25,0.001,1104,15
0.504,0.0001,628,576,50,25,0.001,1204,15
0.52,0.0001,678,626,50,25,0.001,1304,15
0.538,0.0001,717,687,50,25,0.001,1404,15
0.55,0.0001,768,736,50,25,0.001,1504,15
0.574,0.0001,814,790,50,25,0.001,1604,15
0.598,0.0001,858,846,50,25,0.001,1704,15
0.624,0.0001,904,900,50,25,0.001,1804,15
0.646,0.0001,954,950,50,25,0.001,1904,15
0.678,0.0001,997,1007,50,25,0.001,2004,15
0.486,0.0001,44,60,50,25,0.001,104,16
0.494,0.0001,100,104,50,25,0.001,204,16
0.5,0.0001,151,153,50,25,0.001,304,16
0.508,0.0001,201,203,50,25,0.001,404,16
0.516,0.0001,252,252,50,25,0.001,504,16
0.522,0.0001,301,303,50,25,0.001,604,16
0.526,0.0001,346,358,50,25,0.001,704,16
0.538,0.0001,401,403,50,25,0.001,804,16
0.546,0.0001,452,452,50,25,0.001,904,16
0.548,0.0001,504,500,50,25,0.001,1004,16
0.56,0.0001,557,547,50,25,0.001,1104,16
0.56,0.0001,604,600,50,25,0.001,1204,16
0.566,0.0001,657,647,50,25,0.001,1304,16
0.594,0.0001,712,692,50,25,0.001,1404,16
0.614,0.0001,761,743,50,25,0.001,1504,16
0.62,0.0001,815,789,50,25,0.001,1604,16
0.626,0.0001,869,835,50,25,0.001,1704,16
0.648,0.0001,919,885,50,25,0.001,1804,16
0.674,0.0001,966,938,50,25,0.001,1904,16
0.696,0.0001,1016,988,50,25,0.001,2004,16
0.508,0.0001,58,46,50,25,0.001,104,17
0.508,0.0001,107,97,50,25,0.001,204,17
0.518,0.0001,155,149,50,25,0.001,304,17
0.532,0.0001,214,190,50,25,0.001,404,17
0.524,0.0001,258,246,50,25,0.001,504,17
0.526,0.0001,302,302,50,25,0.001,604,17
0.522,0.0001,356,348,50,25,0.001,704,17
0.534,0.0001,413,391,50,25,0.001,804,17
0.544,0.0001,470,434,50,25,0.001,904,17
0.552,0.0001,520,484,50,25,0.001,1004,17
0.552,0.0001,566,538,50,25,0.001,1104,17
0.558,0.0001,620,584,50,25,0.001,1204,17
0.556,0.0001,667,637,50,25,0.001,1304,17
0.566,0.0001,716,688,50,25,0.001,1404,17
0.582,0.0001,760,744,50,25,0.001,1504,17
0.592,0.0001,807,797,50,25,0.001,1604,17
0.6,0.0001,851,853,50,25,0.001,1704,17
0.62,0.0001,903,901,50,25,0.001,1804,17
0.62,0.0001,947,957,50,25,0.001,1904,17
0.638,0.0001,996,1008,50,25,0.001,2004,17
0.506,0.0001,51,53,50,25,0.001,104,18
0.512,0.0001,103,101,50,25,0.001,204,18
0.516,0.0001,159,145,50,25,0.001,304,18
0.522,0.0001,207,197,50,25,0.001,404,18
0.542,0.0001,262,242,50,25,0.001,504,18
0.542,0.0001,320,284,50,25,0.001,604,18
0.546,0.0001,377,327,50,25,0.001,704,18
0.552,0.0001,431,373,50,25,0.001,804,18
0.558,0.0001,477,427,50,25,0.001,904,18
0.566,0.0001,535,469,50,25,0.001,1004,18
0.59,0.0001,586,518,50,25,0.001,1104,18
0.602,0.0001,635,569,50,25,0.001,1204,18
0.598,0.0001,679,625,50,25,0.001,1304,18
0.604,0.0001,726,678,50,25,0.001,1404,18
0.618,0.0001,774,730,50,25,0.001,1504,18
0.626,0.0001,820,784,50,25,0.001,1604,18
0.644,0.0001,868,836,50,25,0.001,1704,18
0.662,0.0001,913,891,50,25,0.001,1804,18
0.682,0.0001,961,943,50,25,0.001,1904,18
0.71,0.0001,1012,992,50,25,0.001,2004,18
0.552,0.0001,63,41,50,25,0.001,104,19
0.546,0.0001,116,88,50,25,0.001,204,19
0.552,0.0001,172,132,50,25,0.001,304,19
0.554,0.0001,221,183,50,25,0.001,404,19
0.548,0.0001,268,236,50,25,0.001,504,19
0.554,0.0001,320,284,50,25,0.001,604,19
0.558,0.0001,374,330,50,25,0.001,704,19
0.572,0.0001,422,382,50,25,0.001,804,19
0.576,0.0001,463,441,50,25,0.001,904,19
0.574,0.0001,512,492,50,25,0.001,1004,19
0.58,0.0001,555,549,50,25,0.001,1104,19
0.588,0.0001,606,598,50,25,0.001,1204,19
0.586,0.0001,650,654,50,25,0.001,1304,19
0.602,0.0001,694,710,50,25,0.001,1404,19
0.606,0.0001,744,760,50,25,0.001,1504,19
0.63,0.0001,794,810,50,25,0.001,1604,19
0.65,0.0001,848,856,50,25,0.001,1704,19
0.664,0.0001,908,896,50,25,0.001,1804,19
0.68,0.0001,958,946,50,25,0.001,1904,19
0.694,0.0001,1005,999,50,25,0.001,2004,19
0.508,0.0001,55,49,50,25,0.001,104,20
0.504,0.0001,101,103,50,25,0.001,204,20
0.51,0.0001,146,158,50,25,0.001,304,20
0.51,0.0001,192,212,50,25,0.001,404,20
0.518,0.0001,246,258,50,25,0.001,504,20
0.52,0.0001,303,301,50,25,0.001,604,20
0.536,0.0001,349,355,50,25,0.001,704,20
0.546,0.0001,393,411,50,25,0.001,804,20
0.548,0.0001,443,461,50,25,0.001,904,20
0.552,0.0001,495,509,50,25,0.001,1004,20
0.562,0.0001,554,550,50,25,0.001,1104,20
0.572,0.0001,608,596,50,25,0.001,1204,20
0.584,0.0001,660,644,50,25,0.001,1304,20
0.594,0.0001,701,703,50,25,0.001,1404,20
0.608,0.0001,748,756,50,25,0.001,1504,20
0.612,0.0001,806,798,50,25,0.001,1604,20
0.624,0.0001,853,851,50,25,0.001,1704,20
0.64,0.0001,906,898,50,25,0.001,1804,20
0.652,0.0001,961,943,50,25,0.001,1904,20
0.668,0.0001,1015,989,50,25,0.001,2004,20
0.492,0.0001,52,52,50,25,0.01,104,1
0.552,0.0001,101,103,50,25,0.01,204,1
0.594,0.0001,155,149,50,25,0.01,304,1
0.616,0.0001,214,190,50,25,0.01,404,1
0.6,0.0001,266,238,50,25,0.01,504,1
0.628,0.0001,312,292,50,25,0.01,604,1
0.626,0.0001,357,347,50,25,0.01,704,1
0.666,0.0001,409,395,50,25,0.01,804,1
0.686,0.0001,456,448,50,25,0.01,904,1
0.77,0.0001,499,505,50,25,0.01,1004,1
0.802,0.0001,550,554,50,25,0.01,1104,1
0.836,0.0001,607,597,50,25,0.01,1204,1
0.87,0.0001,656,648,50,25,0.01,1304,1
0.9,0.0001,702,702,50,25,0.01,1404,1
0.92,0.0001,763,741,50,25,0.01,1504,1
0.938,0.0001,808,796,50,25,0.01,1604,1
0.934,0.0001,856,848,50,25,0.01,1704,1
0.946,0.0001,905,899,50,25,0.01,1804,1
0.946,0.0001,965,939,50,25,0.01,1904,1
0.95,0.0001,1012,992,50,25,0.01,2004,1
0.488,0.0001,56,48,50,25,0.01,104,2
0.502,0.0001,103,101,50,25,0.01,204,2
0.52,0.0001,148,156,50,25,0.01,304,2
0.536,0.0001,196,208,50,25,0.01,404,2
0.56,0.0001,243,261,50,25,0.01,504,2
0.592,0.0001,295,309,50,25,0.01,604,2
0.622,0.0001,346,358,50,25,0.01,704,2
0.662,0.0001,397,407,50,25,0.01,804,2
0.684,0.0001,449,455,50,25,0.01,904,2
0.746,0.0001,502,502,50,25,0.01,1004,2
0.77,0.0001,561,543,50,25,0.01,1104,2
0.872,0.0001,612,592,50,25,0.01,1204,2
0.896,0.0001,665,639,50,25,0.01,1304,2
0.93,0.0001,714,690,50,25,0.01,1404,2
0.936,0.0001,756,748,50,25,0.01,1504,2
0.952,0.0001,812,792,50,25,0.01,1604,2
0.958,0.0001,859,845,50,25,0.01,1704,2
0.966,0.0001,905,899,50,25,0.01,1804,2
0.966,0.0001,958,946,50,25,0.01,1904,2
0.97,0.0001,1016,988,50,25,0.01,2004,2
0.544,0.0001,55,49,50,25,0.01,104,3
0.552,0.0001,106,98,50,25,0.01,204,3
0.59,0.0001,160,144,50,25,0.01,304,3
0.59,0.0001,211,193,50,25,0.01,404,3
0.596,0.0001,258,246,50,25,0.01,504,3
0.624,0.0001,304,300,50,25,0.01,604,3
0.654,0.0001,355,349,50,25,0.01,704,3
0.712,0.0001,405,399,50,25,0.01,804,3
0.756,0.0001,458,446,50,25,0.01,904,3
0.792,0.0001,505,499,50,25,0.01,1004,3
0.848,0.0001,554,550,50,25,0.01,1104,3
0.894,0.0001,610,594,50,25,0.01,1204,3
0.914,0.0001,653,651,50,25,0.01,1304,3
0.928,0.0001,702,702,50,25,0.01,1404,3
0.932,0.0001,753,751,50,25,0.01,1504,3
0.932,0.0001,802,802,50,25,0.01,1604,3
0.932,0.0001,851,853,50,25,0.01,1704,3
0.936,0.0001,898,906,50,25,0.01,1804,3
0.934,0.0001,953,951,50,25,0.01,1904,3
0.94,0.0001,1000,1004,50,25,0.01,2004,3
0.49,0.0001,57,47,50,25,0.01,104,4
0.574,0.0001,107,97,50,25,0.01,204,4
0.544,0.0001,163,141,50,25,0.01,304,4
0.576,0.0001,211,193,50,25,0.01,404,4
0.588,0.0001,257,247,50,25,0.01,504,4
0.618,0.0001,308,296,50,25,0.01,604,4
0.63,0.0001,353,351,50,25,0.01,704,4
0.69,0.0001,396,408,50,25,0.01,804,4
0.714,0.0001,441,463,50,25,0.01,904,4
0.776,0.0001,496,508,50,25,0.01,1004,4
0.82,0.0001,557,547,50,25,0.01,1104,4
0.872,0.0001,604,600,50,25,0.01,1204,4
0.886,0.0001,654,650,50,25,0.01,1304,4
0.916,0.0001,708,696,50,25,0.01,1404,4
0.934,0.0001,756,748,50,25,0.01,1504,4
0.95,0.0001,800,804,50,25,0.01,1604,4
0.956,0.0001,842,862,50,25,0.01,1704,4
0.962,0.0001,902,902,50,25,0.01,1804,4
0.968,0.0001,953,951,50,25,0.01,1904,4
0.97,0.0001,999,1005,50,25,0.01,2004,4
0.502,0.0001,42,62,50,25,0.01,104,5
0.528,0.0001,90,114,50,25,0.01,204,5
0.534,0.0001,142,162,50,25,0.01,304,5
0.572,0.0001,186,218,50,25,0.01,404,5
0.624,0.0001,224,280,50,25,0.01,504,5
0.64,0.0001,272,332,50,25,0.01,604,5
0.66,0.0001,315,389,50,25,0.01,704,5
0.674,0.0001,369,435,50,25,0.01,804,5
0.71,0.0001,414,490,50,25,0.01,904,5
0.766,0.0001,472,532,50,25,0.01,1004,5
0.824,0.0001,516,588,50,25,0.01,1104,5
0.856,0.0001,570,634,50,25,0.01,1204,5
0.892,0.0001,614,690,50,25,0.01,1304,5
0.922,0.0001,675,729,50,25,0.01,1404,5
0.948,0.0001,730,774,50,25,0.01,1504,5
0.952,0.0001,785,819,50,25,0.01,1604,5
0.952,0.0001,845,859,50,25,0.01,1704,5
0.96,0.0001,897,907,50,25,0.01,1804,5
0.958,0.0001,943,961,50,25,0.01,1904,5
0.958,0.0001,995,1009,50,25,0.01,2004,5
0.484,0.0001,64,40,50,25,0.01,104,6
0.516,0.0001,118,86,50,25,0.01,204,6
0.522,0.0001,172,132,50,25,0.01,304,6
0.558,0.0001,222,182,50,25,0.01,404,6
0.602,0.0001,271,233,50,25,0.01,504,6
0.614,0.0001,326,278,50,25,0.01,604,6
0.622,0.0001,375,329,50,25,0.01,704,6
0.628,0.0001,431,373,50,25,0.01,804,6
0.678,0.0001,481,423,50,25,0.01,904,6
0.716,0.0001,525,479,50,25,0.01,1004,6
0.782,0.0001,571,533,50,25,0.01,1104,6
0.838,0.0001,612,592,50,25,0.01,1204,6
0.872,0.0001,664,640,50,25,0.01,1304,6
0.91,0.0001,712,692,50,25,0.01,1404,6
0.924,0.0001,768,736,50,25,0.01,1504,6
0.954,0.0001,816,788,50,25,0.01,1604,6
0.944,0.0001,868,836,50,25,0.01,1704,6
0.956,0.0001,913,891,50,25,0.01,1804,6
0.96,0.0001,959,945,50,25,0.01,1904,6
0.964,0.0001,1004,1000,50,25,0.01,2004,6
0.548,0.0001,55,49,50,25,0.01,104,7
0.552,0.0001,106,98,50,25,0.01,204,7
0.544,0.0001,157,147,50,25,0.01,304,7
0.57,0.0001,207,197,50,25,0.01,404,7
0.604,0.0001,256,248,50,25,0.01,504,7
0.626,0.0001,311,293,50,25,0.01,604,7
0.65,0.0001,357,347,50,25,0.01,704,7
0.69,0.0001,403,401,50,25,0.01,804,7
0.718,0.0001,448,456,50,25,0.01,904,7
0.776,0.0001,488,516,50,25,0.01,1004,7
0.808,0.0001,538,566,50,25,0.01,1104,7
0.858,0.0001,594,610,50,25,0.01,1204,7
0.91,0.0001,644,660,50,25,0.01,1304,7
0.94,0.0001,687,717,50,25,0.01,1404,7
0.962,0.0001,741,763,50,25,0.01,1504,7
0.96,0.0001,792,812,50,25,0.01,1604,7
0.964,0.0001,843,861,50,25,0.01,1704,7
0.97,0.0001,889,915,50,25,0.01,1804,7
0.972,0.0001,946,958,50,25,0.01,1904,7
0.972,0.0001,997,1007,50,25,0.01,2004,7
0.528,0.0001,52,52,50,25,0.01,104,8
0.566,0.0001,109,95,50,25,0.01,204,8
0.562,0.0001,155,149,50,25,0.01,304,8
0.558,0.0001,205,199,50,25,0.01,404,8
0.572,0.0001,259,245,50,25,0.01,504,8
0.618,0.0001,307,297,50,25,0.01,604,8
0.664,0.0001,361,343,50,25,0.01,704,8
0.696,0.0001,414,390,50,25,0.01,804,8
0.726,0.0001,457,447,50,25,0.01,904,8
0.78,0.0001,507,497,50,25,0.01,1004,8
0.814,0.0001,557,547,50,25,0.01,1104,8
0.852,0.0001,607,597,50,25,0.01,1204,8
0.878,0.0001,656,648,50,25,0.01,1304,8
0.926,0.0001,709,695,50,25,0.01,1404,8
0.92,0.0001,759,745,50,25,0.01,1504,8
0.938,0.0001,804,800,50,25,0.01,1604,8
0.948,0.0001,856,848,50,25,0.01,1704,8
0.954,0.0001,904,900,50,25,0.01,1804,8
0.962,0.0001,962,942,50,25,0.01,1904,8
0.968,0.0001,1013,991,50,25,0.01,2004,8
0.502,0.0001,47,57,50,25,0.01,104,9
0.51,0.0001,102,102,50,25,0.01,204,9
0.526,0.0001,163,141,50,25,0.01,304,9
0.544,0.0001,220,184,50,25,0.01,404,9
0.556,0.0001,264,240,50,25,0.01,504,9
0.57,0.0001,312,292,50,25,0.01,604,9
0.588,0.0001,360,344,50,25,0.01,704,9
0.632,0.0001,413,391,50,25,0.01,804,9
0.658,0.0001,457,447,50,25,0.01,904,9
0.686,0.0001,508,496,50,25,0.01,1004,9
0.71,0.0001,565,539,50,25,0.01,1104,9
0.76,0.0001,615,589,50,25,0.01,1204,9
0.808,0.0001,657,647,50,25,0.01,1304,9
0.848,0.0001,708,696,50,25,0.01,1404,9
0.864,0.0001,757,747,50,25,0.01,1504,9
0.896,0.0001,810,794,50,25,0.01,1604,9
0.908,0.0001,852,852,50,25,0.01,1704,9
0.914,0.0001,903,901,50,25,0.01,1804,9
0.928,0.0001,953,951,50,25,0.01,1904,9
0.938,0.0001,996,1008,50,25,0.01,2004,9
0.482,0.0001,61,43,50,25,0.01,104,10
0.506,0.0001,119,85,50,25,0.01,204,10
0.536,0.0001,171,133,50,25,0.01,304,10
0.548,0.0001,217,187,50,25,0.01,404,10
0.584,0.0001,272,232,50,25,0.01,504,10
0.622,0.0001,315,289,50,25,0.01,604,10
0.67,0.0001,365,339,50,25,0.01,704,10
0.684,0.0001,414,390,50,25,0.01,804,10
0.708,0.0001,461,443,50,25,0.01,904,10
0.75,0.0001,508,496,50,25,0.01,1004,10
0.778,0.0001,552,552,50,25,0.01,1104,10
0.822,0.0001,600,604,50,25,0.01,1204,10
0.846,0.0001,640,664,50,25,0.01,1304,10
0.878,0.0001,696,708,50,25,0.01,1404,10
0.896,0.0001,745,759,50,25,0.01,1504,10
0.926,0.0001,795,809,50,25,0.01,1604,10
0.948,0.0001,838,866,50,25,0.01,1704,10
0.952,0.0001,889,915,50,25,0.01,1804,10
0.958,0.0001,937,967,50,25,0.01,1904,10
0.966,0.0001,993,1011,50,25,0.01,2004,10
0.536,0.0001,53,51,50,25,0.01,104,11
0.588,0.0001,104,100,50,25,0.01,204,11
0.604,0.0001,150,154,50,25,0.01,304,11
0.596,0.0001,198,206,50,25,0.01,404,11
0.6,0.0001,248,256,50,25,0.01,504,11
0.62,0.0001,308,296,50,25,0.01,604,11
0.648,0.0001,365,339,50,25,0.01,704,11
0.712,0.0001,418,386,50,25,0.01,804,11
0.764,0.0001,471,433,50,25,0.01,904,11
0.826,0.0001,515,489,50,25,0.01,1004,11
0.85,0.0001,561,543,50,25,0.01,1104,11
0.886,0.0001,620,584,50,25,0.01,1204,11
0.904,0.0001,680,624,50,25,0.01,1304,11
0.934,0.0001,725,679,50,25,0.01,1404,11
0.938,0.0001,775,729,50,25,0.01,1504,11
0.938,0.0001,819,785,50,25,0.01,1604,11
0.94,0.0001,871,833,50,25,0.01,1704,11
0.946,0.0001,918,886,50,25,0.01,1804,11
0.956,0.0001,966,938,50,25,0.01,1904,11
0.952,0.0001,1015,989,50,25,0.01,2004,11
0.542,0.0001,44,60,50,25,0.01,104,12
0.56,0.0001,94,110,50,25,0.01,204,12
0.572,0.0001,148,156,50,25,0.01,304,12
0.596,0.0001,200,204,50,25,0.01,404,12
0.654,0.0001,247,257,50,25,0.01,504,12
0.694,0.0001,305,299,50,25,0.01,604,12
0.74,0.0001,356,348,50,25,0.01,704,12
0.774,0.0001,407,397,50,25,0.01,804,12
0.79,0.0001,448,456,50,25,0.01,904,12
0.838,0.0001,502,502,50,25,0.01,1004,12
0.87,0.0001,547,557,50,25,0.01,1104,12
0.902,0.0001,600,604,50,25,0.01,1204,12
0.916,0.0001,644,660,50,25,0.01,1304,12
0.936,0.0001,698,706,50,25,0.01,1404,12
0.946,0.0001,754,750,50,25,0.01,1504,12
0.96,0.0001,801,803,50,25,0.01,1604,12
0.964,0.0001,849,855,50,25,0.01,1704,12
0.968,0.0001,901,903,50,25,0.01,1804,12
0.972,0.0001,943,961,50,25,0.01,1904,12
0.98,0.0001,989,1015,50,25,0.01,2004,12
0.568,0.0001,52,52,50,25,0.01,104,13
0.588,0.0001,101,103,50,25,0.01,204,13
0.596,0.0001,151,153,50,25,0.01,304,13
0.606,0.0001,192,212,50,25,0.01,404,13
0.638,0.0001,238,266,50,25,0.01,504,13
0.656,0.0001,285,319,50,25,0.01,604,13
0.656,0.0001,332,372,50,25,0.01,704,13
0.696,0.0001,386,418,50,25,0.01,804,13
0.714,0.0001,431,473,50,25,0.01,904,13
0.758,0.0001,483,521,50,25,0.01,1004,13
0.812,0.0001,536,568,50,25,0.01,1104,13
0.884,0.0001,584,620,50,25,0.01,1204,13
0.916,0.0001,640,664,50,25,0.01,1304,13
0.946,0.0001,682,722,50,25,0.01,1404,13
0.96,0.0001,736,768,50,25,0.01,1504,13
0.968,0.0001,787,817,50,25,0.01,1604,13
0.968,0.0001,845,859,50,25,0.01,1704,13
0.976,0.0001,900,904,50,25,0.01,1804,13
0.978,0.0001,955,949,50,25,0.01,1904,13
0.978,0.0001,991,1013,50,25,0.01,2004,13
0.444,0.0001,50,54,50,25,0.01,104,14
0.488,0.0001,97,107,50,25,0.01,204,14
0.516,0.0001,144,160,50,25,0.01,304,14
0.572,0.0001,196,208,50,25,0.01,404,14
0.584,0.0001,245,259,50,25,0.01,504,14
0.628,0.0001,290,314,50,25,0.01,604,14
0.632,0.0001,332,372,50,25,0.01,704,14
0.684,0.0001,383,421,50,25,0.01,804,14
0.7,0.0001,434,470,50,25,0.01,904,14
0.762,0.0001,489,515,50,25,0.01,1004,14
0.826,0.0001,534,570,50,25,0.01,1104,14
0.868,0.0001,583,621,50,25,0.01,1204,14
0.892,0.0001,642,662,50,25,0.01,1304,14
0.92,0.0001,690,714,50,25,0.01,1404,14
0.926,0.0001,740,764,50,25,0.01,1504,14
0.94,0.0001,790,814,50,25,0.01,1604,14
0.946,0.0001,837,867,50,25,0.01,1704,14
0.946,0.0001,886,918,50,25,0.01,1804,14
0.944,0.0001,938,966,50,25,0.01,1904,14
0.954,0.0001,1000,1004,50,25,0.01,2004,14
0.534,0.0001,61,43,50,25,0.01,104,15
0.522,0.0001,113,91,50,25,0.01,204,15
0.532,0.0001,159,145,50,25,0.01,304,15
0.558,0.0001,202,202,50,25,0.01,404,15
0.606,0.0001,244,260,50,25,0.01,504,15
0.64,0.0001,299,305,50,25,0.01,604,15
0.654,0.0001,352,352,50,25,0.01,704,15
0.68,0.0001,396,408,50,25,0.01,804,15
0.712,0.0001,446,458,50,25,0.01,904,15
0.76,0.0001,497,507,50,25,0.01,1004,15
0.8,0.0001,555,549,50,25,0.01,1104,15
0.844,0.0001,608,596,50,25,0.01,1204,15
0.86,0.0001,654,650,50,25,0.01,1304,15
0.892,0.0001,709,695,50,25,0.01,1404,15
0.916,0.0001,760,744,50,25,0.01,1504,15
0.934,0.0001,810,794,50,25,0.01,1604,15
0.936,0.0001,862,842,50,25,0.01,1704,15
0.95,0.0001,919,885,50,25,0.01,1804,15
0.952,0.0001,967,937,50,25,0.01,1904,15
0.952,0.0001,1022,982,50,25,0.01,2004,15
0.526,0.0001,60,44,50,25,0.01,104,16
0.558,0.0001,104,100,50,25,0.01,204,16
0.566,0.0001,151,153,50,25,0.01,304,16
0.59,0.0001,202,202,50,25,0.01,404,16
0.604,0.0001,252,252,50,25,0.01,504,16
0.628,0.0001,316,288,50,25,0.01,604,16
0.644,0.0001,364,340,50,25,0.01,704,16
0.67,0.0001,411,393,50,25,0.01,804,16
0.71,0.0001,459,445,50,25,0.01,904,16
0.766,0.0001,510,494,50,25,0.01,1004,16
0.804,0.0001,558,546,50,25,0.01,1104,16
0.864,0.0001,608,596,50,25,0.01,1204,16
0.904,0.0001,658,646,50,25,0.01,1304,16
0.93,0.0001,712,692,50,25,0.01,1404,16
0.934,0.0001,760,744,50,25,0.01,1504,16
0.944,0.0001,806,798,50,25,0.01,1604,16
0.948,0.0001,855,849,50,25,0.01,1704,16
0.96,0.0001,912,892,50,25,0.01,1804,16
0.962,0.0001,958,946,50,25,0.01,1904,16
0.968,0.0001,1006,998,50,25,0.01,2004,16
0.516,0.0001,48,56,50,25,0.01,104,17
0.526,0.0001,97,107,50,25,0.01,204,17
0.548,0.0001,153,151,50,25,0.01,304,17
0.588,0.0001,202,202,50,25,0.01,404,17
0.61,0.0001,248,256,50,25,0.01,504,17
0.656,0.0001,305,299,50,25,0.01,604,17
0.672,0.0001,355,349,50,25,0.01,704,17
0.702,0.0001,406,398,50,25,0.01,804,17
0.726,0.0001,454,450,50,25,0.01,904,17
0.776,0.0001,508,496,50,25,0.01,1004,17
0.834,0.0001,554,550,50,25,0.01,1104,17
0.868,0.0001,600,604,50,25,0.01,1204,17
0.892,0.0001,645,659,50,25,0.01,1304,17
0.918,0.0001,691,713,50,25,0.01,1404,17
0.942,0.0001,740,764,50,25,0.01,1504,17
0.94,0.0001,787,817,50,25,0.01,1604,17
0.942,0.0001,833,871,50,25,0.01,1704,17
0.958,0.0001,890,914,50,25,0.01,1804,17
0.964,0.0001,945,959,50,25,0.01,1904,17
0.962,0.0001,991,1013,50,25,0.01,2004,17
0.512,0.0001,49,55,50,25,0.01,104,18
0.526,0.0001,99,105,50,25,0.01,204,18
0.532,0.0001,157,147,50,25,0.01,304,18
0.568,0.0001,210,194,50,25,0.01,404,18
0.578,0.0001,269,235,50,25,0.01,504,18
0.588,0.0001,308,296,50,25,0.01,604,18
0.644,0.0001,354,350,50,25,0.01,704,18
0.644,0.0001,411,393,50,25,0.01,804,18
0.656,0.0001,455,449,50,25,0.01,904,18
0.692,0.0001,508,496,50,25,0.01,1004,18
0.714,0.0001,560,544,50,25,0.01,1104,18
0.752,0.0001,617,587,50,25,0.01,1204,18
0.808,0.0001,657,647,50,25,0.01,1304,18
0.846,0.0001,698,706,50,25,0.01,1404,18
0.878,0.0001,748,756,50,25,0.01,1504,18
0.916,0.0001,798,806,50,25,0.01,1604,18
0.922,0.0001,857,847,50,25,0.01,1704,18
0.938,0.0001,902,902,50,25,0.01,1804,18
0.954,0.0001,955,949,50,25,0.01,1904,18
0.96,0.0001,1007,997,50,25,0.01,2004,18
0.518,0.0001,46,58,50,25,0.01,104,19
0.55,0.0001,100,104,50,25,0.01,204,19
0.57,0.0001,143,161,50,25,0.01,304,19
0.59,0.0001,200,204,50,25,0.01,404,19
0.596,0.0001,255,249,50,25,0.01,504,19
0.628,0.0001,303,301,50,25,0.01,604,19
0.662,0.0001,350,354,50,25,0.01,704,19
0.688,0.0001,401,403,50,25,0.01,804,19
0.7,0.0001,454,450,50,25,0.01,904,19
0.78,0.0001,502,502,50,25,0.01,1004,19
0.8,0.0001,555,549,50,25,0.01,1104,19
0.852,0.0001,607,597,50,25,0.01,1204,19
0.884,0.0001,652,652,50,25,0.01,1304,19
0.93,0.0001,705,699,50,25,0.01,1404,19
0.95,0.0001,751,753,50,25,0.01,1504,19
0.954,0.0001,798,806,50,25,0.01,1604,19
0.962,0.0001,858,846,50,25,0.01,1704,19
0.968,0.0001,905,899,50,25,0.01,1804,19
0.966,0.0001,947,957,50,25,0.01,1904,19
0.964,0.0001,991,1013,50,25,0.01,2004,19
0.532,0.0001,48,56,50,25,0.01,104,20
0.57,0.0001,98,106,50,25,0.01,204,20
0.576,0.0001,143,161,50,25,0.01,304,20
0.596,0.0001,192,212,50,25,0.01,404,20
0.624,0.0001,244,260,50,25,0.01,504,20
0.662,0.0001,296,308,50,25,0.01,604,20
0.7,0.0001,349,355,50,25,0.01,704,20
0.724,0.0001,404,400,50,25,0.01,804,20
0.724,0.0001,459,445,50,25,0.01,904,20
0.784,0.0001,504,500,50,25,0.01,1004,20
0.846,0.0001,559,545,50,25,0.01,1104,20
0.904,0.0001,606,598,50,25,0.01,1204,20
0.926,0.0001,663,641,50,25,0.01,1304,20
0.932,0.0001,706,698,50,25,0.01,1404,20
0.942,0.0001,759,745,50,25,0.01,1504,20
0.96,0.0001,801,803,50,25,0.01,1604,20
0.964,0.0001,851,853,50,25,0.01,1704,20
0.962,0.0001,910,894,50,25,0.01,1804,20
0.968,0.0001,963,941,50,25,0.01,1904,20
0.964,0.0001,1013,991,50,25,0.01,2004,20
0.468,0.001,55,49,50,25,0.0001,104,1
0.468,0.001,105,99,50,25,0.0001,204,1
0.468,0.001,159,145,50,25,0.0001,304,1
0.466,0.001,219,185,50,25,0.0001,404,1
0.466,0.001,269,235,50,25,0.0001,504,1
0.468,0.001,329,275,50,25,0.0001,604,1
0.47,0.001,379,325,50,25,0.0001,704,1
0.47,0.001,412,392,50,25,0.0001,804,1
0.47,0.001,459,445,50,25,0.0001,904,1
0.468,0.001,511,493,50,25,0.0001,1004,1
0.468,0.001,564,540,50,25,0.0001,1104,1
0.466,0.001,619,585,50,25,0.0001,1204,1
0.468,0.001,672,632,50,25,0.0001,1304,1
0.468,0.001,715,689,50,25,0.0001,1404,1
0.466,0.001,757,747,50,25,0.0001,1504,1
0.462,0.001,808,796,50,25,0.0001,1604,1
0.462,0.001,861,843,50,25,0.0001,1704,1
0.464,0.001,915,889,50,25,0.0001,1804,1
0.47,0.001,967,937,50,25,0.0001,1904,1
0.472,0.001,1018,986,50,25,0.0001,2004,1
0.52,0.001,46,58,50,25,0.0001,104,2
0.522,0.001,98,106,50,25,0.0001,204,2
0.524,0.001,146,158,50,25,0.0001,304,2
0.524,0.001,200,204,50,25,0.0001,404,2
0.53,0.001,251,253,50,25,0.0001,504,2
0.53,0.001,302,302,50,25,0.0001,604,2
0.53,0.001,359,345,50,25,0.0001,704,2
0.532,0.001,408,396,50,25,0.0001,804,2
0.532,0.001,460,444,50,25,0.0001,904,2
0.534,0.001,519,485,50,25,0.0001,1004,2
0.536,0.001,567,537,50,25,0.0001,1104,2
0.536,0.001,615,589,50,25,0.0001,1204,2
0.538,0.001,660,644,50,25,0.0001,1304,2
0.54,0.001,706,698,50,25,0.0001,1404,2
0.546,0.001,756,748,50,25,0.0001,1504,2
0.54,0.001,797,807,50,25,0.0001,1604,2
0.542,0.001,850,854,50,25,0.0001,1704,2
0.546,0.001,907,897,50,25,0.0001,1804,2
0.546,0.001,960,944,50,25,0.0001,1904,2
0.55,0.001,1007,997,50,25,0.0001,2004,2
0.496,0.001,60,44,50,25,0.0001,104,3
0.496,0.001,105,99,50,25,0.0001,204,3
0.496,0.001,153,151,50,25,0.0001,304,3
0.496,0.001,204,200,50,25,0.0001,404,3
0.496,0.001,250,254,50,25,0.0001,504,3
0.496,0.001,297,307,50,25,0.0001,604,3
0.496,0.001,340,364,50,25,0.0001,704,3
0.496,0.001,386,418,50,25,0.0001,804,3
0.498,0.001,435,469,50,25,0.0001,904,3
0.498,0.001,486,518,50,25,0.0001,1004,3
0.498,0.001,535,569,50,25,0.0001,1104,3
0.5,0.001,582,622,50,25,0.0001,1204,3
0.5,0.001,626,678,50,25,0.0001,1304,3
0.5,0.001,682,722,50,25,0.0001,1404,3
0.498,0.001,731,773,50,25,0.0001,1504,3
0.502,0.001,782,822,50,25,0.0001,1604,3
0.502,0.001,836,868,50,25,0.0001,1704,3
0.502,0.001,897,907,50,25,0.0001,1804,3
0.508,0.001,950,954,50,25,0.0001,1904,3
0.508,0.001,995,1009,50,25,0.0001,2004,3
0.514,0.001,37,67,50,25,0.0001,104,4
0.51,0.001,100,104,50,25,0.0001,204,4
0.512,0.001,146,158,50,25,0.0001,304,4
0.514,0.001,200,204,50,25,0.0001,404,4
0.512,0.001,250,254,50,25,0.0001,504,4
0.512,0.001,292,312,50,25,0.0001,604,4
0.512,0.001,347,357,50,25,0.0001,704,4
0.512,0.001,390,414,50,25,0.0001,804,4
0.51,0.001,436,468,50,25,0.0001,904,4
0.51,0.001,488,516,50,25,0.0001,1004,4
0.512,0.001,541,563,50,25,0.0001,1104,4
0.514,0.001,594,610,50,25,0.0001,1204,4
0.516,0.001,650,654,50,25,0.0001,1304,4
0.52,0.001,693,711,50,25,0.0001,1404,4
0.524,0.001,740,764,50,25,0.0001,1504,4
0.524,0.001,794,810,50,25,0.0001,1604,4
0.526,0.001,847,857,50,25,0.0001,1704,4
0.524,0.001,891,913,50,25,0.0001,1804,4
0.52,0.001,944,960,50,25,0.0001,1904,4
0.53,0.001,994,1010,50,25,0.0001,2004,4
0.466,0.001,48,56,50,25,0.0001,104,5
0.466,0.001,94,110,50,25,0.0001,204,5
0.466,0.001,145,159,50,25,0.0001,304,5
0.466,0.001,198,206,50,25,0.0001,404,5
0.464,0.001,244,260,50,25,0.0001,504,5
0.466,0.001,296,308,50,25,0.0001,604,5
0.468,0.001,343,361,50,25,0.0001,704,5
0.468,0.001,393,411,50,25,0.0001,804,5
0.47,0.001,447,457,50,25,0.0001,904,5
0.468,0.001,491,513,50,25,0.0001,1004,5
0.47,0.001,542,562,50,25,0.0001,1104,5
0.47,0.001,585,619,50,25,0.0001,1204,5
0.47,0.001,637,667,50,25,0.0001,1304,5
0.472,0.001,687,717,50,25,0.0001,1404,5
0.472,0.001,732,772,50,25,0.0001,1504,5
0.472,0.001,780,824,50,25,0.0001,1604,5
0.474,0.001,838,866,50,25,0.0001,1704,5
0.474,0.001,893,911,50,25,0.0001,1804,5
0.474,0.001,937,967,50,25,0.0001,1904,5
0.476,0.001,990,1014,50,25,0.0001,2004,5
0.518,0.001,50,54,50,25,0.0001,104,6
0.52,0.001,91,113,50,25,0.0001,204,6
0.522,0.001,143,161,50,25,0.0001,304,6
0.52,0.001,197,207,50,25,0.0001,404,6
0.522,0.001,259,245,50,25,0.0001,504,6
0.522,0.001,302,302,50,25,0.0001,604,6
0.518,0.001,361,343,50,25,0.0001,704,6
0.518,0.001,404,400,50,25,0.0001,804,6
0.518,0.001,453,451,50,25,0.0001,904,6
0.516,0.001,502,502,50,25,0.0001,1004,6
0.516,0.001,552,552,50,25,0.0001,1104,6
0.518,0.001,603,601,50,25,0.0001,1204,6
0.52,0.001,647,657,50,25,0.0001,1304,6
0.518,0.001,698,706,50,25,0.0001,1404,6
0.516,0.001,748,756,50,25,0.0001,1504,6
0.516,0.001,801,803,50,25,0.0001,1604,6
0.52,0.001,855,849,50,25,0.0001,1704,6
0.52,0.001,913,891,50,25,0.0001,1804,6
0.522,0.001,961,943,50,25,0.0001,1904,6
0.522,0.001,1009,995,50,25,0.0001,2004,6
0.47,0.001,48,56,50,25,0.0001,104,7
0.47,0.001,91,113,50,25,0.0001,204,7
0.47,0.001,150,154,50,25,0.0001,304,7
0.468,0.001,201,203,50,25,0.0001,404,7
0.468,0.001,249,255,50,25,0.0001,504,7
0.468,0.001,305,299,50,25,0.0001,604,7
0.47,0.001,352,352,50,25,0.0001,704,7
0.47,0.001,403,401,50,25,0.0001,804,7
0.47,0.001,448,456,50,25,0.0001,904,7
0.47,0.001,504,500,50,25,0.0001,1004,7
0.474,0.001,555,549,50,25,0.0001,1104,7
0.476,0.001,615,589,50,25,0.0001,1204,7
0.478,0.001,665,639,50,25,0.0001,1304,7
0.48,0.001,714,690,50,25,0.0001,1404,7
0.48,0.001,769,735,50,25,0.0001,1504,7
0.484,0.001,820,784,50,25,0.0001,1604,7
0.486,0.001,858,846,50,25,0.0001,1704,7
0.486,0.001,902,902,50,25,0.0001,1804,7
0.486,0.001,948,956,50,25,0.0001,1904,7
0.49,0.001,994,1010,50,25,0.0001,2004,7
0.47,0.001,47,57,50,25,0.0001,104,8
0.47,0.001,97,107,50,25,0.0001,204,8
0.47,0.001,155,149,50,25,0.0001,304,8
0.468,0.001,207,197,50,25,0.0001,404,8
0.468,0.001,261,243,50,25,0.0001,504,8
0.47,0.001,302,302,50,25,0.0001,604,8
0.47,0.001,354,350,50,25,0.0001,704,8
0.47,0.001,408,396,50,25,0.0001,804,8
0.468,0.001,457,447,50,25,0.0001,904,8
0.466,0.001,514,490,50,25,0.0001,1004,8
0.466,0.001,561,543,50,25,0.0001,1104,8
0.466,0.001,610,594,50,25,0.0001,1204,8
0.468,0.001,659,645,50,25,0.0001,1304,8
0.47,0.001,715,689,50,25,0.0001,1404,8
0.472,0.001,761,743,50,25,0.0001,1504,8
0.472,0.001,817,787,50,25,0.0001,1604,8
0.472,0.001,872,832,50,25,0.0001,1704,8
0.476,0.001,920,884,50,25,0.0001,1804,8
0.478,0.001,964,940,50,25,0.0001,1904,8
0.478,0.001,1009,995,50,25,0.0001,2004,8
0.54,0.001,49,55,50,25,0.0001,104,9
0.54,0.001,109,95,50,25,0.0001,204,9
0.54,0.001,161,143,50,25,0.0001,304,9
0.542,0.001,202,202,50,25,0.0001,404,9
0.542,0.001,249,255,50,25,0.0001,504,9
0.542,0.001,301,303,50,25,0.0001,604,9
0.544,0.001,345,359,50,25,0.0001,704,9
0.544,0.001,402,402,50,25,0.0001,804,9
0.546,0.001,454,450,50,25,0.0001,904,9
0.546,0.001,501,503,50,25,0.0001,1004,9
0.548,0.001,550,554,50,25,0.0001,1104,9
0.548,0.001,599,605,50,25,0.0001,1204,9
0.548,0.001,656,648,50,25,0.0001,1304,9
0.548,0.001,705,699,50,25,0.0001,1404,9
0.546,0.001,758,746,50,25,0.0001,1504,9
0.546,0.001,806,798,50,25,0.0001,1604,9
0.548,0.001,860,844,50,25,0.0001,1704,9
0.55,0.001,908,896,50,25,0.0001,1804,9
0.548,0.001,960,944,50,25,0.0001,1904,9
0.548,0.001,1009,995,50,25,0.0001,2004,9
0.518,0.001,48,56,50,25,0.0001,104,10
0.52,0.001,105,99,50,25,0.0001,204,10
0.52,0.001,161,143,50,25,0.0001,304,10
0.52,0.001,214,190,50,25,0.0001,404,10
0.52,0.001,266,238,50,25,0.0001,504,10
0.524,0.001,310,294,50,25,0.0001,604,10
0.524,0.001,362,342,50,25,0.0001,704,10
0.522,0.001,407,397,50,25,0.0001,804,10
0.52,0.001,458,446,50,25,0.0001,904,10
0.522,0.001,516,488,50,25,0.0001,1004,10
0.524,0.001,570,534,50,25,0.0001,1104,10
0.522,0.001,616,588,50,25,0.0001,1204,10
0.524,0.001,658,646,50,25,0.0001,1304,10
0.524,0.001,701,703,50,25,0.0001,1404,10
0.52,0.001,749,755,50,25,0.0001,1504,10
0.52,0.001,793,811,50,25,0.0001,1604,10
0.52,0.001,847,857,50,25,0.0001,1704,10
0.522,0.001,907,897,50,25,0.0001,1804,10
0.522,0.001,961,943,50,25,0.0001,1904,10
0.524,0.001,1009,995,50,25,0.0001,2004,10
0.506,0.001,47,57,50,25,0.0001,104,11
0.504,0.001,103,101,50,25,0.0001,204,11
0.504,0.001,146,158,50,25,0.0001,304,11
0.504,0.001,209,195,50,25,0.0001,404,11
0.504,0.001,255,249,50,25,0.0001,504,11
0.502,0.001,302,302,50,25,0.0001,604,11
0.502,0.001,352,352,50,25,0.0001,704,11
0.502,0.001,396,408,50,25,0.0001,804,11
0.502,0.001,445,459,50,25,0.0001,904,11
0.504,0.001,494,510,50,25,0.0001,1004,11
0.504,0.001,536,568,50,25,0.0001,1104,11
0.506,0.001,585,619,50,25,0.0001,1204,11
0.504,0.001,643,661,50,25,0.0001,1304,11
0.506,0.001,701,703,50,25,0.0001,1404,11
0.504,0.001,749,755,50,25,0.0001,1504,11
0.5,0.001,793,811,50,25,0.0001,1604,11
0.508,0.001,845,859,50,25,0.0001,1704,11
0.508,0.001,895,909,50,25,0.0001,1804,11
0.508,0.001,944,960,50,25,0.0001,1904,11
0.508,0.001,1001,1003,50,25,0.0001,2004,11
0.472,0.001,52,52,50,25,0.0001,104,12
0.474,0.001,103,101,50,25,0.0001,204,12
0.47,0.001,154,150,50,25,0.0001,304,12
0.47,0.001,209,195,50,25,0.0001,404,12
0.468,0.001,253,251,50,25,0.0001,504,12
0.468,0.001,308,296,50,25,0.0001,604,12
0.468,0.001,354,350,50,25,0.0001,704,12
0.47,0.001,403,401,50,25,0.0001,804,12
0.476,0.001,452,452,50,25,0.0001,904,12
0.48,0.001,504,500,50,25,0.0001,1004,12
0.482,0.001,547,557,50,25,0.0001,1104,12
0.482,0.001,599,605,50,25,0.0001,1204,12
0.482,0.001,647,657,50,25,0.0001,1304,12
0.484,0.001,691,713,50,25,0.0001,1404,12
0.488,0.001,736,768,50,25,0.0001,1504,12
0.49,0.001,792,812,50,25,0.0001,1604,12
0.494,0.001,838,866,50,25,0.0001,1704,12
0.494,0.001,898,906,50,25,0.0001,1804,12
0.494,0.001,946,958,50,25,0.0001,1904,12
0.496,0.001,1005,999,50,25,0.0001,2004,12
0.512,0.001,52,52,50,25,0.0001,104,13
0.514,0.001,112,92,50,25,0.0001,204,13
0.514,0.001,166,138,50,25,0.0001,304,13
0.512,0.001,207,197,50,25,0.0001,404,13
0.51,0.001,249,255,50,25,0.0001,504,13
0.51,0.001,291,313,50,25,0.0001,604,13
0.51,0.001,343,361,50,25,0.0001,704,13
0.51,0.001,387,417,50,25,0.0001,804,13
0.51,0.001,436,468,50,25,0.0001,904,13
0.514,0.001,483,521,50,25,0.0001,1004,13
0.514,0.001,529,575,50,25,0.0001,1104,13
0.516,0.001,577,627,50,25,0.0001,1204,13
0.516,0.001,633,671,50,25,0.0001,1304,13
0.518,0.001,688,716,50,25,0.0001,1404,13
0.526,0.001,734,770,50,25,0.0001,1504,13
0.528,0.001,780,824,50,25,0.0001,1604,13
0.532,0.001,834,870,50,25,0.0001,1704,13
0.534,0.001,891,913,50,25,0.0001,1804,13
0.534,0.001,936,968,50,25,0.0001,1904,13
0.54,0.001,986,1018,50,25,0.0001,2004,13
0.528,0.001,47,57,50,25,0.0001,104,14
0.528,0.001,98,106,50,25,0.0001,204,14
0.53,0.001,155,149,50,25,0.0001,304,14
0.53,0.001,200,204,50,25,0.0001,404,14
0.53,0.001,251,253,50,25,0.0001,504,14
0.534,0.001,292,312,50,25,0.0001,604,14
0.536,0.001,343,361,50,25,0.0001,704,14
0.536,0.001,394,410,50,25,0.0001,804,14
0.538,0.001,443,461,50,25,0.0001,904,14
0.538,0.001,482,522,50,25,0.0001,1004,14
0.54,0.001,541,563,50,25,0.0001,1104,14
0.538,0.001,590,614,50,25,0.0001,1204,14
0.542,0.001,634,670,50,25,0.0001,1304,14
0.542,0.001,685,719,50,25,0.0001,1404,14
0.538,0.001,744,760,50,25,0.0001,1504,14
0.536,0.001,794,810,50,25,0.0001,1604,14
0.536,0.001,850,854,50,25,0.0001,1704,14
0.538,0.001,902,902,50,25,0.0001,1804,14
0.538,0.001,956,948,50,25,0.0001,1904,14
0.538,0.001,1006,998,50,25,0.0001,2004,14
0.508,0.001,48,56,50,25,0.0001,104,15
0.508,0.001,93,111,50,25,0.0001,204,15
0.508,0.001,147,157,50,25,0.0001,304,15
0.508,0.001,189,215,50,25,0.0001,404,15
0.508,0.001,240,264,50,25,0.0001,504,15
0.508,0.001,289,315,50,25,0.0001,604,15
0.508,0.001,333,371,50,25,0.0001,704,15
0.508,0.001,386,418,50,25,0.0001,804,15
0.508,0.001,443,461,50,25,0.0001,904,15
0.508,0.001,489,515,50,25,0.0001,1004,15
0.51,0.001,541,563,50,25,0.0001,1104,15
0.51,0.001,584,620,50,25,0.0001,1204,15
0.512,0.001,637,667,50,25,0.0001,1304,15
0.51,0.001,692,712,50,25,0.0001,1404,15
0.51,0.001,746,758,50,25,0.0001,1504,15
0.51,0.001,797,807,50,25,0.0001,1604,15
0.51,0.001,838,866,50,25,0.0001,1704,15
0.508,0.001,888,916,50,25,0.0001,1804,15
0.508,0.001,946,958,50,25,0.0001,1904,15
0.506,0.001,998,1006,50,25,0.0001,2004,15
0.47,0.001,53,51,50,25,0.0001,104,16
0.47,0.001,99,105,50,25,0.0001,204,16
0.47,0.001,146,158,50,25,0.0001,304,16
0.47,0.001,195,209,50,25,0.0001,404,16
0.47,0.001,244,260,50,25,0.0001,504,16
0.472,0.001,303,301,50,25,0.0001,604,16
0.472,0.001,359,345,50,25,0.0001,704,16
0.474,0.001,414,390,50,25,0.0001,804,16
0.474,0.001,459,445,50,25,0.0001,904,16
0.478,0.001,521,483,50,25,0.0001,1004,16
0.478,0.001,570,534,50,25,0.0001,1104,16
0.482,0.001,620,584,50,25,0.0001,1204,16
0.482,0.001,670,634,50,25,0.0001,1304,16
0.482,0.001,719,685,50,25,0.0001,1404,16
0.478,0.001,766,738,50,25,0.0001,1504,16
0.482,0.001,812,792,50,25,0.0001,1604,16
0.486,0.001,859,845,50,25,0.0001,1704,16
0.488,0.001,911,893,50,25,0.0001,1804,16
0.494,0.001,961,943,50,25,0.0001,1904,16
0.496,0.001,1007,997,50,25,0.0001,2004,16
0.508,0.001,50,54,50,25,0.0001,104,17
0.508,0.001,95,109,50,25,0.0001,204,17
0.51,0.001,154,150,50,25,0.0001,304,17
0.51,0.001,203,201,50,25,0.0001,404,17
0.51,0.001,260,244,50,25,0.0001,504,17
0.51,0.001,311,293,50,25,0.0001,604,17
0.508,0.001,362,342,50,25,0.0001,704,17
0.508,0.001,415,389,50,25,0.0001,804,17
0.51,0.001,463,441,50,25,0.0001,904,17
0.512,0.001,511,493,50,25,0.0001,1004,17
0.512,0.001,557,547,50,25,0.0001,1104,17
0.514,0.001,604,600,50,25,0.0001,1204,17
0.514,0.001,657,647,50,25,0.0001,1304,17
0.512,0.001,707,697,50,25,0.0001,1404,17
0.512,0.001,756,748,50,25,0.0001,1504,17
0.51,0.001,804,800,50,25,0.0001,1604,17
0.508,0.001,860,844,50,25,0.0001,1704,17
0.508,0.001,911,893,50,25,0.0001,1804,17
0.508,0.001,966,938,50,25,0.0001,1904,17
0.506,0.001,1003,1001,50,25,0.0001,2004,17
0.47,0.001,44,60,50,25,0.0001,104,18
0.47,0.001,90,114,50,25,0.0001,204,18
0.468,0.001,141,163,50,25,0.0001,304,18
0.47,0.001,191,213,50,25,0.0001,404,18
0.47,0.001,244,260,50,25,0.0001,504,18
0.47,0.001,300,304,50,25,0.0001,604,18
0.47,0.001,348,356,50,25,0.0001,704,18
0.472,0.001,390,414,50,25,0.0001,804,18
0.472,0.001,442,462,50,25,0.0001,904,18
0.474,0.001,496,508,50,25,0.0001,1004,18
0.472,0.001,552,552,50,25,0.0001,1104,18
0.474,0.001,606,598,50,25,0.0001,1204,18
0.474,0.001,657,647,50,25,0.0001,1304,18
0.476,0.001,703,701,50,25,0.0001,1404,18
0.478,0.001,755,749,50,25,0.0001,1504,18
0.48,0.001,802,802,50,25,0.0001,1604,18
0.48,0.001,851,853,50,25,0.0001,1704,18
0.482,0.001,895,909,50,25,0.0001,1804,18
0.48,0.001,942,962,50,25,0.0001,1904,18
0.482,0.001,986,1018,50,25,0.0001,2004,18
0.466,0.001,60,44,50,25,0.0001,104,19
0.466,0.001,111,93,50,25,0.0001,204,19
0.466,0.001,164,140,50,25,0.0001,304,19
0.468,0.001,210,194,50,25,0.0001,404,19
0.474,0.001,257,247,50,25,0.0001,504,19
0.474,0.001,300,304,50,25,0.0001,604,19
0.474,0.001,344,360,50,25,0.0001,704,19
0.474,0.001,394,410,50,25,0.0001,804,19
0.474,0.001,438,466,50,25,0.0001,904,19
0.476,0.001,488,516,50,25,0.0001,1004,19
0.48,0.001,534,570,50,25,0.0001,1104,19
0.482,0.001,595,609,50,25,0.0001,1204,19
0.482,0.001,650,654,50,25,0.0001,1304,19
0.48,0.001,709,695,50,25,0.0001,1404,19
0.482,0.001,757,747,50,25,0.0001,1504,19
0.484,0.001,796,808,50,25,0.0001,1604,19
0.488,0.001,845,859,50,25,0.0001,1704,19
0.488,0.001,897,907,50,25,0.0001,1804,19
0.49,0.001,947,957,50,25,0.0001,1904,19
0.492,0.001,999,1005,50,25,0.0001,2004,19
0.484,0.001,55,49,50,25,0.0001,104,20
0.484,0.001,106,98,50,25,0.0001,204,20
0.484,0.001,155,149,50,25,0.0001,304,20
0.484,0.001,209,195,50,25,0.0001,404,20
0.486,0.001,256,248,50,25,0.0001,504,20
0.486,0.001,304,300,50,25,0.0001,604,20
0.488,0.001,359,345,50,25,0.0001,704,20
0.492,0.001,408,396,50,25,0.0001,804,20
0.492,0.001,460,444,50,25,0.0001,904,20
0.492,0.001,510,494,50,25,0.0001,1004,20
0.5,0.001,573,531,50,25,0.0001,1104,20
0.5,0.001,619,585,50,25,0.0001,1204,20
0.496,0.001,663,641,50,25,0.0001,1304,20
0.496,0.001,703,701,50,25,0.0001,1404,20
0.492,0.001,755,749,50,25,0.0001,1504,20
0.498,0.001,806,798,50,25,0.0001,1604,20
0.498,0.001,856,848,50,25,0.0001,1704,20
0.496,0.001,903,901,50,25,0.0001,1804,20
0.494,0.001,949,955,50,25,0.0001,1904,20
0.496,0.001,993,1011,50,25,0.0001,2004,20
0.548,0.001,57,47,50,25,0.001,104,1
0.556,0.001,104,100,50,25,0.001,204,1
0.552,0.001,149,155,50,25,0.001,304,1
0.556,0.001,194,210,50,25,0.001,404,1
0.556,0.001,251,253,50,25,0.001,504,1
0.564,0.001,306,298,50,25,0.001,604,1
0.572,0.001,353,351,50,25,0.001,704,1
0.576,0.001,398,406,50,25,0.001,804,1
0.582,0.001,440,464,50,25,0.001,904,1
0.606,0.001,489,515,50,25,0.001,1004,1
0.614,0.001,537,567,50,25,0.001,1104,1
0.624,0.001,587,617,50,25,0.001,1204,1
0.638,0.001,635,669,50,25,0.001,1304,1
0.652,0.001,687,717,50,25,0.001,1404,1
0.66,0.001,746,758,50,25,0.001,1504,1
0.668,0.001,802,802,50,25,0.001,1604,1
0.666,0.001,858,846,50,25,0.001,1704,1
0.678,0.001,904,900,50,25,0.001,1804,1
0.702,0.001,956,948,50,25,0.001,1904,1
0.712,0.001,1005,999,50,25,0.001,2004,1
0.5,0.001,46,58,50,25,0.001,104,2
0.506,0.001,94,110,50,25,0.001,204,2
0.504,0.001,138,166,50,25,0.001,304,2
0.514,0.001,196,208,50,25,0.001,404,2
0.526,0.001,238,266,50,25,0.001,504,2
0.536,0.001,287,317,50,25,0.001,604,2
0.546,0.001,339,365,50,25,0.001,704,2
0.544,0.001,388,416,50,25,0.001,804,2
0.55,0.001,435,469,50,25,0.001,904,2
0.55,0.001,486,518,50,25,0.001,1004,2
0.55,0.001,540,564,50,25,0.001,1104,2
0.556,0.001,589,615,50,25,0.001,1204,2
0.566,0.001,637,667,50,25,0.001,1304,2
0.58,0.001,685,719,50,25,0.001,1404,2
0.588,0.001,742,762,50,25,0.001,1504,2
0.596,0.001,794,810,50,25,0.001,1604,2
0.614,0.001,848,856,50,25,0.001,1704,2
0.624,0.001,897,907,50,25,0.001,1804,2
0.632,0.001,944,960,50,25,0.001,1904,2
0.656,0.001,992,1012,50,25,0.001,2004,2
0.468,0.001,47,57,50,25,0.001,104,3
0.476,0.001,102,102,50,25,0.001,204,3
0.48,0.001,146,158,50,25,0.001,304,3
0.492,0.001,195,209,50,25,0.001,404,3
0.49,0.001,241,263,50,25,0.001,504,3
0.488,0.001,291,313,50,25,0.001,604,3
0.492,0.001,344,360,50,25,0.001,704,3
0.502,0.001,395,409,50,25,0.001,804,3
0.504,0.001,451,453,50,25,0.001,904,3
0.514,0.001,500,504,50,25,0.001,1004,3
0.52,0.001,559,545,50,25,0.001,1104,3
0.538,0.001,611,593,50,25,0.001,1204,3
0.554,0.001,660,644,50,25,0.001,1304,3
0.568,0.001,709,695,50,25,0.001,1404,3
0.588,0.001,747,757,50,25,0.001,1504,3
0.602,0.001,797,807,50,25,0.001,1604,3
0.608,0.001,850,854,50,25,0.001,1704,3
0.628,0.001,895,909,50,25,0.001,1804,3
0.648,0.001,943,961,50,25,0.001,1904,3
0.68,0.001,993,1011,50,25,0.001,2004,3
0.46,0.001,49,55,50,25,0.001,104,4
0.46,0.001,101,103,50,25,0.001,204,4
0.464,0.001,155,149,50,25,0.001,304,4
0.472,0.001,205,199,50,25,0.001,404,4
0.474,0.001,249,255,50,25,0.001,504,4
0.476,0.001,296,308,50,25,0.001,604,4
0.482,0.001,344,360,50,25,0.001,704,4
0.484,0.001,393,411,50,25,0.001,804,4
0.484,0.001,450,454,50,25,0.001,904,4
0.488,0.001,498,506,50,25,0.001,1004,4
0.486,0.001,545,559,50,25,0.001,1104,4
0.492,0.001,598,606,50,25,0.001,1204,4
0.5,0.001,654,650,50,25,0.001,1304,4
0.516,0.001,701,703,50,25,0.001,1404,4
0.522,0.001,750,754,50,25,0.001,1504,4
0.548,0.001,794,810,50,25,0.001,1604,4
0.55,0.001,849,855,50,25,0.001,1704,4
0.568,0.001,906,898,50,25,0.001,1804,4
0.596,0.001,951,953,50,25,0.001,1904,4
0.612,0.001,1006,998,50,25,0.001,2004,4
0.502,0.001,44,60,50,25,0.001,104,5
0.494,0.001,92,112,50,25,0.001,204,5
0.506,0.001,145,159,50,25,0.001,304,5
0.518,0.001,204,200,50,25,0.001,404,5
0.516,0.001,261,243,50,25,0.001,504,5
0.51,0.001,305,299,50,25,0.001,604,5
0.514,0.001,355,349,50,25,0.001,704,5
0.522,0.001,402,402,50,25,0.001,804,5
0.528,0.001,447,457,50,25,0.001,904,5
0.53,0.001,509,495,50,25,0.001,1004,5
0.538,0.001,551,553,50,25,0.001,1104,5
0.542,0.001,597,607,50,25,0.001,1204,5
0.556,0.001,650,654,50,25,0.001,1304,5
0.58,0.001,695,709,50,25,0.001,1404,5
0.602,0.001,739,765,50,25,0.001,1504,5
0.624,0.001,794,810,50,25,0.001,1604,5
0.64,0.001,842,862,50,25,0.001,1704,5
0.66,0.001,893,911,50,25,0.001,1804,5
0.682,0.001,946,958,50,25,0.001,1904,5
0.704,0.001,995,1009,50,25,0.001,2004,5
0.484,0.001,47,57,50,25,0.001,104,6
0.488,0.001,93,111,50,25,0.001,204,6
0.49,0.001,134,170,50,25,0.001,304,6
0.49,0.001,187,217,50,25,0.001,404,6
0.486,0.001,236,268,50,25,0.001,504,6
0.49,0.001,281,323,50,25,0.001,604,6
0.486,0.001,336,368,50,25,0.001,704,6
0.5,0.001,383,421,50,25,0.001,804,6
0.506,0.001,431,473,50,25,0.001,904,6
0.518,0.001,477,527,50,25,0.001,1004,6
0.528,0.001,537,567,50,25,0.001,1104,6
0.546,0.001,590,614,50,25,0.001,1204,6
0.56,0.001,629,675,50,25,0.001,1304,6
0.578,0.001,682,722,50,25,0.001,1404,6
0.6,0.001,738,766,50,25,0.001,1504,6
0.608,0.001,786,818,50,25,0.001,1604,6
0.63,0.001,833,871,50,25,0.001,1704,6
0.646,0.001,891,913,50,25,0.001,1804,6
0.672,0.001,938,966,50,25,0.001,1904,6
0.706,0.001,991,1013,50,25,0.001,2004,6
0.496,0.001,54,50,50,25,0.001,104,7
0.504,0.001,101,103,50,25,0.001,204,7
0.502,0.001,151,153,50,25,0.001,304,7
0.502,0.001,200,204,50,25,0.001,404,7
0.512,0.001,245,259,50,25,0.001,504,7
0.516,0.001,297,307,50,25,0.001,604,7
0.518,0.001,345,359,50,25,0.001,704,7
0.544,0.001,397,407,50,25,0.001,804,7
0.548,0.001,442,462,50,25,0.001,904,7
0.558,0.001,496,508,50,25,0.001,1004,7
0.558,0.001,541,563,50,25,0.001,1104,7
0.566,0.001,595,609,50,25,0.001,1204,7
0.578,0.001,648,656,50,25,0.001,1304,7
0.594,0.001,697,707,50,25,0.001,1404,7
0.62,0.001,756,748,50,25,0.001,1504,7
0.634,0.001,810,794,50,25,0.001,1604,7
0.646,0.001,850,854,50,25,0.001,1704,7
0.668,0.001,903,901,50,25,0.001,1804,7
0.678,0.001,953,951,50,25,0.001,1904,7
0.696,0.001,1007,997,50,25,0.001,2004,7
0.542,0.001,53,51,50,25,0.001,104,8
0.55,0.001,103,101,50,25,0.001,204,8
0.546,0.001,152,152,50,25,0.001,304,8
0.554,0.001,201,203,50,25,0.001,404,8
0.562,0.001,249,255,50,25,0.001,504,8
0.556,0.001,289,315,50,25,0.001,604,8
0.56,0.001,344,360,50,25,0.001,704,8
0.566,0.001,405,399,50,25,0.001,804,8
0.572,0.001,449,455,50,25,0.001,904,8
0.582,0.001,505,499,50,25,0.001,1004,8
0.592,0.001,557,547,50,25,0.001,1104,8
0.6,0.001,614,590,50,25,0.001,1204,8
0.61,0.001,668,636,50,25,0.001,1304,8
0.638,0.001,717,687,50,25,0.001,1404,8
0.644,0.001,770,734,50,25,0.001,1504,8
0.664,0.001,818,786,50,25,0.001,1604,8
0.67,0.001,863,841,50,25,0.001,1704,8
0.692,0.001,907,897,50,25,0.001,1804,8
0.704,0.001,955,949,50,25,0.001,1904,8
0.718,0.001,1007,997,50,25,0.001,2004,8
0.494,0.001,53,51,50,25,0.001,104,9
0.504,0.001,106,98,50,25,0.001,204,9
0.506,0.001,148,156,50,25,0.001,304,9
0.51,0.001,200,204,50,25,0.001,404,9
0.512,0.001,251,253,50,25,0.001,504,9
0.516,0.001,296,308,50,25,0.001,604,9
0.524,0.001,339,365,50,25,0.001,704,9
0.528,0.001,383,421,50,25,0.001,804,9
0.534,0.001,428,476,50,25,0.001,904,9
0.54,0.001,487,517,50,25,0.001,1004,9
0.554,0.001,544,560,50,25,0.001,1104,9
0.552,0.001,593,611,50,25,0.001,1204,9
0.566,0.001,639,665,50,25,0.001,1304,9
0.568,0.001,687,717,50,25,0.001,1404,9
0.572,0.001,729,775,50,25,0.001,1504,9
0.594,0.001,783,821,50,25,0.001,1604,9
0.604,0.001,845,859,50,25,0.001,1704,9
0.62,0.001,896,908,50,25,0.001,1804,9
0.632,0.001,948,956,50,25,0.001,1904,9
0.658,0.001,997,1007,50,25,0.001,2004,9
0.48,0.001,44,60,50,25,0.001,104,10
0.48,0.001,88,116,50,25,0.001,204,10
0.486,0.001,133,171,50,25,0.001,304,10
0.49,0.001,182,222,50,25,0.001,404,10
0.496,0.001,232,272,50,25,0.001,504,10
0.504,0.001,281,323,50,25,0.001,604,10
0.502,0.001,335,369,50,25,0.001,704,10
0.502,0.001,382,422,50,25,0.001,804,10
0.512,0.001,436,468,50,25,0.001,904,10
0.526,0.001,490,514,50,25,0.001,1004,10
0.528,0.001,540,564,50,25,0.001,1104,10
0.546,0.001,590,614,50,25,0.001,1204,10
0.554,0.001,641,663,50,25,0.001,1304,10
0.56,0.001,691,713,50,25,0.001,1404,10
0.568,0.001,744,760,50,25,0.001,1504,10
0.592,0.001,791,813,50,25,0.001,1604,10
0.616,0.001,842,862,50,25,0.001,1704,10
0.63,0.001,897,907,50,25,0.001,1804,10
0.65,0.001,953,951,50,25,0.001,1904,10
0.672,0.001,1003,1001,50,25,0.001,2004,10
0.51,0.001,49,55,50,25,0.001,104,11
0.518,0.001,101,103,50,25,0.001,204,11
0.526,0.001,158,146,50,25,0.001,304,11
0.53,0.001,209,195,50,25,0.001,404,11
0.53,0.001,267,237,50,25,0.001,504,11
0.534,0.001,319,285,50,25,0.001,604,11
0.542,0.001,368,336,50,25,0.001,704,11
0.556,0.001,419,385,50,25,0.001,804,11
0.562,0.001,473,431,50,25,0.001,904,11
0.578,0.001,525,479,50,25,0.001,1004,11
0.588,0.001,573,531,50,25,0.001,1104,11
0.61,0.001,626,578,50,25,0.001,1204,11
0.624,0.001,670,634,50,25,0.001,1304,11
0.642,0.001,714,690,50,25,0.001,1404,11
0.658,0.001,769,735,50,25,0.001,1504,11
0.662,0.001,829,775,50,25,0.001,1604,11
0.664,0.001,880,824,50,25,0.001,1704,11
0.676,0.001,929,875,50,25,0.001,1804,11
0.696,0.001,974,930,50,25,0.001,1904,11
0.718,0.001,1019,985,50,25,0.001,2004,11
0.47,0.001,52,52,50,25,0.001,104,12
0.472,0.001,101,103,50,25,0.001,204,12
0.47,0.001,145,159,50,25,0.001,304,12
0.468,0.001,191,213,50,25,0.001,404,12
0.472,0.001,231,273,50,25,0.001,504,12
0.478,0.001,279,325,50,25,0.001,604,12
0.478,0.001,334,370,50,25,0.001,704,12
0.494,0.001,381,423,50,25,0.001,804,12
0.502,0.001,430,474,50,25,0.001,904,12
0.502,0.001,476,528,50,25,0.001,1004,12
0.512,0.001,526,578,50,25,0.001,1104,12
0.522,0.001,576,628,50,25,0.001,1204,12
0.538,0.001,632,672,50,25,0.001,1304,12
0.554,0.001,680,724,50,25,0.001,1404,12
0.574,0.001,726,778,50,25,0.001,1504,12
0.598,0.001,782,822,50,25,0.001,1604,12
0.594,0.001,841,863,50,25,0.001,1704,12
0.618,0.001,900,904,50,25,0.001,1804,12
0.626,0.001,945,959,50,25,0.001,1904,12
0.636,0.001,986,1018,50,25,0.001,2004,12
0.462,0.001,51,53,50,25,0.001,104,13
0.47,0.001,109,95,50,25,0.001,204,13
0.474,0.001,156,148,50,25,0.001,304,13
0.488,0.001,201,203,50,25,0.001,404,13
0.484,0.001,257,247,50,25,0.001,504,13
0.496,0.001,305,299,50,25,0.001,604,13
0.51,0.001,362,342,50,25,0.001,704,13
0.518,0.001,406,398,50,25,0.001,804,13
0.54,0.001,456,448,50,25,0.001,904,13
0.526,0.001,504,500,50,25,0.001,1004,13
0.532,0.001,554,550,50,25,0.001,1104,13
0.54,0.001,604,600,50,25,0.001,1204,13
0.546,0.001,647,657,50,25,0.001,1304,13
0.554,0.001,695,709,50,25,0.001,1404,13
0.562,0.001,745,759,50,25,0.001,1504,13
0.57,0.001,790,814,50,25,0.001,1604,13
0.578,0.001,839,865,50,25,0.001,1704,13
0.602,0.001,884,920,50,25,0.001,1804,13
0.62,0.001,935,969,50,25,0.001,1904,13
0.636,0.001,996,1008,50,25,0.001,2004,13
0.52,0.001,49,55,50,25,0.001,104,14
0.516,0.001,103,101,50,25,0.001,204,14
0.514,0.001,150,154,50,25,0.001,304,14
0.518,0.001,195,209,50,25,0.001,404,14
0.52,0.001,244,260,50,25,0.001,504,14
0.516,0.001,293,311,50,25,0.001,604,14
0.526,0.001,353,351,50,25,0.001,704,14
0.522,0.001,405,399,50,25,0.001,804,14
0.53,0.001,452,452,50,25,0.001,904,14
0.544,0.001,494,510,50,25,0.001,1004,14
0.548,0.001,552,552,50,25,0.001,1104,14
0.574,0.001,596,608,50,25,0.001,1204,14
0.584,0.001,656,648,50,25,0.001,1304,14
0.586,0.001,699,705,50,25,0.001,1404,14
0.59,0.001,750,754,50,25,0.001,1504,14
0.61,0.001,788,816,50,25,0.001,1604,14
0.628,0.001,841,863,50,25,0.001,1704,14
0.648,0.001,887,917,50,25,0.001,1804,14
0.662,0.001,937,967,50,25,0.001,1904,14
0.68,0.001,986,1018,50,25,0.001,2004,14
0.54,0.001,59,45,50,25,0.001,104,15
0.536,0.001,116,88,50,25,0.001,204,15
0.528,0.001,167,137,50,25,0.001,304,15
0.526,0.001,211,193,50,25,0.001,404,15
0.532,0.001,265,239,50,25,0.001,504,15
0.53,0.001,316,288,50,25,0.001,604,15
0.518,0.001,366,338,50,25,0.001,704,15
0.534,0.001,415,389,50,25,0.001,804,15
0.542,0.001,469,435,50,25,0.001,904,15
0.552,0.001,523,481,50,25,0.001,1004,15
0.56,0.001,576,528,50,25,0.001,1104,15
0.564,0.001,628,576,50,25,0.001,1204,15
0.566,0.001,683,621,50,25,0.001,1304,15
0.586,0.001,730,674,50,25,0.001,1404,15
0.592,0.001,774,730,50,25,0.001,1504,15
0.594,0.001,818,786,50,25,0.001,1604,15
0.598,0.001,866,838,50,25,0.001,1704,15
0.616,0.001,911,893,50,25,0.001,1804,15
0.636,0.001,962,942,50,25,0.001,1904,15
0.656,0.001,1011,993,50,25,0.001,2004,15
0.506,0.001,55,49,50,25,0.001,104,16
0.5,0.001,109,95,50,25,0.001,204,16
0.498,0.001,153,151,50,25,0.001,304,16
0.51,0.001,197,207,50,25,0.001,404,16
0.516,0.001,242,262,50,25,0.001,504,16
0.522,0.001,295,309,50,25,0.001,604,16
0.52,0.001,330,374,50,25,0.001,704,16
0.522,0.001,385,419,50,25,0.001,804,16
0.526,0.001,440,464,50,25,0.001,904,16
0.528,0.001,492,512,50,25,0.001,1004,16
0.518,0.001,552,552,50,25,0.001,1104,16
0.52,0.001,603,601,50,25,0.001,1204,16
0.528,0.001,645,659,50,25,0.001,1304,16
0.526,0.001,698,706,50,25,0.001,1404,16
0.538,0.001,743,761,50,25,0.001,1504,16
0.55,0.001,788,816,50,25,0.001,1604,16
0.564,0.001,845,859,50,25,0.001,1704,16
0.578,0.001,898,906,50,25,0.001,1804,16
0.594,0.001,954,950,50,25,0.001,1904,16
0.604,0.001,1007,997,50,25,0.001,2004,16
0.5,0.001,55,49,50,25,0.001,104,17
0.506,0.001,105,99,50,25,0.001,204,17
0.508,0.001,149,155,50,25,0.001,304,17
0.516,0.001,205,199,50,25,0.001,404,17
0.52,0.001,259,245,50,25,0.001,504,17
0.524,0.001,302,302,50,25,0.001,604,17
0.536,0.001,359,345,50,25,0.001,704,17
0.538,0.001,403,401,50,25,0.001,804,17
0.544,0.001,451,453,50,25,0.001,904,17
0.56,0.001,500,504,50,25,0.001,1004,17
0.57,0.001,547,557,50,25,0.001,1104,17
0.586,0.001,599,605,50,25,0.001,1204,17
0.588,0.001,650,654,50,25,0.001,1304,17
0.6,0.001,699,705,50,25,0.001,1404,17
0.61,0.001,753,751,50,25,0.001,1504,17
0.618,0.001,804,800,50,25,0.001,1604,17
0.636,0.001,854,850,50,25,0.001,1704,17
0.656,0.001,905,899,50,25,0.001,1804,17
0.668,0.001,953,951,50,25,0.001,1904,17
0.682,0.001,1006,998,50,25,0.001,2004,17
0.472,0.001,57,47,50,25,0.001,104,18
0.482,0.001,107,97,50,25,0.001,204,18
0.484,0.001,149,155,50,25,0.001,304,18
0.486,0.001,196,208,50,25,0.001,404,18
0.494,0.001,252,252,50,25,0.001,504,18
0.506,0.001,304,300,50,25,0.001,604,18
0.518,0.001,349,355,50,25,0.001,704,18
0.516,0.001,403,401,50,25,0.001,804,18
0.526,0.001,457,447,50,25,0.001,904,18
0.544,0.001,503,501,50,25,0.001,1004,18
0.56,0.001,546,558,50,25,0.001,1104,18
0.572,0.001,593,611,50,25,0.001,1204,18
0.586,0.001,643,661,50,25,0.001,1304,18
0.59,0.001,701,703,50,25,0.001,1404,18
0.616,0.001,748,756,50,25,0.001,1504,18
0.632,0.001,804,800,50,25,0.001,1604,18
0.64,0.001,859,845,50,25,0.001,1704,18
0.652,0.001,900,904,50,25,0.001,1804,18
0.672,0.001,945,959,50,25,0.001,1904,18
0.694,0.001,998,1006,50,25,0.001,2004,18
0.466,0.001,57,47,50,25,0.001,104,19
0.464,0.001,110,94,50,25,0.001,204,19
0.472,0.001,155,149,50,25,0.001,304,19
0.478,0.001,203,201,50,25,0.001,404,19
0.478,0.001,249,255,50,25,0.001,504,19
0.5,0.001,301,303,50,25,0.001,604,19
0.514,0.001,356,348,50,25,0.001,704,19
0.538,0.001,408,396,50,25,0.001,804,19
0.56,0.001,461,443,50,25,0.001,904,19
0.578,0.001,511,493,50,25,0.001,1004,19
0.598,0.001,557,547,50,25,0.001,1104,19
0.608,0.001,607,597,50,25,0.001,1204,19
0.622,0.001,655,649,50,25,0.001,1304,19
0.622,0.001,703,701,50,25,0.001,1404,19
0.642,0.001,758,746,50,25,0.001,1504,19
0.662,0.001,810,794,50,25,0.001,1604,19
0.68,0.001,863,841,50,25,0.001,1704,19
0.696,0.001,919,885,50,25,0.001,1804,19
0.704,0.001,963,941,50,25,0.001,1904,19
0.728,0.001,1014,990,50,25,0.001,2004,19
0.488,0.001,51,53,50,25,0.001,104,20
0.486,0.001,98,106,50,25,0.001,204,20
0.486,0.001,143,161,50,25,0.001,304,20
0.492,0.001,201,203,50,25,0.001,404,20
0.492,0.001,248,256,50,25,0.001,504,20
0.49,0.001,300,304,50,25,0.001,604,20
0.494,0.001,352,352,50,25,0.001,704,20
0.5,0.001,401,403,50,25,0.001,804,20
0.506,0.001,455,449,50,25,0.001,904,20
0.504,0.001,502,502,50,25,0.001,1004,20
0.508,0.001,555,549,50,25,0.001,1104,20
0.53,0.001,594,610,50,25,0.001,1204,20
0.538,0.001,642,662,50,25,0.001,1304,20
0.554,0.001,697,707,50,25,0.001,1404,20
0.572,0.001,741,763,50,25,0.001,1504,20
0.572,0.001,786,818,50,25,0.001,1604,20
0.588,0.001,837,867,50,25,0.001,1704,20
0.602,0.001,889,915,50,25,0.001,1804,20
0.61,0.001,944,960,50,25,0.001,1904,20
0.638,0.001,992,1012,50,25,0.001,2004,20
0.534,0.001,50,54,50,25,0.01,104,1
0.556,0.001,98,106,50,25,0.01,204,1
0.55,0.001,145,159,50,25,0.01,304,1
0.562,0.001,195,209,50,25,0.01,404,1
0.59,0.001,251,253,50,25,0.01,504,1
0.62,0.001,302,302,50,25,0.01,604,1
0.628,0.001,349,355,50,25,0.01,704,1
0.676,0.001,408,396,50,25,0.01,804,1
0.72,0.001,453,451,50,25,0.01,904,1
0.77,0.001,499,505,50,25,0.01,1004,1
0.814,0.001,541,563,50,25,0.01,1104,1
0.874,0.001,585,619,50,25,0.01,1204,1
0.902,0.001,637,667,50,25,0.01,1304,1
0.938,0.001,688,716,50,25,0.01,1404,1
0.944,0.001,745,759,50,25,0.01,1504,1
0.954,0.001,788,816,50,25,0.01,1604,1
0.95,0.001,840,864,50,25,0.01,1704,1
0.96,0.001,893,911,50,25,0.01,1804,1
0.956,0.001,953,951,50,25,0.01,1904,1
0.952,0.001,999,1005,50,25,0.01,2004,1
0.54,0.001,51,53,50,25,0.01,104,2
0.544,0.001,94,110,50,25,0.01,204,2
0.562,0.001,138,166,50,25,0.01,304,2
0.584,0.001,192,212,50,25,0.01,404,2
0.612,0.001,243,261,50,25,0.01,504,2
0.642,0.001,296,308,50,25,0.01,604,2
0.698,0.001,348,356,50,25,0.01,704,2
0.782,0.001,400,404,50,25,0.01,804,2
0.826,0.001,447,457,50,25,0.01,904,2
0.878,0.001,499,505,50,25,0.01,1004,2
0.906,0.001,542,562,50,25,0.01,1104,2
0.938,0.001,595,609,50,25,0.01,1204,2
0.948,0.001,640,664,50,25,0.01,1304,2
0.96,0.001,686,718,50,25,0.01,1404,2
0.964,0.001,741,763,50,25,0.01,1504,2
0.964,0.001,788,816,50,25,0.01,1604,2
0.97,0.001,850,854,50,25,0.01,1704,2
0.968,0.001,905,899,50,25,0.01,1804,2
0.968,0.001,949,955,50,25,0.01,1904,2
0.972,0.001,995,1009,50,25,0.01,2004,2
0.47,0.001,44,60,50,25,0.01,104,3
0.478,0.001,94,110,50,25,0.01,204,3
0.49,0.001,149,155,50,25,0.01,304,3
0.506,0.001,187,217,50,25,0.01,404,3
0.516,0.001,237,267,50,25,0.01,504,3
0.554,0.001,296,308,50,25,0.01,604,3
0.622,0.001,345,359,50,25,0.01,704,3
0.684,0.001,396,408,50,25,0.01,804,3
0.712,0.001,448,456,50,25,0.01,904,3
0.762,0.001,510,494,50,25,0.01,1004,3
0.784,0.001,556,548,50,25,0.01,1104,3
0.866,0.001,608,596,50,25,0.01,1204,3
0.894,0.001,654,650,50,25,0.01,1304,3
0.926,0.001,705,699,50,25,0.01,1404,3
0.948,0.001,752,752,50,25,0.01,1504,3
0.956,0.001,798,806,50,25,0.01,1604,3
0.962,0.001,849,855,50,25,0.01,1704,3
0.974,0.001,900,904,50,25,0.01,1804,3
0.974,0.001,943,961,50,25,0.01,1904,3
0.978,0.001,991,1013,50,25,0.01,2004,3
0.526,0.001,49,55,50,25,0.01,104,4
0.52,0.001,97,107,50,25,0.01,204,4
0.526,0.001,152,152,50,25,0.01,304,4
0.546,0.001,202,202,50,25,0.01,404,4
0.556,0.001,249,255,50,25,0.01,504,4
0.598,0.001,302,302,50,25,0.01,604,4
0.648,0.001,351,353,50,25,0.01,704,4
0.722,0.001,411,393,50,25,0.01,804,4
0.748,0.001,460,444,50,25,0.01,904,4
0.802,0.001,509,495,50,25,0.01,1004,4
0.854,0.001,559,545,50,25,0.01,1104,4
0.906,0.001,612,592,50,25,0.01,1204,4
0.926,0.001,661,643,50,25,0.01,1304,4
0.948,0.001,709,695,50,25,0.01,1404,4
0.968,0.001,765,739,50,25,0.01,1504,4
0.968,0.001,815,789,50,25,0.01,1604,4
0.964,0.001,860,844,50,25,0.01,1704,4
0.964,0.001,913,891,50,25,0.01,1804,4
0.966,0.001,958,946,50,25,0.01,1904,4
0.972,0.001,1009,995,50,25,0.01,2004,4
0.524,0.001,46,58,50,25,0.01,104,5
0.56,0.001,100,104,50,25,0.01,204,5
0.566,0.001,152,152,50,25,0.01,304,5
0.578,0.001,208,196,50,25,0.01,404,5
0.578,0.001,255,249,50,25,0.01,504,5
0.61,0.001,300,304,50,25,0.01,604,5
0.622,0.001,352,352,50,25,0.01,704,5
0.65,0.001,408,396,50,25,0.01,804,5
0.716,0.001,458,446,50,25,0.01,904,5
0.744,0.001,509,495,50,25,0.01,1004,5
0.81,0.001,549,555,50,25,0.01,1104,5
0.868,0.001,597,607,50,25,0.01,1204,5
0.9,0.001,645,659,50,25,0.01,1304,5
0.936,0.001,697,707,50,25,0.01,1404,5
0.944,0.001,760,744,50,25,0.01,1504,5
0.954,0.001,810,794,50,25,0.01,1604,5
0.958,0.001,858,846,50,25,0.01,1704,5
0.958,0.001,914,890,50,25,0.01,1804,5
0.96,0.001,958,946,50,25,0.01,1904,5
0.962,0.001,1008,996,50,25,0.01,2004,5
0.534,0.001,49,55,50,25,0.01,104,6
0.578,0.001,92,112,50,25,0.01,204,6
0.602,0.001,141,163,50,25,0.01,304,6
0.606,0.001,196,208,50,25,0.01,404,6
0.622,0.001,240,264,50,25,0.01,504,6
0.626,0.001,293,311,50,25,0.01,604,6
0.652,0.001,347,357,50,25,0.01,704,6
0.666,0.001,402,402,50,25,0.01,804,6
0.67,0.001,450,454,50,25,0.01,904,6
0.688,0.001,499,505,50,25,0.01,1004,6
0.71,0.001,546,558,50,25,0.01,1104,6
0.798,0.001,594,610,50,25,0.01,1204,6
0.844,0.001,640,664,50,25,0.01,1304,6
0.888,0.001,698,706,50,25,0.01,1404,6
0.912,0.001,751,753,50,25,0.01,1504,6
0.928,0.001,805,799,50,25,0.01,1604,6
0.948,0.001,854,850,50,25,0.01,1704,6
0.96,0.001,907,897,50,25,0.01,1804,6
0.96,0.001,958,946,50,25,0.01,1904,6
0.96,0.001,1012,992,50,25,0.01,2004,6
0.536,0.001,59,45,50,25,0.01,104,7
0.586,0.001,112,92,50,25,0.01,204,7
0.57,0.001,162,142,50,25,0.01,304,7
0.59,0.001,207,197,50,25,0.01,404,7
0.606,0.001,257,247,50,25,0.01,504,7
0.632,0.001,311,293,50,25,0.01,604,7
0.672,0.001,359,345,50,25,0.01,704,7
0.678,0.001,417,387,50,25,0.01,804,7
0.716,0.001,458,446,50,25,0.01,904,7
0.764,0.001,511,493,50,25,0.01,1004,7
0.776,0.001,555,549,50,25,0.01,1104,7
0.852,0.001,596,608,50,25,0.01,1204,7
0.888,0.001,649,655,50,25,0.01,1304,7
0.918,0.001,701,703,50,25,0.01,1404,7
0.924,0.001,754,750,50,25,0.01,1504,7
0.93,0.001,797,807,50,25,0.01,1604,7
0.938,0.001,852,852,50,25,0.01,1704,7
0.942,0.001,902,902,50,25,0.01,1804,7
0.946,0.001,953,951,50,25,0.01,1904,7
0.944,0.001,1006,998,50,25,0.01,2004,7
0.51,0.001,41,63,50,25,0.01,104,8
0.53,0.001,99,105,50,25,0.01,204,8
0.538,0.001,150,154,50,25,0.01,304,8
0.578,0.001,197,207,50,25,0.01,404,8
0.61,0.001,244,260,50,25,0.01,504,8
0.646,0.001,298,306,50,25,0.01,604,8
0.678,0.001,343,361,50,25,0.01,704,8
0.708,0.001,388,416,50,25,0.01,804,8
0.726,0.001,431,473,50,25,0.01,904,8
0.784,0.001,489,515,50,25,0.01,1004,8
0.816,0.001,550,554,50,25,0.01,1104,8
0.87,0.001,604,600,50,25,0.01,1204,8
0.9,0.001,659,645,50,25,0.01,1304,8
0.922,0.001,707,697,50,25,0.01,1404,8
0.934,0.001,750,754,50,25,0.01,1504,8
0.948,0.001,801,803,50,25,0.01,1604,8
0.944,0.001,849,855,50,25,0.01,1704,8
0.944,0.001,905,899,50,25,0.01,1804,8
0.952,0.001,956,948,50,25,0.01,1904,8
0.946,0.001,1004,1000,50,25,0.01,2004,8
0.588,0.001,52,52,50,25,0.01,104,9
0.58,0.001,99,105,50,25,0.01,204,9
0.58,0.001,146,158,50,25,0.01,304,9
0.604,0.001,203,201,50,25,0.01,404,9
0.62,0.001,250,254,50,25,0.01,504,9
0.658,0.001,308,296,50,25,0.01,604,9
0.692,0.001,364,340,50,25,0.01,704,9
0.726,0.001,411,393,50,25,0.01,804,9
0.76,0.001,458,446,50,25,0.01,904,9
0.808,0.001,518,486,50,25,0.01,1004,9
0.856,0.001,575,529,50,25,0.01,1104,9
0.888,0.001,627,577,50,25,0.01,1204,9
0.92,0.001,673,631,50,25,0.01,1304,9
0.942,0.001,731,673,50,25,0.01,1404,9
0.956,0.001,771,733,50,25,0.01,1504,9
0.956,0.001,808,796,50,25,0.01,1604,9
0.954,0.001,855,849,50,25,0.01,1704,9
0.958,0.001,901,903,50,25,0.01,1804,9
0.966,0.001,954,950,50,25,0.01,1904,9
0.97,0.001,998,1006,50,25,0.01,2004,9
0.482,0.001,54,50,50,25,0.01,104,10
0.496,0.001,108,96,50,25,0.01,204,10
0.512,0.001,148,156,50,25,0.01,304,10
0.58,0.001,196,208,50,25,0.01,404,10
0.602,0.001,251,253,50,25,0.01,504,10
0.652,0.001,299,305,50,25,0.01,604,10
0.674,0.001,340,364,50,25,0.01,704,10
0.72,0.001,397,407,50,25,0.01,804,10
0.76,0.001,445,459,50,25,0.01,904,10
0.804,0.001,495,509,50,25,0.01,1004,10
0.844,0.001,552,552,50,25,0.01,1104,10
0.872,0.001,601,603,50,25,0.01,1204,10
0.896,0.001,646,658,50,25,0.01,1304,10
0.912,0.001,697,707,50,25,0.01,1404,10
0.934,0.001,753,751,50,25,0.01,1504,10
0.94,0.001,806,798,50,25,0.01,1604,10
0.95,0.001,869,835,50,25,0.01,1704,10
0.946,0.001,922,882,50,25,0.01,1804,10
0.944,0.001,970,934,50,25,0.01,1904,10
0.95,0.001,1017,987,50,25,0.01,2004,10
0.464,0.001,57,47,50,25,0.01,104,11
0.51,0.001,106,98,50,25,0.01,204,11
0.568,0.001,161,143,50,25,0.01,304,11
0.614,0.001,205,199,50,25,0.01,404,11
0.63,0.001,258,246,50,25,0.01,504,11
0.642,0.001,316,288,50,25,0.01,604,11
0.676,0.001,366,338,50,25,0.01,704,11
0.71,0.001,417,387,50,25,0.01,804,11
0.746,0.001,466,438,50,25,0.01,904,11
0.804,0.001,516,488,50,25,0.01,1004,11
0.826,0.001,565,539,50,25,0.01,1104,11
0.87,0.001,620,584,50,25,0.01,1204,11
0.892,0.001,676,628,50,25,0.01,1304,11
0.924,0.001,726,678,50,25,0.01,1404,11
0.948,0.001,773,731,50,25,0.01,1504,11
0.95,0.001,820,784,50,25,0.01,1604,11
0.952,0.001,869,835,50,25,0.01,1704,11
0.954,0.001,916,888,50,25,0.01,1804,11
0.956,0.001,966,938,50,25,0.01,1904,11
0.954,0.001,1017,987,50,25,0.01,2004,11
0.516,0.001,47,57,50,25,0.01,104,12
0.532,0.001,88,116,50,25,0.01,204,12
0.55,0.001,137,167,50,25,0.01,304,12
0.61,0.001,182,222,50,25,0.01,404,12
0.604,0.001,242,262,50,25,0.01,504,12
0.624,0.001,296,308,50,25,0.01,604,12
0.652,0.001,350,354,50,25,0.01,704,12
0.682,0.001,404,400,50,25,0.01,804,12
0.732,0.001,448,456,50,25,0.01,904,12
0.788,0.001,499,505,50,25,0.01,1004,12
0.816,0.001,546,558,50,25,0.01,1104,12
0.86,0.001,592,612,50,25,0.01,1204,12
0.9,0.001,635,669,50,25,0.01,1304,12
0.936,0.001,681,723,50,25,0.01,1404,12
0.938,0.001,737,767,50,25,0.01,1504,12
0.968,0.001,792,812,50,25,0.01,1604,12
0.974,0.001,839,865,50,25,0.01,1704,12
0.976,0.001,892,912,50,25,0.01,1804,12
0.974,0.001,951,953,50,25,0.01,1904,12
0.984,0.001,1000,1004,50,25,0.01,2004,12
0.53,0.001,54,50,50,25,0.01,104,13
0.592,0.001,101,103,50,25,0.01,204,13
0.634,0.001,152,152,50,25,0.01,304,13
0.664,0.001,210,194,50,25,0.01,404,13
0.686,0.001,255,249,50,25,0.01,504,13
0.702,0.001,300,304,50,25,0.01,604,13
0.71,0.001,361,343,50,25,0.01,704,13
0.77,0.001,417,387,50,25,0.01,804,13
0.814,0.001,468,436,50,25,0.01,904,13
0.852,0.001,516,488,50,25,0.01,1004,13
0.876,0.001,563,541,50,25,0.01,1104,13
0.904,0.001,610,594,50,25,0.01,1204,13
0.93,0.001,661,643,50,25,0.01,1304,13
0.93,0.001,709,695,50,25,0.01,1404,13
0.942,0.001,749,755,50,25,0.01,1504,13
0.954,0.001,799,805,50,25,0.01,1604,13
0.962,0.001,849,855,50,25,0.01,1704,13
0.964,0.001,901,903,50,25,0.01,1804,13
0.964,0.001,944,960,50,25,0.01,1904,13
0.97,0.001,988,1016,50,25,0.01,2004,13
0.536,0.001,46,58,50,25,0.01,104,14
0.572,0.001,90,114,50,25,0.01,204,14
0.578,0.001,143,161,50,25,0.01,304,14
0.618,0.001,194,210,50,25,0.01,404,14
0.642,0.001,247,257,50,25,0.01,504,14
0.674,0.001,300,304,50,25,0.01,604,14
0.688,0.001,354,350,50,25,0.01,704,14
0.728,0.001,398,406,50,25,0.01,804,14
0.778,0.001,454,450,50,25,0.01,904,14
0.822,0.001,500,504,50,25,0.01,1004,14
0.856,0.001,550,554,50,25,0.01,1104,14
0.906,0.001,607,597,50,25,0.01,1204,14
0.928,0.001,665,639,50,25,0.01,1304,14
0.944,0.001,707,697,50,25,0.01,1404,14
0.948,0.001,760,744,50,25,0.01,1504,14
0.956,0.001,805,799,50,25,0.01,1604,14
0.956,0.001,849,855,50,25,0.01,1704,14
0.958,0.001,899,905,50,25,0.01,1804,14
0.956,0.001,957,947,50,25,0.01,1904,14
0.962,0.001,1010,994,50,25,0.01,2004,14
0.512,0.001,50,54,50,25,0.01,104,15
0.576,0.001,102,102,50,25,0.01,204,15
0.606,0.001,152,152,50,25,0.01,304,15
0.622,0.001,202,202,50,25,0.01,404,15
0.652,0.001,254,250,50,25,0.01,504,15
0.68,0.001,301,303,50,25,0.01,604,15
0.696,0.001,336,368,50,25,0.01,704,15
0.718,0.001,382,422,50,25,0.01,804,15
0.738,0.001,430,474,50,25,0.01,904,15
0.762,0.001,486,518,50,25,0.01,1004,15
0.814,0.001,529,575,50,25,0.01,1104,15
0.868,0.001,578,626,50,25,0.01,1204,15
0.9,0.001,632,672,50,25,0.01,1304,15
0.918,0.001,685,719,50,25,0.01,1404,15
0.94,0.001,734,770,50,25,0.01,1504,15
0.95,0.001,774,830,50,25,0.01,1604,15
0.952,0.001,828,876,50,25,0.01,1704,15
0.96,0.001,871,933,50,25,0.01,1804,15
0.962,0.001,928,976,50,25,0.01,1904,15
0.972,0.001,993,1011,50,25,0.01,2004,15
0.532,0.001,50,54,50,25,0.01,104,16
0.562,0.001,99,105,50,25,0.01,204,16
0.576,0.001,143,161,50,25,0.01,304,16
0.622,0.001,188,216,50,25,0.01,404,16
0.65,0.001,247,257,50,25,0.01,504,16
0.686,0.001,294,310,50,25,0.01,604,16
0.728,0.001,334,370,50,25,0.01,704,16
0.768,0.001,387,417,50,25,0.01,804,16
0.814,0.001,435,469,50,25,0.01,904,16
0.86,0.001,484,520,50,25,0.01,1004,16
0.87,0.001,528,576,50,25,0.01,1104,16
0.908,0.001,580,624,50,25,0.01,1204,16
0.924,0.001,629,675,50,25,0.01,1304,16
0.944,0.001,684,720,50,25,0.01,1404,16
0.938,0.001,735,769,50,25,0.01,1504,16
0.948,0.001,777,827,50,25,0.01,1604,16
0.954,0.001,823,881,50,25,0.01,1704,16
0.956,0.001,880,924,50,25,0.01,1804,16
0.96,0.001,944,960,50,25,0.01,1904,16
0.964,0.001,989,1015,50,25,0.01,2004,16
0.504,0.001,47,57,50,25,0.01,104,17
0.518,0.001,102,102,50,25,0.01,204,17
0.532,0.001,151,153,50,25,0.01,304,17
0.526,0.001,185,219,50,25,0.01,404,17
0.526,0.001,240,264,50,25,0.01,504,17
0.56,0.001,287,317,50,25,0.01,604,17
0.62,0.001,342,362,50,25,0.01,704,17
0.656,0.001,393,411,50,25,0.01,804,17
0.722,0.001,443,461,50,25,0.01,904,17
0.776,0.001,488,516,50,25,0.01,1004,17
0.808,0.001,544,560,50,25,0.01,1104,17
0.854,0.001,605,599,50,25,0.01,1204,17
0.902,0.001,662,642,50,25,0.01,1304,17
0.92,0.001,716,688,50,25,0.01,1404,17
0.928,0.001,765,739,50,25,0.01,1504,17
0.926,0.001,818,786,50,25,0.01,1604,17
0.938,0.001,867,837,50,25,0.01,1704,17
0.944,0.001,911,893,50,25,0.01,1804,17
0.958,0.001,964,940,50,25,0.01,1904,17
0.948,0.001,1014,990,50,25,0.01,2004,17
0.528,0.001,49,55,50,25,0.01,104,18
0.538,0.001,98,106,50,25,0.01,204,18
0.546,0.001,156,148,50,25,0.01,304,18
0.576,0.001,210,194,50,25,0.01,404,18
0.622,0.001,264,240,50,25,0.01,504,18
0.658,0.001,312,292,50,25,0.01,604,18
0.672,0.001,369,335,50,25,0.01,704,18
0.706,0.001,417,387,50,25,0.01,804,18
0.738,0.001,467,437,50,25,0.01,904,18
0.81,0.001,515,489,50,25,0.01,1004,18
0.832,0.001,559,545,50,25,0.01,1104,18
0.874,0.001,604,600,50,25,0.01,1204,18
0.892,0.001,650,654,50,25,0.01,1304,18
0.926,0.001,698,706,50,25,0.01,1404,18
0.94,0.001,758,746,50,25,0.01,1504,18
0.948,0.001,814,790,50,25,0.01,1604,18
0.948,0.001,868,836,50,25,0.01,1704,18
0.956,0.001,914,890,50,25,0.01,1804,18
0.954,0.001,958,946,50,25,0.01,1904,18
0.954,0.001,1008,996,50,25,0.01,2004,18
0.496,0.001,57,47,50,25,0.01,104,19
0.51,0.001,101,103,50,25,0.01,204,19
0.512,0.001,149,155,50,25,0.01,304,19
0.532,0.001,209,195,50,25,0.01,404,19
0.53,0.001,257,247,50,25,0.01,504,19
0.568,0.001,307,297,50,25,0.01,604,19
0.604,0.001,362,342,50,25,0.01,704,19
0.65,0.001,408,396,50,25,0.01,804,19
0.69,0.001,454,450,50,25,0.01,904,19
0.746,0.001,508,496,50,25,0.01,1004,19
0.788,0.001,558,546,50,25,0.01,1104,19
0.85,0.001,598,606,50,25,0.01,1204,19
0.878,0.001,645,659,50,25,0.01,1304,19
0.916,0.001,692,712,50,25,0.01,1404,19
0.932,0.001,741,763,50,25,0.01,1504,19
0.938,0.001,792,812,50,25,0.01,1604,19
0.95,0.001,845,859,50,25,0.01,1704,19
0.954,0.001,892,912,50,25,0.01,1804,19
0.954,0.001,944,960,50,25,0.01,1904,19
0.958,0.001,996,1008,50,25,0.01,2004,19
0.522,0.001,57,47,50,25,0.01,104,20
0.558,0.001,101,103,50,25,0.01,204,20
0.582,0.001,146,158,50,25,0.01,304,20
0.608,0.001,194,210,50,25,0.01,404,20
0.632,0.001,241,263,50,25,0.01,504,20
0.686,0.001,304,300,50,25,0.01,604,20
0.75,0.001,356,348,50,25,0.01,704,20
0.792,0.001,411,393,50,25,0.01,804,20
0.826,0.001,454,450,50,25,0.01,904,20
0.854,0.001,504,500,50,25,0.01,1004,20
0.89,0.001,549,555,50,25,0.01,1104,20
0.922,0.001,592,612,50,25,0.01,1204,20
0.934,0.001,648,656,50,25,0.01,1304,20
0.946,0.001,698,706,50,25,0.01,1404,20
0.954,0.001,748,756,50,25,0.01,1504,20
0.958,0.001,796,808,50,25,0.01,1604,20
0.962,0.001,843,861,50,25,0.01,1704,20
0.97,0.001,899,905,50,25,0.01,1804,20
0.968,0.001,945,959,50,25,0.01,1904,20
0.97,0.001,992,1012,50,25,0.01,2004,20
0.508,1e-05,59,45,50,50,0.0001,104,1
0.508,1e-05,109,95,50,50,0.0001,204,1
0.504,1e-05,163,141,50,50,0.0001,304,1
0.508,1e-05,213,191,50,50,0.0001,404,1
0.51,1e-05,257,247,50,50,0.0001,504,1
0.512,1e-05,302,302,50,50,0.0001,604,1
0.512,1e-05,347,357,50,50,0.0001,704,1
0.516,1e-05,399,405,50,50,0.0001,804,1
0.518,1e-05,454,450,50,50,0.0001,904,1
0.516,1e-05,501,503,50,50,0.0001,1004,1
0.518,1e-05,548,556,50,50,0.0001,1104,1
0.518,1e-05,601,603,50,50,0.0001,1204,1
0.514,1e-05,646,658,50,50,0.0001,1304,1
0.512,1e-05,700,704,50,50,0.0001,1404,1
0.514,1e-05,746,758,50,50,0.0001,1504,1
0.514,1e-05,791,813,50,50,0.0001,1604,1
0.516,1e-05,847,857,50,50,0.0001,1704,1
0.52,1e-05,902,902,50,50,0.0001,1804,1
0.518,1e-05,955,949,50,50,0.0001,1904,1
0.522,1e-05,1002,1002,50,50,0.0001,2004,1
0.522,1e-05,46,58,50,50,0.0001,104,2
0.518,1e-05,105,99,50,50,0.0001,204,2
0.518,1e-05,142,162,50,50,0.0001,304,2
0.518,1e-05,197,207,50,50,0.0001,404,2
0.518,1e-05,254,250,50,50,0.0001,504,2
0.518,1e-05,303,301,50,50,0.0001,604,2
0.518,1e-05,348,356,50,50,0.0001,704,2
0.52,1e-05,400,404,50,50,0.0001,804,2
0.52,1e-05,453,451,50,50,0.0001,904,2
0.52,1e-05,511,493,50,50,0.0001,1004,2
0.524,1e-05,563,541,50,50,0.0001,1104,2
0.52,1e-05,609,595,50,50,0.0001,1204,2
0.522,1e-05,657,647,50,50,0.0001,1304,2
0.528,1e-05,705,699,50,50,0.0001,1404,2
0.528,1e-05,748,756,50,50,0.0001,1504,2
0.522,1e-05,806,798,50,50,0.0001,1604,2
0.526,1e-05,852,852,50,50,0.0001,1704,2
0.528,1e-05,906,898,50,50,0.0001,1804,2
0.532,1e-05,958,946,50,50,0.0001,1904,2
0.534,1e-05,1009,995,50,50,0.0001,2004,2
0.468,1e-05,59,45,50,50,0.0001,104,3
0.468,1e-05,115,89,50,50,0.0001,204,3
0.468,1e-05,167,137,50,50,0.0001,304,3
0.47,1e-05,218,186,50,50,0.0001,404,3
0.47,1e-05,275,229,50,50,0.0001,504,3
0.47,1e-05,326,278,50,50,0.0001,604,3
0.472,1e-05,380,324,50,50,0.0001,704,3
0.472,1e-05,435,369,50,50,0.0001,804,3
0.472,1e-05,485,419,50,50,0.0001,904,3
0.476,1e-05,534,470,50,50,0.0001,1004,3
0.48,1e-05,585,519,50,50,0.0001,1104,3
0.482,1e-05,632,572,50,50,0.0001,1204,3
0.482,1e-05,683,621,50,50,0.0001,1304,3
0.48,1e-05,732,672,50,50,0.0001,1404,3
0.482,1e-05,776,728,50,50,0.0001,1504,3
0.49,1e-05,826,778,50,50,0.0001,1604,3
0.496,1e-05,870,834,50,50,0.0001,1704,3
0.5,1e-05,916,888,50,50,0.0001,1804,3
0.502,1e-05,966,938,50,50,0.0001,1904,3
0.504,1e-05,1010,994,50,50,0.0001,2004,3
0.506,1e-05,53,51,50,50,0.0001,104,4
0.506,1e-05,94,110,50,50,0.0001,204,4
0.506,1e-05,143,161,50,50,0.0001,304,4
0.512,1e-05,189,215,50,50,0.0001,404,4
0.512,1e-05,233,271,50,50,0.0001,504,4
0.512,1e-05,277,327,50,50,0.0001,604,4
0.516,1e-05,330,374,50,50,0.0001,704,4
0.516,1e-05,381,423,50,50,0.0001,804,4
0.518,1e-05,435,469,50,50,0.0001,904,4
0.522,1e-05,487,517,50,50,0.0001,1004,4
0.526,1e-05,537,567,50,50,0.0001,1104,4
0.526,1e-05,586,618,50,50,0.0001,1204,4
0.524,1e-05,632,672,50,50,0.0001,1304,4
0.528,1e-05,680,724,50,50,0.0001,1404,4
0.526,1e-05,728,776,50,50,0.0001,1504,4
0.524,1e-05,782,822,50,50,0.0001,1604,4
0.524,1e-05,846,858,50,50,0.0001,1704,4
0.518,1e-05,891,913,50,50,0.0001,1804,4
0.52,1e-05,936,968,50,50,0.0001,1904,4
0.522,1e-05,986,1018,50,50,0.0001,2004,4
0.502,1e-05,57,47,50,50,0.0001,104,5
0.506,1e-05,115,89,50,50,0.0001,204,5
0.506,1e-05,164,140,50,50,0.0001,304,5
0.506,1e-05,212,192,50,50,0.0001,404,5
0.51,1e-05,261,243,50,50,0.0001,504,5
0.512,1e-05,313,291,50,50,0.0001,604,5
0.514,1e-05,354,350,50,50,0.0001,704,5
0.51,1e-05,407,397,50,50,0.0001,804,5
0.512,1e-05,463,441,50,50,0.0001,904,5
0.514,1e-05,509,495,50,50,0.0001,1004,5
0.516,1e-05,553,551,50,50,0.0001,1104,5
0.518,1e-05,596,608,50,50,0.0001,1204,5
0.52,1e-05,649,655,50,50,0.0001,1304,5
0.52,1e-05,690,714,50,50,0.0001,1404,5
0.524,1e-05,745,759,50,50,0.0001,1504,5
0.524,1e-05,797,807,50,50,0.0001,1604,5
0.528,1e-05,852,852,50,50,0.0001,1704,5
0.524,1e-05,903,901,50,50,0.0001,1804,5
0.524,1e-05,951,953,50,50,0.0001,1904,5
0.53,1e-05,1003,1001,50,50,0.0001,2004,5
0.492,1e-05,50,54,50,50,0.0001,104,6
0.49,1e-05,101,103,50,50,0.0001,204,6
0.49,1e-05,147,157,50,50,0.0001,304,6
0.49,1e-05,193,211,50,50,0.0001,404,6
0.492,1e-05,241,263,50,50,0.0001,504,6
0.492,1e-05,293,311,50,50,0.0001,604,6
0.488,1e-05,347,357,50,50,0.0001,704,6
0.49,1e-05,405,399,50,50,0.0001,804,6
0.494,1e-05,454,450,50,50,0.0001,904,6
0.496,1e-05,510,494,50,50,0.0001,1004,6
0.498,1e-05,561,543,50,50,0.0001,1104,6
0.498,1e-05,615,589,50,50,0.0001,1204,6
0.498,1e-05,663,641,50,50,0.0001,1304,6
0.5,1e-05,703,701,50,50,0.0001,1404,6
0.5,1e-05,762,742,50,50,0.0001,1504,6
0.496,1e-05,803,801,50,50,0.0001,1604,6
0.496,1e-05,842,862,50,50,0.0001,1704,6
0.496,1e-05,900,904,50,50,0.0001,1804,6
0.496,1e-05,957,947,50,50,0.0001,1904,6
0.502,1e-05,1010,994,50,50,0.0001,2004,6
0.512,1e-05,41,63,50,50,0.0001,104,7
0.512,1e-05,96,108,50,50,0.0001,204,7
0.512,1e-05,143,161,50,50,0.0001,304,7
0.512,1e-05,195,209,50,50,0.0001,404,7
0.512,1e-05,248,256,50,50,0.0001,504,7
0.512,1e-05,300,304,50,50,0.0001,604,7
0.51,1e-05,356,348,50,50,0.0001,704,7
0.512,1e-05,405,399,50,50,0.0001,804,7
0.516,1e-05,452,452,50,50,0.0001,904,7
0.516,1e-05,500,504,50,50,0.0001,1004,7
0.516,1e-05,557,547,50,50,0.0001,1104,7
0.514,1e-05,613,591,50,50,0.0001,1204,7
0.514,1e-05,656,648,50,50,0.0001,1304,7
0.516,1e-05,701,703,50,50,0.0001,1404,7
0.518,1e-05,758,746,50,50,0.0001,1504,7
0.52,1e-05,804,800,50,50,0.0001,1604,7
0.52,1e-05,855,849,50,50,0.0001,1704,7
0.522,1e-05,909,895,50,50,0.0001,1804,7
0.526,1e-05,948,956,50,50,0.0001,1904,7
0.524,1e-05,1000,1004,50,50,0.0001,2004,7
0.546,1e-05,58,46,50,50,0.0001,104,8
0.546,1e-05,105,99,50,50,0.0001,204,8
0.546,1e-05,155,149,50,50,0.0001,304,8
0.544,1e-05,205,199,50,50,0.0001,404,8
0.542,1e-05,250,254,50,50,0.0001,504,8
0.542,1e-05,309,295,50,50,0.0001,604,8
0.54,1e-05,362,342,50,50,0.0001,704,8
0.54,1e-05,412,392,50,50,0.0001,804,8
0.544,1e-05,460,444,50,50,0.0001,904,8
0.55,1e-05,502,502,50,50,0.0001,1004,8
0.55,1e-05,542,562,50,50,0.0001,1104,8
0.546,1e-05,596,608,50,50,0.0001,1204,8
0.548,1e-05,648,656,50,50,0.0001,1304,8
0.55,1e-05,702,702,50,50,0.0001,1404,8
0.55,1e-05,749,755,50,50,0.0001,1504,8
0.554,1e-05,799,805,50,50,0.0001,1604,8
0.552,1e-05,849,855,50,50,0.0001,1704,8
0.554,1e-05,893,911,50,50,0.0001,1804,8
0.556,1e-05,945,959,50,50,0.0001,1904,8
0.568,1e-05,990,1014,50,50,0.0001,2004,8
0.512,1e-05,45,59,50,50,0.0001,104,9
0.512,1e-05,98,106,50,50,0.0001,204,9
0.51,1e-05,146,158,50,50,0.0001,304,9
0.51,1e-05,196,208,50,50,0.0001,404,9
0.51,1e-05,242,262,50,50,0.0001,504,9
0.51,1e-05,291,313,50,50,0.0001,604,9
0.512,1e-05,343,361,50,50,0.0001,704,9
0.516,1e-05,402,402,50,50,0.0001,804,9
0.52,1e-05,450,454,50,50,0.0001,904,9
0.522,1e-05,495,509,50,50,0.0001,1004,9
0.526,1e-05,546,558,50,50,0.0001,1104,9
0.522,1e-05,592,612,50,50,0.0001,1204,9
0.52,1e-05,639,665,50,50,0.0001,1304,9
0.52,1e-05,694,710,50,50,0.0001,1404,9
0.528,1e-05,737,767,50,50,0.0001,1504,9
0.53,1e-05,782,822,50,50,0.0001,1604,9
0.53,1e-05,843,861,50,50,0.0001,1704,9
0.53,1e-05,897,907,50,50,0.0001,1804,9
0.53,1e-05,950,954,50,50,0.0001,1904,9
0.536,1e-05,1001,1003,50,50,0.0001,2004,9
0.528,1e-05,59,45,50,50,0.0001,104,10
0.528,1e-05,100,104,50,50,0.0001,204,10
0.528,1e-05,146,158,50,50,0.0001,304,10
0.532,1e-05,193,211,50,50,0.0001,404,10
0.528,1e-05,250,254,50,50,0.0001,504,10
0.526,1e-05,299,305,50,50,0.0001,604,10
0.526,1e-05,353,351,50,50,0.0001,704,10
0.528,1e-05,410,394,50,50,0.0001,804,10
0.528,1e-05,464,440,50,50,0.0001,904,10
0.528,1e-05,511,493,50,50,0.0001,1004,10
0.526,1e-05,564,540,50,50,0.0001,1104,10
0.53,1e-05,614,590,50,50,0.0001,1204,10
0.536,1e-05,659,645,50,50,0.0001,1304,10
0.538,1e-05,707,697,50,50,0.0001,1404,10
0.538,1e-05,752,752,50,50,0.0001,1504,10
0.542,1e-05,790,814,50,50,0.0001,1604,10
0.542,1e-05,838,866,50,50,0.0001,1704,10
0.55,1e-05,889,915,50,50,0.0001,1804,10
0.558,1e-05,940,964,50,50,0.0001,1904,10
0.562,1e-05,992,1012,50,50,0.0001,2004,10
0.422,1e-05,57,47,50,50,0.0001,104,11
0.422,1e-05,110,94,50,50,0.0001,204,11
0.422,1e-05,169,135,50,50,0.0001,304,11
0.424,1e-05,218,186,50,50,0.0001,404,11
0.42,1e-05,274,230,50,50,0.0001,504,11
0.422,1e-05,323,281,50,50,0.0001,604,11
0.42,1e-05,371,333,50,50,0.0001,704,11
0.42,1e-05,422,382,50,50,0.0001,804,11
0.424,1e-05,473,431,50,50,0.0001,904,11
0.424,1e-05,530,474,50,50,0.0001,1004,11
0.43,1e-05,584,520,50,50,0.0001,1104,11
0.434,1e-05,626,578,50,50,0.0001,1204,11
0.428,1e-05,683,621,50,50,0.0001,1304,11
0.43,1e-05,734,670,50,50,0.0001,1404,11
0.43,1e-05,781,723,50,50,0.0001,1504,11
0.434,1e-05,821,783,50,50,0.0001,1604,11
0.436,1e-05,874,830,50,50,0.0001,1704,11
0.436,1e-05,923,881,50,50,0.0001,1804,11
0.44,1e-05,973,931,50,50,0.0001,1904,11
0.446,1e-05,1028,976,50,50,0.0001,2004,11
0.516,1e-05,47,57,50,50,0.0001,104,12
0.516,1e-05,93,111,50,50,0.0001,204,12
0.518,1e-05,142,162,50,50,0.0001,304,12
0.516,1e-05,190,214,50,50,0.0001,404,12
0.516,1e-05,240,264,50,50,0.0001,504,12
0.516,1e-05,285,319,50,50,0.0001,604,12
0.516,1e-05,338,366,50,50,0.0001,704,12
0.512,1e-05,391,413,50,50,0.0001,804,12
0.512,1e-05,433,471,50,50,0.0001,904,12
0.516,1e-05,485,519,50,50,0.0001,1004,12
0.518,1e-05,533,571,50,50,0.0001,1104,12
0.52,1e-05,581,623,50,50,0.0001,1204,12
0.524,1e-05,634,670,50,50,0.0001,1304,12
0.526,1e-05,686,718,50,50,0.0001,1404,12
0.526,1e-05,734,770,50,50,0.0001,1504,12
0.528,1e-05,789,815,50,50,0.0001,1604,12
0.528,1e-05,843,861,50,50,0.0001,1704,12
0.528,1e-05,889,915,50,50,0.0001,1804,12
0.53,1e-05,941,963,50,50,0.0001,1904,12
0.532,1e-05,993,1011,50,50,0.0001,2004,12
0.484,1e-05,42,62,50,50,0.0001,104,13
0.484,1e-05,92,112,50,50,0.0001,204,13
0.484,1e-05,149,155,50,50,0.0001,304,13
0.484,1e-05,195,209,50,50,0.0001,404,13
0.484,1e-05,244,260,50,50,0.0001,504,13
0.486,1e-05,289,315,50,50,0.0001,604,13
0.488,1e-05,333,371,50,50,0.0001,704,13
0.492,1e-05,380,424,50,50,0.0001,804,13
0.496,1e-05,433,471,50,50,0.0001,904,13
0.496,1e-05,483,521,50,50,0.0001,1004,13
0.498,1e-05,533,571,50,50,0.0001,1104,13
0.502,1e-05,585,619,50,50,0.0001,1204,13
0.504,1e-05,641,663,50,50,0.0001,1304,13
0.504,1e-05,696,708,50,50,0.0001,1404,13
0.506,1e-05,743,761,50,50,0.0001,1504,13
0.51,1e-05,784,820,50,50,0.0001,1604,13
0.514,1e-05,829,875,50,50,0.0001,1704,13
0.512,1e-05,874,930,50,50,0.0001,1804,13
0.518,1e-05,926,978,50,50,0.0001,1904,13
0.52,1e-05,978,1026,50,50,0.0001,2004,13
0.516,1e-05,53,51,50,50,0.0001,104,14
0.516,1e-05,95,109,50,50,0.0001,204,14
0.516,1e-05,142,162,50,50,0.0001,304,14
0.518,1e-05,192,212,50,50,0.0001,404,14
0.518,1e-05,235,269,50,50,0.0001,504,14
0.518,1e-05,282,322,50,50,0.0001,604,14
0.518,1e-05,331,373,50,50,0.0001,704,14
0.518,1e-05,379,425,50,50,0.0001,804,14
0.518,1e-05,431,473,50,50,0.0001,904,14
0.518,1e-05,488,516,50,50,0.0001,1004,14
0.522,1e-05,545,559,50,50,0.0001,1104,14
0.522,1e-05,595,609,50,50,0.0001,1204,14
0.522,1e-05,646,658,50,50,0.0001,1304,14
0.52,1e-05,702,702,50,50,0.0001,1404,14
0.522,1e-05,763,741,50,50,0.0001,1504,14
0.524,1e-05,816,788,50,50,0.0001,1604,14
0.524,1e-05,863,841,50,50,0.0001,1704,14
0.524,1e-05,911,893,50,50,0.0001,1804,14
0.526,1e-05,964,940,50,50,0.0001,1904,14
0.526,1e-05,1014,990,50,50,0.0001,2004,14
0.544,1e-05,42,62,50,50,0.0001,104,15
0.542,1e-05,89,115,50,50,0.0001,204,15
0.542,1e-05,147,157,50,50,0.0001,304,15
0.542,1e-05,196,208,50,50,0.0001,404,15
0.544,1e-05,254,250,50,50,0.0001,504,15
0.544,1e-05,297,307,50,50,0.0001,604,15
0.546,1e-05,348,356,50,50,0.0001,704,15
0.546,1e-05,395,409,50,50,0.0001,804,15
0.552,1e-05,451,453,50,50,0.0001,904,15
0.552,1e-05,508,496,50,50,0.0001,1004,15
0.554,1e-05,553,551,50,50,0.0001,1104,15
0.554,1e-05,605,599,50,50,0.0001,1204,15
0.556,1e-05,651,653,50,50,0.0001,1304,15
0.558,1e-05,700,704,50,50,0.0001,1404,15
0.558,1e-05,741,763,50,50,0.0001,1504,15
0.564,1e-05,787,817,50,50,0.0001,1604,15
0.566,1e-05,837,867,50,50,0.0001,1704,15
0.572,1e-05,896,908,50,50,0.0001,1804,15
0.58,1e-05,950,954,50,50,0.0001,1904,15
0.58,1e-05,989,1015,50,50,0.0001,2004,15
0.534,1e-05,63,41,50,50,0.0001,104,16
0.532,1e-05,115,89,50,50,0.0001,204,16
0.532,1e-05,164,140,50,50,0.0001,304,16
0.532,1e-05,219,185,50,50,0.0001,404,16
0.53,1e-05,270,234,50,50,0.0001,504,16
0.532,1e-05,317,287,50,50,0.0001,604,16
0.532,1e-05,374,330,50,50,0.0001,704,16
0.534,1e-05,425,379,50,50,0.0001,804,16
0.532,1e-05,468,436,50,50,0.0001,904,16
0.534,1e-05,511,493,50,50,0.0001,1004,16
0.536,1e-05,560,544,50,50,0.0001,1104,16
0.54,1e-05,603,601,50,50,0.0001,1204,16
0.544,1e-05,645,659,50,50,0.0001,1304,16
0.542,1e-05,695,709,50,50,0.0001,1404,16
0.548,1e-05,745,759,50,50,0.0001,1504,16
0.55,1e-05,798,806,50,50,0.0001,1604,16
0.55,1e-05,862,842,50,50,0.0001,1704,16
0.558,1e-05,907,897,50,50,0.0001,1804,16
0.562,1e-05,953,951,50,50,0.0001,1904,16
0.562,1e-05,1003,1001,50,50,0.0001,2004,16
0.554,1e-05,51,53,50,50,0.0001,104,17
0.556,1e-05,100,104,50,50,0.0001,204,17
0.558,1e-05,156,148,50,50,0.0001,304,17
0.558,1e-05,203,201,50,50,0.0001,404,17
0.556,1e-05,250,254,50,50,0.0001,504,17
0.558,1e-05,303,301,50,50,0.0001,604,17
0.558,1e-05,355,349,50,50,0.0001,704,17
0.562,1e-05,406,398,50,50,0.0001,804,17
0.56,1e-05,446,458,50,50,0.0001,904,17
0.564,1e-05,489,515,50,50,0.0001,1004,17
0.57,1e-05,546,558,50,50,0.0001,1104,17
0.568,1e-05,594,610,50,50,0.0001,1204,17
0.572,1e-05,635,669,50,50,0.0001,1304,17
0.574,1e-05,684,720,50,50,0.0001,1404,17
0.582,1e-05,741,763,50,50,0.0001,1504,17
0.58,1e-05,785,819,50,50,0.0001,1604,17
0.582,1e-05,841,863,50,50,0.0001,1704,17
0.582,1e-05,892,912,50,50,0.0001,1804,17
0.586,1e-05,946,958,50,50,0.0001,1904,17
0.59,1e-05,998,1006,50,50,0.0001,2004,17
0.502,1e-05,53,51,50,50,0.0001,104,18
0.506,1e-05,107,97,50,50,0.0001,204,18
0.504,1e-05,167,137,50,50,0.0001,304,18
0.504,1e-05,216,188,50,50,0.0001,404,18
0.504,1e-05,271,233,50,50,0.0001,504,18
0.504,1e-05,324,280,50,50,0.0001,604,18
0.506,1e-05,372,332,50,50,0.0001,704,18
0.508,1e-05,420,384,50,50,0.0001,804,18
0.508,1e-05,469,435,50,50,0.0001,904,18
0.51,1e-05,517,487,50,50,0.0001,1004,18
0.51,1e-05,571,533,50,50,0.0001,1104,18
0.51,1e-05,612,592,50,50,0.0001,1204,18
0.516,1e-05,665,639,50,50,0.0001,1304,18
0.518,1e-05,702,702,50,50,0.0001,1404,18
0.516,1e-05,753,751,50,50,0.0001,1504,18
0.518,1e-05,804,800,50,50,0.0001,1604,18
0.524,1e-05,864,840,50,50,0.0001,1704,18
0.526,1e-05,915,889,50,50,0.0001,1804,18
0.53,1e-05,955,949,50,50,0.0001,1904,18
0.53,1e-05,1005,999,50,50,0.0001,2004,18
0.518,1e-05,57,47,50,50,0.0001,104,19
0.518,1e-05,106,98,50,50,0.0001,204,19
0.518,1e-05,154,150,50,50,0.0001,304,19
0.516,1e-05,200,204,50,50,0.0001,404,19
0.516,1e-05,256,248,50,50,0.0001,504,19
0.516,1e-05,301,303,50,50,0.0001,604,19
0.518,1e-05,353,351,50,50,0.0001,704,19
0.524,1e-05,416,388,50,50,0.0001,804,19
0.526,1e-05,461,443,50,50,0.0001,904,19
0.53,1e-05,507,497,50,50,0.0001,1004,19
0.53,1e-05,551,553,50,50,0.0001,1104,19
0.526,1e-05,603,601,50,50,0.0001,1204,19
0.526,1e-05,649,655,50,50,0.0001,1304,19
0.526,1e-05,697,707,50,50,0.0001,1404,19
0.526,1e-05,755,749,50,50,0.0001,1504,19
0.528,1e-05,796,808,50,50,0.0001,1604,19
0.536,1e-05,849,855,50,50,0.0001,1704,19
0.536,1e-05,904,900,50,50,0.0001,1804,19
0.538,1e-05,957,947,50,50,0.0001,1904,19
0.538,1e-05,1007,997,50,50,0.0001,2004,19
0.51,1e-05,54,50,50,50,0.0001,104,20
0.51,1e-05,111,93,50,50,0.0001,204,20
0.51,1e-05,160,144,50,50,0.0001,304,20
0.51,1e-05,202,202,50,50,0.0001,404,20
0.508,1e-05,246,258,50,50,0.0001,504,20
0.51,1e-05,293,311,50,50,0.0001,604,20
0.51,1e-05,348,356,50,50,0.0001,704,20
0.51,1e-05,399,405,50,50,0.0001,804,20
0.51,1e-05,453,451,50,50,0.0001,904,20
0.514,1e-05,506,498,50,50,0.0001,1004,20
0.514,1e-05,556,548,50,50,0.0001,1104,20
0.516,1e-05,609,595,50,50,0.0001,1204,20
0.514,1e-05,658,646,50,50,0.0001,1304,20
0.514,1e-05,699,705,50,50,0.0001,1404,20
0.514,1e-05,747,757,50,50,0.0001,1504,20
0.514,1e-05,797,807,50,50,0.0001,1604,20
0.518,1e-05,851,853,50,50,0.0001,1704,20
0.524,1e-05,900,904,50,50,0.0001,1804,20
0.524,1e-05,952,952,50,50,0.0001,1904,20
0.52,1e-05,1004,1000,50,50,0.0001,2004,20
0.478,1e-05,49,55,50,50,0.001,104,1
0.476,1e-05,100,104,50,50,0.001,204,1
0.482,1e-05,154,150,50,50,0.001,304,1
0.48,1e-05,215,189,50,50,0.001,404,1
0.498,1e-05,259,245,50,50,0.001,504,1
0.502,1e-05,309,295,50,50,0.001,604,1
0.508,1e-05,359,345,50,50,0.001,704,1
0.524,1e-05,407,397,50,50,0.001,804,1
0.544,1e-05,458,446,50,50,0.001,904,1
0.57,1e-05,505,499,50,50,0.001,1004,1
0.584,1e-05,556,548,50,50,0.001,1104,1
0.598,1e-05,603,601,50,50,0.001,1204,1
0.622,1e-05,648,656,50,50,0.001,1304,1
0.646,1e-05,700,704,50,50,0.001,1404,1
0.666,1e-05,744,760,50,50,0.001,1504,1
0.698,1e-05,793,811,50,50,0.001,1604,1
0.716,1e-05,846,858,50,50,0.001,1704,1
0.726,1e-05,904,900,50,50,0.001,1804,1
0.74,1e-05,953,951,50,50,0.001,1904,1
0.76,1e-05,1005,999,50,50,0.001,2004,1
0.454,1e-05,60,44,50,50,0.001,104,2
0.458,1e-05,100,104,50,50,0.001,204,2
0.466,1e-05,146,158,50,50,0.001,304,2
0.486,1e-05,207,197,50,50,0.001,404,2
0.476,1e-05,262,242,50,50,0.001,504,2
0.484,1e-05,303,301,50,50,0.001,604,2
0.484,1e-05,355,349,50,50,0.001,704,2
0.498,1e-05,409,395,50,50,0.001,804,2
0.504,1e-05,464,440,50,50,0.001,904,2
0.514,1e-05,511,493,50,50,0.001,1004,2
0.54,1e-05,558,546,50,50,0.001,1104,2
0.572,1e-05,611,593,50,50,0.001,1204,2
0.602,1e-05,653,651,50,50,0.001,1304,2
0.612,1e-05,703,701,50,50,0.001,1404,2
0.632,1e-05,755,749,50,50,0.001,1504,2
0.664,1e-05,810,794,50,50,0.001,1604,2
0.68,1e-05,860,844,50,50,0.001,1704,2
0.698,1e-05,904,900,50,50,0.001,1804,2
0.724,1e-05,954,950,50,50,0.001,1904,2
0.746,1e-05,1008,996,50,50,0.001,2004,2
0.504,1e-05,49,55,50,50,0.001,104,3
0.496,1e-05,105,99,50,50,0.001,204,3
0.494,1e-05,162,142,50,50,0.001,304,3
0.5,1e-05,208,196,50,50,0.001,404,3
0.508,1e-05,260,244,50,50,0.001,504,3
0.514,1e-05,311,293,50,50,0.001,604,3
0.52,1e-05,362,342,50,50,0.001,704,3
0.526,1e-05,420,384,50,50,0.001,804,3
0.524,1e-05,471,433,50,50,0.001,904,3
0.542,1e-05,515,489,50,50,0.001,1004,3
0.568,1e-05,562,542,50,50,0.001,1104,3
0.57,1e-05,614,590,50,50,0.001,1204,3
0.582,1e-05,663,641,50,50,0.001,1304,3
0.6,1e-05,710,694,50,50,0.001,1404,3
0.622,1e-05,763,741,50,50,0.001,1504,3
0.648,1e-05,811,793,50,50,0.001,1604,3
0.654,1e-05,865,839,50,50,0.001,1704,3
0.682,1e-05,918,886,50,50,0.001,1804,3
0.71,1e-05,960,944,50,50,0.001,1904,3
0.74,1e-05,1010,994,50,50,0.001,2004,3
0.476,1e-05,58,46,50,50,0.001,104,4
0.482,1e-05,111,93,50,50,0.001,204,4
0.496,1e-05,166,138,50,50,0.001,304,4
0.506,1e-05,213,191,50,50,0.001,404,4
0.486,1e-05,256,248,50,50,0.001,504,4
0.49,1e-05,302,302,50,50,0.001,604,4
0.508,1e-05,352,352,50,50,0.001,704,4
0.518,1e-05,405,399,50,50,0.001,804,4
0.536,1e-05,454,450,50,50,0.001,904,4
0.554,1e-05,496,508,50,50,0.001,1004,4
0.572,1e-05,537,567,50,50,0.001,1104,4
0.574,1e-05,584,620,50,50,0.001,1204,4
0.578,1e-05,631,673,50,50,0.001,1304,4
0.6,1e-05,689,715,50,50,0.001,1404,4
0.61,1e-05,735,769,50,50,0.001,1504,4
0.62,1e-05,791,813,50,50,0.001,1604,4
0.638,1e-05,844,860,50,50,0.001,1704,4
0.654,1e-05,896,908,50,50,0.001,1804,4
0.702,1e-05,944,960,50,50,0.001,1904,4
0.726,1e-05,993,1011,50,50,0.001,2004,4
0.526,1e-05,48,56,50,50,0.001,104,5
0.53,1e-05,106,98,50,50,0.001,204,5
0.534,1e-05,150,154,50,50,0.001,304,5
0.548,1e-05,201,203,50,50,0.001,404,5
0.564,1e-05,244,260,50,50,0.001,504,5
0.566,1e-05,302,302,50,50,0.001,604,5
0.576,1e-05,353,351,50,50,0.001,704,5
0.59,1e-05,402,402,50,50,0.001,804,5
0.604,1e-05,454,450,50,50,0.001,904,5
0.618,1e-05,499,505,50,50,0.001,1004,5
0.632,1e-05,546,558,50,50,0.001,1104,5
0.65,1e-05,588,616,50,50,0.001,1204,5
0.642,1e-05,636,668,50,50,0.001,1304,5
0.656,1e-05,686,718,50,50,0.001,1404,5
0.676,1e-05,738,766,50,50,0.001,1504,5
0.694,1e-05,797,807,50,50,0.001,1604,5
0.708,1e-05,849,855,50,50,0.001,1704,5
0.73,1e-05,896,908,50,50,0.001,1804,5
0.748,1e-05,951,953,50,50,0.001,1904,5
0.758,1e-05,994,1010,50,50,0.001,2004,5
0.478,1e-05,49,55,50,50,0.001,104,6
0.482,1e-05,105,99,50,50,0.001,204,6
0.482,1e-05,157,147,50,50,0.001,304,6
0.496,1e-05,206,198,50,50,0.001,404,6
0.504,1e-05,263,241,50,50,0.001,504,6
0.508,1e-05,310,294,50,50,0.001,604,6
0.506,1e-05,357,347,50,50,0.001,704,6
0.524,1e-05,403,401,50,50,0.001,804,6
0.54,1e-05,454,450,50,50,0.001,904,6
0.546,1e-05,498,506,50,50,0.001,1004,6
0.548,1e-05,553,551,50,50,0.001,1104,6
0.556,1e-05,610,594,50,50,0.001,1204,6
0.558,1e-05,662,642,50,50,0.001,1304,6
0.558,1e-05,715,689,50,50,0.001,1404,6
0.57,1e-05,762,742,50,50,0.001,1504,6
0.592,1e-05,803,801,50,50,0.001,1604,6
0.624,1e-05,849,855,50,50,0.001,1704,6
0.662,1e-05,897,907,50,50,0.001,1804,6
0.694,1e-05,951,953,50,50,0.001,1904,6
0.716,1e-05,996,1008,50,50,0.001,2004,6
0.45,1e-05,57,47,50,50,0.001,104,7
0.458,1e-05,105,99,50,50,0.001,204,7
0.462,1e-05,151,153,50,50,0.001,304,7
0.47,1e-05,203,201,50,50,0.001,404,7
0.478,1e-05,250,254,50,50,0.001,504,7
0.484,1e-05,290,314,50,50,0.001,604,7
0.494,1e-05,340,364,50,50,0.001,704,7
0.52,1e-05,391,413,50,50,0.001,804,7
0.542,1e-05,435,469,50,50,0.001,904,7
0.548,1e-05,486,518,50,50,0.001,1004,7
0.556,1e-05,539,565,50,50,0.001,1104,7
0.572,1e-05,583,621,50,50,0.001,1204,7
0.586,1e-05,632,672,50,50,0.001,1304,7
0.624,1e-05,686,718,50,50,0.001,1404,7
0.64,1e-05,743,761,50,50,0.001,1504,7
0.664,1e-05,794,810,50,50,0.001,1604,7
0.682,1e-05,847,857,50,50,0.001,1704,7
0.71,1e-05,895,909,50,50,0.001,1804,7
0.728,1e-05,947,957,50,50,0.001,1904,7
0.746,1e-05,1000,1004,50,50,0.001,2004,7
0.45,1e-05,53,51,50,50,0.001,104,8
0.452,1e-05,101,103,50,50,0.001,204,8
0.456,1e-05,137,167,50,50,0.001,304,8
0.468,1e-05,186,218,50,50,0.001,404,8
0.482,1e-05,243,261,50,50,0.001,504,8
0.492,1e-05,292,312,50,50,0.001,604,8
0.5,1e-05,344,360,50,50,0.001,704,8
0.518,1e-05,395,409,50,50,0.001,804,8
0.544,1e-05,451,453,50,50,0.001,904,8
0.568,1e-05,512,492,50,50,0.001,1004,8
0.584,1e-05,566,538,50,50,0.001,1104,8
0.588,1e-05,628,576,50,50,0.001,1204,8
0.616,1e-05,679,625,50,50,0.001,1304,8
0.65,1e-05,741,663,50,50,0.001,1404,8
0.662,1e-05,792,712,50,50,0.001,1504,8
0.686,1e-05,833,771,50,50,0.001,1604,8
0.706,1e-05,886,818,50,50,0.001,1704,8
0.738,1e-05,939,865,50,50,0.001,1804,8
0.756,1e-05,985,919,50,50,0.001,1904,8
0.768,1e-05,1032,972,50,50,0.001,2004,8
0.5,1e-05,56,48,50,50,0.001,104,9
0.512,1e-05,102,102,50,50,0.001,204,9
0.512,1e-05,150,154,50,50,0.001,304,9
0.514,1e-05,198,206,50,50,0.001,404,9
0.524,1e-05,244,260,50,50,0.001,504,9
0.52,1e-05,291,313,50,50,0.001,604,9
0.53,1e-05,343,361,50,50,0.001,704,9
0.542,1e-05,401,403,50,50,0.001,804,9
0.568,1e-05,454,450,50,50,0.001,904,9
0.588,1e-05,500,504,50,50,0.001,1004,9
0.594,1e-05,547,557,50,50,0.001,1104,9
0.626,1e-05,604,600,50,50,0.001,1204,9
0.648,1e-05,650,654,50,50,0.001,1304,9
0.66,1e-05,701,703,50,50,0.001,1404,9
0.658,1e-05,751,753,50,50,0.001,1504,9
0.684,1e-05,805,799,50,50,0.001,1604,9
0.708,1e-05,848,856,50,50,0.001,1704,9
0.72,1e-05,895,909,50,50,0.001,1804,9
0.752,1e-05,946,958,50,50,0.001,1904,9
0.78,1e-05,997,1007,50,50,0.001,2004,9
0.464,1e-05,55,49,50,50,0.001,104,10
0.458,1e-05,105,99,50,50,0.001,204,10
0.464,1e-05,154,150,50,50,0.001,304,10
0.472,1e-05,196,208,50,50,0.001,404,10
0.47,1e-05,257,247,50,50,0.001,504,10
0.486,1e-05,301,303,50,50,0.001,604,10
0.49,1e-05,351,353,50,50,0.001,704,10
0.506,1e-05,412,392,50,50,0.001,804,10
0.514,1e-05,463,441,50,50,0.001,904,10
0.53,1e-05,515,489,50,50,0.001,1004,10
0.538,1e-05,555,549,50,50,0.001,1104,10
0.566,1e-05,600,604,50,50,0.001,1204,10
0.584,1e-05,649,655,50,50,0.001,1304,10
0.602,1e-05,708,696,50,50,0.001,1404,10
0.642,1e-05,759,745,50,50,0.001,1504,10
0.676,1e-05,806,798,50,50,0.001,1604,10
0.682,1e-05,851,853,50,50,0.001,1704,10
0.708,1e-05,899,905,50,50,0.001,1804,10
0.72,1e-05,952,952,50,50,0.001,1904,10
0.744,1e-05,1011,993,50,50,0.001,2004,10
0.534,1e-05,63,41,50,50,0.001,104,11
0.528,1e-05,112,92,50,50,0.001,204,11
0.534,1e-05,168,136,50,50,0.001,304,11
0.534,1e-05,222,182,50,50,0.001,404,11
0.54,1e-05,270,234,50,50,0.001,504,11
0.536,1e-05,331,273,50,50,0.001,604,11
0.544,1e-05,378,326,50,50,0.001,704,11
0.55,1e-05,426,378,50,50,0.001,804,11
0.556,1e-05,470,434,50,50,0.001,904,11
0.562,1e-05,523,481,50,50,0.001,1004,11
0.562,1e-05,571,533,50,50,0.001,1104,11
0.57,1e-05,630,574,50,50,0.001,1204,11
0.596,1e-05,671,633,50,50,0.001,1304,11
0.606,1e-05,731,673,50,50,0.001,1404,11
0.616,1e-05,779,725,50,50,0.001,1504,11
0.634,1e-05,830,774,50,50,0.001,1604,11
0.664,1e-05,877,827,50,50,0.001,1704,11
0.694,1e-05,929,875,50,50,0.001,1804,11
0.744,1e-05,980,924,50,50,0.001,1904,11
0.788,1e-05,1025,979,50,50,0.001,2004,11
0.522,1e-05,53,51,50,50,0.001,104,12
0.526,1e-05,110,94,50,50,0.001,204,12
0.52,1e-05,161,143,50,50,0.001,304,12
0.538,1e-05,209,195,50,50,0.001,404,12
0.546,1e-05,259,245,50,50,0.001,504,12
0.552,1e-05,306,298,50,50,0.001,604,12
0.566,1e-05,360,344,50,50,0.001,704,12
0.586,1e-05,407,397,50,50,0.001,804,12
0.59,1e-05,458,446,50,50,0.001,904,12
0.62,1e-05,502,502,50,50,0.001,1004,12
0.632,1e-05,551,553,50,50,0.001,1104,12
0.646,1e-05,601,603,50,50,0.001,1204,12
0.666,1e-05,650,654,50,50,0.001,1304,12
0.686,1e-05,706,698,50,50,0.001,1404,12
0.696,1e-05,754,750,50,50,0.001,1504,12
0.71,1e-05,806,798,50,50,0.001,1604,12
0.714,1e-05,846,858,50,50,0.001,1704,12
0.734,1e-05,893,911,50,50,0.001,1804,12
0.74,1e-05,943,961,50,50,0.001,1904,12
0.762,1e-05,991,1013,50,50,0.001,2004,12
0.488,1e-05,56,48,50,50,0.001,104,13
0.492,1e-05,106,98,50,50,0.001,204,13
0.488,1e-05,150,154,50,50,0.001,304,13
0.498,1e-05,200,204,50,50,0.001,404,13
0.514,1e-05,255,249,50,50,0.001,504,13
0.508,1e-05,310,294,50,50,0.001,604,13
0.51,1e-05,352,352,50,50,0.001,704,13
0.524,1e-05,403,401,50,50,0.001,804,13
0.532,1e-05,447,457,50,50,0.001,904,13
0.558,1e-05,500,504,50,50,0.001,1004,13
0.578,1e-05,549,555,50,50,0.001,1104,13
0.614,1e-05,595,609,50,50,0.001,1204,13
0.64,1e-05,643,661,50,50,0.001,1304,13
0.662,1e-05,690,714,50,50,0.001,1404,13
0.672,1e-05,742,762,50,50,0.001,1504,13
0.686,1e-05,793,811,50,50,0.001,1604,13
0.704,1e-05,840,864,50,50,0.001,1704,13
0.736,1e-05,894,910,50,50,0.001,1804,13
0.764,1e-05,946,958,50,50,0.001,1904,13
0.788,1e-05,1001,1003,50,50,0.001,2004,13
0.464,1e-05,47,57,50,50,0.001,104,14
0.474,1e-05,96,108,50,50,0.001,204,14
0.484,1e-05,151,153,50,50,0.001,304,14
0.504,1e-05,201,203,50,50,0.001,404,14
0.506,1e-05,259,245,50,50,0.001,504,14
0.51,1e-05,308,296,50,50,0.001,604,14
0.522,1e-05,367,337,50,50,0.001,704,14
0.53,1e-05,414,390,50,50,0.001,804,14
0.532,1e-05,470,434,50,50,0.001,904,14
0.538,1e-05,521,483,50,50,0.001,1004,14
0.544,1e-05,566,538,50,50,0.001,1104,14
0.566,1e-05,612,592,50,50,0.001,1204,14
0.578,1e-05,657,647,50,50,0.001,1304,14
0.608,1e-05,700,704,50,50,0.001,1404,14
0.632,1e-05,754,750,50,50,0.001,1504,14
0.654,1e-05,802,802,50,50,0.001,1604,14
0.69,1e-05,860,844,50,50,0.001,1704,14
0.724,1e-05,911,893,50,50,0.001,1804,14
0.746,1e-05,961,943,50,50,0.001,1904,14
0.778,1e-05,1009,995,50,50,0.001,2004,14
0.528,1e-05,45,59,50,50,0.001,104,15
0.526,1e-05,90,114,50,50,0.001,204,15
0.524,1e-05,131,173,50,50,0.001,304,15
0.526,1e-05,182,222,50,50,0.001,404,15
0.534,1e-05,237,267,50,50,0.001,504,15
0.538,1e-05,292,312,50,50,0.001,604,15
0.54,1e-05,349,355,50,50,0.001,704,15
0.55,1e-05,406,398,50,50,0.001,804,15
0.57,1e-05,457,447,50,50,0.001,904,15
0.562,1e-05,506,498,50,50,0.001,1004,15
0.566,1e-05,558,546,50,50,0.001,1104,15
0.578,1e-05,610,594,50,50,0.001,1204,15
0.586,1e-05,657,647,50,50,0.001,1304,15
0.592,1e-05,704,700,50,50,0.001,1404,15
0.614,1e-05,757,747,50,50,0.001,1504,15
0.626,1e-05,799,805,50,50,0.001,1604,15
0.65,1e-05,846,858,50,50,0.001,1704,15
0.67,1e-05,893,911,50,50,0.001,1804,15
0.688,1e-05,946,958,50,50,0.001,1904,15
0.724,1e-05,1001,1003,50,50,0.001,2004,15
0.568,1e-05,48,56,50,50,0.001,104,16
0.566,1e-05,96,108,50,50,0.001,204,16
0.566,1e-05,149,155,50,50,0.001,304,16
0.57,1e-05,199,205,50,50,0.001,404,16
0.566,1e-05,251,253,50,50,0.001,504,16
0.582,1e-05,307,297,50,50,0.001,604,16
0.584,1e-05,356,348,50,50,0.001,704,16
0.576,1e-05,407,397,50,50,0.001,804,16
0.566,1e-05,463,441,50,50,0.001,904,16
0.576,1e-05,513,491,50,50,0.001,1004,16
0.574,1e-05,564,540,50,50,0.001,1104,16
0.594,1e-05,622,582,50,50,0.001,1204,16
0.6,1e-05,675,629,50,50,0.001,1304,16
0.622,1e-05,725,679,50,50,0.001,1404,16
0.626,1e-05,767,737,50,50,0.001,1504,16
0.648,1e-05,811,793,50,50,0.001,1604,16
0.66,1e-05,859,845,50,50,0.001,1704,16
0.678,1e-05,906,898,50,50,0.001,1804,16
0.698,1e-05,956,948,50,50,0.001,1904,16
0.726,1e-05,1014,990,50,50,0.001,2004,16
0.562,1e-05,55,49,50,50,0.001,104,17
0.554,1e-05,101,103,50,50,0.001,204,17
0.566,1e-05,151,153,50,50,0.001,304,17
0.584,1e-05,207,197,50,50,0.001,404,17
0.588,1e-05,259,245,50,50,0.001,504,17
0.578,1e-05,314,290,50,50,0.001,604,17
0.578,1e-05,364,340,50,50,0.001,704,17
0.586,1e-05,409,395,50,50,0.001,804,17
0.596,1e-05,465,439,50,50,0.001,904,17
0.614,1e-05,507,497,50,50,0.001,1004,17
0.618,1e-05,559,545,50,50,0.001,1104,17
0.634,1e-05,600,604,50,50,0.001,1204,17
0.646,1e-05,652,652,50,50,0.001,1304,17
0.66,1e-05,698,706,50,50,0.001,1404,17
0.67,1e-05,748,756,50,50,0.001,1504,17
0.692,1e-05,799,805,50,50,0.001,1604,17
0.71,1e-05,845,859,50,50,0.001,1704,17
0.718,1e-05,905,899,50,50,0.001,1804,17
0.758,1e-05,951,953,50,50,0.001,1904,17
0.778,1e-05,995,1009,50,50,0.001,2004,17
0.498,1e-05,61,43,50,50,0.001,104,18
0.496,1e-05,107,97,50,50,0.001,204,18
0.482,1e-05,153,151,50,50,0.001,304,18
0.5,1e-05,198,206,50,50,0.001,404,18
0.508,1e-05,244,260,50,50,0.001,504,18
0.52,1e-05,293,311,50,50,0.001,604,18
0.538,1e-05,349,355,50,50,0.001,704,18
0.546,1e-05,397,407,50,50,0.001,804,18
0.554,1e-05,438,466,50,50,0.001,904,18
0.568,1e-05,489,515,50,50,0.001,1004,18
0.58,1e-05,544,560,50,50,0.001,1104,18
0.596,1e-05,586,618,50,50,0.001,1204,18
0.61,1e-05,633,671,50,50,0.001,1304,18
0.632,1e-05,686,718,50,50,0.001,1404,18
0.64,1e-05,732,772,50,50,0.001,1504,18
0.668,1e-05,787,817,50,50,0.001,1604,18
0.704,1e-05,840,864,50,50,0.001,1704,18
0.732,1e-05,894,910,50,50,0.001,1804,18
0.738,1e-05,949,955,50,50,0.001,1904,18
0.762,1e-05,1006,998,50,50,0.001,2004,18
0.476,1e-05,52,52,50,50,0.001,104,19
0.486,1e-05,104,100,50,50,0.001,204,19
0.488,1e-05,153,151,50,50,0.001,304,19
0.5,1e-05,210,194,50,50,0.001,404,19
0.502,1e-05,257,247,50,50,0.001,504,19
0.516,1e-05,306,298,50,50,0.001,604,19
0.528,1e-05,359,345,50,50,0.001,704,19
0.544,1e-05,407,397,50,50,0.001,804,19
0.564,1e-05,454,450,50,50,0.001,904,19
0.58,1e-05,501,503,50,50,0.001,1004,19
0.592,1e-05,551,553,50,50,0.001,1104,19
0.612,1e-05,607,597,50,50,0.001,1204,19
0.618,1e-05,659,645,50,50,0.001,1304,19
0.638,1e-05,702,702,50,50,0.001,1404,19
0.656,1e-05,748,756,50,50,0.001,1504,19
0.668,1e-05,802,802,50,50,0.001,1604,19
0.676,1e-05,854,850,50,50,0.001,1704,19
0.69,1e-05,905,899,50,50,0.001,1804,19
0.724,1e-05,954,950,50,50,0.001,1904,19
0.746,1e-05,998,1006,50,50,0.001,2004,19
0.5,1e-05,56,48,50,50,0.001,104,20
0.5,1e-05,100,104,50,50,0.001,204,20
0.506,1e-05,143,161,50,50,0.001,304,20
0.512,1e-05,190,214,50,50,0.001,404,20
0.524,1e-05,241,263,50,50,0.001,504,20
0.526,1e-05,298,306,50,50,0.001,604,20
0.532,1e-05,342,362,50,50,0.001,704,20
0.534,1e-05,392,412,50,50,0.001,804,20
0.548,1e-05,445,459,50,50,0.001,904,20
0.566,1e-05,496,508,50,50,0.001,1004,20
0.584,1e-05,549,555,50,50,0.001,1104,20
0.606,1e-05,602,602,50,50,0.001,1204,20
0.626,1e-05,653,651,50,50,0.001,1304,20
0.652,1e-05,706,698,50,50,0.001,1404,20
0.674,1e-05,757,747,50,50,0.001,1504,20
0.706,1e-05,803,801,50,50,0.001,1604,20
0.734,1e-05,849,855,50,50,0.001,1704,20
0.752,1e-05,904,900,50,50,0.001,1804,20
0.778,1e-05,956,948,50,50,0.001,1904,20
0.784,1e-05,1012,992,50,50,0.001,2004,20
0.546,1e-05,58,46,50,50,0.01,104,1
0.57,1e-05,114,90,50,50,0.01,204,1
0.546,1e-05,160,144,50,50,0.01,304,1
0.59,1e-05,205,199,50,50,0.01,404,1
0.634,1e-05,256,248,50,50,0.01,504,1
0.698,1e-05,310,294,50,50,0.01,604,1
0.718,1e-05,363,341,50,50,0.01,704,1
0.75,1e-05,408,396,50,50,0.01,804,1
0.752,1e-05,457,447,50,50,0.01,904,1
0.83,1e-05,513,491,50,50,0.01,1004,1
0.88,1e-05,562,542,50,50,0.01,1104,1
0.916,1e-05,613,591,50,50,0.01,1204,1
0.936,1e-05,659,645,50,50,0.01,1304,1
0.948,1e-05,705,699,50,50,0.01,1404,1
0.95,1e-05,757,747,50,50,0.01,1504,1
0.954,1e-05,804,800,50,50,0.01,1604,1
0.956,1e-05,852,852,50,50,0.01,1704,1
0.962,1e-05,904,900,50,50,0.01,1804,1
0.964,1e-05,953,951,50,50,0.01,1904,1
0.956,1e-05,1005,999,50,50,0.01,2004,1
0.548,1e-05,50,54,50,50,0.01,104,2
0.582,1e-05,99,105,50,50,0.01,204,2
0.574,1e-05,151,153,50,50,0.01,304,2
0.614,1e-05,203,201,50,50,0.01,404,2
0.634,1e-05,247,257,50,50,0.01,504,2
0.684,1e-05,300,304,50,50,0.01,604,2
0.718,1e-05,349,355,50,50,0.01,704,2
0.77,1e-05,396,408,50,50,0.01,804,2
0.784,1e-05,456,448,50,50,0.01,904,2
0.838,1e-05,514,490,50,50,0.01,1004,2
0.876,1e-05,563,541,50,50,0.01,1104,2
0.93,1e-05,609,595,50,50,0.01,1204,2
0.934,1e-05,657,647,50,50,0.01,1304,2
0.954,1e-05,716,688,50,50,0.01,1404,2
0.952,1e-05,764,740,50,50,0.01,1504,2
0.96,1e-05,819,785,50,50,0.01,1604,2
0.96,1e-05,864,840,50,50,0.01,1704,2
0.964,1e-05,916,888,50,50,0.01,1804,2
0.962,1e-05,960,944,50,50,0.01,1904,2
0.966,1e-05,1000,1004,50,50,0.01,2004,2
0.56,1e-05,48,56,50,50,0.01,104,3
0.542,1e-05,93,111,50,50,0.01,204,3
0.552,1e-05,146,158,50,50,0.01,304,3
0.578,1e-05,189,215,50,50,0.01,404,3
0.648,1e-05,241,263,50,50,0.01,504,3
0.658,1e-05,289,315,50,50,0.01,604,3
0.698,1e-05,346,358,50,50,0.01,704,3
0.744,1e-05,390,414,50,50,0.01,804,3
0.79,1e-05,438,466,50,50,0.01,904,3
0.804,1e-05,486,518,50,50,0.01,1004,3
0.838,1e-05,527,577,50,50,0.01,1104,3
0.894,1e-05,576,628,50,50,0.01,1204,3
0.928,1e-05,630,674,50,50,0.01,1304,3
0.94,1e-05,679,725,50,50,0.01,1404,3
0.958,1e-05,724,780,50,50,0.01,1504,3
0.952,1e-05,769,835,50,50,0.01,1604,3
0.956,1e-05,825,879,50,50,0.01,1704,3
0.966,1e-05,878,926,50,50,0.01,1804,3
0.96,1e-05,929,975,50,50,0.01,1904,3
0.954,1e-05,986,1018,50,50,0.01,2004,3
0.46,1e-05,55,49,50,50,0.01,104,4
0.506,1e-05,112,92,50,50,0.01,204,4
0.532,1e-05,172,132,50,50,0.01,304,4
0.568,1e-05,225,179,50,50,0.01,404,4
0.592,1e-05,269,235,50,50,0.01,504,4
0.632,1e-05,309,295,50,50,0.01,604,4
0.688,1e-05,354,350,50,50,0.01,704,4
0.73,1e-05,409,395,50,50,0.01,804,4
0.79,1e-05,451,453,50,50,0.01,904,4
0.856,1e-05,512,492,50,50,0.01,1004,4
0.894,1e-05,569,535,50,50,0.01,1104,4
0.932,1e-05,625,579,50,50,0.01,1204,4
0.938,1e-05,670,634,50,50,0.01,1304,4
0.946,1e-05,710,694,50,50,0.01,1404,4
0.946,1e-05,765,739,50,50,0.01,1504,4
0.946,1e-05,819,785,50,50,0.01,1604,4
0.962,1e-05,866,838,50,50,0.01,1704,4
0.966,1e-05,910,894,50,50,0.01,1804,4
0.968,1e-05,955,949,50,50,0.01,1904,4
0.972,1e-05,1005,999,50,50,0.01,2004,4
0.52,1e-05,44,60,50,50,0.01,104,5
0.516,1e-05,96,108,50,50,0.01,204,5
0.522,1e-05,154,150,50,50,0.01,304,5
0.53,1e-05,200,204,50,50,0.01,404,5
0.546,1e-05,255,249,50,50,0.01,504,5
0.598,1e-05,302,302,50,50,0.01,604,5
0.642,1e-05,351,353,50,50,0.01,704,5
0.684,1e-05,402,402,50,50,0.01,804,5
0.732,1e-05,451,453,50,50,0.01,904,5
0.782,1e-05,503,501,50,50,0.01,1004,5
0.834,1e-05,550,554,50,50,0.01,1104,5
0.904,1e-05,600,604,50,50,0.01,1204,5
0.918,1e-05,646,658,50,50,0.01,1304,5
0.938,1e-05,694,710,50,50,0.01,1404,5
0.938,1e-05,749,755,50,50,0.01,1504,5
0.95,1e-05,805,799,50,50,0.01,1604,5
0.948,1e-05,870,834,50,50,0.01,1704,5
0.952,1e-05,912,892,50,50,0.01,1804,5
0.946,1e-05,956,948,50,50,0.01,1904,5
0.956,1e-05,1015,989,50,50,0.01,2004,5
0.526,1e-05,53,51,50,50,0.01,104,6
0.58,1e-05,100,104,50,50,0.01,204,6
0.586,1e-05,157,147,50,50,0.01,304,6
0.594,1e-05,202,202,50,50,0.01,404,6
0.628,1e-05,248,256,50,50,0.01,504,6
0.656,1e-05,294,310,50,50,0.01,604,6
0.718,1e-05,347,357,50,50,0.01,704,6
0.788,1e-05,397,407,50,50,0.01,804,6
0.836,1e-05,442,462,50,50,0.01,904,6
0.874,1e-05,489,515,50,50,0.01,1004,6
0.902,1e-05,541,563,50,50,0.01,1104,6
0.926,1e-05,590,614,50,50,0.01,1204,6
0.936,1e-05,638,666,50,50,0.01,1304,6
0.95,1e-05,689,715,50,50,0.01,1404,6
0.956,1e-05,744,760,50,50,0.01,1504,6
0.956,1e-05,799,805,50,50,0.01,1604,6
0.958,1e-05,845,859,50,50,0.01,1704,6
0.962,1e-05,895,909,50,50,0.01,1804,6
0.962,1e-05,945,959,50,50,0.01,1904,6
0.968,1e-05,999,1005,50,50,0.01,2004,6
0.492,1e-05,58,46,50,50,0.01,104,7
0.562,1e-05,107,97,50,50,0.01,204,7
0.606,1e-05,150,154,50,50,0.01,304,7
0.63,1e-05,194,210,50,50,0.01,404,7
0.662,1e-05,242,262,50,50,0.01,504,7
0.698,1e-05,297,307,50,50,0.01,604,7
0.738,1e-05,350,354,50,50,0.01,704,7
0.774,1e-05,398,406,50,50,0.01,804,7
0.798,1e-05,448,456,50,50,0.01,904,7
0.848,1e-05,498,506,50,50,0.01,1004,7
0.9,1e-05,555,549,50,50,0.01,1104,7
0.928,1e-05,609,595,50,50,0.01,1204,7
0.932,1e-05,661,643,50,50,0.01,1304,7
0.946,1e-05,707,697,50,50,0.01,1404,7
0.956,1e-05,754,750,50,50,0.01,1504,7
0.956,1e-05,806,798,50,50,0.01,1604,7
0.968,1e-05,852,852,50,50,0.01,1704,7
0.972,1e-05,912,892,50,50,0.01,1804,7
0.972,1e-05,955,949,50,50,0.01,1904,7
0.974,1e-05,1008,996,50,50,0.01,2004,7
0.51,1e-05,54,50,50,50,0.01,104,8
0.552,1e-05,107,97,50,50,0.01,204,8
0.582,1e-05,143,161,50,50,0.01,304,8
0.588,1e-05,189,215,50,50,0.01,404,8
0.608,1e-05,240,264,50,50,0.01,504,8
0.642,1e-05,290,314,50,50,0.01,604,8
0.69,1e-05,337,367,50,50,0.01,704,8
0.738,1e-05,393,411,50,50,0.01,804,8
0.788,1e-05,439,465,50,50,0.01,904,8
0.846,1e-05,486,518,50,50,0.01,1004,8
0.904,1e-05,532,572,50,50,0.01,1104,8
0.928,1e-05,582,622,50,50,0.01,1204,8
0.926,1e-05,632,672,50,50,0.01,1304,8
0.94,1e-05,689,715,50,50,0.01,1404,8
0.944,1e-05,733,771,50,50,0.01,1504,8
0.954,1e-05,784,820,50,50,0.01,1604,8
0.956,1e-05,829,875,50,50,0.01,1704,8
0.95,1e-05,881,923,50,50,0.01,1804,8
0.962,1e-05,932,972,50,50,0.01,1904,8
0.96,1e-05,980,1024,50,50,0.01,2004,8
0.46,1e-05,60,44,50,50,0.01,104,9
0.518,1e-05,113,91,50,50,0.01,204,9
0.576,1e-05,152,152,50,50,0.01,304,9
0.612,1e-05,204,200,50,50,0.01,404,9
0.61,1e-05,257,247,50,50,0.01,504,9
0.63,1e-05,304,300,50,50,0.01,604,9
0.652,1e-05,358,346,50,50,0.01,704,9
0.698,1e-05,413,391,50,50,0.01,804,9
0.718,1e-05,458,446,50,50,0.01,904,9
0.802,1e-05,510,494,50,50,0.01,1004,9
0.858,1e-05,565,539,50,50,0.01,1104,9
0.924,1e-05,622,582,50,50,0.01,1204,9
0.934,1e-05,665,639,50,50,0.01,1304,9
0.948,1e-05,714,690,50,50,0.01,1404,9
0.954,1e-05,766,738,50,50,0.01,1504,9
0.958,1e-05,823,781,50,50,0.01,1604,9
0.964,1e-05,869,835,50,50,0.01,1704,9
0.97,1e-05,924,880,50,50,0.01,1804,9
0.976,1e-05,978,926,50,50,0.01,1904,9
0.974,1e-05,1027,977,50,50,0.01,2004,9
0.514,1e-05,65,39,50,50,0.01,104,10
0.532,1e-05,112,92,50,50,0.01,204,10
0.558,1e-05,160,144,50,50,0.01,304,10
0.594,1e-05,223,181,50,50,0.01,404,10
0.666,1e-05,280,224,50,50,0.01,504,10
0.722,1e-05,320,284,50,50,0.01,604,10
0.724,1e-05,368,336,50,50,0.01,704,10
0.786,1e-05,415,389,50,50,0.01,804,10
0.826,1e-05,463,441,50,50,0.01,904,10
0.878,1e-05,521,483,50,50,0.01,1004,10
0.896,1e-05,572,532,50,50,0.01,1104,10
0.922,1e-05,625,579,50,50,0.01,1204,10
0.914,1e-05,673,631,50,50,0.01,1304,10
0.94,1e-05,715,689,50,50,0.01,1404,10
0.94,1e-05,771,733,50,50,0.01,1504,10
0.946,1e-05,820,784,50,50,0.01,1604,10
0.954,1e-05,870,834,50,50,0.01,1704,10
0.958,1e-05,911,893,50,50,0.01,1804,10
0.96,1e-05,959,945,50,50,0.01,1904,10
0.964,1e-05,1006,998,50,50,0.01,2004,10
0.53,1e-05,52,52,50,50,0.01,104,11
0.548,1e-05,109,95,50,50,0.01,204,11
0.584,1e-05,152,152,50,50,0.01,304,11
0.622,1e-05,203,201,50,50,0.01,404,11
0.65,1e-05,264,240,50,50,0.01,504,11
0.684,1e-05,308,296,50,50,0.01,604,11
0.744,1e-05,359,345,50,50,0.01,704,11
0.79,1e-05,405,399,50,50,0.01,804,11
0.83,1e-05,456,448,50,50,0.01,904,11
0.868,1e-05,511,493,50,50,0.01,1004,11
0.906,1e-05,558,546,50,50,0.01,1104,11
0.92,1e-05,609,595,50,50,0.01,1204,11
0.936,1e-05,650,654,50,50,0.01,1304,11
0.948,1e-05,704,700,50,50,0.01,1404,11
0.948,1e-05,752,752,50,50,0.01,1504,11
0.954,1e-05,803,801,50,50,0.01,1604,11
0.954,1e-05,853,851,50,50,0.01,1704,11
0.952,1e-05,894,910,50,50,0.01,1804,11
0.952,1e-05,946,958,50,50,0.01,1904,11
0.96,1e-05,994,1010,50,50,0.01,2004,11
0.52,1e-05,53,51,50,50,0.01,104,12
0.558,1e-05,110,94,50,50,0.01,204,12
0.594,1e-05,164,140,50,50,0.01,304,12
0.638,1e-05,216,188,50,50,0.01,404,12
0.652,1e-05,269,235,50,50,0.01,504,12
0.67,1e-05,323,281,50,50,0.01,604,12
0.684,1e-05,369,335,50,50,0.01,704,12
0.712,1e-05,418,386,50,50,0.01,804,12
0.766,1e-05,462,442,50,50,0.01,904,12
0.838,1e-05,512,492,50,50,0.01,1004,12
0.872,1e-05,554,550,50,50,0.01,1104,12
0.898,1e-05,601,603,50,50,0.01,1204,12
0.914,1e-05,642,662,50,50,0.01,1304,12
0.93,1e-05,693,711,50,50,0.01,1404,12
0.948,1e-05,747,757,50,50,0.01,1504,12
0.952,1e-05,802,802,50,50,0.01,1604,12
0.95,1e-05,851,853,50,50,0.01,1704,12
0.962,1e-05,902,902,50,50,0.01,1804,12
0.956,1e-05,949,955,50,50,0.01,1904,12
0.966,1e-05,1005,999,50,50,0.01,2004,12
0.51,1e-05,62,42,50,50,0.01,104,13
0.546,1e-05,110,94,50,50,0.01,204,13
0.55,1e-05,159,145,50,50,0.01,304,13
0.588,1e-05,216,188,50,50,0.01,404,13
0.62,1e-05,265,239,50,50,0.01,504,13
0.656,1e-05,323,281,50,50,0.01,604,13
0.694,1e-05,368,336,50,50,0.01,704,13
0.74,1e-05,418,386,50,50,0.01,804,13
0.766,1e-05,457,447,50,50,0.01,904,13
0.814,1e-05,504,500,50,50,0.01,1004,13
0.86,1e-05,548,556,50,50,0.01,1104,13
0.916,1e-05,595,609,50,50,0.01,1204,13
0.942,1e-05,647,657,50,50,0.01,1304,13
0.956,1e-05,692,712,50,50,0.01,1404,13
0.962,1e-05,740,764,50,50,0.01,1504,13
0.96,1e-05,785,819,50,50,0.01,1604,13
0.972,1e-05,838,866,50,50,0.01,1704,13
0.972,1e-05,885,919,50,50,0.01,1804,13
0.976,1e-05,941,963,50,50,0.01,1904,13
0.974,1e-05,989,1015,50,50,0.01,2004,13
0.542,1e-05,48,56,50,50,0.01,104,14
0.544,1e-05,104,100,50,50,0.01,204,14
0.548,1e-05,151,153,50,50,0.01,304,14
0.568,1e-05,200,204,50,50,0.01,404,14
0.604,1e-05,254,250,50,50,0.01,504,14
0.652,1e-05,299,305,50,50,0.01,604,14
0.686,1e-05,352,352,50,50,0.01,704,14
0.744,1e-05,398,406,50,50,0.01,804,14
0.796,1e-05,452,452,50,50,0.01,904,14
0.864,1e-05,504,500,50,50,0.01,1004,14
0.91,1e-05,551,553,50,50,0.01,1104,14
0.944,1e-05,605,599,50,50,0.01,1204,14
0.958,1e-05,652,652,50,50,0.01,1304,14
0.96,1e-05,701,703,50,50,0.01,1404,14
0.964,1e-05,743,761,50,50,0.01,1504,14
0.964,1e-05,790,814,50,50,0.01,1604,14
0.958,1e-05,839,865,50,50,0.01,1704,14
0.97,1e-05,898,906,50,50,0.01,1804,14
0.972,1e-05,953,951,50,50,0.01,1904,14
0.978,1e-05,1000,1004,50,50,0.01,2004,14
0.518,1e-05,44,60,50,50,0.01,104,15
0.564,1e-05,88,116,50,50,0.01,204,15
0.586,1e-05,137,167,50,50,0.01,304,15
0.6,1e-05,192,212,50,50,0.01,404,15
0.62,1e-05,236,268,50,50,0.01,504,15
0.658,1e-05,291,313,50,50,0.01,604,15
0.7,1e-05,337,367,50,50,0.01,704,15
0.754,1e-05,388,416,50,50,0.01,804,15
0.808,1e-05,439,465,50,50,0.01,904,15
0.858,1e-05,484,520,50,50,0.01,1004,15
0.912,1e-05,533,571,50,50,0.01,1104,15
0.94,1e-05,579,625,50,50,0.01,1204,15
0.946,1e-05,628,676,50,50,0.01,1304,15
0.954,1e-05,687,717,50,50,0.01,1404,15
0.968,1e-05,740,764,50,50,0.01,1504,15
0.972,1e-05,794,810,50,50,0.01,1604,15
0.974,1e-05,844,860,50,50,0.01,1704,15
0.982,1e-05,900,904,50,50,0.01,1804,15
0.98,1e-05,954,950,50,50,0.01,1904,15
0.982,1e-05,1008,996,50,50,0.01,2004,15
0.504,1e-05,53,51,50,50,0.01,104,16
0.518,1e-05,104,100,50,50,0.01,204,16
0.544,1e-05,153,151,50,50,0.01,304,16
0.582,1e-05,204,200,50,50,0.01,404,16
0.604,1e-05,251,253,50,50,0.01,504,16
0.658,1e-05,291,313,50,50,0.01,604,16
0.674,1e-05,337,367,50,50,0.01,704,16
0.74,1e-05,386,418,50,50,0.01,804,16
0.772,1e-05,429,475,50,50,0.01,904,16
0.82,1e-05,476,528,50,50,0.01,1004,16
0.85,1e-05,533,571,50,50,0.01,1104,16
0.896,1e-05,590,614,50,50,0.01,1204,16
0.916,1e-05,651,653,50,50,0.01,1304,16
0.934,1e-05,707,697,50,50,0.01,1404,16
0.946,1e-05,761,743,50,50,0.01,1504,16
0.948,1e-05,815,789,50,50,0.01,1604,16
0.95,1e-05,863,841,50,50,0.01,1704,16
0.958,1e-05,911,893,50,50,0.01,1804,16
0.948,1e-05,961,943,50,50,0.01,1904,16
0.954,1e-05,1008,996,50,50,0.01,2004,16
0.526,1e-05,50,54,50,50,0.01,104,17
0.544,1e-05,99,105,50,50,0.01,204,17
0.56,1e-05,157,147,50,50,0.01,304,17
0.58,1e-05,202,202,50,50,0.01,404,17
0.6,1e-05,252,252,50,50,0.01,504,17
0.644,1e-05,305,299,50,50,0.01,604,17
0.672,1e-05,359,345,50,50,0.01,704,17
0.72,1e-05,406,398,50,50,0.01,804,17
0.754,1e-05,455,449,50,50,0.01,904,17
0.846,1e-05,499,505,50,50,0.01,1004,17
0.886,1e-05,543,561,50,50,0.01,1104,17
0.918,1e-05,589,615,50,50,0.01,1204,17
0.914,1e-05,638,666,50,50,0.01,1304,17
0.95,1e-05,697,707,50,50,0.01,1404,17
0.954,1e-05,748,756,50,50,0.01,1504,17
0.958,1e-05,802,802,50,50,0.01,1604,17
0.964,1e-05,853,851,50,50,0.01,1704,17
0.962,1e-05,905,899,50,50,0.01,1804,17
0.964,1e-05,956,948,50,50,0.01,1904,17
0.972,1e-05,1012,992,50,50,0.01,2004,17
0.522,1e-05,56,48,50,50,0.01,104,18
0.572,1e-05,102,102,50,50,0.01,204,18
0.598,1e-05,151,153,50,50,0.01,304,18
0.632,1e-05,203,201,50,50,0.01,404,18
0.646,1e-05,255,249,50,50,0.01,504,18
0.686,1e-05,308,296,50,50,0.01,604,18
0.71,1e-05,355,349,50,50,0.01,704,18
0.758,1e-05,402,402,50,50,0.01,804,18
0.782,1e-05,452,452,50,50,0.01,904,18
0.828,1e-05,486,518,50,50,0.01,1004,18
0.894,1e-05,532,572,50,50,0.01,1104,18
0.92,1e-05,584,620,50,50,0.01,1204,18
0.934,1e-05,642,662,50,50,0.01,1304,18
0.956,1e-05,695,709,50,50,0.01,1404,18
0.962,1e-05,750,754,50,50,0.01,1504,18
0.968,1e-05,799,805,50,50,0.01,1604,18
0.968,1e-05,851,853,50,50,0.01,1704,18
0.968,1e-05,900,904,50,50,0.01,1804,18
0.97,1e-05,955,949,50,50,0.01,1904,18
0.976,1e-05,1002,1002,50,50,0.01,2004,18
0.526,1e-05,46,58,50,50,0.01,104,19
0.554,1e-05,102,102,50,50,0.01,204,19
0.574,1e-05,152,152,50,50,0.01,304,19
0.606,1e-05,198,206,50,50,0.01,404,19
0.618,1e-05,250,254,50,50,0.01,504,19
0.65,1e-05,307,297,50,50,0.01,604,19
0.676,1e-05,355,349,50,50,0.01,704,19
0.744,1e-05,404,400,50,50,0.01,804,19
0.808,1e-05,448,456,50,50,0.01,904,19
0.876,1e-05,499,505,50,50,0.01,1004,19
0.91,1e-05,554,550,50,50,0.01,1104,19
0.934,1e-05,601,603,50,50,0.01,1204,19
0.946,1e-05,644,660,50,50,0.01,1304,19
0.954,1e-05,692,712,50,50,0.01,1404,19
0.956,1e-05,739,765,50,50,0.01,1504,19
0.96,1e-05,785,819,50,50,0.01,1604,19
0.96,1e-05,836,868,50,50,0.01,1704,19
0.962,1e-05,894,910,50,50,0.01,1804,19
0.97,1e-05,939,965,50,50,0.01,1904,19
0.97,1e-05,988,1016,50,50,0.01,2004,19
0.49,1e-05,51,53,50,50,0.01,104,20
0.578,1e-05,95,109,50,50,0.01,204,20
0.578,1e-05,145,159,50,50,0.01,304,20
0.596,1e-05,197,207,50,50,0.01,404,20
0.602,1e-05,252,252,50,50,0.01,504,20
0.624,1e-05,300,304,50,50,0.01,604,20
0.644,1e-05,352,352,50,50,0.01,704,20
0.694,1e-05,406,398,50,50,0.01,804,20
0.724,1e-05,454,450,50,50,0.01,904,20
0.774,1e-05,502,502,50,50,0.01,1004,20
0.828,1e-05,558,546,50,50,0.01,1104,20
0.898,1e-05,605,599,50,50,0.01,1204,20
0.904,1e-05,659,645,50,50,0.01,1304,20
0.932,1e-05,718,686,50,50,0.01,1404,20
0.944,1e-05,766,738,50,50,0.01,1504,20
0.95,1e-05,815,789,50,50,0.01,1604,20
0.958,1e-05,869,835,50,50,0.01,1704,20
0.96,1e-05,925,879,50,50,0.01,1804,20
0.958,1e-05,974,930,50,50,0.01,1904,20
0.956,1e-05,1012,992,50,50,0.01,2004,20
0.51,0.0001,55,49,50,50,0.0001,104,1
0.51,0.0001,101,103,50,50,0.0001,204,1
0.508,0.0001,149,155,50,50,0.0001,304,1
0.51,0.0001,200,204,50,50,0.0001,404,1
0.51,0.0001,254,250,50,50,0.0001,504,1
0.512,0.0001,306,298,50,50,0.0001,604,1
0.51,0.0001,357,347,50,50,0.0001,704,1
0.514,0.0001,406,398,50,50,0.0001,804,1
0.518,0.0001,458,446,50,50,0.0001,904,1
0.516,0.0001,505,499,50,50,0.0001,1004,1
0.52,0.0001,559,545,50,50,0.0001,1104,1
0.522,0.0001,601,603,50,50,0.0001,1204,1
0.522,0.0001,652,652,50,50,0.0001,1304,1
0.524,0.0001,702,702,50,50,0.0001,1404,1
0.522,0.0001,748,756,50,50,0.0001,1504,1
0.526,0.0001,801,803,50,50,0.0001,1604,1
0.528,0.0001,840,864,50,50,0.0001,1704,1
0.536,0.0001,887,917,50,50,0.0001,1804,1
0.54,0.0001,941,963,50,50,0.0001,1904,1
0.542,0.0001,996,1008,50,50,0.0001,2004,1
0.442,0.0001,51,53,50,50,0.0001,104,2
0.442,0.0001,97,107,50,50,0.0001,204,2
0.442,0.0001,141,163,50,50,0.0001,304,2
0.44,0.0001,189,215,50,50,0.0001,404,2
0.44,0.0001,235,269,50,50,0.0001,504,2
0.44,0.0001,293,311,50,50,0.0001,604,2
0.442,0.0001,342,362,50,50,0.0001,704,2
0.444,0.0001,390,414,50,50,0.0001,804,2
0.444,0.0001,447,457,50,50,0.0001,904,2
0.446,0.0001,507,497,50,50,0.0001,1004,2
0.446,0.0001,558,546,50,50,0.0001,1104,2
0.45,0.0001,611,593,50,50,0.0001,1204,2
0.456,0.0001,661,643,50,50,0.0001,1304,2
0.456,0.0001,706,698,50,50,0.0001,1404,2
0.456,0.0001,751,753,50,50,0.0001,1504,2
0.458,0.0001,805,799,50,50,0.0001,1604,2
0.462,0.0001,856,848,50,50,0.0001,1704,2
0.466,0.0001,900,904,50,50,0.0001,1804,2
0.47,0.0001,948,956,50,50,0.0001,1904,2
0.474,0.0001,1005,999,50,50,0.0001,2004,2
0.492,0.0001,51,53,50,50,0.0001,104,3
0.49,0.0001,96,108,50,50,0.0001,204,3
0.492,0.0001,150,154,50,50,0.0001,304,3
0.492,0.0001,206,198,50,50,0.0001,404,3
0.498,0.0001,255,249,50,50,0.0001,504,3
0.498,0.0001,303,301,50,50,0.0001,604,3
0.496,0.0001,356,348,50,50,0.0001,704,3
0.496,0.0001,403,401,50,50,0.0001,804,3
0.496,0.0001,455,449,50,50,0.0001,904,3
0.498,0.0001,507,497,50,50,0.0001,1004,3
0.5,0.0001,562,542,50,50,0.0001,1104,3
0.502,0.0001,608,596,50,50,0.0001,1204,3
0.5,0.0001,666,638,50,50,0.0001,1304,3
0.502,0.0001,718,686,50,50,0.0001,1404,3
0.504,0.0001,767,737,50,50,0.0001,1504,3
0.502,0.0001,810,794,50,50,0.0001,1604,3
0.504,0.0001,862,842,50,50,0.0001,1704,3
0.5,0.0001,910,894,50,50,0.0001,1804,3
0.498,0.0001,957,947,50,50,0.0001,1904,3
0.502,0.0001,1005,999,50,50,0.0001,2004,3
0.512,0.0001,48,56,50,50,0.0001,104,4
0.512,0.0001,98,106,50,50,0.0001,204,4
0.516,0.0001,149,155,50,50,0.0001,304,4
0.518,0.0001,203,201,50,50,0.0001,404,4
0.518,0.0001,261,243,50,50,0.0001,504,4
0.52,0.0001,307,297,50,50,0.0001,604,4
0.52,0.0001,355,349,50,50,0.0001,704,4
0.522,0.0001,401,403,50,50,0.0001,804,4
0.522,0.0001,456,448,50,50,0.0001,904,4
0.522,0.0001,504,500,50,50,0.0001,1004,4
0.522,0.0001,556,548,50,50,0.0001,1104,4
0.518,0.0001,612,592,50,50,0.0001,1204,4
0.52,0.0001,653,651,50,50,0.0001,1304,4
0.52,0.0001,701,703,50,50,0.0001,1404,4
0.524,0.0001,762,742,50,50,0.0001,1504,4
0.526,0.0001,811,793,50,50,0.0001,1604,4
0.528,0.0001,856,848,50,50,0.0001,1704,4
0.528,0.0001,894,910,50,50,0.0001,1804,4
0.532,0.0001,949,955,50,50,0.0001,1904,4
0.54,0.0001,987,1017,50,50,0.0001,2004,4
0.53,0.0001,54,50,50,50,0.0001,104,5
0.528,0.0001,112,92,50,50,0.0001,204,5
0.53,0.0001,155,149,50,50,0.0001,304,5
0.53,0.0001,200,204,50,50,0.0001,404,5
0.536,0.0001,254,250,50,50,0.0001,504,5
0.536,0.0001,304,300,50,50,0.0001,604,5
0.534,0.0001,348,356,50,50,0.0001,704,5
0.534,0.0001,403,401,50,50,0.0001,804,5
0.534,0.0001,453,451,50,50,0.0001,904,5
0.534,0.0001,500,504,50,50,0.0001,1004,5
0.534,0.0001,549,555,50,50,0.0001,1104,5
0.532,0.0001,596,608,50,50,0.0001,1204,5
0.534,0.0001,641,663,50,50,0.0001,1304,5
0.532,0.0001,694,710,50,50,0.0001,1404,5
0.532,0.0001,743,761,50,50,0.0001,1504,5
0.532,0.0001,787,817,50,50,0.0001,1604,5
0.536,0.0001,841,863,50,50,0.0001,1704,5
0.54,0.0001,896,908,50,50,0.0001,1804,5
0.54,0.0001,955,949,50,50,0.0001,1904,5
0.538,0.0001,1006,998,50,50,0.0001,2004,5
0.47,0.0001,56,48,50,50,0.0001,104,6
0.47,0.0001,108,96,50,50,0.0001,204,6
0.47,0.0001,149,155,50,50,0.0001,304,6
0.47,0.0001,194,210,50,50,0.0001,404,6
0.47,0.0001,244,260,50,50,0.0001,504,6
0.47,0.0001,292,312,50,50,0.0001,604,6
0.47,0.0001,340,364,50,50,0.0001,704,6
0.47,0.0001,389,415,50,50,0.0001,804,6
0.472,0.0001,438,466,50,50,0.0001,904,6
0.474,0.0001,490,514,50,50,0.0001,1004,6
0.474,0.0001,539,565,50,50,0.0001,1104,6
0.476,0.0001,592,612,50,50,0.0001,1204,6
0.478,0.0001,641,663,50,50,0.0001,1304,6
0.478,0.0001,690,714,50,50,0.0001,1404,6
0.478,0.0001,745,759,50,50,0.0001,1504,6
0.48,0.0001,792,812,50,50,0.0001,1604,6
0.48,0.0001,840,864,50,50,0.0001,1704,6
0.482,0.0001,887,917,50,50,0.0001,1804,6
0.48,0.0001,939,965,50,50,0.0001,1904,6
0.482,0.0001,992,1012,50,50,0.0001,2004,6
0.486,0.0001,42,62,50,50,0.0001,104,7
0.486,0.0001,91,113,50,50,0.0001,204,7
0.486,0.0001,144,160,50,50,0.0001,304,7
0.49,0.0001,198,206,50,50,0.0001,404,7
0.492,0.0001,251,253,50,50,0.0001,504,7
0.492,0.0001,295,309,50,50,0.0001,604,7
0.496,0.0001,349,355,50,50,0.0001,704,7
0.496,0.0001,399,405,50,50,0.0001,804,7
0.494,0.0001,453,451,50,50,0.0001,904,7
0.494,0.0001,494,510,50,50,0.0001,1004,7
0.5,0.0001,544,560,50,50,0.0001,1104,7
0.498,0.0001,611,593,50,50,0.0001,1204,7
0.496,0.0001,660,644,50,50,0.0001,1304,7
0.498,0.0001,708,696,50,50,0.0001,1404,7
0.504,0.0001,754,750,50,50,0.0001,1504,7
0.504,0.0001,798,806,50,50,0.0001,1604,7
0.508,0.0001,849,855,50,50,0.0001,1704,7
0.514,0.0001,901,903,50,50,0.0001,1804,7
0.514,0.0001,953,951,50,50,0.0001,1904,7
0.52,0.0001,1002,1002,50,50,0.0001,2004,7
0.502,0.0001,56,48,50,50,0.0001,104,8
0.502,0.0001,113,91,50,50,0.0001,204,8
0.502,0.0001,168,136,50,50,0.0001,304,8
0.498,0.0001,218,186,50,50,0.0001,404,8
0.5,0.0001,260,244,50,50,0.0001,504,8
0.502,0.0001,322,282,50,50,0.0001,604,8
0.502,0.0001,382,322,50,50,0.0001,704,8
0.502,0.0001,430,374,50,50,0.0001,804,8
0.502,0.0001,480,424,50,50,0.0001,904,8
0.504,0.0001,526,478,50,50,0.0001,1004,8
0.508,0.0001,572,532,50,50,0.0001,1104,8
0.51,0.0001,627,577,50,50,0.0001,1204,8
0.51,0.0001,681,623,50,50,0.0001,1304,8
0.51,0.0001,730,674,50,50,0.0001,1404,8
0.512,0.0001,783,721,50,50,0.0001,1504,8
0.514,0.0001,819,785,50,50,0.0001,1604,8
0.516,0.0001,873,831,50,50,0.0001,1704,8
0.522,0.0001,914,890,50,50,0.0001,1804,8
0.518,0.0001,960,944,50,50,0.0001,1904,8
0.522,0.0001,1006,998,50,50,0.0001,2004,8
0.5,0.0001,51,53,50,50,0.0001,104,9
0.502,0.0001,103,101,50,50,0.0001,204,9
0.502,0.0001,149,155,50,50,0.0001,304,9
0.502,0.0001,202,202,50,50,0.0001,404,9
0.504,0.0001,256,248,50,50,0.0001,504,9
0.508,0.0001,314,290,50,50,0.0001,604,9
0.508,0.0001,356,348,50,50,0.0001,704,9
0.512,0.0001,398,406,50,50,0.0001,804,9
0.512,0.0001,461,443,50,50,0.0001,904,9
0.512,0.0001,520,484,50,50,0.0001,1004,9
0.51,0.0001,569,535,50,50,0.0001,1104,9
0.514,0.0001,621,583,50,50,0.0001,1204,9
0.514,0.0001,665,639,50,50,0.0001,1304,9
0.52,0.0001,716,688,50,50,0.0001,1404,9
0.524,0.0001,760,744,50,50,0.0001,1504,9
0.52,0.0001,810,794,50,50,0.0001,1604,9
0.522,0.0001,857,847,50,50,0.0001,1704,9
0.524,0.0001,903,901,50,50,0.0001,1804,9
0.522,0.0001,954,950,50,50,0.0001,1904,9
0.524,0.0001,1001,1003,50,50,0.0001,2004,9
0.482,0.0001,41,63,50,50,0.0001,104,10
0.482,0.0001,86,118,50,50,0.0001,204,10
0.482,0.0001,126,178,50,50,0.0001,304,10
0.48,0.0001,178,226,50,50,0.0001,404,10
0.48,0.0001,226,278,50,50,0.0001,504,10
0.48,0.0001,272,332,50,50,0.0001,604,10
0.48,0.0001,323,381,50,50,0.0001,704,10
0.482,0.0001,372,432,50,50,0.0001,804,10
0.482,0.0001,423,481,50,50,0.0001,904,10
0.482,0.0001,477,527,50,50,0.0001,1004,10
0.482,0.0001,520,584,50,50,0.0001,1104,10
0.48,0.0001,573,631,50,50,0.0001,1204,10
0.48,0.0001,627,677,50,50,0.0001,1304,10
0.484,0.0001,678,726,50,50,0.0001,1404,10
0.484,0.0001,733,771,50,50,0.0001,1504,10
0.484,0.0001,777,827,50,50,0.0001,1604,10
0.486,0.0001,834,870,50,50,0.0001,1704,10
0.494,0.0001,883,921,50,50,0.0001,1804,10
0.5,0.0001,943,961,50,50,0.0001,1904,10
0.5,0.0001,989,1015,50,50,0.0001,2004,10
0.51,0.0001,56,48,50,50,0.0001,104,11
0.508,0.0001,114,90,50,50,0.0001,204,11
0.508,0.0001,161,143,50,50,0.0001,304,11
0.512,0.0001,216,188,50,50,0.0001,404,11
0.514,0.0001,272,232,50,50,0.0001,504,11
0.518,0.0001,323,281,50,50,0.0001,604,11
0.522,0.0001,374,330,50,50,0.0001,704,11
0.522,0.0001,426,378,50,50,0.0001,804,11
0.524,0.0001,470,434,50,50,0.0001,904,11
0.524,0.0001,511,493,50,50,0.0001,1004,11
0.524,0.0001,554,550,50,50,0.0001,1104,11
0.526,0.0001,610,594,50,50,0.0001,1204,11
0.53,0.0001,654,650,50,50,0.0001,1304,11
0.532,0.0001,700,704,50,50,0.0001,1404,11
0.528,0.0001,745,759,50,50,0.0001,1504,11
0.53,0.0001,795,809,50,50,0.0001,1604,11
0.538,0.0001,842,862,50,50,0.0001,1704,11
0.542,0.0001,893,911,50,50,0.0001,1804,11
0.54,0.0001,949,955,50,50,0.0001,1904,11
0.542,0.0001,988,1016,50,50,0.0001,2004,11
0.524,0.0001,56,48,50,50,0.0001,104,12
0.524,0.0001,101,103,50,50,0.0001,204,12
0.524,0.0001,148,156,50,50,0.0001,304,12
0.524,0.0001,209,195,50,50,0.0001,404,12
0.524,0.0001,256,248,50,50,0.0001,504,12
0.524,0.0001,311,293,50,50,0.0001,604,12
0.524,0.0001,354,350,50,50,0.0001,704,12
0.522,0.0001,406,398,50,50,0.0001,804,12
0.522,0.0001,457,447,50,50,0.0001,904,12
0.522,0.0001,515,489,50,50,0.0001,1004,12
0.524,0.0001,561,543,50,50,0.0001,1104,12
0.524,0.0001,612,592,50,50,0.0001,1204,12
0.524,0.0001,662,642,50,50,0.0001,1304,12
0.528,0.0001,706,698,50,50,0.0001,1404,12
0.528,0.0001,749,755,50,50,0.0001,1504,12
0.53,0.0001,801,803,50,50,0.0001,1604,12
0.53,0.0001,846,858,50,50,0.0001,1704,12
0.53,0.0001,905,899,50,50,0.0001,1804,12
0.532,0.0001,955,949,50,50,0.0001,1904,12
0.532,0.0001,1014,990,50,50,0.0001,2004,12
0.476,0.0001,60,44,50,50,0.0001,104,13
0.476,0.0001,107,97,50,50,0.0001,204,13
0.478,0.0001,161,143,50,50,0.0001,304,13
0.478,0.0001,208,196,50,50,0.0001,404,13
0.478,0.0001,251,253,50,50,0.0001,504,13
0.476,0.0001,309,295,50,50,0.0001,604,13
0.478,0.0001,362,342,50,50,0.0001,704,13
0.478,0.0001,410,394,50,50,0.0001,804,13
0.476,0.0001,453,451,50,50,0.0001,904,13
0.478,0.0001,498,506,50,50,0.0001,1004,13
0.48,0.0001,547,557,50,50,0.0001,1104,13
0.48,0.0001,603,601,50,50,0.0001,1204,13
0.476,0.0001,653,651,50,50,0.0001,1304,13
0.48,0.0001,710,694,50,50,0.0001,1404,13
0.486,0.0001,750,754,50,50,0.0001,1504,13
0.486,0.0001,813,791,50,50,0.0001,1604,13
0.486,0.0001,860,844,50,50,0.0001,1704,13
0.488,0.0001,911,893,50,50,0.0001,1804,13
0.496,0.0001,959,945,50,50,0.0001,1904,13
0.496,0.0001,1010,994,50,50,0.0001,2004,13
0.526,0.0001,52,52,50,50,0.0001,104,14
0.53,0.0001,98,106,50,50,0.0001,204,14
0.528,0.0001,154,150,50,50,0.0001,304,14
0.528,0.0001,202,202,50,50,0.0001,404,14
0.53,0.0001,250,254,50,50,0.0001,504,14
0.532,0.0001,308,296,50,50,0.0001,604,14
0.538,0.0001,360,344,50,50,0.0001,704,14
0.536,0.0001,408,396,50,50,0.0001,804,14
0.536,0.0001,461,443,50,50,0.0001,904,14
0.54,0.0001,508,496,50,50,0.0001,1004,14
0.542,0.0001,572,532,50,50,0.0001,1104,14
0.538,0.0001,626,578,50,50,0.0001,1204,14
0.542,0.0001,667,637,50,50,0.0001,1304,14
0.54,0.0001,719,685,50,50,0.0001,1404,14
0.54,0.0001,768,736,50,50,0.0001,1504,14
0.54,0.0001,812,792,50,50,0.0001,1604,14
0.54,0.0001,862,842,50,50,0.0001,1704,14
0.548,0.0001,911,893,50,50,0.0001,1804,14
0.552,0.0001,967,937,50,50,0.0001,1904,14
0.554,0.0001,1022,982,50,50,0.0001,2004,14
0.532,0.0001,48,56,50,50,0.0001,104,15
0.534,0.0001,96,108,50,50,0.0001,204,15
0.534,0.0001,147,157,50,50,0.0001,304,15
0.534,0.0001,198,206,50,50,0.0001,404,15
0.534,0.0001,244,260,50,50,0.0001,504,15
0.534,0.0001,294,310,50,50,0.0001,604,15
0.538,0.0001,344,360,50,50,0.0001,704,15
0.538,0.0001,391,413,50,50,0.0001,804,15
0.542,0.0001,442,462,50,50,0.0001,904,15
0.542,0.0001,498,506,50,50,0.0001,1004,15
0.542,0.0001,552,552,50,50,0.0001,1104,15
0.542,0.0001,612,592,50,50,0.0001,1204,15
0.546,0.0001,668,636,50,50,0.0001,1304,15
0.548,0.0001,723,681,50,50,0.0001,1404,15
0.55,0.0001,777,727,50,50,0.0001,1504,15
0.55,0.0001,832,772,50,50,0.0001,1604,15
0.554,0.0001,877,827,50,50,0.0001,1704,15
0.554,0.0001,920,884,50,50,0.0001,1804,15
0.55,0.0001,970,934,50,50,0.0001,1904,15
0.55,0.0001,1017,987,50,50,0.0001,2004,15
0.492,0.0001,62,42,50,50,0.0001,104,16
0.492,0.0001,115,89,50,50,0.0001,204,16
0.492,0.0001,162,142,50,50,0.0001,304,16
0.492,0.0001,217,187,50,50,0.0001,404,16
0.492,0.0001,268,236,50,50,0.0001,504,16
0.492,0.0001,321,283,50,50,0.0001,604,16
0.494,0.0001,369,335,50,50,0.0001,704,16
0.494,0.0001,424,380,50,50,0.0001,804,16
0.496,0.0001,472,432,50,50,0.0001,904,16
0.5,0.0001,522,482,50,50,0.0001,1004,16
0.5,0.0001,577,527,50,50,0.0001,1104,16
0.502,0.0001,621,583,50,50,0.0001,1204,16
0.504,0.0001,667,637,50,50,0.0001,1304,16
0.51,0.0001,710,694,50,50,0.0001,1404,16
0.51,0.0001,765,739,50,50,0.0001,1504,16
0.518,0.0001,815,789,50,50,0.0001,1604,16
0.52,0.0001,859,845,50,50,0.0001,1704,16
0.522,0.0001,907,897,50,50,0.0001,1804,16
0.528,0.0001,960,944,50,50,0.0001,1904,16
0.534,0.0001,1010,994,50,50,0.0001,2004,16
0.484,0.0001,50,54,50,50,0.0001,104,17
0.48,0.0001,103,101,50,50,0.0001,204,17
0.48,0.0001,159,145,50,50,0.0001,304,17
0.48,0.0001,205,199,50,50,0.0001,404,17
0.48,0.0001,250,254,50,50,0.0001,504,17
0.482,0.0001,301,303,50,50,0.0001,604,17
0.48,0.0001,347,357,50,50,0.0001,704,17
0.48,0.0001,399,405,50,50,0.0001,804,17
0.484,0.0001,455,449,50,50,0.0001,904,17
0.49,0.0001,504,500,50,50,0.0001,1004,17
0.49,0.0001,550,554,50,50,0.0001,1104,17
0.494,0.0001,600,604,50,50,0.0001,1204,17
0.496,0.0001,657,647,50,50,0.0001,1304,17
0.5,0.0001,711,693,50,50,0.0001,1404,17
0.506,0.0001,753,751,50,50,0.0001,1504,17
0.508,0.0001,805,799,50,50,0.0001,1604,17
0.51,0.0001,855,849,50,50,0.0001,1704,17
0.512,0.0001,907,897,50,50,0.0001,1804,17
0.518,0.0001,954,950,50,50,0.0001,1904,17
0.522,0.0001,1007,997,50,50,0.0001,2004,17
0.478,0.0001,33,71,50,50,0.0001,104,18
0.478,0.0001,85,119,50,50,0.0001,204,18
0.478,0.0001,136,168,50,50,0.0001,304,18
0.48,0.0001,185,219,50,50,0.0001,404,18
0.486,0.0001,247,257,50,50,0.0001,504,18
0.486,0.0001,292,312,50,50,0.0001,604,18
0.484,0.0001,340,364,50,50,0.0001,704,18
0.49,0.0001,384,420,50,50,0.0001,804,18
0.49,0.0001,439,465,50,50,0.0001,904,18
0.49,0.0001,494,510,50,50,0.0001,1004,18
0.492,0.0001,540,564,50,50,0.0001,1104,18
0.494,0.0001,593,611,50,50,0.0001,1204,18
0.494,0.0001,642,662,50,50,0.0001,1304,18
0.494,0.0001,692,712,50,50,0.0001,1404,18
0.496,0.0001,741,763,50,50,0.0001,1504,18
0.5,0.0001,792,812,50,50,0.0001,1604,18
0.504,0.0001,846,858,50,50,0.0001,1704,18
0.504,0.0001,892,912,50,50,0.0001,1804,18
0.518,0.0001,947,957,50,50,0.0001,1904,18
0.522,0.0001,999,1005,50,50,0.0001,2004,18
0.508,0.0001,51,53,50,50,0.0001,104,19
0.508,0.0001,101,103,50,50,0.0001,204,19
0.51,0.0001,150,154,50,50,0.0001,304,19
0.51,0.0001,209,195,50,50,0.0001,404,19
0.51,0.0001,256,248,50,50,0.0001,504,19
0.508,0.0001,306,298,50,50,0.0001,604,19
0.508,0.0001,358,346,50,50,0.0001,704,19
0.51,0.0001,408,396,50,50,0.0001,804,19
0.512,0.0001,465,439,50,50,0.0001,904,19
0.516,0.0001,513,491,50,50,0.0001,1004,19
0.514,0.0001,564,540,50,50,0.0001,1104,19
0.512,0.0001,610,594,50,50,0.0001,1204,19
0.514,0.0001,659,645,50,50,0.0001,1304,19
0.522,0.0001,702,702,50,50,0.0001,1404,19
0.524,0.0001,750,754,50,50,0.0001,1504,19
0.53,0.0001,802,802,50,50,0.0001,1604,19
0.53,0.0001,850,854,50,50,0.0001,1704,19
0.532,0.0001,898,906,50,50,0.0001,1804,19
0.532,0.0001,955,949,50,50,0.0001,1904,19
0.536,0.0001,1004,1000,50,50,0.0001,2004,19
0.512,0.0001,45,59,50,50,0.0001,104,20
0.514,0.0001,89,115,50,50,0.0001,204,20
0.514,0.0001,142,162,50,50,0.0001,304,20
0.514,0.0001,198,206,50,50,0.0001,404,20
0.516,0.0001,253,251,50,50,0.0001,504,20
0.516,0.0001,301,303,50,50,0.0001,604,20
0.516,0.0001,361,343,50,50,0.0001,704,20
0.514,0.0001,419,385,50,50,0.0001,804,20
0.516,0.0001,465,439,50,50,0.0001,904,20
0.516,0.0001,506,498,50,50,0.0001,1004,20
0.52,0.0001,554,550,50,50,0.0001,1104,20
0.52,0.0001,597,607,50,50,0.0001,1204,20
0.522,0.0001,647,657,50,50,0.0001,1304,20
0.516,0.0001,696,708,50,50,0.0001,1404,20
0.52,0.0001,748,756,50,50,0.0001,1504,20
0.518,0.0001,796,808,50,50,0.0001,1604,20
0.52,0.0001,851,853,50,50,0.0001,1704,20
0.522,0.0001,908,896,50,50,0.0001,1804,20
0.522,0.0001,962,942,50,50,0.0001,1904,20
0.526,0.0001,1005,999,50,50,0.0001,2004,20
0.534,0.0001,51,53,50,50,0.001,104,1
0.54,0.0001,108,96,50,50,0.001,204,1
0.546,0.0001,155,149,50,50,0.001,304,1
0.546,0.0001,207,197,50,50,0.001,404,1
0.56,0.0001,257,247,50,50,0.001,504,1
0.566,0.0001,305,299,50,50,0.001,604,1
0.562,0.0001,361,343,50,50,0.001,704,1
0.566,0.0001,415,389,50,50,0.001,804,1
0.578,0.0001,469,435,50,50,0.001,904,1
0.594,0.0001,523,481,50,50,0.001,1004,1
0.578,0.0001,571,533,50,50,0.001,1104,1
0.598,0.0001,614,590,50,50,0.001,1204,1
0.61,0.0001,665,639,50,50,0.001,1304,1
0.632,0.0001,712,692,50,50,0.001,1404,1
0.65,0.0001,753,751,50,50,0.001,1504,1
0.666,0.0001,801,803,50,50,0.001,1604,1
0.682,0.0001,843,861,50,50,0.001,1704,1
0.704,0.0001,899,905,50,50,0.001,1804,1
0.714,0.0001,947,957,50,50,0.001,1904,1
0.74,0.0001,988,1016,50,50,0.001,2004,1
0.508,0.0001,55,49,50,50,0.001,104,2
0.512,0.0001,106,98,50,50,0.001,204,2
0.514,0.0001,160,144,50,50,0.001,304,2
0.522,0.0001,216,188,50,50,0.001,404,2
0.522,0.0001,263,241,50,50,0.001,504,2
0.52,0.0001,320,284,50,50,0.001,604,2
0.526,0.0001,369,335,50,50,0.001,704,2
0.542,0.0001,415,389,50,50,0.001,804,2
0.552,0.0001,463,441,50,50,0.001,904,2
0.57,0.0001,517,487,50,50,0.001,1004,2
0.58,0.0001,565,539,50,50,0.001,1104,2
0.582,0.0001,616,588,50,50,0.001,1204,2
0.598,0.0001,664,640,50,50,0.001,1304,2
0.598,0.0001,710,694,50,50,0.001,1404,2
0.618,0.0001,756,748,50,50,0.001,1504,2
0.634,0.0001,807,797,50,50,0.001,1604,2
0.65,0.0001,868,836,50,50,0.001,1704,2
0.672,0.0001,919,885,50,50,0.001,1804,2
0.68,0.0001,967,937,50,50,0.001,1904,2
0.702,0.0001,1012,992,50,50,0.001,2004,2
0.508,0.0001,51,53,50,50,0.001,104,3
0.516,0.0001,109,95,50,50,0.001,204,3
0.514,0.0001,164,140,50,50,0.001,304,3
0.518,0.0001,216,188,50,50,0.001,404,3
0.522,0.0001,266,238,50,50,0.001,504,3
0.542,0.0001,306,298,50,50,0.001,604,3
0.546,0.0001,362,342,50,50,0.001,704,3
0.554,0.0001,413,391,50,50,0.001,804,3
0.546,0.0001,462,442,50,50,0.001,904,3
0.558,0.0001,518,486,50,50,0.001,1004,3
0.57,0.0001,569,535,50,50,0.001,1104,3
0.586,0.0001,616,588,50,50,0.001,1204,3
0.6,0.0001,662,642,50,50,0.001,1304,3
0.62,0.0001,710,694,50,50,0.001,1404,3
0.648,0.0001,760,744,50,50,0.001,1504,3
0.664,0.0001,806,798,50,50,0.001,1604,3
0.69,0.0001,853,851,50,50,0.001,1704,3
0.71,0.0001,901,903,50,50,0.001,1804,3
0.714,0.0001,949,955,50,50,0.001,1904,3
0.746,0.0001,1000,1004,50,50,0.001,2004,3
0.474,0.0001,48,56,50,50,0.001,104,4
0.48,0.0001,95,109,50,50,0.001,204,4
0.482,0.0001,141,163,50,50,0.001,304,4
0.488,0.0001,194,210,50,50,0.001,404,4
0.494,0.0001,245,259,50,50,0.001,504,4
0.504,0.0001,308,296,50,50,0.001,604,4
0.508,0.0001,353,351,50,50,0.001,704,4
0.524,0.0001,406,398,50,50,0.001,804,4
0.53,0.0001,458,446,50,50,0.001,904,4
0.542,0.0001,502,502,50,50,0.001,1004,4
0.562,0.0001,550,554,50,50,0.001,1104,4
0.568,0.0001,599,605,50,50,0.001,1204,4
0.572,0.0001,648,656,50,50,0.001,1304,4
0.594,0.0001,702,702,50,50,0.001,1404,4
0.61,0.0001,753,751,50,50,0.001,1504,4
0.628,0.0001,807,797,50,50,0.001,1604,4
0.648,0.0001,862,842,50,50,0.001,1704,4
0.676,0.0001,912,892,50,50,0.001,1804,4
0.71,0.0001,962,942,50,50,0.001,1904,4
0.726,0.0001,1008,996,50,50,0.001,2004,4
0.476,0.0001,49,55,50,50,0.001,104,5
0.48,0.0001,95,109,50,50,0.001,204,5
0.48,0.0001,150,154,50,50,0.001,304,5
0.482,0.0001,206,198,50,50,0.001,404,5
0.482,0.0001,259,245,50,50,0.001,504,5
0.488,0.0001,298,306,50,50,0.001,604,5
0.498,0.0001,349,355,50,50,0.001,704,5
0.488,0.0001,390,414,50,50,0.001,804,5
0.488,0.0001,443,461,50,50,0.001,904,5
0.496,0.0001,498,506,50,50,0.001,1004,5
0.522,0.0001,546,558,50,50,0.001,1104,5
0.544,0.0001,598,606,50,50,0.001,1204,5
0.568,0.0001,638,666,50,50,0.001,1304,5
0.574,0.0001,692,712,50,50,0.001,1404,5
0.584,0.0001,733,771,50,50,0.001,1504,5
0.604,0.0001,785,819,50,50,0.001,1604,5
0.63,0.0001,834,870,50,50,0.001,1704,5
0.672,0.0001,890,914,50,50,0.001,1804,5
0.72,0.0001,939,965,50,50,0.001,1904,5
0.744,0.0001,993,1011,50,50,0.001,2004,5
0.492,0.0001,46,58,50,50,0.001,104,6
0.492,0.0001,96,108,50,50,0.001,204,6
0.494,0.0001,148,156,50,50,0.001,304,6
0.502,0.0001,198,206,50,50,0.001,404,6
0.508,0.0001,247,257,50,50,0.001,504,6
0.534,0.0001,293,311,50,50,0.001,604,6
0.53,0.0001,340,364,50,50,0.001,704,6
0.55,0.0001,388,416,50,50,0.001,804,6
0.562,0.0001,440,464,50,50,0.001,904,6
0.588,0.0001,491,513,50,50,0.001,1004,6
0.616,0.0001,541,563,50,50,0.001,1104,6
0.634,0.0001,588,616,50,50,0.001,1204,6
0.66,0.0001,627,677,50,50,0.001,1304,6
0.68,0.0001,676,728,50,50,0.001,1404,6
0.688,0.0001,725,779,50,50,0.001,1504,6
0.704,0.0001,777,827,50,50,0.001,1604,6
0.73,0.0001,829,875,50,50,0.001,1704,6
0.738,0.0001,891,913,50,50,0.001,1804,6
0.77,0.0001,951,953,50,50,0.001,1904,6
0.8,0.0001,1003,1001,50,50,0.001,2004,6
0.52,0.0001,59,45,50,50,0.001,104,7
0.53,0.0001,105,99,50,50,0.001,204,7
0.528,0.0001,154,150,50,50,0.001,304,7
0.542,0.0001,212,192,50,50,0.001,404,7
0.55,0.0001,257,247,50,50,0.001,504,7
0.554,0.0001,307,297,50,50,0.001,604,7
0.562,0.0001,348,356,50,50,0.001,704,7
0.578,0.0001,401,403,50,50,0.001,804,7
0.592,0.0001,457,447,50,50,0.001,904,7
0.598,0.0001,496,508,50,50,0.001,1004,7
0.604,0.0001,545,559,50,50,0.001,1104,7
0.62,0.0001,600,604,50,50,0.001,1204,7
0.628,0.0001,651,653,50,50,0.001,1304,7
0.652,0.0001,697,707,50,50,0.001,1404,7
0.672,0.0001,741,763,50,50,0.001,1504,7
0.69,0.0001,796,808,50,50,0.001,1604,7
0.716,0.0001,845,859,50,50,0.001,1704,7
0.738,0.0001,900,904,50,50,0.001,1804,7
0.764,0.0001,947,957,50,50,0.001,1904,7
0.786,0.0001,1001,1003,50,50,0.001,2004,7
0.556,0.0001,53,51,50,50,0.001,104,8
0.556,0.0001,108,96,50,50,0.001,204,8
0.566,0.0001,163,141,50,50,0.001,304,8
0.572,0.0001,215,189,50,50,0.001,404,8
0.572,0.0001,268,236,50,50,0.001,504,8
0.568,0.0001,306,298,50,50,0.001,604,8
0.568,0.0001,361,343,50,50,0.001,704,8
0.574,0.0001,417,387,50,50,0.001,804,8
0.578,0.0001,472,432,50,50,0.001,904,8
0.582,0.0001,516,488,50,50,0.001,1004,8
0.588,0.0001,566,538,50,50,0.001,1104,8
0.61,0.0001,617,587,50,50,0.001,1204,8
0.626,0.0001,675,629,50,50,0.001,1304,8
0.636,0.0001,727,677,50,50,0.001,1404,8
0.632,0.0001,774,730,50,50,0.001,1504,8
0.64,0.0001,824,780,50,50,0.001,1604,8
0.65,0.0001,873,831,50,50,0.001,1704,8
0.678,0.0001,919,885,50,50,0.001,1804,8
0.698,0.0001,961,943,50,50,0.001,1904,8
0.734,0.0001,1006,998,50,50,0.001,2004,8
0.478,0.0001,41,63,50,50,0.001,104,9
0.478,0.0001,91,113,50,50,0.001,204,9
0.478,0.0001,140,164,50,50,0.001,304,9
0.48,0.0001,195,209,50,50,0.001,404,9
0.482,0.0001,248,256,50,50,0.001,504,9
0.482,0.0001,303,301,50,50,0.001,604,9
0.482,0.0001,352,352,50,50,0.001,704,9
0.484,0.0001,401,403,50,50,0.001,804,9
0.5,0.0001,455,449,50,50,0.001,904,9
0.52,0.0001,511,493,50,50,0.001,1004,9
0.528,0.0001,555,549,50,50,0.001,1104,9
0.546,0.0001,608,596,50,50,0.001,1204,9
0.578,0.0001,657,647,50,50,0.001,1304,9
0.602,0.0001,708,696,50,50,0.001,1404,9
0.626,0.0001,751,753,50,50,0.001,1504,9
0.65,0.0001,799,805,50,50,0.001,1604,9
0.666,0.0001,852,852,50,50,0.001,1704,9
0.684,0.0001,896,908,50,50,0.001,1804,9
0.714,0.0001,946,958,50,50,0.001,1904,9
0.74,0.0001,991,1013,50,50,0.001,2004,9
0.518,0.0001,58,46,50,50,0.001,104,10
0.52,0.0001,97,107,50,50,0.001,204,10
0.53,0.0001,146,158,50,50,0.001,304,10
0.542,0.0001,197,207,50,50,0.001,404,10
0.56,0.0001,252,252,50,50,0.001,504,10
0.57,0.0001,306,298,50,50,0.001,604,10
0.572,0.0001,351,353,50,50,0.001,704,10
0.58,0.0001,407,397,50,50,0.001,804,10
0.6,0.0001,465,439,50,50,0.001,904,10
0.612,0.0001,515,489,50,50,0.001,1004,10
0.618,0.0001,560,544,50,50,0.001,1104,10
0.626,0.0001,620,584,50,50,0.001,1204,10
0.636,0.0001,672,632,50,50,0.001,1304,10
0.664,0.0001,720,684,50,50,0.001,1404,10
0.678,0.0001,774,730,50,50,0.001,1504,10
0.69,0.0001,813,791,50,50,0.001,1604,10
0.702,0.0001,872,832,50,50,0.001,1704,10
0.724,0.0001,920,884,50,50,0.001,1804,10
0.748,0.0001,968,936,50,50,0.001,1904,10
0.778,0.0001,1015,989,50,50,0.001,2004,10
0.484,0.0001,50,54,50,50,0.001,104,11
0.498,0.0001,97,107,50,50,0.001,204,11
0.516,0.0001,154,150,50,50,0.001,304,11
0.514,0.0001,200,204,50,50,0.001,404,11
0.52,0.0001,258,246,50,50,0.001,504,11
0.53,0.0001,316,288,50,50,0.001,604,11
0.53,0.0001,369,335,50,50,0.001,704,11
0.536,0.0001,412,392,50,50,0.001,804,11
0.546,0.0001,461,443,50,50,0.001,904,11
0.56,0.0001,514,490,50,50,0.001,1004,11
0.566,0.0001,558,546,50,50,0.001,1104,11
0.59,0.0001,601,603,50,50,0.001,1204,11
0.608,0.0001,653,651,50,50,0.001,1304,11
0.606,0.0001,707,697,50,50,0.001,1404,11
0.638,0.0001,761,743,50,50,0.001,1504,11
0.66,0.0001,803,801,50,50,0.001,1604,11
0.682,0.0001,848,856,50,50,0.001,1704,11
0.702,0.0001,906,898,50,50,0.001,1804,11
0.722,0.0001,950,954,50,50,0.001,1904,11
0.746,0.0001,995,1009,50,50,0.001,2004,11
0.502,0.0001,58,46,50,50,0.001,104,12
0.502,0.0001,105,99,50,50,0.001,204,12
0.496,0.0001,154,150,50,50,0.001,304,12
0.498,0.0001,203,201,50,50,0.001,404,12
0.506,0.0001,256,248,50,50,0.001,504,12
0.52,0.0001,310,294,50,50,0.001,604,12
0.544,0.0001,363,341,50,50,0.001,704,12
0.544,0.0001,407,397,50,50,0.001,804,12
0.55,0.0001,459,445,50,50,0.001,904,12
0.562,0.0001,506,498,50,50,0.001,1004,12
0.566,0.0001,547,557,50,50,0.001,1104,12
0.582,0.0001,595,609,50,50,0.001,1204,12
0.598,0.0001,652,652,50,50,0.001,1304,12
0.608,0.0001,704,700,50,50,0.001,1404,12
0.604,0.0001,752,752,50,50,0.001,1504,12
0.612,0.0001,806,798,50,50,0.001,1604,12
0.62,0.0001,864,840,50,50,0.001,1704,12
0.64,0.0001,909,895,50,50,0.001,1804,12
0.656,0.0001,960,944,50,50,0.001,1904,12
0.69,0.0001,998,1006,50,50,0.001,2004,12
0.484,0.0001,56,48,50,50,0.001,104,13
0.486,0.0001,105,99,50,50,0.001,204,13
0.486,0.0001,152,152,50,50,0.001,304,13
0.486,0.0001,204,200,50,50,0.001,404,13
0.492,0.0001,253,251,50,50,0.001,504,13
0.506,0.0001,305,299,50,50,0.001,604,13
0.512,0.0001,353,351,50,50,0.001,704,13
0.54,0.0001,404,400,50,50,0.001,804,13
0.552,0.0001,455,449,50,50,0.001,904,13
0.55,0.0001,502,502,50,50,0.001,1004,13
0.566,0.0001,552,552,50,50,0.001,1104,13
0.582,0.0001,601,603,50,50,0.001,1204,13
0.588,0.0001,656,648,50,50,0.001,1304,13
0.628,0.0001,701,703,50,50,0.001,1404,13
0.65,0.0001,742,762,50,50,0.001,1504,13
0.67,0.0001,797,807,50,50,0.001,1604,13
0.676,0.0001,852,852,50,50,0.001,1704,13
0.684,0.0001,912,892,50,50,0.001,1804,13
0.702,0.0001,954,950,50,50,0.001,1904,13
0.744,0.0001,1007,997,50,50,0.001,2004,13
0.498,0.0001,50,54,50,50,0.001,104,14
0.506,0.0001,101,103,50,50,0.001,204,14
0.504,0.0001,144,160,50,50,0.001,304,14
0.528,0.0001,197,207,50,50,0.001,404,14
0.544,0.0001,244,260,50,50,0.001,504,14
0.554,0.0001,286,318,50,50,0.001,604,14
0.576,0.0001,337,367,50,50,0.001,704,14
0.584,0.0001,378,426,50,50,0.001,804,14
0.584,0.0001,432,472,50,50,0.001,904,14
0.596,0.0001,488,516,50,50,0.001,1004,14
0.6,0.0001,543,561,50,50,0.001,1104,14
0.616,0.0001,591,613,50,50,0.001,1204,14
0.658,0.0001,650,654,50,50,0.001,1304,14
0.684,0.0001,694,710,50,50,0.001,1404,14
0.694,0.0001,745,759,50,50,0.001,1504,14
0.72,0.0001,796,808,50,50,0.001,1604,14
0.742,0.0001,851,853,50,50,0.001,1704,14
0.762,0.0001,904,900,50,50,0.001,1804,14
0.78,0.0001,947,957,50,50,0.001,1904,14
0.8,0.0001,1000,1004,50,50,0.001,2004,14
0.544,0.0001,49,55,50,50,0.001,104,15
0.544,0.0001,84,120,50,50,0.001,204,15
0.548,0.0001,145,159,50,50,0.001,304,15
0.548,0.0001,184,220,50,50,0.001,404,15
0.552,0.0001,227,277,50,50,0.001,504,15
0.56,0.0001,279,325,50,50,0.001,604,15
0.566,0.0001,325,379,50,50,0.001,704,15
0.572,0.0001,369,435,50,50,0.001,804,15
0.566,0.0001,419,485,50,50,0.001,904,15
0.57,0.0001,466,538,50,50,0.001,1004,15
0.58,0.0001,517,587,50,50,0.001,1104,15
0.582,0.0001,571,633,50,50,0.001,1204,15
0.596,0.0001,629,675,50,50,0.001,1304,15
0.624,0.0001,674,730,50,50,0.001,1404,15
0.618,0.0001,731,773,50,50,0.001,1504,15
0.66,0.0001,782,822,50,50,0.001,1604,15
0.686,0.0001,839,865,50,50,0.001,1704,15
0.708,0.0001,884,920,50,50,0.001,1804,15
0.752,0.0001,941,963,50,50,0.001,1904,15
0.788,0.0001,984,1020,50,50,0.001,2004,15
0.504,0.0001,53,51,50,50,0.001,104,16
0.504,0.0001,113,91,50,50,0.001,204,16
0.51,0.0001,167,137,50,50,0.001,304,16
0.524,0.0001,222,182,50,50,0.001,404,16
0.536,0.0001,273,231,50,50,0.001,504,16
0.548,0.0001,334,270,50,50,0.001,604,16
0.55,0.0001,392,312,50,50,0.001,704,16
0.548,0.0001,444,360,50,50,0.001,804,16
0.564,0.0001,489,415,50,50,0.001,904,16
0.586,0.0001,542,462,50,50,0.001,1004,16
0.594,0.0001,593,511,50,50,0.001,1104,16
0.618,0.0001,640,564,50,50,0.001,1204,16
0.63,0.0001,687,617,50,50,0.001,1304,16
0.642,0.0001,733,671,50,50,0.001,1404,16
0.662,0.0001,789,715,50,50,0.001,1504,16
0.684,0.0001,837,767,50,50,0.001,1604,16
0.698,0.0001,887,817,50,50,0.001,1704,16
0.698,0.0001,931,873,50,50,0.001,1804,16
0.734,0.0001,972,932,50,50,0.001,1904,16
0.746,0.0001,1010,994,50,50,0.001,2004,16
0.506,0.0001,55,49,50,50,0.001,104,17
0.504,0.0001,105,99,50,50,0.001,204,17
0.506,0.0001,155,149,50,50,0.001,304,17
0.518,0.0001,215,189,50,50,0.001,404,17
0.53,0.0001,262,242,50,50,0.001,504,17
0.54,0.0001,307,297,50,50,0.001,604,17
0.54,0.0001,356,348,50,50,0.001,704,17
0.546,0.0001,395,409,50,50,0.001,804,17
0.556,0.0001,443,461,50,50,0.001,904,17
0.572,0.0001,492,512,50,50,0.001,1004,17
0.582,0.0001,539,565,50,50,0.001,1104,17
0.618,0.0001,594,610,50,50,0.001,1204,17
0.65,0.0001,649,655,50,50,0.001,1304,17
0.674,0.0001,705,699,50,50,0.001,1404,17
0.69,0.0001,757,747,50,50,0.001,1504,17
0.716,0.0001,811,793,50,50,0.001,1604,17
0.728,0.0001,854,850,50,50,0.001,1704,17
0.74,0.0001,904,900,50,50,0.001,1804,17
0.762,0.0001,954,950,50,50,0.001,1904,17
0.798,0.0001,998,1006,50,50,0.001,2004,17
0.528,0.0001,50,54,50,50,0.001,104,18
0.522,0.0001,99,105,50,50,0.001,204,18
0.524,0.0001,144,160,50,50,0.001,304,18
0.524,0.0001,195,209,50,50,0.001,404,18
0.522,0.0001,244,260,50,50,0.001,504,18
0.536,0.0001,289,315,50,50,0.001,604,18
0.548,0.0001,343,361,50,50,0.001,704,18
0.568,0.0001,386,418,50,50,0.001,804,18
0.574,0.0001,434,470,50,50,0.001,904,18
0.576,0.0001,482,522,50,50,0.001,1004,18
0.582,0.0001,529,575,50,50,0.001,1104,18
0.598,0.0001,585,619,50,50,0.001,1204,18
0.622,0.0001,639,665,50,50,0.001,1304,18
0.632,0.0001,685,719,50,50,0.001,1404,18
0.656,0.0001,726,778,50,50,0.001,1504,18
0.68,0.0001,783,821,50,50,0.001,1604,18
0.684,0.0001,830,874,50,50,0.001,1704,18
0.698,0.0001,881,923,50,50,0.001,1804,18
0.712,0.0001,931,973,50,50,0.001,1904,18
0.728,0.0001,988,1016,50,50,0.001,2004,18
0.512,0.0001,51,53,50,50,0.001,104,19
0.514,0.0001,106,98,50,50,0.001,204,19
0.516,0.0001,164,140,50,50,0.001,304,19
0.518,0.0001,212,192,50,50,0.001,404,19
0.502,0.0001,276,228,50,50,0.001,504,19
0.508,0.0001,333,271,50,50,0.001,604,19
0.51,0.0001,378,326,50,50,0.001,704,19
0.512,0.0001,439,365,50,50,0.001,804,19
0.506,0.0001,485,419,50,50,0.001,904,19
0.52,0.0001,532,472,50,50,0.001,1004,19
0.536,0.0001,573,531,50,50,0.001,1104,19
0.566,0.0001,621,583,50,50,0.001,1204,19
0.574,0.0001,663,641,50,50,0.001,1304,19
0.582,0.0001,711,693,50,50,0.001,1404,19
0.6,0.0001,758,746,50,50,0.001,1504,19
0.622,0.0001,802,802,50,50,0.001,1604,19
0.642,0.0001,855,849,50,50,0.001,1704,19
0.658,0.0001,912,892,50,50,0.001,1804,19
0.672,0.0001,959,945,50,50,0.001,1904,19
0.696,0.0001,1007,997,50,50,0.001,2004,19
0.518,0.0001,53,51,50,50,0.001,104,20
0.518,0.0001,98,106,50,50,0.001,204,20
0.526,0.0001,142,162,50,50,0.001,304,20
0.542,0.0001,187,217,50,50,0.001,404,20
0.538,0.0001,243,261,50,50,0.001,504,20
0.554,0.0001,301,303,50,50,0.001,604,20
0.546,0.0001,354,350,50,50,0.001,704,20
0.55,0.0001,405,399,50,50,0.001,804,20
0.572,0.0001,459,445,50,50,0.001,904,20
0.59,0.0001,509,495,50,50,0.001,1004,20
0.606,0.0001,558,546,50,50,0.001,1104,20
0.608,0.0001,610,594,50,50,0.001,1204,20
0.634,0.0001,659,645,50,50,0.001,1304,20
0.66,0.0001,710,694,50,50,0.001,1404,20
0.674,0.0001,758,746,50,50,0.001,1504,20
0.69,0.0001,813,791,50,50,0.001,1604,20
0.696,0.0001,858,846,50,50,0.001,1704,20
0.704,0.0001,900,904,50,50,0.001,1804,20
0.74,0.0001,951,953,50,50,0.001,1904,20
0.762,0.0001,999,1005,50,50,0.001,2004,20
0.498,0.0001,60,44,50,50,0.01,104,1
0.546,0.0001,110,94,50,50,0.01,204,1
0.564,0.0001,155,149,50,50,0.01,304,1
0.584,0.0001,197,207,50,50,0.01,404,1
0.598,0.0001,245,259,50,50,0.01,504,1
0.632,0.0001,303,301,50,50,0.01,604,1
0.678,0.0001,355,349,50,50,0.01,704,1
0.754,0.0001,400,404,50,50,0.01,804,1
0.78,0.0001,455,449,50,50,0.01,904,1
0.862,0.0001,509,495,50,50,0.01,1004,1
0.888,0.0001,562,542,50,50,0.01,1104,1
0.91,0.0001,620,584,50,50,0.01,1204,1
0.928,0.0001,679,625,50,50,0.01,1304,1
0.948,0.0001,725,679,50,50,0.01,1404,1
0.954,0.0001,782,722,50,50,0.01,1504,1
0.954,0.0001,826,778,50,50,0.01,1604,1
0.958,0.0001,868,836,50,50,0.01,1704,1
0.96,0.0001,912,892,50,50,0.01,1804,1
0.968,0.0001,959,945,50,50,0.01,1904,1
0.964,0.0001,1002,1002,50,50,0.01,2004,1
0.528,0.0001,54,50,50,50,0.01,104,2
0.58,0.0001,104,100,50,50,0.01,204,2
0.588,0.0001,154,150,50,50,0.01,304,2
0.604,0.0001,216,188,50,50,0.01,404,2
0.606,0.0001,269,235,50,50,0.01,504,2
0.632,0.0001,321,283,50,50,0.01,604,2
0.684,0.0001,366,338,50,50,0.01,704,2
0.732,0.0001,414,390,50,50,0.01,804,2
0.776,0.0001,464,440,50,50,0.01,904,2
0.826,0.0001,505,499,50,50,0.01,1004,2
0.854,0.0001,548,556,50,50,0.01,1104,2
0.904,0.0001,597,607,50,50,0.01,1204,2
0.916,0.0001,648,656,50,50,0.01,1304,2
0.924,0.0001,712,692,50,50,0.01,1404,2
0.946,0.0001,757,747,50,50,0.01,1504,2
0.946,0.0001,801,803,50,50,0.01,1604,2
0.954,0.0001,856,848,50,50,0.01,1704,2
0.956,0.0001,909,895,50,50,0.01,1804,2
0.958,0.0001,955,949,50,50,0.01,1904,2
0.96,0.0001,999,1005,50,50,0.01,2004,2
0.566,0.0001,61,43,50,50,0.01,104,3
0.58,0.0001,98,106,50,50,0.01,204,3
0.59,0.0001,144,160,50,50,0.01,304,3
0.592,0.0001,188,216,50,50,0.01,404,3
0.612,0.0001,233,271,50,50,0.01,504,3
0.646,0.0001,287,317,50,50,0.01,604,3
0.678,0.0001,336,368,50,50,0.01,704,3
0.736,0.0001,380,424,50,50,0.01,804,3
0.76,0.0001,430,474,50,50,0.01,904,3
0.828,0.0001,485,519,50,50,0.01,1004,3
0.868,0.0001,536,568,50,50,0.01,1104,3
0.902,0.0001,588,616,50,50,0.01,1204,3
0.912,0.0001,638,666,50,50,0.01,1304,3
0.938,0.0001,688,716,50,50,0.01,1404,3
0.938,0.0001,738,766,50,50,0.01,1504,3
0.952,0.0001,782,822,50,50,0.01,1604,3
0.964,0.0001,831,873,50,50,0.01,1704,3
0.952,0.0001,879,925,50,50,0.01,1804,3
0.966,0.0001,929,975,50,50,0.01,1904,3
0.964,0.0001,972,1032,50,50,0.01,2004,3
0.484,0.0001,53,51,50,50,0.01,104,4
0.534,0.0001,98,106,50,50,0.01,204,4
0.564,0.0001,153,151,50,50,0.01,304,4
0.624,0.0001,202,202,50,50,0.01,404,4
0.644,0.0001,254,250,50,50,0.01,504,4
0.668,0.0001,308,296,50,50,0.01,604,4
0.692,0.0001,356,348,50,50,0.01,704,4
0.728,0.0001,405,399,50,50,0.01,804,4
0.772,0.0001,451,453,50,50,0.01,904,4
0.844,0.0001,504,500,50,50,0.01,1004,4
0.888,0.0001,559,545,50,50,0.01,1104,4
0.906,0.0001,606,598,50,50,0.01,1204,4
0.932,0.0001,660,644,50,50,0.01,1304,4
0.954,0.0001,705,699,50,50,0.01,1404,4
0.954,0.0001,754,750,50,50,0.01,1504,4
0.96,0.0001,799,805,50,50,0.01,1604,4
0.97,0.0001,850,854,50,50,0.01,1704,4
0.972,0.0001,894,910,50,50,0.01,1804,4
0.968,0.0001,941,963,50,50,0.01,1904,4
0.974,0.0001,991,1013,50,50,0.01,2004,4
0.504,0.0001,50,54,50,50,0.01,104,5
0.55,0.0001,105,99,50,50,0.01,204,5
0.584,0.0001,163,141,50,50,0.01,304,5
0.622,0.0001,212,192,50,50,0.01,404,5
0.632,0.0001,264,240,50,50,0.01,504,5
0.652,0.0001,306,298,50,50,0.01,604,5
0.686,0.0001,349,355,50,50,0.01,704,5
0.716,0.0001,396,408,50,50,0.01,804,5
0.734,0.0001,447,457,50,50,0.01,904,5
0.802,0.0001,498,506,50,50,0.01,1004,5
0.84,0.0001,545,559,50,50,0.01,1104,5
0.886,0.0001,591,613,50,50,0.01,1204,5
0.908,0.0001,642,662,50,50,0.01,1304,5
0.936,0.0001,693,711,50,50,0.01,1404,5
0.946,0.0001,748,756,50,50,0.01,1504,5
0.956,0.0001,797,807,50,50,0.01,1604,5
0.96,0.0001,845,859,50,50,0.01,1704,5
0.966,0.0001,886,918,50,50,0.01,1804,5
0.964,0.0001,944,960,50,50,0.01,1904,5
0.968,0.0001,1000,1004,50,50,0.01,2004,5
0.474,0.0001,47,57,50,50,0.01,104,6
0.49,0.0001,97,107,50,50,0.01,204,6
0.53,0.0001,144,160,50,50,0.01,304,6
0.568,0.0001,195,209,50,50,0.01,404,6
0.612,0.0001,242,262,50,50,0.01,504,6
0.664,0.0001,299,305,50,50,0.01,604,6
0.718,0.0001,350,354,50,50,0.01,704,6
0.78,0.0001,396,408,50,50,0.01,804,6
0.806,0.0001,456,448,50,50,0.01,904,6
0.868,0.0001,500,504,50,50,0.01,1004,6
0.876,0.0001,552,552,50,50,0.01,1104,6
0.916,0.0001,606,598,50,50,0.01,1204,6
0.93,0.0001,652,652,50,50,0.01,1304,6
0.93,0.0001,697,707,50,50,0.01,1404,6
0.942,0.0001,748,756,50,50,0.01,1504,6
0.96,0.0001,793,811,50,50,0.01,1604,6
0.958,0.0001,843,861,50,50,0.01,1704,6
0.964,0.0001,894,910,50,50,0.01,1804,6
0.964,0.0001,946,958,50,50,0.01,1904,6
0.96,0.0001,990,1014,50,50,0.01,2004,6
0.464,0.0001,57,47,50,50,0.01,104,7
0.518,0.0001,100,104,50,50,0.01,204,7
0.546,0.0001,150,154,50,50,0.01,304,7
0.574,0.0001,197,207,50,50,0.01,404,7
0.582,0.0001,244,260,50,50,0.01,504,7
0.626,0.0001,293,311,50,50,0.01,604,7
0.658,0.0001,349,355,50,50,0.01,704,7
0.71,0.0001,409,395,50,50,0.01,804,7
0.742,0.0001,460,444,50,50,0.01,904,7
0.79,0.0001,506,498,50,50,0.01,1004,7
0.862,0.0001,556,548,50,50,0.01,1104,7
0.902,0.0001,614,590,50,50,0.01,1204,7
0.924,0.0001,664,640,50,50,0.01,1304,7
0.942,0.0001,708,696,50,50,0.01,1404,7
0.946,0.0001,755,749,50,50,0.01,1504,7
0.952,0.0001,801,803,50,50,0.01,1604,7
0.96,0.0001,842,862,50,50,0.01,1704,7
0.962,0.0001,888,916,50,50,0.01,1804,7
0.96,0.0001,933,971,50,50,0.01,1904,7
0.974,0.0001,991,1013,50,50,0.01,2004,7
0.466,0.0001,47,57,50,50,0.01,104,8
0.49,0.0001,92,112,50,50,0.01,204,8
0.544,0.0001,143,161,50,50,0.01,304,8
0.568,0.0001,192,212,50,50,0.01,404,8
0.61,0.0001,238,266,50,50,0.01,504,8
0.664,0.0001,290,314,50,50,0.01,604,8
0.698,0.0001,332,372,50,50,0.01,704,8
0.726,0.0001,380,424,50,50,0.01,804,8
0.754,0.0001,434,470,50,50,0.01,904,8
0.802,0.0001,490,514,50,50,0.01,1004,8
0.864,0.0001,540,564,50,50,0.01,1104,8
0.89,0.0001,584,620,50,50,0.01,1204,8
0.912,0.0001,636,668,50,50,0.01,1304,8
0.95,0.0001,677,727,50,50,0.01,1404,8
0.952,0.0001,728,776,50,50,0.01,1504,8
0.96,0.0001,779,825,50,50,0.01,1604,8
0.96,0.0001,823,881,50,50,0.01,1704,8
0.966,0.0001,879,925,50,50,0.01,1804,8
0.966,0.0001,936,968,50,50,0.01,1904,8
0.968,0.0001,980,1024,50,50,0.01,2004,8
0.48,0.0001,49,55,50,50,0.01,104,9
0.532,0.0001,104,100,50,50,0.01,204,9
0.542,0.0001,156,148,50,50,0.01,304,9
0.574,0.0001,206,198,50,50,0.01,404,9
0.618,0.0001,255,249,50,50,0.01,504,9
0.644,0.0001,309,295,50,50,0.01,604,9
0.676,0.0001,361,343,50,50,0.01,704,9
0.714,0.0001,407,397,50,50,0.01,804,9
0.766,0.0001,461,443,50,50,0.01,904,9
0.814,0.0001,502,502,50,50,0.01,1004,9
0.868,0.0001,563,541,50,50,0.01,1104,9
0.906,0.0001,616,588,50,50,0.01,1204,9
0.914,0.0001,666,638,50,50,0.01,1304,9
0.932,0.0001,713,691,50,50,0.01,1404,9
0.94,0.0001,755,749,50,50,0.01,1504,9
0.952,0.0001,808,796,50,50,0.01,1604,9
0.96,0.0001,861,843,50,50,0.01,1704,9
0.964,0.0001,918,886,50,50,0.01,1804,9
0.966,0.0001,963,941,50,50,0.01,1904,9
0.974,0.0001,1013,991,50,50,0.01,2004,9
0.552,0.0001,55,49,50,50,0.01,104,10
0.574,0.0001,105,99,50,50,0.01,204,10
0.572,0.0001,154,150,50,50,0.01,304,10
0.608,0.0001,198,206,50,50,0.01,404,10
0.626,0.0001,247,257,50,50,0.01,504,10
0.652,0.0001,297,307,50,50,0.01,604,10
0.682,0.0001,347,357,50,50,0.01,704,10
0.746,0.0001,403,401,50,50,0.01,804,10
0.776,0.0001,453,451,50,50,0.01,904,10
0.834,0.0001,503,501,50,50,0.01,1004,10
0.888,0.0001,542,562,50,50,0.01,1104,10
0.906,0.0001,595,609,50,50,0.01,1204,10
0.928,0.0001,646,658,50,50,0.01,1304,10
0.942,0.0001,693,711,50,50,0.01,1404,10
0.95,0.0001,751,753,50,50,0.01,1504,10
0.954,0.0001,799,805,50,50,0.01,1604,10
0.956,0.0001,854,850,50,50,0.01,1704,10
0.96,0.0001,901,903,50,50,0.01,1804,10
0.966,0.0001,958,946,50,50,0.01,1904,10
0.97,0.0001,1009,995,50,50,0.01,2004,10
0.534,0.0001,47,57,50,50,0.01,104,11
0.532,0.0001,101,103,50,50,0.01,204,11
0.532,0.0001,158,146,50,50,0.01,304,11
0.57,0.0001,206,198,50,50,0.01,404,11
0.58,0.0001,254,250,50,50,0.01,504,11
0.62,0.0001,300,304,50,50,0.01,604,11
0.684,0.0001,346,358,50,50,0.01,704,11
0.748,0.0001,391,413,50,50,0.01,804,11
0.776,0.0001,447,457,50,50,0.01,904,11
0.838,0.0001,503,501,50,50,0.01,1004,11
0.882,0.0001,567,537,50,50,0.01,1104,11
0.932,0.0001,620,584,50,50,0.01,1204,11
0.944,0.0001,668,636,50,50,0.01,1304,11
0.942,0.0001,718,686,50,50,0.01,1404,11
0.95,0.0001,763,741,50,50,0.01,1504,11
0.952,0.0001,804,800,50,50,0.01,1604,11
0.958,0.0001,854,850,50,50,0.01,1704,11
0.96,0.0001,902,902,50,50,0.01,1804,11
0.97,0.0001,951,953,50,50,0.01,1904,11
0.974,0.0001,997,1007,50,50,0.01,2004,11
0.498,0.0001,58,46,50,50,0.01,104,12
0.526,0.0001,106,98,50,50,0.01,204,12
0.55,0.0001,165,139,50,50,0.01,304,12
0.582,0.0001,210,194,50,50,0.01,404,12
0.602,0.0001,247,257,50,50,0.01,504,12
0.648,0.0001,301,303,50,50,0.01,604,12
0.68,0.0001,352,352,50,50,0.01,704,12
0.748,0.0001,397,407,50,50,0.01,804,12
0.77,0.0001,438,466,50,50,0.01,904,12
0.842,0.0001,486,518,50,50,0.01,1004,12
0.88,0.0001,536,568,50,50,0.01,1104,12
0.904,0.0001,585,619,50,50,0.01,1204,12
0.902,0.0001,645,659,50,50,0.01,1304,12
0.916,0.0001,689,715,50,50,0.01,1404,12
0.922,0.0001,736,768,50,50,0.01,1504,12
0.928,0.0001,779,825,50,50,0.01,1604,12
0.938,0.0001,829,875,50,50,0.01,1704,12
0.946,0.0001,881,923,50,50,0.01,1804,12
0.952,0.0001,933,971,50,50,0.01,1904,12
0.956,0.0001,974,1030,50,50,0.01,2004,12
0.536,0.0001,52,52,50,50,0.01,104,13
0.59,0.0001,109,95,50,50,0.01,204,13
0.622,0.0001,154,150,50,50,0.01,304,13
0.662,0.0001,205,199,50,50,0.01,404,13
0.682,0.0001,251,253,50,50,0.01,504,13
0.71,0.0001,300,304,50,50,0.01,604,13
0.756,0.0001,346,358,50,50,0.01,704,13
0.812,0.0001,385,419,50,50,0.01,804,13
0.86,0.0001,441,463,50,50,0.01,904,13
0.878,0.0001,491,513,50,50,0.01,1004,13
0.916,0.0001,543,561,50,50,0.01,1104,13
0.948,0.0001,595,609,50,50,0.01,1204,13
0.956,0.0001,644,660,50,50,0.01,1304,13
0.968,0.0001,694,710,50,50,0.01,1404,13
0.968,0.0001,753,751,50,50,0.01,1504,13
0.976,0.0001,806,798,50,50,0.01,1604,13
0.978,0.0001,860,844,50,50,0.01,1704,13
0.978,0.0001,914,890,50,50,0.01,1804,13
0.98,0.0001,961,943,50,50,0.01,1904,13
0.978,0.0001,1001,1003,50,50,0.01,2004,13
0.544,0.0001,50,54,50,50,0.01,104,14
0.566,0.0001,104,100,50,50,0.01,204,14
0.566,0.0001,151,153,50,50,0.01,304,14
0.586,0.0001,197,207,50,50,0.01,404,14
0.612,0.0001,242,262,50,50,0.01,504,14
0.652,0.0001,289,315,50,50,0.01,604,14
0.68,0.0001,344,360,50,50,0.01,704,14
0.702,0.0001,393,411,50,50,0.01,804,14
0.74,0.0001,444,460,50,50,0.01,904,14
0.786,0.0001,498,506,50,50,0.01,1004,14
0.842,0.0001,550,554,50,50,0.01,1104,14
0.9,0.0001,603,601,50,50,0.01,1204,14
0.912,0.0001,643,661,50,50,0.01,1304,14
0.934,0.0001,695,709,50,50,0.01,1404,14
0.942,0.0001,746,758,50,50,0.01,1504,14
0.942,0.0001,810,794,50,50,0.01,1604,14
0.946,0.0001,856,848,50,50,0.01,1704,14
0.95,0.0001,906,898,50,50,0.01,1804,14
0.952,0.0001,955,949,50,50,0.01,1904,14
0.964,0.0001,1003,1001,50,50,0.01,2004,14
0.466,0.0001,49,55,50,50,0.01,104,15
0.508,0.0001,89,115,50,50,0.01,204,15
0.526,0.0001,141,163,50,50,0.01,304,15
0.548,0.0001,182,222,50,50,0.01,404,15
0.562,0.0001,233,271,50,50,0.01,504,15
0.596,0.0001,283,321,50,50,0.01,604,15
0.63,0.0001,332,372,50,50,0.01,704,15
0.708,0.0001,381,423,50,50,0.01,804,15
0.748,0.0001,425,479,50,50,0.01,904,15
0.804,0.0001,477,527,50,50,0.01,1004,15
0.844,0.0001,532,572,50,50,0.01,1104,15
0.872,0.0001,589,615,50,50,0.01,1204,15
0.898,0.0001,641,663,50,50,0.01,1304,15
0.918,0.0001,692,712,50,50,0.01,1404,15
0.928,0.0001,736,768,50,50,0.01,1504,15
0.934,0.0001,790,814,50,50,0.01,1604,15
0.938,0.0001,837,867,50,50,0.01,1704,15
0.944,0.0001,886,918,50,50,0.01,1804,15
0.944,0.0001,936,968,50,50,0.01,1904,15
0.948,0.0001,987,1017,50,50,0.01,2004,15
0.57,0.0001,56,48,50,50,0.01,104,16
0.6,0.0001,113,91,50,50,0.01,204,16
0.61,0.0001,161,143,50,50,0.01,304,16
0.622,0.0001,209,195,50,50,0.01,404,16
0.642,0.0001,251,253,50,50,0.01,504,16
0.7,0.0001,300,304,50,50,0.01,604,16
0.748,0.0001,354,350,50,50,0.01,704,16
0.83,0.0001,403,401,50,50,0.01,804,16
0.846,0.0001,448,456,50,50,0.01,904,16
0.89,0.0001,498,506,50,50,0.01,1004,16
0.906,0.0001,545,559,50,50,0.01,1104,16
0.938,0.0001,590,614,50,50,0.01,1204,16
0.942,0.0001,639,665,50,50,0.01,1304,16
0.948,0.0001,680,724,50,50,0.01,1404,16
0.954,0.0001,740,764,50,50,0.01,1504,16
0.954,0.0001,791,813,50,50,0.01,1604,16
0.954,0.0001,842,862,50,50,0.01,1704,16
0.962,0.0001,894,910,50,50,0.01,1804,16
0.966,0.0001,945,959,50,50,0.01,1904,16
0.97,0.0001,991,1013,50,50,0.01,2004,16
0.532,0.0001,46,58,50,50,0.01,104,17
0.544,0.0001,96,108,50,50,0.01,204,17
0.554,0.0001,149,155,50,50,0.01,304,17
0.584,0.0001,200,204,50,50,0.01,404,17
0.61,0.0001,256,248,50,50,0.01,504,17
0.636,0.0001,311,293,50,50,0.01,604,17
0.646,0.0001,356,348,50,50,0.01,704,17
0.694,0.0001,411,393,50,50,0.01,804,17
0.722,0.0001,457,447,50,50,0.01,904,17
0.79,0.0001,505,499,50,50,0.01,1004,17
0.846,0.0001,549,555,50,50,0.01,1104,17
0.902,0.0001,595,609,50,50,0.01,1204,17
0.928,0.0001,644,660,50,50,0.01,1304,17
0.956,0.0001,696,708,50,50,0.01,1404,17
0.964,0.0001,753,751,50,50,0.01,1504,17
0.966,0.0001,797,807,50,50,0.01,1604,17
0.968,0.0001,850,854,50,50,0.01,1704,17
0.972,0.0001,901,903,50,50,0.01,1804,17
0.972,0.0001,958,946,50,50,0.01,1904,17
0.972,0.0001,1005,999,50,50,0.01,2004,17
0.466,0.0001,50,54,50,50,0.01,104,18
0.546,0.0001,96,108,50,50,0.01,204,18
0.56,0.0001,144,160,50,50,0.01,304,18
0.592,0.0001,194,210,50,50,0.01,404,18
0.59,0.0001,254,250,50,50,0.01,504,18
0.642,0.0001,297,307,50,50,0.01,604,18
0.702,0.0001,345,359,50,50,0.01,704,18
0.77,0.0001,390,414,50,50,0.01,804,18
0.814,0.0001,446,458,50,50,0.01,904,18
0.846,0.0001,493,511,50,50,0.01,1004,18
0.88,0.0001,543,561,50,50,0.01,1104,18
0.93,0.0001,599,605,50,50,0.01,1204,18
0.944,0.0001,654,650,50,50,0.01,1304,18
0.956,0.0001,701,703,50,50,0.01,1404,18
0.96,0.0001,746,758,50,50,0.01,1504,18
0.962,0.0001,797,807,50,50,0.01,1604,18
0.962,0.0001,842,862,50,50,0.01,1704,18
0.962,0.0001,897,907,50,50,0.01,1804,18
0.966,0.0001,955,949,50,50,0.01,1904,18
0.962,0.0001,998,1006,50,50,0.01,2004,18
0.534,0.0001,45,59,50,50,0.01,104,19
0.534,0.0001,87,117,50,50,0.01,204,19
0.548,0.0001,138,166,50,50,0.01,304,19
0.572,0.0001,195,209,50,50,0.01,404,19
0.584,0.0001,247,257,50,50,0.01,504,19
0.614,0.0001,295,309,50,50,0.01,604,19
0.662,0.0001,340,364,50,50,0.01,704,19
0.696,0.0001,385,419,50,50,0.01,804,19
0.734,0.0001,428,476,50,50,0.01,904,19
0.784,0.0001,478,526,50,50,0.01,1004,19
0.812,0.0001,526,578,50,50,0.01,1104,19
0.856,0.0001,580,624,50,50,0.01,1204,19
0.896,0.0001,625,679,50,50,0.01,1304,19
0.92,0.0001,674,730,50,50,0.01,1404,19
0.934,0.0001,727,777,50,50,0.01,1504,19
0.94,0.0001,785,819,50,50,0.01,1604,19
0.944,0.0001,835,869,50,50,0.01,1704,19
0.944,0.0001,889,915,50,50,0.01,1804,19
0.948,0.0001,941,963,50,50,0.01,1904,19
0.95,0.0001,998,1006,50,50,0.01,2004,19
0.53,0.0001,57,47,50,50,0.01,104,20
0.558,0.0001,102,102,50,50,0.01,204,20
0.568,0.0001,153,151,50,50,0.01,304,20
0.584,0.0001,197,207,50,50,0.01,404,20
0.596,0.0001,249,255,50,50,0.01,504,20
0.656,0.0001,303,301,50,50,0.01,604,20
0.658,0.0001,356,348,50,50,0.01,704,20
0.68,0.0001,402,402,50,50,0.01,804,20
0.726,0.0001,444,460,50,50,0.01,904,20
0.814,0.0001,502,502,50,50,0.01,1004,20
0.852,0.0001,553,551,50,50,0.01,1104,20
0.878,0.0001,600,604,50,50,0.01,1204,20
0.908,0.0001,652,652,50,50,0.01,1304,20
0.942,0.0001,701,703,50,50,0.01,1404,20
0.942,0.0001,752,752,50,50,0.01,1504,20
0.952,0.0001,811,793,50,50,0.01,1604,20
0.936,0.0001,864,840,50,50,0.01,1704,20
0.966,0.0001,914,890,50,50,0.01,1804,20
0.962,0.0001,960,944,50,50,0.01,1904,20
0.966,0.0001,1013,991,50,50,0.01,2004,20
0.502,0.001,53,51,50,50,0.0001,104,1
0.504,0.001,104,100,50,50,0.0001,204,1
0.506,0.001,156,148,50,50,0.0001,304,1
0.506,0.001,213,191,50,50,0.0001,404,1
0.506,0.001,260,244,50,50,0.0001,504,1
0.506,0.001,308,296,50,50,0.0001,604,1
0.504,0.001,364,340,50,50,0.0001,704,1
0.502,0.001,416,388,50,50,0.0001,804,1
0.502,0.001,462,442,50,50,0.0001,904,1
0.504,0.001,505,499,50,50,0.0001,1004,1
0.504,0.001,558,546,50,50,0.0001,1104,1
0.506,0.001,607,597,50,50,0.0001,1204,1
0.506,0.001,656,648,50,50,0.0001,1304,1
0.506,0.001,710,694,50,50,0.0001,1404,1
0.506,0.001,763,741,50,50,0.0001,1504,1
0.504,0.001,815,789,50,50,0.0001,1604,1
0.504,0.001,859,845,50,50,0.0001,1704,1
0.504,0.001,904,900,50,50,0.0001,1804,1
0.506,0.001,953,951,50,50,0.0001,1904,1
0.508,0.001,1005,999,50,50,0.0001,2004,1
0.512,0.001,49,55,50,50,0.0001,104,2
0.516,0.001,96,108,50,50,0.0001,204,2
0.516,0.001,143,161,50,50,0.0001,304,2
0.516,0.001,194,210,50,50,0.0001,404,2
0.516,0.001,240,264,50,50,0.0001,504,2
0.516,0.001,294,310,50,50,0.0001,604,2
0.512,0.001,347,357,50,50,0.0001,704,2
0.508,0.001,402,402,50,50,0.0001,804,2
0.508,0.001,443,461,50,50,0.0001,904,2
0.506,0.001,484,520,50,50,0.0001,1004,2
0.51,0.001,538,566,50,50,0.0001,1104,2
0.514,0.001,585,619,50,50,0.0001,1204,2
0.512,0.001,637,667,50,50,0.0001,1304,2
0.512,0.001,683,721,50,50,0.0001,1404,2
0.51,0.001,736,768,50,50,0.0001,1504,2
0.512,0.001,790,814,50,50,0.0001,1604,2
0.518,0.001,842,862,50,50,0.0001,1704,2
0.522,0.001,904,900,50,50,0.0001,1804,2
0.524,0.001,949,955,50,50,0.0001,1904,2
0.534,0.001,998,1006,50,50,0.0001,2004,2
0.52,0.001,48,56,50,50,0.0001,104,3
0.52,0.001,99,105,50,50,0.0001,204,3
0.516,0.001,146,158,50,50,0.0001,304,3
0.516,0.001,186,218,50,50,0.0001,404,3
0.516,0.001,240,264,50,50,0.0001,504,3
0.516,0.001,294,310,50,50,0.0001,604,3
0.518,0.001,350,354,50,50,0.0001,704,3
0.52,0.001,400,404,50,50,0.0001,804,3
0.524,0.001,448,456,50,50,0.0001,904,3
0.524,0.001,499,505,50,50,0.0001,1004,3
0.524,0.001,555,549,50,50,0.0001,1104,3
0.526,0.001,600,604,50,50,0.0001,1204,3
0.53,0.001,651,653,50,50,0.0001,1304,3
0.534,0.001,697,707,50,50,0.0001,1404,3
0.532,0.001,752,752,50,50,0.0001,1504,3
0.534,0.001,792,812,50,50,0.0001,1604,3
0.536,0.001,848,856,50,50,0.0001,1704,3
0.54,0.001,899,905,50,50,0.0001,1804,3
0.538,0.001,949,955,50,50,0.0001,1904,3
0.542,0.001,999,1005,50,50,0.0001,2004,3
0.492,0.001,47,57,50,50,0.0001,104,4
0.492,0.001,104,100,50,50,0.0001,204,4
0.492,0.001,161,143,50,50,0.0001,304,4
0.492,0.001,213,191,50,50,0.0001,404,4
0.492,0.001,261,243,50,50,0.0001,504,4
0.494,0.001,311,293,50,50,0.0001,604,4
0.494,0.001,361,343,50,50,0.0001,704,4
0.498,0.001,411,393,50,50,0.0001,804,4
0.498,0.001,466,438,50,50,0.0001,904,4
0.498,0.001,508,496,50,50,0.0001,1004,4
0.498,0.001,560,544,50,50,0.0001,1104,4
0.498,0.001,606,598,50,50,0.0001,1204,4
0.5,0.001,659,645,50,50,0.0001,1304,4
0.504,0.001,699,705,50,50,0.0001,1404,4
0.506,0.001,747,757,50,50,0.0001,1504,4
0.512,0.001,800,804,50,50,0.0001,1604,4
0.516,0.001,856,848,50,50,0.0001,1704,4
0.52,0.001,910,894,50,50,0.0001,1804,4
0.524,0.001,951,953,50,50,0.0001,1904,4
0.524,0.001,1002,1002,50,50,0.0001,2004,4
0.486,0.001,44,60,50,50,0.0001,104,5
0.486,0.001,99,105,50,50,0.0001,204,5
0.484,0.001,145,159,50,50,0.0001,304,5
0.486,0.001,199,205,50,50,0.0001,404,5
0.488,0.001,255,249,50,50,0.0001,504,5
0.488,0.001,305,299,50,50,0.0001,604,5
0.49,0.001,358,346,50,50,0.0001,704,5
0.49,0.001,410,394,50,50,0.0001,804,5
0.492,0.001,455,449,50,50,0.0001,904,5
0.494,0.001,505,499,50,50,0.0001,1004,5
0.492,0.001,557,547,50,50,0.0001,1104,5
0.492,0.001,613,591,50,50,0.0001,1204,5
0.492,0.001,667,637,50,50,0.0001,1304,5
0.498,0.001,709,695,50,50,0.0001,1404,5
0.498,0.001,766,738,50,50,0.0001,1504,5
0.5,0.001,817,787,50,50,0.0001,1604,5
0.504,0.001,867,837,50,50,0.0001,1704,5
0.51,0.001,920,884,50,50,0.0001,1804,5
0.512,0.001,966,938,50,50,0.0001,1904,5
0.512,0.001,1015,989,50,50,0.0001,2004,5
0.512,0.001,46,58,50,50,0.0001,104,6
0.512,0.001,97,107,50,50,0.0001,204,6
0.516,0.001,149,155,50,50,0.0001,304,6
0.518,0.001,200,204,50,50,0.0001,404,6
0.518,0.001,245,259,50,50,0.0001,504,6
0.518,0.001,299,305,50,50,0.0001,604,6
0.52,0.001,346,358,50,50,0.0001,704,6
0.522,0.001,391,413,50,50,0.0001,804,6
0.524,0.001,445,459,50,50,0.0001,904,6
0.524,0.001,489,515,50,50,0.0001,1004,6
0.524,0.001,535,569,50,50,0.0001,1104,6
0.52,0.001,589,615,50,50,0.0001,1204,6
0.516,0.001,653,651,50,50,0.0001,1304,6
0.516,0.001,701,703,50,50,0.0001,1404,6
0.522,0.001,745,759,50,50,0.0001,1504,6
0.522,0.001,801,803,50,50,0.0001,1604,6
0.524,0.001,854,850,50,50,0.0001,1704,6
0.526,0.001,906,898,50,50,0.0001,1804,6
0.524,0.001,950,954,50,50,0.0001,1904,6
0.526,0.001,995,1009,50,50,0.0001,2004,6
0.506,0.001,51,53,50,50,0.0001,104,7
0.506,0.001,101,103,50,50,0.0001,204,7
0.504,0.001,151,153,50,50,0.0001,304,7
0.506,0.001,200,204,50,50,0.0001,404,7
0.506,0.001,255,249,50,50,0.0001,504,7
0.504,0.001,306,298,50,50,0.0001,604,7
0.508,0.001,354,350,50,50,0.0001,704,7
0.512,0.001,401,403,50,50,0.0001,804,7
0.512,0.001,449,455,50,50,0.0001,904,7
0.51,0.001,499,505,50,50,0.0001,1004,7
0.51,0.001,546,558,50,50,0.0001,1104,7
0.51,0.001,596,608,50,50,0.0001,1204,7
0.51,0.001,642,662,50,50,0.0001,1304,7
0.516,0.001,694,710,50,50,0.0001,1404,7
0.522,0.001,744,760,50,50,0.0001,1504,7
0.528,0.001,799,805,50,50,0.0001,1604,7
0.532,0.001,851,853,50,50,0.0001,1704,7
0.534,0.001,901,903,50,50,0.0001,1804,7
0.532,0.001,948,956,50,50,0.0001,1904,7
0.536,0.001,1003,1001,50,50,0.0001,2004,7
0.488,0.001,55,49,50,50,0.0001,104,8
0.49,0.001,98,106,50,50,0.0001,204,8
0.49,0.001,149,155,50,50,0.0001,304,8
0.492,0.001,190,214,50,50,0.0001,404,8
0.492,0.001,241,263,50,50,0.0001,504,8
0.492,0.001,282,322,50,50,0.0001,604,8
0.492,0.001,328,376,50,50,0.0001,704,8
0.49,0.001,383,421,50,50,0.0001,804,8
0.49,0.001,432,472,50,50,0.0001,904,8
0.494,0.001,484,520,50,50,0.0001,1004,8
0.498,0.001,544,560,50,50,0.0001,1104,8
0.508,0.001,602,602,50,50,0.0001,1204,8
0.51,0.001,659,645,50,50,0.0001,1304,8
0.51,0.001,712,692,50,50,0.0001,1404,8
0.514,0.001,761,743,50,50,0.0001,1504,8
0.516,0.001,806,798,50,50,0.0001,1604,8
0.514,0.001,861,843,50,50,0.0001,1704,8
0.514,0.001,913,891,50,50,0.0001,1804,8
0.522,0.001,966,938,50,50,0.0001,1904,8
0.522,0.001,1008,996,50,50,0.0001,2004,8
0.464,0.001,59,45,50,50,0.0001,104,9
0.468,0.001,109,95,50,50,0.0001,204,9
0.468,0.001,163,141,50,50,0.0001,304,9
0.468,0.001,210,194,50,50,0.0001,404,9
0.466,0.001,257,247,50,50,0.0001,504,9
0.464,0.001,310,294,50,50,0.0001,604,9
0.462,0.001,358,346,50,50,0.0001,704,9
0.462,0.001,409,395,50,50,0.0001,804,9
0.46,0.001,453,451,50,50,0.0001,904,9
0.462,0.001,511,493,50,50,0.0001,1004,9
0.462,0.001,554,550,50,50,0.0001,1104,9
0.462,0.001,601,603,50,50,0.0001,1204,9
0.464,0.001,658,646,50,50,0.0001,1304,9
0.464,0.001,711,693,50,50,0.0001,1404,9
0.47,0.001,760,744,50,50,0.0001,1504,9
0.468,0.001,798,806,50,50,0.0001,1604,9
0.474,0.001,847,857,50,50,0.0001,1704,9
0.482,0.001,906,898,50,50,0.0001,1804,9
0.49,0.001,961,943,50,50,0.0001,1904,9
0.492,0.001,1011,993,50,50,0.0001,2004,9
0.542,0.001,50,54,50,50,0.0001,104,10
0.54,0.001,107,97,50,50,0.0001,204,10
0.54,0.001,152,152,50,50,0.0001,304,10
0.542,0.001,202,202,50,50,0.0001,404,10
0.542,0.001,249,255,50,50,0.0001,504,10
0.544,0.001,303,301,50,50,0.0001,604,10
0.544,0.001,345,359,50,50,0.0001,704,10
0.55,0.001,396,408,50,50,0.0001,804,10
0.55,0.001,445,459,50,50,0.0001,904,10
0.55,0.001,494,510,50,50,0.0001,1004,10
0.55,0.001,536,568,50,50,0.0001,1104,10
0.55,0.001,597,607,50,50,0.0001,1204,10
0.556,0.001,646,658,50,50,0.0001,1304,10
0.556,0.001,696,708,50,50,0.0001,1404,10
0.562,0.001,750,754,50,50,0.0001,1504,10
0.566,0.001,795,809,50,50,0.0001,1604,10
0.566,0.001,843,861,50,50,0.0001,1704,10
0.564,0.001,888,916,50,50,0.0001,1804,10
0.566,0.001,931,973,50,50,0.0001,1904,10
0.566,0.001,982,1022,50,50,0.0001,2004,10
0.504,0.001,49,55,50,50,0.0001,104,11
0.51,0.001,99,105,50,50,0.0001,204,11
0.508,0.001,143,161,50,50,0.0001,304,11
0.508,0.001,196,208,50,50,0.0001,404,11
0.51,0.001,237,267,50,50,0.0001,504,11
0.51,0.001,273,331,50,50,0.0001,604,11
0.512,0.001,333,371,50,50,0.0001,704,11
0.512,0.001,391,413,50,50,0.0001,804,11
0.516,0.001,441,463,50,50,0.0001,904,11
0.514,0.001,494,510,50,50,0.0001,1004,11
0.516,0.001,546,558,50,50,0.0001,1104,11
0.514,0.001,604,600,50,50,0.0001,1204,11
0.522,0.001,657,647,50,50,0.0001,1304,11
0.522,0.001,710,694,50,50,0.0001,1404,11
0.522,0.001,758,746,50,50,0.0001,1504,11
0.524,0.001,803,801,50,50,0.0001,1604,11
0.526,0.001,853,851,50,50,0.0001,1704,11
0.524,0.001,905,899,50,50,0.0001,1804,11
0.526,0.001,951,953,50,50,0.0001,1904,11
0.528,0.001,1006,998,50,50,0.0001,2004,11
0.502,0.001,57,47,50,50,0.0001,104,12
0.502,0.001,106,98,50,50,0.0001,204,12
0.5,0.001,155,149,50,50,0.0001,304,12
0.5,0.001,214,190,50,50,0.0001,404,12
0.502,0.001,265,239,50,50,0.0001,504,12
0.5,0.001,314,290,50,50,0.0001,604,12
0.5,0.001,361,343,50,50,0.0001,704,12
0.504,0.001,404,400,50,50,0.0001,804,12
0.504,0.001,461,443,50,50,0.0001,904,12
0.506,0.001,512,492,50,50,0.0001,1004,12
0.504,0.001,564,540,50,50,0.0001,1104,12
0.504,0.001,622,582,50,50,0.0001,1204,12
0.508,0.001,664,640,50,50,0.0001,1304,12
0.512,0.001,708,696,50,50,0.0001,1404,12
0.514,0.001,764,740,50,50,0.0001,1504,12
0.512,0.001,814,790,50,50,0.0001,1604,12
0.512,0.001,859,845,50,50,0.0001,1704,12
0.518,0.001,904,900,50,50,0.0001,1804,12
0.52,0.001,964,940,50,50,0.0001,1904,12
0.522,0.001,1013,991,50,50,0.0001,2004,12
0.5,0.001,57,47,50,50,0.0001,104,13
0.5,0.001,109,95,50,50,0.0001,204,13
0.5,0.001,152,152,50,50,0.0001,304,13
0.502,0.001,195,209,50,50,0.0001,404,13
0.502,0.001,248,256,50,50,0.0001,504,13
0.504,0.001,306,298,50,50,0.0001,604,13
0.506,0.001,358,346,50,50,0.0001,704,13
0.506,0.001,401,403,50,50,0.0001,804,13
0.508,0.001,446,458,50,50,0.0001,904,13
0.512,0.001,494,510,50,50,0.0001,1004,13
0.512,0.001,546,558,50,50,0.0001,1104,13
0.512,0.001,593,611,50,50,0.0001,1204,13
0.514,0.001,646,658,50,50,0.0001,1304,13
0.514,0.001,685,719,50,50,0.0001,1404,13
0.514,0.001,742,762,50,50,0.0001,1504,13
0.518,0.001,790,814,50,50,0.0001,1604,13
0.522,0.001,843,861,50,50,0.0001,1704,13
0.52,0.001,896,908,50,50,0.0001,1804,13
0.526,0.001,945,959,50,50,0.0001,1904,13
0.524,0.001,995,1009,50,50,0.0001,2004,13
0.536,0.001,50,54,50,50,0.0001,104,14
0.536,0.001,98,106,50,50,0.0001,204,14
0.532,0.001,146,158,50,50,0.0001,304,14
0.532,0.001,197,207,50,50,0.0001,404,14
0.534,0.001,246,258,50,50,0.0001,504,14
0.534,0.001,306,298,50,50,0.0001,604,14
0.532,0.001,364,340,50,50,0.0001,704,14
0.53,0.001,416,388,50,50,0.0001,804,14
0.53,0.001,470,434,50,50,0.0001,904,14
0.532,0.001,518,486,50,50,0.0001,1004,14
0.532,0.001,569,535,50,50,0.0001,1104,14
0.536,0.001,627,577,50,50,0.0001,1204,14
0.536,0.001,673,631,50,50,0.0001,1304,14
0.542,0.001,728,676,50,50,0.0001,1404,14
0.542,0.001,775,729,50,50,0.0001,1504,14
0.55,0.001,817,787,50,50,0.0001,1604,14
0.556,0.001,869,835,50,50,0.0001,1704,14
0.556,0.001,913,891,50,50,0.0001,1804,14
0.56,0.001,955,949,50,50,0.0001,1904,14
0.562,0.001,1009,995,50,50,0.0001,2004,14
0.508,0.001,50,54,50,50,0.0001,104,15
0.508,0.001,97,107,50,50,0.0001,204,15
0.51,0.001,145,159,50,50,0.0001,304,15
0.514,0.001,199,205,50,50,0.0001,404,15
0.516,0.001,242,262,50,50,0.0001,504,15
0.516,0.001,297,307,50,50,0.0001,604,15
0.516,0.001,344,360,50,50,0.0001,704,15
0.518,0.001,392,412,50,50,0.0001,804,15
0.518,0.001,438,466,50,50,0.0001,904,15
0.52,0.001,488,516,50,50,0.0001,1004,15
0.518,0.001,545,559,50,50,0.0001,1104,15
0.526,0.001,595,609,50,50,0.0001,1204,15
0.528,0.001,646,658,50,50,0.0001,1304,15
0.528,0.001,711,693,50,50,0.0001,1404,15
0.528,0.001,762,742,50,50,0.0001,1504,15
0.53,0.001,814,790,50,50,0.0001,1604,15
0.53,0.001,863,841,50,50,0.0001,1704,15
0.53,0.001,910,894,50,50,0.0001,1804,15
0.532,0.001,959,945,50,50,0.0001,1904,15
0.534,0.001,1005,999,50,50,0.0001,2004,15
0.486,0.001,50,54,50,50,0.0001,104,16
0.486,0.001,94,110,50,50,0.0001,204,16
0.484,0.001,140,164,50,50,0.0001,304,16
0.486,0.001,187,217,50,50,0.0001,404,16
0.492,0.001,242,262,50,50,0.0001,504,16
0.494,0.001,302,302,50,50,0.0001,604,16
0.498,0.001,349,355,50,50,0.0001,704,16
0.496,0.001,395,409,50,50,0.0001,804,16
0.498,0.001,449,455,50,50,0.0001,904,16
0.5,0.001,498,506,50,50,0.0001,1004,16
0.498,0.001,543,561,50,50,0.0001,1104,16
0.498,0.001,591,613,50,50,0.0001,1204,16
0.498,0.001,647,657,50,50,0.0001,1304,16
0.5,0.001,699,705,50,50,0.0001,1404,16
0.51,0.001,748,756,50,50,0.0001,1504,16
0.506,0.001,809,795,50,50,0.0001,1604,16
0.51,0.001,860,844,50,50,0.0001,1704,16
0.51,0.001,908,896,50,50,0.0001,1804,16
0.514,0.001,953,951,50,50,0.0001,1904,16
0.514,0.001,998,1006,50,50,0.0001,2004,16
0.486,0.001,63,41,50,50,0.0001,104,17
0.488,0.001,114,90,50,50,0.0001,204,17
0.486,0.001,163,141,50,50,0.0001,304,17
0.486,0.001,215,189,50,50,0.0001,404,17
0.484,0.001,273,231,50,50,0.0001,504,17
0.482,0.001,323,281,50,50,0.0001,604,17
0.482,0.001,368,336,50,50,0.0001,704,17
0.482,0.001,423,381,50,50,0.0001,804,17
0.48,0.001,468,436,50,50,0.0001,904,17
0.48,0.001,512,492,50,50,0.0001,1004,17
0.48,0.001,563,541,50,50,0.0001,1104,17
0.484,0.001,619,585,50,50,0.0001,1204,17
0.482,0.001,670,634,50,50,0.0001,1304,17
0.482,0.001,729,675,50,50,0.0001,1404,17
0.482,0.001,780,724,50,50,0.0001,1504,17
0.484,0.001,833,771,50,50,0.0001,1604,17
0.482,0.001,881,823,50,50,0.0001,1704,17
0.486,0.001,925,879,50,50,0.0001,1804,17
0.484,0.001,971,933,50,50,0.0001,1904,17
0.486,0.001,1014,990,50,50,0.0001,2004,17
0.522,0.001,42,62,50,50,0.0001,104,18
0.524,0.001,94,110,50,50,0.0001,204,18
0.524,0.001,143,161,50,50,0.0001,304,18
0.528,0.001,198,206,50,50,0.0001,404,18
0.53,0.001,245,259,50,50,0.0001,504,18
0.532,0.001,286,318,50,50,0.0001,604,18
0.532,0.001,349,355,50,50,0.0001,704,18
0.534,0.001,401,403,50,50,0.0001,804,18
0.534,0.001,460,444,50,50,0.0001,904,18
0.534,0.001,504,500,50,50,0.0001,1004,18
0.534,0.001,554,550,50,50,0.0001,1104,18
0.536,0.001,607,597,50,50,0.0001,1204,18
0.536,0.001,660,644,50,50,0.0001,1304,18
0.542,0.001,712,692,50,50,0.0001,1404,18
0.542,0.001,766,738,50,50,0.0001,1504,18
0.542,0.001,809,795,50,50,0.0001,1604,18
0.542,0.001,863,841,50,50,0.0001,1704,18
0.542,0.001,913,891,50,50,0.0001,1804,18
0.542,0.001,963,941,50,50,0.0001,1904,18
0.548,0.001,1019,985,50,50,0.0001,2004,18
0.482,0.001,45,59,50,50,0.0001,104,19
0.482,0.001,100,104,50,50,0.0001,204,19
0.482,0.001,147,157,50,50,0.0001,304,19
0.484,0.001,203,201,50,50,0.0001,404,19
0.484,0.001,251,253,50,50,0.0001,504,19
0.482,0.001,307,297,50,50,0.0001,604,19
0.48,0.001,354,350,50,50,0.0001,704,19
0.48,0.001,402,402,50,50,0.0001,804,19
0.48,0.001,454,450,50,50,0.0001,904,19
0.48,0.001,503,501,50,50,0.0001,1004,19
0.478,0.001,554,550,50,50,0.0001,1104,19
0.48,0.001,607,597,50,50,0.0001,1204,19
0.478,0.001,649,655,50,50,0.0001,1304,19
0.48,0.001,699,705,50,50,0.0001,1404,19
0.482,0.001,746,758,50,50,0.0001,1504,19
0.488,0.001,801,803,50,50,0.0001,1604,19
0.488,0.001,845,859,50,50,0.0001,1704,19
0.492,0.001,899,905,50,50,0.0001,1804,19
0.488,0.001,944,960,50,50,0.0001,1904,19
0.492,0.001,996,1008,50,50,0.0001,2004,19
0.46,0.001,54,50,50,50,0.0001,104,20
0.458,0.001,107,97,50,50,0.0001,204,20
0.458,0.001,156,148,50,50,0.0001,304,20
0.456,0.001,206,198,50,50,0.0001,404,20
0.458,0.001,245,259,50,50,0.0001,504,20
0.462,0.001,292,312,50,50,0.0001,604,20
0.458,0.001,346,358,50,50,0.0001,704,20
0.46,0.001,401,403,50,50,0.0001,804,20
0.464,0.001,446,458,50,50,0.0001,904,20
0.468,0.001,490,514,50,50,0.0001,1004,20
0.472,0.001,546,558,50,50,0.0001,1104,20
0.472,0.001,600,604,50,50,0.0001,1204,20
0.476,0.001,651,653,50,50,0.0001,1304,20
0.478,0.001,697,707,50,50,0.0001,1404,20
0.48,0.001,748,756,50,50,0.0001,1504,20
0.476,0.001,790,814,50,50,0.0001,1604,20
0.48,0.001,844,860,50,50,0.0001,1704,20
0.484,0.001,896,908,50,50,0.0001,1804,20
0.484,0.001,945,959,50,50,0.0001,1904,20
0.486,0.001,998,1006,50,50,0.0001,2004,20
0.478,0.001,54,50,50,50,0.001,104,1
0.48,0.001,98,106,50,50,0.001,204,1
0.488,0.001,155,149,50,50,0.001,304,1
0.496,0.001,205,199,50,50,0.001,404,1
0.502,0.001,259,245,50,50,0.001,504,1
0.506,0.001,318,286,50,50,0.001,604,1
0.51,0.001,364,340,50,50,0.001,704,1
0.528,0.001,413,391,50,50,0.001,804,1
0.53,0.001,470,434,50,50,0.001,904,1
0.542,0.001,521,483,50,50,0.001,1004,1
0.548,0.001,568,536,50,50,0.001,1104,1
0.552,0.001,616,588,50,50,0.001,1204,1
0.564,0.001,665,639,50,50,0.001,1304,1
0.59,0.001,712,692,50,50,0.001,1404,1
0.6,0.001,757,747,50,50,0.001,1504,1
0.618,0.001,803,801,50,50,0.001,1604,1
0.64,0.001,852,852,50,50,0.001,1704,1
0.66,0.001,902,902,50,50,0.001,1804,1
0.684,0.001,959,945,50,50,0.001,1904,1
0.7,0.001,1013,991,50,50,0.001,2004,1
0.508,0.001,51,53,50,50,0.001,104,2
0.516,0.001,104,100,50,50,0.001,204,2
0.526,0.001,166,138,50,50,0.001,304,2
0.528,0.001,218,186,50,50,0.001,404,2
0.54,0.001,269,235,50,50,0.001,504,2
0.558,0.001,321,283,50,50,0.001,604,2
0.562,0.001,373,331,50,50,0.001,704,2
0.57,0.001,426,378,50,50,0.001,804,2
0.568,0.001,476,428,50,50,0.001,904,2
0.59,0.001,527,477,50,50,0.001,1004,2
0.598,0.001,574,530,50,50,0.001,1104,2
0.614,0.001,620,584,50,50,0.001,1204,2
0.616,0.001,669,635,50,50,0.001,1304,2
0.66,0.001,710,694,50,50,0.001,1404,2
0.672,0.001,760,744,50,50,0.001,1504,2
0.686,0.001,814,790,50,50,0.001,1604,2
0.69,0.001,859,845,50,50,0.001,1704,2
0.71,0.001,907,897,50,50,0.001,1804,2
0.734,0.001,963,941,50,50,0.001,1904,2
0.756,0.001,1013,991,50,50,0.001,2004,2
0.462,0.001,56,48,50,50,0.001,104,3
0.466,0.001,108,96,50,50,0.001,204,3
0.478,0.001,152,152,50,50,0.001,304,3
0.486,0.001,200,204,50,50,0.001,404,3
0.494,0.001,250,254,50,50,0.001,504,3
0.508,0.001,295,309,50,50,0.001,604,3
0.522,0.001,351,353,50,50,0.001,704,3
0.536,0.001,399,405,50,50,0.001,804,3
0.55,0.001,461,443,50,50,0.001,904,3
0.57,0.001,507,497,50,50,0.001,1004,3
0.582,0.001,552,552,50,50,0.001,1104,3
0.598,0.001,601,603,50,50,0.001,1204,3
0.614,0.001,647,657,50,50,0.001,1304,3
0.622,0.001,696,708,50,50,0.001,1404,3
0.656,0.001,749,755,50,50,0.001,1504,3
0.672,0.001,803,801,50,50,0.001,1604,3
0.68,0.001,859,845,50,50,0.001,1704,3
0.708,0.001,906,898,50,50,0.001,1804,3
0.722,0.001,962,942,50,50,0.001,1904,3
0.756,0.001,1017,987,50,50,0.001,2004,3
0.506,0.001,46,58,50,50,0.001,104,4
0.51,0.001,95,109,50,50,0.001,204,4
0.502,0.001,150,154,50,50,0.001,304,4
0.492,0.001,207,197,50,50,0.001,404,4
0.494,0.001,258,246,50,50,0.001,504,4
0.5,0.001,305,299,50,50,0.001,604,4
0.496,0.001,350,354,50,50,0.001,704,4
0.502,0.001,403,401,50,50,0.001,804,4
0.506,0.001,451,453,50,50,0.001,904,4
0.514,0.001,498,506,50,50,0.001,1004,4
0.524,0.001,550,554,50,50,0.001,1104,4
0.546,0.001,590,614,50,50,0.001,1204,4
0.556,0.001,645,659,50,50,0.001,1304,4
0.584,0.001,692,712,50,50,0.001,1404,4
0.596,0.001,742,762,50,50,0.001,1504,4
0.638,0.001,791,813,50,50,0.001,1604,4
0.676,0.001,842,862,50,50,0.001,1704,4
0.704,0.001,895,909,50,50,0.001,1804,4
0.724,0.001,956,948,50,50,0.001,1904,4
0.74,0.001,1003,1001,50,50,0.001,2004,4
0.53,0.001,48,56,50,50,0.001,104,5
0.528,0.001,99,105,50,50,0.001,204,5
0.538,0.001,149,155,50,50,0.001,304,5
0.554,0.001,197,207,50,50,0.001,404,5
0.558,0.001,252,252,50,50,0.001,504,5
0.574,0.001,302,302,50,50,0.001,604,5
0.584,0.001,355,349,50,50,0.001,704,5
0.592,0.001,412,392,50,50,0.001,804,5
0.604,0.001,456,448,50,50,0.001,904,5
0.61,0.001,506,498,50,50,0.001,1004,5
0.616,0.001,559,545,50,50,0.001,1104,5
0.618,0.001,603,601,50,50,0.001,1204,5
0.628,0.001,653,651,50,50,0.001,1304,5
0.646,0.001,707,697,50,50,0.001,1404,5
0.664,0.001,757,747,50,50,0.001,1504,5
0.688,0.001,817,787,50,50,0.001,1604,5
0.704,0.001,864,840,50,50,0.001,1704,5
0.72,0.001,915,889,50,50,0.001,1804,5
0.742,0.001,965,939,50,50,0.001,1904,5
0.78,0.001,1013,991,50,50,0.001,2004,5
0.488,0.001,52,52,50,50,0.001,104,6
0.482,0.001,103,101,50,50,0.001,204,6
0.486,0.001,150,154,50,50,0.001,304,6
0.492,0.001,195,209,50,50,0.001,404,6
0.486,0.001,247,257,50,50,0.001,504,6
0.482,0.001,301,303,50,50,0.001,604,6
0.482,0.001,355,349,50,50,0.001,704,6
0.494,0.001,405,399,50,50,0.001,804,6
0.506,0.001,453,451,50,50,0.001,904,6
0.52,0.001,513,491,50,50,0.001,1004,6
0.528,0.001,565,539,50,50,0.001,1104,6
0.544,0.001,612,592,50,50,0.001,1204,6
0.556,0.001,664,640,50,50,0.001,1304,6
0.586,0.001,712,692,50,50,0.001,1404,6
0.6,0.001,756,748,50,50,0.001,1504,6
0.618,0.001,799,805,50,50,0.001,1604,6
0.634,0.001,852,852,50,50,0.001,1704,6
0.672,0.001,898,906,50,50,0.001,1804,6
0.708,0.001,943,961,50,50,0.001,1904,6
0.736,0.001,985,1019,50,50,0.001,2004,6
0.45,0.001,60,44,50,50,0.001,104,7
0.464,0.001,110,94,50,50,0.001,204,7
0.476,0.001,172,132,50,50,0.001,304,7
0.49,0.001,221,183,50,50,0.001,404,7
0.494,0.001,270,234,50,50,0.001,504,7
0.502,0.001,321,283,50,50,0.001,604,7
0.504,0.001,356,348,50,50,0.001,704,7
0.522,0.001,399,405,50,50,0.001,804,7
0.532,0.001,450,454,50,50,0.001,904,7
0.548,0.001,501,503,50,50,0.001,1004,7
0.57,0.001,553,551,50,50,0.001,1104,7
0.582,0.001,595,609,50,50,0.001,1204,7
0.594,0.001,639,665,50,50,0.001,1304,7
0.616,0.001,691,713,50,50,0.001,1404,7
0.634,0.001,744,760,50,50,0.001,1504,7
0.662,0.001,802,802,50,50,0.001,1604,7
0.68,0.001,850,854,50,50,0.001,1704,7
0.694,0.001,907,897,50,50,0.001,1804,7
0.73,0.001,960,944,50,50,0.001,1904,7
0.756,0.001,1008,996,50,50,0.001,2004,7
0.512,0.001,44,60,50,50,0.001,104,8
0.514,0.001,99,105,50,50,0.001,204,8
0.52,0.001,149,155,50,50,0.001,304,8
0.53,0.001,201,203,50,50,0.001,404,8
0.544,0.001,256,248,50,50,0.001,504,8
0.56,0.001,305,299,50,50,0.001,604,8
0.568,0.001,349,355,50,50,0.001,704,8
0.58,0.001,400,404,50,50,0.001,804,8
0.6,0.001,444,460,50,50,0.001,904,8
0.618,0.001,499,505,50,50,0.001,1004,8
0.622,0.001,553,551,50,50,0.001,1104,8
0.64,0.001,599,605,50,50,0.001,1204,8
0.658,0.001,648,656,50,50,0.001,1304,8
0.668,0.001,699,705,50,50,0.001,1404,8
0.668,0.001,750,754,50,50,0.001,1504,8
0.694,0.001,795,809,50,50,0.001,1604,8
0.718,0.001,841,863,50,50,0.001,1704,8
0.734,0.001,886,918,50,50,0.001,1804,8
0.746,0.001,941,963,50,50,0.001,1904,8
0.766,0.001,1000,1004,50,50,0.001,2004,8
0.526,0.001,48,56,50,50,0.001,104,9
0.534,0.001,97,107,50,50,0.001,204,9
0.53,0.001,152,152,50,50,0.001,304,9
0.532,0.001,197,207,50,50,0.001,404,9
0.534,0.001,242,262,50,50,0.001,504,9
0.548,0.001,290,314,50,50,0.001,604,9
0.556,0.001,338,366,50,50,0.001,704,9
0.552,0.001,386,418,50,50,0.001,804,9
0.57,0.001,434,470,50,50,0.001,904,9
0.574,0.001,485,519,50,50,0.001,1004,9
0.582,0.001,539,565,50,50,0.001,1104,9
0.596,0.001,592,612,50,50,0.001,1204,9
0.612,0.001,644,660,50,50,0.001,1304,9
0.638,0.001,694,710,50,50,0.001,1404,9
0.66,0.001,743,761,50,50,0.001,1504,9
0.662,0.001,796,808,50,50,0.001,1604,9
0.664,0.001,851,853,50,50,0.001,1704,9
0.68,0.001,897,907,50,50,0.001,1804,9
0.706,0.001,949,955,50,50,0.001,1904,9
0.734,0.001,997,1007,50,50,0.001,2004,9
0.528,0.001,57,47,50,50,0.001,104,10
0.528,0.001,113,91,50,50,0.001,204,10
0.53,0.001,168,136,50,50,0.001,304,10
0.532,0.001,214,190,50,50,0.001,404,10
0.534,0.001,266,238,50,50,0.001,504,10
0.542,0.001,312,292,50,50,0.001,604,10
0.554,0.001,362,342,50,50,0.001,704,10
0.564,0.001,411,393,50,50,0.001,804,10
0.566,0.001,465,439,50,50,0.001,904,10
0.58,0.001,513,491,50,50,0.001,1004,10
0.584,0.001,567,537,50,50,0.001,1104,10
0.616,0.001,618,586,50,50,0.001,1204,10
0.632,0.001,663,641,50,50,0.001,1304,10
0.65,0.001,713,691,50,50,0.001,1404,10
0.664,0.001,766,738,50,50,0.001,1504,10
0.69,0.001,817,787,50,50,0.001,1604,10
0.712,0.001,860,844,50,50,0.001,1704,10
0.738,0.001,899,905,50,50,0.001,1804,10
0.768,0.001,946,958,50,50,0.001,1904,10
0.79,0.001,994,1010,50,50,0.001,2004,10
0.512,0.001,53,51,50,50,0.001,104,11
0.532,0.001,103,101,50,50,0.001,204,11
0.53,0.001,150,154,50,50,0.001,304,11
0.544,0.001,204,200,50,50,0.001,404,11
0.54,0.001,254,250,50,50,0.001,504,11
0.548,0.001,306,298,50,50,0.001,604,11
0.558,0.001,351,353,50,50,0.001,704,11
0.574,0.001,406,398,50,50,0.001,804,11
0.576,0.001,458,446,50,50,0.001,904,11
0.584,0.001,513,491,50,50,0.001,1004,11
0.602,0.001,564,540,50,50,0.001,1104,11
0.612,0.001,613,591,50,50,0.001,1204,11
0.614,0.001,662,642,50,50,0.001,1304,11
0.634,0.001,704,700,50,50,0.001,1404,11
0.66,0.001,748,756,50,50,0.001,1504,11
0.668,0.001,793,811,50,50,0.001,1604,11
0.68,0.001,843,861,50,50,0.001,1704,11
0.704,0.001,892,912,50,50,0.001,1804,11
0.75,0.001,948,956,50,50,0.001,1904,11
0.768,0.001,996,1008,50,50,0.001,2004,11
0.47,0.001,55,49,50,50,0.001,104,12
0.482,0.001,104,100,50,50,0.001,204,12
0.49,0.001,153,151,50,50,0.001,304,12
0.492,0.001,210,194,50,50,0.001,404,12
0.502,0.001,266,238,50,50,0.001,504,12
0.512,0.001,316,288,50,50,0.001,604,12
0.52,0.001,361,343,50,50,0.001,704,12
0.526,0.001,407,397,50,50,0.001,804,12
0.54,0.001,453,451,50,50,0.001,904,12
0.56,0.001,504,500,50,50,0.001,1004,12
0.562,0.001,550,554,50,50,0.001,1104,12
0.582,0.001,604,600,50,50,0.001,1204,12
0.606,0.001,661,643,50,50,0.001,1304,12
0.624,0.001,702,702,50,50,0.001,1404,12
0.642,0.001,753,751,50,50,0.001,1504,12
0.664,0.001,805,799,50,50,0.001,1604,12
0.68,0.001,855,849,50,50,0.001,1704,12
0.712,0.001,910,894,50,50,0.001,1804,12
0.726,0.001,963,941,50,50,0.001,1904,12
0.742,0.001,1017,987,50,50,0.001,2004,12
0.488,0.001,50,54,50,50,0.001,104,13
0.5,0.001,115,89,50,50,0.001,204,13
0.498,0.001,163,141,50,50,0.001,304,13
0.52,0.001,209,195,50,50,0.001,404,13
0.526,0.001,264,240,50,50,0.001,504,13
0.536,0.001,309,295,50,50,0.001,604,13
0.552,0.001,359,345,50,50,0.001,704,13
0.562,0.001,406,398,50,50,0.001,804,13
0.584,0.001,457,447,50,50,0.001,904,13
0.598,0.001,505,499,50,50,0.001,1004,13
0.602,0.001,539,565,50,50,0.001,1104,13
0.624,0.001,598,606,50,50,0.001,1204,13
0.644,0.001,647,657,50,50,0.001,1304,13
0.648,0.001,695,709,50,50,0.001,1404,13
0.656,0.001,744,760,50,50,0.001,1504,13
0.666,0.001,793,811,50,50,0.001,1604,13
0.694,0.001,846,858,50,50,0.001,1704,13
0.712,0.001,890,914,50,50,0.001,1804,13
0.728,0.001,945,959,50,50,0.001,1904,13
0.762,0.001,999,1005,50,50,0.001,2004,13
0.506,0.001,46,58,50,50,0.001,104,14
0.506,0.001,103,101,50,50,0.001,204,14
0.504,0.001,166,138,50,50,0.001,304,14
0.508,0.001,221,183,50,50,0.001,404,14
0.504,0.001,270,234,50,50,0.001,504,14
0.508,0.001,313,291,50,50,0.001,604,14
0.508,0.001,348,356,50,50,0.001,704,14
0.536,0.001,401,403,50,50,0.001,804,14
0.54,0.001,451,453,50,50,0.001,904,14
0.556,0.001,497,507,50,50,0.001,1004,14
0.568,0.001,541,563,50,50,0.001,1104,14
0.594,0.001,593,611,50,50,0.001,1204,14
0.602,0.001,653,651,50,50,0.001,1304,14
0.628,0.001,692,712,50,50,0.001,1404,14
0.656,0.001,744,760,50,50,0.001,1504,14
0.678,0.001,792,812,50,50,0.001,1604,14
0.7,0.001,838,866,50,50,0.001,1704,14
0.71,0.001,884,920,50,50,0.001,1804,14
0.724,0.001,935,969,50,50,0.001,1904,14
0.744,0.001,997,1007,50,50,0.001,2004,14
0.522,0.001,46,58,50,50,0.001,104,15
0.532,0.001,97,107,50,50,0.001,204,15
0.538,0.001,158,146,50,50,0.001,304,15
0.546,0.001,213,191,50,50,0.001,404,15
0.552,0.001,264,240,50,50,0.001,504,15
0.564,0.001,326,278,50,50,0.001,604,15
0.564,0.001,369,335,50,50,0.001,704,15
0.572,0.001,413,391,50,50,0.001,804,15
0.576,0.001,451,453,50,50,0.001,904,15
0.592,0.001,498,506,50,50,0.001,1004,15
0.6,0.001,555,549,50,50,0.001,1104,15
0.608,0.001,602,602,50,50,0.001,1204,15
0.616,0.001,652,652,50,50,0.001,1304,15
0.63,0.001,706,698,50,50,0.001,1404,15
0.644,0.001,756,748,50,50,0.001,1504,15
0.652,0.001,812,792,50,50,0.001,1604,15
0.686,0.001,868,836,50,50,0.001,1704,15
0.698,0.001,920,884,50,50,0.001,1804,15
0.718,0.001,965,939,50,50,0.001,1904,15
0.748,0.001,1006,998,50,50,0.001,2004,15
0.55,0.001,52,52,50,50,0.001,104,16
0.556,0.001,89,115,50,50,0.001,204,16
0.554,0.001,141,163,50,50,0.001,304,16
0.554,0.001,183,221,50,50,0.001,404,16
0.57,0.001,235,269,50,50,0.001,504,16
0.574,0.001,286,318,50,50,0.001,604,16
0.59,0.001,344,360,50,50,0.001,704,16
0.588,0.001,400,404,50,50,0.001,804,16
0.576,0.001,454,450,50,50,0.001,904,16
0.578,0.001,502,502,50,50,0.001,1004,16
0.584,0.001,548,556,50,50,0.001,1104,16
0.6,0.001,597,607,50,50,0.001,1204,16
0.616,0.001,637,667,50,50,0.001,1304,16
0.63,0.001,694,710,50,50,0.001,1404,16
0.656,0.001,741,763,50,50,0.001,1504,16
0.69,0.001,790,814,50,50,0.001,1604,16
0.708,0.001,839,865,50,50,0.001,1704,16
0.724,0.001,889,915,50,50,0.001,1804,16
0.738,0.001,940,964,50,50,0.001,1904,16
0.75,0.001,987,1017,50,50,0.001,2004,16
0.504,0.001,51,53,50,50,0.001,104,17
0.518,0.001,109,95,50,50,0.001,204,17
0.526,0.001,171,133,50,50,0.001,304,17
0.528,0.001,214,190,50,50,0.001,404,17
0.53,0.001,270,234,50,50,0.001,504,17
0.538,0.001,322,282,50,50,0.001,604,17
0.52,0.001,373,331,50,50,0.001,704,17
0.536,0.001,429,375,50,50,0.001,804,17
0.54,0.001,473,431,50,50,0.001,904,17
0.54,0.001,522,482,50,50,0.001,1004,17
0.562,0.001,574,530,50,50,0.001,1104,17
0.568,0.001,622,582,50,50,0.001,1204,17
0.582,0.001,672,632,50,50,0.001,1304,17
0.616,0.001,722,682,50,50,0.001,1404,17
0.604,0.001,768,736,50,50,0.001,1504,17
0.63,0.001,826,778,50,50,0.001,1604,17
0.644,0.001,873,831,50,50,0.001,1704,17
0.678,0.001,924,880,50,50,0.001,1804,17
0.716,0.001,973,931,50,50,0.001,1904,17
0.756,0.001,1015,989,50,50,0.001,2004,17
0.548,0.001,54,50,50,50,0.001,104,18
0.554,0.001,103,101,50,50,0.001,204,18
0.556,0.001,152,152,50,50,0.001,304,18
0.558,0.001,207,197,50,50,0.001,404,18
0.558,0.001,258,246,50,50,0.001,504,18
0.558,0.001,305,299,50,50,0.001,604,18
0.56,0.001,350,354,50,50,0.001,704,18
0.562,0.001,396,408,50,50,0.001,804,18
0.57,0.001,447,457,50,50,0.001,904,18
0.568,0.001,490,514,50,50,0.001,1004,18
0.592,0.001,531,573,50,50,0.001,1104,18
0.586,0.001,577,627,50,50,0.001,1204,18
0.606,0.001,628,676,50,50,0.001,1304,18
0.634,0.001,688,716,50,50,0.001,1404,18
0.648,0.001,744,760,50,50,0.001,1504,18
0.682,0.001,798,806,50,50,0.001,1604,18
0.71,0.001,845,859,50,50,0.001,1704,18
0.736,0.001,890,914,50,50,0.001,1804,18
0.744,0.001,938,966,50,50,0.001,1904,18
0.768,0.001,991,1013,50,50,0.001,2004,18
0.524,0.001,51,53,50,50,0.001,104,19
0.52,0.001,96,108,50,50,0.001,204,19
0.522,0.001,143,161,50,50,0.001,304,19
0.526,0.001,188,216,50,50,0.001,404,19
0.526,0.001,245,259,50,50,0.001,504,19
0.53,0.001,293,311,50,50,0.001,604,19
0.528,0.001,336,368,50,50,0.001,704,19
0.526,0.001,393,411,50,50,0.001,804,19
0.542,0.001,444,460,50,50,0.001,904,19
0.544,0.001,490,514,50,50,0.001,1004,19
0.556,0.001,541,563,50,50,0.001,1104,19
0.556,0.001,594,610,50,50,0.001,1204,19
0.57,0.001,640,664,50,50,0.001,1304,19
0.596,0.001,692,712,50,50,0.001,1404,19
0.618,0.001,742,762,50,50,0.001,1504,19
0.638,0.001,791,813,50,50,0.001,1604,19
0.656,0.001,839,865,50,50,0.001,1704,19
0.678,0.001,888,916,50,50,0.001,1804,19
0.704,0.001,931,973,50,50,0.001,1904,19
0.738,0.001,983,1021,50,50,0.001,2004,19
0.542,0.001,43,61,50,50,0.001,104,20
0.548,0.001,87,117,50,50,0.001,204,20
0.548,0.001,124,180,50,50,0.001,304,20
0.554,0.001,181,223,50,50,0.001,404,20
0.538,0.001,236,268,50,50,0.001,504,20
0.546,0.001,290,314,50,50,0.001,604,20
0.558,0.001,347,357,50,50,0.001,704,20
0.558,0.001,395,409,50,50,0.001,804,20
0.57,0.001,446,458,50,50,0.001,904,20
0.572,0.001,504,500,50,50,0.001,1004,20
0.588,0.001,555,549,50,50,0.001,1104,20
0.602,0.001,604,600,50,50,0.001,1204,20
0.612,0.001,656,648,50,50,0.001,1304,20
0.616,0.001,709,695,50,50,0.001,1404,20
0.634,0.001,756,748,50,50,0.001,1504,20
0.654,0.001,802,802,50,50,0.001,1604,20
0.67,0.001,852,852,50,50,0.001,1704,20
0.688,0.001,895,909,50,50,0.001,1804,20
0.704,0.001,946,958,50,50,0.001,1904,20
0.72,0.001,1006,998,50,50,0.001,2004,20
0.514,0.001,49,55,50,50,0.01,104,1
0.512,0.001,104,100,50,50,0.01,204,1
0.492,0.001,139,165,50,50,0.01,304,1
0.522,0.001,185,219,50,50,0.01,404,1
0.54,0.001,246,258,50,50,0.01,504,1
0.584,0.001,292,312,50,50,0.01,604,1
0.64,0.001,337,367,50,50,0.01,704,1
0.678,0.001,388,416,50,50,0.01,804,1
0.738,0.001,436,468,50,50,0.01,904,1
0.806,0.001,493,511,50,50,0.01,1004,1
0.89,0.001,536,568,50,50,0.01,1104,1
0.924,0.001,587,617,50,50,0.01,1204,1
0.922,0.001,639,665,50,50,0.01,1304,1
0.932,0.001,685,719,50,50,0.01,1404,1
0.936,0.001,737,767,50,50,0.01,1504,1
0.946,0.001,792,812,50,50,0.01,1604,1
0.948,0.001,842,862,50,50,0.01,1704,1
0.958,0.001,891,913,50,50,0.01,1804,1
0.962,0.001,946,958,50,50,0.01,1904,1
0.962,0.001,996,1008,50,50,0.01,2004,1
0.512,0.001,47,57,50,50,0.01,104,2
0.542,0.001,105,99,50,50,0.01,204,2
0.59,0.001,154,150,50,50,0.01,304,2
0.598,0.001,194,210,50,50,0.01,404,2
0.61,0.001,246,258,50,50,0.01,504,2
0.66,0.001,290,314,50,50,0.01,604,2
0.686,0.001,342,362,50,50,0.01,704,2
0.742,0.001,393,411,50,50,0.01,804,2
0.784,0.001,443,461,50,50,0.01,904,2
0.828,0.001,483,521,50,50,0.01,1004,2
0.872,0.001,539,565,50,50,0.01,1104,2
0.9,0.001,594,610,50,50,0.01,1204,2
0.92,0.001,641,663,50,50,0.01,1304,2
0.936,0.001,696,708,50,50,0.01,1404,2
0.942,0.001,751,753,50,50,0.01,1504,2
0.954,0.001,795,809,50,50,0.01,1604,2
0.95,0.001,842,862,50,50,0.01,1704,2
0.956,0.001,893,911,50,50,0.01,1804,2
0.964,0.001,937,967,50,50,0.01,1904,2
0.966,0.001,989,1015,50,50,0.01,2004,2
0.484,0.001,57,47,50,50,0.01,104,3
0.54,0.001,108,96,50,50,0.01,204,3
0.536,0.001,161,143,50,50,0.01,304,3
0.554,0.001,210,194,50,50,0.01,404,3
0.596,0.001,251,253,50,50,0.01,504,3
0.654,0.001,304,300,50,50,0.01,604,3
0.696,0.001,352,352,50,50,0.01,704,3
0.74,0.001,407,397,50,50,0.01,804,3
0.798,0.001,457,447,50,50,0.01,904,3
0.834,0.001,504,500,50,50,0.01,1004,3
0.872,0.001,552,552,50,50,0.01,1104,3
0.922,0.001,597,607,50,50,0.01,1204,3
0.932,0.001,651,653,50,50,0.01,1304,3
0.942,0.001,702,702,50,50,0.01,1404,3
0.944,0.001,755,749,50,50,0.01,1504,3
0.95,0.001,803,801,50,50,0.01,1604,3
0.96,0.001,853,851,50,50,0.01,1704,3
0.96,0.001,907,897,50,50,0.01,1804,3
0.96,0.001,951,953,50,50,0.01,1904,3
0.964,0.001,1002,1002,50,50,0.01,2004,3
0.478,0.001,53,51,50,50,0.01,104,4
0.55,0.001,101,103,50,50,0.01,204,4
0.594,0.001,139,165,50,50,0.01,304,4
0.608,0.001,190,214,50,50,0.01,404,4
0.602,0.001,241,263,50,50,0.01,504,4
0.63,0.001,292,312,50,50,0.01,604,4
0.654,0.001,352,352,50,50,0.01,704,4
0.724,0.001,402,402,50,50,0.01,804,4
0.758,0.001,451,453,50,50,0.01,904,4
0.81,0.001,504,500,50,50,0.01,1004,4
0.846,0.001,553,551,50,50,0.01,1104,4
0.878,0.001,604,600,50,50,0.01,1204,4
0.908,0.001,653,651,50,50,0.01,1304,4
0.942,0.001,698,706,50,50,0.01,1404,4
0.938,0.001,751,753,50,50,0.01,1504,4
0.946,0.001,808,796,50,50,0.01,1604,4
0.956,0.001,862,842,50,50,0.01,1704,4
0.944,0.001,909,895,50,50,0.01,1804,4
0.954,0.001,960,944,50,50,0.01,1904,4
0.948,0.001,1003,1001,50,50,0.01,2004,4
0.508,0.001,52,52,50,50,0.01,104,5
0.554,0.001,103,101,50,50,0.01,204,5
0.568,0.001,153,151,50,50,0.01,304,5
0.59,0.001,203,201,50,50,0.01,404,5
0.6,0.001,260,244,50,50,0.01,504,5
0.644,0.001,306,298,50,50,0.01,604,5
0.666,0.001,352,352,50,50,0.01,704,5
0.698,0.001,408,396,50,50,0.01,804,5
0.722,0.001,461,443,50,50,0.01,904,5
0.77,0.001,513,491,50,50,0.01,1004,5
0.81,0.001,556,548,50,50,0.01,1104,5
0.882,0.001,601,603,50,50,0.01,1204,5
0.916,0.001,656,648,50,50,0.01,1304,5
0.934,0.001,700,704,50,50,0.01,1404,5
0.942,0.001,756,748,50,50,0.01,1504,5
0.958,0.001,808,796,50,50,0.01,1604,5
0.96,0.001,850,854,50,50,0.01,1704,5
0.966,0.001,902,902,50,50,0.01,1804,5
0.97,0.001,952,952,50,50,0.01,1904,5
0.97,0.001,1010,994,50,50,0.01,2004,5
0.55,0.001,55,49,50,50,0.01,104,6
0.6,0.001,104,100,50,50,0.01,204,6
0.602,0.001,160,144,50,50,0.01,304,6
0.602,0.001,207,197,50,50,0.01,404,6
0.632,0.001,258,246,50,50,0.01,504,6
0.674,0.001,311,293,50,50,0.01,604,6
0.692,0.001,356,348,50,50,0.01,704,6
0.748,0.001,403,401,50,50,0.01,804,6
0.796,0.001,456,448,50,50,0.01,904,6
0.856,0.001,507,497,50,50,0.01,1004,6
0.864,0.001,556,548,50,50,0.01,1104,6
0.92,0.001,615,589,50,50,0.01,1204,6
0.93,0.001,662,642,50,50,0.01,1304,6
0.932,0.001,709,695,50,50,0.01,1404,6
0.954,0.001,759,745,50,50,0.01,1504,6
0.958,0.001,807,797,50,50,0.01,1604,6
0.962,0.001,850,854,50,50,0.01,1704,6
0.966,0.001,909,895,50,50,0.01,1804,6
0.958,0.001,960,944,50,50,0.01,1904,6
0.962,0.001,1004,1000,50,50,0.01,2004,6
0.566,0.001,53,51,50,50,0.01,104,7
0.564,0.001,102,102,50,50,0.01,204,7
0.584,0.001,151,153,50,50,0.01,304,7
0.626,0.001,206,198,50,50,0.01,404,7
0.644,0.001,254,250,50,50,0.01,504,7
0.692,0.001,308,296,50,50,0.01,604,7
0.726,0.001,361,343,50,50,0.01,704,7
0.784,0.001,413,391,50,50,0.01,804,7
0.824,0.001,459,445,50,50,0.01,904,7
0.886,0.001,513,491,50,50,0.01,1004,7
0.928,0.001,571,533,50,50,0.01,1104,7
0.946,0.001,618,586,50,50,0.01,1204,7
0.948,0.001,664,640,50,50,0.01,1304,7
0.954,0.001,706,698,50,50,0.01,1404,7
0.956,0.001,754,750,50,50,0.01,1504,7
0.96,0.001,807,797,50,50,0.01,1604,7
0.962,0.001,844,860,50,50,0.01,1704,7
0.97,0.001,891,913,50,50,0.01,1804,7
0.972,0.001,950,954,50,50,0.01,1904,7
0.966,0.001,1005,999,50,50,0.01,2004,7
0.534,0.001,52,52,50,50,0.01,104,8
0.55,0.001,107,97,50,50,0.01,204,8
0.546,0.001,153,151,50,50,0.01,304,8
0.56,0.001,210,194,50,50,0.01,404,8
0.578,0.001,257,247,50,50,0.01,504,8
0.624,0.001,297,307,50,50,0.01,604,8
0.65,0.001,351,353,50,50,0.01,704,8
0.696,0.001,404,400,50,50,0.01,804,8
0.76,0.001,459,445,50,50,0.01,904,8
0.842,0.001,512,492,50,50,0.01,1004,8
0.878,0.001,557,547,50,50,0.01,1104,8
0.916,0.001,611,593,50,50,0.01,1204,8
0.936,0.001,652,652,50,50,0.01,1304,8
0.936,0.001,697,707,50,50,0.01,1404,8
0.95,0.001,744,760,50,50,0.01,1504,8
0.966,0.001,792,812,50,50,0.01,1604,8
0.968,0.001,847,857,50,50,0.01,1704,8
0.968,0.001,902,902,50,50,0.01,1804,8
0.968,0.001,950,954,50,50,0.01,1904,8
0.974,0.001,1008,996,50,50,0.01,2004,8
0.52,0.001,45,59,50,50,0.01,104,9
0.544,0.001,94,110,50,50,0.01,204,9
0.548,0.001,143,161,50,50,0.01,304,9
0.552,0.001,195,209,50,50,0.01,404,9
0.58,0.001,251,253,50,50,0.01,504,9
0.632,0.001,303,301,50,50,0.01,604,9
0.648,0.001,355,349,50,50,0.01,704,9
0.684,0.001,402,402,50,50,0.01,804,9
0.726,0.001,451,453,50,50,0.01,904,9
0.778,0.001,502,502,50,50,0.01,1004,9
0.832,0.001,554,550,50,50,0.01,1104,9
0.874,0.001,615,589,50,50,0.01,1204,9
0.914,0.001,661,643,50,50,0.01,1304,9
0.946,0.001,713,691,50,50,0.01,1404,9
0.962,0.001,762,742,50,50,0.01,1504,9
0.966,0.001,816,788,50,50,0.01,1604,9
0.968,0.001,866,838,50,50,0.01,1704,9
0.97,0.001,920,884,50,50,0.01,1804,9
0.972,0.001,964,940,50,50,0.01,1904,9
0.97,0.001,1020,984,50,50,0.01,2004,9
0.502,0.001,48,56,50,50,0.01,104,10
0.626,0.001,93,111,50,50,0.01,204,10
0.592,0.001,143,161,50,50,0.01,304,10
0.598,0.001,190,214,50,50,0.01,404,10
0.628,0.001,245,259,50,50,0.01,504,10
0.686,0.001,295,309,50,50,0.01,604,10
0.74,0.001,346,358,50,50,0.01,704,10
0.812,0.001,395,409,50,50,0.01,804,10
0.844,0.001,438,466,50,50,0.01,904,10
0.862,0.001,488,516,50,50,0.01,1004,10
0.918,0.001,537,567,50,50,0.01,1104,10
0.942,0.001,595,609,50,50,0.01,1204,10
0.938,0.001,644,660,50,50,0.01,1304,10
0.954,0.001,695,709,50,50,0.01,1404,10
0.962,0.001,753,751,50,50,0.01,1504,10
0.962,0.001,795,809,50,50,0.01,1604,10
0.966,0.001,856,848,50,50,0.01,1704,10
0.97,0.001,913,891,50,50,0.01,1804,10
0.968,0.001,962,942,50,50,0.01,1904,10
0.964,0.001,1010,994,50,50,0.01,2004,10
0.536,0.001,49,55,50,50,0.01,104,11
0.548,0.001,100,104,50,50,0.01,204,11
0.544,0.001,156,148,50,50,0.01,304,11
0.572,0.001,205,199,50,50,0.01,404,11
0.598,0.001,257,247,50,50,0.01,504,11
0.638,0.001,303,301,50,50,0.01,604,11
0.658,0.001,351,353,50,50,0.01,704,11
0.704,0.001,408,396,50,50,0.01,804,11
0.744,0.001,458,446,50,50,0.01,904,11
0.842,0.001,506,498,50,50,0.01,1004,11
0.878,0.001,549,555,50,50,0.01,1104,11
0.906,0.001,601,603,50,50,0.01,1204,11
0.918,0.001,647,657,50,50,0.01,1304,11
0.928,0.001,696,708,50,50,0.01,1404,11
0.932,0.001,744,760,50,50,0.01,1504,11
0.944,0.001,794,810,50,50,0.01,1604,11
0.948,0.001,837,867,50,50,0.01,1704,11
0.954,0.001,880,924,50,50,0.01,1804,11
0.956,0.001,941,963,50,50,0.01,1904,11
0.958,0.001,989,1015,50,50,0.01,2004,11
0.508,0.001,62,42,50,50,0.01,104,12
0.55,0.001,111,93,50,50,0.01,204,12
0.556,0.001,165,139,50,50,0.01,304,12
0.57,0.001,220,184,50,50,0.01,404,12
0.588,0.001,271,233,50,50,0.01,504,12
0.616,0.001,317,287,50,50,0.01,604,12
0.676,0.001,373,331,50,50,0.01,704,12
0.788,0.001,435,369,50,50,0.01,804,12
0.838,0.001,479,425,50,50,0.01,904,12
0.896,0.001,530,474,50,50,0.01,1004,12
0.91,0.001,583,521,50,50,0.01,1104,12
0.934,0.001,633,571,50,50,0.01,1204,12
0.948,0.001,678,626,50,50,0.01,1304,12
0.942,0.001,722,682,50,50,0.01,1404,12
0.952,0.001,766,738,50,50,0.01,1504,12
0.956,0.001,802,802,50,50,0.01,1604,12
0.956,0.001,860,844,50,50,0.01,1704,12
0.964,0.001,909,895,50,50,0.01,1804,12
0.964,0.001,958,946,50,50,0.01,1904,12
0.966,0.001,1009,995,50,50,0.01,2004,12
0.51,0.001,56,48,50,50,0.01,104,13
0.538,0.001,106,98,50,50,0.01,204,13
0.582,0.001,157,147,50,50,0.01,304,13
0.61,0.001,208,196,50,50,0.01,404,13
0.624,0.001,258,246,50,50,0.01,504,13
0.666,0.001,308,296,50,50,0.01,604,13
0.704,0.001,359,345,50,50,0.01,704,13
0.778,0.001,404,400,50,50,0.01,804,13
0.82,0.001,449,455,50,50,0.01,904,13
0.858,0.001,496,508,50,50,0.01,1004,13
0.898,0.001,544,560,50,50,0.01,1104,13
0.922,0.001,599,605,50,50,0.01,1204,13
0.942,0.001,659,645,50,50,0.01,1304,13
0.95,0.001,705,699,50,50,0.01,1404,13
0.956,0.001,757,747,50,50,0.01,1504,13
0.96,0.001,806,798,50,50,0.01,1604,13
0.964,0.001,856,848,50,50,0.01,1704,13
0.966,0.001,903,901,50,50,0.01,1804,13
0.97,0.001,952,952,50,50,0.01,1904,13
0.976,0.001,998,1006,50,50,0.01,2004,13
0.498,0.001,49,55,50,50,0.01,104,14
0.564,0.001,100,104,50,50,0.01,204,14
0.596,0.001,143,161,50,50,0.01,304,14
0.632,0.001,188,216,50,50,0.01,404,14
0.658,0.001,247,257,50,50,0.01,504,14
0.706,0.001,297,307,50,50,0.01,604,14
0.728,0.001,342,362,50,50,0.01,704,14
0.808,0.001,390,414,50,50,0.01,804,14
0.834,0.001,441,463,50,50,0.01,904,14
0.88,0.001,490,514,50,50,0.01,1004,14
0.902,0.001,541,563,50,50,0.01,1104,14
0.914,0.001,581,623,50,50,0.01,1204,14
0.924,0.001,637,667,50,50,0.01,1304,14
0.938,0.001,686,718,50,50,0.01,1404,14
0.938,0.001,740,764,50,50,0.01,1504,14
0.942,0.001,792,812,50,50,0.01,1604,14
0.946,0.001,846,858,50,50,0.01,1704,14
0.958,0.001,901,903,50,50,0.01,1804,14
0.956,0.001,939,965,50,50,0.01,1904,14
0.968,0.001,989,1015,50,50,0.01,2004,14
0.546,0.001,52,52,50,50,0.01,104,15
0.586,0.001,107,97,50,50,0.01,204,15
0.6,0.001,163,141,50,50,0.01,304,15
0.634,0.001,210,194,50,50,0.01,404,15
0.652,0.001,259,245,50,50,0.01,504,15
0.69,0.001,310,294,50,50,0.01,604,15
0.694,0.001,358,346,50,50,0.01,704,15
0.744,0.001,407,397,50,50,0.01,804,15
0.754,0.001,449,455,50,50,0.01,904,15
0.78,0.001,490,514,50,50,0.01,1004,15
0.814,0.001,544,560,50,50,0.01,1104,15
0.87,0.001,597,607,50,50,0.01,1204,15
0.872,0.001,650,654,50,50,0.01,1304,15
0.91,0.001,694,710,50,50,0.01,1404,15
0.926,0.001,749,755,50,50,0.01,1504,15
0.942,0.001,803,801,50,50,0.01,1604,15
0.952,0.001,852,852,50,50,0.01,1704,15
0.964,0.001,904,900,50,50,0.01,1804,15
0.964,0.001,957,947,50,50,0.01,1904,15
0.96,0.001,1011,993,50,50,0.01,2004,15
0.548,0.001,53,51,50,50,0.01,104,16
0.59,0.001,97,107,50,50,0.01,204,16
0.618,0.001,147,157,50,50,0.01,304,16
0.628,0.001,201,203,50,50,0.01,404,16
0.646,0.001,246,258,50,50,0.01,504,16
0.68,0.001,294,310,50,50,0.01,604,16
0.722,0.001,350,354,50,50,0.01,704,16
0.762,0.001,397,407,50,50,0.01,804,16
0.782,0.001,453,451,50,50,0.01,904,16
0.876,0.001,499,505,50,50,0.01,1004,16
0.908,0.001,548,556,50,50,0.01,1104,16
0.932,0.001,598,606,50,50,0.01,1204,16
0.94,0.001,652,652,50,50,0.01,1304,16
0.948,0.001,707,697,50,50,0.01,1404,16
0.952,0.001,756,748,50,50,0.01,1504,16
0.968,0.001,807,797,50,50,0.01,1604,16
0.968,0.001,853,851,50,50,0.01,1704,16
0.966,0.001,907,897,50,50,0.01,1804,16
0.966,0.001,956,948,50,50,0.01,1904,16
0.974,0.001,1005,999,50,50,0.01,2004,16
0.52,0.001,50,54,50,50,0.01,104,17
0.54,0.001,110,94,50,50,0.01,204,17
0.55,0.001,164,140,50,50,0.01,304,17
0.574,0.001,217,187,50,50,0.01,404,17
0.594,0.001,258,246,50,50,0.01,504,17
0.674,0.001,304,300,50,50,0.01,604,17
0.712,0.001,350,354,50,50,0.01,704,17
0.766,0.001,394,410,50,50,0.01,804,17
0.802,0.001,439,465,50,50,0.01,904,17
0.864,0.001,492,512,50,50,0.01,1004,17
0.906,0.001,538,566,50,50,0.01,1104,17
0.93,0.001,585,619,50,50,0.01,1204,17
0.948,0.001,632,672,50,50,0.01,1304,17
0.962,0.001,688,716,50,50,0.01,1404,17
0.97,0.001,742,762,50,50,0.01,1504,17
0.958,0.001,795,809,50,50,0.01,1604,17
0.964,0.001,849,855,50,50,0.01,1704,17
0.972,0.001,898,906,50,50,0.01,1804,17
0.976,0.001,954,950,50,50,0.01,1904,17
0.978,0.001,1008,996,50,50,0.01,2004,17
0.518,0.001,53,51,50,50,0.01,104,18
0.512,0.001,106,98,50,50,0.01,204,18
0.51,0.001,155,149,50,50,0.01,304,18
0.546,0.001,208,196,50,50,0.01,404,18
0.572,0.001,264,240,50,50,0.01,504,18
0.608,0.001,313,291,50,50,0.01,604,18
0.658,0.001,356,348,50,50,0.01,704,18
0.72,0.001,415,389,50,50,0.01,804,18
0.782,0.001,465,439,50,50,0.01,904,18
0.824,0.001,512,492,50,50,0.01,1004,18
0.86,0.001,551,553,50,50,0.01,1104,18
0.908,0.001,611,593,50,50,0.01,1204,18
0.92,0.001,664,640,50,50,0.01,1304,18
0.946,0.001,710,694,50,50,0.01,1404,18
0.962,0.001,758,746,50,50,0.01,1504,18
0.964,0.001,800,804,50,50,0.01,1604,18
0.966,0.001,856,848,50,50,0.01,1704,18
0.964,0.001,910,894,50,50,0.01,1804,18
0.966,0.001,957,947,50,50,0.01,1904,18
0.968,0.001,1010,994,50,50,0.01,2004,18
0.516,0.001,54,50,50,50,0.01,104,19
0.554,0.001,108,96,50,50,0.01,204,19
0.586,0.001,166,138,50,50,0.01,304,19
0.608,0.001,219,185,50,50,0.01,404,19
0.63,0.001,273,231,50,50,0.01,504,19
0.656,0.001,318,286,50,50,0.01,604,19
0.688,0.001,364,340,50,50,0.01,704,19
0.736,0.001,414,390,50,50,0.01,804,19
0.762,0.001,463,441,50,50,0.01,904,19
0.812,0.001,515,489,50,50,0.01,1004,19
0.848,0.001,574,530,50,50,0.01,1104,19
0.898,0.001,625,579,50,50,0.01,1204,19
0.906,0.001,682,622,50,50,0.01,1304,19
0.926,0.001,728,676,50,50,0.01,1404,19
0.938,0.001,773,731,50,50,0.01,1504,19
0.946,0.001,815,789,50,50,0.01,1604,19
0.948,0.001,859,845,50,50,0.01,1704,19
0.958,0.001,913,891,50,50,0.01,1804,19
0.96,0.001,967,937,50,50,0.01,1904,19
0.958,0.001,1014,990,50,50,0.01,2004,19
0.554,0.001,59,45,50,50,0.01,104,20
0.584,0.001,107,97,50,50,0.01,204,20
0.596,0.001,161,143,50,50,0.01,304,20
0.616,0.001,210,194,50,50,0.01,404,20
0.638,0.001,255,249,50,50,0.01,504,20
0.688,0.001,295,309,50,50,0.01,604,20
0.734,0.001,347,357,50,50,0.01,704,20
0.8,0.001,398,406,50,50,0.01,804,20
0.828,0.001,440,464,50,50,0.01,904,20
0.864,0.001,496,508,50,50,0.01,1004,20
0.896,0.001,551,553,50,50,0.01,1104,20
0.916,0.001,594,610,50,50,0.01,1204,20
0.93,0.001,640,664,50,50,0.01,1304,20
0.95,0.001,687,717,50,50,0.01,1404,20
0.958,0.001,731,773,50,50,0.01,1504,20
0.946,0.001,778,826,50,50,0.01,1604,20
0.954,0.001,842,862,50,50,0.01,1704,20
0.966,0.001,884,920,50,50,0.01,1804,20
0.966,0.001,941,963,50,50,0.01,1904,20
0.962,0.001,1002,1002,50,50,0.01,2004,20
0.464,1e-05,54,50,50,100,0.0001,104,1
0.466,1e-05,103,101,50,100,0.0001,204,1
0.466,1e-05,150,154,50,100,0.0001,304,1
0.462,1e-05,195,209,50,100,0.0001,404,1
0.462,1e-05,241,263,50,100,0.0001,504,1
0.462,1e-05,295,309,50,100,0.0001,604,1
0.466,1e-05,353,351,50,100,0.0001,704,1
0.47,1e-05,398,406,50,100,0.0001,804,1
0.476,1e-05,442,462,50,100,0.0001,904,1
0.478,1e-05,496,508,50,100,0.0001,1004,1
0.48,1e-05,541,563,50,100,0.0001,1104,1
0.476,1e-05,592,612,50,100,0.0001,1204,1
0.478,1e-05,641,663,50,100,0.0001,1304,1
0.478,1e-05,693,711,50,100,0.0001,1404,1
0.478,1e-05,744,760,50,100,0.0001,1504,1
0.484,1e-05,806,798,50,100,0.0001,1604,1
0.482,1e-05,859,845,50,100,0.0001,1704,1
0.484,1e-05,900,904,50,100,0.0001,1804,1
0.486,1e-05,950,954,50,100,0.0001,1904,1
0.492,1e-05,1003,1001,50,100,0.0001,2004,1
0.476,1e-05,58,46,50,100,0.0001,104,2
0.476,1e-05,110,94,50,100,0.0001,204,2
0.476,1e-05,169,135,50,100,0.0001,304,2
0.476,1e-05,224,180,50,100,0.0001,404,2
0.474,1e-05,276,228,50,100,0.0001,504,2
0.474,1e-05,322,282,50,100,0.0001,604,2
0.476,1e-05,373,331,50,100,0.0001,704,2
0.476,1e-05,427,377,50,100,0.0001,804,2
0.476,1e-05,463,441,50,100,0.0001,904,2
0.476,1e-05,507,497,50,100,0.0001,1004,2
0.476,1e-05,550,554,50,100,0.0001,1104,2
0.474,1e-05,588,616,50,100,0.0001,1204,2
0.476,1e-05,644,660,50,100,0.0001,1304,2
0.478,1e-05,693,711,50,100,0.0001,1404,2
0.48,1e-05,741,763,50,100,0.0001,1504,2
0.48,1e-05,781,823,50,100,0.0001,1604,2
0.48,1e-05,833,871,50,100,0.0001,1704,2
0.484,1e-05,896,908,50,100,0.0001,1804,2
0.484,1e-05,945,959,50,100,0.0001,1904,2
0.488,1e-05,990,1014,50,100,0.0001,2004,2
0.504,1e-05,51,53,50,100,0.0001,104,3
0.506,1e-05,103,101,50,100,0.0001,204,3
0.51,1e-05,152,152,50,100,0.0001,304,3
0.508,1e-05,199,205,50,100,0.0001,404,3
0.508,1e-05,244,260,50,100,0.0001,504,3
0.512,1e-05,299,305,50,100,0.0001,604,3
0.51,1e-05,349,355,50,100,0.0001,704,3
0.512,1e-05,397,407,50,100,0.0001,804,3
0.512,1e-05,456,448,50,100,0.0001,904,3
0.512,1e-05,509,495,50,100,0.0001,1004,3
0.518,1e-05,552,552,50,100,0.0001,1104,3
0.524,1e-05,600,604,50,100,0.0001,1204,3
0.526,1e-05,648,656,50,100,0.0001,1304,3
0.528,1e-05,705,699,50,100,0.0001,1404,3
0.53,1e-05,765,739,50,100,0.0001,1504,3
0.526,1e-05,813,791,50,100,0.0001,1604,3
0.524,1e-05,866,838,50,100,0.0001,1704,3
0.536,1e-05,913,891,50,100,0.0001,1804,3
0.542,1e-05,955,949,50,100,0.0001,1904,3
0.542,1e-05,1004,1000,50,100,0.0001,2004,3
0.502,1e-05,54,50,50,100,0.0001,104,4
0.504,1e-05,94,110,50,100,0.0001,204,4
0.506,1e-05,140,164,50,100,0.0001,304,4
0.504,1e-05,187,217,50,100,0.0001,404,4
0.5,1e-05,235,269,50,100,0.0001,504,4
0.5,1e-05,287,317,50,100,0.0001,604,4
0.502,1e-05,328,376,50,100,0.0001,704,4
0.502,1e-05,378,426,50,100,0.0001,804,4
0.506,1e-05,435,469,50,100,0.0001,904,4
0.502,1e-05,487,517,50,100,0.0001,1004,4
0.508,1e-05,536,568,50,100,0.0001,1104,4
0.508,1e-05,596,608,50,100,0.0001,1204,4
0.514,1e-05,643,661,50,100,0.0001,1304,4
0.516,1e-05,693,711,50,100,0.0001,1404,4
0.514,1e-05,739,765,50,100,0.0001,1504,4
0.516,1e-05,791,813,50,100,0.0001,1604,4
0.522,1e-05,840,864,50,100,0.0001,1704,4
0.526,1e-05,891,913,50,100,0.0001,1804,4
0.53,1e-05,940,964,50,100,0.0001,1904,4
0.534,1e-05,998,1006,50,100,0.0001,2004,4
0.526,1e-05,48,56,50,100,0.0001,104,5
0.526,1e-05,101,103,50,100,0.0001,204,5
0.528,1e-05,150,154,50,100,0.0001,304,5
0.528,1e-05,207,197,50,100,0.0001,404,5
0.534,1e-05,258,246,50,100,0.0001,504,5
0.534,1e-05,310,294,50,100,0.0001,604,5
0.532,1e-05,360,344,50,100,0.0001,704,5
0.534,1e-05,406,398,50,100,0.0001,804,5
0.536,1e-05,452,452,50,100,0.0001,904,5
0.54,1e-05,500,504,50,100,0.0001,1004,5
0.542,1e-05,555,549,50,100,0.0001,1104,5
0.54,1e-05,604,600,50,100,0.0001,1204,5
0.542,1e-05,654,650,50,100,0.0001,1304,5
0.54,1e-05,698,706,50,100,0.0001,1404,5
0.542,1e-05,749,755,50,100,0.0001,1504,5
0.542,1e-05,800,804,50,100,0.0001,1604,5
0.55,1e-05,855,849,50,100,0.0001,1704,5
0.55,1e-05,903,901,50,100,0.0001,1804,5
0.554,1e-05,954,950,50,100,0.0001,1904,5
0.56,1e-05,1005,999,50,100,0.0001,2004,5
0.488,1e-05,43,61,50,100,0.0001,104,6
0.482,1e-05,94,110,50,100,0.0001,204,6
0.482,1e-05,137,167,50,100,0.0001,304,6
0.48,1e-05,185,219,50,100,0.0001,404,6
0.48,1e-05,236,268,50,100,0.0001,504,6
0.486,1e-05,290,314,50,100,0.0001,604,6
0.482,1e-05,340,364,50,100,0.0001,704,6
0.492,1e-05,394,410,50,100,0.0001,804,6
0.492,1e-05,436,468,50,100,0.0001,904,6
0.496,1e-05,494,510,50,100,0.0001,1004,6
0.496,1e-05,551,553,50,100,0.0001,1104,6
0.506,1e-05,596,608,50,100,0.0001,1204,6
0.512,1e-05,649,655,50,100,0.0001,1304,6
0.522,1e-05,708,696,50,100,0.0001,1404,6
0.528,1e-05,759,745,50,100,0.0001,1504,6
0.532,1e-05,807,797,50,100,0.0001,1604,6
0.54,1e-05,856,848,50,100,0.0001,1704,6
0.542,1e-05,896,908,50,100,0.0001,1804,6
0.55,1e-05,951,953,50,100,0.0001,1904,6
0.554,1e-05,1003,1001,50,100,0.0001,2004,6
0.534,1e-05,37,67,50,100,0.0001,104,7
0.532,1e-05,85,119,50,100,0.0001,204,7
0.536,1e-05,130,174,50,100,0.0001,304,7
0.536,1e-05,180,224,50,100,0.0001,404,7
0.534,1e-05,231,273,50,100,0.0001,504,7
0.534,1e-05,278,326,50,100,0.0001,604,7
0.534,1e-05,324,380,50,100,0.0001,704,7
0.536,1e-05,373,431,50,100,0.0001,804,7
0.542,1e-05,424,480,50,100,0.0001,904,7
0.546,1e-05,473,531,50,100,0.0001,1004,7
0.548,1e-05,521,583,50,100,0.0001,1104,7
0.552,1e-05,576,628,50,100,0.0001,1204,7
0.554,1e-05,627,677,50,100,0.0001,1304,7
0.558,1e-05,682,722,50,100,0.0001,1404,7
0.554,1e-05,731,773,50,100,0.0001,1504,7
0.554,1e-05,785,819,50,100,0.0001,1604,7
0.554,1e-05,837,867,50,100,0.0001,1704,7
0.554,1e-05,886,918,50,100,0.0001,1804,7
0.56,1e-05,936,968,50,100,0.0001,1904,7
0.56,1e-05,990,1014,50,100,0.0001,2004,7
0.476,1e-05,46,58,50,100,0.0001,104,8
0.476,1e-05,97,107,50,100,0.0001,204,8
0.476,1e-05,154,150,50,100,0.0001,304,8
0.472,1e-05,198,206,50,100,0.0001,404,8
0.476,1e-05,250,254,50,100,0.0001,504,8
0.474,1e-05,310,294,50,100,0.0001,604,8
0.476,1e-05,349,355,50,100,0.0001,704,8
0.478,1e-05,404,400,50,100,0.0001,804,8
0.478,1e-05,456,448,50,100,0.0001,904,8
0.48,1e-05,513,491,50,100,0.0001,1004,8
0.484,1e-05,566,538,50,100,0.0001,1104,8
0.49,1e-05,616,588,50,100,0.0001,1204,8
0.496,1e-05,660,644,50,100,0.0001,1304,8
0.498,1e-05,711,693,50,100,0.0001,1404,8
0.498,1e-05,758,746,50,100,0.0001,1504,8
0.498,1e-05,807,797,50,100,0.0001,1604,8
0.504,1e-05,855,849,50,100,0.0001,1704,8
0.51,1e-05,904,900,50,100,0.0001,1804,8
0.51,1e-05,960,944,50,100,0.0001,1904,8
0.516,1e-05,1007,997,50,100,0.0001,2004,8
0.484,1e-05,48,56,50,100,0.0001,104,9
0.484,1e-05,92,112,50,100,0.0001,204,9
0.482,1e-05,137,167,50,100,0.0001,304,9
0.488,1e-05,186,218,50,100,0.0001,404,9
0.49,1e-05,239,265,50,100,0.0001,504,9
0.49,1e-05,287,317,50,100,0.0001,604,9
0.488,1e-05,333,371,50,100,0.0001,704,9
0.492,1e-05,391,413,50,100,0.0001,804,9
0.492,1e-05,450,454,50,100,0.0001,904,9
0.492,1e-05,501,503,50,100,0.0001,1004,9
0.488,1e-05,550,554,50,100,0.0001,1104,9
0.486,1e-05,597,607,50,100,0.0001,1204,9
0.486,1e-05,646,658,50,100,0.0001,1304,9
0.49,1e-05,701,703,50,100,0.0001,1404,9
0.502,1e-05,748,756,50,100,0.0001,1504,9
0.498,1e-05,796,808,50,100,0.0001,1604,9
0.496,1e-05,855,849,50,100,0.0001,1704,9
0.5,1e-05,899,905,50,100,0.0001,1804,9
0.504,1e-05,950,954,50,100,0.0001,1904,9
0.506,1e-05,998,1006,50,100,0.0001,2004,9
0.546,1e-05,60,44,50,100,0.0001,104,10
0.546,1e-05,112,92,50,100,0.0001,204,10
0.546,1e-05,163,141,50,100,0.0001,304,10
0.546,1e-05,213,191,50,100,0.0001,404,10
0.548,1e-05,266,238,50,100,0.0001,504,10
0.546,1e-05,319,285,50,100,0.0001,604,10
0.542,1e-05,365,339,50,100,0.0001,704,10
0.546,1e-05,416,388,50,100,0.0001,804,10
0.548,1e-05,470,434,50,100,0.0001,904,10
0.554,1e-05,520,484,50,100,0.0001,1004,10
0.554,1e-05,566,538,50,100,0.0001,1104,10
0.55,1e-05,622,582,50,100,0.0001,1204,10
0.552,1e-05,672,632,50,100,0.0001,1304,10
0.55,1e-05,727,677,50,100,0.0001,1404,10
0.556,1e-05,776,728,50,100,0.0001,1504,10
0.56,1e-05,824,780,50,100,0.0001,1604,10
0.568,1e-05,865,839,50,100,0.0001,1704,10
0.572,1e-05,917,887,50,100,0.0001,1804,10
0.582,1e-05,968,936,50,100,0.0001,1904,10
0.584,1e-05,1010,994,50,100,0.0001,2004,10
0.474,1e-05,56,48,50,100,0.0001,104,11
0.474,1e-05,109,95,50,100,0.0001,204,11
0.47,1e-05,158,146,50,100,0.0001,304,11
0.47,1e-05,207,197,50,100,0.0001,404,11
0.466,1e-05,255,249,50,100,0.0001,504,11
0.464,1e-05,298,306,50,100,0.0001,604,11
0.464,1e-05,345,359,50,100,0.0001,704,11
0.468,1e-05,394,410,50,100,0.0001,804,11
0.47,1e-05,457,447,50,100,0.0001,904,11
0.472,1e-05,514,490,50,100,0.0001,1004,11
0.478,1e-05,562,542,50,100,0.0001,1104,11
0.48,1e-05,612,592,50,100,0.0001,1204,11
0.48,1e-05,666,638,50,100,0.0001,1304,11
0.478,1e-05,716,688,50,100,0.0001,1404,11
0.48,1e-05,771,733,50,100,0.0001,1504,11
0.488,1e-05,824,780,50,100,0.0001,1604,11
0.502,1e-05,870,834,50,100,0.0001,1704,11
0.51,1e-05,918,886,50,100,0.0001,1804,11
0.516,1e-05,968,936,50,100,0.0001,1904,11
0.522,1e-05,1010,994,50,100,0.0001,2004,11
0.548,1e-05,55,49,50,100,0.0001,104,12
0.548,1e-05,107,97,50,100,0.0001,204,12
0.548,1e-05,155,149,50,100,0.0001,304,12
0.548,1e-05,200,204,50,100,0.0001,404,12
0.546,1e-05,255,249,50,100,0.0001,504,12
0.546,1e-05,307,297,50,100,0.0001,604,12
0.546,1e-05,363,341,50,100,0.0001,704,12
0.544,1e-05,412,392,50,100,0.0001,804,12
0.542,1e-05,463,441,50,100,0.0001,904,12
0.544,1e-05,517,487,50,100,0.0001,1004,12
0.548,1e-05,561,543,50,100,0.0001,1104,12
0.546,1e-05,609,595,50,100,0.0001,1204,12
0.538,1e-05,666,638,50,100,0.0001,1304,12
0.544,1e-05,711,693,50,100,0.0001,1404,12
0.542,1e-05,763,741,50,100,0.0001,1504,12
0.542,1e-05,810,794,50,100,0.0001,1604,12
0.54,1e-05,863,841,50,100,0.0001,1704,12
0.548,1e-05,912,892,50,100,0.0001,1804,12
0.544,1e-05,958,946,50,100,0.0001,1904,12
0.56,1e-05,1009,995,50,100,0.0001,2004,12
0.548,1e-05,44,60,50,100,0.0001,104,13
0.544,1e-05,96,108,50,100,0.0001,204,13
0.542,1e-05,144,160,50,100,0.0001,304,13
0.54,1e-05,182,222,50,100,0.0001,404,13
0.54,1e-05,234,270,50,100,0.0001,504,13
0.544,1e-05,293,311,50,100,0.0001,604,13
0.546,1e-05,345,359,50,100,0.0001,704,13
0.544,1e-05,398,406,50,100,0.0001,804,13
0.542,1e-05,448,456,50,100,0.0001,904,13
0.538,1e-05,498,506,50,100,0.0001,1004,13
0.536,1e-05,546,558,50,100,0.0001,1104,13
0.536,1e-05,589,615,50,100,0.0001,1204,13
0.54,1e-05,643,661,50,100,0.0001,1304,13
0.544,1e-05,695,709,50,100,0.0001,1404,13
0.55,1e-05,747,757,50,100,0.0001,1504,13
0.552,1e-05,792,812,50,100,0.0001,1604,13
0.554,1e-05,836,868,50,100,0.0001,1704,13
0.55,1e-05,893,911,50,100,0.0001,1804,13
0.552,1e-05,941,963,50,100,0.0001,1904,13
0.552,1e-05,989,1015,50,100,0.0001,2004,13
0.484,1e-05,51,53,50,100,0.0001,104,14
0.492,1e-05,104,100,50,100,0.0001,204,14
0.486,1e-05,155,149,50,100,0.0001,304,14
0.49,1e-05,212,192,50,100,0.0001,404,14
0.488,1e-05,262,242,50,100,0.0001,504,14
0.488,1e-05,312,292,50,100,0.0001,604,14
0.492,1e-05,366,338,50,100,0.0001,704,14
0.496,1e-05,415,389,50,100,0.0001,804,14
0.496,1e-05,464,440,50,100,0.0001,904,14
0.502,1e-05,506,498,50,100,0.0001,1004,14
0.498,1e-05,556,548,50,100,0.0001,1104,14
0.498,1e-05,603,601,50,100,0.0001,1204,14
0.502,1e-05,661,643,50,100,0.0001,1304,14
0.508,1e-05,708,696,50,100,0.0001,1404,14
0.512,1e-05,754,750,50,100,0.0001,1504,14
0.514,1e-05,799,805,50,100,0.0001,1604,14
0.516,1e-05,852,852,50,100,0.0001,1704,14
0.528,1e-05,897,907,50,100,0.0001,1804,14
0.528,1e-05,945,959,50,100,0.0001,1904,14
0.538,1e-05,1001,1003,50,100,0.0001,2004,14
0.512,1e-05,56,48,50,100,0.0001,104,15
0.512,1e-05,100,104,50,100,0.0001,204,15
0.512,1e-05,148,156,50,100,0.0001,304,15
0.514,1e-05,200,204,50,100,0.0001,404,15
0.514,1e-05,244,260,50,100,0.0001,504,15
0.514,1e-05,287,317,50,100,0.0001,604,15
0.514,1e-05,334,370,50,100,0.0001,704,15
0.514,1e-05,398,406,50,100,0.0001,804,15
0.514,1e-05,449,455,50,100,0.0001,904,15
0.514,1e-05,496,508,50,100,0.0001,1004,15
0.512,1e-05,543,561,50,100,0.0001,1104,15
0.512,1e-05,602,602,50,100,0.0001,1204,15
0.512,1e-05,654,650,50,100,0.0001,1304,15
0.512,1e-05,701,703,50,100,0.0001,1404,15
0.512,1e-05,755,749,50,100,0.0001,1504,15
0.51,1e-05,804,800,50,100,0.0001,1604,15
0.508,1e-05,847,857,50,100,0.0001,1704,15
0.512,1e-05,900,904,50,100,0.0001,1804,15
0.51,1e-05,954,950,50,100,0.0001,1904,15
0.514,1e-05,1008,996,50,100,0.0001,2004,15
0.458,1e-05,54,50,50,100,0.0001,104,16
0.46,1e-05,108,96,50,100,0.0001,204,16
0.466,1e-05,158,146,50,100,0.0001,304,16
0.468,1e-05,217,187,50,100,0.0001,404,16
0.47,1e-05,263,241,50,100,0.0001,504,16
0.476,1e-05,314,290,50,100,0.0001,604,16
0.48,1e-05,365,339,50,100,0.0001,704,16
0.482,1e-05,402,402,50,100,0.0001,804,16
0.48,1e-05,448,456,50,100,0.0001,904,16
0.48,1e-05,500,504,50,100,0.0001,1004,16
0.484,1e-05,561,543,50,100,0.0001,1104,16
0.488,1e-05,607,597,50,100,0.0001,1204,16
0.496,1e-05,652,652,50,100,0.0001,1304,16
0.5,1e-05,701,703,50,100,0.0001,1404,16
0.502,1e-05,754,750,50,100,0.0001,1504,16
0.498,1e-05,798,806,50,100,0.0001,1604,16
0.506,1e-05,846,858,50,100,0.0001,1704,16
0.514,1e-05,898,906,50,100,0.0001,1804,16
0.518,1e-05,947,957,50,100,0.0001,1904,16
0.52,1e-05,996,1008,50,100,0.0001,2004,16
0.48,1e-05,46,58,50,100,0.0001,104,17
0.48,1e-05,100,104,50,100,0.0001,204,17
0.482,1e-05,153,151,50,100,0.0001,304,17
0.49,1e-05,204,200,50,100,0.0001,404,17
0.492,1e-05,253,251,50,100,0.0001,504,17
0.496,1e-05,310,294,50,100,0.0001,604,17
0.5,1e-05,355,349,50,100,0.0001,704,17
0.504,1e-05,405,399,50,100,0.0001,804,17
0.502,1e-05,457,447,50,100,0.0001,904,17
0.502,1e-05,508,496,50,100,0.0001,1004,17
0.504,1e-05,548,556,50,100,0.0001,1104,17
0.508,1e-05,597,607,50,100,0.0001,1204,17
0.512,1e-05,636,668,50,100,0.0001,1304,17
0.516,1e-05,684,720,50,100,0.0001,1404,17
0.518,1e-05,743,761,50,100,0.0001,1504,17
0.524,1e-05,798,806,50,100,0.0001,1604,17
0.526,1e-05,853,851,50,100,0.0001,1704,17
0.536,1e-05,904,900,50,100,0.0001,1804,17
0.538,1e-05,958,946,50,100,0.0001,1904,17
0.542,1e-05,1015,989,50,100,0.0001,2004,17
0.492,1e-05,53,51,50,100,0.0001,104,18
0.496,1e-05,96,108,50,100,0.0001,204,18
0.496,1e-05,153,151,50,100,0.0001,304,18
0.496,1e-05,208,196,50,100,0.0001,404,18
0.494,1e-05,250,254,50,100,0.0001,504,18
0.496,1e-05,299,305,50,100,0.0001,604,18
0.494,1e-05,346,358,50,100,0.0001,704,18
0.5,1e-05,392,412,50,100,0.0001,804,18
0.506,1e-05,443,461,50,100,0.0001,904,18
0.504,1e-05,490,514,50,100,0.0001,1004,18
0.504,1e-05,541,563,50,100,0.0001,1104,18
0.504,1e-05,587,617,50,100,0.0001,1204,18
0.502,1e-05,637,667,50,100,0.0001,1304,18
0.51,1e-05,692,712,50,100,0.0001,1404,18
0.516,1e-05,740,764,50,100,0.0001,1504,18
0.518,1e-05,784,820,50,100,0.0001,1604,18
0.516,1e-05,833,871,50,100,0.0001,1704,18
0.518,1e-05,890,914,50,100,0.0001,1804,18
0.52,1e-05,939,965,50,100,0.0001,1904,18
0.52,1e-05,995,1009,50,100,0.0001,2004,18
0.534,1e-05,54,50,50,100,0.0001,104,19
0.53,1e-05,106,98,50,100,0.0001,204,19
0.532,1e-05,152,152,50,100,0.0001,304,19
0.538,1e-05,205,199,50,100,0.0001,404,19
0.534,1e-05,254,250,50,100,0.0001,504,19
0.534,1e-05,310,294,50,100,0.0001,604,19
0.542,1e-05,362,342,50,100,0.0001,704,19
0.54,1e-05,414,390,50,100,0.0001,804,19
0.542,1e-05,455,449,50,100,0.0001,904,19
0.548,1e-05,512,492,50,100,0.0001,1004,19
0.55,1e-05,555,549,50,100,0.0001,1104,19
0.556,1e-05,613,591,50,100,0.0001,1204,19
0.556,1e-05,665,639,50,100,0.0001,1304,19
0.558,1e-05,712,692,50,100,0.0001,1404,19
0.562,1e-05,756,748,50,100,0.0001,1504,19
0.572,1e-05,805,799,50,100,0.0001,1604,19
0.578,1e-05,867,837,50,100,0.0001,1704,19
0.588,1e-05,917,887,50,100,0.0001,1804,19
0.59,1e-05,972,932,50,100,0.0001,1904,19
0.594,1e-05,1022,982,50,100,0.0001,2004,19
0.518,1e-05,48,56,50,100,0.0001,104,20
0.518,1e-05,96,108,50,100,0.0001,204,20
0.522,1e-05,143,161,50,100,0.0001,304,20
0.528,1e-05,196,208,50,100,0.0001,404,20
0.526,1e-05,253,251,50,100,0.0001,504,20
0.53,1e-05,302,302,50,100,0.0001,604,20
0.53,1e-05,346,358,50,100,0.0001,704,20
0.53,1e-05,393,411,50,100,0.0001,804,20
0.532,1e-05,440,464,50,100,0.0001,904,20
0.54,1e-05,489,515,50,100,0.0001,1004,20
0.542,1e-05,535,569,50,100,0.0001,1104,20
0.542,1e-05,587,617,50,100,0.0001,1204,20
0.546,1e-05,633,671,50,100,0.0001,1304,20
0.55,1e-05,688,716,50,100,0.0001,1404,20
0.55,1e-05,740,764,50,100,0.0001,1504,20
0.55,1e-05,785,819,50,100,0.0001,1604,20
0.55,1e-05,831,873,50,100,0.0001,1704,20
0.552,1e-05,877,927,50,100,0.0001,1804,20
0.558,1e-05,927,977,50,100,0.0001,1904,20
0.562,1e-05,978,1026,50,100,0.0001,2004,20
0.47,1e-05,58,46,50,100,0.001,104,1
0.482,1e-05,110,94,50,100,0.001,204,1
0.492,1e-05,163,141,50,100,0.001,304,1
0.498,1e-05,218,186,50,100,0.001,404,1
0.508,1e-05,264,240,50,100,0.001,504,1
0.526,1e-05,312,292,50,100,0.001,604,1
0.534,1e-05,365,339,50,100,0.001,704,1
0.546,1e-05,422,382,50,100,0.001,804,1
0.56,1e-05,472,432,50,100,0.001,904,1
0.578,1e-05,526,478,50,100,0.001,1004,1
0.6,1e-05,571,533,50,100,0.001,1104,1
0.614,1e-05,626,578,50,100,0.001,1204,1
0.632,1e-05,672,632,50,100,0.001,1304,1
0.642,1e-05,725,679,50,100,0.001,1404,1
0.676,1e-05,771,733,50,100,0.001,1504,1
0.69,1e-05,832,772,50,100,0.001,1604,1
0.724,1e-05,873,831,50,100,0.001,1704,1
0.748,1e-05,930,874,50,100,0.001,1804,1
0.772,1e-05,967,937,50,100,0.001,1904,1
0.81,1e-05,1010,994,50,100,0.001,2004,1
0.482,1e-05,51,53,50,100,0.001,104,2
0.5,1e-05,102,102,50,100,0.001,204,2
0.502,1e-05,159,145,50,100,0.001,304,2
0.5,1e-05,207,197,50,100,0.001,404,2
0.502,1e-05,250,254,50,100,0.001,504,2
0.512,1e-05,297,307,50,100,0.001,604,2
0.528,1e-05,347,357,50,100,0.001,704,2
0.552,1e-05,396,408,50,100,0.001,804,2
0.574,1e-05,453,451,50,100,0.001,904,2
0.596,1e-05,510,494,50,100,0.001,1004,2
0.608,1e-05,559,545,50,100,0.001,1104,2
0.644,1e-05,607,597,50,100,0.001,1204,2
0.666,1e-05,648,656,50,100,0.001,1304,2
0.692,1e-05,700,704,50,100,0.001,1404,2
0.706,1e-05,746,758,50,100,0.001,1504,2
0.724,1e-05,802,802,50,100,0.001,1604,2
0.756,1e-05,847,857,50,100,0.001,1704,2
0.79,1e-05,901,903,50,100,0.001,1804,2
0.806,1e-05,948,956,50,100,0.001,1904,2
0.832,1e-05,992,1012,50,100,0.001,2004,2
0.506,1e-05,43,61,50,100,0.001,104,3
0.508,1e-05,93,111,50,100,0.001,204,3
0.506,1e-05,139,165,50,100,0.001,304,3
0.524,1e-05,192,212,50,100,0.001,404,3
0.538,1e-05,243,261,50,100,0.001,504,3
0.55,1e-05,300,304,50,100,0.001,604,3
0.558,1e-05,351,353,50,100,0.001,704,3
0.58,1e-05,402,402,50,100,0.001,804,3
0.596,1e-05,453,451,50,100,0.001,904,3
0.618,1e-05,503,501,50,100,0.001,1004,3
0.65,1e-05,555,549,50,100,0.001,1104,3
0.684,1e-05,598,606,50,100,0.001,1204,3
0.704,1e-05,649,655,50,100,0.001,1304,3
0.716,1e-05,697,707,50,100,0.001,1404,3
0.74,1e-05,740,764,50,100,0.001,1504,3
0.774,1e-05,799,805,50,100,0.001,1604,3
0.774,1e-05,845,859,50,100,0.001,1704,3
0.798,1e-05,892,912,50,100,0.001,1804,3
0.808,1e-05,937,967,50,100,0.001,1904,3
0.828,1e-05,988,1016,50,100,0.001,2004,3
0.546,1e-05,53,51,50,100,0.001,104,4
0.556,1e-05,99,105,50,100,0.001,204,4
0.558,1e-05,150,154,50,100,0.001,304,4
0.56,1e-05,205,199,50,100,0.001,404,4
0.574,1e-05,259,245,50,100,0.001,504,4
0.568,1e-05,315,289,50,100,0.001,604,4
0.58,1e-05,360,344,50,100,0.001,704,4
0.588,1e-05,411,393,50,100,0.001,804,4
0.594,1e-05,468,436,50,100,0.001,904,4
0.612,1e-05,513,491,50,100,0.001,1004,4
0.626,1e-05,559,545,50,100,0.001,1104,4
0.62,1e-05,604,600,50,100,0.001,1204,4
0.656,1e-05,650,654,50,100,0.001,1304,4
0.688,1e-05,711,693,50,100,0.001,1404,4
0.696,1e-05,762,742,50,100,0.001,1504,4
0.716,1e-05,807,797,50,100,0.001,1604,4
0.744,1e-05,857,847,50,100,0.001,1704,4
0.782,1e-05,906,898,50,100,0.001,1804,4
0.806,1e-05,960,944,50,100,0.001,1904,4
0.82,1e-05,1007,997,50,100,0.001,2004,4
0.5,1e-05,49,55,50,100,0.001,104,5
0.514,1e-05,99,105,50,100,0.001,204,5
0.51,1e-05,149,155,50,100,0.001,304,5
0.518,1e-05,202,202,50,100,0.001,404,5
0.536,1e-05,249,255,50,100,0.001,504,5
0.544,1e-05,296,308,50,100,0.001,604,5
0.554,1e-05,351,353,50,100,0.001,704,5
0.58,1e-05,403,401,50,100,0.001,804,5
0.584,1e-05,448,456,50,100,0.001,904,5
0.612,1e-05,493,511,50,100,0.001,1004,5
0.63,1e-05,546,558,50,100,0.001,1104,5
0.672,1e-05,599,605,50,100,0.001,1204,5
0.702,1e-05,643,661,50,100,0.001,1304,5
0.734,1e-05,698,706,50,100,0.001,1404,5
0.752,1e-05,752,752,50,100,0.001,1504,5
0.788,1e-05,800,804,50,100,0.001,1604,5
0.812,1e-05,857,847,50,100,0.001,1704,5
0.822,1e-05,895,909,50,100,0.001,1804,5
0.846,1e-05,952,952,50,100,0.001,1904,5
0.86,1e-05,1005,999,50,100,0.001,2004,5
0.51,1e-05,58,46,50,100,0.001,104,6
0.522,1e-05,102,102,50,100,0.001,204,6
0.54,1e-05,143,161,50,100,0.001,304,6
0.57,1e-05,198,206,50,100,0.001,404,6
0.576,1e-05,244,260,50,100,0.001,504,6
0.59,1e-05,289,315,50,100,0.001,604,6
0.598,1e-05,348,356,50,100,0.001,704,6
0.608,1e-05,407,397,50,100,0.001,804,6
0.638,1e-05,454,450,50,100,0.001,904,6
0.648,1e-05,503,501,50,100,0.001,1004,6
0.67,1e-05,551,553,50,100,0.001,1104,6
0.682,1e-05,601,603,50,100,0.001,1204,6
0.706,1e-05,656,648,50,100,0.001,1304,6
0.724,1e-05,708,696,50,100,0.001,1404,6
0.738,1e-05,769,735,50,100,0.001,1504,6
0.774,1e-05,814,790,50,100,0.001,1604,6
0.794,1e-05,864,840,50,100,0.001,1704,6
0.826,1e-05,912,892,50,100,0.001,1804,6
0.858,1e-05,964,940,50,100,0.001,1904,6
0.88,1e-05,1007,997,50,100,0.001,2004,6
0.476,1e-05,52,52,50,100,0.001,104,7
0.474,1e-05,106,98,50,100,0.001,204,7
0.472,1e-05,150,154,50,100,0.001,304,7
0.458,1e-05,198,206,50,100,0.001,404,7
0.464,1e-05,245,259,50,100,0.001,504,7
0.496,1e-05,300,304,50,100,0.001,604,7
0.524,1e-05,360,344,50,100,0.001,704,7
0.546,1e-05,406,398,50,100,0.001,804,7
0.56,1e-05,450,454,50,100,0.001,904,7
0.588,1e-05,495,509,50,100,0.001,1004,7
0.622,1e-05,550,554,50,100,0.001,1104,7
0.64,1e-05,609,595,50,100,0.001,1204,7
0.668,1e-05,668,636,50,100,0.001,1304,7
0.684,1e-05,717,687,50,100,0.001,1404,7
0.712,1e-05,763,741,50,100,0.001,1504,7
0.754,1e-05,803,801,50,100,0.001,1604,7
0.774,1e-05,848,856,50,100,0.001,1704,7
0.804,1e-05,905,899,50,100,0.001,1804,7
0.82,1e-05,957,947,50,100,0.001,1904,7
0.85,1e-05,1009,995,50,100,0.001,2004,7
0.51,1e-05,49,55,50,100,0.001,104,8
0.524,1e-05,101,103,50,100,0.001,204,8
0.524,1e-05,156,148,50,100,0.001,304,8
0.522,1e-05,211,193,50,100,0.001,404,8
0.524,1e-05,261,243,50,100,0.001,504,8
0.556,1e-05,304,300,50,100,0.001,604,8
0.578,1e-05,353,351,50,100,0.001,704,8
0.59,1e-05,408,396,50,100,0.001,804,8
0.582,1e-05,468,436,50,100,0.001,904,8
0.612,1e-05,513,491,50,100,0.001,1004,8
0.62,1e-05,558,546,50,100,0.001,1104,8
0.63,1e-05,605,599,50,100,0.001,1204,8
0.648,1e-05,657,647,50,100,0.001,1304,8
0.674,1e-05,704,700,50,100,0.001,1404,8
0.684,1e-05,754,750,50,100,0.001,1504,8
0.722,1e-05,804,800,50,100,0.001,1604,8
0.734,1e-05,848,856,50,100,0.001,1704,8
0.766,1e-05,897,907,50,100,0.001,1804,8
0.808,1e-05,943,961,50,100,0.001,1904,8
0.838,1e-05,999,1005,50,100,0.001,2004,8
0.462,1e-05,50,54,50,100,0.001,104,9
0.464,1e-05,98,106,50,100,0.001,204,9
0.474,1e-05,146,158,50,100,0.001,304,9
0.496,1e-05,200,204,50,100,0.001,404,9
0.5,1e-05,247,257,50,100,0.001,504,9
0.534,1e-05,294,310,50,100,0.001,604,9
0.554,1e-05,348,356,50,100,0.001,704,9
0.586,1e-05,399,405,50,100,0.001,804,9
0.614,1e-05,446,458,50,100,0.001,904,9
0.642,1e-05,492,512,50,100,0.001,1004,9
0.662,1e-05,537,567,50,100,0.001,1104,9
0.686,1e-05,595,609,50,100,0.001,1204,9
0.708,1e-05,652,652,50,100,0.001,1304,9
0.73,1e-05,698,706,50,100,0.001,1404,9
0.746,1e-05,755,749,50,100,0.001,1504,9
0.778,1e-05,809,795,50,100,0.001,1604,9
0.81,1e-05,865,839,50,100,0.001,1704,9
0.842,1e-05,919,885,50,100,0.001,1804,9
0.836,1e-05,971,933,50,100,0.001,1904,9
0.85,1e-05,1024,980,50,100,0.001,2004,9
0.476,1e-05,50,54,50,100,0.001,104,10
0.504,1e-05,90,114,50,100,0.001,204,10
0.522,1e-05,134,170,50,100,0.001,304,10
0.542,1e-05,185,219,50,100,0.001,404,10
0.562,1e-05,235,269,50,100,0.001,504,10
0.586,1e-05,286,318,50,100,0.001,604,10
0.592,1e-05,338,366,50,100,0.001,704,10
0.586,1e-05,382,422,50,100,0.001,804,10
0.598,1e-05,435,469,50,100,0.001,904,10
0.606,1e-05,486,518,50,100,0.001,1004,10
0.618,1e-05,541,563,50,100,0.001,1104,10
0.65,1e-05,599,605,50,100,0.001,1204,10
0.666,1e-05,646,658,50,100,0.001,1304,10
0.696,1e-05,690,714,50,100,0.001,1404,10
0.718,1e-05,748,756,50,100,0.001,1504,10
0.74,1e-05,798,806,50,100,0.001,1604,10
0.76,1e-05,853,851,50,100,0.001,1704,10
0.784,1e-05,907,897,50,100,0.001,1804,10
0.798,1e-05,952,952,50,100,0.001,1904,10
0.812,1e-05,1003,1001,50,100,0.001,2004,10
0.482,1e-05,53,51,50,100,0.001,104,11
0.48,1e-05,100,104,50,100,0.001,204,11
0.488,1e-05,155,149,50,100,0.001,304,11
0.502,1e-05,193,211,50,100,0.001,404,11
0.51,1e-05,241,263,50,100,0.001,504,11
0.534,1e-05,297,307,50,100,0.001,604,11
0.54,1e-05,350,354,50,100,0.001,704,11
0.562,1e-05,402,402,50,100,0.001,804,11
0.594,1e-05,451,453,50,100,0.001,904,11
0.616,1e-05,508,496,50,100,0.001,1004,11
0.622,1e-05,552,552,50,100,0.001,1104,11
0.646,1e-05,600,604,50,100,0.001,1204,11
0.654,1e-05,652,652,50,100,0.001,1304,11
0.686,1e-05,691,713,50,100,0.001,1404,11
0.722,1e-05,738,766,50,100,0.001,1504,11
0.746,1e-05,801,803,50,100,0.001,1604,11
0.758,1e-05,855,849,50,100,0.001,1704,11
0.798,1e-05,893,911,50,100,0.001,1804,11
0.818,1e-05,947,957,50,100,0.001,1904,11
0.842,1e-05,1003,1001,50,100,0.001,2004,11
0.47,1e-05,49,55,50,100,0.001,104,12
0.476,1e-05,97,107,50,100,0.001,204,12
0.48,1e-05,154,150,50,100,0.001,304,12
0.492,1e-05,197,207,50,100,0.001,404,12
0.516,1e-05,250,254,50,100,0.001,504,12
0.538,1e-05,294,310,50,100,0.001,604,12
0.562,1e-05,349,355,50,100,0.001,704,12
0.58,1e-05,405,399,50,100,0.001,804,12
0.598,1e-05,460,444,50,100,0.001,904,12
0.624,1e-05,506,498,50,100,0.001,1004,12
0.642,1e-05,557,547,50,100,0.001,1104,12
0.666,1e-05,602,602,50,100,0.001,1204,12
0.676,1e-05,655,649,50,100,0.001,1304,12
0.688,1e-05,718,686,50,100,0.001,1404,12
0.714,1e-05,765,739,50,100,0.001,1504,12
0.736,1e-05,819,785,50,100,0.001,1604,12
0.782,1e-05,869,835,50,100,0.001,1704,12
0.798,1e-05,913,891,50,100,0.001,1804,12
0.808,1e-05,962,942,50,100,0.001,1904,12
0.828,1e-05,1009,995,50,100,0.001,2004,12
0.492,1e-05,55,49,50,100,0.001,104,13
0.492,1e-05,108,96,50,100,0.001,204,13
0.49,1e-05,156,148,50,100,0.001,304,13
0.49,1e-05,206,198,50,100,0.001,404,13
0.49,1e-05,251,253,50,100,0.001,504,13
0.498,1e-05,300,304,50,100,0.001,604,13
0.508,1e-05,345,359,50,100,0.001,704,13
0.512,1e-05,397,407,50,100,0.001,804,13
0.516,1e-05,436,468,50,100,0.001,904,13
0.538,1e-05,488,516,50,100,0.001,1004,13
0.554,1e-05,539,565,50,100,0.001,1104,13
0.586,1e-05,591,613,50,100,0.001,1204,13
0.6,1e-05,641,663,50,100,0.001,1304,13
0.618,1e-05,688,716,50,100,0.001,1404,13
0.644,1e-05,732,772,50,100,0.001,1504,13
0.678,1e-05,785,819,50,100,0.001,1604,13
0.684,1e-05,842,862,50,100,0.001,1704,13
0.714,1e-05,896,908,50,100,0.001,1804,13
0.756,1e-05,948,956,50,100,0.001,1904,13
0.79,1e-05,998,1006,50,100,0.001,2004,13
0.518,1e-05,49,55,50,100,0.001,104,14
0.528,1e-05,105,99,50,100,0.001,204,14
0.534,1e-05,154,150,50,100,0.001,304,14
0.534,1e-05,202,202,50,100,0.001,404,14
0.538,1e-05,256,248,50,100,0.001,504,14
0.544,1e-05,306,298,50,100,0.001,604,14
0.548,1e-05,351,353,50,100,0.001,704,14
0.56,1e-05,395,409,50,100,0.001,804,14
0.564,1e-05,446,458,50,100,0.001,904,14
0.598,1e-05,494,510,50,100,0.001,1004,14
0.628,1e-05,549,555,50,100,0.001,1104,14
0.656,1e-05,598,606,50,100,0.001,1204,14
0.672,1e-05,658,646,50,100,0.001,1304,14
0.698,1e-05,707,697,50,100,0.001,1404,14
0.742,1e-05,761,743,50,100,0.001,1504,14
0.762,1e-05,813,791,50,100,0.001,1604,14
0.788,1e-05,858,846,50,100,0.001,1704,14
0.798,1e-05,909,895,50,100,0.001,1804,14
0.798,1e-05,960,944,50,100,0.001,1904,14
0.82,1e-05,1011,993,50,100,0.001,2004,14
0.512,1e-05,50,54,50,100,0.001,104,15
0.518,1e-05,97,107,50,100,0.001,204,15
0.518,1e-05,149,155,50,100,0.001,304,15
0.524,1e-05,193,211,50,100,0.001,404,15
0.522,1e-05,248,256,50,100,0.001,504,15
0.526,1e-05,290,314,50,100,0.001,604,15
0.524,1e-05,343,361,50,100,0.001,704,15
0.526,1e-05,403,401,50,100,0.001,804,15
0.532,1e-05,458,446,50,100,0.001,904,15
0.56,1e-05,510,494,50,100,0.001,1004,15
0.578,1e-05,563,541,50,100,0.001,1104,15
0.616,1e-05,617,587,50,100,0.001,1204,15
0.646,1e-05,665,639,50,100,0.001,1304,15
0.66,1e-05,713,691,50,100,0.001,1404,15
0.696,1e-05,767,737,50,100,0.001,1504,15
0.724,1e-05,817,787,50,100,0.001,1604,15
0.774,1e-05,865,839,50,100,0.001,1704,15
0.796,1e-05,907,897,50,100,0.001,1804,15
0.812,1e-05,957,947,50,100,0.001,1904,15
0.84,1e-05,1001,1003,50,100,0.001,2004,15
0.542,1e-05,52,52,50,100,0.001,104,16
0.542,1e-05,94,110,50,100,0.001,204,16
0.546,1e-05,137,167,50,100,0.001,304,16
0.562,1e-05,178,226,50,100,0.001,404,16
0.548,1e-05,224,280,50,100,0.001,504,16
0.542,1e-05,275,329,50,100,0.001,604,16
0.534,1e-05,324,380,50,100,0.001,704,16
0.546,1e-05,376,428,50,100,0.001,804,16
0.552,1e-05,440,464,50,100,0.001,904,16
0.578,1e-05,491,513,50,100,0.001,1004,16
0.6,1e-05,538,566,50,100,0.001,1104,16
0.624,1e-05,589,615,50,100,0.001,1204,16
0.636,1e-05,641,663,50,100,0.001,1304,16
0.656,1e-05,689,715,50,100,0.001,1404,16
0.668,1e-05,741,763,50,100,0.001,1504,16
0.696,1e-05,792,812,50,100,0.001,1604,16
0.714,1e-05,846,858,50,100,0.001,1704,16
0.73,1e-05,905,899,50,100,0.001,1804,16
0.746,1e-05,954,950,50,100,0.001,1904,16
0.78,1e-05,999,1005,50,100,0.001,2004,16
0.508,1e-05,54,50,50,100,0.001,104,17
0.52,1e-05,108,96,50,100,0.001,204,17
0.524,1e-05,160,144,50,100,0.001,304,17
0.542,1e-05,198,206,50,100,0.001,404,17
0.546,1e-05,249,255,50,100,0.001,504,17
0.552,1e-05,302,302,50,100,0.001,604,17
0.568,1e-05,356,348,50,100,0.001,704,17
0.58,1e-05,412,392,50,100,0.001,804,17
0.598,1e-05,459,445,50,100,0.001,904,17
0.618,1e-05,521,483,50,100,0.001,1004,17
0.638,1e-05,559,545,50,100,0.001,1104,17
0.668,1e-05,606,598,50,100,0.001,1204,17
0.692,1e-05,654,650,50,100,0.001,1304,17
0.71,1e-05,703,701,50,100,0.001,1404,17
0.724,1e-05,755,749,50,100,0.001,1504,17
0.748,1e-05,808,796,50,100,0.001,1604,17
0.766,1e-05,862,842,50,100,0.001,1704,17
0.79,1e-05,915,889,50,100,0.001,1804,17
0.798,1e-05,970,934,50,100,0.001,1904,17
0.816,1e-05,1022,982,50,100,0.001,2004,17
0.512,1e-05,56,48,50,100,0.001,104,18
0.512,1e-05,112,92,50,100,0.001,204,18
0.516,1e-05,162,142,50,100,0.001,304,18
0.52,1e-05,212,192,50,100,0.001,404,18
0.548,1e-05,253,251,50,100,0.001,504,18
0.548,1e-05,304,300,50,100,0.001,604,18
0.564,1e-05,351,353,50,100,0.001,704,18
0.57,1e-05,408,396,50,100,0.001,804,18
0.586,1e-05,466,438,50,100,0.001,904,18
0.594,1e-05,512,492,50,100,0.001,1004,18
0.612,1e-05,566,538,50,100,0.001,1104,18
0.64,1e-05,618,586,50,100,0.001,1204,18
0.656,1e-05,678,626,50,100,0.001,1304,18
0.688,1e-05,724,680,50,100,0.001,1404,18
0.716,1e-05,771,733,50,100,0.001,1504,18
0.746,1e-05,815,789,50,100,0.001,1604,18
0.802,1e-05,861,843,50,100,0.001,1704,18
0.83,1e-05,913,891,50,100,0.001,1804,18
0.852,1e-05,964,940,50,100,0.001,1904,18
0.876,1e-05,1014,990,50,100,0.001,2004,18
0.484,1e-05,53,51,50,100,0.001,104,19
0.498,1e-05,108,96,50,100,0.001,204,19
0.508,1e-05,148,156,50,100,0.001,304,19
0.526,1e-05,205,199,50,100,0.001,404,19
0.522,1e-05,258,246,50,100,0.001,504,19
0.532,1e-05,313,291,50,100,0.001,604,19
0.538,1e-05,362,342,50,100,0.001,704,19
0.554,1e-05,413,391,50,100,0.001,804,19
0.588,1e-05,465,439,50,100,0.001,904,19
0.608,1e-05,510,494,50,100,0.001,1004,19
0.624,1e-05,562,542,50,100,0.001,1104,19
0.658,1e-05,609,595,50,100,0.001,1204,19
0.666,1e-05,653,651,50,100,0.001,1304,19
0.684,1e-05,709,695,50,100,0.001,1404,19
0.706,1e-05,761,743,50,100,0.001,1504,19
0.75,1e-05,813,791,50,100,0.001,1604,19
0.764,1e-05,868,836,50,100,0.001,1704,19
0.794,1e-05,912,892,50,100,0.001,1804,19
0.818,1e-05,954,950,50,100,0.001,1904,19
0.852,1e-05,997,1007,50,100,0.001,2004,19
0.572,1e-05,55,49,50,100,0.001,104,20
0.576,1e-05,114,90,50,100,0.001,204,20
0.58,1e-05,160,144,50,100,0.001,304,20
0.59,1e-05,203,201,50,100,0.001,404,20
0.598,1e-05,248,256,50,100,0.001,504,20
0.602,1e-05,299,305,50,100,0.001,604,20
0.608,1e-05,357,347,50,100,0.001,704,20
0.604,1e-05,415,389,50,100,0.001,804,20
0.62,1e-05,462,442,50,100,0.001,904,20
0.624,1e-05,509,495,50,100,0.001,1004,20
0.65,1e-05,569,535,50,100,0.001,1104,20
0.662,1e-05,622,582,50,100,0.001,1204,20
0.67,1e-05,671,633,50,100,0.001,1304,20
0.68,1e-05,717,687,50,100,0.001,1404,20
0.702,1e-05,770,734,50,100,0.001,1504,20
0.724,1e-05,813,791,50,100,0.001,1604,20
0.746,1e-05,864,840,50,100,0.001,1704,20
0.772,1e-05,923,881,50,100,0.001,1804,20
0.786,1e-05,971,933,50,100,0.001,1904,20
0.814,1e-05,1024,980,50,100,0.001,2004,20
0.572,1e-05,49,55,50,100,0.01,104,1
0.588,1e-05,98,106,50,100,0.01,204,1
0.64,1e-05,147,157,50,100,0.01,304,1
0.666,1e-05,195,209,50,100,0.01,404,1
0.666,1e-05,242,262,50,100,0.01,504,1
0.69,1e-05,292,312,50,100,0.01,604,1
0.708,1e-05,361,343,50,100,0.01,704,1
0.758,1e-05,399,405,50,100,0.01,804,1
0.822,1e-05,452,452,50,100,0.01,904,1
0.876,1e-05,500,504,50,100,0.01,1004,1
0.916,1e-05,556,548,50,100,0.01,1104,1
0.942,1e-05,605,599,50,100,0.01,1204,1
0.942,1e-05,644,660,50,100,0.01,1304,1
0.942,1e-05,701,703,50,100,0.01,1404,1
0.948,1e-05,751,753,50,100,0.01,1504,1
0.956,1e-05,795,809,50,100,0.01,1604,1
0.96,1e-05,848,856,50,100,0.01,1704,1
0.956,1e-05,897,907,50,100,0.01,1804,1
0.956,1e-05,952,952,50,100,0.01,1904,1
0.966,1e-05,1009,995,50,100,0.01,2004,1
0.576,1e-05,53,51,50,100,0.01,104,2
0.608,1e-05,111,93,50,100,0.01,204,2
0.646,1e-05,162,142,50,100,0.01,304,2
0.706,1e-05,220,184,50,100,0.01,404,2
0.712,1e-05,263,241,50,100,0.01,504,2
0.748,1e-05,314,290,50,100,0.01,604,2
0.778,1e-05,362,342,50,100,0.01,704,2
0.832,1e-05,409,395,50,100,0.01,804,2
0.878,1e-05,454,450,50,100,0.01,904,2
0.924,1e-05,504,500,50,100,0.01,1004,2
0.944,1e-05,557,547,50,100,0.01,1104,2
0.956,1e-05,601,603,50,100,0.01,1204,2
0.962,1e-05,646,658,50,100,0.01,1304,2
0.966,1e-05,695,709,50,100,0.01,1404,2
0.968,1e-05,747,757,50,100,0.01,1504,2
0.968,1e-05,804,800,50,100,0.01,1604,2
0.97,1e-05,861,843,50,100,0.01,1704,2
0.976,1e-05,921,883,50,100,0.01,1804,2
0.978,1e-05,978,926,50,100,0.01,1904,2
0.978,1e-05,1030,974,50,100,0.01,2004,2
0.508,1e-05,44,60,50,100,0.01,104,3
0.536,1e-05,107,97,50,100,0.01,204,3
0.566,1e-05,159,145,50,100,0.01,304,3
0.596,1e-05,209,195,50,100,0.01,404,3
0.634,1e-05,257,247,50,100,0.01,504,3
0.67,1e-05,302,302,50,100,0.01,604,3
0.71,1e-05,357,347,50,100,0.01,704,3
0.79,1e-05,404,400,50,100,0.01,804,3
0.854,1e-05,452,452,50,100,0.01,904,3
0.894,1e-05,507,497,50,100,0.01,1004,3
0.916,1e-05,561,543,50,100,0.01,1104,3
0.944,1e-05,614,590,50,100,0.01,1204,3
0.95,1e-05,659,645,50,100,0.01,1304,3
0.952,1e-05,707,697,50,100,0.01,1404,3
0.952,1e-05,758,746,50,100,0.01,1504,3
0.964,1e-05,815,789,50,100,0.01,1604,3
0.966,1e-05,862,842,50,100,0.01,1704,3
0.97,1e-05,907,897,50,100,0.01,1804,3
0.97,1e-05,954,950,50,100,0.01,1904,3
0.972,1e-05,1005,999,50,100,0.01,2004,3
0.5,1e-05,53,51,50,100,0.01,104,4
0.582,1e-05,102,102,50,100,0.01,204,4
0.594,1e-05,150,154,50,100,0.01,304,4
0.636,1e-05,197,207,50,100,0.01,404,4
0.678,1e-05,254,250,50,100,0.01,504,4
0.706,1e-05,300,304,50,100,0.01,604,4
0.75,1e-05,359,345,50,100,0.01,704,4
0.824,1e-05,411,393,50,100,0.01,804,4
0.868,1e-05,456,448,50,100,0.01,904,4
0.922,1e-05,504,500,50,100,0.01,1004,4
0.926,1e-05,552,552,50,100,0.01,1104,4
0.946,1e-05,605,599,50,100,0.01,1204,4
0.948,1e-05,655,649,50,100,0.01,1304,4
0.95,1e-05,706,698,50,100,0.01,1404,4
0.952,1e-05,763,741,50,100,0.01,1504,4
0.964,1e-05,811,793,50,100,0.01,1604,4
0.958,1e-05,865,839,50,100,0.01,1704,4
0.958,1e-05,906,898,50,100,0.01,1804,4
0.962,1e-05,964,940,50,100,0.01,1904,4
0.966,1e-05,1008,996,50,100,0.01,2004,4
0.548,1e-05,54,50,50,100,0.01,104,5
0.594,1e-05,99,105,50,100,0.01,204,5
0.626,1e-05,153,151,50,100,0.01,304,5
0.65,1e-05,198,206,50,100,0.01,404,5
0.688,1e-05,260,244,50,100,0.01,504,5
0.736,1e-05,306,298,50,100,0.01,604,5
0.76,1e-05,355,349,50,100,0.01,704,5
0.836,1e-05,404,400,50,100,0.01,804,5
0.884,1e-05,450,454,50,100,0.01,904,5
0.922,1e-05,495,509,50,100,0.01,1004,5
0.924,1e-05,546,558,50,100,0.01,1104,5
0.952,1e-05,605,599,50,100,0.01,1204,5
0.96,1e-05,658,646,50,100,0.01,1304,5
0.968,1e-05,706,698,50,100,0.01,1404,5
0.964,1e-05,759,745,50,100,0.01,1504,5
0.97,1e-05,807,797,50,100,0.01,1604,5
0.974,1e-05,853,851,50,100,0.01,1704,5
0.974,1e-05,907,897,50,100,0.01,1804,5
0.974,1e-05,954,950,50,100,0.01,1904,5
0.982,1e-05,1004,1000,50,100,0.01,2004,5
0.596,1e-05,55,49,50,100,0.01,104,6
0.604,1e-05,96,108,50,100,0.01,204,6
0.614,1e-05,157,147,50,100,0.01,304,6
0.658,1e-05,204,200,50,100,0.01,404,6
0.672,1e-05,252,252,50,100,0.01,504,6
0.702,1e-05,305,299,50,100,0.01,604,6
0.744,1e-05,351,353,50,100,0.01,704,6
0.824,1e-05,401,403,50,100,0.01,804,6
0.86,1e-05,447,457,50,100,0.01,904,6
0.898,1e-05,490,514,50,100,0.01,1004,6
0.928,1e-05,544,560,50,100,0.01,1104,6
0.936,1e-05,603,601,50,100,0.01,1204,6
0.938,1e-05,654,650,50,100,0.01,1304,6
0.95,1e-05,702,702,50,100,0.01,1404,6
0.952,1e-05,745,759,50,100,0.01,1504,6
0.946,1e-05,796,808,50,100,0.01,1604,6
0.95,1e-05,856,848,50,100,0.01,1704,6
0.956,1e-05,907,897,50,100,0.01,1804,6
0.958,1e-05,961,943,50,100,0.01,1904,6
0.962,1e-05,1006,998,50,100,0.01,2004,6
0.504,1e-05,45,59,50,100,0.01,104,7
0.526,1e-05,91,113,50,100,0.01,204,7
0.544,1e-05,139,165,50,100,0.01,304,7
0.554,1e-05,201,203,50,100,0.01,404,7
0.59,1e-05,251,253,50,100,0.01,504,7
0.65,1e-05,298,306,50,100,0.01,604,7
0.7,1e-05,341,363,50,100,0.01,704,7
0.776,1e-05,392,412,50,100,0.01,804,7
0.842,1e-05,442,462,50,100,0.01,904,7
0.876,1e-05,484,520,50,100,0.01,1004,7
0.908,1e-05,531,573,50,100,0.01,1104,7
0.934,1e-05,591,613,50,100,0.01,1204,7
0.954,1e-05,640,664,50,100,0.01,1304,7
0.954,1e-05,692,712,50,100,0.01,1404,7
0.964,1e-05,750,754,50,100,0.01,1504,7
0.95,1e-05,796,808,50,100,0.01,1604,7
0.966,1e-05,842,862,50,100,0.01,1704,7
0.964,1e-05,891,913,50,100,0.01,1804,7
0.96,1e-05,941,963,50,100,0.01,1904,7
0.964,1e-05,995,1009,50,100,0.01,2004,7
0.528,1e-05,54,50,50,100,0.01,104,8
0.57,1e-05,108,96,50,100,0.01,204,8
0.598,1e-05,153,151,50,100,0.01,304,8
0.626,1e-05,204,200,50,100,0.01,404,8
0.678,1e-05,255,249,50,100,0.01,504,8
0.72,1e-05,308,296,50,100,0.01,604,8
0.75,1e-05,360,344,50,100,0.01,704,8
0.784,1e-05,418,386,50,100,0.01,804,8
0.826,1e-05,472,432,50,100,0.01,904,8
0.88,1e-05,525,479,50,100,0.01,1004,8
0.93,1e-05,574,530,50,100,0.01,1104,8
0.944,1e-05,616,588,50,100,0.01,1204,8
0.956,1e-05,660,644,50,100,0.01,1304,8
0.962,1e-05,709,695,50,100,0.01,1404,8
0.962,1e-05,764,740,50,100,0.01,1504,8
0.966,1e-05,814,790,50,100,0.01,1604,8
0.968,1e-05,853,851,50,100,0.01,1704,8
0.966,1e-05,901,903,50,100,0.01,1804,8
0.966,1e-05,947,957,50,100,0.01,1904,8
0.972,1e-05,1002,1002,50,100,0.01,2004,8
0.526,1e-05,57,47,50,100,0.01,104,9
0.558,1e-05,103,101,50,100,0.01,204,9
0.584,1e-05,146,158,50,100,0.01,304,9
0.614,1e-05,188,216,50,100,0.01,404,9
0.63,1e-05,239,265,50,100,0.01,504,9
0.69,1e-05,295,309,50,100,0.01,604,9
0.744,1e-05,345,359,50,100,0.01,704,9
0.802,1e-05,400,404,50,100,0.01,804,9
0.818,1e-05,448,456,50,100,0.01,904,9
0.892,1e-05,501,503,50,100,0.01,1004,9
0.912,1e-05,552,552,50,100,0.01,1104,9
0.936,1e-05,601,603,50,100,0.01,1204,9
0.946,1e-05,650,654,50,100,0.01,1304,9
0.948,1e-05,705,699,50,100,0.01,1404,9
0.946,1e-05,762,742,50,100,0.01,1504,9
0.954,1e-05,802,802,50,100,0.01,1604,9
0.962,1e-05,850,854,50,100,0.01,1704,9
0.966,1e-05,900,904,50,100,0.01,1804,9
0.966,1e-05,948,956,50,100,0.01,1904,9
0.972,1e-05,998,1006,50,100,0.01,2004,9
0.58,1e-05,44,60,50,100,0.01,104,10
0.56,1e-05,100,104,50,100,0.01,204,10
0.572,1e-05,156,148,50,100,0.01,304,10
0.616,1e-05,209,195,50,100,0.01,404,10
0.662,1e-05,261,243,50,100,0.01,504,10
0.72,1e-05,308,296,50,100,0.01,604,10
0.758,1e-05,362,342,50,100,0.01,704,10
0.814,1e-05,417,387,50,100,0.01,804,10
0.856,1e-05,465,439,50,100,0.01,904,10
0.91,1e-05,509,495,50,100,0.01,1004,10
0.926,1e-05,551,553,50,100,0.01,1104,10
0.934,1e-05,600,604,50,100,0.01,1204,10
0.948,1e-05,647,657,50,100,0.01,1304,10
0.956,1e-05,691,713,50,100,0.01,1404,10
0.962,1e-05,741,763,50,100,0.01,1504,10
0.966,1e-05,787,817,50,100,0.01,1604,10
0.966,1e-05,835,869,50,100,0.01,1704,10
0.968,1e-05,892,912,50,100,0.01,1804,10
0.968,1e-05,945,959,50,100,0.01,1904,10
0.97,1e-05,994,1010,50,100,0.01,2004,10
0.556,1e-05,53,51,50,100,0.01,104,11
0.574,1e-05,108,96,50,100,0.01,204,11
0.574,1e-05,169,135,50,100,0.01,304,11
0.61,1e-05,216,188,50,100,0.01,404,11
0.626,1e-05,260,244,50,100,0.01,504,11
0.684,1e-05,316,288,50,100,0.01,604,11
0.738,1e-05,365,339,50,100,0.01,704,11
0.804,1e-05,411,393,50,100,0.01,804,11
0.87,1e-05,469,435,50,100,0.01,904,11
0.922,1e-05,516,488,50,100,0.01,1004,11
0.92,1e-05,554,550,50,100,0.01,1104,11
0.94,1e-05,604,600,50,100,0.01,1204,11
0.958,1e-05,653,651,50,100,0.01,1304,11
0.966,1e-05,709,695,50,100,0.01,1404,11
0.964,1e-05,763,741,50,100,0.01,1504,11
0.972,1e-05,810,794,50,100,0.01,1604,11
0.972,1e-05,851,853,50,100,0.01,1704,11
0.972,1e-05,905,899,50,100,0.01,1804,11
0.974,1e-05,957,947,50,100,0.01,1904,11
0.976,1e-05,1011,993,50,100,0.01,2004,11
0.48,1e-05,40,64,50,100,0.01,104,12
0.504,1e-05,91,113,50,100,0.01,204,12
0.556,1e-05,133,171,50,100,0.01,304,12
0.59,1e-05,177,227,50,100,0.01,404,12
0.628,1e-05,236,268,50,100,0.01,504,12
0.668,1e-05,281,323,50,100,0.01,604,12
0.716,1e-05,338,366,50,100,0.01,704,12
0.772,1e-05,394,410,50,100,0.01,804,12
0.814,1e-05,439,465,50,100,0.01,904,12
0.9,1e-05,479,525,50,100,0.01,1004,12
0.904,1e-05,532,572,50,100,0.01,1104,12
0.936,1e-05,587,617,50,100,0.01,1204,12
0.944,1e-05,635,669,50,100,0.01,1304,12
0.948,1e-05,691,713,50,100,0.01,1404,12
0.952,1e-05,741,763,50,100,0.01,1504,12
0.964,1e-05,792,812,50,100,0.01,1604,12
0.968,1e-05,841,863,50,100,0.01,1704,12
0.966,1e-05,893,911,50,100,0.01,1804,12
0.964,1e-05,936,968,50,100,0.01,1904,12
0.968,1e-05,988,1016,50,100,0.01,2004,12
0.556,1e-05,46,58,50,100,0.01,104,13
0.606,1e-05,103,101,50,100,0.01,204,13
0.618,1e-05,156,148,50,100,0.01,304,13
0.628,1e-05,213,191,50,100,0.01,404,13
0.648,1e-05,267,237,50,100,0.01,504,13
0.7,1e-05,321,283,50,100,0.01,604,13
0.748,1e-05,375,329,50,100,0.01,704,13
0.842,1e-05,427,377,50,100,0.01,804,13
0.888,1e-05,480,424,50,100,0.01,904,13
0.918,1e-05,527,477,50,100,0.01,1004,13
0.946,1e-05,577,527,50,100,0.01,1104,13
0.952,1e-05,626,578,50,100,0.01,1204,13
0.962,1e-05,674,630,50,100,0.01,1304,13
0.956,1e-05,723,681,50,100,0.01,1404,13
0.956,1e-05,779,725,50,100,0.01,1504,13
0.962,1e-05,818,786,50,100,0.01,1604,13
0.962,1e-05,861,843,50,100,0.01,1704,13
0.966,1e-05,910,894,50,100,0.01,1804,13
0.968,1e-05,958,946,50,100,0.01,1904,13
0.97,1e-05,1001,1003,50,100,0.01,2004,13
0.538,1e-05,52,52,50,100,0.01,104,14
0.586,1e-05,98,106,50,100,0.01,204,14
0.598,1e-05,152,152,50,100,0.01,304,14
0.594,1e-05,201,203,50,100,0.01,404,14
0.616,1e-05,254,250,50,100,0.01,504,14
0.666,1e-05,298,306,50,100,0.01,604,14
0.738,1e-05,347,357,50,100,0.01,704,14
0.78,1e-05,404,400,50,100,0.01,804,14
0.844,1e-05,459,445,50,100,0.01,904,14
0.882,1e-05,504,500,50,100,0.01,1004,14
0.902,1e-05,553,551,50,100,0.01,1104,14
0.934,1e-05,606,598,50,100,0.01,1204,14
0.938,1e-05,660,644,50,100,0.01,1304,14
0.94,1e-05,708,696,50,100,0.01,1404,14
0.94,1e-05,755,749,50,100,0.01,1504,14
0.956,1e-05,807,797,50,100,0.01,1604,14
0.946,1e-05,858,846,50,100,0.01,1704,14
0.956,1e-05,908,896,50,100,0.01,1804,14
0.96,1e-05,959,945,50,100,0.01,1904,14
0.964,1e-05,1011,993,50,100,0.01,2004,14
0.562,1e-05,44,60,50,100,0.01,104,15
0.564,1e-05,94,110,50,100,0.01,204,15
0.592,1e-05,150,154,50,100,0.01,304,15
0.642,1e-05,211,193,50,100,0.01,404,15
0.646,1e-05,263,241,50,100,0.01,504,15
0.664,1e-05,318,286,50,100,0.01,604,15
0.718,1e-05,374,330,50,100,0.01,704,15
0.78,1e-05,412,392,50,100,0.01,804,15
0.798,1e-05,467,437,50,100,0.01,904,15
0.876,1e-05,517,487,50,100,0.01,1004,15
0.884,1e-05,575,529,50,100,0.01,1104,15
0.934,1e-05,622,582,50,100,0.01,1204,15
0.942,1e-05,675,629,50,100,0.01,1304,15
0.942,1e-05,727,677,50,100,0.01,1404,15
0.952,1e-05,771,733,50,100,0.01,1504,15
0.954,1e-05,821,783,50,100,0.01,1604,15
0.954,1e-05,872,832,50,100,0.01,1704,15
0.954,1e-05,914,890,50,100,0.01,1804,15
0.96,1e-05,963,941,50,100,0.01,1904,15
0.962,1e-05,1005,999,50,100,0.01,2004,15
0.478,1e-05,53,51,50,100,0.01,104,16
0.504,1e-05,112,92,50,100,0.01,204,16
0.502,1e-05,156,148,50,100,0.01,304,16
0.576,1e-05,206,198,50,100,0.01,404,16
0.606,1e-05,266,238,50,100,0.01,504,16
0.702,1e-05,315,289,50,100,0.01,604,16
0.748,1e-05,359,345,50,100,0.01,704,16
0.798,1e-05,412,392,50,100,0.01,804,16
0.826,1e-05,464,440,50,100,0.01,904,16
0.88,1e-05,519,485,50,100,0.01,1004,16
0.896,1e-05,556,548,50,100,0.01,1104,16
0.91,1e-05,609,595,50,100,0.01,1204,16
0.936,1e-05,653,651,50,100,0.01,1304,16
0.938,1e-05,708,696,50,100,0.01,1404,16
0.946,1e-05,756,748,50,100,0.01,1504,16
0.956,1e-05,812,792,50,100,0.01,1604,16
0.958,1e-05,862,842,50,100,0.01,1704,16
0.96,1e-05,915,889,50,100,0.01,1804,16
0.964,1e-05,968,936,50,100,0.01,1904,16
0.96,1e-05,1011,993,50,100,0.01,2004,16
0.508,1e-05,55,49,50,100,0.01,104,17
0.522,1e-05,109,95,50,100,0.01,204,17
0.554,1e-05,147,157,50,100,0.01,304,17
0.604,1e-05,208,196,50,100,0.01,404,17
0.64,1e-05,254,250,50,100,0.01,504,17
0.678,1e-05,304,300,50,100,0.01,604,17
0.694,1e-05,359,345,50,100,0.01,704,17
0.718,1e-05,409,395,50,100,0.01,804,17
0.784,1e-05,467,437,50,100,0.01,904,17
0.834,1e-05,525,479,50,100,0.01,1004,17
0.884,1e-05,568,536,50,100,0.01,1104,17
0.924,1e-05,617,587,50,100,0.01,1204,17
0.946,1e-05,669,635,50,100,0.01,1304,17
0.956,1e-05,722,682,50,100,0.01,1404,17
0.958,1e-05,772,732,50,100,0.01,1504,17
0.97,1e-05,820,784,50,100,0.01,1604,17
0.976,1e-05,868,836,50,100,0.01,1704,17
0.976,1e-05,920,884,50,100,0.01,1804,17
0.978,1e-05,967,937,50,100,0.01,1904,17
0.976,1e-05,1025,979,50,100,0.01,2004,17
0.53,1e-05,55,49,50,100,0.01,104,18
0.584,1e-05,93,111,50,100,0.01,204,18
0.61,1e-05,140,164,50,100,0.01,304,18
0.628,1e-05,195,209,50,100,0.01,404,18
0.65,1e-05,246,258,50,100,0.01,504,18
0.694,1e-05,305,299,50,100,0.01,604,18
0.746,1e-05,344,360,50,100,0.01,704,18
0.808,1e-05,389,415,50,100,0.01,804,18
0.866,1e-05,434,470,50,100,0.01,904,18
0.9,1e-05,484,520,50,100,0.01,1004,18
0.932,1e-05,539,565,50,100,0.01,1104,18
0.958,1e-05,589,615,50,100,0.01,1204,18
0.952,1e-05,637,667,50,100,0.01,1304,18
0.954,1e-05,684,720,50,100,0.01,1404,18
0.95,1e-05,736,768,50,100,0.01,1504,18
0.97,1e-05,788,816,50,100,0.01,1604,18
0.972,1e-05,835,869,50,100,0.01,1704,18
0.972,1e-05,889,915,50,100,0.01,1804,18
0.974,1e-05,935,969,50,100,0.01,1904,18
0.978,1e-05,994,1010,50,100,0.01,2004,18
0.524,1e-05,47,57,50,100,0.01,104,19
0.59,1e-05,97,107,50,100,0.01,204,19
0.598,1e-05,150,154,50,100,0.01,304,19
0.612,1e-05,203,201,50,100,0.01,404,19
0.636,1e-05,258,246,50,100,0.01,504,19
0.636,1e-05,311,293,50,100,0.01,604,19
0.684,1e-05,364,340,50,100,0.01,704,19
0.748,1e-05,412,392,50,100,0.01,804,19
0.794,1e-05,454,450,50,100,0.01,904,19
0.858,1e-05,504,500,50,100,0.01,1004,19
0.904,1e-05,556,548,50,100,0.01,1104,19
0.928,1e-05,610,594,50,100,0.01,1204,19
0.928,1e-05,657,647,50,100,0.01,1304,19
0.94,1e-05,703,701,50,100,0.01,1404,19
0.946,1e-05,751,753,50,100,0.01,1504,19
0.964,1e-05,800,804,50,100,0.01,1604,19
0.972,1e-05,841,863,50,100,0.01,1704,19
0.976,1e-05,890,914,50,100,0.01,1804,19
0.97,1e-05,944,960,50,100,0.01,1904,19
0.968,1e-05,1000,1004,50,100,0.01,2004,19
0.56,1e-05,49,55,50,100,0.01,104,20
0.57,1e-05,96,108,50,100,0.01,204,20
0.59,1e-05,160,144,50,100,0.01,304,20
0.656,1e-05,210,194,50,100,0.01,404,20
0.672,1e-05,260,244,50,100,0.01,504,20
0.744,1e-05,306,298,50,100,0.01,604,20
0.792,1e-05,357,347,50,100,0.01,704,20
0.83,1e-05,404,400,50,100,0.01,804,20
0.862,1e-05,458,446,50,100,0.01,904,20
0.908,1e-05,504,500,50,100,0.01,1004,20
0.904,1e-05,568,536,50,100,0.01,1104,20
0.934,1e-05,624,580,50,100,0.01,1204,20
0.946,1e-05,676,628,50,100,0.01,1304,20
0.958,1e-05,716,688,50,100,0.01,1404,20
0.954,1e-05,753,751,50,100,0.01,1504,20
0.962,1e-05,806,798,50,100,0.01,1604,20
0.966,1e-05,858,846,50,100,0.01,1704,20
0.964,1e-05,912,892,50,100,0.01,1804,20
0.97,1e-05,968,936,50,100,0.01,1904,20
0.976,1e-05,1017,987,50,100,0.01,2004,20
0.528,0.0001,53,51,50,100,0.0001,104,1
0.526,0.0001,100,104,50,100,0.0001,204,1
0.526,0.0001,145,159,50,100,0.0001,304,1
0.526,0.0001,193,211,50,100,0.0001,404,1
0.524,0.0001,246,258,50,100,0.0001,504,1
0.524,0.0001,297,307,50,100,0.0001,604,1
0.528,0.0001,347,357,50,100,0.0001,704,1
0.534,0.0001,397,407,50,100,0.0001,804,1
0.534,0.0001,449,455,50,100,0.0001,904,1
0.536,0.0001,498,506,50,100,0.0001,1004,1
0.536,0.0001,559,545,50,100,0.0001,1104,1
0.536,0.0001,606,598,50,100,0.0001,1204,1
0.54,0.0001,659,645,50,100,0.0001,1304,1
0.538,0.0001,706,698,50,100,0.0001,1404,1
0.546,0.0001,761,743,50,100,0.0001,1504,1
0.55,0.0001,810,794,50,100,0.0001,1604,1
0.552,0.0001,863,841,50,100,0.0001,1704,1
0.552,0.0001,908,896,50,100,0.0001,1804,1
0.56,0.0001,961,943,50,100,0.0001,1904,1
0.57,0.0001,1004,1000,50,100,0.0001,2004,1
0.502,0.0001,49,55,50,100,0.0001,104,2
0.502,0.0001,100,104,50,100,0.0001,204,2
0.502,0.0001,144,160,50,100,0.0001,304,2
0.502,0.0001,196,208,50,100,0.0001,404,2
0.504,0.0001,240,264,50,100,0.0001,504,2
0.506,0.0001,298,306,50,100,0.0001,604,2
0.506,0.0001,341,363,50,100,0.0001,704,2
0.51,0.0001,391,413,50,100,0.0001,804,2
0.506,0.0001,449,455,50,100,0.0001,904,2
0.504,0.0001,501,503,50,100,0.0001,1004,2
0.504,0.0001,540,564,50,100,0.0001,1104,2
0.508,0.0001,596,608,50,100,0.0001,1204,2
0.506,0.0001,642,662,50,100,0.0001,1304,2
0.51,0.0001,697,707,50,100,0.0001,1404,2
0.508,0.0001,748,756,50,100,0.0001,1504,2
0.506,0.0001,799,805,50,100,0.0001,1604,2
0.51,0.0001,849,855,50,100,0.0001,1704,2
0.52,0.0001,899,905,50,100,0.0001,1804,2
0.518,0.0001,956,948,50,100,0.0001,1904,2
0.526,0.0001,1009,995,50,100,0.0001,2004,2
0.482,0.0001,51,53,50,100,0.0001,104,3
0.482,0.0001,94,110,50,100,0.0001,204,3
0.484,0.0001,146,158,50,100,0.0001,304,3
0.484,0.0001,190,214,50,100,0.0001,404,3
0.484,0.0001,238,266,50,100,0.0001,504,3
0.486,0.0001,289,315,50,100,0.0001,604,3
0.484,0.0001,334,370,50,100,0.0001,704,3
0.484,0.0001,379,425,50,100,0.0001,804,3
0.484,0.0001,436,468,50,100,0.0001,904,3
0.484,0.0001,491,513,50,100,0.0001,1004,3
0.486,0.0001,531,573,50,100,0.0001,1104,3
0.488,0.0001,587,617,50,100,0.0001,1204,3
0.494,0.0001,640,664,50,100,0.0001,1304,3
0.49,0.0001,696,708,50,100,0.0001,1404,3
0.492,0.0001,744,760,50,100,0.0001,1504,3
0.5,0.0001,802,802,50,100,0.0001,1604,3
0.504,0.0001,852,852,50,100,0.0001,1704,3
0.514,0.0001,904,900,50,100,0.0001,1804,3
0.52,0.0001,959,945,50,100,0.0001,1904,3
0.526,0.0001,1008,996,50,100,0.0001,2004,3
0.474,0.0001,53,51,50,100,0.0001,104,4
0.472,0.0001,106,98,50,100,0.0001,204,4
0.472,0.0001,156,148,50,100,0.0001,304,4
0.472,0.0001,203,201,50,100,0.0001,404,4
0.472,0.0001,254,250,50,100,0.0001,504,4
0.474,0.0001,308,296,50,100,0.0001,604,4
0.474,0.0001,349,355,50,100,0.0001,704,4
0.474,0.0001,405,399,50,100,0.0001,804,4
0.48,0.0001,453,451,50,100,0.0001,904,4
0.482,0.0001,503,501,50,100,0.0001,1004,4
0.48,0.0001,552,552,50,100,0.0001,1104,4
0.486,0.0001,602,602,50,100,0.0001,1204,4
0.486,0.0001,654,650,50,100,0.0001,1304,4
0.49,0.0001,709,695,50,100,0.0001,1404,4
0.494,0.0001,751,753,50,100,0.0001,1504,4
0.496,0.0001,797,807,50,100,0.0001,1604,4
0.5,0.0001,851,853,50,100,0.0001,1704,4
0.508,0.0001,898,906,50,100,0.0001,1804,4
0.508,0.0001,942,962,50,100,0.0001,1904,4
0.52,0.0001,997,1007,50,100,0.0001,2004,4
0.502,0.0001,53,51,50,100,0.0001,104,5
0.5,0.0001,99,105,50,100,0.0001,204,5
0.504,0.0001,143,161,50,100,0.0001,304,5
0.506,0.0001,191,213,50,100,0.0001,404,5
0.504,0.0001,251,253,50,100,0.0001,504,5
0.508,0.0001,308,296,50,100,0.0001,604,5
0.514,0.0001,357,347,50,100,0.0001,704,5
0.514,0.0001,403,401,50,100,0.0001,804,5
0.51,0.0001,455,449,50,100,0.0001,904,5
0.512,0.0001,500,504,50,100,0.0001,1004,5
0.512,0.0001,550,554,50,100,0.0001,1104,5
0.516,0.0001,593,611,50,100,0.0001,1204,5
0.518,0.0001,647,657,50,100,0.0001,1304,5
0.526,0.0001,696,708,50,100,0.0001,1404,5
0.534,0.0001,754,750,50,100,0.0001,1504,5
0.54,0.0001,803,801,50,100,0.0001,1604,5
0.546,0.0001,859,845,50,100,0.0001,1704,5
0.546,0.0001,916,888,50,100,0.0001,1804,5
0.55,0.0001,971,933,50,100,0.0001,1904,5
0.552,0.0001,1015,989,50,100,0.0001,2004,5
0.476,0.0001,54,50,50,100,0.0001,104,6
0.476,0.0001,102,102,50,100,0.0001,204,6
0.476,0.0001,154,150,50,100,0.0001,304,6
0.474,0.0001,206,198,50,100,0.0001,404,6
0.476,0.0001,246,258,50,100,0.0001,504,6
0.478,0.0001,298,306,50,100,0.0001,604,6
0.484,0.0001,338,366,50,100,0.0001,704,6
0.484,0.0001,389,415,50,100,0.0001,804,6
0.486,0.0001,447,457,50,100,0.0001,904,6
0.48,0.0001,497,507,50,100,0.0001,1004,6
0.478,0.0001,549,555,50,100,0.0001,1104,6
0.482,0.0001,599,605,50,100,0.0001,1204,6
0.486,0.0001,651,653,50,100,0.0001,1304,6
0.494,0.0001,693,711,50,100,0.0001,1404,6
0.498,0.0001,740,764,50,100,0.0001,1504,6
0.502,0.0001,795,809,50,100,0.0001,1604,6
0.506,0.0001,851,853,50,100,0.0001,1704,6
0.508,0.0001,897,907,50,100,0.0001,1804,6
0.518,0.0001,955,949,50,100,0.0001,1904,6
0.526,0.0001,1015,989,50,100,0.0001,2004,6
0.456,0.0001,62,42,50,100,0.0001,104,7
0.458,0.0001,116,88,50,100,0.0001,204,7
0.458,0.0001,162,142,50,100,0.0001,304,7
0.458,0.0001,209,195,50,100,0.0001,404,7
0.46,0.0001,262,242,50,100,0.0001,504,7
0.46,0.0001,313,291,50,100,0.0001,604,7
0.46,0.0001,367,337,50,100,0.0001,704,7
0.462,0.0001,411,393,50,100,0.0001,804,7
0.462,0.0001,452,452,50,100,0.0001,904,7
0.464,0.0001,502,502,50,100,0.0001,1004,7
0.462,0.0001,550,554,50,100,0.0001,1104,7
0.468,0.0001,604,600,50,100,0.0001,1204,7
0.466,0.0001,644,660,50,100,0.0001,1304,7
0.472,0.0001,694,710,50,100,0.0001,1404,7
0.474,0.0001,746,758,50,100,0.0001,1504,7
0.478,0.0001,798,806,50,100,0.0001,1604,7
0.486,0.0001,851,853,50,100,0.0001,1704,7
0.486,0.0001,895,909,50,100,0.0001,1804,7
0.484,0.0001,945,959,50,100,0.0001,1904,7
0.484,0.0001,996,1008,50,100,0.0001,2004,7
0.532,0.0001,45,59,50,100,0.0001,104,8
0.532,0.0001,96,108,50,100,0.0001,204,8
0.534,0.0001,138,166,50,100,0.0001,304,8
0.532,0.0001,190,214,50,100,0.0001,404,8
0.53,0.0001,245,259,50,100,0.0001,504,8
0.534,0.0001,298,306,50,100,0.0001,604,8
0.532,0.0001,347,357,50,100,0.0001,704,8
0.538,0.0001,392,412,50,100,0.0001,804,8
0.538,0.0001,445,459,50,100,0.0001,904,8
0.538,0.0001,486,518,50,100,0.0001,1004,8
0.534,0.0001,544,560,50,100,0.0001,1104,8
0.53,0.0001,591,613,50,100,0.0001,1204,8
0.532,0.0001,651,653,50,100,0.0001,1304,8
0.538,0.0001,699,705,50,100,0.0001,1404,8
0.542,0.0001,748,756,50,100,0.0001,1504,8
0.544,0.0001,806,798,50,100,0.0001,1604,8
0.55,0.0001,858,846,50,100,0.0001,1704,8
0.56,0.0001,908,896,50,100,0.0001,1804,8
0.56,0.0001,958,946,50,100,0.0001,1904,8
0.564,0.0001,1009,995,50,100,0.0001,2004,8
0.53,0.0001,50,54,50,100,0.0001,104,9
0.53,0.0001,101,103,50,100,0.0001,204,9
0.53,0.0001,145,159,50,100,0.0001,304,9
0.53,0.0001,179,225,50,100,0.0001,404,9
0.53,0.0001,223,281,50,100,0.0001,504,9
0.528,0.0001,276,328,50,100,0.0001,604,9
0.53,0.0001,326,378,50,100,0.0001,704,9
0.53,0.0001,373,431,50,100,0.0001,804,9
0.528,0.0001,425,479,50,100,0.0001,904,9
0.528,0.0001,480,524,50,100,0.0001,1004,9
0.53,0.0001,534,570,50,100,0.0001,1104,9
0.534,0.0001,589,615,50,100,0.0001,1204,9
0.536,0.0001,632,672,50,100,0.0001,1304,9
0.544,0.0001,684,720,50,100,0.0001,1404,9
0.542,0.0001,737,767,50,100,0.0001,1504,9
0.544,0.0001,778,826,50,100,0.0001,1604,9
0.548,0.0001,832,872,50,100,0.0001,1704,9
0.546,0.0001,882,922,50,100,0.0001,1804,9
0.552,0.0001,940,964,50,100,0.0001,1904,9
0.558,0.0001,984,1020,50,100,0.0001,2004,9
0.548,0.0001,57,47,50,100,0.0001,104,10
0.548,0.0001,105,99,50,100,0.0001,204,10
0.548,0.0001,157,147,50,100,0.0001,304,10
0.552,0.0001,206,198,50,100,0.0001,404,10
0.552,0.0001,259,245,50,100,0.0001,504,10
0.55,0.0001,306,298,50,100,0.0001,604,10
0.552,0.0001,353,351,50,100,0.0001,704,10
0.554,0.0001,405,399,50,100,0.0001,804,10
0.558,0.0001,454,450,50,100,0.0001,904,10
0.56,0.0001,513,491,50,100,0.0001,1004,10
0.564,0.0001,564,540,50,100,0.0001,1104,10
0.564,0.0001,616,588,50,100,0.0001,1204,10
0.572,0.0001,661,643,50,100,0.0001,1304,10
0.576,0.0001,702,702,50,100,0.0001,1404,10
0.58,0.0001,753,751,50,100,0.0001,1504,10
0.592,0.0001,809,795,50,100,0.0001,1604,10
0.596,0.0001,861,843,50,100,0.0001,1704,10
0.598,0.0001,907,897,50,100,0.0001,1804,10
0.6,0.0001,964,940,50,100,0.0001,1904,10
0.616,0.0001,1011,993,50,100,0.0001,2004,10
0.512,0.0001,56,48,50,100,0.0001,104,11
0.516,0.0001,108,96,50,100,0.0001,204,11
0.514,0.0001,163,141,50,100,0.0001,304,11
0.518,0.0001,215,189,50,100,0.0001,404,11
0.52,0.0001,269,235,50,100,0.0001,504,11
0.526,0.0001,321,283,50,100,0.0001,604,11
0.53,0.0001,369,335,50,100,0.0001,704,11
0.53,0.0001,408,396,50,100,0.0001,804,11
0.53,0.0001,457,447,50,100,0.0001,904,11
0.53,0.0001,503,501,50,100,0.0001,1004,11
0.53,0.0001,562,542,50,100,0.0001,1104,11
0.536,0.0001,614,590,50,100,0.0001,1204,11
0.538,0.0001,669,635,50,100,0.0001,1304,11
0.538,0.0001,715,689,50,100,0.0001,1404,11
0.542,0.0001,764,740,50,100,0.0001,1504,11
0.542,0.0001,822,782,50,100,0.0001,1604,11
0.548,0.0001,868,836,50,100,0.0001,1704,11
0.556,0.0001,912,892,50,100,0.0001,1804,11
0.564,0.0001,960,944,50,100,0.0001,1904,11
0.566,0.0001,1014,990,50,100,0.0001,2004,11
0.536,0.0001,63,41,50,100,0.0001,104,12
0.534,0.0001,111,93,50,100,0.0001,204,12
0.534,0.0001,154,150,50,100,0.0001,304,12
0.536,0.0001,202,202,50,100,0.0001,404,12
0.538,0.0001,253,251,50,100,0.0001,504,12
0.544,0.0001,306,298,50,100,0.0001,604,12
0.544,0.0001,351,353,50,100,0.0001,704,12
0.544,0.0001,404,400,50,100,0.0001,804,12
0.542,0.0001,446,458,50,100,0.0001,904,12
0.548,0.0001,493,511,50,100,0.0001,1004,12
0.554,0.0001,542,562,50,100,0.0001,1104,12
0.556,0.0001,593,611,50,100,0.0001,1204,12
0.562,0.0001,640,664,50,100,0.0001,1304,12
0.568,0.0001,690,714,50,100,0.0001,1404,12
0.576,0.0001,741,763,50,100,0.0001,1504,12
0.578,0.0001,800,804,50,100,0.0001,1604,12
0.578,0.0001,857,847,50,100,0.0001,1704,12
0.586,0.0001,907,897,50,100,0.0001,1804,12
0.59,0.0001,958,946,50,100,0.0001,1904,12
0.594,0.0001,1009,995,50,100,0.0001,2004,12
0.502,0.0001,52,52,50,100,0.0001,104,13
0.506,0.0001,110,94,50,100,0.0001,204,13
0.506,0.0001,159,145,50,100,0.0001,304,13
0.506,0.0001,200,204,50,100,0.0001,404,13
0.51,0.0001,251,253,50,100,0.0001,504,13
0.508,0.0001,303,301,50,100,0.0001,604,13
0.508,0.0001,351,353,50,100,0.0001,704,13
0.508,0.0001,395,409,50,100,0.0001,804,13
0.51,0.0001,444,460,50,100,0.0001,904,13
0.508,0.0001,492,512,50,100,0.0001,1004,13
0.51,0.0001,548,556,50,100,0.0001,1104,13
0.516,0.0001,600,604,50,100,0.0001,1204,13
0.522,0.0001,639,665,50,100,0.0001,1304,13
0.522,0.0001,697,707,50,100,0.0001,1404,13
0.524,0.0001,744,760,50,100,0.0001,1504,13
0.516,0.0001,793,811,50,100,0.0001,1604,13
0.516,0.0001,842,862,50,100,0.0001,1704,13
0.52,0.0001,900,904,50,100,0.0001,1804,13
0.52,0.0001,947,957,50,100,0.0001,1904,13
0.526,0.0001,994,1010,50,100,0.0001,2004,13
0.502,0.0001,51,53,50,100,0.0001,104,14
0.502,0.0001,109,95,50,100,0.0001,204,14
0.498,0.0001,148,156,50,100,0.0001,304,14
0.5,0.0001,200,204,50,100,0.0001,404,14
0.506,0.0001,253,251,50,100,0.0001,504,14
0.504,0.0001,302,302,50,100,0.0001,604,14
0.502,0.0001,364,340,50,100,0.0001,704,14
0.502,0.0001,420,384,50,100,0.0001,804,14
0.502,0.0001,470,434,50,100,0.0001,904,14
0.504,0.0001,517,487,50,100,0.0001,1004,14
0.508,0.0001,564,540,50,100,0.0001,1104,14
0.51,0.0001,612,592,50,100,0.0001,1204,14
0.516,0.0001,666,638,50,100,0.0001,1304,14
0.522,0.0001,714,690,50,100,0.0001,1404,14
0.528,0.0001,765,739,50,100,0.0001,1504,14
0.532,0.0001,818,786,50,100,0.0001,1604,14
0.538,0.0001,867,837,50,100,0.0001,1704,14
0.548,0.0001,924,880,50,100,0.0001,1804,14
0.562,0.0001,977,927,50,100,0.0001,1904,14
0.566,0.0001,1026,978,50,100,0.0001,2004,14
0.486,0.0001,49,55,50,100,0.0001,104,15
0.484,0.0001,100,104,50,100,0.0001,204,15
0.484,0.0001,153,151,50,100,0.0001,304,15
0.484,0.0001,205,199,50,100,0.0001,404,15
0.488,0.0001,256,248,50,100,0.0001,504,15
0.488,0.0001,307,297,50,100,0.0001,604,15
0.49,0.0001,356,348,50,100,0.0001,704,15
0.488,0.0001,404,400,50,100,0.0001,804,15
0.494,0.0001,449,455,50,100,0.0001,904,15
0.49,0.0001,502,502,50,100,0.0001,1004,15
0.5,0.0001,549,555,50,100,0.0001,1104,15
0.496,0.0001,592,612,50,100,0.0001,1204,15
0.498,0.0001,640,664,50,100,0.0001,1304,15
0.506,0.0001,683,721,50,100,0.0001,1404,15
0.506,0.0001,738,766,50,100,0.0001,1504,15
0.508,0.0001,790,814,50,100,0.0001,1604,15
0.516,0.0001,835,869,50,100,0.0001,1704,15
0.518,0.0001,876,928,50,100,0.0001,1804,15
0.526,0.0001,932,972,50,100,0.0001,1904,15
0.534,0.0001,982,1022,50,100,0.0001,2004,15
0.486,0.0001,53,51,50,100,0.0001,104,16
0.486,0.0001,101,103,50,100,0.0001,204,16
0.486,0.0001,154,150,50,100,0.0001,304,16
0.486,0.0001,198,206,50,100,0.0001,404,16
0.488,0.0001,250,254,50,100,0.0001,504,16
0.494,0.0001,299,305,50,100,0.0001,604,16
0.502,0.0001,353,351,50,100,0.0001,704,16
0.496,0.0001,407,397,50,100,0.0001,804,16
0.496,0.0001,453,451,50,100,0.0001,904,16
0.496,0.0001,500,504,50,100,0.0001,1004,16
0.5,0.0001,551,553,50,100,0.0001,1104,16
0.506,0.0001,603,601,50,100,0.0001,1204,16
0.506,0.0001,648,656,50,100,0.0001,1304,16
0.508,0.0001,707,697,50,100,0.0001,1404,16
0.518,0.0001,755,749,50,100,0.0001,1504,16
0.52,0.0001,806,798,50,100,0.0001,1604,16
0.524,0.0001,861,843,50,100,0.0001,1704,16
0.528,0.0001,914,890,50,100,0.0001,1804,16
0.528,0.0001,952,952,50,100,0.0001,1904,16
0.534,0.0001,1010,994,50,100,0.0001,2004,16
0.528,0.0001,53,51,50,100,0.0001,104,17
0.526,0.0001,105,99,50,100,0.0001,204,17
0.526,0.0001,154,150,50,100,0.0001,304,17
0.524,0.0001,205,199,50,100,0.0001,404,17
0.53,0.0001,257,247,50,100,0.0001,504,17
0.536,0.0001,304,300,50,100,0.0001,604,17
0.536,0.0001,362,342,50,100,0.0001,704,17
0.538,0.0001,416,388,50,100,0.0001,804,17
0.542,0.0001,457,447,50,100,0.0001,904,17
0.546,0.0001,503,501,50,100,0.0001,1004,17
0.548,0.0001,559,545,50,100,0.0001,1104,17
0.548,0.0001,608,596,50,100,0.0001,1204,17
0.554,0.0001,649,655,50,100,0.0001,1304,17
0.554,0.0001,704,700,50,100,0.0001,1404,17
0.558,0.0001,753,751,50,100,0.0001,1504,17
0.568,0.0001,797,807,50,100,0.0001,1604,17
0.572,0.0001,844,860,50,100,0.0001,1704,17
0.582,0.0001,900,904,50,100,0.0001,1804,17
0.586,0.0001,947,957,50,100,0.0001,1904,17
0.598,0.0001,992,1012,50,100,0.0001,2004,17
0.5,0.0001,52,52,50,100,0.0001,104,18
0.502,0.0001,105,99,50,100,0.0001,204,18
0.5,0.0001,152,152,50,100,0.0001,304,18
0.5,0.0001,206,198,50,100,0.0001,404,18
0.5,0.0001,255,249,50,100,0.0001,504,18
0.5,0.0001,302,302,50,100,0.0001,604,18
0.5,0.0001,354,350,50,100,0.0001,704,18
0.498,0.0001,408,396,50,100,0.0001,804,18
0.5,0.0001,461,443,50,100,0.0001,904,18
0.504,0.0001,511,493,50,100,0.0001,1004,18
0.504,0.0001,561,543,50,100,0.0001,1104,18
0.516,0.0001,604,600,50,100,0.0001,1204,18
0.516,0.0001,648,656,50,100,0.0001,1304,18
0.516,0.0001,699,705,50,100,0.0001,1404,18
0.518,0.0001,744,760,50,100,0.0001,1504,18
0.522,0.0001,799,805,50,100,0.0001,1604,18
0.522,0.0001,852,852,50,100,0.0001,1704,18
0.522,0.0001,901,903,50,100,0.0001,1804,18
0.522,0.0001,952,952,50,100,0.0001,1904,18
0.526,0.0001,1002,1002,50,100,0.0001,2004,18
0.482,0.0001,50,54,50,100,0.0001,104,19
0.48,0.0001,101,103,50,100,0.0001,204,19
0.48,0.0001,156,148,50,100,0.0001,304,19
0.48,0.0001,210,194,50,100,0.0001,404,19
0.478,0.0001,260,244,50,100,0.0001,504,19
0.48,0.0001,311,293,50,100,0.0001,604,19
0.482,0.0001,368,336,50,100,0.0001,704,19
0.482,0.0001,408,396,50,100,0.0001,804,19
0.48,0.0001,457,447,50,100,0.0001,904,19
0.48,0.0001,510,494,50,100,0.0001,1004,19
0.482,0.0001,560,544,50,100,0.0001,1104,19
0.48,0.0001,604,600,50,100,0.0001,1204,19
0.484,0.0001,653,651,50,100,0.0001,1304,19
0.494,0.0001,704,700,50,100,0.0001,1404,19
0.5,0.0001,756,748,50,100,0.0001,1504,19
0.51,0.0001,805,799,50,100,0.0001,1604,19
0.51,0.0001,857,847,50,100,0.0001,1704,19
0.514,0.0001,908,896,50,100,0.0001,1804,19
0.512,0.0001,958,946,50,100,0.0001,1904,19
0.518,0.0001,1016,988,50,100,0.0001,2004,19
0.49,0.0001,51,53,50,100,0.0001,104,20
0.494,0.0001,87,117,50,100,0.0001,204,20
0.498,0.0001,145,159,50,100,0.0001,304,20
0.498,0.0001,192,212,50,100,0.0001,404,20
0.498,0.0001,240,264,50,100,0.0001,504,20
0.496,0.0001,287,317,50,100,0.0001,604,20
0.504,0.0001,334,370,50,100,0.0001,704,20
0.51,0.0001,384,420,50,100,0.0001,804,20
0.506,0.0001,437,467,50,100,0.0001,904,20
0.506,0.0001,483,521,50,100,0.0001,1004,20
0.506,0.0001,531,573,50,100,0.0001,1104,20
0.502,0.0001,584,620,50,100,0.0001,1204,20
0.504,0.0001,639,665,50,100,0.0001,1304,20
0.508,0.0001,685,719,50,100,0.0001,1404,20
0.51,0.0001,735,769,50,100,0.0001,1504,20
0.52,0.0001,788,816,50,100,0.0001,1604,20
0.53,0.0001,838,866,50,100,0.0001,1704,20
0.534,0.0001,891,913,50,100,0.0001,1804,20
0.54,0.0001,947,957,50,100,0.0001,1904,20
0.544,0.0001,997,1007,50,100,0.0001,2004,20
0.454,0.0001,46,58,50,100,0.001,104,1
0.46,0.0001,89,115,50,100,0.001,204,1
0.47,0.0001,139,165,50,100,0.001,304,1
0.504,0.0001,196,208,50,100,0.001,404,1
0.506,0.0001,243,261,50,100,0.001,504,1
0.526,0.0001,294,310,50,100,0.001,604,1
0.546,0.0001,350,354,50,100,0.001,704,1
0.57,0.0001,404,400,50,100,0.001,804,1
0.584,0.0001,457,447,50,100,0.001,904,1
0.598,0.0001,503,501,50,100,0.001,1004,1
0.618,0.0001,561,543,50,100,0.001,1104,1
0.64,0.0001,613,591,50,100,0.001,1204,1
0.672,0.0001,663,641,50,100,0.001,1304,1
0.7,0.0001,708,696,50,100,0.001,1404,1
0.714,0.0001,762,742,50,100,0.001,1504,1
0.744,0.0001,814,790,50,100,0.001,1604,1
0.756,0.0001,873,831,50,100,0.001,1704,1
0.79,0.0001,916,888,50,100,0.001,1804,1
0.79,0.0001,965,939,50,100,0.001,1904,1
0.822,0.0001,1013,991,50,100,0.001,2004,1
0.514,0.0001,53,51,50,100,0.001,104,2
0.514,0.0001,97,107,50,100,0.001,204,2
0.532,0.0001,149,155,50,100,0.001,304,2
0.544,0.0001,196,208,50,100,0.001,404,2
0.554,0.0001,247,257,50,100,0.001,504,2
0.562,0.0001,294,310,50,100,0.001,604,2
0.582,0.0001,351,353,50,100,0.001,704,2
0.586,0.0001,408,396,50,100,0.001,804,2
0.61,0.0001,454,450,50,100,0.001,904,2
0.612,0.0001,510,494,50,100,0.001,1004,2
0.626,0.0001,560,544,50,100,0.001,1104,2
0.646,0.0001,612,592,50,100,0.001,1204,2
0.658,0.0001,659,645,50,100,0.001,1304,2
0.686,0.0001,705,699,50,100,0.001,1404,2
0.71,0.0001,758,746,50,100,0.001,1504,2
0.744,0.0001,805,799,50,100,0.001,1604,2
0.758,0.0001,852,852,50,100,0.001,1704,2
0.794,0.0001,904,900,50,100,0.001,1804,2
0.822,0.0001,960,944,50,100,0.001,1904,2
0.85,0.0001,1017,987,50,100,0.001,2004,2
0.458,0.0001,55,49,50,100,0.001,104,3
0.47,0.0001,112,92,50,100,0.001,204,3
0.476,0.0001,161,143,50,100,0.001,304,3
0.502,0.0001,202,202,50,100,0.001,404,3
0.526,0.0001,254,250,50,100,0.001,504,3
0.534,0.0001,302,302,50,100,0.001,604,3
0.544,0.0001,350,354,50,100,0.001,704,3
0.562,0.0001,403,401,50,100,0.001,804,3
0.584,0.0001,450,454,50,100,0.001,904,3
0.618,0.0001,499,505,50,100,0.001,1004,3
0.664,0.0001,553,551,50,100,0.001,1104,3
0.692,0.0001,608,596,50,100,0.001,1204,3
0.704,0.0001,666,638,50,100,0.001,1304,3
0.734,0.0001,713,691,50,100,0.001,1404,3
0.728,0.0001,764,740,50,100,0.001,1504,3
0.744,0.0001,816,788,50,100,0.001,1604,3
0.79,0.0001,861,843,50,100,0.001,1704,3
0.836,0.0001,907,897,50,100,0.001,1804,3
0.852,0.0001,953,951,50,100,0.001,1904,3
0.878,0.0001,1004,1000,50,100,0.001,2004,3
0.462,0.0001,55,49,50,100,0.001,104,4
0.468,0.0001,105,99,50,100,0.001,204,4
0.482,0.0001,150,154,50,100,0.001,304,4
0.492,0.0001,199,205,50,100,0.001,404,4
0.502,0.0001,243,261,50,100,0.001,504,4
0.516,0.0001,288,316,50,100,0.001,604,4
0.532,0.0001,337,367,50,100,0.001,704,4
0.552,0.0001,388,416,50,100,0.001,804,4
0.574,0.0001,441,463,50,100,0.001,904,4
0.59,0.0001,494,510,50,100,0.001,1004,4
0.618,0.0001,536,568,50,100,0.001,1104,4
0.632,0.0001,581,623,50,100,0.001,1204,4
0.666,0.0001,636,668,50,100,0.001,1304,4
0.682,0.0001,684,720,50,100,0.001,1404,4
0.694,0.0001,738,766,50,100,0.001,1504,4
0.708,0.0001,793,811,50,100,0.001,1604,4
0.708,0.0001,834,870,50,100,0.001,1704,4
0.722,0.0001,883,921,50,100,0.001,1804,4
0.744,0.0001,932,972,50,100,0.001,1904,4
0.772,0.0001,985,1019,50,100,0.001,2004,4
0.492,0.0001,47,57,50,100,0.001,104,5
0.502,0.0001,103,101,50,100,0.001,204,5
0.514,0.0001,156,148,50,100,0.001,304,5
0.506,0.0001,205,199,50,100,0.001,404,5
0.518,0.0001,251,253,50,100,0.001,504,5
0.538,0.0001,297,307,50,100,0.001,604,5
0.562,0.0001,346,358,50,100,0.001,704,5
0.59,0.0001,401,403,50,100,0.001,804,5
0.596,0.0001,451,453,50,100,0.001,904,5
0.62,0.0001,502,502,50,100,0.001,1004,5
0.652,0.0001,552,552,50,100,0.001,1104,5
0.678,0.0001,608,596,50,100,0.001,1204,5
0.694,0.0001,656,648,50,100,0.001,1304,5
0.722,0.0001,713,691,50,100,0.001,1404,5
0.766,0.0001,766,738,50,100,0.001,1504,5
0.8,0.0001,810,794,50,100,0.001,1604,5
0.83,0.0001,865,839,50,100,0.001,1704,5
0.85,0.0001,915,889,50,100,0.001,1804,5
0.86,0.0001,966,938,50,100,0.001,1904,5
0.882,0.0001,1022,982,50,100,0.001,2004,5
0.512,0.0001,55,49,50,100,0.001,104,6
0.51,0.0001,104,100,50,100,0.001,204,6
0.53,0.0001,149,155,50,100,0.001,304,6
0.546,0.0001,196,208,50,100,0.001,404,6
0.55,0.0001,245,259,50,100,0.001,504,6
0.57,0.0001,293,311,50,100,0.001,604,6
0.584,0.0001,347,357,50,100,0.001,704,6
0.602,0.0001,396,408,50,100,0.001,804,6
0.612,0.0001,448,456,50,100,0.001,904,6
0.632,0.0001,493,511,50,100,0.001,1004,6
0.658,0.0001,542,562,50,100,0.001,1104,6
0.68,0.0001,587,617,50,100,0.001,1204,6
0.694,0.0001,638,666,50,100,0.001,1304,6
0.718,0.0001,689,715,50,100,0.001,1404,6
0.752,0.0001,739,765,50,100,0.001,1504,6
0.78,0.0001,795,809,50,100,0.001,1604,6
0.788,0.0001,840,864,50,100,0.001,1704,6
0.814,0.0001,894,910,50,100,0.001,1804,6
0.846,0.0001,949,955,50,100,0.001,1904,6
0.866,0.0001,1005,999,50,100,0.001,2004,6
0.482,0.0001,55,49,50,100,0.001,104,7
0.484,0.0001,109,95,50,100,0.001,204,7
0.494,0.0001,150,154,50,100,0.001,304,7
0.5,0.0001,199,205,50,100,0.001,404,7
0.51,0.0001,255,249,50,100,0.001,504,7
0.528,0.0001,314,290,50,100,0.001,604,7
0.542,0.0001,376,328,50,100,0.001,704,7
0.544,0.0001,417,387,50,100,0.001,804,7
0.556,0.0001,467,437,50,100,0.001,904,7
0.566,0.0001,527,477,50,100,0.001,1004,7
0.586,0.0001,584,520,50,100,0.001,1104,7
0.612,0.0001,633,571,50,100,0.001,1204,7
0.626,0.0001,680,624,50,100,0.001,1304,7
0.654,0.0001,727,677,50,100,0.001,1404,7
0.66,0.0001,770,734,50,100,0.001,1504,7
0.71,0.0001,815,789,50,100,0.001,1604,7
0.758,0.0001,864,840,50,100,0.001,1704,7
0.784,0.0001,914,890,50,100,0.001,1804,7
0.802,0.0001,961,943,50,100,0.001,1904,7
0.84,0.0001,1009,995,50,100,0.001,2004,7
0.482,0.0001,57,47,50,100,0.001,104,8
0.498,0.0001,107,97,50,100,0.001,204,8
0.52,0.0001,157,147,50,100,0.001,304,8
0.522,0.0001,205,199,50,100,0.001,404,8
0.542,0.0001,256,248,50,100,0.001,504,8
0.54,0.0001,311,293,50,100,0.001,604,8
0.556,0.0001,360,344,50,100,0.001,704,8
0.574,0.0001,407,397,50,100,0.001,804,8
0.586,0.0001,458,446,50,100,0.001,904,8
0.6,0.0001,510,494,50,100,0.001,1004,8
0.612,0.0001,564,540,50,100,0.001,1104,8
0.646,0.0001,609,595,50,100,0.001,1204,8
0.656,0.0001,654,650,50,100,0.001,1304,8
0.694,0.0001,700,704,50,100,0.001,1404,8
0.726,0.0001,750,754,50,100,0.001,1504,8
0.752,0.0001,812,792,50,100,0.001,1604,8
0.772,0.0001,865,839,50,100,0.001,1704,8
0.814,0.0001,922,882,50,100,0.001,1804,8
0.842,0.0001,968,936,50,100,0.001,1904,8
0.872,0.0001,1022,982,50,100,0.001,2004,8
0.544,0.0001,53,51,50,100,0.001,104,9
0.548,0.0001,108,96,50,100,0.001,204,9
0.548,0.0001,154,150,50,100,0.001,304,9
0.554,0.0001,212,192,50,100,0.001,404,9
0.564,0.0001,254,250,50,100,0.001,504,9
0.584,0.0001,302,302,50,100,0.001,604,9
0.592,0.0001,355,349,50,100,0.001,704,9
0.596,0.0001,411,393,50,100,0.001,804,9
0.606,0.0001,464,440,50,100,0.001,904,9
0.618,0.0001,509,495,50,100,0.001,1004,9
0.63,0.0001,563,541,50,100,0.001,1104,9
0.634,0.0001,613,591,50,100,0.001,1204,9
0.662,0.0001,661,643,50,100,0.001,1304,9
0.692,0.0001,711,693,50,100,0.001,1404,9
0.718,0.0001,754,750,50,100,0.001,1504,9
0.728,0.0001,803,801,50,100,0.001,1604,9
0.754,0.0001,860,844,50,100,0.001,1704,9
0.77,0.0001,910,894,50,100,0.001,1804,9
0.796,0.0001,964,940,50,100,0.001,1904,9
0.818,0.0001,1012,992,50,100,0.001,2004,9
0.448,0.0001,53,51,50,100,0.001,104,10
0.456,0.0001,103,101,50,100,0.001,204,10
0.46,0.0001,148,156,50,100,0.001,304,10
0.468,0.0001,202,202,50,100,0.001,404,10
0.478,0.0001,252,252,50,100,0.001,504,10
0.504,0.0001,300,304,50,100,0.001,604,10
0.53,0.0001,351,353,50,100,0.001,704,10
0.568,0.0001,408,396,50,100,0.001,804,10
0.586,0.0001,454,450,50,100,0.001,904,10
0.61,0.0001,497,507,50,100,0.001,1004,10
0.628,0.0001,559,545,50,100,0.001,1104,10
0.642,0.0001,612,592,50,100,0.001,1204,10
0.656,0.0001,664,640,50,100,0.001,1304,10
0.686,0.0001,703,701,50,100,0.001,1404,10
0.716,0.0001,756,748,50,100,0.001,1504,10
0.746,0.0001,805,799,50,100,0.001,1604,10
0.762,0.0001,851,853,50,100,0.001,1704,10
0.788,0.0001,909,895,50,100,0.001,1804,10
0.808,0.0001,952,952,50,100,0.001,1904,10
0.83,0.0001,1001,1003,50,100,0.001,2004,10
0.518,0.0001,53,51,50,100,0.001,104,11
0.512,0.0001,98,106,50,100,0.001,204,11
0.514,0.0001,144,160,50,100,0.001,304,11
0.506,0.0001,194,210,50,100,0.001,404,11
0.516,0.0001,252,252,50,100,0.001,504,11
0.55,0.0001,307,297,50,100,0.001,604,11
0.588,0.0001,353,351,50,100,0.001,704,11
0.612,0.0001,400,404,50,100,0.001,804,11
0.628,0.0001,440,464,50,100,0.001,904,11
0.654,0.0001,485,519,50,100,0.001,1004,11
0.668,0.0001,539,565,50,100,0.001,1104,11
0.696,0.0001,585,619,50,100,0.001,1204,11
0.698,0.0001,630,674,50,100,0.001,1304,11
0.718,0.0001,670,734,50,100,0.001,1404,11
0.72,0.0001,734,770,50,100,0.001,1504,11
0.74,0.0001,789,815,50,100,0.001,1604,11
0.758,0.0001,837,867,50,100,0.001,1704,11
0.786,0.0001,889,915,50,100,0.001,1804,11
0.818,0.0001,946,958,50,100,0.001,1904,11
0.836,0.0001,986,1018,50,100,0.001,2004,11
0.528,0.0001,56,48,50,100,0.001,104,12
0.538,0.0001,103,101,50,100,0.001,204,12
0.548,0.0001,152,152,50,100,0.001,304,12
0.552,0.0001,200,204,50,100,0.001,404,12
0.56,0.0001,242,262,50,100,0.001,504,12
0.578,0.0001,287,317,50,100,0.001,604,12
0.582,0.0001,339,365,50,100,0.001,704,12
0.584,0.0001,384,420,50,100,0.001,804,12
0.584,0.0001,434,470,50,100,0.001,904,12
0.592,0.0001,481,523,50,100,0.001,1004,12
0.624,0.0001,542,562,50,100,0.001,1104,12
0.658,0.0001,591,613,50,100,0.001,1204,12
0.674,0.0001,641,663,50,100,0.001,1304,12
0.696,0.0001,700,704,50,100,0.001,1404,12
0.71,0.0001,751,753,50,100,0.001,1504,12
0.728,0.0001,803,801,50,100,0.001,1604,12
0.742,0.0001,854,850,50,100,0.001,1704,12
0.776,0.0001,899,905,50,100,0.001,1804,12
0.798,0.0001,944,960,50,100,0.001,1904,12
0.83,0.0001,999,1005,50,100,0.001,2004,12
0.494,0.0001,47,57,50,100,0.001,104,13
0.5,0.0001,96,108,50,100,0.001,204,13
0.494,0.0001,137,167,50,100,0.001,304,13
0.5,0.0001,192,212,50,100,0.001,404,13
0.508,0.0001,229,275,50,100,0.001,504,13
0.51,0.0001,295,309,50,100,0.001,604,13
0.51,0.0001,348,356,50,100,0.001,704,13
0.53,0.0001,391,413,50,100,0.001,804,13
0.526,0.0001,441,463,50,100,0.001,904,13
0.548,0.0001,495,509,50,100,0.001,1004,13
0.568,0.0001,550,554,50,100,0.001,1104,13
0.624,0.0001,603,601,50,100,0.001,1204,13
0.666,0.0001,654,650,50,100,0.001,1304,13
0.682,0.0001,706,698,50,100,0.001,1404,13
0.71,0.0001,755,749,50,100,0.001,1504,13
0.726,0.0001,806,798,50,100,0.001,1604,13
0.75,0.0001,857,847,50,100,0.001,1704,13
0.794,0.0001,904,900,50,100,0.001,1804,13
0.81,0.0001,950,954,50,100,0.001,1904,13
0.838,0.0001,994,1010,50,100,0.001,2004,13
0.474,0.0001,47,57,50,100,0.001,104,14
0.502,0.0001,99,105,50,100,0.001,204,14
0.52,0.0001,157,147,50,100,0.001,304,14
0.528,0.0001,200,204,50,100,0.001,404,14
0.544,0.0001,253,251,50,100,0.001,504,14
0.568,0.0001,304,300,50,100,0.001,604,14
0.596,0.0001,351,353,50,100,0.001,704,14
0.618,0.0001,410,394,50,100,0.001,804,14
0.64,0.0001,458,446,50,100,0.001,904,14
0.658,0.0001,510,494,50,100,0.001,1004,14
0.68,0.0001,559,545,50,100,0.001,1104,14
0.694,0.0001,608,596,50,100,0.001,1204,14
0.698,0.0001,657,647,50,100,0.001,1304,14
0.7,0.0001,699,705,50,100,0.001,1404,14
0.712,0.0001,745,759,50,100,0.001,1504,14
0.738,0.0001,792,812,50,100,0.001,1604,14
0.78,0.0001,850,854,50,100,0.001,1704,14
0.798,0.0001,898,906,50,100,0.001,1804,14
0.812,0.0001,950,954,50,100,0.001,1904,14
0.828,0.0001,998,1006,50,100,0.001,2004,14
0.524,0.0001,54,50,50,100,0.001,104,15
0.554,0.0001,97,107,50,100,0.001,204,15
0.544,0.0001,154,150,50,100,0.001,304,15
0.536,0.0001,203,201,50,100,0.001,404,15
0.54,0.0001,256,248,50,100,0.001,504,15
0.546,0.0001,304,300,50,100,0.001,604,15
0.566,0.0001,345,359,50,100,0.001,704,15
0.586,0.0001,386,418,50,100,0.001,804,15
0.592,0.0001,430,474,50,100,0.001,904,15
0.58,0.0001,473,531,50,100,0.001,1004,15
0.598,0.0001,520,584,50,100,0.001,1104,15
0.626,0.0001,572,632,50,100,0.001,1204,15
0.654,0.0001,628,676,50,100,0.001,1304,15
0.684,0.0001,682,722,50,100,0.001,1404,15
0.722,0.0001,733,771,50,100,0.001,1504,15
0.738,0.0001,784,820,50,100,0.001,1604,15
0.764,0.0001,840,864,50,100,0.001,1704,15
0.796,0.0001,893,911,50,100,0.001,1804,15
0.824,0.0001,948,956,50,100,0.001,1904,15
0.846,0.0001,998,1006,50,100,0.001,2004,15
0.52,0.0001,55,49,50,100,0.001,104,16
0.522,0.0001,104,100,50,100,0.001,204,16
0.53,0.0001,154,150,50,100,0.001,304,16
0.536,0.0001,203,201,50,100,0.001,404,16
0.556,0.0001,258,246,50,100,0.001,504,16
0.568,0.0001,299,305,50,100,0.001,604,16
0.574,0.0001,343,361,50,100,0.001,704,16
0.586,0.0001,391,413,50,100,0.001,804,16
0.592,0.0001,442,462,50,100,0.001,904,16
0.612,0.0001,490,514,50,100,0.001,1004,16
0.626,0.0001,549,555,50,100,0.001,1104,16
0.668,0.0001,595,609,50,100,0.001,1204,16
0.678,0.0001,643,661,50,100,0.001,1304,16
0.7,0.0001,689,715,50,100,0.001,1404,16
0.73,0.0001,736,768,50,100,0.001,1504,16
0.774,0.0001,783,821,50,100,0.001,1604,16
0.8,0.0001,842,862,50,100,0.001,1704,16
0.818,0.0001,894,910,50,100,0.001,1804,16
0.824,0.0001,952,952,50,100,0.001,1904,16
0.848,0.0001,996,1008,50,100,0.001,2004,16
0.54,0.0001,50,54,50,100,0.001,104,17
0.542,0.0001,101,103,50,100,0.001,204,17
0.538,0.0001,147,157,50,100,0.001,304,17
0.542,0.0001,204,200,50,100,0.001,404,17
0.562,0.0001,255,249,50,100,0.001,504,17
0.586,0.0001,302,302,50,100,0.001,604,17
0.596,0.0001,355,349,50,100,0.001,704,17
0.602,0.0001,407,397,50,100,0.001,804,17
0.628,0.0001,461,443,50,100,0.001,904,17
0.656,0.0001,520,484,50,100,0.001,1004,17
0.67,0.0001,567,537,50,100,0.001,1104,17
0.7,0.0001,615,589,50,100,0.001,1204,17
0.714,0.0001,658,646,50,100,0.001,1304,17
0.736,0.0001,704,700,50,100,0.001,1404,17
0.748,0.0001,755,749,50,100,0.001,1504,17
0.766,0.0001,799,805,50,100,0.001,1604,17
0.788,0.0001,852,852,50,100,0.001,1704,17
0.81,0.0001,890,914,50,100,0.001,1804,17
0.828,0.0001,939,965,50,100,0.001,1904,17
0.858,0.0001,990,1014,50,100,0.001,2004,17
0.518,0.0001,43,61,50,100,0.001,104,18
0.528,0.0001,88,116,50,100,0.001,204,18
0.53,0.0001,131,173,50,100,0.001,304,18
0.52,0.0001,171,233,50,100,0.001,404,18
0.522,0.0001,226,278,50,100,0.001,504,18
0.546,0.0001,271,333,50,100,0.001,604,18
0.546,0.0001,323,381,50,100,0.001,704,18
0.56,0.0001,376,428,50,100,0.001,804,18
0.568,0.0001,421,483,50,100,0.001,904,18
0.582,0.0001,467,537,50,100,0.001,1004,18
0.584,0.0001,521,583,50,100,0.001,1104,18
0.62,0.0001,573,631,50,100,0.001,1204,18
0.642,0.0001,624,680,50,100,0.001,1304,18
0.682,0.0001,677,727,50,100,0.001,1404,18
0.71,0.0001,731,773,50,100,0.001,1504,18
0.748,0.0001,786,818,50,100,0.001,1604,18
0.764,0.0001,837,867,50,100,0.001,1704,18
0.79,0.0001,881,923,50,100,0.001,1804,18
0.808,0.0001,938,966,50,100,0.001,1904,18
0.82,0.0001,991,1013,50,100,0.001,2004,18
0.482,0.0001,54,50,50,100,0.001,104,19
0.504,0.0001,103,101,50,100,0.001,204,19
0.512,0.0001,152,152,50,100,0.001,304,19
0.522,0.0001,201,203,50,100,0.001,404,19
0.532,0.0001,239,265,50,100,0.001,504,19
0.528,0.0001,294,310,50,100,0.001,604,19
0.536,0.0001,344,360,50,100,0.001,704,19
0.574,0.0001,395,409,50,100,0.001,804,19
0.588,0.0001,441,463,50,100,0.001,904,19
0.606,0.0001,501,503,50,100,0.001,1004,19
0.636,0.0001,551,553,50,100,0.001,1104,19
0.67,0.0001,598,606,50,100,0.001,1204,19
0.702,0.0001,650,654,50,100,0.001,1304,19
0.72,0.0001,698,706,50,100,0.001,1404,19
0.75,0.0001,744,760,50,100,0.001,1504,19
0.79,0.0001,803,801,50,100,0.001,1604,19
0.808,0.0001,850,854,50,100,0.001,1704,19
0.846,0.0001,913,891,50,100,0.001,1804,19
0.856,0.0001,960,944,50,100,0.001,1904,19
0.876,0.0001,1007,997,50,100,0.001,2004,19
0.52,0.0001,55,49,50,100,0.001,104,20
0.524,0.0001,109,95,50,100,0.001,204,20
0.534,0.0001,162,142,50,100,0.001,304,20
0.538,0.0001,209,195,50,100,0.001,404,20
0.544,0.0001,252,252,50,100,0.001,504,20
0.556,0.0001,298,306,50,100,0.001,604,20
0.57,0.0001,342,362,50,100,0.001,704,20
0.568,0.0001,393,411,50,100,0.001,804,20
0.582,0.0001,447,457,50,100,0.001,904,20
0.626,0.0001,494,510,50,100,0.001,1004,20
0.646,0.0001,538,566,50,100,0.001,1104,20
0.678,0.0001,599,605,50,100,0.001,1204,20
0.678,0.0001,654,650,50,100,0.001,1304,20
0.71,0.0001,709,695,50,100,0.001,1404,20
0.73,0.0001,762,742,50,100,0.001,1504,20
0.756,0.0001,819,785,50,100,0.001,1604,20
0.782,0.0001,865,839,50,100,0.001,1704,20
0.824,0.0001,912,892,50,100,0.001,1804,20
0.832,0.0001,960,944,50,100,0.001,1904,20
0.856,0.0001,1011,993,50,100,0.001,2004,20
0.514,0.0001,46,58,50,100,0.01,104,1
0.542,0.0001,92,112,50,100,0.01,204,1
0.55,0.0001,138,166,50,100,0.01,304,1
0.6,0.0001,187,217,50,100,0.01,404,1
0.624,0.0001,236,268,50,100,0.01,504,1
0.666,0.0001,285,319,50,100,0.01,604,1
0.694,0.0001,341,363,50,100,0.01,704,1
0.756,0.0001,389,415,50,100,0.01,804,1
0.798,0.0001,431,473,50,100,0.01,904,1
0.874,0.0001,483,521,50,100,0.01,1004,1
0.886,0.0001,536,568,50,100,0.01,1104,1
0.922,0.0001,589,615,50,100,0.01,1204,1
0.942,0.0001,638,666,50,100,0.01,1304,1
0.934,0.0001,686,718,50,100,0.01,1404,1
0.946,0.0001,735,769,50,100,0.01,1504,1
0.96,0.0001,796,808,50,100,0.01,1604,1
0.962,0.0001,844,860,50,100,0.01,1704,1
0.966,0.0001,902,902,50,100,0.01,1804,1
0.966,0.0001,949,955,50,100,0.01,1904,1
0.96,0.0001,998,1006,50,100,0.01,2004,1
0.572,0.0001,46,58,50,100,0.01,104,2
0.598,0.0001,98,106,50,100,0.01,204,2
0.604,0.0001,136,168,50,100,0.01,304,2
0.622,0.0001,181,223,50,100,0.01,404,2
0.666,0.0001,236,268,50,100,0.01,504,2
0.714,0.0001,276,328,50,100,0.01,604,2
0.75,0.0001,337,367,50,100,0.01,704,2
0.8,0.0001,386,418,50,100,0.01,804,2
0.846,0.0001,433,471,50,100,0.01,904,2
0.9,0.0001,479,525,50,100,0.01,1004,2
0.928,0.0001,526,578,50,100,0.01,1104,2
0.946,0.0001,578,626,50,100,0.01,1204,2
0.952,0.0001,631,673,50,100,0.01,1304,2
0.958,0.0001,680,724,50,100,0.01,1404,2
0.952,0.0001,734,770,50,100,0.01,1504,2
0.964,0.0001,794,810,50,100,0.01,1604,2
0.968,0.0001,846,858,50,100,0.01,1704,2
0.97,0.0001,899,905,50,100,0.01,1804,2
0.968,0.0001,946,958,50,100,0.01,1904,2
0.978,0.0001,996,1008,50,100,0.01,2004,2
0.55,0.0001,57,47,50,100,0.01,104,3
0.624,0.0001,105,99,50,100,0.01,204,3
0.61,0.0001,162,142,50,100,0.01,304,3
0.626,0.0001,211,193,50,100,0.01,404,3
0.638,0.0001,270,234,50,100,0.01,504,3
0.676,0.0001,313,291,50,100,0.01,604,3
0.676,0.0001,363,341,50,100,0.01,704,3
0.758,0.0001,422,382,50,100,0.01,804,3
0.816,0.0001,471,433,50,100,0.01,904,3
0.872,0.0001,530,474,50,100,0.01,1004,3
0.9,0.0001,587,517,50,100,0.01,1104,3
0.926,0.0001,630,574,50,100,0.01,1204,3
0.942,0.0001,679,625,50,100,0.01,1304,3
0.958,0.0001,727,677,50,100,0.01,1404,3
0.954,0.0001,782,722,50,100,0.01,1504,3
0.964,0.0001,829,775,50,100,0.01,1604,3
0.968,0.0001,873,831,50,100,0.01,1704,3
0.966,0.0001,922,882,50,100,0.01,1804,3
0.97,0.0001,971,933,50,100,0.01,1904,3
0.974,0.0001,1014,990,50,100,0.01,2004,3
0.566,0.0001,51,53,50,100,0.01,104,4
0.57,0.0001,108,96,50,100,0.01,204,4
0.572,0.0001,153,151,50,100,0.01,304,4
0.608,0.0001,207,197,50,100,0.01,404,4
0.612,0.0001,256,248,50,100,0.01,504,4
0.66,0.0001,312,292,50,100,0.01,604,4
0.724,0.0001,356,348,50,100,0.01,704,4
0.78,0.0001,408,396,50,100,0.01,804,4
0.822,0.0001,451,453,50,100,0.01,904,4
0.894,0.0001,495,509,50,100,0.01,1004,4
0.908,0.0001,542,562,50,100,0.01,1104,4
0.936,0.0001,596,608,50,100,0.01,1204,4
0.932,0.0001,637,667,50,100,0.01,1304,4
0.946,0.0001,698,706,50,100,0.01,1404,4
0.948,0.0001,750,754,50,100,0.01,1504,4
0.946,0.0001,795,809,50,100,0.01,1604,4
0.96,0.0001,850,854,50,100,0.01,1704,4
0.962,0.0001,903,901,50,100,0.01,1804,4
0.962,0.0001,955,949,50,100,0.01,1904,4
0.968,0.0001,1002,1002,50,100,0.01,2004,4
0.522,0.0001,51,53,50,100,0.01,104,5
0.556,0.0001,93,111,50,100,0.01,204,5
0.57,0.0001,143,161,50,100,0.01,304,5
0.606,0.0001,196,208,50,100,0.01,404,5
0.6,0.0001,254,250,50,100,0.01,504,5
0.636,0.0001,301,303,50,100,0.01,604,5
0.688,0.0001,349,355,50,100,0.01,704,5
0.756,0.0001,393,411,50,100,0.01,804,5
0.8,0.0001,446,458,50,100,0.01,904,5
0.854,0.0001,499,505,50,100,0.01,1004,5
0.882,0.0001,547,557,50,100,0.01,1104,5
0.918,0.0001,588,616,50,100,0.01,1204,5
0.924,0.0001,647,657,50,100,0.01,1304,5
0.948,0.0001,695,709,50,100,0.01,1404,5
0.954,0.0001,741,763,50,100,0.01,1504,5
0.952,0.0001,789,815,50,100,0.01,1604,5
0.95,0.0001,835,869,50,100,0.01,1704,5
0.96,0.0001,880,924,50,100,0.01,1804,5
0.968,0.0001,936,968,50,100,0.01,1904,5
0.97,0.0001,993,1011,50,100,0.01,2004,5
0.57,0.0001,53,51,50,100,0.01,104,6
0.578,0.0001,104,100,50,100,0.01,204,6
0.596,0.0001,155,149,50,100,0.01,304,6
0.618,0.0001,203,201,50,100,0.01,404,6
0.64,0.0001,255,249,50,100,0.01,504,6
0.712,0.0001,306,298,50,100,0.01,604,6
0.78,0.0001,349,355,50,100,0.01,704,6
0.846,0.0001,402,402,50,100,0.01,804,6
0.884,0.0001,451,453,50,100,0.01,904,6
0.908,0.0001,501,503,50,100,0.01,1004,6
0.926,0.0001,544,560,50,100,0.01,1104,6
0.95,0.0001,587,617,50,100,0.01,1204,6
0.948,0.0001,631,673,50,100,0.01,1304,6
0.96,0.0001,680,724,50,100,0.01,1404,6
0.962,0.0001,726,778,50,100,0.01,1504,6
0.964,0.0001,780,824,50,100,0.01,1604,6
0.974,0.0001,833,871,50,100,0.01,1704,6
0.978,0.0001,883,921,50,100,0.01,1804,6
0.972,0.0001,934,970,50,100,0.01,1904,6
0.976,0.0001,990,1014,50,100,0.01,2004,6
0.516,0.0001,52,52,50,100,0.01,104,7
0.576,0.0001,100,104,50,100,0.01,204,7
0.624,0.0001,150,154,50,100,0.01,304,7
0.662,0.0001,208,196,50,100,0.01,404,7
0.69,0.0001,254,250,50,100,0.01,504,7
0.718,0.0001,309,295,50,100,0.01,604,7
0.716,0.0001,363,341,50,100,0.01,704,7
0.776,0.0001,411,393,50,100,0.01,804,7
0.804,0.0001,464,440,50,100,0.01,904,7
0.864,0.0001,515,489,50,100,0.01,1004,7
0.88,0.0001,563,541,50,100,0.01,1104,7
0.934,0.0001,612,592,50,100,0.01,1204,7
0.946,0.0001,662,642,50,100,0.01,1304,7
0.958,0.0001,716,688,50,100,0.01,1404,7
0.962,0.0001,764,740,50,100,0.01,1504,7
0.96,0.0001,818,786,50,100,0.01,1604,7
0.974,0.0001,865,839,50,100,0.01,1704,7
0.976,0.0001,912,892,50,100,0.01,1804,7
0.98,0.0001,956,948,50,100,0.01,1904,7
0.982,0.0001,1010,994,50,100,0.01,2004,7
0.556,0.0001,59,45,50,100,0.01,104,8
0.58,0.0001,116,88,50,100,0.01,204,8
0.584,0.0001,168,136,50,100,0.01,304,8
0.614,0.0001,226,178,50,100,0.01,404,8
0.652,0.0001,272,232,50,100,0.01,504,8
0.686,0.0001,320,284,50,100,0.01,604,8
0.718,0.0001,364,340,50,100,0.01,704,8
0.76,0.0001,408,396,50,100,0.01,804,8
0.822,0.0001,455,449,50,100,0.01,904,8
0.876,0.0001,495,509,50,100,0.01,1004,8
0.892,0.0001,548,556,50,100,0.01,1104,8
0.918,0.0001,596,608,50,100,0.01,1204,8
0.924,0.0001,651,653,50,100,0.01,1304,8
0.952,0.0001,697,707,50,100,0.01,1404,8
0.958,0.0001,752,752,50,100,0.01,1504,8
0.956,0.0001,799,805,50,100,0.01,1604,8
0.952,0.0001,848,856,50,100,0.01,1704,8
0.962,0.0001,894,910,50,100,0.01,1804,8
0.962,0.0001,940,964,50,100,0.01,1904,8
0.968,0.0001,998,1006,50,100,0.01,2004,8
0.568,0.0001,50,54,50,100,0.01,104,9
0.598,0.0001,101,103,50,100,0.01,204,9
0.628,0.0001,149,155,50,100,0.01,304,9
0.656,0.0001,196,208,50,100,0.01,404,9
0.68,0.0001,248,256,50,100,0.01,504,9
0.696,0.0001,305,299,50,100,0.01,604,9
0.734,0.0001,348,356,50,100,0.01,704,9
0.784,0.0001,407,397,50,100,0.01,804,9
0.8,0.0001,455,449,50,100,0.01,904,9
0.852,0.0001,505,499,50,100,0.01,1004,9
0.888,0.0001,560,544,50,100,0.01,1104,9
0.932,0.0001,608,596,50,100,0.01,1204,9
0.932,0.0001,651,653,50,100,0.01,1304,9
0.94,0.0001,700,704,50,100,0.01,1404,9
0.928,0.0001,732,772,50,100,0.01,1504,9
0.942,0.0001,774,830,50,100,0.01,1604,9
0.944,0.0001,830,874,50,100,0.01,1704,9
0.956,0.0001,887,917,50,100,0.01,1804,9
0.958,0.0001,952,952,50,100,0.01,1904,9
0.962,0.0001,1004,1000,50,100,0.01,2004,9
0.526,0.0001,52,52,50,100,0.01,104,10
0.54,0.0001,103,101,50,100,0.01,204,10
0.552,0.0001,142,162,50,100,0.01,304,10
0.626,0.0001,197,207,50,100,0.01,404,10
0.612,0.0001,237,267,50,100,0.01,504,10
0.636,0.0001,288,316,50,100,0.01,604,10
0.682,0.0001,334,370,50,100,0.01,704,10
0.74,0.0001,377,427,50,100,0.01,804,10
0.79,0.0001,432,472,50,100,0.01,904,10
0.866,0.0001,482,522,50,100,0.01,1004,10
0.906,0.0001,534,570,50,100,0.01,1104,10
0.936,0.0001,584,620,50,100,0.01,1204,10
0.946,0.0001,632,672,50,100,0.01,1304,10
0.964,0.0001,686,718,50,100,0.01,1404,10
0.962,0.0001,747,757,50,100,0.01,1504,10
0.968,0.0001,791,813,50,100,0.01,1604,10
0.974,0.0001,846,858,50,100,0.01,1704,10
0.974,0.0001,891,913,50,100,0.01,1804,10
0.976,0.0001,940,964,50,100,0.01,1904,10
0.978,0.0001,991,1013,50,100,0.01,2004,10
0.544,0.0001,61,43,50,100,0.01,104,11
0.56,0.0001,108,96,50,100,0.01,204,11
0.59,0.0001,160,144,50,100,0.01,304,11
0.606,0.0001,211,193,50,100,0.01,404,11
0.638,0.0001,262,242,50,100,0.01,504,11
0.706,0.0001,307,297,50,100,0.01,604,11
0.71,0.0001,364,340,50,100,0.01,704,11
0.784,0.0001,408,396,50,100,0.01,804,11
0.82,0.0001,460,444,50,100,0.01,904,11
0.866,0.0001,515,489,50,100,0.01,1004,11
0.91,0.0001,557,547,50,100,0.01,1104,11
0.928,0.0001,605,599,50,100,0.01,1204,11
0.94,0.0001,653,651,50,100,0.01,1304,11
0.946,0.0001,702,702,50,100,0.01,1404,11
0.944,0.0001,756,748,50,100,0.01,1504,11
0.946,0.0001,801,803,50,100,0.01,1604,11
0.958,0.0001,858,846,50,100,0.01,1704,11
0.958,0.0001,900,904,50,100,0.01,1804,11
0.958,0.0001,947,957,50,100,0.01,1904,11
0.966,0.0001,998,1006,50,100,0.01,2004,11
0.532,0.0001,57,47,50,100,0.01,104,12
0.588,0.0001,112,92,50,100,0.01,204,12
0.568,0.0001,153,151,50,100,0.01,304,12
0.608,0.0001,211,193,50,100,0.01,404,12
0.642,0.0001,260,244,50,100,0.01,504,12
0.714,0.0001,311,293,50,100,0.01,604,12
0.746,0.0001,366,338,50,100,0.01,704,12
0.798,0.0001,419,385,50,100,0.01,804,12
0.84,0.0001,461,443,50,100,0.01,904,12
0.866,0.0001,509,495,50,100,0.01,1004,12
0.864,0.0001,552,552,50,100,0.01,1104,12
0.906,0.0001,603,601,50,100,0.01,1204,12
0.922,0.0001,649,655,50,100,0.01,1304,12
0.936,0.0001,696,708,50,100,0.01,1404,12
0.944,0.0001,743,761,50,100,0.01,1504,12
0.954,0.0001,795,809,50,100,0.01,1604,12
0.95,0.0001,843,861,50,100,0.01,1704,12
0.958,0.0001,893,911,50,100,0.01,1804,12
0.95,0.0001,941,963,50,100,0.01,1904,12
0.944,0.0001,992,1012,50,100,0.01,2004,12
0.536,0.0001,50,54,50,100,0.01,104,13
0.554,0.0001,99,105,50,100,0.01,204,13
0.57,0.0001,147,157,50,100,0.01,304,13
0.6,0.0001,194,210,50,100,0.01,404,13
0.64,0.0001,248,256,50,100,0.01,504,13
0.682,0.0001,297,307,50,100,0.01,604,13
0.72,0.0001,342,362,50,100,0.01,704,13
0.792,0.0001,386,418,50,100,0.01,804,13
0.87,0.0001,443,461,50,100,0.01,904,13
0.914,0.0001,492,512,50,100,0.01,1004,13
0.926,0.0001,536,568,50,100,0.01,1104,13
0.954,0.0001,589,615,50,100,0.01,1204,13
0.954,0.0001,644,660,50,100,0.01,1304,13
0.964,0.0001,698,706,50,100,0.01,1404,13
0.97,0.0001,746,758,50,100,0.01,1504,13
0.968,0.0001,797,807,50,100,0.01,1604,13
0.976,0.0001,847,857,50,100,0.01,1704,13
0.966,0.0001,898,906,50,100,0.01,1804,13
0.976,0.0001,952,952,50,100,0.01,1904,13
0.976,0.0001,1004,1000,50,100,0.01,2004,13
0.534,0.0001,54,50,50,100,0.01,104,14
0.574,0.0001,93,111,50,100,0.01,204,14
0.582,0.0001,141,163,50,100,0.01,304,14
0.626,0.0001,194,210,50,100,0.01,404,14
0.656,0.0001,255,249,50,100,0.01,504,14
0.69,0.0001,299,305,50,100,0.01,604,14
0.764,0.0001,350,354,50,100,0.01,704,14
0.822,0.0001,403,401,50,100,0.01,804,14
0.868,0.0001,447,457,50,100,0.01,904,14
0.908,0.0001,498,506,50,100,0.01,1004,14
0.944,0.0001,548,556,50,100,0.01,1104,14
0.96,0.0001,590,614,50,100,0.01,1204,14
0.958,0.0001,640,664,50,100,0.01,1304,14
0.966,0.0001,685,719,50,100,0.01,1404,14
0.974,0.0001,741,763,50,100,0.01,1504,14
0.978,0.0001,796,808,50,100,0.01,1604,14
0.982,0.0001,851,853,50,100,0.01,1704,14
0.982,0.0001,898,906,50,100,0.01,1804,14
0.984,0.0001,946,958,50,100,0.01,1904,14
0.986,0.0001,1004,1000,50,100,0.01,2004,14
0.502,0.0001,57,47,50,100,0.01,104,15
0.572,0.0001,108,96,50,100,0.01,204,15
0.616,0.0001,159,145,50,100,0.01,304,15
0.636,0.0001,210,194,50,100,0.01,404,15
0.646,0.0001,261,243,50,100,0.01,504,15
0.698,0.0001,313,291,50,100,0.01,604,15
0.73,0.0001,358,346,50,100,0.01,704,15
0.768,0.0001,408,396,50,100,0.01,804,15
0.792,0.0001,456,448,50,100,0.01,904,15
0.86,0.0001,508,496,50,100,0.01,1004,15
0.858,0.0001,563,541,50,100,0.01,1104,15
0.93,0.0001,615,589,50,100,0.01,1204,15
0.934,0.0001,660,644,50,100,0.01,1304,15
0.944,0.0001,712,692,50,100,0.01,1404,15
0.948,0.0001,755,749,50,100,0.01,1504,15
0.96,0.0001,804,800,50,100,0.01,1604,15
0.962,0.0001,848,856,50,100,0.01,1704,15
0.966,0.0001,911,893,50,100,0.01,1804,15
0.968,0.0001,956,948,50,100,0.01,1904,15
0.974,0.0001,1003,1001,50,100,0.01,2004,15
0.488,0.0001,43,61,50,100,0.01,104,16
0.566,0.0001,98,106,50,100,0.01,204,16
0.592,0.0001,150,154,50,100,0.01,304,16
0.646,0.0001,197,207,50,100,0.01,404,16
0.68,0.0001,254,250,50,100,0.01,504,16
0.746,0.0001,311,293,50,100,0.01,604,16
0.786,0.0001,364,340,50,100,0.01,704,16
0.858,0.0001,412,392,50,100,0.01,804,16
0.894,0.0001,457,447,50,100,0.01,904,16
0.926,0.0001,509,495,50,100,0.01,1004,16
0.946,0.0001,552,552,50,100,0.01,1104,16
0.946,0.0001,603,601,50,100,0.01,1204,16
0.95,0.0001,653,651,50,100,0.01,1304,16
0.958,0.0001,696,708,50,100,0.01,1404,16
0.952,0.0001,743,761,50,100,0.01,1504,16
0.958,0.0001,789,815,50,100,0.01,1604,16
0.97,0.0001,835,869,50,100,0.01,1704,16
0.964,0.0001,890,914,50,100,0.01,1804,16
0.974,0.0001,932,972,50,100,0.01,1904,16
0.972,0.0001,988,1016,50,100,0.01,2004,16
0.574,0.0001,50,54,50,100,0.01,104,17
0.6,0.0001,102,102,50,100,0.01,204,17
0.628,0.0001,155,149,50,100,0.01,304,17
0.664,0.0001,207,197,50,100,0.01,404,17
0.658,0.0001,262,242,50,100,0.01,504,17
0.688,0.0001,319,285,50,100,0.01,604,17
0.75,0.0001,369,335,50,100,0.01,704,17
0.84,0.0001,407,397,50,100,0.01,804,17
0.87,0.0001,457,447,50,100,0.01,904,17
0.92,0.0001,503,501,50,100,0.01,1004,17
0.916,0.0001,550,554,50,100,0.01,1104,17
0.916,0.0001,600,604,50,100,0.01,1204,17
0.944,0.0001,649,655,50,100,0.01,1304,17
0.956,0.0001,699,705,50,100,0.01,1404,17
0.958,0.0001,745,759,50,100,0.01,1504,17
0.962,0.0001,798,806,50,100,0.01,1604,17
0.962,0.0001,851,853,50,100,0.01,1704,17
0.966,0.0001,897,907,50,100,0.01,1804,17
0.968,0.0001,946,958,50,100,0.01,1904,17
0.978,0.0001,994,1010,50,100,0.01,2004,17
0.498,0.0001,51,53,50,100,0.01,104,18
0.638,0.0001,89,115,50,100,0.01,204,18
0.618,0.0001,141,163,50,100,0.01,304,18
0.596,0.0001,190,214,50,100,0.01,404,18
0.632,0.0001,246,258,50,100,0.01,504,18
0.676,0.0001,290,314,50,100,0.01,604,18
0.722,0.0001,343,361,50,100,0.01,704,18
0.782,0.0001,394,410,50,100,0.01,804,18
0.818,0.0001,446,458,50,100,0.01,904,18
0.868,0.0001,494,510,50,100,0.01,1004,18
0.892,0.0001,548,556,50,100,0.01,1104,18
0.952,0.0001,596,608,50,100,0.01,1204,18
0.964,0.0001,646,658,50,100,0.01,1304,18
0.97,0.0001,701,703,50,100,0.01,1404,18
0.968,0.0001,756,748,50,100,0.01,1504,18
0.978,0.0001,800,804,50,100,0.01,1604,18
0.978,0.0001,857,847,50,100,0.01,1704,18
0.982,0.0001,912,892,50,100,0.01,1804,18
0.982,0.0001,964,940,50,100,0.01,1904,18
0.982,0.0001,1022,982,50,100,0.01,2004,18
0.546,0.0001,42,62,50,100,0.01,104,19
0.518,0.0001,93,111,50,100,0.01,204,19
0.55,0.0001,147,157,50,100,0.01,304,19
0.622,0.0001,199,205,50,100,0.01,404,19
0.652,0.0001,248,256,50,100,0.01,504,19
0.676,0.0001,293,311,50,100,0.01,604,19
0.728,0.0001,344,360,50,100,0.01,704,19
0.79,0.0001,394,410,50,100,0.01,804,19
0.818,0.0001,442,462,50,100,0.01,904,19
0.884,0.0001,492,512,50,100,0.01,1004,19
0.914,0.0001,543,561,50,100,0.01,1104,19
0.956,0.0001,599,605,50,100,0.01,1204,19
0.952,0.0001,648,656,50,100,0.01,1304,19
0.962,0.0001,699,705,50,100,0.01,1404,19
0.972,0.0001,752,752,50,100,0.01,1504,19
0.976,0.0001,798,806,50,100,0.01,1604,19
0.972,0.0001,846,858,50,100,0.01,1704,19
0.978,0.0001,892,912,50,100,0.01,1804,19
0.976,0.0001,945,959,50,100,0.01,1904,19
0.982,0.0001,995,1009,50,100,0.01,2004,19
0.53,0.0001,51,53,50,100,0.01,104,20
0.558,0.0001,100,104,50,100,0.01,204,20
0.596,0.0001,146,158,50,100,0.01,304,20
0.646,0.0001,207,197,50,100,0.01,404,20
0.674,0.0001,254,250,50,100,0.01,504,20
0.708,0.0001,312,292,50,100,0.01,604,20
0.71,0.0001,360,344,50,100,0.01,704,20
0.75,0.0001,417,387,50,100,0.01,804,20
0.794,0.0001,470,434,50,100,0.01,904,20
0.85,0.0001,514,490,50,100,0.01,1004,20
0.874,0.0001,563,541,50,100,0.01,1104,20
0.924,0.0001,622,582,50,100,0.01,1204,20
0.934,0.0001,675,629,50,100,0.01,1304,20
0.936,0.0001,725,679,50,100,0.01,1404,20
0.942,0.0001,769,735,50,100,0.01,1504,20
0.962,0.0001,824,780,50,100,0.01,1604,20
0.96,0.0001,872,832,50,100,0.01,1704,20
0.966,0.0001,911,893,50,100,0.01,1804,20
0.974,0.0001,956,948,50,100,0.01,1904,20
0.972,0.0001,1007,997,50,100,0.01,2004,20
0.522,0.001,57,47,50,100,0.0001,104,1
0.524,0.001,100,104,50,100,0.0001,204,1
0.522,0.001,145,159,50,100,0.0001,304,1
0.522,0.001,195,209,50,100,0.0001,404,1
0.522,0.001,251,253,50,100,0.0001,504,1
0.522,0.001,293,311,50,100,0.0001,604,1
0.524,0.001,343,361,50,100,0.0001,704,1
0.522,0.001,396,408,50,100,0.0001,804,1
0.522,0.001,448,456,50,100,0.0001,904,1
0.522,0.001,499,505,50,100,0.0001,1004,1
0.522,0.001,538,566,50,100,0.0001,1104,1
0.526,0.001,584,620,50,100,0.0001,1204,1
0.534,0.001,634,670,50,100,0.0001,1304,1
0.538,0.001,689,715,50,100,0.0001,1404,1
0.54,0.001,741,763,50,100,0.0001,1504,1
0.542,0.001,787,817,50,100,0.0001,1604,1
0.54,0.001,844,860,50,100,0.0001,1704,1
0.54,0.001,898,906,50,100,0.0001,1804,1
0.542,0.001,960,944,50,100,0.0001,1904,1
0.542,0.001,1007,997,50,100,0.0001,2004,1
0.534,0.001,61,43,50,100,0.0001,104,2
0.534,0.001,107,97,50,100,0.0001,204,2
0.534,0.001,151,153,50,100,0.0001,304,2
0.53,0.001,195,209,50,100,0.0001,404,2
0.53,0.001,242,262,50,100,0.0001,504,2
0.53,0.001,297,307,50,100,0.0001,604,2
0.538,0.001,349,355,50,100,0.0001,704,2
0.538,0.001,398,406,50,100,0.0001,804,2
0.546,0.001,450,454,50,100,0.0001,904,2
0.546,0.001,496,508,50,100,0.0001,1004,2
0.548,0.001,544,560,50,100,0.0001,1104,2
0.546,0.001,595,609,50,100,0.0001,1204,2
0.548,0.001,651,653,50,100,0.0001,1304,2
0.55,0.001,700,704,50,100,0.0001,1404,2
0.552,0.001,753,751,50,100,0.0001,1504,2
0.558,0.001,809,795,50,100,0.0001,1604,2
0.562,0.001,859,845,50,100,0.0001,1704,2
0.562,0.001,908,896,50,100,0.0001,1804,2
0.57,0.001,951,953,50,100,0.0001,1904,2
0.578,0.001,1001,1003,50,100,0.0001,2004,2
0.502,0.001,51,53,50,100,0.0001,104,3
0.508,0.001,104,100,50,100,0.0001,204,3
0.512,0.001,155,149,50,100,0.0001,304,3
0.51,0.001,207,197,50,100,0.0001,404,3
0.508,0.001,261,243,50,100,0.0001,504,3
0.506,0.001,319,285,50,100,0.0001,604,3
0.504,0.001,372,332,50,100,0.0001,704,3
0.504,0.001,416,388,50,100,0.0001,804,3
0.508,0.001,458,446,50,100,0.0001,904,3
0.512,0.001,509,495,50,100,0.0001,1004,3
0.52,0.001,549,555,50,100,0.0001,1104,3
0.524,0.001,603,601,50,100,0.0001,1204,3
0.52,0.001,649,655,50,100,0.0001,1304,3
0.522,0.001,709,695,50,100,0.0001,1404,3
0.52,0.001,758,746,50,100,0.0001,1504,3
0.516,0.001,811,793,50,100,0.0001,1604,3
0.522,0.001,859,845,50,100,0.0001,1704,3
0.524,0.001,911,893,50,100,0.0001,1804,3
0.534,0.001,956,948,50,100,0.0001,1904,3
0.538,0.001,1006,998,50,100,0.0001,2004,3
0.524,0.001,41,63,50,100,0.0001,104,4
0.522,0.001,101,103,50,100,0.0001,204,4
0.522,0.001,146,158,50,100,0.0001,304,4
0.526,0.001,202,202,50,100,0.0001,404,4
0.53,0.001,256,248,50,100,0.0001,504,4
0.532,0.001,309,295,50,100,0.0001,604,4
0.528,0.001,358,346,50,100,0.0001,704,4
0.526,0.001,409,395,50,100,0.0001,804,4
0.522,0.001,452,452,50,100,0.0001,904,4
0.526,0.001,497,507,50,100,0.0001,1004,4
0.532,0.001,538,566,50,100,0.0001,1104,4
0.53,0.001,588,616,50,100,0.0001,1204,4
0.53,0.001,647,657,50,100,0.0001,1304,4
0.532,0.001,692,712,50,100,0.0001,1404,4
0.534,0.001,747,757,50,100,0.0001,1504,4
0.534,0.001,807,797,50,100,0.0001,1604,4
0.546,0.001,853,851,50,100,0.0001,1704,4
0.554,0.001,916,888,50,100,0.0001,1804,4
0.558,0.001,963,941,50,100,0.0001,1904,4
0.56,0.001,1014,990,50,100,0.0001,2004,4
0.516,0.001,56,48,50,100,0.0001,104,5
0.514,0.001,106,98,50,100,0.0001,204,5
0.512,0.001,161,143,50,100,0.0001,304,5
0.51,0.001,213,191,50,100,0.0001,404,5
0.51,0.001,273,231,50,100,0.0001,504,5
0.508,0.001,321,283,50,100,0.0001,604,5
0.506,0.001,372,332,50,100,0.0001,704,5
0.506,0.001,422,382,50,100,0.0001,804,5
0.51,0.001,473,431,50,100,0.0001,904,5
0.508,0.001,515,489,50,100,0.0001,1004,5
0.506,0.001,560,544,50,100,0.0001,1104,5
0.508,0.001,605,599,50,100,0.0001,1204,5
0.51,0.001,656,648,50,100,0.0001,1304,5
0.514,0.001,704,700,50,100,0.0001,1404,5
0.518,0.001,753,751,50,100,0.0001,1504,5
0.53,0.001,804,800,50,100,0.0001,1604,5
0.536,0.001,848,856,50,100,0.0001,1704,5
0.55,0.001,905,899,50,100,0.0001,1804,5
0.548,0.001,947,957,50,100,0.0001,1904,5
0.552,0.001,1002,1002,50,100,0.0001,2004,5
0.522,0.001,60,44,50,100,0.0001,104,6
0.526,0.001,110,94,50,100,0.0001,204,6
0.526,0.001,165,139,50,100,0.0001,304,6
0.518,0.001,218,186,50,100,0.0001,404,6
0.52,0.001,274,230,50,100,0.0001,504,6
0.52,0.001,330,274,50,100,0.0001,604,6
0.516,0.001,380,324,50,100,0.0001,704,6
0.522,0.001,425,379,50,100,0.0001,804,6
0.532,0.001,475,429,50,100,0.0001,904,6
0.534,0.001,518,486,50,100,0.0001,1004,6
0.53,0.001,577,527,50,100,0.0001,1104,6
0.53,0.001,620,584,50,100,0.0001,1204,6
0.53,0.001,666,638,50,100,0.0001,1304,6
0.53,0.001,715,689,50,100,0.0001,1404,6
0.54,0.001,764,740,50,100,0.0001,1504,6
0.548,0.001,814,790,50,100,0.0001,1604,6
0.546,0.001,859,845,50,100,0.0001,1704,6
0.548,0.001,909,895,50,100,0.0001,1804,6
0.552,0.001,962,942,50,100,0.0001,1904,6
0.562,0.001,1007,997,50,100,0.0001,2004,6
0.524,0.001,48,56,50,100,0.0001,104,7
0.526,0.001,103,101,50,100,0.0001,204,7
0.526,0.001,152,152,50,100,0.0001,304,7
0.526,0.001,203,201,50,100,0.0001,404,7
0.526,0.001,256,248,50,100,0.0001,504,7
0.53,0.001,306,298,50,100,0.0001,604,7
0.532,0.001,351,353,50,100,0.0001,704,7
0.532,0.001,403,401,50,100,0.0001,804,7
0.536,0.001,453,451,50,100,0.0001,904,7
0.532,0.001,516,488,50,100,0.0001,1004,7
0.532,0.001,568,536,50,100,0.0001,1104,7
0.534,0.001,624,580,50,100,0.0001,1204,7
0.53,0.001,670,634,50,100,0.0001,1304,7
0.53,0.001,715,689,50,100,0.0001,1404,7
0.534,0.001,763,741,50,100,0.0001,1504,7
0.534,0.001,814,790,50,100,0.0001,1604,7
0.534,0.001,859,845,50,100,0.0001,1704,7
0.544,0.001,910,894,50,100,0.0001,1804,7
0.548,0.001,954,950,50,100,0.0001,1904,7
0.556,0.001,1011,993,50,100,0.0001,2004,7
0.488,0.001,59,45,50,100,0.0001,104,8
0.49,0.001,104,100,50,100,0.0001,204,8
0.494,0.001,157,147,50,100,0.0001,304,8
0.488,0.001,208,196,50,100,0.0001,404,8
0.492,0.001,258,246,50,100,0.0001,504,8
0.496,0.001,306,298,50,100,0.0001,604,8
0.498,0.001,348,356,50,100,0.0001,704,8
0.498,0.001,390,414,50,100,0.0001,804,8
0.492,0.001,439,465,50,100,0.0001,904,8
0.496,0.001,493,511,50,100,0.0001,1004,8
0.496,0.001,532,572,50,100,0.0001,1104,8
0.5,0.001,585,619,50,100,0.0001,1204,8
0.504,0.001,640,664,50,100,0.0001,1304,8
0.506,0.001,685,719,50,100,0.0001,1404,8
0.5,0.001,731,773,50,100,0.0001,1504,8
0.506,0.001,790,814,50,100,0.0001,1604,8
0.516,0.001,841,863,50,100,0.0001,1704,8
0.526,0.001,903,901,50,100,0.0001,1804,8
0.522,0.001,948,956,50,100,0.0001,1904,8
0.532,0.001,990,1014,50,100,0.0001,2004,8
0.464,0.001,56,48,50,100,0.0001,104,9
0.464,0.001,109,95,50,100,0.0001,204,9
0.464,0.001,152,152,50,100,0.0001,304,9
0.464,0.001,208,196,50,100,0.0001,404,9
0.464,0.001,261,243,50,100,0.0001,504,9
0.458,0.001,302,302,50,100,0.0001,604,9
0.458,0.001,352,352,50,100,0.0001,704,9
0.46,0.001,406,398,50,100,0.0001,804,9
0.46,0.001,459,445,50,100,0.0001,904,9
0.46,0.001,509,495,50,100,0.0001,1004,9
0.46,0.001,559,545,50,100,0.0001,1104,9
0.464,0.001,603,601,50,100,0.0001,1204,9
0.462,0.001,646,658,50,100,0.0001,1304,9
0.466,0.001,697,707,50,100,0.0001,1404,9
0.466,0.001,744,760,50,100,0.0001,1504,9
0.47,0.001,791,813,50,100,0.0001,1604,9
0.474,0.001,845,859,50,100,0.0001,1704,9
0.48,0.001,900,904,50,100,0.0001,1804,9
0.482,0.001,944,960,50,100,0.0001,1904,9
0.482,0.001,998,1006,50,100,0.0001,2004,9
0.496,0.001,48,56,50,100,0.0001,104,10
0.498,0.001,99,105,50,100,0.0001,204,10
0.498,0.001,137,167,50,100,0.0001,304,10
0.496,0.001,183,221,50,100,0.0001,404,10
0.502,0.001,241,263,50,100,0.0001,504,10
0.506,0.001,293,311,50,100,0.0001,604,10
0.502,0.001,341,363,50,100,0.0001,704,10
0.51,0.001,392,412,50,100,0.0001,804,10
0.516,0.001,448,456,50,100,0.0001,904,10
0.512,0.001,493,511,50,100,0.0001,1004,10
0.512,0.001,542,562,50,100,0.0001,1104,10
0.518,0.001,594,610,50,100,0.0001,1204,10
0.516,0.001,649,655,50,100,0.0001,1304,10
0.514,0.001,696,708,50,100,0.0001,1404,10
0.518,0.001,742,762,50,100,0.0001,1504,10
0.52,0.001,787,817,50,100,0.0001,1604,10
0.522,0.001,832,872,50,100,0.0001,1704,10
0.524,0.001,888,916,50,100,0.0001,1804,10
0.53,0.001,939,965,50,100,0.0001,1904,10
0.542,0.001,993,1011,50,100,0.0001,2004,10
0.534,0.001,54,50,50,100,0.0001,104,11
0.538,0.001,102,102,50,100,0.0001,204,11
0.538,0.001,154,150,50,100,0.0001,304,11
0.536,0.001,201,203,50,100,0.0001,404,11
0.538,0.001,254,250,50,100,0.0001,504,11
0.54,0.001,295,309,50,100,0.0001,604,11
0.542,0.001,350,354,50,100,0.0001,704,11
0.548,0.001,396,408,50,100,0.0001,804,11
0.554,0.001,445,459,50,100,0.0001,904,11
0.556,0.001,506,498,50,100,0.0001,1004,11
0.558,0.001,557,547,50,100,0.0001,1104,11
0.56,0.001,604,600,50,100,0.0001,1204,11
0.566,0.001,662,642,50,100,0.0001,1304,11
0.576,0.001,713,691,50,100,0.0001,1404,11
0.572,0.001,767,737,50,100,0.0001,1504,11
0.572,0.001,819,785,50,100,0.0001,1604,11
0.576,0.001,867,837,50,100,0.0001,1704,11
0.578,0.001,910,894,50,100,0.0001,1804,11
0.584,0.001,959,945,50,100,0.0001,1904,11
0.582,0.001,1007,997,50,100,0.0001,2004,11
0.502,0.001,43,61,50,100,0.0001,104,12
0.502,0.001,93,111,50,100,0.0001,204,12
0.498,0.001,150,154,50,100,0.0001,304,12
0.504,0.001,204,200,50,100,0.0001,404,12
0.506,0.001,250,254,50,100,0.0001,504,12
0.5,0.001,297,307,50,100,0.0001,604,12
0.502,0.001,339,365,50,100,0.0001,704,12
0.504,0.001,389,415,50,100,0.0001,804,12
0.506,0.001,439,465,50,100,0.0001,904,12
0.506,0.001,495,509,50,100,0.0001,1004,12
0.512,0.001,540,564,50,100,0.0001,1104,12
0.512,0.001,585,619,50,100,0.0001,1204,12
0.516,0.001,635,669,50,100,0.0001,1304,12
0.516,0.001,693,711,50,100,0.0001,1404,12
0.52,0.001,750,754,50,100,0.0001,1504,12
0.52,0.001,796,808,50,100,0.0001,1604,12
0.516,0.001,853,851,50,100,0.0001,1704,12
0.524,0.001,899,905,50,100,0.0001,1804,12
0.526,0.001,956,948,50,100,0.0001,1904,12
0.524,0.001,1009,995,50,100,0.0001,2004,12
0.49,0.001,57,47,50,100,0.0001,104,13
0.488,0.001,104,100,50,100,0.0001,204,13
0.49,0.001,152,152,50,100,0.0001,304,13
0.49,0.001,205,199,50,100,0.0001,404,13
0.492,0.001,250,254,50,100,0.0001,504,13
0.498,0.001,286,318,50,100,0.0001,604,13
0.5,0.001,332,372,50,100,0.0001,704,13
0.502,0.001,386,418,50,100,0.0001,804,13
0.506,0.001,435,469,50,100,0.0001,904,13
0.502,0.001,483,521,50,100,0.0001,1004,13
0.504,0.001,532,572,50,100,0.0001,1104,13
0.506,0.001,580,624,50,100,0.0001,1204,13
0.504,0.001,636,668,50,100,0.0001,1304,13
0.506,0.001,681,723,50,100,0.0001,1404,13
0.506,0.001,742,762,50,100,0.0001,1504,13
0.508,0.001,791,813,50,100,0.0001,1604,13
0.508,0.001,849,855,50,100,0.0001,1704,13
0.52,0.001,898,906,50,100,0.0001,1804,13
0.524,0.001,943,961,50,100,0.0001,1904,13
0.532,0.001,990,1014,50,100,0.0001,2004,13
0.478,0.001,55,49,50,100,0.0001,104,14
0.476,0.001,103,101,50,100,0.0001,204,14
0.476,0.001,150,154,50,100,0.0001,304,14
0.48,0.001,198,206,50,100,0.0001,404,14
0.478,0.001,249,255,50,100,0.0001,504,14
0.48,0.001,301,303,50,100,0.0001,604,14
0.48,0.001,345,359,50,100,0.0001,704,14
0.488,0.001,398,406,50,100,0.0001,804,14
0.49,0.001,442,462,50,100,0.0001,904,14
0.498,0.001,491,513,50,100,0.0001,1004,14
0.502,0.001,545,559,50,100,0.0001,1104,14
0.5,0.001,595,609,50,100,0.0001,1204,14
0.502,0.001,653,651,50,100,0.0001,1304,14
0.506,0.001,710,694,50,100,0.0001,1404,14
0.508,0.001,761,743,50,100,0.0001,1504,14
0.518,0.001,796,808,50,100,0.0001,1604,14
0.526,0.001,848,856,50,100,0.0001,1704,14
0.53,0.001,893,911,50,100,0.0001,1804,14
0.536,0.001,938,966,50,100,0.0001,1904,14
0.542,0.001,986,1018,50,100,0.0001,2004,14
0.488,0.001,58,46,50,100,0.0001,104,15
0.488,0.001,103,101,50,100,0.0001,204,15
0.49,0.001,161,143,50,100,0.0001,304,15
0.49,0.001,214,190,50,100,0.0001,404,15
0.49,0.001,269,235,50,100,0.0001,504,15
0.49,0.001,319,285,50,100,0.0001,604,15
0.49,0.001,361,343,50,100,0.0001,704,15
0.49,0.001,409,395,50,100,0.0001,804,15
0.49,0.001,456,448,50,100,0.0001,904,15
0.49,0.001,510,494,50,100,0.0001,1004,15
0.492,0.001,560,544,50,100,0.0001,1104,15
0.492,0.001,598,606,50,100,0.0001,1204,15
0.492,0.001,642,662,50,100,0.0001,1304,15
0.496,0.001,695,709,50,100,0.0001,1404,15
0.498,0.001,751,753,50,100,0.0001,1504,15
0.5,0.001,806,798,50,100,0.0001,1604,15
0.498,0.001,853,851,50,100,0.0001,1704,15
0.5,0.001,906,898,50,100,0.0001,1804,15
0.504,0.001,949,955,50,100,0.0001,1904,15
0.506,0.001,999,1005,50,100,0.0001,2004,15
0.47,0.001,48,56,50,100,0.0001,104,16
0.468,0.001,103,101,50,100,0.0001,204,16
0.464,0.001,156,148,50,100,0.0001,304,16
0.468,0.001,206,198,50,100,0.0001,404,16
0.47,0.001,252,252,50,100,0.0001,504,16
0.47,0.001,302,302,50,100,0.0001,604,16
0.47,0.001,355,349,50,100,0.0001,704,16
0.482,0.001,406,398,50,100,0.0001,804,16
0.486,0.001,466,438,50,100,0.0001,904,16
0.49,0.001,514,490,50,100,0.0001,1004,16
0.49,0.001,556,548,50,100,0.0001,1104,16
0.492,0.001,608,596,50,100,0.0001,1204,16
0.492,0.001,651,653,50,100,0.0001,1304,16
0.496,0.001,706,698,50,100,0.0001,1404,16
0.504,0.001,757,747,50,100,0.0001,1504,16
0.506,0.001,801,803,50,100,0.0001,1604,16
0.516,0.001,855,849,50,100,0.0001,1704,16
0.524,0.001,903,901,50,100,0.0001,1804,16
0.526,0.001,949,955,50,100,0.0001,1904,16
0.534,0.001,999,1005,50,100,0.0001,2004,16
0.516,0.001,52,52,50,100,0.0001,104,17
0.518,0.001,102,102,50,100,0.0001,204,17
0.516,0.001,157,147,50,100,0.0001,304,17
0.512,0.001,210,194,50,100,0.0001,404,17
0.514,0.001,264,240,50,100,0.0001,504,17
0.514,0.001,305,299,50,100,0.0001,604,17
0.518,0.001,357,347,50,100,0.0001,704,17
0.518,0.001,407,397,50,100,0.0001,804,17
0.522,0.001,448,456,50,100,0.0001,904,17
0.524,0.001,486,518,50,100,0.0001,1004,17
0.53,0.001,532,572,50,100,0.0001,1104,17
0.534,0.001,583,621,50,100,0.0001,1204,17
0.534,0.001,635,669,50,100,0.0001,1304,17
0.534,0.001,684,720,50,100,0.0001,1404,17
0.532,0.001,733,771,50,100,0.0001,1504,17
0.536,0.001,788,816,50,100,0.0001,1604,17
0.538,0.001,847,857,50,100,0.0001,1704,17
0.548,0.001,892,912,50,100,0.0001,1804,17
0.552,0.001,944,960,50,100,0.0001,1904,17
0.558,0.001,992,1012,50,100,0.0001,2004,17
0.48,0.001,39,65,50,100,0.0001,104,18
0.484,0.001,89,115,50,100,0.0001,204,18
0.488,0.001,135,169,50,100,0.0001,304,18
0.492,0.001,179,225,50,100,0.0001,404,18
0.496,0.001,226,278,50,100,0.0001,504,18
0.496,0.001,275,329,50,100,0.0001,604,18
0.496,0.001,321,383,50,100,0.0001,704,18
0.5,0.001,375,429,50,100,0.0001,804,18
0.506,0.001,430,474,50,100,0.0001,904,18
0.506,0.001,478,526,50,100,0.0001,1004,18
0.51,0.001,527,577,50,100,0.0001,1104,18
0.518,0.001,577,627,50,100,0.0001,1204,18
0.516,0.001,630,674,50,100,0.0001,1304,18
0.52,0.001,683,721,50,100,0.0001,1404,18
0.524,0.001,729,775,50,100,0.0001,1504,18
0.53,0.001,779,825,50,100,0.0001,1604,18
0.538,0.001,822,882,50,100,0.0001,1704,18
0.548,0.001,868,936,50,100,0.0001,1804,18
0.552,0.001,920,984,50,100,0.0001,1904,18
0.558,0.001,978,1026,50,100,0.0001,2004,18
0.464,0.001,50,54,50,100,0.0001,104,19
0.462,0.001,100,104,50,100,0.0001,204,19
0.464,0.001,145,159,50,100,0.0001,304,19
0.466,0.001,199,205,50,100,0.0001,404,19
0.468,0.001,260,244,50,100,0.0001,504,19
0.468,0.001,302,302,50,100,0.0001,604,19
0.472,0.001,354,350,50,100,0.0001,704,19
0.476,0.001,409,395,50,100,0.0001,804,19
0.478,0.001,449,455,50,100,0.0001,904,19
0.48,0.001,497,507,50,100,0.0001,1004,19
0.48,0.001,553,551,50,100,0.0001,1104,19
0.476,0.001,606,598,50,100,0.0001,1204,19
0.478,0.001,656,648,50,100,0.0001,1304,19
0.472,0.001,700,704,50,100,0.0001,1404,19
0.474,0.001,741,763,50,100,0.0001,1504,19
0.476,0.001,796,808,50,100,0.0001,1604,19
0.494,0.001,845,859,50,100,0.0001,1704,19
0.508,0.001,903,901,50,100,0.0001,1804,19
0.514,0.001,956,948,50,100,0.0001,1904,19
0.524,0.001,1008,996,50,100,0.0001,2004,19
0.516,0.001,58,46,50,100,0.0001,104,20
0.514,0.001,110,94,50,100,0.0001,204,20
0.516,0.001,151,153,50,100,0.0001,304,20
0.518,0.001,197,207,50,100,0.0001,404,20
0.52,0.001,241,263,50,100,0.0001,504,20
0.52,0.001,286,318,50,100,0.0001,604,20
0.518,0.001,337,367,50,100,0.0001,704,20
0.52,0.001,392,412,50,100,0.0001,804,20
0.51,0.001,443,461,50,100,0.0001,904,20
0.508,0.001,500,504,50,100,0.0001,1004,20
0.514,0.001,547,557,50,100,0.0001,1104,20
0.52,0.001,593,611,50,100,0.0001,1204,20
0.526,0.001,642,662,50,100,0.0001,1304,20
0.526,0.001,694,710,50,100,0.0001,1404,20
0.526,0.001,744,760,50,100,0.0001,1504,20
0.524,0.001,796,808,50,100,0.0001,1604,20
0.532,0.001,849,855,50,100,0.0001,1704,20
0.546,0.001,895,909,50,100,0.0001,1804,20
0.546,0.001,955,949,50,100,0.0001,1904,20
0.548,0.001,1010,994,50,100,0.0001,2004,20
0.488,0.001,54,50,50,100,0.001,104,1
0.492,0.001,104,100,50,100,0.001,204,1
0.5,0.001,151,153,50,100,0.001,304,1
0.524,0.001,200,204,50,100,0.001,404,1
0.528,0.001,252,252,50,100,0.001,504,1
0.548,0.001,305,299,50,100,0.001,604,1
0.56,0.001,356,348,50,100,0.001,704,1
0.574,0.001,410,394,50,100,0.001,804,1
0.596,0.001,463,441,50,100,0.001,904,1
0.618,0.001,511,493,50,100,0.001,1004,1
0.636,0.001,570,534,50,100,0.001,1104,1
0.648,0.001,628,576,50,100,0.001,1204,1
0.672,0.001,678,626,50,100,0.001,1304,1
0.708,0.001,724,680,50,100,0.001,1404,1
0.74,0.001,771,733,50,100,0.001,1504,1
0.75,0.001,821,783,50,100,0.001,1604,1
0.764,0.001,867,837,50,100,0.001,1704,1
0.784,0.001,908,896,50,100,0.001,1804,1
0.798,0.001,955,949,50,100,0.001,1904,1
0.814,0.001,1000,1004,50,100,0.001,2004,1
0.494,0.001,51,53,50,100,0.001,104,2
0.504,0.001,95,109,50,100,0.001,204,2
0.506,0.001,148,156,50,100,0.001,304,2
0.534,0.001,194,210,50,100,0.001,404,2
0.54,0.001,248,256,50,100,0.001,504,2
0.586,0.001,288,316,50,100,0.001,604,2
0.606,0.001,347,357,50,100,0.001,704,2
0.632,0.001,402,402,50,100,0.001,804,2
0.656,0.001,455,449,50,100,0.001,904,2
0.676,0.001,511,493,50,100,0.001,1004,2
0.686,0.001,562,542,50,100,0.001,1104,2
0.72,0.001,618,586,50,100,0.001,1204,2
0.73,0.001,669,635,50,100,0.001,1304,2
0.752,0.001,718,686,50,100,0.001,1404,2
0.756,0.001,776,728,50,100,0.001,1504,2
0.786,0.001,825,779,50,100,0.001,1604,2
0.806,0.001,863,841,50,100,0.001,1704,2
0.814,0.001,909,895,50,100,0.001,1804,2
0.836,0.001,960,944,50,100,0.001,1904,2
0.852,0.001,1005,999,50,100,0.001,2004,2
0.496,0.001,60,44,50,100,0.001,104,3
0.5,0.001,109,95,50,100,0.001,204,3
0.498,0.001,158,146,50,100,0.001,304,3
0.514,0.001,207,197,50,100,0.001,404,3
0.53,0.001,252,252,50,100,0.001,504,3
0.53,0.001,304,300,50,100,0.001,604,3
0.52,0.001,349,355,50,100,0.001,704,3
0.546,0.001,397,407,50,100,0.001,804,3
0.578,0.001,438,466,50,100,0.001,904,3
0.59,0.001,481,523,50,100,0.001,1004,3
0.612,0.001,531,573,50,100,0.001,1104,3
0.628,0.001,583,621,50,100,0.001,1204,3
0.644,0.001,641,663,50,100,0.001,1304,3
0.664,0.001,692,712,50,100,0.001,1404,3
0.692,0.001,742,762,50,100,0.001,1504,3
0.72,0.001,798,806,50,100,0.001,1604,3
0.756,0.001,847,857,50,100,0.001,1704,3
0.78,0.001,891,913,50,100,0.001,1804,3
0.798,0.001,941,963,50,100,0.001,1904,3
0.816,0.001,996,1008,50,100,0.001,2004,3
0.546,0.001,48,56,50,100,0.001,104,4
0.538,0.001,95,109,50,100,0.001,204,4
0.546,0.001,150,154,50,100,0.001,304,4
0.57,0.001,205,199,50,100,0.001,404,4
0.57,0.001,247,257,50,100,0.001,504,4
0.582,0.001,292,312,50,100,0.001,604,4
0.588,0.001,342,362,50,100,0.001,704,4
0.598,0.001,391,413,50,100,0.001,804,4
0.624,0.001,440,464,50,100,0.001,904,4
0.624,0.001,485,519,50,100,0.001,1004,4
0.644,0.001,541,563,50,100,0.001,1104,4
0.666,0.001,589,615,50,100,0.001,1204,4
0.68,0.001,640,664,50,100,0.001,1304,4
0.7,0.001,690,714,50,100,0.001,1404,4
0.72,0.001,739,765,50,100,0.001,1504,4
0.746,0.001,789,815,50,100,0.001,1604,4
0.78,0.001,849,855,50,100,0.001,1704,4
0.81,0.001,905,899,50,100,0.001,1804,4
0.824,0.001,962,942,50,100,0.001,1904,4
0.856,0.001,1011,993,50,100,0.001,2004,4
0.5,0.001,50,54,50,100,0.001,104,5
0.504,0.001,107,97,50,100,0.001,204,5
0.506,0.001,155,149,50,100,0.001,304,5
0.528,0.001,211,193,50,100,0.001,404,5
0.532,0.001,258,246,50,100,0.001,504,5
0.546,0.001,306,298,50,100,0.001,604,5
0.546,0.001,349,355,50,100,0.001,704,5
0.56,0.001,401,403,50,100,0.001,804,5
0.574,0.001,444,460,50,100,0.001,904,5
0.598,0.001,501,503,50,100,0.001,1004,5
0.616,0.001,557,547,50,100,0.001,1104,5
0.642,0.001,606,598,50,100,0.001,1204,5
0.662,0.001,657,647,50,100,0.001,1304,5
0.682,0.001,712,692,50,100,0.001,1404,5
0.712,0.001,759,745,50,100,0.001,1504,5
0.738,0.001,814,790,50,100,0.001,1604,5
0.764,0.001,858,846,50,100,0.001,1704,5
0.788,0.001,899,905,50,100,0.001,1804,5
0.806,0.001,946,958,50,100,0.001,1904,5
0.824,0.001,996,1008,50,100,0.001,2004,5
0.54,0.001,54,50,50,100,0.001,104,6
0.54,0.001,107,97,50,100,0.001,204,6
0.556,0.001,158,146,50,100,0.001,304,6
0.566,0.001,212,192,50,100,0.001,404,6
0.576,0.001,263,241,50,100,0.001,504,6
0.594,0.001,312,292,50,100,0.001,604,6
0.614,0.001,361,343,50,100,0.001,704,6
0.62,0.001,402,402,50,100,0.001,804,6
0.634,0.001,458,446,50,100,0.001,904,6
0.654,0.001,505,499,50,100,0.001,1004,6
0.67,0.001,557,547,50,100,0.001,1104,6
0.708,0.001,607,597,50,100,0.001,1204,6
0.732,0.001,655,649,50,100,0.001,1304,6
0.758,0.001,704,700,50,100,0.001,1404,6
0.768,0.001,758,746,50,100,0.001,1504,6
0.792,0.001,813,791,50,100,0.001,1604,6
0.814,0.001,868,836,50,100,0.001,1704,6
0.842,0.001,915,889,50,100,0.001,1804,6
0.864,0.001,964,940,50,100,0.001,1904,6
0.88,0.001,1010,994,50,100,0.001,2004,6
0.498,0.001,57,47,50,100,0.001,104,7
0.514,0.001,102,102,50,100,0.001,204,7
0.518,0.001,150,154,50,100,0.001,304,7
0.532,0.001,193,211,50,100,0.001,404,7
0.528,0.001,244,260,50,100,0.001,504,7
0.54,0.001,294,310,50,100,0.001,604,7
0.554,0.001,351,353,50,100,0.001,704,7
0.572,0.001,395,409,50,100,0.001,804,7
0.586,0.001,443,461,50,100,0.001,904,7
0.61,0.001,489,515,50,100,0.001,1004,7
0.62,0.001,543,561,50,100,0.001,1104,7
0.634,0.001,588,616,50,100,0.001,1204,7
0.678,0.001,638,666,50,100,0.001,1304,7
0.692,0.001,691,713,50,100,0.001,1404,7
0.694,0.001,742,762,50,100,0.001,1504,7
0.716,0.001,788,816,50,100,0.001,1604,7
0.738,0.001,845,859,50,100,0.001,1704,7
0.77,0.001,896,908,50,100,0.001,1804,7
0.788,0.001,952,952,50,100,0.001,1904,7
0.816,0.001,997,1007,50,100,0.001,2004,7
0.494,0.001,54,50,50,100,0.001,104,8
0.508,0.001,105,99,50,100,0.001,204,8
0.506,0.001,153,151,50,100,0.001,304,8
0.516,0.001,196,208,50,100,0.001,404,8
0.534,0.001,245,259,50,100,0.001,504,8
0.556,0.001,299,305,50,100,0.001,604,8
0.562,0.001,344,360,50,100,0.001,704,8
0.564,0.001,393,411,50,100,0.001,804,8
0.566,0.001,446,458,50,100,0.001,904,8
0.594,0.001,492,512,50,100,0.001,1004,8
0.626,0.001,543,561,50,100,0.001,1104,8
0.656,0.001,595,609,50,100,0.001,1204,8
0.682,0.001,642,662,50,100,0.001,1304,8
0.696,0.001,690,714,50,100,0.001,1404,8
0.72,0.001,732,772,50,100,0.001,1504,8
0.748,0.001,788,816,50,100,0.001,1604,8
0.756,0.001,842,862,50,100,0.001,1704,8
0.772,0.001,899,905,50,100,0.001,1804,8
0.784,0.001,947,957,50,100,0.001,1904,8
0.81,0.001,1005,999,50,100,0.001,2004,8
0.49,0.001,55,49,50,100,0.001,104,9
0.49,0.001,104,100,50,100,0.001,204,9
0.49,0.001,157,147,50,100,0.001,304,9
0.504,0.001,218,186,50,100,0.001,404,9
0.506,0.001,265,239,50,100,0.001,504,9
0.502,0.001,319,285,50,100,0.001,604,9
0.52,0.001,359,345,50,100,0.001,704,9
0.542,0.001,407,397,50,100,0.001,804,9
0.542,0.001,456,448,50,100,0.001,904,9
0.572,0.001,497,507,50,100,0.001,1004,9
0.598,0.001,548,556,50,100,0.001,1104,9
0.614,0.001,607,597,50,100,0.001,1204,9
0.634,0.001,656,648,50,100,0.001,1304,9
0.66,0.001,707,697,50,100,0.001,1404,9
0.688,0.001,759,745,50,100,0.001,1504,9
0.734,0.001,809,795,50,100,0.001,1604,9
0.752,0.001,854,850,50,100,0.001,1704,9
0.772,0.001,906,898,50,100,0.001,1804,9
0.808,0.001,952,952,50,100,0.001,1904,9
0.832,0.001,1001,1003,50,100,0.001,2004,9
0.558,0.001,55,49,50,100,0.001,104,10
0.562,0.001,94,110,50,100,0.001,204,10
0.554,0.001,145,159,50,100,0.001,304,10
0.564,0.001,202,202,50,100,0.001,404,10
0.57,0.001,251,253,50,100,0.001,504,10
0.554,0.001,308,296,50,100,0.001,604,10
0.57,0.001,356,348,50,100,0.001,704,10
0.568,0.001,397,407,50,100,0.001,804,10
0.604,0.001,445,459,50,100,0.001,904,10
0.61,0.001,486,518,50,100,0.001,1004,10
0.634,0.001,529,575,50,100,0.001,1104,10
0.652,0.001,575,629,50,100,0.001,1204,10
0.674,0.001,621,683,50,100,0.001,1304,10
0.684,0.001,674,730,50,100,0.001,1404,10
0.704,0.001,726,778,50,100,0.001,1504,10
0.718,0.001,777,827,50,100,0.001,1604,10
0.76,0.001,825,879,50,100,0.001,1704,10
0.79,0.001,878,926,50,100,0.001,1804,10
0.8,0.001,933,971,50,100,0.001,1904,10
0.818,0.001,986,1018,50,100,0.001,2004,10
0.484,0.001,50,54,50,100,0.001,104,11
0.498,0.001,95,109,50,100,0.001,204,11
0.506,0.001,142,162,50,100,0.001,304,11
0.522,0.001,190,214,50,100,0.001,404,11
0.532,0.001,241,263,50,100,0.001,504,11
0.552,0.001,294,310,50,100,0.001,604,11
0.568,0.001,353,351,50,100,0.001,704,11
0.584,0.001,408,396,50,100,0.001,804,11
0.584,0.001,456,448,50,100,0.001,904,11
0.578,0.001,508,496,50,100,0.001,1004,11
0.59,0.001,560,544,50,100,0.001,1104,11
0.606,0.001,610,594,50,100,0.001,1204,11
0.632,0.001,656,648,50,100,0.001,1304,11
0.646,0.001,701,703,50,100,0.001,1404,11
0.672,0.001,749,755,50,100,0.001,1504,11
0.684,0.001,798,806,50,100,0.001,1604,11
0.72,0.001,853,851,50,100,0.001,1704,11
0.766,0.001,897,907,50,100,0.001,1804,11
0.806,0.001,949,955,50,100,0.001,1904,11
0.838,0.001,1001,1003,50,100,0.001,2004,11
0.512,0.001,47,57,50,100,0.001,104,12
0.516,0.001,82,122,50,100,0.001,204,12
0.526,0.001,138,166,50,100,0.001,304,12
0.536,0.001,189,215,50,100,0.001,404,12
0.544,0.001,241,263,50,100,0.001,504,12
0.556,0.001,288,316,50,100,0.001,604,12
0.56,0.001,338,366,50,100,0.001,704,12
0.572,0.001,382,422,50,100,0.001,804,12
0.59,0.001,421,483,50,100,0.001,904,12
0.594,0.001,476,528,50,100,0.001,1004,12
0.612,0.001,517,587,50,100,0.001,1104,12
0.63,0.001,568,636,50,100,0.001,1204,12
0.644,0.001,613,691,50,100,0.001,1304,12
0.666,0.001,669,735,50,100,0.001,1404,12
0.694,0.001,719,785,50,100,0.001,1504,12
0.712,0.001,775,829,50,100,0.001,1604,12
0.732,0.001,828,876,50,100,0.001,1704,12
0.766,0.001,880,924,50,100,0.001,1804,12
0.786,0.001,932,972,50,100,0.001,1904,12
0.804,0.001,987,1017,50,100,0.001,2004,12
0.482,0.001,53,51,50,100,0.001,104,13
0.496,0.001,99,105,50,100,0.001,204,13
0.502,0.001,148,156,50,100,0.001,304,13
0.496,0.001,199,205,50,100,0.001,404,13
0.502,0.001,249,255,50,100,0.001,504,13
0.51,0.001,298,306,50,100,0.001,604,13
0.51,0.001,349,355,50,100,0.001,704,13
0.524,0.001,402,402,50,100,0.001,804,13
0.53,0.001,450,454,50,100,0.001,904,13
0.552,0.001,505,499,50,100,0.001,1004,13
0.574,0.001,552,552,50,100,0.001,1104,13
0.602,0.001,592,612,50,100,0.001,1204,13
0.624,0.001,640,664,50,100,0.001,1304,13
0.634,0.001,693,711,50,100,0.001,1404,13
0.668,0.001,743,761,50,100,0.001,1504,13
0.698,0.001,788,816,50,100,0.001,1604,13
0.728,0.001,839,865,50,100,0.001,1704,13
0.746,0.001,888,916,50,100,0.001,1804,13
0.766,0.001,941,963,50,100,0.001,1904,13
0.8,0.001,996,1008,50,100,0.001,2004,13
0.516,0.001,65,39,50,100,0.001,104,14
0.514,0.001,112,92,50,100,0.001,204,14
0.52,0.001,161,143,50,100,0.001,304,14
0.518,0.001,211,193,50,100,0.001,404,14
0.526,0.001,258,246,50,100,0.001,504,14
0.55,0.001,303,301,50,100,0.001,604,14
0.57,0.001,349,355,50,100,0.001,704,14
0.6,0.001,398,406,50,100,0.001,804,14
0.604,0.001,442,462,50,100,0.001,904,14
0.622,0.001,492,512,50,100,0.001,1004,14
0.656,0.001,547,557,50,100,0.001,1104,14
0.674,0.001,609,595,50,100,0.001,1204,14
0.682,0.001,651,653,50,100,0.001,1304,14
0.7,0.001,696,708,50,100,0.001,1404,14
0.72,0.001,748,756,50,100,0.001,1504,14
0.73,0.001,797,807,50,100,0.001,1604,14
0.748,0.001,853,851,50,100,0.001,1704,14
0.772,0.001,902,902,50,100,0.001,1804,14
0.784,0.001,950,954,50,100,0.001,1904,14
0.816,0.001,997,1007,50,100,0.001,2004,14
0.492,0.001,42,62,50,100,0.001,104,15
0.494,0.001,88,116,50,100,0.001,204,15
0.506,0.001,147,157,50,100,0.001,304,15
0.524,0.001,192,212,50,100,0.001,404,15
0.546,0.001,245,259,50,100,0.001,504,15
0.564,0.001,294,310,50,100,0.001,604,15
0.578,0.001,352,352,50,100,0.001,704,15
0.59,0.001,396,408,50,100,0.001,804,15
0.584,0.001,441,463,50,100,0.001,904,15
0.614,0.001,495,509,50,100,0.001,1004,15
0.638,0.001,552,552,50,100,0.001,1104,15
0.66,0.001,607,597,50,100,0.001,1204,15
0.69,0.001,655,649,50,100,0.001,1304,15
0.72,0.001,704,700,50,100,0.001,1404,15
0.742,0.001,750,754,50,100,0.001,1504,15
0.778,0.001,800,804,50,100,0.001,1604,15
0.796,0.001,851,853,50,100,0.001,1704,15
0.822,0.001,910,894,50,100,0.001,1804,15
0.838,0.001,957,947,50,100,0.001,1904,15
0.866,0.001,1013,991,50,100,0.001,2004,15
0.484,0.001,51,53,50,100,0.001,104,16
0.498,0.001,104,100,50,100,0.001,204,16
0.5,0.001,156,148,50,100,0.001,304,16
0.502,0.001,208,196,50,100,0.001,404,16
0.506,0.001,260,244,50,100,0.001,504,16
0.538,0.001,308,296,50,100,0.001,604,16
0.546,0.001,354,350,50,100,0.001,704,16
0.574,0.001,411,393,50,100,0.001,804,16
0.584,0.001,456,448,50,100,0.001,904,16
0.614,0.001,509,495,50,100,0.001,1004,16
0.656,0.001,561,543,50,100,0.001,1104,16
0.664,0.001,604,600,50,100,0.001,1204,16
0.684,0.001,660,644,50,100,0.001,1304,16
0.712,0.001,714,690,50,100,0.001,1404,16
0.738,0.001,764,740,50,100,0.001,1504,16
0.746,0.001,816,788,50,100,0.001,1604,16
0.77,0.001,876,828,50,100,0.001,1704,16
0.78,0.001,926,878,50,100,0.001,1804,16
0.798,0.001,969,935,50,100,0.001,1904,16
0.822,0.001,1013,991,50,100,0.001,2004,16
0.466,0.001,53,51,50,100,0.001,104,17
0.484,0.001,100,104,50,100,0.001,204,17
0.498,0.001,152,152,50,100,0.001,304,17
0.502,0.001,206,198,50,100,0.001,404,17
0.498,0.001,257,247,50,100,0.001,504,17
0.522,0.001,316,288,50,100,0.001,604,17
0.524,0.001,366,338,50,100,0.001,704,17
0.546,0.001,399,405,50,100,0.001,804,17
0.572,0.001,446,458,50,100,0.001,904,17
0.59,0.001,500,504,50,100,0.001,1004,17
0.6,0.001,546,558,50,100,0.001,1104,17
0.622,0.001,594,610,50,100,0.001,1204,17
0.646,0.001,646,658,50,100,0.001,1304,17
0.662,0.001,704,700,50,100,0.001,1404,17
0.698,0.001,746,758,50,100,0.001,1504,17
0.724,0.001,798,806,50,100,0.001,1604,17
0.746,0.001,854,850,50,100,0.001,1704,17
0.776,0.001,904,900,50,100,0.001,1804,17
0.8,0.001,953,951,50,100,0.001,1904,17
0.816,0.001,1003,1001,50,100,0.001,2004,17
0.456,0.001,38,66,50,100,0.001,104,18
0.462,0.001,83,121,50,100,0.001,204,18
0.466,0.001,139,165,50,100,0.001,304,18
0.476,0.001,183,221,50,100,0.001,404,18
0.486,0.001,239,265,50,100,0.001,504,18
0.51,0.001,283,321,50,100,0.001,604,18
0.514,0.001,328,376,50,100,0.001,704,18
0.538,0.001,374,430,50,100,0.001,804,18
0.554,0.001,428,476,50,100,0.001,904,18
0.568,0.001,479,525,50,100,0.001,1004,18
0.582,0.001,527,577,50,100,0.001,1104,18
0.622,0.001,579,625,50,100,0.001,1204,18
0.624,0.001,631,673,50,100,0.001,1304,18
0.65,0.001,686,718,50,100,0.001,1404,18
0.662,0.001,736,768,50,100,0.001,1504,18
0.702,0.001,784,820,50,100,0.001,1604,18
0.726,0.001,836,868,50,100,0.001,1704,18
0.73,0.001,875,929,50,100,0.001,1804,18
0.738,0.001,930,974,50,100,0.001,1904,18
0.762,0.001,988,1016,50,100,0.001,2004,18
0.468,0.001,53,51,50,100,0.001,104,19
0.494,0.001,112,92,50,100,0.001,204,19
0.49,0.001,158,146,50,100,0.001,304,19
0.494,0.001,211,193,50,100,0.001,404,19
0.508,0.001,260,244,50,100,0.001,504,19
0.53,0.001,300,304,50,100,0.001,604,19
0.534,0.001,354,350,50,100,0.001,704,19
0.556,0.001,404,400,50,100,0.001,804,19
0.584,0.001,450,454,50,100,0.001,904,19
0.602,0.001,497,507,50,100,0.001,1004,19
0.622,0.001,545,559,50,100,0.001,1104,19
0.622,0.001,607,597,50,100,0.001,1204,19
0.644,0.001,661,643,50,100,0.001,1304,19
0.678,0.001,713,691,50,100,0.001,1404,19
0.696,0.001,762,742,50,100,0.001,1504,19
0.73,0.001,805,799,50,100,0.001,1604,19
0.756,0.001,857,847,50,100,0.001,1704,19
0.806,0.001,907,897,50,100,0.001,1804,19
0.814,0.001,951,953,50,100,0.001,1904,19
0.826,0.001,995,1009,50,100,0.001,2004,19
0.54,0.001,46,58,50,100,0.001,104,20
0.54,0.001,93,111,50,100,0.001,204,20
0.538,0.001,140,164,50,100,0.001,304,20
0.558,0.001,186,218,50,100,0.001,404,20
0.558,0.001,231,273,50,100,0.001,504,20
0.56,0.001,289,315,50,100,0.001,604,20
0.556,0.001,344,360,50,100,0.001,704,20
0.558,0.001,390,414,50,100,0.001,804,20
0.566,0.001,446,458,50,100,0.001,904,20
0.588,0.001,493,511,50,100,0.001,1004,20
0.602,0.001,550,554,50,100,0.001,1104,20
0.636,0.001,606,598,50,100,0.001,1204,20
0.66,0.001,652,652,50,100,0.001,1304,20
0.664,0.001,699,705,50,100,0.001,1404,20
0.696,0.001,749,755,50,100,0.001,1504,20
0.736,0.001,804,800,50,100,0.001,1604,20
0.756,0.001,853,851,50,100,0.001,1704,20
0.8,0.001,897,907,50,100,0.001,1804,20
0.818,0.001,953,951,50,100,0.001,1904,20
0.832,0.001,1000,1004,50,100,0.001,2004,20
0.526,0.001,59,45,50,100,0.01,104,1
0.572,0.001,109,95,50,100,0.01,204,1
0.592,0.001,155,149,50,100,0.01,304,1
0.664,0.001,213,191,50,100,0.01,404,1
0.67,0.001,266,238,50,100,0.01,504,1
0.708,0.001,321,283,50,100,0.01,604,1
0.72,0.001,368,336,50,100,0.01,704,1
0.77,0.001,416,388,50,100,0.01,804,1
0.796,0.001,461,443,50,100,0.01,904,1
0.86,0.001,515,489,50,100,0.01,1004,1
0.892,0.001,564,540,50,100,0.01,1104,1
0.93,0.001,615,589,50,100,0.01,1204,1
0.95,0.001,662,642,50,100,0.01,1304,1
0.958,0.001,715,689,50,100,0.01,1404,1
0.972,0.001,760,744,50,100,0.01,1504,1
0.978,0.001,813,791,50,100,0.01,1604,1
0.978,0.001,860,844,50,100,0.01,1704,1
0.98,0.001,916,888,50,100,0.01,1804,1
0.984,0.001,961,943,50,100,0.01,1904,1
0.986,0.001,1005,999,50,100,0.01,2004,1
0.512,0.001,53,51,50,100,0.01,104,2
0.568,0.001,100,104,50,100,0.01,204,2
0.61,0.001,149,155,50,100,0.01,304,2
0.662,0.001,201,203,50,100,0.01,404,2
0.676,0.001,254,250,50,100,0.01,504,2
0.71,0.001,297,307,50,100,0.01,604,2
0.742,0.001,349,355,50,100,0.01,704,2
0.812,0.001,390,414,50,100,0.01,804,2
0.862,0.001,440,464,50,100,0.01,904,2
0.912,0.001,488,516,50,100,0.01,1004,2
0.924,0.001,541,563,50,100,0.01,1104,2
0.952,0.001,576,628,50,100,0.01,1204,2
0.956,0.001,624,680,50,100,0.01,1304,2
0.96,0.001,674,730,50,100,0.01,1404,2
0.962,0.001,725,779,50,100,0.01,1504,2
0.97,0.001,779,825,50,100,0.01,1604,2
0.968,0.001,823,881,50,100,0.01,1704,2
0.972,0.001,878,926,50,100,0.01,1804,2
0.978,0.001,933,971,50,100,0.01,1904,2
0.978,0.001,988,1016,50,100,0.01,2004,2
0.498,0.001,49,55,50,100,0.01,104,3
0.546,0.001,96,108,50,100,0.01,204,3
0.584,0.001,146,158,50,100,0.01,304,3
0.63,0.001,193,211,50,100,0.01,404,3
0.652,0.001,243,261,50,100,0.01,504,3
0.68,0.001,291,313,50,100,0.01,604,3
0.748,0.001,342,362,50,100,0.01,704,3
0.826,0.001,390,414,50,100,0.01,804,3
0.838,0.001,449,455,50,100,0.01,904,3
0.9,0.001,498,506,50,100,0.01,1004,3
0.91,0.001,549,555,50,100,0.01,1104,3
0.938,0.001,597,607,50,100,0.01,1204,3
0.926,0.001,644,660,50,100,0.01,1304,3
0.95,0.001,693,711,50,100,0.01,1404,3
0.946,0.001,729,775,50,100,0.01,1504,3
0.96,0.001,783,821,50,100,0.01,1604,3
0.958,0.001,833,871,50,100,0.01,1704,3
0.964,0.001,879,925,50,100,0.01,1804,3
0.962,0.001,927,977,50,100,0.01,1904,3
0.966,0.001,982,1022,50,100,0.01,2004,3
0.556,0.001,50,54,50,100,0.01,104,4
0.61,0.001,101,103,50,100,0.01,204,4
0.628,0.001,154,150,50,100,0.01,304,4
0.652,0.001,199,205,50,100,0.01,404,4
0.68,0.001,249,255,50,100,0.01,504,4
0.722,0.001,289,315,50,100,0.01,604,4
0.74,0.001,338,366,50,100,0.01,704,4
0.786,0.001,387,417,50,100,0.01,804,4
0.852,0.001,442,462,50,100,0.01,904,4
0.894,0.001,502,502,50,100,0.01,1004,4
0.914,0.001,549,555,50,100,0.01,1104,4
0.942,0.001,602,602,50,100,0.01,1204,4
0.958,0.001,652,652,50,100,0.01,1304,4
0.962,0.001,698,706,50,100,0.01,1404,4
0.964,0.001,755,749,50,100,0.01,1504,4
0.966,0.001,805,799,50,100,0.01,1604,4
0.968,0.001,853,851,50,100,0.01,1704,4
0.97,0.001,902,902,50,100,0.01,1804,4
0.97,0.001,950,954,50,100,0.01,1904,4
0.972,0.001,1003,1001,50,100,0.01,2004,4
0.514,0.001,48,56,50,100,0.01,104,5
0.528,0.001,104,100,50,100,0.01,204,5
0.54,0.001,145,159,50,100,0.01,304,5
0.59,0.001,196,208,50,100,0.01,404,5
0.63,0.001,240,264,50,100,0.01,504,5
0.688,0.001,288,316,50,100,0.01,604,5
0.72,0.001,337,367,50,100,0.01,704,5
0.728,0.001,394,410,50,100,0.01,804,5
0.802,0.001,441,463,50,100,0.01,904,5
0.858,0.001,497,507,50,100,0.01,1004,5
0.898,0.001,547,557,50,100,0.01,1104,5
0.92,0.001,597,607,50,100,0.01,1204,5
0.932,0.001,651,653,50,100,0.01,1304,5
0.944,0.001,701,703,50,100,0.01,1404,5
0.946,0.001,741,763,50,100,0.01,1504,5
0.956,0.001,793,811,50,100,0.01,1604,5
0.948,0.001,838,866,50,100,0.01,1704,5
0.946,0.001,885,919,50,100,0.01,1804,5
0.958,0.001,937,967,50,100,0.01,1904,5
0.962,0.001,998,1006,50,100,0.01,2004,5
0.556,0.001,50,54,50,100,0.01,104,6
0.606,0.001,105,99,50,100,0.01,204,6
0.614,0.001,150,154,50,100,0.01,304,6
0.646,0.001,202,202,50,100,0.01,404,6
0.698,0.001,262,242,50,100,0.01,504,6
0.74,0.001,311,293,50,100,0.01,604,6
0.768,0.001,370,334,50,100,0.01,704,6
0.84,0.001,413,391,50,100,0.01,804,6
0.882,0.001,466,438,50,100,0.01,904,6
0.912,0.001,508,496,50,100,0.01,1004,6
0.926,0.001,558,546,50,100,0.01,1104,6
0.952,0.001,608,596,50,100,0.01,1204,6
0.95,0.001,656,648,50,100,0.01,1304,6
0.962,0.001,703,701,50,100,0.01,1404,6
0.976,0.001,751,753,50,100,0.01,1504,6
0.974,0.001,807,797,50,100,0.01,1604,6
0.974,0.001,854,850,50,100,0.01,1704,6
0.978,0.001,900,904,50,100,0.01,1804,6
0.978,0.001,950,954,50,100,0.01,1904,6
0.978,0.001,1001,1003,50,100,0.01,2004,6
0.546,0.001,50,54,50,100,0.01,104,7
0.568,0.001,99,105,50,100,0.01,204,7
0.588,0.001,140,164,50,100,0.01,304,7
0.614,0.001,187,217,50,100,0.01,404,7
0.652,0.001,235,269,50,100,0.01,504,7
0.714,0.001,286,318,50,100,0.01,604,7
0.754,0.001,339,365,50,100,0.01,704,7
0.842,0.001,378,426,50,100,0.01,804,7
0.868,0.001,428,476,50,100,0.01,904,7
0.908,0.001,481,523,50,100,0.01,1004,7
0.93,0.001,531,573,50,100,0.01,1104,7
0.936,0.001,584,620,50,100,0.01,1204,7
0.936,0.001,623,681,50,100,0.01,1304,7
0.946,0.001,683,721,50,100,0.01,1404,7
0.946,0.001,722,782,50,100,0.01,1504,7
0.948,0.001,776,828,50,100,0.01,1604,7
0.956,0.001,831,873,50,100,0.01,1704,7
0.96,0.001,888,916,50,100,0.01,1804,7
0.962,0.001,939,965,50,100,0.01,1904,7
0.966,0.001,996,1008,50,100,0.01,2004,7
0.578,0.001,55,49,50,100,0.01,104,8
0.56,0.001,102,102,50,100,0.01,204,8
0.546,0.001,155,149,50,100,0.01,304,8
0.548,0.001,195,209,50,100,0.01,404,8
0.61,0.001,245,259,50,100,0.01,504,8
0.676,0.001,305,299,50,100,0.01,604,8
0.706,0.001,352,352,50,100,0.01,704,8
0.784,0.001,402,402,50,100,0.01,804,8
0.852,0.001,451,453,50,100,0.01,904,8
0.9,0.001,489,515,50,100,0.01,1004,8
0.926,0.001,539,565,50,100,0.01,1104,8
0.938,0.001,589,615,50,100,0.01,1204,8
0.942,0.001,631,673,50,100,0.01,1304,8
0.956,0.001,684,720,50,100,0.01,1404,8
0.956,0.001,734,770,50,100,0.01,1504,8
0.96,0.001,783,821,50,100,0.01,1604,8
0.96,0.001,837,867,50,100,0.01,1704,8
0.964,0.001,890,914,50,100,0.01,1804,8
0.972,0.001,937,967,50,100,0.01,1904,8
0.97,0.001,986,1018,50,100,0.01,2004,8
0.486,0.001,59,45,50,100,0.01,104,9
0.55,0.001,101,103,50,100,0.01,204,9
0.562,0.001,151,153,50,100,0.01,304,9
0.59,0.001,198,206,50,100,0.01,404,9
0.616,0.001,258,246,50,100,0.01,504,9
0.662,0.001,295,309,50,100,0.01,604,9
0.672,0.001,355,349,50,100,0.01,704,9
0.716,0.001,403,401,50,100,0.01,804,9
0.752,0.001,450,454,50,100,0.01,904,9
0.822,0.001,501,503,50,100,0.01,1004,9
0.888,0.001,550,554,50,100,0.01,1104,9
0.908,0.001,599,605,50,100,0.01,1204,9
0.928,0.001,654,650,50,100,0.01,1304,9
0.958,0.001,715,689,50,100,0.01,1404,9
0.97,0.001,758,746,50,100,0.01,1504,9
0.966,0.001,803,801,50,100,0.01,1604,9
0.97,0.001,851,853,50,100,0.01,1704,9
0.976,0.001,901,903,50,100,0.01,1804,9
0.972,0.001,946,958,50,100,0.01,1904,9
0.974,0.001,990,1014,50,100,0.01,2004,9
0.5,0.001,51,53,50,100,0.01,104,10
0.524,0.001,97,107,50,100,0.01,204,10
0.55,0.001,144,160,50,100,0.01,304,10
0.618,0.001,197,207,50,100,0.01,404,10
0.626,0.001,251,253,50,100,0.01,504,10
0.664,0.001,303,301,50,100,0.01,604,10
0.708,0.001,352,352,50,100,0.01,704,10
0.764,0.001,403,401,50,100,0.01,804,10
0.798,0.001,451,453,50,100,0.01,904,10
0.878,0.001,502,502,50,100,0.01,1004,10
0.89,0.001,548,556,50,100,0.01,1104,10
0.942,0.001,597,607,50,100,0.01,1204,10
0.93,0.001,651,653,50,100,0.01,1304,10
0.962,0.001,709,695,50,100,0.01,1404,10
0.958,0.001,762,742,50,100,0.01,1504,10
0.964,0.001,813,791,50,100,0.01,1604,10
0.968,0.001,865,839,50,100,0.01,1704,10
0.966,0.001,909,895,50,100,0.01,1804,10
0.972,0.001,962,942,50,100,0.01,1904,10
0.978,0.001,1013,991,50,100,0.01,2004,10
0.522,0.001,54,50,50,100,0.01,104,11
0.562,0.001,103,101,50,100,0.01,204,11
0.584,0.001,144,160,50,100,0.01,304,11
0.594,0.001,195,209,50,100,0.01,404,11
0.604,0.001,246,258,50,100,0.01,504,11
0.68,0.001,306,298,50,100,0.01,604,11
0.722,0.001,357,347,50,100,0.01,704,11
0.786,0.001,402,402,50,100,0.01,804,11
0.836,0.001,448,456,50,100,0.01,904,11
0.884,0.001,496,508,50,100,0.01,1004,11
0.926,0.001,549,555,50,100,0.01,1104,11
0.932,0.001,603,601,50,100,0.01,1204,11
0.942,0.001,643,661,50,100,0.01,1304,11
0.944,0.001,690,714,50,100,0.01,1404,11
0.954,0.001,739,765,50,100,0.01,1504,11
0.96,0.001,789,815,50,100,0.01,1604,11
0.962,0.001,835,869,50,100,0.01,1704,11
0.96,0.001,885,919,50,100,0.01,1804,11
0.972,0.001,937,967,50,100,0.01,1904,11
0.968,0.001,985,1019,50,100,0.01,2004,11
0.5,0.001,38,66,50,100,0.01,104,12
0.538,0.001,89,115,50,100,0.01,204,12
0.562,0.001,132,172,50,100,0.01,304,12
0.594,0.001,186,218,50,100,0.01,404,12
0.626,0.001,239,265,50,100,0.01,504,12
0.632,0.001,284,320,50,100,0.01,604,12
0.676,0.001,325,379,50,100,0.01,704,12
0.716,0.001,372,432,50,100,0.01,804,12
0.796,0.001,433,471,50,100,0.01,904,12
0.834,0.001,485,519,50,100,0.01,1004,12
0.872,0.001,535,569,50,100,0.01,1104,12
0.906,0.001,580,624,50,100,0.01,1204,12
0.914,0.001,633,671,50,100,0.01,1304,12
0.93,0.001,691,713,50,100,0.01,1404,12
0.932,0.001,744,760,50,100,0.01,1504,12
0.94,0.001,788,816,50,100,0.01,1604,12
0.94,0.001,846,858,50,100,0.01,1704,12
0.952,0.001,898,906,50,100,0.01,1804,12
0.956,0.001,953,951,50,100,0.01,1904,12
0.948,0.001,1000,1004,50,100,0.01,2004,12
0.526,0.001,45,59,50,100,0.01,104,13
0.542,0.001,102,102,50,100,0.01,204,13
0.572,0.001,144,160,50,100,0.01,304,13
0.626,0.001,196,208,50,100,0.01,404,13
0.664,0.001,243,261,50,100,0.01,504,13
0.722,0.001,297,307,50,100,0.01,604,13
0.784,0.001,349,355,50,100,0.01,704,13
0.828,0.001,392,412,50,100,0.01,804,13
0.858,0.001,450,454,50,100,0.01,904,13
0.89,0.001,494,510,50,100,0.01,1004,13
0.912,0.001,547,557,50,100,0.01,1104,13
0.932,0.001,593,611,50,100,0.01,1204,13
0.962,0.001,648,656,50,100,0.01,1304,13
0.97,0.001,693,711,50,100,0.01,1404,13
0.972,0.001,742,762,50,100,0.01,1504,13
0.976,0.001,794,810,50,100,0.01,1604,13
0.978,0.001,846,858,50,100,0.01,1704,13
0.984,0.001,897,907,50,100,0.01,1804,13
0.986,0.001,953,951,50,100,0.01,1904,13
0.986,0.001,1003,1001,50,100,0.01,2004,13
0.552,0.001,52,52,50,100,0.01,104,14
0.614,0.001,96,108,50,100,0.01,204,14
0.602,0.001,141,163,50,100,0.01,304,14
0.63,0.001,195,209,50,100,0.01,404,14
0.656,0.001,264,240,50,100,0.01,504,14
0.682,0.001,310,294,50,100,0.01,604,14
0.704,0.001,352,352,50,100,0.01,704,14
0.762,0.001,401,403,50,100,0.01,804,14
0.814,0.001,451,453,50,100,0.01,904,14
0.866,0.001,497,507,50,100,0.01,1004,14
0.896,0.001,546,558,50,100,0.01,1104,14
0.932,0.001,598,606,50,100,0.01,1204,14
0.938,0.001,656,648,50,100,0.01,1304,14
0.948,0.001,704,700,50,100,0.01,1404,14
0.956,0.001,756,748,50,100,0.01,1504,14
0.952,0.001,804,800,50,100,0.01,1604,14
0.952,0.001,857,847,50,100,0.01,1704,14
0.96,0.001,905,899,50,100,0.01,1804,14
0.964,0.001,950,954,50,100,0.01,1904,14
0.968,0.001,1006,998,50,100,0.01,2004,14
0.518,0.001,57,47,50,100,0.01,104,15
0.556,0.001,104,100,50,100,0.01,204,15
0.558,0.001,156,148,50,100,0.01,304,15
0.588,0.001,204,200,50,100,0.01,404,15
0.614,0.001,253,251,50,100,0.01,504,15
0.668,0.001,295,309,50,100,0.01,604,15
0.724,0.001,349,355,50,100,0.01,704,15
0.806,0.001,402,402,50,100,0.01,804,15
0.84,0.001,449,455,50,100,0.01,904,15
0.904,0.001,502,502,50,100,0.01,1004,15
0.94,0.001,555,549,50,100,0.01,1104,15
0.942,0.001,605,599,50,100,0.01,1204,15
0.938,0.001,652,652,50,100,0.01,1304,15
0.954,0.001,700,704,50,100,0.01,1404,15
0.958,0.001,751,753,50,100,0.01,1504,15
0.958,0.001,801,803,50,100,0.01,1604,15
0.958,0.001,856,848,50,100,0.01,1704,15
0.966,0.001,899,905,50,100,0.01,1804,15
0.97,0.001,940,964,50,100,0.01,1904,15
0.97,0.001,999,1005,50,100,0.01,2004,15
0.51,0.001,47,57,50,100,0.01,104,16
0.57,0.001,100,104,50,100,0.01,204,16
0.584,0.001,147,157,50,100,0.01,304,16
0.63,0.001,210,194,50,100,0.01,404,16
0.672,0.001,257,247,50,100,0.01,504,16
0.724,0.001,301,303,50,100,0.01,604,16
0.764,0.001,351,353,50,100,0.01,704,16
0.832,0.001,403,401,50,100,0.01,804,16
0.854,0.001,456,448,50,100,0.01,904,16
0.932,0.001,502,502,50,100,0.01,1004,16
0.954,0.001,545,559,50,100,0.01,1104,16
0.94,0.001,598,606,50,100,0.01,1204,16
0.944,0.001,656,648,50,100,0.01,1304,16
0.944,0.001,713,691,50,100,0.01,1404,16
0.944,0.001,760,744,50,100,0.01,1504,16
0.952,0.001,807,797,50,100,0.01,1604,16
0.956,0.001,860,844,50,100,0.01,1704,16
0.954,0.001,912,892,50,100,0.01,1804,16
0.962,0.001,964,940,50,100,0.01,1904,16
0.964,0.001,1008,996,50,100,0.01,2004,16
0.52,0.001,56,48,50,100,0.01,104,17
0.53,0.001,109,95,50,100,0.01,204,17
0.534,0.001,167,137,50,100,0.01,304,17
0.582,0.001,217,187,50,100,0.01,404,17
0.608,0.001,270,234,50,100,0.01,504,17
0.656,0.001,327,277,50,100,0.01,604,17
0.716,0.001,380,324,50,100,0.01,704,17
0.746,0.001,423,381,50,100,0.01,804,17
0.828,0.001,467,437,50,100,0.01,904,17
0.868,0.001,519,485,50,100,0.01,1004,17
0.894,0.001,570,534,50,100,0.01,1104,17
0.896,0.001,624,580,50,100,0.01,1204,17
0.926,0.001,678,626,50,100,0.01,1304,17
0.944,0.001,717,687,50,100,0.01,1404,17
0.962,0.001,768,736,50,100,0.01,1504,17
0.97,0.001,816,788,50,100,0.01,1604,17
0.974,0.001,866,838,50,100,0.01,1704,17
0.976,0.001,915,889,50,100,0.01,1804,17
0.984,0.001,963,941,50,100,0.01,1904,17
0.986,0.001,1008,996,50,100,0.01,2004,17
0.548,0.001,53,51,50,100,0.01,104,18
0.598,0.001,108,96,50,100,0.01,204,18
0.64,0.001,160,144,50,100,0.01,304,18
0.642,0.001,212,192,50,100,0.01,404,18
0.658,0.001,260,244,50,100,0.01,504,18
0.698,0.001,305,299,50,100,0.01,604,18
0.76,0.001,363,341,50,100,0.01,704,18
0.818,0.001,415,389,50,100,0.01,804,18
0.85,0.001,466,438,50,100,0.01,904,18
0.898,0.001,516,488,50,100,0.01,1004,18
0.924,0.001,571,533,50,100,0.01,1104,18
0.958,0.001,622,582,50,100,0.01,1204,18
0.968,0.001,665,639,50,100,0.01,1304,18
0.974,0.001,711,693,50,100,0.01,1404,18
0.974,0.001,755,749,50,100,0.01,1504,18
0.982,0.001,811,793,50,100,0.01,1604,18
0.984,0.001,862,842,50,100,0.01,1704,18
0.984,0.001,916,888,50,100,0.01,1804,18
0.984,0.001,963,941,50,100,0.01,1904,18
0.986,0.001,1014,990,50,100,0.01,2004,18
0.528,0.001,57,47,50,100,0.01,104,19
0.566,0.001,116,88,50,100,0.01,204,19
0.58,0.001,161,143,50,100,0.01,304,19
0.62,0.001,219,185,50,100,0.01,404,19
0.66,0.001,267,237,50,100,0.01,504,19
0.726,0.001,319,285,50,100,0.01,604,19
0.778,0.001,367,337,50,100,0.01,704,19
0.832,0.001,422,382,50,100,0.01,804,19
0.868,0.001,470,434,50,100,0.01,904,19
0.894,0.001,521,483,50,100,0.01,1004,19
0.918,0.001,569,535,50,100,0.01,1104,19
0.936,0.001,621,583,50,100,0.01,1204,19
0.944,0.001,666,638,50,100,0.01,1304,19
0.954,0.001,714,690,50,100,0.01,1404,19
0.95,0.001,760,744,50,100,0.01,1504,19
0.948,0.001,807,797,50,100,0.01,1604,19
0.956,0.001,850,854,50,100,0.01,1704,19
0.96,0.001,900,904,50,100,0.01,1804,19
0.966,0.001,947,957,50,100,0.01,1904,19
0.964,0.001,996,1008,50,100,0.01,2004,19
0.504,0.001,61,43,50,100,0.01,104,20
0.554,0.001,108,96,50,100,0.01,204,20
0.544,0.001,169,135,50,100,0.01,304,20
0.598,0.001,211,193,50,100,0.01,404,20
0.636,0.001,259,245,50,100,0.01,504,20
0.666,0.001,309,295,50,100,0.01,604,20
0.694,0.001,367,337,50,100,0.01,704,20
0.758,0.001,415,389,50,100,0.01,804,20
0.762,0.001,469,435,50,100,0.01,904,20
0.812,0.001,516,488,50,100,0.01,1004,20
0.882,0.001,574,530,50,100,0.01,1104,20
0.918,0.001,616,588,50,100,0.01,1204,20
0.936,0.001,667,637,50,100,0.01,1304,20
0.948,0.001,717,687,50,100,0.01,1404,20
0.946,0.001,767,737,50,100,0.01,1504,20
0.946,0.001,812,792,50,100,0.01,1604,20
0.962,0.001,859,845,50,100,0.01,1704,20
0.964,0.001,916,888,50,100,0.01,1804,20
0.966,0.001,964,940,50,100,0.01,1904,20
0.972,0.001,1014,990,50,100,0.01,2004,20
0.518,1e-05,51,53,100,2,0.0001,104,1
0.518,1e-05,99,105,100,2,0.0001,204,1
0.518,1e-05,156,148,100,2,0.0001,304,1
0.518,1e-05,197,207,100,2,0.0001,404,1
0.518,1e-05,253,251,100,2,0.0001,504,1
0.518,1e-05,295,309,100,2,0.0001,604,1
0.518,1e-05,349,355,100,2,0.0001,704,1
0.518,1e-05,410,394,100,2,0.0001,804,1
0.518,1e-05,463,441,100,2,0.0001,904,1
0.518,1e-05,512,492,100,2,0.0001,1004,1
0.518,1e-05,562,542,100,2,0.0001,1104,1
0.518,1e-05,611,593,100,2,0.0001,1204,1
0.518,1e-05,658,646,100,2,0.0001,1304,1
0.518,1e-05,713,691,100,2,0.0001,1404,1
0.518,1e-05,763,741,100,2,0.0001,1504,1
0.518,1e-05,818,786,100,2,0.0001,1604,1
0.518,1e-05,864,840,100,2,0.0001,1704,1
0.518,1e-05,908,896,100,2,0.0001,1804,1
0.518,1e-05,961,943,100,2,0.0001,1904,1
0.518,1e-05,1011,993,100,2,0.0001,2004,1
0.488,1e-05,50,54,100,2,0.0001,104,2
0.488,1e-05,103,101,100,2,0.0001,204,2
0.488,1e-05,155,149,100,2,0.0001,304,2
0.488,1e-05,206,198,100,2,0.0001,404,2
0.488,1e-05,253,251,100,2,0.0001,504,2
0.488,1e-05,304,300,100,2,0.0001,604,2
0.488,1e-05,355,349,100,2,0.0001,704,2
0.488,1e-05,407,397,100,2,0.0001,804,2
0.488,1e-05,469,435,100,2,0.0001,904,2
0.488,1e-05,514,490,100,2,0.0001,1004,2
0.488,1e-05,563,541,100,2,0.0001,1104,2
0.488,1e-05,605,599,100,2,0.0001,1204,2
0.488,1e-05,648,656,100,2,0.0001,1304,2
0.488,1e-05,693,711,100,2,0.0001,1404,2
0.488,1e-05,746,758,100,2,0.0001,1504,2
0.488,1e-05,798,806,100,2,0.0001,1604,2
0.488,1e-05,850,854,100,2,0.0001,1704,2
0.488,1e-05,901,903,100,2,0.0001,1804,2
0.488,1e-05,947,957,100,2,0.0001,1904,2
0.488,1e-05,996,1008,100,2,0.0001,2004,2
0.526,1e-05,54,50,100,2,0.0001,104,3
0.526,1e-05,102,102,100,2,0.0001,204,3
0.526,1e-05,145,159,100,2,0.0001,304,3
0.526,1e-05,194,210,100,2,0.0001,404,3
0.526,1e-05,246,258,100,2,0.0001,504,3
0.526,1e-05,301,303,100,2,0.0001,604,3
0.526,1e-05,348,356,100,2,0.0001,704,3
0.526,1e-05,400,404,100,2,0.0001,804,3
0.526,1e-05,448,456,100,2,0.0001,904,3
0.526,1e-05,502,502,100,2,0.0001,1004,3
0.526,1e-05,541,563,100,2,0.0001,1104,3
0.526,1e-05,591,613,100,2,0.0001,1204,3
0.526,1e-05,646,658,100,2,0.0001,1304,3
0.526,1e-05,689,715,100,2,0.0001,1404,3
0.526,1e-05,731,773,100,2,0.0001,1504,3
0.526,1e-05,784,820,100,2,0.0001,1604,3
0.526,1e-05,833,871,100,2,0.0001,1704,3
0.526,1e-05,887,917,100,2,0.0001,1804,3
0.526,1e-05,938,966,100,2,0.0001,1904,3
0.526,1e-05,989,1015,100,2,0.0001,2004,3
0.49,1e-05,52,52,100,2,0.0001,104,4
0.49,1e-05,102,102,100,2,0.0001,204,4
0.49,1e-05,152,152,100,2,0.0001,304,4
0.49,1e-05,206,198,100,2,0.0001,404,4
0.49,1e-05,255,249,100,2,0.0001,504,4
0.49,1e-05,308,296,100,2,0.0001,604,4
0.49,1e-05,358,346,100,2,0.0001,704,4
0.49,1e-05,406,398,100,2,0.0001,804,4
0.49,1e-05,455,449,100,2,0.0001,904,4
0.49,1e-05,507,497,100,2,0.0001,1004,4
0.49,1e-05,556,548,100,2,0.0001,1104,4
0.49,1e-05,608,596,100,2,0.0001,1204,4
0.49,1e-05,651,653,100,2,0.0001,1304,4
0.49,1e-05,698,706,100,2,0.0001,1404,4
0.49,1e-05,745,759,100,2,0.0001,1504,4
0.49,1e-05,799,805,100,2,0.0001,1604,4
0.49,1e-05,851,853,100,2,0.0001,1704,4
0.49,1e-05,898,906,100,2,0.0001,1804,4
0.49,1e-05,953,951,100,2,0.0001,1904,4
0.49,1e-05,1007,997,100,2,0.0001,2004,4
0.51,1e-05,48,56,100,2,0.0001,104,5
0.512,1e-05,99,105,100,2,0.0001,204,5
0.512,1e-05,150,154,100,2,0.0001,304,5
0.512,1e-05,194,210,100,2,0.0001,404,5
0.512,1e-05,241,263,100,2,0.0001,504,5
0.51,1e-05,293,311,100,2,0.0001,604,5
0.512,1e-05,341,363,100,2,0.0001,704,5
0.512,1e-05,392,412,100,2,0.0001,804,5
0.512,1e-05,446,458,100,2,0.0001,904,5
0.51,1e-05,503,501,100,2,0.0001,1004,5
0.51,1e-05,555,549,100,2,0.0001,1104,5
0.51,1e-05,604,600,100,2,0.0001,1204,5
0.512,1e-05,658,646,100,2,0.0001,1304,5
0.512,1e-05,710,694,100,2,0.0001,1404,5
0.512,1e-05,763,741,100,2,0.0001,1504,5
0.512,1e-05,808,796,100,2,0.0001,1604,5
0.51,1e-05,858,846,100,2,0.0001,1704,5
0.51,1e-05,910,894,100,2,0.0001,1804,5
0.51,1e-05,952,952,100,2,0.0001,1904,5
0.51,1e-05,1005,999,100,2,0.0001,2004,5
0.522,1e-05,49,55,100,2,0.0001,104,6
0.522,1e-05,101,103,100,2,0.0001,204,6
0.522,1e-05,152,152,100,2,0.0001,304,6
0.522,1e-05,205,199,100,2,0.0001,404,6
0.522,1e-05,247,257,100,2,0.0001,504,6
0.52,1e-05,305,299,100,2,0.0001,604,6
0.52,1e-05,356,348,100,2,0.0001,704,6
0.52,1e-05,404,400,100,2,0.0001,804,6
0.518,1e-05,454,450,100,2,0.0001,904,6
0.52,1e-05,499,505,100,2,0.0001,1004,6
0.52,1e-05,550,554,100,2,0.0001,1104,6
0.52,1e-05,607,597,100,2,0.0001,1204,6
0.522,1e-05,660,644,100,2,0.0001,1304,6
0.522,1e-05,711,693,100,2,0.0001,1404,6
0.522,1e-05,755,749,100,2,0.0001,1504,6
0.52,1e-05,802,802,100,2,0.0001,1604,6
0.524,1e-05,855,849,100,2,0.0001,1704,6
0.526,1e-05,910,894,100,2,0.0001,1804,6
0.522,1e-05,963,941,100,2,0.0001,1904,6
0.526,1e-05,1014,990,100,2,0.0001,2004,6
0.51,1e-05,52,52,100,2,0.0001,104,7
0.51,1e-05,93,111,100,2,0.0001,204,7
0.512,1e-05,140,164,100,2,0.0001,304,7
0.51,1e-05,188,216,100,2,0.0001,404,7
0.51,1e-05,243,261,100,2,0.0001,504,7
0.51,1e-05,294,310,100,2,0.0001,604,7
0.51,1e-05,350,354,100,2,0.0001,704,7
0.51,1e-05,391,413,100,2,0.0001,804,7
0.51,1e-05,444,460,100,2,0.0001,904,7
0.512,1e-05,491,513,100,2,0.0001,1004,7
0.512,1e-05,542,562,100,2,0.0001,1104,7
0.512,1e-05,606,598,100,2,0.0001,1204,7
0.51,1e-05,653,651,100,2,0.0001,1304,7
0.51,1e-05,700,704,100,2,0.0001,1404,7
0.516,1e-05,756,748,100,2,0.0001,1504,7
0.516,1e-05,807,797,100,2,0.0001,1604,7
0.514,1e-05,853,851,100,2,0.0001,1704,7
0.514,1e-05,909,895,100,2,0.0001,1804,7
0.516,1e-05,958,946,100,2,0.0001,1904,7
0.514,1e-05,1008,996,100,2,0.0001,2004,7
0.482,1e-05,47,57,100,2,0.0001,104,8
0.482,1e-05,98,106,100,2,0.0001,204,8
0.484,1e-05,140,164,100,2,0.0001,304,8
0.484,1e-05,191,213,100,2,0.0001,404,8
0.484,1e-05,240,264,100,2,0.0001,504,8
0.484,1e-05,285,319,100,2,0.0001,604,8
0.484,1e-05,338,366,100,2,0.0001,704,8
0.484,1e-05,389,415,100,2,0.0001,804,8
0.484,1e-05,444,460,100,2,0.0001,904,8
0.484,1e-05,492,512,100,2,0.0001,1004,8
0.484,1e-05,541,563,100,2,0.0001,1104,8
0.484,1e-05,596,608,100,2,0.0001,1204,8
0.484,1e-05,644,660,100,2,0.0001,1304,8
0.484,1e-05,689,715,100,2,0.0001,1404,8
0.484,1e-05,741,763,100,2,0.0001,1504,8
0.484,1e-05,790,814,100,2,0.0001,1604,8
0.484,1e-05,844,860,100,2,0.0001,1704,8
0.484,1e-05,895,909,100,2,0.0001,1804,8
0.484,1e-05,940,964,100,2,0.0001,1904,8
0.484,1e-05,994,1010,100,2,0.0001,2004,8
0.49,1e-05,55,49,100,2,0.0001,104,9
0.49,1e-05,110,94,100,2,0.0001,204,9
0.49,1e-05,158,146,100,2,0.0001,304,9
0.49,1e-05,213,191,100,2,0.0001,404,9
0.49,1e-05,259,245,100,2,0.0001,504,9
0.49,1e-05,306,298,100,2,0.0001,604,9
0.49,1e-05,357,347,100,2,0.0001,704,9
0.49,1e-05,401,403,100,2,0.0001,804,9
0.49,1e-05,455,449,100,2,0.0001,904,9
0.49,1e-05,500,504,100,2,0.0001,1004,9
0.49,1e-05,550,554,100,2,0.0001,1104,9
0.49,1e-05,599,605,100,2,0.0001,1204,9
0.49,1e-05,644,660,100,2,0.0001,1304,9
0.49,1e-05,691,713,100,2,0.0001,1404,9
0.49,1e-05,742,762,100,2,0.0001,1504,9
0.49,1e-05,795,809,100,2,0.0001,1604,9
0.49,1e-05,843,861,100,2,0.0001,1704,9
0.49,1e-05,891,913,100,2,0.0001,1804,9
0.49,1e-05,942,962,100,2,0.0001,1904,9
0.49,1e-05,997,1007,100,2,0.0001,2004,9
0.512,1e-05,44,60,100,2,0.0001,104,10
0.512,1e-05,93,111,100,2,0.0001,204,10
0.512,1e-05,144,160,100,2,0.0001,304,10
0.512,1e-05,189,215,100,2,0.0001,404,10
0.512,1e-05,244,260,100,2,0.0001,504,10
0.512,1e-05,295,309,100,2,0.0001,604,10
0.512,1e-05,344,360,100,2,0.0001,704,10
0.512,1e-05,399,405,100,2,0.0001,804,10
0.512,1e-05,449,455,100,2,0.0001,904,10
0.512,1e-05,503,501,100,2,0.0001,1004,10
0.512,1e-05,550,554,100,2,0.0001,1104,10
0.512,1e-05,590,614,100,2,0.0001,1204,10
0.512,1e-05,639,665,100,2,0.0001,1304,10
0.512,1e-05,691,713,100,2,0.0001,1404,10
0.512,1e-05,751,753,100,2,0.0001,1504,10
0.512,1e-05,802,802,100,2,0.0001,1604,10
0.512,1e-05,852,852,100,2,0.0001,1704,10
0.512,1e-05,902,902,100,2,0.0001,1804,10
0.512,1e-05,952,952,100,2,0.0001,1904,10
0.512,1e-05,996,1008,100,2,0.0001,2004,10
0.504,1e-05,50,54,100,2,0.0001,104,11
0.504,1e-05,104,100,100,2,0.0001,204,11
0.504,1e-05,150,154,100,2,0.0001,304,11
0.504,1e-05,195,209,100,2,0.0001,404,11
0.504,1e-05,255,249,100,2,0.0001,504,11
0.502,1e-05,303,301,100,2,0.0001,604,11
0.504,1e-05,349,355,100,2,0.0001,704,11
0.504,1e-05,407,397,100,2,0.0001,804,11
0.502,1e-05,457,447,100,2,0.0001,904,11
0.498,1e-05,498,506,100,2,0.0001,1004,11
0.498,1e-05,551,553,100,2,0.0001,1104,11
0.502,1e-05,613,591,100,2,0.0001,1204,11
0.5,1e-05,667,637,100,2,0.0001,1304,11
0.502,1e-05,716,688,100,2,0.0001,1404,11
0.5,1e-05,767,737,100,2,0.0001,1504,11
0.5,1e-05,824,780,100,2,0.0001,1604,11
0.5,1e-05,873,831,100,2,0.0001,1704,11
0.502,1e-05,918,886,100,2,0.0001,1804,11
0.5,1e-05,959,945,100,2,0.0001,1904,11
0.5,1e-05,1011,993,100,2,0.0001,2004,11
0.512,1e-05,52,52,100,2,0.0001,104,12
0.512,1e-05,96,108,100,2,0.0001,204,12
0.512,1e-05,133,171,100,2,0.0001,304,12
0.512,1e-05,179,225,100,2,0.0001,404,12
0.512,1e-05,224,280,100,2,0.0001,504,12
0.512,1e-05,262,342,100,2,0.0001,604,12
0.512,1e-05,322,382,100,2,0.0001,704,12
0.512,1e-05,369,435,100,2,0.0001,804,12
0.512,1e-05,427,477,100,2,0.0001,904,12
0.51,1e-05,473,531,100,2,0.0001,1004,12
0.514,1e-05,526,578,100,2,0.0001,1104,12
0.516,1e-05,576,628,100,2,0.0001,1204,12
0.518,1e-05,623,681,100,2,0.0001,1304,12
0.518,1e-05,669,735,100,2,0.0001,1404,12
0.518,1e-05,722,782,100,2,0.0001,1504,12
0.516,1e-05,774,830,100,2,0.0001,1604,12
0.514,1e-05,832,872,100,2,0.0001,1704,12
0.516,1e-05,894,910,100,2,0.0001,1804,12
0.516,1e-05,940,964,100,2,0.0001,1904,12
0.518,1e-05,992,1012,100,2,0.0001,2004,12
0.504,1e-05,50,54,100,2,0.0001,104,13
0.504,1e-05,89,115,100,2,0.0001,204,13
0.504,1e-05,149,155,100,2,0.0001,304,13
0.504,1e-05,203,201,100,2,0.0001,404,13
0.504,1e-05,248,256,100,2,0.0001,504,13
0.504,1e-05,298,306,100,2,0.0001,604,13
0.504,1e-05,345,359,100,2,0.0001,704,13
0.504,1e-05,395,409,100,2,0.0001,804,13
0.504,1e-05,441,463,100,2,0.0001,904,13
0.504,1e-05,486,518,100,2,0.0001,1004,13
0.504,1e-05,538,566,100,2,0.0001,1104,13
0.504,1e-05,597,607,100,2,0.0001,1204,13
0.504,1e-05,647,657,100,2,0.0001,1304,13
0.504,1e-05,693,711,100,2,0.0001,1404,13
0.504,1e-05,740,764,100,2,0.0001,1504,13
0.506,1e-05,791,813,100,2,0.0001,1604,13
0.506,1e-05,849,855,100,2,0.0001,1704,13
0.506,1e-05,896,908,100,2,0.0001,1804,13
0.506,1e-05,947,957,100,2,0.0001,1904,13
0.506,1e-05,1000,1004,100,2,0.0001,2004,13
0.484,1e-05,47,57,100,2,0.0001,104,14
0.484,1e-05,107,97,100,2,0.0001,204,14
0.484,1e-05,152,152,100,2,0.0001,304,14
0.484,1e-05,207,197,100,2,0.0001,404,14
0.484,1e-05,256,248,100,2,0.0001,504,14
0.484,1e-05,306,298,100,2,0.0001,604,14
0.484,1e-05,362,342,100,2,0.0001,704,14
0.484,1e-05,410,394,100,2,0.0001,804,14
0.486,1e-05,458,446,100,2,0.0001,904,14
0.486,1e-05,513,491,100,2,0.0001,1004,14
0.488,1e-05,558,546,100,2,0.0001,1104,14
0.488,1e-05,603,601,100,2,0.0001,1204,14
0.488,1e-05,648,656,100,2,0.0001,1304,14
0.488,1e-05,696,708,100,2,0.0001,1404,14
0.49,1e-05,741,763,100,2,0.0001,1504,14
0.49,1e-05,790,814,100,2,0.0001,1604,14
0.49,1e-05,849,855,100,2,0.0001,1704,14
0.488,1e-05,901,903,100,2,0.0001,1804,14
0.49,1e-05,953,951,100,2,0.0001,1904,14
0.49,1e-05,1008,996,100,2,0.0001,2004,14
0.502,1e-05,58,46,100,2,0.0001,104,15
0.502,1e-05,102,102,100,2,0.0001,204,15
0.502,1e-05,154,150,100,2,0.0001,304,15
0.502,1e-05,211,193,100,2,0.0001,404,15
0.502,1e-05,268,236,100,2,0.0001,504,15
0.502,1e-05,319,285,100,2,0.0001,604,15
0.502,1e-05,367,337,100,2,0.0001,704,15
0.502,1e-05,414,390,100,2,0.0001,804,15
0.502,1e-05,463,441,100,2,0.0001,904,15
0.502,1e-05,509,495,100,2,0.0001,1004,15
0.502,1e-05,553,551,100,2,0.0001,1104,15
0.502,1e-05,607,597,100,2,0.0001,1204,15
0.502,1e-05,651,653,100,2,0.0001,1304,15
0.502,1e-05,696,708,100,2,0.0001,1404,15
0.502,1e-05,746,758,100,2,0.0001,1504,15
0.502,1e-05,799,805,100,2,0.0001,1604,15
0.502,1e-05,849,855,100,2,0.0001,1704,15
0.502,1e-05,904,900,100,2,0.0001,1804,15
0.502,1e-05,955,949,100,2,0.0001,1904,15
0.502,1e-05,1003,1001,100,2,0.0001,2004,15
0.49,1e-05,55,49,100,2,0.0001,104,16
0.49,1e-05,104,100,100,2,0.0001,204,16
0.49,1e-05,160,144,100,2,0.0001,304,16
0.49,1e-05,210,194,100,2,0.0001,404,16
0.49,1e-05,261,243,100,2,0.0001,504,16
0.49,1e-05,307,297,100,2,0.0001,604,16
0.49,1e-05,351,353,100,2,0.0001,704,16
0.49,1e-05,401,403,100,2,0.0001,804,16
0.49,1e-05,444,460,100,2,0.0001,904,16
0.49,1e-05,487,517,100,2,0.0001,1004,16
0.49,1e-05,536,568,100,2,0.0001,1104,16
0.49,1e-05,591,613,100,2,0.0001,1204,16
0.49,1e-05,637,667,100,2,0.0001,1304,16
0.49,1e-05,692,712,100,2,0.0001,1404,16
0.49,1e-05,743,761,100,2,0.0001,1504,16
0.49,1e-05,798,806,100,2,0.0001,1604,16
0.492,1e-05,845,859,100,2,0.0001,1704,16
0.492,1e-05,897,907,100,2,0.0001,1804,16
0.492,1e-05,957,947,100,2,0.0001,1904,16
0.492,1e-05,1006,998,100,2,0.0001,2004,16
0.504,1e-05,55,49,100,2,0.0001,104,17
0.504,1e-05,108,96,100,2,0.0001,204,17
0.504,1e-05,158,146,100,2,0.0001,304,17
0.504,1e-05,206,198,100,2,0.0001,404,17
0.504,1e-05,265,239,100,2,0.0001,504,17
0.504,1e-05,310,294,100,2,0.0001,604,17
0.504,1e-05,361,343,100,2,0.0001,704,17
0.504,1e-05,408,396,100,2,0.0001,804,17
0.504,1e-05,460,444,100,2,0.0001,904,17
0.504,1e-05,503,501,100,2,0.0001,1004,17
0.504,1e-05,547,557,100,2,0.0001,1104,17
0.504,1e-05,593,611,100,2,0.0001,1204,17
0.504,1e-05,642,662,100,2,0.0001,1304,17
0.504,1e-05,701,703,100,2,0.0001,1404,17
0.504,1e-05,754,750,100,2,0.0001,1504,17
0.504,1e-05,807,797,100,2,0.0001,1604,17
0.504,1e-05,853,851,100,2,0.0001,1704,17
0.504,1e-05,901,903,100,2,0.0001,1804,17
0.504,1e-05,960,944,100,2,0.0001,1904,17
0.504,1e-05,1000,1004,100,2,0.0001,2004,17
0.512,1e-05,50,54,100,2,0.0001,104,18
0.512,1e-05,100,104,100,2,0.0001,204,18
0.512,1e-05,149,155,100,2,0.0001,304,18
0.512,1e-05,202,202,100,2,0.0001,404,18
0.512,1e-05,251,253,100,2,0.0001,504,18
0.512,1e-05,291,313,100,2,0.0001,604,18
0.512,1e-05,343,361,100,2,0.0001,704,18
0.512,1e-05,389,415,100,2,0.0001,804,18
0.512,1e-05,438,466,100,2,0.0001,904,18
0.512,1e-05,489,515,100,2,0.0001,1004,18
0.512,1e-05,538,566,100,2,0.0001,1104,18
0.512,1e-05,589,615,100,2,0.0001,1204,18
0.512,1e-05,643,661,100,2,0.0001,1304,18
0.512,1e-05,688,716,100,2,0.0001,1404,18
0.512,1e-05,731,773,100,2,0.0001,1504,18
0.512,1e-05,786,818,100,2,0.0001,1604,18
0.512,1e-05,838,866,100,2,0.0001,1704,18
0.512,1e-05,890,914,100,2,0.0001,1804,18
0.512,1e-05,941,963,100,2,0.0001,1904,18
0.512,1e-05,996,1008,100,2,0.0001,2004,18
0.47,1e-05,55,49,100,2,0.0001,104,19
0.47,1e-05,113,91,100,2,0.0001,204,19
0.47,1e-05,160,144,100,2,0.0001,304,19
0.47,1e-05,211,193,100,2,0.0001,404,19
0.47,1e-05,264,240,100,2,0.0001,504,19
0.47,1e-05,317,287,100,2,0.0001,604,19
0.47,1e-05,367,337,100,2,0.0001,704,19
0.47,1e-05,421,383,100,2,0.0001,804,19
0.47,1e-05,475,429,100,2,0.0001,904,19
0.47,1e-05,525,479,100,2,0.0001,1004,19
0.47,1e-05,574,530,100,2,0.0001,1104,19
0.47,1e-05,626,578,100,2,0.0001,1204,19
0.47,1e-05,672,632,100,2,0.0001,1304,19
0.47,1e-05,725,679,100,2,0.0001,1404,19
0.47,1e-05,778,726,100,2,0.0001,1504,19
0.47,1e-05,830,774,100,2,0.0001,1604,19
0.47,1e-05,873,831,100,2,0.0001,1704,19
0.47,1e-05,920,884,100,2,0.0001,1804,19
0.47,1e-05,962,942,100,2,0.0001,1904,19
0.47,1e-05,1017,987,100,2,0.0001,2004,19
0.492,1e-05,54,50,100,2,0.0001,104,20
0.492,1e-05,104,100,100,2,0.0001,204,20
0.492,1e-05,140,164,100,2,0.0001,304,20
0.492,1e-05,187,217,100,2,0.0001,404,20
0.492,1e-05,233,271,100,2,0.0001,504,20
0.492,1e-05,290,314,100,2,0.0001,604,20
0.492,1e-05,334,370,100,2,0.0001,704,20
0.492,1e-05,382,422,100,2,0.0001,804,20
0.492,1e-05,431,473,100,2,0.0001,904,20
0.496,1e-05,482,522,100,2,0.0001,1004,20
0.496,1e-05,530,574,100,2,0.0001,1104,20
0.494,1e-05,587,617,100,2,0.0001,1204,20
0.496,1e-05,637,667,100,2,0.0001,1304,20
0.5,1e-05,694,710,100,2,0.0001,1404,20
0.502,1e-05,749,755,100,2,0.0001,1504,20
0.504,1e-05,794,810,100,2,0.0001,1604,20
0.502,1e-05,853,851,100,2,0.0001,1704,20
0.5,1e-05,901,903,100,2,0.0001,1804,20
0.506,1e-05,957,947,100,2,0.0001,1904,20
0.506,1e-05,1006,998,100,2,0.0001,2004,20
0.512,1e-05,63,41,100,2,0.001,104,1
0.512,1e-05,115,89,100,2,0.001,204,1
0.512,1e-05,170,134,100,2,0.001,304,1
0.512,1e-05,217,187,100,2,0.001,404,1
0.512,1e-05,267,237,100,2,0.001,504,1
0.512,1e-05,317,287,100,2,0.001,604,1
0.512,1e-05,368,336,100,2,0.001,704,1
0.512,1e-05,419,385,100,2,0.001,804,1
0.512,1e-05,462,442,100,2,0.001,904,1
0.512,1e-05,513,491,100,2,0.001,1004,1
0.512,1e-05,561,543,100,2,0.001,1104,1
0.512,1e-05,605,599,100,2,0.001,1204,1
0.512,1e-05,656,648,100,2,0.001,1304,1
0.512,1e-05,702,702,100,2,0.001,1404,1
0.512,1e-05,751,753,100,2,0.001,1504,1
0.512,1e-05,798,806,100,2,0.001,1604,1
0.512,1e-05,854,850,100,2,0.001,1704,1
0.512,1e-05,899,905,100,2,0.001,1804,1
0.512,1e-05,948,956,100,2,0.001,1904,1
0.512,1e-05,996,1008,100,2,0.001,2004,1
0.498,1e-05,54,50,100,2,0.001,104,2
0.498,1e-05,96,108,100,2,0.001,204,2
0.498,1e-05,139,165,100,2,0.001,304,2
0.498,1e-05,188,216,100,2,0.001,404,2
0.498,1e-05,245,259,100,2,0.001,504,2
0.5,1e-05,296,308,100,2,0.001,604,2
0.498,1e-05,351,353,100,2,0.001,704,2
0.5,1e-05,398,406,100,2,0.001,804,2
0.5,1e-05,449,455,100,2,0.001,904,2
0.502,1e-05,497,507,100,2,0.001,1004,2
0.502,1e-05,552,552,100,2,0.001,1104,2
0.504,1e-05,600,604,100,2,0.001,1204,2
0.504,1e-05,648,656,100,2,0.001,1304,2
0.506,1e-05,703,701,100,2,0.001,1404,2
0.506,1e-05,756,748,100,2,0.001,1504,2
0.506,1e-05,806,798,100,2,0.001,1604,2
0.504,1e-05,855,849,100,2,0.001,1704,2
0.51,1e-05,906,898,100,2,0.001,1804,2
0.518,1e-05,961,943,100,2,0.001,1904,2
0.532,1e-05,1003,1001,100,2,0.001,2004,2
0.54,1e-05,56,48,100,2,0.001,104,3
0.538,1e-05,111,93,100,2,0.001,204,3
0.54,1e-05,165,139,100,2,0.001,304,3
0.536,1e-05,209,195,100,2,0.001,404,3
0.536,1e-05,258,246,100,2,0.001,504,3
0.536,1e-05,301,303,100,2,0.001,604,3
0.54,1e-05,351,353,100,2,0.001,704,3
0.538,1e-05,396,408,100,2,0.001,804,3
0.538,1e-05,442,462,100,2,0.001,904,3
0.538,1e-05,496,508,100,2,0.001,1004,3
0.538,1e-05,549,555,100,2,0.001,1104,3
0.534,1e-05,590,614,100,2,0.001,1204,3
0.532,1e-05,643,661,100,2,0.001,1304,3
0.536,1e-05,697,707,100,2,0.001,1404,3
0.538,1e-05,742,762,100,2,0.001,1504,3
0.548,1e-05,796,808,100,2,0.001,1604,3
0.55,1e-05,846,858,100,2,0.001,1704,3
0.564,1e-05,893,911,100,2,0.001,1804,3
0.564,1e-05,933,971,100,2,0.001,1904,3
0.57,1e-05,982,1022,100,2,0.001,2004,3
0.504,1e-05,50,54,100,2,0.001,104,4
0.504,1e-05,96,108,100,2,0.001,204,4
0.504,1e-05,154,150,100,2,0.001,304,4
0.504,1e-05,190,214,100,2,0.001,404,4
0.504,1e-05,237,267,100,2,0.001,504,4
0.504,1e-05,277,327,100,2,0.001,604,4
0.504,1e-05,324,380,100,2,0.001,704,4
0.504,1e-05,382,422,100,2,0.001,804,4
0.504,1e-05,442,462,100,2,0.001,904,4
0.504,1e-05,498,506,100,2,0.001,1004,4
0.504,1e-05,548,556,100,2,0.001,1104,4
0.504,1e-05,600,604,100,2,0.001,1204,4
0.504,1e-05,656,648,100,2,0.001,1304,4
0.504,1e-05,712,692,100,2,0.001,1404,4
0.504,1e-05,758,746,100,2,0.001,1504,4
0.504,1e-05,809,795,100,2,0.001,1604,4
0.504,1e-05,858,846,100,2,0.001,1704,4
0.504,1e-05,903,901,100,2,0.001,1804,4
0.504,1e-05,953,951,100,2,0.001,1904,4
0.504,1e-05,1000,1004,100,2,0.001,2004,4
0.538,1e-05,56,48,100,2,0.001,104,5
0.536,1e-05,100,104,100,2,0.001,204,5
0.534,1e-05,157,147,100,2,0.001,304,5
0.536,1e-05,203,201,100,2,0.001,404,5
0.536,1e-05,252,252,100,2,0.001,504,5
0.532,1e-05,304,300,100,2,0.001,604,5
0.532,1e-05,349,355,100,2,0.001,704,5
0.534,1e-05,405,399,100,2,0.001,804,5
0.532,1e-05,446,458,100,2,0.001,904,5
0.53,1e-05,492,512,100,2,0.001,1004,5
0.534,1e-05,540,564,100,2,0.001,1104,5
0.53,1e-05,596,608,100,2,0.001,1204,5
0.528,1e-05,648,656,100,2,0.001,1304,5
0.524,1e-05,698,706,100,2,0.001,1404,5
0.526,1e-05,750,754,100,2,0.001,1504,5
0.528,1e-05,797,807,100,2,0.001,1604,5
0.526,1e-05,852,852,100,2,0.001,1704,5
0.53,1e-05,909,895,100,2,0.001,1804,5
0.526,1e-05,954,950,100,2,0.001,1904,5
0.524,1e-05,1005,999,100,2,0.001,2004,5
0.448,1e-05,56,48,100,2,0.001,104,6
0.448,1e-05,107,97,100,2,0.001,204,6
0.448,1e-05,155,149,100,2,0.001,304,6
0.448,1e-05,207,197,100,2,0.001,404,6
0.448,1e-05,263,241,100,2,0.001,504,6
0.448,1e-05,308,296,100,2,0.001,604,6
0.448,1e-05,363,341,100,2,0.001,704,6
0.448,1e-05,415,389,100,2,0.001,804,6
0.448,1e-05,462,442,100,2,0.001,904,6
0.448,1e-05,511,493,100,2,0.001,1004,6
0.448,1e-05,565,539,100,2,0.001,1104,6
0.448,1e-05,626,578,100,2,0.001,1204,6
0.448,1e-05,680,624,100,2,0.001,1304,6
0.448,1e-05,736,668,100,2,0.001,1404,6
0.448,1e-05,779,725,100,2,0.001,1504,6
0.448,1e-05,828,776,100,2,0.001,1604,6
0.448,1e-05,877,827,100,2,0.001,1704,6
0.448,1e-05,922,882,100,2,0.001,1804,6
0.448,1e-05,982,922,100,2,0.001,1904,6
0.448,1e-05,1028,976,100,2,0.001,2004,6
0.446,1e-05,55,49,100,2,0.001,104,7
0.446,1e-05,115,89,100,2,0.001,204,7
0.444,1e-05,156,148,100,2,0.001,304,7
0.446,1e-05,208,196,100,2,0.001,404,7
0.454,1e-05,255,249,100,2,0.001,504,7
0.452,1e-05,308,296,100,2,0.001,604,7
0.45,1e-05,356,348,100,2,0.001,704,7
0.454,1e-05,406,398,100,2,0.001,804,7
0.454,1e-05,459,445,100,2,0.001,904,7
0.458,1e-05,514,490,100,2,0.001,1004,7
0.462,1e-05,563,541,100,2,0.001,1104,7
0.472,1e-05,612,592,100,2,0.001,1204,7
0.476,1e-05,665,639,100,2,0.001,1304,7
0.478,1e-05,718,686,100,2,0.001,1404,7
0.48,1e-05,771,733,100,2,0.001,1504,7
0.486,1e-05,832,772,100,2,0.001,1604,7
0.486,1e-05,881,823,100,2,0.001,1704,7
0.484,1e-05,926,878,100,2,0.001,1804,7
0.484,1e-05,980,924,100,2,0.001,1904,7
0.484,1e-05,1033,971,100,2,0.001,2004,7
0.482,1e-05,59,45,100,2,0.001,104,8
0.484,1e-05,114,90,100,2,0.001,204,8
0.484,1e-05,150,154,100,2,0.001,304,8
0.484,1e-05,194,210,100,2,0.001,404,8
0.484,1e-05,245,259,100,2,0.001,504,8
0.484,1e-05,293,311,100,2,0.001,604,8
0.482,1e-05,341,363,100,2,0.001,704,8
0.48,1e-05,388,416,100,2,0.001,804,8
0.482,1e-05,441,463,100,2,0.001,904,8
0.488,1e-05,486,518,100,2,0.001,1004,8
0.49,1e-05,536,568,100,2,0.001,1104,8
0.49,1e-05,590,614,100,2,0.001,1204,8
0.498,1e-05,638,666,100,2,0.001,1304,8
0.502,1e-05,697,707,100,2,0.001,1404,8
0.506,1e-05,748,756,100,2,0.001,1504,8
0.518,1e-05,800,804,100,2,0.001,1604,8
0.524,1e-05,851,853,100,2,0.001,1704,8
0.526,1e-05,900,904,100,2,0.001,1804,8
0.534,1e-05,953,951,100,2,0.001,1904,8
0.542,1e-05,1011,993,100,2,0.001,2004,8
0.474,1e-05,55,49,100,2,0.001,104,9
0.474,1e-05,102,102,100,2,0.001,204,9
0.474,1e-05,154,150,100,2,0.001,304,9
0.476,1e-05,197,207,100,2,0.001,404,9
0.476,1e-05,245,259,100,2,0.001,504,9
0.478,1e-05,300,304,100,2,0.001,604,9
0.48,1e-05,349,355,100,2,0.001,704,9
0.482,1e-05,401,403,100,2,0.001,804,9
0.482,1e-05,454,450,100,2,0.001,904,9
0.48,1e-05,503,501,100,2,0.001,1004,9
0.484,1e-05,552,552,100,2,0.001,1104,9
0.488,1e-05,606,598,100,2,0.001,1204,9
0.494,1e-05,656,648,100,2,0.001,1304,9
0.494,1e-05,706,698,100,2,0.001,1404,9
0.494,1e-05,760,744,100,2,0.001,1504,9
0.502,1e-05,803,801,100,2,0.001,1604,9
0.494,1e-05,859,845,100,2,0.001,1704,9
0.494,1e-05,909,895,100,2,0.001,1804,9
0.496,1e-05,964,940,100,2,0.001,1904,9
0.494,1e-05,1015,989,100,2,0.001,2004,9
0.506,1e-05,60,44,100,2,0.001,104,10
0.504,1e-05,114,90,100,2,0.001,204,10
0.502,1e-05,165,139,100,2,0.001,304,10
0.5,1e-05,213,191,100,2,0.001,404,10
0.502,1e-05,269,235,100,2,0.001,504,10
0.504,1e-05,319,285,100,2,0.001,604,10
0.506,1e-05,373,331,100,2,0.001,704,10
0.506,1e-05,429,375,100,2,0.001,804,10
0.506,1e-05,479,425,100,2,0.001,904,10
0.506,1e-05,527,477,100,2,0.001,1004,10
0.51,1e-05,578,526,100,2,0.001,1104,10
0.506,1e-05,617,587,100,2,0.001,1204,10
0.51,1e-05,666,638,100,2,0.001,1304,10
0.51,1e-05,714,690,100,2,0.001,1404,10
0.51,1e-05,769,735,100,2,0.001,1504,10
0.516,1e-05,812,792,100,2,0.001,1604,10
0.516,1e-05,866,838,100,2,0.001,1704,10
0.522,1e-05,907,897,100,2,0.001,1804,10
0.52,1e-05,956,948,100,2,0.001,1904,10
0.522,1e-05,1006,998,100,2,0.001,2004,10
0.468,1e-05,52,52,100,2,0.001,104,11
0.466,1e-05,99,105,100,2,0.001,204,11
0.466,1e-05,146,158,100,2,0.001,304,11
0.464,1e-05,188,216,100,2,0.001,404,11
0.464,1e-05,233,271,100,2,0.001,504,11
0.464,1e-05,281,323,100,2,0.001,604,11
0.464,1e-05,327,377,100,2,0.001,704,11
0.464,1e-05,386,418,100,2,0.001,804,11
0.468,1e-05,440,464,100,2,0.001,904,11
0.464,1e-05,498,506,100,2,0.001,1004,11
0.462,1e-05,549,555,100,2,0.001,1104,11
0.47,1e-05,598,606,100,2,0.001,1204,11
0.476,1e-05,647,657,100,2,0.001,1304,11
0.48,1e-05,700,704,100,2,0.001,1404,11
0.48,1e-05,745,759,100,2,0.001,1504,11
0.484,1e-05,792,812,100,2,0.001,1604,11
0.486,1e-05,840,864,100,2,0.001,1704,11
0.492,1e-05,886,918,100,2,0.001,1804,11
0.496,1e-05,932,972,100,2,0.001,1904,11
0.502,1e-05,987,1017,100,2,0.001,2004,11
0.52,1e-05,51,53,100,2,0.001,104,12
0.52,1e-05,107,97,100,2,0.001,204,12
0.522,1e-05,162,142,100,2,0.001,304,12
0.522,1e-05,212,192,100,2,0.001,404,12
0.526,1e-05,259,245,100,2,0.001,504,12
0.526,1e-05,315,289,100,2,0.001,604,12
0.526,1e-05,358,346,100,2,0.001,704,12
0.528,1e-05,407,397,100,2,0.001,804,12
0.528,1e-05,452,452,100,2,0.001,904,12
0.53,1e-05,500,504,100,2,0.001,1004,12
0.532,1e-05,551,553,100,2,0.001,1104,12
0.536,1e-05,607,597,100,2,0.001,1204,12
0.536,1e-05,657,647,100,2,0.001,1304,12
0.544,1e-05,712,692,100,2,0.001,1404,12
0.55,1e-05,762,742,100,2,0.001,1504,12
0.554,1e-05,815,789,100,2,0.001,1604,12
0.56,1e-05,859,845,100,2,0.001,1704,12
0.566,1e-05,916,888,100,2,0.001,1804,12
0.572,1e-05,968,936,100,2,0.001,1904,12
0.58,1e-05,1016,988,100,2,0.001,2004,12
0.482,1e-05,55,49,100,2,0.001,104,13
0.482,1e-05,102,102,100,2,0.001,204,13
0.482,1e-05,153,151,100,2,0.001,304,13
0.482,1e-05,205,199,100,2,0.001,404,13
0.482,1e-05,247,257,100,2,0.001,504,13
0.482,1e-05,291,313,100,2,0.001,604,13
0.482,1e-05,349,355,100,2,0.001,704,13
0.482,1e-05,397,407,100,2,0.001,804,13
0.482,1e-05,455,449,100,2,0.001,904,13
0.482,1e-05,506,498,100,2,0.001,1004,13
0.482,1e-05,551,553,100,2,0.001,1104,13
0.482,1e-05,600,604,100,2,0.001,1204,13
0.504,1e-05,649,655,100,2,0.001,1304,13
0.498,1e-05,698,706,100,2,0.001,1404,13
0.496,1e-05,748,756,100,2,0.001,1504,13
0.496,1e-05,804,800,100,2,0.001,1604,13
0.502,1e-05,857,847,100,2,0.001,1704,13
0.504,1e-05,901,903,100,2,0.001,1804,13
0.51,1e-05,939,965,100,2,0.001,1904,13
0.514,1e-05,993,1011,100,2,0.001,2004,13
0.502,1e-05,52,52,100,2,0.001,104,14
0.502,1e-05,106,98,100,2,0.001,204,14
0.502,1e-05,162,142,100,2,0.001,304,14
0.502,1e-05,212,192,100,2,0.001,404,14
0.502,1e-05,263,241,100,2,0.001,504,14
0.502,1e-05,297,307,100,2,0.001,604,14
0.502,1e-05,355,349,100,2,0.001,704,14
0.502,1e-05,402,402,100,2,0.001,804,14
0.502,1e-05,444,460,100,2,0.001,904,14
0.502,1e-05,495,509,100,2,0.001,1004,14
0.502,1e-05,542,562,100,2,0.001,1104,14
0.502,1e-05,594,610,100,2,0.001,1204,14
0.502,1e-05,644,660,100,2,0.001,1304,14
0.502,1e-05,701,703,100,2,0.001,1404,14
0.502,1e-05,748,756,100,2,0.001,1504,14
0.502,1e-05,801,803,100,2,0.001,1604,14
0.502,1e-05,853,851,100,2,0.001,1704,14
0.476,1e-05,906,898,100,2,0.001,1804,14
0.474,1e-05,954,950,100,2,0.001,1904,14
0.464,1e-05,1001,1003,100,2,0.001,2004,14
0.49,1e-05,49,55,100,2,0.001,104,15
0.49,1e-05,98,106,100,2,0.001,204,15
0.49,1e-05,157,147,100,2,0.001,304,15
0.49,1e-05,207,197,100,2,0.001,404,15
0.49,1e-05,257,247,100,2,0.001,504,15
0.49,1e-05,306,298,100,2,0.001,604,15
0.49,1e-05,357,347,100,2,0.001,704,15
0.49,1e-05,406,398,100,2,0.001,804,15
0.49,1e-05,450,454,100,2,0.001,904,15
0.49,1e-05,495,509,100,2,0.001,1004,15
0.49,1e-05,543,561,100,2,0.001,1104,15
0.49,1e-05,591,613,100,2,0.001,1204,15
0.49,1e-05,643,661,100,2,0.001,1304,15
0.49,1e-05,692,712,100,2,0.001,1404,15
0.49,1e-05,750,754,100,2,0.001,1504,15
0.49,1e-05,797,807,100,2,0.001,1604,15
0.49,1e-05,845,859,100,2,0.001,1704,15
0.49,1e-05,901,903,100,2,0.001,1804,15
0.49,1e-05,954,950,100,2,0.001,1904,15
0.49,1e-05,997,1007,100,2,0.001,2004,15
0.478,1e-05,50,54,100,2,0.001,104,16
0.478,1e-05,102,102,100,2,0.001,204,16
0.478,1e-05,151,153,100,2,0.001,304,16
0.478,1e-05,200,204,100,2,0.001,404,16
0.478,1e-05,245,259,100,2,0.001,504,16
0.478,1e-05,288,316,100,2,0.001,604,16
0.478,1e-05,337,367,100,2,0.001,704,16
0.478,1e-05,385,419,100,2,0.001,804,16
0.478,1e-05,437,467,100,2,0.001,904,16
0.478,1e-05,490,514,100,2,0.001,1004,16
0.478,1e-05,538,566,100,2,0.001,1104,16
0.478,1e-05,582,622,100,2,0.001,1204,16
0.478,1e-05,630,674,100,2,0.001,1304,16
0.478,1e-05,674,730,100,2,0.001,1404,16
0.478,1e-05,726,778,100,2,0.001,1504,16
0.478,1e-05,775,829,100,2,0.001,1604,16
0.478,1e-05,833,871,100,2,0.001,1704,16
0.478,1e-05,887,917,100,2,0.001,1804,16
0.478,1e-05,934,970,100,2,0.001,1904,16
0.478,1e-05,991,1013,100,2,0.001,2004,16
0.544,1e-05,47,57,100,2,0.001,104,17
0.544,1e-05,98,106,100,2,0.001,204,17
0.544,1e-05,149,155,100,2,0.001,304,17
0.544,1e-05,202,202,100,2,0.001,404,17
0.544,1e-05,249,255,100,2,0.001,504,17
0.544,1e-05,309,295,100,2,0.001,604,17
0.544,1e-05,350,354,100,2,0.001,704,17
0.544,1e-05,406,398,100,2,0.001,804,17
0.544,1e-05,453,451,100,2,0.001,904,17
0.544,1e-05,504,500,100,2,0.001,1004,17
0.544,1e-05,558,546,100,2,0.001,1104,17
0.544,1e-05,600,604,100,2,0.001,1204,17
0.544,1e-05,656,648,100,2,0.001,1304,17
0.544,1e-05,706,698,100,2,0.001,1404,17
0.544,1e-05,747,757,100,2,0.001,1504,17
0.544,1e-05,784,820,100,2,0.001,1604,17
0.544,1e-05,834,870,100,2,0.001,1704,17
0.544,1e-05,893,911,100,2,0.001,1804,17
0.544,1e-05,934,970,100,2,0.001,1904,17
0.544,1e-05,980,1024,100,2,0.001,2004,17
0.51,1e-05,53,51,100,2,0.001,104,18
0.508,1e-05,98,106,100,2,0.001,204,18
0.504,1e-05,151,153,100,2,0.001,304,18
0.506,1e-05,207,197,100,2,0.001,404,18
0.51,1e-05,254,250,100,2,0.001,504,18
0.51,1e-05,300,304,100,2,0.001,604,18
0.51,1e-05,339,365,100,2,0.001,704,18
0.516,1e-05,391,413,100,2,0.001,804,18
0.516,1e-05,435,469,100,2,0.001,904,18
0.52,1e-05,489,515,100,2,0.001,1004,18
0.518,1e-05,543,561,100,2,0.001,1104,18
0.522,1e-05,588,616,100,2,0.001,1204,18
0.518,1e-05,632,672,100,2,0.001,1304,18
0.524,1e-05,683,721,100,2,0.001,1404,18
0.532,1e-05,735,769,100,2,0.001,1504,18
0.528,1e-05,788,816,100,2,0.001,1604,18
0.532,1e-05,840,864,100,2,0.001,1704,18
0.538,1e-05,887,917,100,2,0.001,1804,18
0.546,1e-05,942,962,100,2,0.001,1904,18
0.558,1e-05,998,1006,100,2,0.001,2004,18
0.492,1e-05,53,51,100,2,0.001,104,19
0.492,1e-05,108,96,100,2,0.001,204,19
0.492,1e-05,161,143,100,2,0.001,304,19
0.492,1e-05,212,192,100,2,0.001,404,19
0.492,1e-05,281,223,100,2,0.001,504,19
0.492,1e-05,326,278,100,2,0.001,604,19
0.492,1e-05,387,317,100,2,0.001,704,19
0.492,1e-05,429,375,100,2,0.001,804,19
0.492,1e-05,482,422,100,2,0.001,904,19
0.492,1e-05,526,478,100,2,0.001,1004,19
0.492,1e-05,575,529,100,2,0.001,1104,19
0.492,1e-05,620,584,100,2,0.001,1204,19
0.492,1e-05,670,634,100,2,0.001,1304,19
0.492,1e-05,717,687,100,2,0.001,1404,19
0.492,1e-05,761,743,100,2,0.001,1504,19
0.492,1e-05,806,798,100,2,0.001,1604,19
0.492,1e-05,856,848,100,2,0.001,1704,19
0.492,1e-05,902,902,100,2,0.001,1804,19
0.492,1e-05,951,953,100,2,0.001,1904,19
0.494,1e-05,998,1006,100,2,0.001,2004,19
0.476,1e-05,56,48,100,2,0.001,104,20
0.476,1e-05,103,101,100,2,0.001,204,20
0.476,1e-05,159,145,100,2,0.001,304,20
0.476,1e-05,206,198,100,2,0.001,404,20
0.476,1e-05,258,246,100,2,0.001,504,20
0.476,1e-05,298,306,100,2,0.001,604,20
0.476,1e-05,344,360,100,2,0.001,704,20
0.476,1e-05,391,413,100,2,0.001,804,20
0.476,1e-05,434,470,100,2,0.001,904,20
0.476,1e-05,482,522,100,2,0.001,1004,20
0.476,1e-05,531,573,100,2,0.001,1104,20
0.476,1e-05,589,615,100,2,0.001,1204,20
0.476,1e-05,650,654,100,2,0.001,1304,20
0.476,1e-05,693,711,100,2,0.001,1404,20
0.476,1e-05,736,768,100,2,0.001,1504,20
0.476,1e-05,791,813,100,2,0.001,1604,20
0.476,1e-05,842,862,100,2,0.001,1704,20
0.476,1e-05,895,909,100,2,0.001,1804,20
0.476,1e-05,947,957,100,2,0.001,1904,20
0.476,1e-05,990,1014,100,2,0.001,2004,20
0.512,1e-05,55,49,100,2,0.01,104,1
0.5,1e-05,102,102,100,2,0.01,204,1
0.488,1e-05,151,153,100,2,0.01,304,1
0.49,1e-05,201,203,100,2,0.01,404,1
0.508,1e-05,249,255,100,2,0.01,504,1
0.52,1e-05,305,299,100,2,0.01,604,1
0.534,1e-05,357,347,100,2,0.01,704,1
0.576,1e-05,415,389,100,2,0.01,804,1
0.62,1e-05,458,446,100,2,0.01,904,1
0.686,1e-05,515,489,100,2,0.01,1004,1
0.688,1e-05,556,548,100,2,0.01,1104,1
0.712,1e-05,600,604,100,2,0.01,1204,1
0.772,1e-05,655,649,100,2,0.01,1304,1
0.812,1e-05,708,696,100,2,0.01,1404,1
0.834,1e-05,756,748,100,2,0.01,1504,1
0.866,1e-05,800,804,100,2,0.01,1604,1
0.874,1e-05,849,855,100,2,0.01,1704,1
0.878,1e-05,901,903,100,2,0.01,1804,1
0.89,1e-05,950,954,100,2,0.01,1904,1
0.884,1e-05,996,1008,100,2,0.01,2004,1
0.476,1e-05,52,52,100,2,0.01,104,2
0.476,1e-05,98,106,100,2,0.01,204,2
0.476,1e-05,141,163,100,2,0.01,304,2
0.476,1e-05,183,221,100,2,0.01,404,2
0.476,1e-05,233,271,100,2,0.01,504,2
0.476,1e-05,288,316,100,2,0.01,604,2
0.476,1e-05,347,357,100,2,0.01,704,2
0.476,1e-05,392,412,100,2,0.01,804,2
0.476,1e-05,432,472,100,2,0.01,904,2
0.476,1e-05,485,519,100,2,0.01,1004,2
0.476,1e-05,534,570,100,2,0.01,1104,2
0.476,1e-05,586,618,100,2,0.01,1204,2
0.476,1e-05,637,667,100,2,0.01,1304,2
0.488,1e-05,684,720,100,2,0.01,1404,2
0.552,1e-05,725,779,100,2,0.01,1504,2
0.614,1e-05,779,825,100,2,0.01,1604,2
0.634,1e-05,826,878,100,2,0.01,1704,2
0.67,1e-05,884,920,100,2,0.01,1804,2
0.696,1e-05,940,964,100,2,0.01,1904,2
0.712,1e-05,990,1014,100,2,0.01,2004,2
0.488,1e-05,55,49,100,2,0.01,104,3
0.494,1e-05,108,96,100,2,0.01,204,3
0.492,1e-05,158,146,100,2,0.01,304,3
0.484,1e-05,213,191,100,2,0.01,404,3
0.486,1e-05,269,235,100,2,0.01,504,3
0.48,1e-05,314,290,100,2,0.01,604,3
0.482,1e-05,367,337,100,2,0.01,704,3
0.5,1e-05,421,383,100,2,0.01,804,3
0.51,1e-05,476,428,100,2,0.01,904,3
0.514,1e-05,533,471,100,2,0.01,1004,3
0.504,1e-05,574,530,100,2,0.01,1104,3
0.528,1e-05,626,578,100,2,0.01,1204,3
0.544,1e-05,679,625,100,2,0.01,1304,3
0.554,1e-05,722,682,100,2,0.01,1404,3
0.566,1e-05,772,732,100,2,0.01,1504,3
0.566,1e-05,811,793,100,2,0.01,1604,3
0.604,1e-05,853,851,100,2,0.01,1704,3
0.654,1e-05,906,898,100,2,0.01,1804,3
0.66,1e-05,954,950,100,2,0.01,1904,3
0.718,1e-05,1001,1003,100,2,0.01,2004,3
0.472,1e-05,49,55,100,2,0.01,104,4
0.472,1e-05,106,98,100,2,0.01,204,4
0.472,1e-05,156,148,100,2,0.01,304,4
0.472,1e-05,200,204,100,2,0.01,404,4
0.472,1e-05,254,250,100,2,0.01,504,4
0.472,1e-05,306,298,100,2,0.01,604,4
0.472,1e-05,349,355,100,2,0.01,704,4
0.472,1e-05,395,409,100,2,0.01,804,4
0.472,1e-05,439,465,100,2,0.01,904,4
0.472,1e-05,486,518,100,2,0.01,1004,4
0.472,1e-05,540,564,100,2,0.01,1104,4
0.472,1e-05,592,612,100,2,0.01,1204,4
0.472,1e-05,640,664,100,2,0.01,1304,4
0.472,1e-05,688,716,100,2,0.01,1404,4
0.472,1e-05,736,768,100,2,0.01,1504,4
0.472,1e-05,788,816,100,2,0.01,1604,4
0.472,1e-05,834,870,100,2,0.01,1704,4
0.57,1e-05,894,910,100,2,0.01,1804,4
0.566,1e-05,944,960,100,2,0.01,1904,4
0.578,1e-05,988,1016,100,2,0.01,2004,4
0.502,1e-05,54,50,100,2,0.01,104,5
0.52,1e-05,109,95,100,2,0.01,204,5
0.538,1e-05,162,142,100,2,0.01,304,5
0.562,1e-05,212,192,100,2,0.01,404,5
0.55,1e-05,269,235,100,2,0.01,504,5
0.56,1e-05,322,282,100,2,0.01,604,5
0.556,1e-05,362,342,100,2,0.01,704,5
0.556,1e-05,415,389,100,2,0.01,804,5
0.554,1e-05,469,435,100,2,0.01,904,5
0.562,1e-05,510,494,100,2,0.01,1004,5
0.584,1e-05,567,537,100,2,0.01,1104,5
0.598,1e-05,609,595,100,2,0.01,1204,5
0.638,1e-05,659,645,100,2,0.01,1304,5
0.65,1e-05,704,700,100,2,0.01,1404,5
0.644,1e-05,764,740,100,2,0.01,1504,5
0.666,1e-05,811,793,100,2,0.01,1604,5
0.67,1e-05,859,845,100,2,0.01,1704,5
0.678,1e-05,915,889,100,2,0.01,1804,5
0.696,1e-05,968,936,100,2,0.01,1904,5
0.71,1e-05,1011,993,100,2,0.01,2004,5
0.534,1e-05,44,60,100,2,0.01,104,6
0.536,1e-05,102,102,100,2,0.01,204,6
0.536,1e-05,148,156,100,2,0.01,304,6
0.538,1e-05,196,208,100,2,0.01,404,6
0.532,1e-05,250,254,100,2,0.01,504,6
0.538,1e-05,302,302,100,2,0.01,604,6
0.546,1e-05,354,350,100,2,0.01,704,6
0.572,1e-05,402,402,100,2,0.01,804,6
0.576,1e-05,450,454,100,2,0.01,904,6
0.594,1e-05,502,502,100,2,0.01,1004,6
0.604,1e-05,543,561,100,2,0.01,1104,6
0.606,1e-05,590,614,100,2,0.01,1204,6
0.584,1e-05,639,665,100,2,0.01,1304,6
0.584,1e-05,686,718,100,2,0.01,1404,6
0.566,1e-05,728,776,100,2,0.01,1504,6
0.57,1e-05,780,824,100,2,0.01,1604,6
0.558,1e-05,826,878,100,2,0.01,1704,6
0.568,1e-05,874,930,100,2,0.01,1804,6
0.562,1e-05,933,971,100,2,0.01,1904,6
0.562,1e-05,985,1019,100,2,0.01,2004,6
0.51,1e-05,60,44,100,2,0.01,104,7
0.518,1e-05,111,93,100,2,0.01,204,7
0.528,1e-05,168,136,100,2,0.01,304,7
0.52,1e-05,221,183,100,2,0.01,404,7
0.522,1e-05,268,236,100,2,0.01,504,7
0.52,1e-05,316,288,100,2,0.01,604,7
0.546,1e-05,360,344,100,2,0.01,704,7
0.544,1e-05,409,395,100,2,0.01,804,7
0.536,1e-05,459,445,100,2,0.01,904,7
0.53,1e-05,509,495,100,2,0.01,1004,7
0.526,1e-05,560,544,100,2,0.01,1104,7
0.522,1e-05,609,595,100,2,0.01,1204,7
0.54,1e-05,657,647,100,2,0.01,1304,7
0.544,1e-05,704,700,100,2,0.01,1404,7
0.552,1e-05,750,754,100,2,0.01,1504,7
0.566,1e-05,797,807,100,2,0.01,1604,7
0.586,1e-05,851,853,100,2,0.01,1704,7
0.588,1e-05,904,900,100,2,0.01,1804,7
0.576,1e-05,955,949,100,2,0.01,1904,7
0.6,1e-05,1001,1003,100,2,0.01,2004,7
0.552,1e-05,51,53,100,2,0.01,104,8
0.574,1e-05,102,102,100,2,0.01,204,8
0.562,1e-05,156,148,100,2,0.01,304,8
0.564,1e-05,211,193,100,2,0.01,404,8
0.57,1e-05,262,242,100,2,0.01,504,8
0.574,1e-05,311,293,100,2,0.01,604,8
0.578,1e-05,356,348,100,2,0.01,704,8
0.578,1e-05,404,400,100,2,0.01,804,8
0.564,1e-05,452,452,100,2,0.01,904,8
0.572,1e-05,499,505,100,2,0.01,1004,8
0.576,1e-05,548,556,100,2,0.01,1104,8
0.584,1e-05,605,599,100,2,0.01,1204,8
0.594,1e-05,653,651,100,2,0.01,1304,8
0.604,1e-05,696,708,100,2,0.01,1404,8
0.592,1e-05,744,760,100,2,0.01,1504,8
0.582,1e-05,790,814,100,2,0.01,1604,8
0.602,1e-05,844,860,100,2,0.01,1704,8
0.608,1e-05,893,911,100,2,0.01,1804,8
0.614,1e-05,946,958,100,2,0.01,1904,8
0.616,1e-05,992,1012,100,2,0.01,2004,8
0.486,1e-05,51,53,100,2,0.01,104,9
0.52,1e-05,104,100,100,2,0.01,204,9
0.538,1e-05,154,150,100,2,0.01,304,9
0.53,1e-05,206,198,100,2,0.01,404,9
0.544,1e-05,256,248,100,2,0.01,504,9
0.546,1e-05,301,303,100,2,0.01,604,9
0.54,1e-05,348,356,100,2,0.01,704,9
0.542,1e-05,396,408,100,2,0.01,804,9
0.56,1e-05,442,462,100,2,0.01,904,9
0.582,1e-05,496,508,100,2,0.01,1004,9
0.59,1e-05,542,562,100,2,0.01,1104,9
0.596,1e-05,599,605,100,2,0.01,1204,9
0.602,1e-05,648,656,100,2,0.01,1304,9
0.588,1e-05,691,713,100,2,0.01,1404,9
0.59,1e-05,741,763,100,2,0.01,1504,9
0.61,1e-05,793,811,100,2,0.01,1604,9
0.616,1e-05,849,855,100,2,0.01,1704,9
0.628,1e-05,898,906,100,2,0.01,1804,9
0.638,1e-05,949,955,100,2,0.01,1904,9
0.66,1e-05,1000,1004,100,2,0.01,2004,9
0.478,1e-05,59,45,100,2,0.01,104,10
0.478,1e-05,102,102,100,2,0.01,204,10
0.478,1e-05,147,157,100,2,0.01,304,10
0.484,1e-05,191,213,100,2,0.01,404,10
0.484,1e-05,243,261,100,2,0.01,504,10
0.49,1e-05,294,310,100,2,0.01,604,10
0.498,1e-05,343,361,100,2,0.01,704,10
0.528,1e-05,389,415,100,2,0.01,804,10
0.552,1e-05,444,460,100,2,0.01,904,10
0.568,1e-05,491,513,100,2,0.01,1004,10
0.574,1e-05,543,561,100,2,0.01,1104,10
0.602,1e-05,588,616,100,2,0.01,1204,10
0.634,1e-05,633,671,100,2,0.01,1304,10
0.668,1e-05,675,729,100,2,0.01,1404,10
0.708,1e-05,729,775,100,2,0.01,1504,10
0.738,1e-05,784,820,100,2,0.01,1604,10
0.768,1e-05,830,874,100,2,0.01,1704,10
0.798,1e-05,876,928,100,2,0.01,1804,10
0.82,1e-05,939,965,100,2,0.01,1904,10
0.85,1e-05,991,1013,100,2,0.01,2004,10
0.51,1e-05,43,61,100,2,0.01,104,11
0.512,1e-05,92,112,100,2,0.01,204,11
0.518,1e-05,139,165,100,2,0.01,304,11
0.528,1e-05,191,213,100,2,0.01,404,11
0.536,1e-05,242,262,100,2,0.01,504,11
0.552,1e-05,288,316,100,2,0.01,604,11
0.568,1e-05,342,362,100,2,0.01,704,11
0.606,1e-05,390,414,100,2,0.01,804,11
0.648,1e-05,439,465,100,2,0.01,904,11
0.664,1e-05,491,513,100,2,0.01,1004,11
0.682,1e-05,540,564,100,2,0.01,1104,11
0.696,1e-05,589,615,100,2,0.01,1204,11
0.744,1e-05,647,657,100,2,0.01,1304,11
0.778,1e-05,698,706,100,2,0.01,1404,11
0.79,1e-05,741,763,100,2,0.01,1504,11
0.82,1e-05,795,809,100,2,0.01,1604,11
0.836,1e-05,854,850,100,2,0.01,1704,11
0.848,1e-05,907,897,100,2,0.01,1804,11
0.854,1e-05,955,949,100,2,0.01,1904,11
0.854,1e-05,1004,1000,100,2,0.01,2004,11
0.496,1e-05,50,54,100,2,0.01,104,12
0.508,1e-05,104,100,100,2,0.01,204,12
0.51,1e-05,152,152,100,2,0.01,304,12
0.548,1e-05,199,205,100,2,0.01,404,12
0.536,1e-05,249,255,100,2,0.01,504,12
0.54,1e-05,304,300,100,2,0.01,604,12
0.524,1e-05,349,355,100,2,0.01,704,12
0.528,1e-05,405,399,100,2,0.01,804,12
0.532,1e-05,456,448,100,2,0.01,904,12
0.526,1e-05,501,503,100,2,0.01,1004,12
0.532,1e-05,548,556,100,2,0.01,1104,12
0.518,1e-05,592,612,100,2,0.01,1204,12
0.518,1e-05,639,665,100,2,0.01,1304,12
0.526,1e-05,692,712,100,2,0.01,1404,12
0.568,1e-05,738,766,100,2,0.01,1504,12
0.582,1e-05,786,818,100,2,0.01,1604,12
0.608,1e-05,837,867,100,2,0.01,1704,12
0.624,1e-05,895,909,100,2,0.01,1804,12
0.64,1e-05,949,955,100,2,0.01,1904,12
0.692,1e-05,1003,1001,100,2,0.01,2004,12
0.486,1e-05,51,53,100,2,0.01,104,13
0.496,1e-05,97,107,100,2,0.01,204,13
0.5,1e-05,154,150,100,2,0.01,304,13
0.504,1e-05,205,199,100,2,0.01,404,13
0.5,1e-05,255,249,100,2,0.01,504,13
0.498,1e-05,304,300,100,2,0.01,604,13
0.52,1e-05,359,345,100,2,0.01,704,13
0.524,1e-05,404,400,100,2,0.01,804,13
0.53,1e-05,462,442,100,2,0.01,904,13
0.548,1e-05,508,496,100,2,0.01,1004,13
0.548,1e-05,558,546,100,2,0.01,1104,13
0.548,1e-05,603,601,100,2,0.01,1204,13
0.564,1e-05,660,644,100,2,0.01,1304,13
0.578,1e-05,708,696,100,2,0.01,1404,13
0.59,1e-05,760,744,100,2,0.01,1504,13
0.596,1e-05,809,795,100,2,0.01,1604,13
0.614,1e-05,860,844,100,2,0.01,1704,13
0.626,1e-05,911,893,100,2,0.01,1804,13
0.638,1e-05,957,947,100,2,0.01,1904,13
0.656,1e-05,1009,995,100,2,0.01,2004,13
0.546,1e-05,52,52,100,2,0.01,104,14
0.558,1e-05,98,106,100,2,0.01,204,14
0.55,1e-05,143,161,100,2,0.01,304,14
0.58,1e-05,193,211,100,2,0.01,404,14
0.592,1e-05,238,266,100,2,0.01,504,14
0.604,1e-05,285,319,100,2,0.01,604,14
0.608,1e-05,330,374,100,2,0.01,704,14
0.61,1e-05,384,420,100,2,0.01,804,14
0.62,1e-05,438,466,100,2,0.01,904,14
0.63,1e-05,493,511,100,2,0.01,1004,14
0.622,1e-05,541,563,100,2,0.01,1104,14
0.652,1e-05,588,616,100,2,0.01,1204,14
0.654,1e-05,641,663,100,2,0.01,1304,14
0.676,1e-05,690,714,100,2,0.01,1404,14
0.682,1e-05,737,767,100,2,0.01,1504,14
0.698,1e-05,781,823,100,2,0.01,1604,14
0.708,1e-05,837,867,100,2,0.01,1704,14
0.716,1e-05,885,919,100,2,0.01,1804,14
0.72,1e-05,938,966,100,2,0.01,1904,14
0.726,1e-05,995,1009,100,2,0.01,2004,14
0.47,1e-05,45,59,100,2,0.01,104,15
0.47,1e-05,92,112,100,2,0.01,204,15
0.47,1e-05,136,168,100,2,0.01,304,15
0.47,1e-05,193,211,100,2,0.01,404,15
0.47,1e-05,235,269,100,2,0.01,504,15
0.47,1e-05,286,318,100,2,0.01,604,15
0.47,1e-05,349,355,100,2,0.01,704,15
0.47,1e-05,397,407,100,2,0.01,804,15
0.47,1e-05,449,455,100,2,0.01,904,15
0.47,1e-05,498,506,100,2,0.01,1004,15
0.47,1e-05,550,554,100,2,0.01,1104,15
0.47,1e-05,601,603,100,2,0.01,1204,15
0.47,1e-05,649,655,100,2,0.01,1304,15
0.47,1e-05,699,705,100,2,0.01,1404,15
0.47,1e-05,755,749,100,2,0.01,1504,15
0.47,1e-05,810,794,100,2,0.01,1604,15
0.47,1e-05,862,842,100,2,0.01,1704,15
0.47,1e-05,922,882,100,2,0.01,1804,15
0.47,1e-05,971,933,100,2,0.01,1904,15
0.47,1e-05,1017,987,100,2,0.01,2004,15
0.474,1e-05,54,50,100,2,0.01,104,16
0.47,1e-05,102,102,100,2,0.01,204,16
0.47,1e-05,162,142,100,2,0.01,304,16
0.48,1e-05,211,193,100,2,0.01,404,16
0.48,1e-05,255,249,100,2,0.01,504,16
0.484,1e-05,301,303,100,2,0.01,604,16
0.5,1e-05,348,356,100,2,0.01,704,16
0.508,1e-05,395,409,100,2,0.01,804,16
0.53,1e-05,443,461,100,2,0.01,904,16
0.554,1e-05,488,516,100,2,0.01,1004,16
0.55,1e-05,538,566,100,2,0.01,1104,16
0.56,1e-05,594,610,100,2,0.01,1204,16
0.57,1e-05,643,661,100,2,0.01,1304,16
0.582,1e-05,699,705,100,2,0.01,1404,16
0.598,1e-05,745,759,100,2,0.01,1504,16
0.618,1e-05,791,813,100,2,0.01,1604,16
0.616,1e-05,843,861,100,2,0.01,1704,16
0.644,1e-05,888,916,100,2,0.01,1804,16
0.644,1e-05,942,962,100,2,0.01,1904,16
0.656,1e-05,990,1014,100,2,0.01,2004,16
0.452,1e-05,53,51,100,2,0.01,104,17
0.464,1e-05,100,104,100,2,0.01,204,17
0.464,1e-05,144,160,100,2,0.01,304,17
0.452,1e-05,197,207,100,2,0.01,404,17
0.46,1e-05,246,258,100,2,0.01,504,17
0.472,1e-05,296,308,100,2,0.01,604,17
0.49,1e-05,351,353,100,2,0.01,704,17
0.498,1e-05,393,411,100,2,0.01,804,17
0.516,1e-05,439,465,100,2,0.01,904,17
0.534,1e-05,491,513,100,2,0.01,1004,17
0.55,1e-05,548,556,100,2,0.01,1104,17
0.558,1e-05,602,602,100,2,0.01,1204,17
0.58,1e-05,651,653,100,2,0.01,1304,17
0.588,1e-05,704,700,100,2,0.01,1404,17
0.59,1e-05,756,748,100,2,0.01,1504,17
0.602,1e-05,799,805,100,2,0.01,1604,17
0.596,1e-05,851,853,100,2,0.01,1704,17
0.652,1e-05,899,905,100,2,0.01,1804,17
0.656,1e-05,952,952,100,2,0.01,1904,17
0.704,1e-05,1004,1000,100,2,0.01,2004,17
0.494,1e-05,51,53,100,2,0.01,104,18
0.498,1e-05,90,114,100,2,0.01,204,18
0.5,1e-05,138,166,100,2,0.01,304,18
0.524,1e-05,184,220,100,2,0.01,404,18
0.512,1e-05,238,266,100,2,0.01,504,18
0.524,1e-05,284,320,100,2,0.01,604,18
0.522,1e-05,341,363,100,2,0.01,704,18
0.524,1e-05,394,410,100,2,0.01,804,18
0.524,1e-05,438,466,100,2,0.01,904,18
0.53,1e-05,480,524,100,2,0.01,1004,18
0.532,1e-05,543,561,100,2,0.01,1104,18
0.538,1e-05,589,615,100,2,0.01,1204,18
0.548,1e-05,636,668,100,2,0.01,1304,18
0.548,1e-05,680,724,100,2,0.01,1404,18
0.564,1e-05,734,770,100,2,0.01,1504,18
0.564,1e-05,779,825,100,2,0.01,1604,18
0.574,1e-05,840,864,100,2,0.01,1704,18
0.588,1e-05,887,917,100,2,0.01,1804,18
0.602,1e-05,938,966,100,2,0.01,1904,18
0.618,1e-05,994,1010,100,2,0.01,2004,18
0.524,1e-05,50,54,100,2,0.01,104,19
0.524,1e-05,98,106,100,2,0.01,204,19
0.524,1e-05,153,151,100,2,0.01,304,19
0.524,1e-05,206,198,100,2,0.01,404,19
0.524,1e-05,261,243,100,2,0.01,504,19
0.524,1e-05,312,292,100,2,0.01,604,19
0.524,1e-05,354,350,100,2,0.01,704,19
0.548,1e-05,405,399,100,2,0.01,804,19
0.576,1e-05,457,447,100,2,0.01,904,19
0.59,1e-05,511,493,100,2,0.01,1004,19
0.6,1e-05,560,544,100,2,0.01,1104,19
0.614,1e-05,603,601,100,2,0.01,1204,19
0.624,1e-05,648,656,100,2,0.01,1304,19
0.64,1e-05,703,701,100,2,0.01,1404,19
0.644,1e-05,753,751,100,2,0.01,1504,19
0.65,1e-05,799,805,100,2,0.01,1604,19
0.652,1e-05,848,856,100,2,0.01,1704,19
0.666,1e-05,893,911,100,2,0.01,1804,19
0.668,1e-05,942,962,100,2,0.01,1904,19
0.678,1e-05,990,1014,100,2,0.01,2004,19
0.48,1e-05,55,49,100,2,0.01,104,20
0.48,1e-05,111,93,100,2,0.01,204,20
0.48,1e-05,157,147,100,2,0.01,304,20
0.48,1e-05,204,200,100,2,0.01,404,20
0.48,1e-05,246,258,100,2,0.01,504,20
0.516,1e-05,307,297,100,2,0.01,604,20
0.534,1e-05,353,351,100,2,0.01,704,20
0.536,1e-05,401,403,100,2,0.01,804,20
0.554,1e-05,459,445,100,2,0.01,904,20
0.56,1e-05,514,490,100,2,0.01,1004,20
0.564,1e-05,562,542,100,2,0.01,1104,20
0.578,1e-05,608,596,100,2,0.01,1204,20
0.57,1e-05,657,647,100,2,0.01,1304,20
0.566,1e-05,710,694,100,2,0.01,1404,20
0.572,1e-05,747,757,100,2,0.01,1504,20
0.588,1e-05,799,805,100,2,0.01,1604,20
0.596,1e-05,847,857,100,2,0.01,1704,20
0.588,1e-05,893,911,100,2,0.01,1804,20
0.59,1e-05,943,961,100,2,0.01,1904,20
0.6,1e-05,992,1012,100,2,0.01,2004,20
0.5,0.0001,51,53,100,2,0.0001,104,1
0.5,0.0001,97,107,100,2,0.0001,204,1
0.5,0.0001,144,160,100,2,0.0001,304,1
0.5,0.0001,200,204,100,2,0.0001,404,1
0.5,0.0001,250,254,100,2,0.0001,504,1
0.5,0.0001,308,296,100,2,0.0001,604,1
0.5,0.0001,356,348,100,2,0.0001,704,1
0.5,0.0001,405,399,100,2,0.0001,804,1
0.5,0.0001,452,452,100,2,0.0001,904,1
0.5,0.0001,495,509,100,2,0.0001,1004,1
0.5,0.0001,550,554,100,2,0.0001,1104,1
0.5,0.0001,610,594,100,2,0.0001,1204,1
0.5,0.0001,657,647,100,2,0.0001,1304,1
0.5,0.0001,699,705,100,2,0.0001,1404,1
0.5,0.0001,746,758,100,2,0.0001,1504,1
0.5,0.0001,798,806,100,2,0.0001,1604,1
0.5,0.0001,849,855,100,2,0.0001,1704,1
0.5,0.0001,899,905,100,2,0.0001,1804,1
0.5,0.0001,954,950,100,2,0.0001,1904,1
0.5,0.0001,1002,1002,100,2,0.0001,2004,1
0.476,0.0001,59,45,100,2,0.0001,104,2
0.476,0.0001,115,89,100,2,0.0001,204,2
0.476,0.0001,165,139,100,2,0.0001,304,2
0.476,0.0001,214,190,100,2,0.0001,404,2
0.476,0.0001,257,247,100,2,0.0001,504,2
0.476,0.0001,305,299,100,2,0.0001,604,2
0.476,0.0001,350,354,100,2,0.0001,704,2
0.476,0.0001,406,398,100,2,0.0001,804,2
0.476,0.0001,444,460,100,2,0.0001,904,2
0.476,0.0001,495,509,100,2,0.0001,1004,2
0.476,0.0001,535,569,100,2,0.0001,1104,2
0.476,0.0001,579,625,100,2,0.0001,1204,2
0.476,0.0001,633,671,100,2,0.0001,1304,2
0.476,0.0001,677,727,100,2,0.0001,1404,2
0.476,0.0001,730,774,100,2,0.0001,1504,2
0.476,0.0001,783,821,100,2,0.0001,1604,2
0.476,0.0001,833,871,100,2,0.0001,1704,2
0.476,0.0001,882,922,100,2,0.0001,1804,2
0.476,0.0001,938,966,100,2,0.0001,1904,2
0.476,0.0001,990,1014,100,2,0.0001,2004,2
0.504,0.0001,44,60,100,2,0.0001,104,3
0.504,0.0001,100,104,100,2,0.0001,204,3
0.504,0.0001,150,154,100,2,0.0001,304,3
0.504,0.0001,200,204,100,2,0.0001,404,3
0.504,0.0001,245,259,100,2,0.0001,504,3
0.504,0.0001,298,306,100,2,0.0001,604,3
0.504,0.0001,353,351,100,2,0.0001,704,3
0.504,0.0001,401,403,100,2,0.0001,804,3
0.504,0.0001,453,451,100,2,0.0001,904,3
0.504,0.0001,505,499,100,2,0.0001,1004,3
0.504,0.0001,555,549,100,2,0.0001,1104,3
0.504,0.0001,602,602,100,2,0.0001,1204,3
0.504,0.0001,650,654,100,2,0.0001,1304,3
0.504,0.0001,698,706,100,2,0.0001,1404,3
0.504,0.0001,756,748,100,2,0.0001,1504,3
0.504,0.0001,803,801,100,2,0.0001,1604,3
0.504,0.0001,852,852,100,2,0.0001,1704,3
0.504,0.0001,905,899,100,2,0.0001,1804,3
0.504,0.0001,957,947,100,2,0.0001,1904,3
0.504,0.0001,1004,1000,100,2,0.0001,2004,3
0.518,0.0001,50,54,100,2,0.0001,104,4
0.518,0.0001,96,108,100,2,0.0001,204,4
0.518,0.0001,151,153,100,2,0.0001,304,4
0.518,0.0001,200,204,100,2,0.0001,404,4
0.518,0.0001,245,259,100,2,0.0001,504,4
0.518,0.0001,298,306,100,2,0.0001,604,4
0.518,0.0001,351,353,100,2,0.0001,704,4
0.518,0.0001,398,406,100,2,0.0001,804,4
0.518,0.0001,445,459,100,2,0.0001,904,4
0.518,0.0001,492,512,100,2,0.0001,1004,4
0.518,0.0001,538,566,100,2,0.0001,1104,4
0.518,0.0001,588,616,100,2,0.0001,1204,4
0.518,0.0001,638,666,100,2,0.0001,1304,4
0.518,0.0001,689,715,100,2,0.0001,1404,4
0.518,0.0001,743,761,100,2,0.0001,1504,4
0.518,0.0001,787,817,100,2,0.0001,1604,4
0.518,0.0001,838,866,100,2,0.0001,1704,4
0.518,0.0001,885,919,100,2,0.0001,1804,4
0.518,0.0001,943,961,100,2,0.0001,1904,4
0.518,0.0001,993,1011,100,2,0.0001,2004,4
0.504,0.0001,47,57,100,2,0.0001,104,5
0.504,0.0001,96,108,100,2,0.0001,204,5
0.504,0.0001,149,155,100,2,0.0001,304,5
0.504,0.0001,203,201,100,2,0.0001,404,5
0.504,0.0001,250,254,100,2,0.0001,504,5
0.504,0.0001,301,303,100,2,0.0001,604,5
0.504,0.0001,349,355,100,2,0.0001,704,5
0.504,0.0001,398,406,100,2,0.0001,804,5
0.504,0.0001,448,456,100,2,0.0001,904,5
0.504,0.0001,504,500,100,2,0.0001,1004,5
0.504,0.0001,556,548,100,2,0.0001,1104,5
0.504,0.0001,602,602,100,2,0.0001,1204,5
0.504,0.0001,648,656,100,2,0.0001,1304,5
0.504,0.0001,702,702,100,2,0.0001,1404,5
0.504,0.0001,761,743,100,2,0.0001,1504,5
0.504,0.0001,812,792,100,2,0.0001,1604,5
0.504,0.0001,860,844,100,2,0.0001,1704,5
0.504,0.0001,908,896,100,2,0.0001,1804,5
0.504,0.0001,956,948,100,2,0.0001,1904,5
0.504,0.0001,1000,1004,100,2,0.0001,2004,5
0.476,0.0001,57,47,100,2,0.0001,104,6
0.476,0.0001,98,106,100,2,0.0001,204,6
0.476,0.0001,149,155,100,2,0.0001,304,6
0.476,0.0001,203,201,100,2,0.0001,404,6
0.476,0.0001,251,253,100,2,0.0001,504,6
0.476,0.0001,305,299,100,2,0.0001,604,6
0.476,0.0001,360,344,100,2,0.0001,704,6
0.476,0.0001,409,395,100,2,0.0001,804,6
0.476,0.0001,459,445,100,2,0.0001,904,6
0.476,0.0001,506,498,100,2,0.0001,1004,6
0.476,0.0001,551,553,100,2,0.0001,1104,6
0.476,0.0001,596,608,100,2,0.0001,1204,6
0.476,0.0001,653,651,100,2,0.0001,1304,6
0.476,0.0001,696,708,100,2,0.0001,1404,6
0.476,0.0001,739,765,100,2,0.0001,1504,6
0.476,0.0001,787,817,100,2,0.0001,1604,6
0.476,0.0001,840,864,100,2,0.0001,1704,6
0.476,0.0001,896,908,100,2,0.0001,1804,6
0.476,0.0001,939,965,100,2,0.0001,1904,6
0.476,0.0001,990,1014,100,2,0.0001,2004,6
0.512,0.0001,48,56,100,2,0.0001,104,7
0.512,0.0001,98,106,100,2,0.0001,204,7
0.512,0.0001,150,154,100,2,0.0001,304,7
0.512,0.0001,203,201,100,2,0.0001,404,7
0.512,0.0001,258,246,100,2,0.0001,504,7
0.512,0.0001,309,295,100,2,0.0001,604,7
0.512,0.0001,360,344,100,2,0.0001,704,7
0.512,0.0001,411,393,100,2,0.0001,804,7
0.512,0.0001,458,446,100,2,0.0001,904,7
0.512,0.0001,507,497,100,2,0.0001,1004,7
0.512,0.0001,555,549,100,2,0.0001,1104,7
0.512,0.0001,603,601,100,2,0.0001,1204,7
0.512,0.0001,657,647,100,2,0.0001,1304,7
0.512,0.0001,703,701,100,2,0.0001,1404,7
0.512,0.0001,751,753,100,2,0.0001,1504,7
0.512,0.0001,792,812,100,2,0.0001,1604,7
0.512,0.0001,841,863,100,2,0.0001,1704,7
0.512,0.0001,893,911,100,2,0.0001,1804,7
0.512,0.0001,949,955,100,2,0.0001,1904,7
0.512,0.0001,996,1008,100,2,0.0001,2004,7
0.502,0.0001,36,68,100,2,0.0001,104,8
0.502,0.0001,88,116,100,2,0.0001,204,8
0.502,0.0001,139,165,100,2,0.0001,304,8
0.502,0.0001,191,213,100,2,0.0001,404,8
0.502,0.0001,236,268,100,2,0.0001,504,8
0.502,0.0001,293,311,100,2,0.0001,604,8
0.502,0.0001,342,362,100,2,0.0001,704,8
0.502,0.0001,401,403,100,2,0.0001,804,8
0.502,0.0001,444,460,100,2,0.0001,904,8
0.502,0.0001,493,511,100,2,0.0001,1004,8
0.502,0.0001,548,556,100,2,0.0001,1104,8
0.502,0.0001,601,603,100,2,0.0001,1204,8
0.504,0.0001,643,661,100,2,0.0001,1304,8
0.504,0.0001,691,713,100,2,0.0001,1404,8
0.504,0.0001,741,763,100,2,0.0001,1504,8
0.504,0.0001,784,820,100,2,0.0001,1604,8
0.504,0.0001,847,857,100,2,0.0001,1704,8
0.504,0.0001,895,909,100,2,0.0001,1804,8
0.504,0.0001,955,949,100,2,0.0001,1904,8
0.502,0.0001,1002,1002,100,2,0.0001,2004,8
0.47,0.0001,64,40,100,2,0.0001,104,9
0.47,0.0001,117,87,100,2,0.0001,204,9
0.47,0.0001,162,142,100,2,0.0001,304,9
0.47,0.0001,209,195,100,2,0.0001,404,9
0.47,0.0001,259,245,100,2,0.0001,504,9
0.47,0.0001,310,294,100,2,0.0001,604,9
0.47,0.0001,365,339,100,2,0.0001,704,9
0.47,0.0001,414,390,100,2,0.0001,804,9
0.47,0.0001,462,442,100,2,0.0001,904,9
0.47,0.0001,508,496,100,2,0.0001,1004,9
0.47,0.0001,563,541,100,2,0.0001,1104,9
0.47,0.0001,616,588,100,2,0.0001,1204,9
0.47,0.0001,660,644,100,2,0.0001,1304,9
0.47,0.0001,712,692,100,2,0.0001,1404,9
0.47,0.0001,754,750,100,2,0.0001,1504,9
0.47,0.0001,804,800,100,2,0.0001,1604,9
0.47,0.0001,854,850,100,2,0.0001,1704,9
0.47,0.0001,909,895,100,2,0.0001,1804,9
0.47,0.0001,965,939,100,2,0.0001,1904,9
0.472,0.0001,1021,983,100,2,0.0001,2004,9
0.494,0.0001,48,56,100,2,0.0001,104,10
0.494,0.0001,100,104,100,2,0.0001,204,10
0.494,0.0001,152,152,100,2,0.0001,304,10
0.494,0.0001,197,207,100,2,0.0001,404,10
0.494,0.0001,244,260,100,2,0.0001,504,10
0.494,0.0001,297,307,100,2,0.0001,604,10
0.494,0.0001,341,363,100,2,0.0001,704,10
0.494,0.0001,389,415,100,2,0.0001,804,10
0.494,0.0001,448,456,100,2,0.0001,904,10
0.494,0.0001,499,505,100,2,0.0001,1004,10
0.494,0.0001,552,552,100,2,0.0001,1104,10
0.494,0.0001,597,607,100,2,0.0001,1204,10
0.494,0.0001,644,660,100,2,0.0001,1304,10
0.494,0.0001,694,710,100,2,0.0001,1404,10
0.494,0.0001,744,760,100,2,0.0001,1504,10
0.494,0.0001,787,817,100,2,0.0001,1604,10
0.494,0.0001,839,865,100,2,0.0001,1704,10
0.494,0.0001,903,901,100,2,0.0001,1804,10
0.494,0.0001,948,956,100,2,0.0001,1904,10
0.494,0.0001,999,1005,100,2,0.0001,2004,10
0.49,0.0001,54,50,100,2,0.0001,104,11
0.49,0.0001,100,104,100,2,0.0001,204,11
0.49,0.0001,150,154,100,2,0.0001,304,11
0.49,0.0001,200,204,100,2,0.0001,404,11
0.49,0.0001,253,251,100,2,0.0001,504,11
0.49,0.0001,311,293,100,2,0.0001,604,11
0.492,0.0001,369,335,100,2,0.0001,704,11
0.492,0.0001,416,388,100,2,0.0001,804,11
0.492,0.0001,461,443,100,2,0.0001,904,11
0.492,0.0001,511,493,100,2,0.0001,1004,11
0.492,0.0001,568,536,100,2,0.0001,1104,11
0.492,0.0001,603,601,100,2,0.0001,1204,11
0.492,0.0001,656,648,100,2,0.0001,1304,11
0.494,0.0001,705,699,100,2,0.0001,1404,11
0.494,0.0001,749,755,100,2,0.0001,1504,11
0.496,0.0001,797,807,100,2,0.0001,1604,11
0.496,0.0001,857,847,100,2,0.0001,1704,11
0.496,0.0001,907,897,100,2,0.0001,1804,11
0.496,0.0001,955,949,100,2,0.0001,1904,11
0.496,0.0001,1002,1002,100,2,0.0001,2004,11
0.5,0.0001,52,52,100,2,0.0001,104,12
0.5,0.0001,98,106,100,2,0.0001,204,12
0.5,0.0001,147,157,100,2,0.0001,304,12
0.5,0.0001,197,207,100,2,0.0001,404,12
0.498,0.0001,241,263,100,2,0.0001,504,12
0.498,0.0001,291,313,100,2,0.0001,604,12
0.498,0.0001,337,367,100,2,0.0001,704,12
0.498,0.0001,390,414,100,2,0.0001,804,12
0.498,0.0001,447,457,100,2,0.0001,904,12
0.498,0.0001,506,498,100,2,0.0001,1004,12
0.498,0.0001,547,557,100,2,0.0001,1104,12
0.498,0.0001,603,601,100,2,0.0001,1204,12
0.498,0.0001,650,654,100,2,0.0001,1304,12
0.498,0.0001,698,706,100,2,0.0001,1404,12
0.496,0.0001,747,757,100,2,0.0001,1504,12
0.496,0.0001,800,804,100,2,0.0001,1604,12
0.498,0.0001,850,854,100,2,0.0001,1704,12
0.498,0.0001,906,898,100,2,0.0001,1804,12
0.498,0.0001,956,948,100,2,0.0001,1904,12
0.498,0.0001,1002,1002,100,2,0.0001,2004,12
0.52,0.0001,59,45,100,2,0.0001,104,13
0.52,0.0001,101,103,100,2,0.0001,204,13
0.52,0.0001,149,155,100,2,0.0001,304,13
0.52,0.0001,193,211,100,2,0.0001,404,13
0.52,0.0001,240,264,100,2,0.0001,504,13
0.52,0.0001,282,322,100,2,0.0001,604,13
0.52,0.0001,333,371,100,2,0.0001,704,13
0.52,0.0001,388,416,100,2,0.0001,804,13
0.52,0.0001,436,468,100,2,0.0001,904,13
0.52,0.0001,490,514,100,2,0.0001,1004,13
0.52,0.0001,538,566,100,2,0.0001,1104,13
0.52,0.0001,585,619,100,2,0.0001,1204,13
0.52,0.0001,640,664,100,2,0.0001,1304,13
0.52,0.0001,695,709,100,2,0.0001,1404,13
0.52,0.0001,744,760,100,2,0.0001,1504,13
0.52,0.0001,791,813,100,2,0.0001,1604,13
0.52,0.0001,844,860,100,2,0.0001,1704,13
0.52,0.0001,899,905,100,2,0.0001,1804,13
0.52,0.0001,957,947,100,2,0.0001,1904,13
0.52,0.0001,1012,992,100,2,0.0001,2004,13
0.528,0.0001,50,54,100,2,0.0001,104,14
0.528,0.0001,106,98,100,2,0.0001,204,14
0.528,0.0001,152,152,100,2,0.0001,304,14
0.528,0.0001,195,209,100,2,0.0001,404,14
0.528,0.0001,235,269,100,2,0.0001,504,14
0.528,0.0001,278,326,100,2,0.0001,604,14
0.528,0.0001,337,367,100,2,0.0001,704,14
0.528,0.0001,392,412,100,2,0.0001,804,14
0.528,0.0001,446,458,100,2,0.0001,904,14
0.528,0.0001,496,508,100,2,0.0001,1004,14
0.528,0.0001,539,565,100,2,0.0001,1104,14
0.528,0.0001,598,606,100,2,0.0001,1204,14
0.528,0.0001,650,654,100,2,0.0001,1304,14
0.528,0.0001,701,703,100,2,0.0001,1404,14
0.528,0.0001,748,756,100,2,0.0001,1504,14
0.528,0.0001,806,798,100,2,0.0001,1604,14
0.528,0.0001,852,852,100,2,0.0001,1704,14
0.528,0.0001,903,901,100,2,0.0001,1804,14
0.528,0.0001,961,943,100,2,0.0001,1904,14
0.528,0.0001,1016,988,100,2,0.0001,2004,14
0.49,0.0001,51,53,100,2,0.0001,104,15
0.49,0.0001,94,110,100,2,0.0001,204,15
0.49,0.0001,144,160,100,2,0.0001,304,15
0.49,0.0001,192,212,100,2,0.0001,404,15
0.49,0.0001,245,259,100,2,0.0001,504,15
0.49,0.0001,297,307,100,2,0.0001,604,15
0.49,0.0001,346,358,100,2,0.0001,704,15
0.49,0.0001,401,403,100,2,0.0001,804,15
0.49,0.0001,450,454,100,2,0.0001,904,15
0.49,0.0001,496,508,100,2,0.0001,1004,15
0.49,0.0001,547,557,100,2,0.0001,1104,15
0.49,0.0001,597,607,100,2,0.0001,1204,15
0.49,0.0001,656,648,100,2,0.0001,1304,15
0.49,0.0001,702,702,100,2,0.0001,1404,15
0.49,0.0001,750,754,100,2,0.0001,1504,15
0.492,0.0001,800,804,100,2,0.0001,1604,15
0.492,0.0001,856,848,100,2,0.0001,1704,15
0.494,0.0001,907,897,100,2,0.0001,1804,15
0.494,0.0001,961,943,100,2,0.0001,1904,15
0.496,0.0001,1010,994,100,2,0.0001,2004,15
0.502,0.0001,48,56,100,2,0.0001,104,16
0.502,0.0001,90,114,100,2,0.0001,204,16
0.502,0.0001,142,162,100,2,0.0001,304,16
0.502,0.0001,194,210,100,2,0.0001,404,16
0.502,0.0001,240,264,100,2,0.0001,504,16
0.502,0.0001,293,311,100,2,0.0001,604,16
0.502,0.0001,350,354,100,2,0.0001,704,16
0.502,0.0001,395,409,100,2,0.0001,804,16
0.502,0.0001,448,456,100,2,0.0001,904,16
0.502,0.0001,501,503,100,2,0.0001,1004,16
0.502,0.0001,555,549,100,2,0.0001,1104,16
0.502,0.0001,596,608,100,2,0.0001,1204,16
0.502,0.0001,657,647,100,2,0.0001,1304,16
0.502,0.0001,706,698,100,2,0.0001,1404,16
0.502,0.0001,754,750,100,2,0.0001,1504,16
0.502,0.0001,803,801,100,2,0.0001,1604,16
0.502,0.0001,845,859,100,2,0.0001,1704,16
0.502,0.0001,903,901,100,2,0.0001,1804,16
0.504,0.0001,958,946,100,2,0.0001,1904,16
0.506,0.0001,1011,993,100,2,0.0001,2004,16
0.464,0.0001,50,54,100,2,0.0001,104,17
0.464,0.0001,105,99,100,2,0.0001,204,17
0.462,0.0001,153,151,100,2,0.0001,304,17
0.462,0.0001,200,204,100,2,0.0001,404,17
0.462,0.0001,249,255,100,2,0.0001,504,17
0.462,0.0001,294,310,100,2,0.0001,604,17
0.462,0.0001,342,362,100,2,0.0001,704,17
0.462,0.0001,396,408,100,2,0.0001,804,17
0.462,0.0001,445,459,100,2,0.0001,904,17
0.462,0.0001,481,523,100,2,0.0001,1004,17
0.462,0.0001,537,567,100,2,0.0001,1104,17
0.462,0.0001,597,607,100,2,0.0001,1204,17
0.462,0.0001,645,659,100,2,0.0001,1304,17
0.462,0.0001,702,702,100,2,0.0001,1404,17
0.462,0.0001,751,753,100,2,0.0001,1504,17
0.462,0.0001,800,804,100,2,0.0001,1604,17
0.462,0.0001,851,853,100,2,0.0001,1704,17
0.462,0.0001,913,891,100,2,0.0001,1804,17
0.462,0.0001,964,940,100,2,0.0001,1904,17
0.462,0.0001,1016,988,100,2,0.0001,2004,17
0.494,0.0001,51,53,100,2,0.0001,104,18
0.494,0.0001,104,100,100,2,0.0001,204,18
0.494,0.0001,153,151,100,2,0.0001,304,18
0.494,0.0001,193,211,100,2,0.0001,404,18
0.494,0.0001,246,258,100,2,0.0001,504,18
0.494,0.0001,297,307,100,2,0.0001,604,18
0.494,0.0001,354,350,100,2,0.0001,704,18
0.494,0.0001,413,391,100,2,0.0001,804,18
0.494,0.0001,470,434,100,2,0.0001,904,18
0.494,0.0001,527,477,100,2,0.0001,1004,18
0.494,0.0001,566,538,100,2,0.0001,1104,18
0.494,0.0001,620,584,100,2,0.0001,1204,18
0.494,0.0001,665,639,100,2,0.0001,1304,18
0.494,0.0001,718,686,100,2,0.0001,1404,18
0.496,0.0001,776,728,100,2,0.0001,1504,18
0.498,0.0001,821,783,100,2,0.0001,1604,18
0.498,0.0001,871,833,100,2,0.0001,1704,18
0.498,0.0001,915,889,100,2,0.0001,1804,18
0.498,0.0001,954,950,100,2,0.0001,1904,18
0.498,0.0001,1001,1003,100,2,0.0001,2004,18
0.518,0.0001,54,50,100,2,0.0001,104,19
0.518,0.0001,105,99,100,2,0.0001,204,19
0.518,0.0001,156,148,100,2,0.0001,304,19
0.518,0.0001,206,198,100,2,0.0001,404,19
0.518,0.0001,253,251,100,2,0.0001,504,19
0.518,0.0001,304,300,100,2,0.0001,604,19
0.518,0.0001,358,346,100,2,0.0001,704,19
0.518,0.0001,404,400,100,2,0.0001,804,19
0.518,0.0001,451,453,100,2,0.0001,904,19
0.518,0.0001,502,502,100,2,0.0001,1004,19
0.518,0.0001,556,548,100,2,0.0001,1104,19
0.518,0.0001,607,597,100,2,0.0001,1204,19
0.518,0.0001,656,648,100,2,0.0001,1304,19
0.518,0.0001,708,696,100,2,0.0001,1404,19
0.518,0.0001,757,747,100,2,0.0001,1504,19
0.518,0.0001,811,793,100,2,0.0001,1604,19
0.518,0.0001,856,848,100,2,0.0001,1704,19
0.518,0.0001,913,891,100,2,0.0001,1804,19
0.518,0.0001,959,945,100,2,0.0001,1904,19
0.518,0.0001,1011,993,100,2,0.0001,2004,19
0.512,0.0001,52,52,100,2,0.0001,104,20
0.512,0.0001,107,97,100,2,0.0001,204,20
0.512,0.0001,154,150,100,2,0.0001,304,20
0.512,0.0001,206,198,100,2,0.0001,404,20
0.512,0.0001,263,241,100,2,0.0001,504,20
0.512,0.0001,313,291,100,2,0.0001,604,20
0.512,0.0001,364,340,100,2,0.0001,704,20
0.512,0.0001,418,386,100,2,0.0001,804,20
0.512,0.0001,464,440,100,2,0.0001,904,20
0.512,0.0001,512,492,100,2,0.0001,1004,20
0.512,0.0001,564,540,100,2,0.0001,1104,20
0.512,0.0001,608,596,100,2,0.0001,1204,20
0.512,0.0001,658,646,100,2,0.0001,1304,20
0.512,0.0001,712,692,100,2,0.0001,1404,20
0.512,0.0001,749,755,100,2,0.0001,1504,20
0.512,0.0001,796,808,100,2,0.0001,1604,20
0.512,0.0001,853,851,100,2,0.0001,1704,20
0.512,0.0001,899,905,100,2,0.0001,1804,20
0.512,0.0001,947,957,100,2,0.0001,1904,20
0.512,0.0001,996,1008,100,2,0.0001,2004,20
0.514,0.0001,51,53,100,2,0.001,104,1
0.514,0.0001,111,93,100,2,0.001,204,1
0.514,0.0001,159,145,100,2,0.001,304,1
0.514,0.0001,206,198,100,2,0.001,404,1
0.512,0.0001,256,248,100,2,0.001,504,1
0.514,0.0001,308,296,100,2,0.001,604,1
0.518,0.0001,362,342,100,2,0.001,704,1
0.52,0.0001,411,393,100,2,0.001,804,1
0.522,0.0001,461,443,100,2,0.001,904,1
0.532,0.0001,515,489,100,2,0.001,1004,1
0.54,0.0001,570,534,100,2,0.001,1104,1
0.546,0.0001,608,596,100,2,0.001,1204,1
0.546,0.0001,659,645,100,2,0.001,1304,1
0.552,0.0001,703,701,100,2,0.001,1404,1
0.548,0.0001,753,751,100,2,0.001,1504,1
0.546,0.0001,800,804,100,2,0.001,1604,1
0.556,0.0001,857,847,100,2,0.001,1704,1
0.558,0.0001,910,894,100,2,0.001,1804,1
0.564,0.0001,950,954,100,2,0.001,1904,1
0.57,0.0001,996,1008,100,2,0.001,2004,1
0.468,0.0001,56,48,100,2,0.001,104,2
0.468,0.0001,111,93,100,2,0.001,204,2
0.468,0.0001,148,156,100,2,0.001,304,2
0.468,0.0001,203,201,100,2,0.001,404,2
0.468,0.0001,248,256,100,2,0.001,504,2
0.498,0.0001,290,314,100,2,0.001,604,2
0.494,0.0001,337,367,100,2,0.001,704,2
0.498,0.0001,386,418,100,2,0.001,804,2
0.498,0.0001,437,467,100,2,0.001,904,2
0.494,0.0001,489,515,100,2,0.001,1004,2
0.498,0.0001,540,564,100,2,0.001,1104,2
0.502,0.0001,585,619,100,2,0.001,1204,2
0.502,0.0001,638,666,100,2,0.001,1304,2
0.506,0.0001,693,711,100,2,0.001,1404,2
0.508,0.0001,729,775,100,2,0.001,1504,2
0.512,0.0001,780,824,100,2,0.001,1604,2
0.512,0.0001,834,870,100,2,0.001,1704,2
0.506,0.0001,885,919,100,2,0.001,1804,2
0.524,0.0001,938,966,100,2,0.001,1904,2
0.528,0.0001,986,1018,100,2,0.001,2004,2
0.504,0.0001,49,55,100,2,0.001,104,3
0.504,0.0001,99,105,100,2,0.001,204,3
0.504,0.0001,153,151,100,2,0.001,304,3
0.504,0.0001,201,203,100,2,0.001,404,3
0.506,0.0001,251,253,100,2,0.001,504,3
0.51,0.0001,304,300,100,2,0.001,604,3
0.51,0.0001,350,354,100,2,0.001,704,3
0.514,0.0001,403,401,100,2,0.001,804,3
0.514,0.0001,449,455,100,2,0.001,904,3
0.514,0.0001,500,504,100,2,0.001,1004,3
0.514,0.0001,569,535,100,2,0.001,1104,3
0.514,0.0001,619,585,100,2,0.001,1204,3
0.516,0.0001,659,645,100,2,0.001,1304,3
0.52,0.0001,708,696,100,2,0.001,1404,3
0.522,0.0001,764,740,100,2,0.001,1504,3
0.52,0.0001,811,793,100,2,0.001,1604,3
0.522,0.0001,860,844,100,2,0.001,1704,3
0.526,0.0001,911,893,100,2,0.001,1804,3
0.526,0.0001,960,944,100,2,0.001,1904,3
0.536,0.0001,1009,995,100,2,0.001,2004,3
0.522,0.0001,57,47,100,2,0.001,104,4
0.522,0.0001,105,99,100,2,0.001,204,4
0.522,0.0001,150,154,100,2,0.001,304,4
0.522,0.0001,194,210,100,2,0.001,404,4
0.522,0.0001,242,262,100,2,0.001,504,4
0.522,0.0001,290,314,100,2,0.001,604,4
0.522,0.0001,345,359,100,2,0.001,704,4
0.522,0.0001,390,414,100,2,0.001,804,4
0.522,0.0001,451,453,100,2,0.001,904,4
0.522,0.0001,507,497,100,2,0.001,1004,4
0.522,0.0001,562,542,100,2,0.001,1104,4
0.522,0.0001,607,597,100,2,0.001,1204,4
0.522,0.0001,663,641,100,2,0.001,1304,4
0.522,0.0001,710,694,100,2,0.001,1404,4
0.522,0.0001,754,750,100,2,0.001,1504,4
0.522,0.0001,812,792,100,2,0.001,1604,4
0.522,0.0001,866,838,100,2,0.001,1704,4
0.522,0.0001,914,890,100,2,0.001,1804,4
0.522,0.0001,967,937,100,2,0.001,1904,4
0.522,0.0001,1013,991,100,2,0.001,2004,4
0.534,0.0001,55,49,100,2,0.001,104,5
0.538,0.0001,110,94,100,2,0.001,204,5
0.538,0.0001,157,147,100,2,0.001,304,5
0.54,0.0001,204,200,100,2,0.001,404,5
0.54,0.0001,258,246,100,2,0.001,504,5
0.538,0.0001,314,290,100,2,0.001,604,5
0.54,0.0001,363,341,100,2,0.001,704,5
0.55,0.0001,411,393,100,2,0.001,804,5
0.55,0.0001,460,444,100,2,0.001,904,5
0.55,0.0001,514,490,100,2,0.001,1004,5
0.548,0.0001,566,538,100,2,0.001,1104,5
0.542,0.0001,610,594,100,2,0.001,1204,5
0.544,0.0001,664,640,100,2,0.001,1304,5
0.55,0.0001,714,690,100,2,0.001,1404,5
0.558,0.0001,760,744,100,2,0.001,1504,5
0.562,0.0001,808,796,100,2,0.001,1604,5
0.57,0.0001,862,842,100,2,0.001,1704,5
0.574,0.0001,913,891,100,2,0.001,1804,5
0.574,0.0001,958,946,100,2,0.001,1904,5
0.578,0.0001,1007,997,100,2,0.001,2004,5
0.464,0.0001,59,45,100,2,0.001,104,6
0.464,0.0001,109,95,100,2,0.001,204,6
0.464,0.0001,156,148,100,2,0.001,304,6
0.464,0.0001,206,198,100,2,0.001,404,6
0.464,0.0001,252,252,100,2,0.001,504,6
0.464,0.0001,299,305,100,2,0.001,604,6
0.464,0.0001,350,354,100,2,0.001,704,6
0.464,0.0001,407,397,100,2,0.001,804,6
0.464,0.0001,458,446,100,2,0.001,904,6
0.464,0.0001,500,504,100,2,0.001,1004,6
0.464,0.0001,553,551,100,2,0.001,1104,6
0.464,0.0001,604,600,100,2,0.001,1204,6
0.464,0.0001,664,640,100,2,0.001,1304,6
0.464,0.0001,710,694,100,2,0.001,1404,6
0.464,0.0001,765,739,100,2,0.001,1504,6
0.464,0.0001,816,788,100,2,0.001,1604,6
0.464,0.0001,868,836,100,2,0.001,1704,6
0.464,0.0001,923,881,100,2,0.001,1804,6
0.464,0.0001,970,934,100,2,0.001,1904,6
0.464,0.0001,1020,984,100,2,0.001,2004,6
0.488,0.0001,56,48,100,2,0.001,104,7
0.49,0.0001,94,110,100,2,0.001,204,7
0.496,0.0001,146,158,100,2,0.001,304,7
0.494,0.0001,201,203,100,2,0.001,404,7
0.492,0.0001,249,255,100,2,0.001,504,7
0.494,0.0001,285,319,100,2,0.001,604,7
0.5,0.0001,339,365,100,2,0.001,704,7
0.506,0.0001,389,415,100,2,0.001,804,7
0.504,0.0001,443,461,100,2,0.001,904,7
0.506,0.0001,491,513,100,2,0.001,1004,7
0.514,0.0001,544,560,100,2,0.001,1104,7
0.516,0.0001,593,611,100,2,0.001,1204,7
0.518,0.0001,639,665,100,2,0.001,1304,7
0.518,0.0001,698,706,100,2,0.001,1404,7
0.518,0.0001,756,748,100,2,0.001,1504,7
0.518,0.0001,800,804,100,2,0.001,1604,7
0.524,0.0001,850,854,100,2,0.001,1704,7
0.524,0.0001,899,905,100,2,0.001,1804,7
0.528,0.0001,945,959,100,2,0.001,1904,7
0.532,0.0001,996,1008,100,2,0.001,2004,7
0.488,0.0001,49,55,100,2,0.001,104,8
0.488,0.0001,104,100,100,2,0.001,204,8
0.488,0.0001,157,147,100,2,0.001,304,8
0.488,0.0001,200,204,100,2,0.001,404,8
0.488,0.0001,251,253,100,2,0.001,504,8
0.488,0.0001,302,302,100,2,0.001,604,8
0.488,0.0001,350,354,100,2,0.001,704,8
0.488,0.0001,396,408,100,2,0.001,804,8
0.488,0.0001,449,455,100,2,0.001,904,8
0.488,0.0001,495,509,100,2,0.001,1004,8
0.488,0.0001,547,557,100,2,0.001,1104,8
0.488,0.0001,601,603,100,2,0.001,1204,8
0.488,0.0001,653,651,100,2,0.001,1304,8
0.488,0.0001,703,701,100,2,0.001,1404,8
0.488,0.0001,755,749,100,2,0.001,1504,8
0.488,0.0001,803,801,100,2,0.001,1604,8
0.488,0.0001,851,853,100,2,0.001,1704,8
0.488,0.0001,903,901,100,2,0.001,1804,8
0.488,0.0001,961,943,100,2,0.001,1904,8
0.488,0.0001,1008,996,100,2,0.001,2004,8
0.51,0.0001,54,50,100,2,0.001,104,9
0.51,0.0001,108,96,100,2,0.001,204,9
0.51,0.0001,156,148,100,2,0.001,304,9
0.51,0.0001,206,198,100,2,0.001,404,9
0.51,0.0001,254,250,100,2,0.001,504,9
0.51,0.0001,306,298,100,2,0.001,604,9
0.51,0.0001,352,352,100,2,0.001,704,9
0.51,0.0001,397,407,100,2,0.001,804,9
0.51,0.0001,444,460,100,2,0.001,904,9
0.51,0.0001,491,513,100,2,0.001,1004,9
0.51,0.0001,537,567,100,2,0.001,1104,9
0.51,0.0001,587,617,100,2,0.001,1204,9
0.51,0.0001,638,666,100,2,0.001,1304,9
0.51,0.0001,690,714,100,2,0.001,1404,9
0.51,0.0001,741,763,100,2,0.001,1504,9
0.51,0.0001,785,819,100,2,0.001,1604,9
0.51,0.0001,849,855,100,2,0.001,1704,9
0.51,0.0001,902,902,100,2,0.001,1804,9
0.51,0.0001,951,953,100,2,0.001,1904,9
0.512,0.0001,997,1007,100,2,0.001,2004,9
0.486,0.0001,50,54,100,2,0.001,104,10
0.492,0.0001,93,111,100,2,0.001,204,10
0.494,0.0001,147,157,100,2,0.001,304,10
0.496,0.0001,198,206,100,2,0.001,404,10
0.498,0.0001,245,259,100,2,0.001,504,10
0.498,0.0001,298,306,100,2,0.001,604,10
0.5,0.0001,345,359,100,2,0.001,704,10
0.492,0.0001,399,405,100,2,0.001,804,10
0.49,0.0001,455,449,100,2,0.001,904,10
0.498,0.0001,505,499,100,2,0.001,1004,10
0.506,0.0001,551,553,100,2,0.001,1104,10
0.506,0.0001,609,595,100,2,0.001,1204,10
0.508,0.0001,656,648,100,2,0.001,1304,10
0.51,0.0001,704,700,100,2,0.001,1404,10
0.51,0.0001,755,749,100,2,0.001,1504,10
0.506,0.0001,802,802,100,2,0.001,1604,10
0.498,0.0001,851,853,100,2,0.001,1704,10
0.496,0.0001,912,892,100,2,0.001,1804,10
0.502,0.0001,960,944,100,2,0.001,1904,10
0.498,0.0001,1004,1000,100,2,0.001,2004,10
0.496,0.0001,49,55,100,2,0.001,104,11
0.496,0.0001,111,93,100,2,0.001,204,11
0.498,0.0001,168,136,100,2,0.001,304,11
0.502,0.0001,226,178,100,2,0.001,404,11
0.502,0.0001,277,227,100,2,0.001,504,11
0.504,0.0001,328,276,100,2,0.001,604,11
0.506,0.0001,381,323,100,2,0.001,704,11
0.508,0.0001,424,380,100,2,0.001,804,11
0.512,0.0001,474,430,100,2,0.001,904,11
0.516,0.0001,521,483,100,2,0.001,1004,11
0.512,0.0001,575,529,100,2,0.001,1104,11
0.514,0.0001,636,568,100,2,0.001,1204,11
0.508,0.0001,674,630,100,2,0.001,1304,11
0.514,0.0001,722,682,100,2,0.001,1404,11
0.516,0.0001,768,736,100,2,0.001,1504,11
0.514,0.0001,827,777,100,2,0.001,1604,11
0.53,0.0001,876,828,100,2,0.001,1704,11
0.532,0.0001,922,882,100,2,0.001,1804,11
0.532,0.0001,960,944,100,2,0.001,1904,11
0.548,0.0001,1014,990,100,2,0.001,2004,11
0.504,0.0001,54,50,100,2,0.001,104,12
0.504,0.0001,95,109,100,2,0.001,204,12
0.504,0.0001,144,160,100,2,0.001,304,12
0.504,0.0001,184,220,100,2,0.001,404,12
0.504,0.0001,236,268,100,2,0.001,504,12
0.504,0.0001,281,323,100,2,0.001,604,12
0.504,0.0001,330,374,100,2,0.001,704,12
0.504,0.0001,382,422,100,2,0.001,804,12
0.504,0.0001,438,466,100,2,0.001,904,12
0.504,0.0001,488,516,100,2,0.001,1004,12
0.504,0.0001,535,569,100,2,0.001,1104,12
0.504,0.0001,586,618,100,2,0.001,1204,12
0.504,0.0001,632,672,100,2,0.001,1304,12
0.504,0.0001,684,720,100,2,0.001,1404,12
0.504,0.0001,736,768,100,2,0.001,1504,12
0.504,0.0001,791,813,100,2,0.001,1604,12
0.504,0.0001,843,861,100,2,0.001,1704,12
0.504,0.0001,899,905,100,2,0.001,1804,12
0.504,0.0001,953,951,100,2,0.001,1904,12
0.504,0.0001,1000,1004,100,2,0.001,2004,12
0.516,0.0001,57,47,100,2,0.001,104,13
0.514,0.0001,104,100,100,2,0.001,204,13
0.514,0.0001,148,156,100,2,0.001,304,13
0.51,0.0001,194,210,100,2,0.001,404,13
0.512,0.0001,233,271,100,2,0.001,504,13
0.51,0.0001,280,324,100,2,0.001,604,13
0.512,0.0001,333,371,100,2,0.001,704,13
0.508,0.0001,385,419,100,2,0.001,804,13
0.51,0.0001,443,461,100,2,0.001,904,13
0.51,0.0001,494,510,100,2,0.001,1004,13
0.51,0.0001,546,558,100,2,0.001,1104,13
0.516,0.0001,597,607,100,2,0.001,1204,13
0.516,0.0001,643,661,100,2,0.001,1304,13
0.518,0.0001,693,711,100,2,0.001,1404,13
0.516,0.0001,743,761,100,2,0.001,1504,13
0.522,0.0001,792,812,100,2,0.001,1604,13
0.528,0.0001,837,867,100,2,0.001,1704,13
0.528,0.0001,890,914,100,2,0.001,1804,13
0.536,0.0001,947,957,100,2,0.001,1904,13
0.55,0.0001,1005,999,100,2,0.001,2004,13
0.502,0.0001,46,58,100,2,0.001,104,14
0.502,0.0001,96,108,100,2,0.001,204,14
0.502,0.0001,150,154,100,2,0.001,304,14
0.502,0.0001,193,211,100,2,0.001,404,14
0.502,0.0001,249,255,100,2,0.001,504,14
0.51,0.0001,302,302,100,2,0.001,604,14
0.518,0.0001,349,355,100,2,0.001,704,14
0.528,0.0001,403,401,100,2,0.001,804,14
0.532,0.0001,447,457,100,2,0.001,904,14
0.534,0.0001,495,509,100,2,0.001,1004,14
0.542,0.0001,538,566,100,2,0.001,1104,14
0.554,0.0001,585,619,100,2,0.001,1204,14
0.554,0.0001,639,665,100,2,0.001,1304,14
0.55,0.0001,683,721,100,2,0.001,1404,14
0.55,0.0001,736,768,100,2,0.001,1504,14
0.54,0.0001,787,817,100,2,0.001,1604,14
0.544,0.0001,847,857,100,2,0.001,1704,14
0.544,0.0001,903,901,100,2,0.001,1804,14
0.548,0.0001,954,950,100,2,0.001,1904,14
0.546,0.0001,1002,1002,100,2,0.001,2004,14
0.498,0.0001,48,56,100,2,0.001,104,15
0.498,0.0001,102,102,100,2,0.001,204,15
0.498,0.0001,157,147,100,2,0.001,304,15
0.498,0.0001,200,204,100,2,0.001,404,15
0.498,0.0001,256,248,100,2,0.001,504,15
0.498,0.0001,310,294,100,2,0.001,604,15
0.498,0.0001,357,347,100,2,0.001,704,15
0.498,0.0001,406,398,100,2,0.001,804,15
0.498,0.0001,458,446,100,2,0.001,904,15
0.498,0.0001,510,494,100,2,0.001,1004,15
0.498,0.0001,556,548,100,2,0.001,1104,15
0.498,0.0001,601,603,100,2,0.001,1204,15
0.498,0.0001,657,647,100,2,0.001,1304,15
0.498,0.0001,704,700,100,2,0.001,1404,15
0.498,0.0001,751,753,100,2,0.001,1504,15
0.498,0.0001,806,798,100,2,0.001,1604,15
0.498,0.0001,859,845,100,2,0.001,1704,15
0.498,0.0001,906,898,100,2,0.001,1804,15
0.498,0.0001,951,953,100,2,0.001,1904,15
0.498,0.0001,1003,1001,100,2,0.001,2004,15
0.498,0.0001,48,56,100,2,0.001,104,16
0.498,0.0001,95,109,100,2,0.001,204,16
0.498,0.0001,142,162,100,2,0.001,304,16
0.498,0.0001,194,210,100,2,0.001,404,16
0.498,0.0001,251,253,100,2,0.001,504,16
0.498,0.0001,297,307,100,2,0.001,604,16
0.498,0.0001,347,357,100,2,0.001,704,16
0.498,0.0001,400,404,100,2,0.001,804,16
0.498,0.0001,448,456,100,2,0.001,904,16
0.498,0.0001,497,507,100,2,0.001,1004,16
0.498,0.0001,540,564,100,2,0.001,1104,16
0.498,0.0001,588,616,100,2,0.001,1204,16
0.498,0.0001,648,656,100,2,0.001,1304,16
0.498,0.0001,698,706,100,2,0.001,1404,16
0.498,0.0001,741,763,100,2,0.001,1504,16
0.498,0.0001,787,817,100,2,0.001,1604,16
0.498,0.0001,843,861,100,2,0.001,1704,16
0.498,0.0001,901,903,100,2,0.001,1804,16
0.498,0.0001,950,954,100,2,0.001,1904,16
0.498,0.0001,1003,1001,100,2,0.001,2004,16
0.486,0.0001,49,55,100,2,0.001,104,17
0.48,0.0001,105,99,100,2,0.001,204,17
0.476,0.0001,159,145,100,2,0.001,304,17
0.476,0.0001,213,191,100,2,0.001,404,17
0.476,0.0001,252,252,100,2,0.001,504,17
0.478,0.0001,304,300,100,2,0.001,604,17
0.482,0.0001,359,345,100,2,0.001,704,17
0.486,0.0001,408,396,100,2,0.001,804,17
0.492,0.0001,457,447,100,2,0.001,904,17
0.5,0.0001,505,499,100,2,0.001,1004,17
0.502,0.0001,546,558,100,2,0.001,1104,17
0.5,0.0001,599,605,100,2,0.001,1204,17
0.498,0.0001,645,659,100,2,0.001,1304,17
0.508,0.0001,690,714,100,2,0.001,1404,17
0.512,0.0001,749,755,100,2,0.001,1504,17
0.504,0.0001,802,802,100,2,0.001,1604,17
0.518,0.0001,853,851,100,2,0.001,1704,17
0.52,0.0001,904,900,100,2,0.001,1804,17
0.528,0.0001,959,945,100,2,0.001,1904,17
0.528,0.0001,1013,991,100,2,0.001,2004,17
0.484,0.0001,47,57,100,2,0.001,104,18
0.486,0.0001,100,104,100,2,0.001,204,18
0.486,0.0001,160,144,100,2,0.001,304,18
0.486,0.0001,215,189,100,2,0.001,404,18
0.486,0.0001,270,234,100,2,0.001,504,18
0.492,0.0001,320,284,100,2,0.001,604,18
0.504,0.0001,370,334,100,2,0.001,704,18
0.502,0.0001,425,379,100,2,0.001,804,18
0.508,0.0001,477,427,100,2,0.001,904,18
0.51,0.0001,521,483,100,2,0.001,1004,18
0.516,0.0001,568,536,100,2,0.001,1104,18
0.512,0.0001,612,592,100,2,0.001,1204,18
0.518,0.0001,664,640,100,2,0.001,1304,18
0.52,0.0001,704,700,100,2,0.001,1404,18
0.522,0.0001,750,754,100,2,0.001,1504,18
0.524,0.0001,801,803,100,2,0.001,1604,18
0.526,0.0001,858,846,100,2,0.001,1704,18
0.528,0.0001,905,899,100,2,0.001,1804,18
0.544,0.0001,957,947,100,2,0.001,1904,18
0.546,0.0001,1002,1002,100,2,0.001,2004,18
0.488,0.0001,45,59,100,2,0.001,104,19
0.488,0.0001,98,106,100,2,0.001,204,19
0.488,0.0001,142,162,100,2,0.001,304,19
0.488,0.0001,193,211,100,2,0.001,404,19
0.488,0.0001,245,259,100,2,0.001,504,19
0.488,0.0001,295,309,100,2,0.001,604,19
0.488,0.0001,352,352,100,2,0.001,704,19
0.488,0.0001,398,406,100,2,0.001,804,19
0.488,0.0001,439,465,100,2,0.001,904,19
0.488,0.0001,492,512,100,2,0.001,1004,19
0.488,0.0001,549,555,100,2,0.001,1104,19
0.488,0.0001,593,611,100,2,0.001,1204,19
0.488,0.0001,647,657,100,2,0.001,1304,19
0.488,0.0001,693,711,100,2,0.001,1404,19
0.488,0.0001,744,760,100,2,0.001,1504,19
0.488,0.0001,803,801,100,2,0.001,1604,19
0.488,0.0001,853,851,100,2,0.001,1704,19
0.488,0.0001,899,905,100,2,0.001,1804,19
0.488,0.0001,950,954,100,2,0.001,1904,19
0.488,0.0001,996,1008,100,2,0.001,2004,19
0.486,0.0001,59,45,100,2,0.001,104,20
0.486,0.0001,102,102,100,2,0.001,204,20
0.486,0.0001,151,153,100,2,0.001,304,20
0.486,0.0001,209,195,100,2,0.001,404,20
0.486,0.0001,257,247,100,2,0.001,504,20
0.486,0.0001,309,295,100,2,0.001,604,20
0.486,0.0001,351,353,100,2,0.001,704,20
0.486,0.0001,392,412,100,2,0.001,804,20
0.486,0.0001,441,463,100,2,0.001,904,20
0.486,0.0001,494,510,100,2,0.001,1004,20
0.486,0.0001,548,556,100,2,0.001,1104,20
0.486,0.0001,603,601,100,2,0.001,1204,20
0.486,0.0001,658,646,100,2,0.001,1304,20
0.486,0.0001,711,693,100,2,0.001,1404,20
0.486,0.0001,758,746,100,2,0.001,1504,20
0.486,0.0001,802,802,100,2,0.001,1604,20
0.486,0.0001,850,854,100,2,0.001,1704,20
0.488,0.0001,906,898,100,2,0.001,1804,20
0.49,0.0001,966,938,100,2,0.001,1904,20
0.492,0.0001,1009,995,100,2,0.001,2004,20
0.494,0.0001,54,50,100,2,0.01,104,1
0.494,0.0001,106,98,100,2,0.01,204,1
0.494,0.0001,152,152,100,2,0.01,304,1
0.494,0.0001,199,205,100,2,0.01,404,1
0.494,0.0001,255,249,100,2,0.01,504,1
0.494,0.0001,307,297,100,2,0.01,604,1
0.494,0.0001,352,352,100,2,0.01,704,1
0.494,0.0001,404,400,100,2,0.01,804,1
0.494,0.0001,454,450,100,2,0.01,904,1
0.494,0.0001,508,496,100,2,0.01,1004,1
0.494,0.0001,558,546,100,2,0.01,1104,1
0.494,0.0001,607,597,100,2,0.01,1204,1
0.494,0.0001,647,657,100,2,0.01,1304,1
0.494,0.0001,703,701,100,2,0.01,1404,1
0.494,0.0001,753,751,100,2,0.01,1504,1
0.494,0.0001,796,808,100,2,0.01,1604,1
0.494,0.0001,846,858,100,2,0.01,1704,1
0.494,0.0001,900,904,100,2,0.01,1804,1
0.494,0.0001,946,958,100,2,0.01,1904,1
0.494,0.0001,999,1005,100,2,0.01,2004,1
0.474,0.0001,46,58,100,2,0.01,104,2
0.472,0.0001,91,113,100,2,0.01,204,2
0.476,0.0001,144,160,100,2,0.01,304,2
0.488,0.0001,194,210,100,2,0.01,404,2
0.49,0.0001,242,262,100,2,0.01,504,2
0.508,0.0001,295,309,100,2,0.01,604,2
0.52,0.0001,340,364,100,2,0.01,704,2
0.534,0.0001,387,417,100,2,0.01,804,2
0.544,0.0001,427,477,100,2,0.01,904,2
0.562,0.0001,484,520,100,2,0.01,1004,2
0.586,0.0001,543,561,100,2,0.01,1104,2
0.588,0.0001,596,608,100,2,0.01,1204,2
0.584,0.0001,646,658,100,2,0.01,1304,2
0.618,0.0001,706,698,100,2,0.01,1404,2
0.666,0.0001,752,752,100,2,0.01,1504,2
0.734,0.0001,797,807,100,2,0.01,1604,2
0.78,0.0001,846,858,100,2,0.01,1704,2
0.814,0.0001,898,906,100,2,0.01,1804,2
0.826,0.0001,944,960,100,2,0.01,1904,2
0.852,0.0001,989,1015,100,2,0.01,2004,2
0.534,0.0001,55,49,100,2,0.01,104,3
0.55,0.0001,106,98,100,2,0.01,204,3
0.55,0.0001,158,146,100,2,0.01,304,3
0.546,0.0001,212,192,100,2,0.01,404,3
0.552,0.0001,255,249,100,2,0.01,504,3
0.548,0.0001,310,294,100,2,0.01,604,3
0.54,0.0001,360,344,100,2,0.01,704,3
0.546,0.0001,412,392,100,2,0.01,804,3
0.558,0.0001,456,448,100,2,0.01,904,3
0.57,0.0001,498,506,100,2,0.01,1004,3
0.57,0.0001,555,549,100,2,0.01,1104,3
0.58,0.0001,610,594,100,2,0.01,1204,3
0.584,0.0001,654,650,100,2,0.01,1304,3
0.6,0.0001,706,698,100,2,0.01,1404,3
0.594,0.0001,755,749,100,2,0.01,1504,3
0.604,0.0001,796,808,100,2,0.01,1604,3
0.62,0.0001,848,856,100,2,0.01,1704,3
0.63,0.0001,899,905,100,2,0.01,1804,3
0.622,0.0001,953,951,100,2,0.01,1904,3
0.636,0.0001,1004,1000,100,2,0.01,2004,3
0.494,0.0001,46,58,100,2,0.01,104,4
0.484,0.0001,97,107,100,2,0.01,204,4
0.474,0.0001,152,152,100,2,0.01,304,4
0.46,0.0001,206,198,100,2,0.01,404,4
0.462,0.0001,247,257,100,2,0.01,504,4
0.47,0.0001,298,306,100,2,0.01,604,4
0.496,0.0001,348,356,100,2,0.01,704,4
0.52,0.0001,399,405,100,2,0.01,804,4
0.528,0.0001,454,450,100,2,0.01,904,4
0.53,0.0001,511,493,100,2,0.01,1004,4
0.528,0.0001,558,546,100,2,0.01,1104,4
0.532,0.0001,603,601,100,2,0.01,1204,4
0.552,0.0001,657,647,100,2,0.01,1304,4
0.576,0.0001,702,702,100,2,0.01,1404,4
0.568,0.0001,752,752,100,2,0.01,1504,4
0.59,0.0001,805,799,100,2,0.01,1604,4
0.616,0.0001,853,851,100,2,0.01,1704,4
0.624,0.0001,899,905,100,2,0.01,1804,4
0.614,0.0001,953,951,100,2,0.01,1904,4
0.622,0.0001,997,1007,100,2,0.01,2004,4
0.554,0.0001,49,55,100,2,0.01,104,5
0.536,0.0001,104,100,100,2,0.01,204,5
0.54,0.0001,162,142,100,2,0.01,304,5
0.538,0.0001,208,196,100,2,0.01,404,5
0.532,0.0001,255,249,100,2,0.01,504,5
0.54,0.0001,297,307,100,2,0.01,604,5
0.536,0.0001,342,362,100,2,0.01,704,5
0.54,0.0001,396,408,100,2,0.01,804,5
0.546,0.0001,452,452,100,2,0.01,904,5
0.542,0.0001,500,504,100,2,0.01,1004,5
0.536,0.0001,546,558,100,2,0.01,1104,5
0.534,0.0001,599,605,100,2,0.01,1204,5
0.564,0.0001,648,656,100,2,0.01,1304,5
0.584,0.0001,705,699,100,2,0.01,1404,5
0.574,0.0001,750,754,100,2,0.01,1504,5
0.574,0.0001,803,801,100,2,0.01,1604,5
0.562,0.0001,850,854,100,2,0.01,1704,5
0.56,0.0001,902,902,100,2,0.01,1804,5
0.568,0.0001,953,951,100,2,0.01,1904,5
0.562,0.0001,1009,995,100,2,0.01,2004,5
0.526,0.0001,44,60,100,2,0.01,104,6
0.526,0.0001,96,108,100,2,0.01,204,6
0.532,0.0001,148,156,100,2,0.01,304,6
0.548,0.0001,195,209,100,2,0.01,404,6
0.552,0.0001,238,266,100,2,0.01,504,6
0.592,0.0001,291,313,100,2,0.01,604,6
0.57,0.0001,334,370,100,2,0.01,704,6
0.592,0.0001,381,423,100,2,0.01,804,6
0.588,0.0001,434,470,100,2,0.01,904,6
0.586,0.0001,487,517,100,2,0.01,1004,6
0.586,0.0001,539,565,100,2,0.01,1104,6
0.598,0.0001,591,613,100,2,0.01,1204,6
0.592,0.0001,634,670,100,2,0.01,1304,6
0.598,0.0001,688,716,100,2,0.01,1404,6
0.61,0.0001,732,772,100,2,0.01,1504,6
0.628,0.0001,784,820,100,2,0.01,1604,6
0.632,0.0001,831,873,100,2,0.01,1704,6
0.642,0.0001,881,923,100,2,0.01,1804,6
0.662,0.0001,934,970,100,2,0.01,1904,6
0.666,0.0001,989,1015,100,2,0.01,2004,6
0.482,0.0001,54,50,100,2,0.01,104,7
0.482,0.0001,102,102,100,2,0.01,204,7
0.488,0.0001,145,159,100,2,0.01,304,7
0.494,0.0001,188,216,100,2,0.01,404,7
0.496,0.0001,244,260,100,2,0.01,504,7
0.51,0.0001,295,309,100,2,0.01,604,7
0.506,0.0001,348,356,100,2,0.01,704,7
0.526,0.0001,395,409,100,2,0.01,804,7
0.53,0.0001,443,461,100,2,0.01,904,7
0.518,0.0001,502,502,100,2,0.01,1004,7
0.506,0.0001,549,555,100,2,0.01,1104,7
0.5,0.0001,596,608,100,2,0.01,1204,7
0.504,0.0001,649,655,100,2,0.01,1304,7
0.52,0.0001,703,701,100,2,0.01,1404,7
0.518,0.0001,755,749,100,2,0.01,1504,7
0.532,0.0001,811,793,100,2,0.01,1604,7
0.532,0.0001,865,839,100,2,0.01,1704,7
0.54,0.0001,915,889,100,2,0.01,1804,7
0.542,0.0001,965,939,100,2,0.01,1904,7
0.55,0.0001,1011,993,100,2,0.01,2004,7
0.464,0.0001,53,51,100,2,0.01,104,8
0.464,0.0001,107,97,100,2,0.01,204,8
0.464,0.0001,159,145,100,2,0.01,304,8
0.504,0.0001,205,199,100,2,0.01,404,8
0.522,0.0001,251,253,100,2,0.01,504,8
0.54,0.0001,301,303,100,2,0.01,604,8
0.536,0.0001,349,355,100,2,0.01,704,8
0.558,0.0001,401,403,100,2,0.01,804,8
0.568,0.0001,449,455,100,2,0.01,904,8
0.588,0.0001,492,512,100,2,0.01,1004,8
0.634,0.0001,540,564,100,2,0.01,1104,8
0.648,0.0001,590,614,100,2,0.01,1204,8
0.676,0.0001,644,660,100,2,0.01,1304,8
0.71,0.0001,694,710,100,2,0.01,1404,8
0.742,0.0001,756,748,100,2,0.01,1504,8
0.776,0.0001,799,805,100,2,0.01,1604,8
0.796,0.0001,846,858,100,2,0.01,1704,8
0.848,0.0001,894,910,100,2,0.01,1804,8
0.852,0.0001,957,947,100,2,0.01,1904,8
0.87,0.0001,1020,984,100,2,0.01,2004,8
0.506,0.0001,43,61,100,2,0.01,104,9
0.506,0.0001,93,111,100,2,0.01,204,9
0.506,0.0001,144,160,100,2,0.01,304,9
0.506,0.0001,201,203,100,2,0.01,404,9
0.512,0.0001,253,251,100,2,0.01,504,9
0.522,0.0001,308,296,100,2,0.01,604,9
0.556,0.0001,356,348,100,2,0.01,704,9
0.594,0.0001,408,396,100,2,0.01,804,9
0.624,0.0001,461,443,100,2,0.01,904,9
0.644,0.0001,515,489,100,2,0.01,1004,9
0.63,0.0001,560,544,100,2,0.01,1104,9
0.614,0.0001,600,604,100,2,0.01,1204,9
0.612,0.0001,657,647,100,2,0.01,1304,9
0.64,0.0001,708,696,100,2,0.01,1404,9
0.656,0.0001,758,746,100,2,0.01,1504,9
0.666,0.0001,803,801,100,2,0.01,1604,9
0.674,0.0001,850,854,100,2,0.01,1704,9
0.678,0.0001,903,901,100,2,0.01,1804,9
0.688,0.0001,954,950,100,2,0.01,1904,9
0.698,0.0001,1005,999,100,2,0.01,2004,9
0.51,0.0001,48,56,100,2,0.01,104,10
0.51,0.0001,88,116,100,2,0.01,204,10
0.516,0.0001,131,173,100,2,0.01,304,10
0.55,0.0001,191,213,100,2,0.01,404,10
0.556,0.0001,236,268,100,2,0.01,504,10
0.566,0.0001,285,319,100,2,0.01,604,10
0.574,0.0001,338,366,100,2,0.01,704,10
0.576,0.0001,386,418,100,2,0.01,804,10
0.568,0.0001,447,457,100,2,0.01,904,10
0.556,0.0001,489,515,100,2,0.01,1004,10
0.552,0.0001,539,565,100,2,0.01,1104,10
0.572,0.0001,588,616,100,2,0.01,1204,10
0.574,0.0001,640,664,100,2,0.01,1304,10
0.592,0.0001,692,712,100,2,0.01,1404,10
0.588,0.0001,749,755,100,2,0.01,1504,10
0.594,0.0001,799,805,100,2,0.01,1604,10
0.602,0.0001,849,855,100,2,0.01,1704,10
0.588,0.0001,904,900,100,2,0.01,1804,10
0.582,0.0001,955,949,100,2,0.01,1904,10
0.596,0.0001,996,1008,100,2,0.01,2004,10
0.486,0.0001,57,47,100,2,0.01,104,11
0.498,0.0001,101,103,100,2,0.01,204,11
0.512,0.0001,153,151,100,2,0.01,304,11
0.524,0.0001,197,207,100,2,0.01,404,11
0.532,0.0001,247,257,100,2,0.01,504,11
0.524,0.0001,297,307,100,2,0.01,604,11
0.518,0.0001,349,355,100,2,0.01,704,11
0.524,0.0001,395,409,100,2,0.01,804,11
0.538,0.0001,442,462,100,2,0.01,904,11
0.542,0.0001,493,511,100,2,0.01,1004,11
0.534,0.0001,549,555,100,2,0.01,1104,11
0.554,0.0001,589,615,100,2,0.01,1204,11
0.572,0.0001,637,667,100,2,0.01,1304,11
0.584,0.0001,685,719,100,2,0.01,1404,11
0.588,0.0001,743,761,100,2,0.01,1504,11
0.594,0.0001,791,813,100,2,0.01,1604,11
0.602,0.0001,843,861,100,2,0.01,1704,11
0.618,0.0001,892,912,100,2,0.01,1804,11
0.63,0.0001,942,962,100,2,0.01,1904,11
0.642,0.0001,990,1014,100,2,0.01,2004,11
0.5,0.0001,48,56,100,2,0.01,104,12
0.5,0.0001,91,113,100,2,0.01,204,12
0.5,0.0001,142,162,100,2,0.01,304,12
0.5,0.0001,202,202,100,2,0.01,404,12
0.5,0.0001,249,255,100,2,0.01,504,12
0.5,0.0001,296,308,100,2,0.01,604,12
0.5,0.0001,350,354,100,2,0.01,704,12
0.5,0.0001,400,404,100,2,0.01,804,12
0.5,0.0001,451,453,100,2,0.01,904,12
0.5,0.0001,504,500,100,2,0.01,1004,12
0.5,0.0001,550,554,100,2,0.01,1104,12
0.5,0.0001,603,601,100,2,0.01,1204,12
0.5,0.0001,652,652,100,2,0.01,1304,12
0.5,0.0001,708,696,100,2,0.01,1404,12
0.506,0.0001,757,747,100,2,0.01,1504,12
0.556,0.0001,808,796,100,2,0.01,1604,12
0.552,0.0001,860,844,100,2,0.01,1704,12
0.566,0.0001,914,890,100,2,0.01,1804,12
0.572,0.0001,960,944,100,2,0.01,1904,12
0.59,0.0001,1002,1002,100,2,0.01,2004,12
0.502,0.0001,42,62,100,2,0.01,104,13
0.498,0.0001,85,119,100,2,0.01,204,13
0.502,0.0001,132,172,100,2,0.01,304,13
0.518,0.0001,187,217,100,2,0.01,404,13
0.542,0.0001,239,265,100,2,0.01,504,13
0.6,0.0001,291,313,100,2,0.01,604,13
0.632,0.0001,340,364,100,2,0.01,704,13
0.656,0.0001,387,417,100,2,0.01,804,13
0.678,0.0001,437,467,100,2,0.01,904,13
0.692,0.0001,493,511,100,2,0.01,1004,13
0.708,0.0001,550,554,100,2,0.01,1104,13
0.746,0.0001,593,611,100,2,0.01,1204,13
0.77,0.0001,645,659,100,2,0.01,1304,13
0.792,0.0001,694,710,100,2,0.01,1404,13
0.828,0.0001,747,757,100,2,0.01,1504,13
0.856,0.0001,793,811,100,2,0.01,1604,13
0.864,0.0001,850,854,100,2,0.01,1704,13
0.89,0.0001,904,900,100,2,0.01,1804,13
0.914,0.0001,955,949,100,2,0.01,1904,13
0.914,0.0001,1000,1004,100,2,0.01,2004,13
0.526,0.0001,43,61,100,2,0.01,104,14
0.53,0.0001,102,102,100,2,0.01,204,14
0.53,0.0001,156,148,100,2,0.01,304,14
0.54,0.0001,205,199,100,2,0.01,404,14
0.548,0.0001,256,248,100,2,0.01,504,14
0.564,0.0001,309,295,100,2,0.01,604,14
0.536,0.0001,356,348,100,2,0.01,704,14
0.522,0.0001,413,391,100,2,0.01,804,14
0.528,0.0001,457,447,100,2,0.01,904,14
0.524,0.0001,504,500,100,2,0.01,1004,14
0.534,0.0001,560,544,100,2,0.01,1104,14
0.546,0.0001,616,588,100,2,0.01,1204,14
0.572,0.0001,660,644,100,2,0.01,1304,14
0.584,0.0001,714,690,100,2,0.01,1404,14
0.596,0.0001,769,735,100,2,0.01,1504,14
0.638,0.0001,822,782,100,2,0.01,1604,14
0.668,0.0001,872,832,100,2,0.01,1704,14
0.684,0.0001,920,884,100,2,0.01,1804,14
0.708,0.0001,969,935,100,2,0.01,1904,14
0.718,0.0001,1013,991,100,2,0.01,2004,14
0.51,0.0001,57,47,100,2,0.01,104,15
0.516,0.0001,105,99,100,2,0.01,204,15
0.518,0.0001,151,153,100,2,0.01,304,15
0.504,0.0001,204,200,100,2,0.01,404,15
0.51,0.0001,262,242,100,2,0.01,504,15
0.508,0.0001,306,298,100,2,0.01,604,15
0.494,0.0001,362,342,100,2,0.01,704,15
0.496,0.0001,408,396,100,2,0.01,804,15
0.506,0.0001,455,449,100,2,0.01,904,15
0.526,0.0001,502,502,100,2,0.01,1004,15
0.534,0.0001,548,556,100,2,0.01,1104,15
0.548,0.0001,591,613,100,2,0.01,1204,15
0.554,0.0001,644,660,100,2,0.01,1304,15
0.58,0.0001,703,701,100,2,0.01,1404,15
0.58,0.0001,741,763,100,2,0.01,1504,15
0.576,0.0001,794,810,100,2,0.01,1604,15
0.594,0.0001,846,858,100,2,0.01,1704,15
0.614,0.0001,901,903,100,2,0.01,1804,15
0.64,0.0001,952,952,100,2,0.01,1904,15
0.652,0.0001,998,1006,100,2,0.01,2004,15
0.47,0.0001,53,51,100,2,0.01,104,16
0.47,0.0001,105,99,100,2,0.01,204,16
0.47,0.0001,157,147,100,2,0.01,304,16
0.47,0.0001,209,195,100,2,0.01,404,16
0.47,0.0001,260,244,100,2,0.01,504,16
0.47,0.0001,309,295,100,2,0.01,604,16
0.47,0.0001,358,346,100,2,0.01,704,16
0.47,0.0001,409,395,100,2,0.01,804,16
0.47,0.0001,462,442,100,2,0.01,904,16
0.47,0.0001,509,495,100,2,0.01,1004,16
0.47,0.0001,558,546,100,2,0.01,1104,16
0.47,0.0001,605,599,100,2,0.01,1204,16
0.47,0.0001,650,654,100,2,0.01,1304,16
0.47,0.0001,711,693,100,2,0.01,1404,16
0.47,0.0001,760,744,100,2,0.01,1504,16
0.47,0.0001,813,791,100,2,0.01,1604,16
0.47,0.0001,866,838,100,2,0.01,1704,16
0.47,0.0001,918,886,100,2,0.01,1804,16
0.804,0.0001,965,939,100,2,0.01,1904,16
0.91,0.0001,1017,987,100,2,0.01,2004,16
0.478,0.0001,54,50,100,2,0.01,104,17
0.494,0.0001,107,97,100,2,0.01,204,17
0.494,0.0001,161,143,100,2,0.01,304,17
0.494,0.0001,203,201,100,2,0.01,404,17
0.482,0.0001,260,244,100,2,0.01,504,17
0.478,0.0001,307,297,100,2,0.01,604,17
0.484,0.0001,355,349,100,2,0.01,704,17
0.52,0.0001,402,402,100,2,0.01,804,17
0.546,0.0001,453,451,100,2,0.01,904,17
0.576,0.0001,514,490,100,2,0.01,1004,17
0.598,0.0001,562,542,100,2,0.01,1104,17
0.648,0.0001,607,597,100,2,0.01,1204,17
0.678,0.0001,657,647,100,2,0.01,1304,17
0.706,0.0001,715,689,100,2,0.01,1404,17
0.718,0.0001,757,747,100,2,0.01,1504,17
0.782,0.0001,804,800,100,2,0.01,1604,17
0.842,0.0001,854,850,100,2,0.01,1704,17
0.882,0.0001,899,905,100,2,0.01,1804,17
0.906,0.0001,951,953,100,2,0.01,1904,17
0.914,0.0001,1004,1000,100,2,0.01,2004,17
0.54,0.0001,55,49,100,2,0.01,104,18
0.554,0.0001,108,96,100,2,0.01,204,18
0.556,0.0001,160,144,100,2,0.01,304,18
0.57,0.0001,209,195,100,2,0.01,404,18
0.596,0.0001,262,242,100,2,0.01,504,18
0.62,0.0001,312,292,100,2,0.01,604,18
0.618,0.0001,365,339,100,2,0.01,704,18
0.63,0.0001,421,383,100,2,0.01,804,18
0.64,0.0001,472,432,100,2,0.01,904,18
0.644,0.0001,529,475,100,2,0.01,1004,18
0.642,0.0001,562,542,100,2,0.01,1104,18
0.656,0.0001,606,598,100,2,0.01,1204,18
0.668,0.0001,654,650,100,2,0.01,1304,18
0.684,0.0001,700,704,100,2,0.01,1404,18
0.686,0.0001,749,755,100,2,0.01,1504,18
0.706,0.0001,805,799,100,2,0.01,1604,18
0.716,0.0001,863,841,100,2,0.01,1704,18
0.736,0.0001,920,884,100,2,0.01,1804,18
0.728,0.0001,963,941,100,2,0.01,1904,18
0.748,0.0001,1021,983,100,2,0.01,2004,18
0.452,0.0001,51,53,100,2,0.01,104,19
0.46,0.0001,106,98,100,2,0.01,204,19
0.472,0.0001,156,148,100,2,0.01,304,19
0.486,0.0001,202,202,100,2,0.01,404,19
0.488,0.0001,257,247,100,2,0.01,504,19
0.506,0.0001,305,299,100,2,0.01,604,19
0.53,0.0001,366,338,100,2,0.01,704,19
0.536,0.0001,413,391,100,2,0.01,804,19
0.546,0.0001,465,439,100,2,0.01,904,19
0.534,0.0001,510,494,100,2,0.01,1004,19
0.534,0.0001,562,542,100,2,0.01,1104,19
0.528,0.0001,611,593,100,2,0.01,1204,19
0.542,0.0001,657,647,100,2,0.01,1304,19
0.56,0.0001,711,693,100,2,0.01,1404,19
0.566,0.0001,759,745,100,2,0.01,1504,19
0.572,0.0001,809,795,100,2,0.01,1604,19
0.598,0.0001,873,831,100,2,0.01,1704,19
0.6,0.0001,924,880,100,2,0.01,1804,19
0.6,0.0001,974,930,100,2,0.01,1904,19
0.622,0.0001,1028,976,100,2,0.01,2004,19
0.522,0.0001,56,48,100,2,0.01,104,20
0.522,0.0001,98,106,100,2,0.01,204,20
0.522,0.0001,149,155,100,2,0.01,304,20
0.522,0.0001,201,203,100,2,0.01,404,20
0.522,0.0001,248,256,100,2,0.01,504,20
0.522,0.0001,299,305,100,2,0.01,604,20
0.522,0.0001,357,347,100,2,0.01,704,20
0.532,0.0001,399,405,100,2,0.01,804,20
0.578,0.0001,448,456,100,2,0.01,904,20
0.596,0.0001,504,500,100,2,0.01,1004,20
0.598,0.0001,566,538,100,2,0.01,1104,20
0.596,0.0001,624,580,100,2,0.01,1204,20
0.608,0.0001,674,630,100,2,0.01,1304,20
0.59,0.0001,730,674,100,2,0.01,1404,20
0.592,0.0001,777,727,100,2,0.01,1504,20
0.584,0.0001,829,775,100,2,0.01,1604,20
0.61,0.0001,876,828,100,2,0.01,1704,20
0.614,0.0001,920,884,100,2,0.01,1804,20
0.638,0.0001,962,942,100,2,0.01,1904,20
0.648,0.0001,1013,991,100,2,0.01,2004,20
0.452,0.001,49,55,100,2,0.0001,104,1
0.452,0.001,97,107,100,2,0.0001,204,1
0.452,0.001,150,154,100,2,0.0001,304,1
0.452,0.001,196,208,100,2,0.0001,404,1
0.452,0.001,242,262,100,2,0.0001,504,1
0.452,0.001,289,315,100,2,0.0001,604,1
0.452,0.001,346,358,100,2,0.0001,704,1
0.452,0.001,399,405,100,2,0.0001,804,1
0.452,0.001,449,455,100,2,0.0001,904,1
0.452,0.001,497,507,100,2,0.0001,1004,1
0.452,0.001,541,563,100,2,0.0001,1104,1
0.452,0.001,585,619,100,2,0.0001,1204,1
0.452,0.001,634,670,100,2,0.0001,1304,1
0.452,0.001,683,721,100,2,0.0001,1404,1
0.452,0.001,730,774,100,2,0.0001,1504,1
0.452,0.001,785,819,100,2,0.0001,1604,1
0.452,0.001,834,870,100,2,0.0001,1704,1
0.452,0.001,881,923,100,2,0.0001,1804,1
0.452,0.001,927,977,100,2,0.0001,1904,1
0.452,0.001,978,1026,100,2,0.0001,2004,1
0.474,0.001,54,50,100,2,0.0001,104,2
0.474,0.001,109,95,100,2,0.0001,204,2
0.474,0.001,164,140,100,2,0.0001,304,2
0.474,0.001,220,184,100,2,0.0001,404,2
0.474,0.001,268,236,100,2,0.0001,504,2
0.474,0.001,312,292,100,2,0.0001,604,2
0.474,0.001,369,335,100,2,0.0001,704,2
0.474,0.001,419,385,100,2,0.0001,804,2
0.474,0.001,473,431,100,2,0.0001,904,2
0.474,0.001,517,487,100,2,0.0001,1004,2
0.474,0.001,558,546,100,2,0.0001,1104,2
0.474,0.001,607,597,100,2,0.0001,1204,2
0.474,0.001,661,643,100,2,0.0001,1304,2
0.474,0.001,713,691,100,2,0.0001,1404,2
0.474,0.001,756,748,100,2,0.0001,1504,2
0.474,0.001,803,801,100,2,0.0001,1604,2
0.474,0.001,856,848,100,2,0.0001,1704,2
0.474,0.001,905,899,100,2,0.0001,1804,2
0.474,0.001,954,950,100,2,0.0001,1904,2
0.474,0.001,1015,989,100,2,0.0001,2004,2
0.488,0.001,51,53,100,2,0.0001,104,3
0.488,0.001,90,114,100,2,0.0001,204,3
0.488,0.001,135,169,100,2,0.0001,304,3
0.49,0.001,174,230,100,2,0.0001,404,3
0.49,0.001,233,271,100,2,0.0001,504,3
0.49,0.001,286,318,100,2,0.0001,604,3
0.49,0.001,331,373,100,2,0.0001,704,3
0.49,0.001,382,422,100,2,0.0001,804,3
0.492,0.001,430,474,100,2,0.0001,904,3
0.492,0.001,479,525,100,2,0.0001,1004,3
0.492,0.001,528,576,100,2,0.0001,1104,3
0.492,0.001,587,617,100,2,0.0001,1204,3
0.492,0.001,636,668,100,2,0.0001,1304,3
0.49,0.001,688,716,100,2,0.0001,1404,3
0.488,0.001,740,764,100,2,0.0001,1504,3
0.486,0.001,798,806,100,2,0.0001,1604,3
0.486,0.001,847,857,100,2,0.0001,1704,3
0.484,0.001,899,905,100,2,0.0001,1804,3
0.484,0.001,953,951,100,2,0.0001,1904,3
0.484,0.001,1000,1004,100,2,0.0001,2004,3
0.506,0.001,62,42,100,2,0.0001,104,4
0.506,0.001,119,85,100,2,0.0001,204,4
0.506,0.001,168,136,100,2,0.0001,304,4
0.506,0.001,220,184,100,2,0.0001,404,4
0.506,0.001,261,243,100,2,0.0001,504,4
0.506,0.001,310,294,100,2,0.0001,604,4
0.506,0.001,359,345,100,2,0.0001,704,4
0.506,0.001,414,390,100,2,0.0001,804,4
0.506,0.001,471,433,100,2,0.0001,904,4
0.506,0.001,517,487,100,2,0.0001,1004,4
0.506,0.001,555,549,100,2,0.0001,1104,4
0.506,0.001,602,602,100,2,0.0001,1204,4
0.506,0.001,658,646,100,2,0.0001,1304,4
0.506,0.001,711,693,100,2,0.0001,1404,4
0.506,0.001,761,743,100,2,0.0001,1504,4
0.506,0.001,808,796,100,2,0.0001,1604,4
0.506,0.001,857,847,100,2,0.0001,1704,4
0.506,0.001,911,893,100,2,0.0001,1804,4
0.506,0.001,954,950,100,2,0.0001,1904,4
0.506,0.001,999,1005,100,2,0.0001,2004,4
0.518,0.001,52,52,100,2,0.0001,104,5
0.518,0.001,90,114,100,2,0.0001,204,5
0.518,0.001,137,167,100,2,0.0001,304,5
0.518,0.001,190,214,100,2,0.0001,404,5
0.518,0.001,230,274,100,2,0.0001,504,5
0.518,0.001,274,330,100,2,0.0001,604,5
0.518,0.001,339,365,100,2,0.0001,704,5
0.518,0.001,384,420,100,2,0.0001,804,5
0.518,0.001,435,469,100,2,0.0001,904,5
0.518,0.001,492,512,100,2,0.0001,1004,5
0.518,0.001,541,563,100,2,0.0001,1104,5
0.518,0.001,593,611,100,2,0.0001,1204,5
0.518,0.001,639,665,100,2,0.0001,1304,5
0.518,0.001,689,715,100,2,0.0001,1404,5
0.518,0.001,748,756,100,2,0.0001,1504,5
0.518,0.001,801,803,100,2,0.0001,1604,5
0.518,0.001,847,857,100,2,0.0001,1704,5
0.518,0.001,893,911,100,2,0.0001,1804,5
0.518,0.001,944,960,100,2,0.0001,1904,5
0.518,0.001,993,1011,100,2,0.0001,2004,5
0.51,0.001,56,48,100,2,0.0001,104,6
0.51,0.001,102,102,100,2,0.0001,204,6
0.51,0.001,152,152,100,2,0.0001,304,6
0.51,0.001,205,199,100,2,0.0001,404,6
0.51,0.001,263,241,100,2,0.0001,504,6
0.51,0.001,308,296,100,2,0.0001,604,6
0.51,0.001,351,353,100,2,0.0001,704,6
0.51,0.001,402,402,100,2,0.0001,804,6
0.51,0.001,454,450,100,2,0.0001,904,6
0.51,0.001,501,503,100,2,0.0001,1004,6
0.51,0.001,554,550,100,2,0.0001,1104,6
0.51,0.001,607,597,100,2,0.0001,1204,6
0.51,0.001,652,652,100,2,0.0001,1304,6
0.51,0.001,697,707,100,2,0.0001,1404,6
0.51,0.001,756,748,100,2,0.0001,1504,6
0.51,0.001,811,793,100,2,0.0001,1604,6
0.51,0.001,868,836,100,2,0.0001,1704,6
0.51,0.001,911,893,100,2,0.0001,1804,6
0.51,0.001,958,946,100,2,0.0001,1904,6
0.51,0.001,1007,997,100,2,0.0001,2004,6
0.506,0.001,55,49,100,2,0.0001,104,7
0.508,0.001,105,99,100,2,0.0001,204,7
0.508,0.001,154,150,100,2,0.0001,304,7
0.51,0.001,210,194,100,2,0.0001,404,7
0.51,0.001,258,246,100,2,0.0001,504,7
0.51,0.001,303,301,100,2,0.0001,604,7
0.512,0.001,356,348,100,2,0.0001,704,7
0.512,0.001,404,400,100,2,0.0001,804,7
0.514,0.001,449,455,100,2,0.0001,904,7
0.514,0.001,499,505,100,2,0.0001,1004,7
0.516,0.001,548,556,100,2,0.0001,1104,7
0.516,0.001,608,596,100,2,0.0001,1204,7
0.516,0.001,648,656,100,2,0.0001,1304,7
0.514,0.001,700,704,100,2,0.0001,1404,7
0.512,0.001,746,758,100,2,0.0001,1504,7
0.512,0.001,793,811,100,2,0.0001,1604,7
0.514,0.001,852,852,100,2,0.0001,1704,7
0.512,0.001,901,903,100,2,0.0001,1804,7
0.514,0.001,948,956,100,2,0.0001,1904,7
0.516,0.001,1003,1001,100,2,0.0001,2004,7
0.498,0.001,59,45,100,2,0.0001,104,8
0.498,0.001,109,95,100,2,0.0001,204,8
0.498,0.001,157,147,100,2,0.0001,304,8
0.498,0.001,212,192,100,2,0.0001,404,8
0.498,0.001,265,239,100,2,0.0001,504,8
0.498,0.001,321,283,100,2,0.0001,604,8
0.498,0.001,371,333,100,2,0.0001,704,8
0.498,0.001,419,385,100,2,0.0001,804,8
0.498,0.001,461,443,100,2,0.0001,904,8
0.498,0.001,510,494,100,2,0.0001,1004,8
0.498,0.001,557,547,100,2,0.0001,1104,8
0.498,0.001,606,598,100,2,0.0001,1204,8
0.498,0.001,652,652,100,2,0.0001,1304,8
0.498,0.001,702,702,100,2,0.0001,1404,8
0.498,0.001,749,755,100,2,0.0001,1504,8
0.498,0.001,806,798,100,2,0.0001,1604,8
0.498,0.001,859,845,100,2,0.0001,1704,8
0.498,0.001,903,901,100,2,0.0001,1804,8
0.498,0.001,952,952,100,2,0.0001,1904,8
0.498,0.001,1003,1001,100,2,0.0001,2004,8
0.518,0.001,54,50,100,2,0.0001,104,9
0.518,0.001,108,96,100,2,0.0001,204,9
0.518,0.001,151,153,100,2,0.0001,304,9
0.518,0.001,196,208,100,2,0.0001,404,9
0.518,0.001,245,259,100,2,0.0001,504,9
0.518,0.001,288,316,100,2,0.0001,604,9
0.518,0.001,333,371,100,2,0.0001,704,9
0.518,0.001,392,412,100,2,0.0001,804,9
0.518,0.001,441,463,100,2,0.0001,904,9
0.518,0.001,498,506,100,2,0.0001,1004,9
0.518,0.001,538,566,100,2,0.0001,1104,9
0.518,0.001,594,610,100,2,0.0001,1204,9
0.518,0.001,649,655,100,2,0.0001,1304,9
0.518,0.001,699,705,100,2,0.0001,1404,9
0.518,0.001,750,754,100,2,0.0001,1504,9
0.518,0.001,799,805,100,2,0.0001,1604,9
0.518,0.001,848,856,100,2,0.0001,1704,9
0.518,0.001,903,901,100,2,0.0001,1804,9
0.518,0.001,955,949,100,2,0.0001,1904,9
0.518,0.001,1011,993,100,2,0.0001,2004,9
0.506,0.001,50,54,100,2,0.0001,104,10
0.506,0.001,103,101,100,2,0.0001,204,10
0.506,0.001,156,148,100,2,0.0001,304,10
0.506,0.001,204,200,100,2,0.0001,404,10
0.506,0.001,251,253,100,2,0.0001,504,10
0.506,0.001,303,301,100,2,0.0001,604,10
0.506,0.001,360,344,100,2,0.0001,704,10
0.506,0.001,415,389,100,2,0.0001,804,10
0.506,0.001,466,438,100,2,0.0001,904,10
0.506,0.001,515,489,100,2,0.0001,1004,10
0.506,0.001,554,550,100,2,0.0001,1104,10
0.504,0.001,607,597,100,2,0.0001,1204,10
0.504,0.001,650,654,100,2,0.0001,1304,10
0.504,0.001,706,698,100,2,0.0001,1404,10
0.506,0.001,750,754,100,2,0.0001,1504,10
0.506,0.001,801,803,100,2,0.0001,1604,10
0.506,0.001,851,853,100,2,0.0001,1704,10
0.506,0.001,902,902,100,2,0.0001,1804,10
0.506,0.001,949,955,100,2,0.0001,1904,10
0.504,0.001,994,1010,100,2,0.0001,2004,10
0.512,0.001,50,54,100,2,0.0001,104,11
0.512,0.001,93,111,100,2,0.0001,204,11
0.512,0.001,150,154,100,2,0.0001,304,11
0.512,0.001,201,203,100,2,0.0001,404,11
0.512,0.001,254,250,100,2,0.0001,504,11
0.512,0.001,304,300,100,2,0.0001,604,11
0.512,0.001,357,347,100,2,0.0001,704,11
0.512,0.001,411,393,100,2,0.0001,804,11
0.512,0.001,465,439,100,2,0.0001,904,11
0.512,0.001,518,486,100,2,0.0001,1004,11
0.512,0.001,561,543,100,2,0.0001,1104,11
0.512,0.001,616,588,100,2,0.0001,1204,11
0.512,0.001,665,639,100,2,0.0001,1304,11
0.512,0.001,708,696,100,2,0.0001,1404,11
0.512,0.001,760,744,100,2,0.0001,1504,11
0.512,0.001,819,785,100,2,0.0001,1604,11
0.512,0.001,864,840,100,2,0.0001,1704,11
0.512,0.001,910,894,100,2,0.0001,1804,11
0.512,0.001,966,938,100,2,0.0001,1904,11
0.512,0.001,1008,996,100,2,0.0001,2004,11
0.486,0.001,48,56,100,2,0.0001,104,12
0.486,0.001,99,105,100,2,0.0001,204,12
0.486,0.001,149,155,100,2,0.0001,304,12
0.486,0.001,194,210,100,2,0.0001,404,12
0.486,0.001,230,274,100,2,0.0001,504,12
0.486,0.001,275,329,100,2,0.0001,604,12
0.486,0.001,327,377,100,2,0.0001,704,12
0.486,0.001,373,431,100,2,0.0001,804,12
0.486,0.001,428,476,100,2,0.0001,904,12
0.486,0.001,477,527,100,2,0.0001,1004,12
0.486,0.001,538,566,100,2,0.0001,1104,12
0.486,0.001,585,619,100,2,0.0001,1204,12
0.486,0.001,627,677,100,2,0.0001,1304,12
0.486,0.001,683,721,100,2,0.0001,1404,12
0.486,0.001,731,773,100,2,0.0001,1504,12
0.486,0.001,781,823,100,2,0.0001,1604,12
0.486,0.001,842,862,100,2,0.0001,1704,12
0.486,0.001,890,914,100,2,0.0001,1804,12
0.486,0.001,943,961,100,2,0.0001,1904,12
0.486,0.001,995,1009,100,2,0.0001,2004,12
0.5,0.001,44,60,100,2,0.0001,104,13
0.5,0.001,98,106,100,2,0.0001,204,13
0.5,0.001,141,163,100,2,0.0001,304,13
0.5,0.001,199,205,100,2,0.0001,404,13
0.5,0.001,242,262,100,2,0.0001,504,13
0.5,0.001,299,305,100,2,0.0001,604,13
0.5,0.001,359,345,100,2,0.0001,704,13
0.5,0.001,420,384,100,2,0.0001,804,13
0.5,0.001,462,442,100,2,0.0001,904,13
0.5,0.001,512,492,100,2,0.0001,1004,13
0.5,0.001,555,549,100,2,0.0001,1104,13
0.5,0.001,599,605,100,2,0.0001,1204,13
0.5,0.001,653,651,100,2,0.0001,1304,13
0.5,0.001,702,702,100,2,0.0001,1404,13
0.5,0.001,755,749,100,2,0.0001,1504,13
0.5,0.001,795,809,100,2,0.0001,1604,13
0.5,0.001,848,856,100,2,0.0001,1704,13
0.5,0.001,893,911,100,2,0.0001,1804,13
0.5,0.001,954,950,100,2,0.0001,1904,13
0.5,0.001,1002,1002,100,2,0.0001,2004,13
0.524,0.001,53,51,100,2,0.0001,104,14
0.524,0.001,104,100,100,2,0.0001,204,14
0.524,0.001,156,148,100,2,0.0001,304,14
0.524,0.001,201,203,100,2,0.0001,404,14
0.524,0.001,243,261,100,2,0.0001,504,14
0.524,0.001,294,310,100,2,0.0001,604,14
0.524,0.001,348,356,100,2,0.0001,704,14
0.524,0.001,395,409,100,2,0.0001,804,14
0.524,0.001,448,456,100,2,0.0001,904,14
0.524,0.001,499,505,100,2,0.0001,1004,14
0.524,0.001,543,561,100,2,0.0001,1104,14
0.524,0.001,591,613,100,2,0.0001,1204,14
0.524,0.001,643,661,100,2,0.0001,1304,14
0.524,0.001,691,713,100,2,0.0001,1404,14
0.524,0.001,740,764,100,2,0.0001,1504,14
0.524,0.001,789,815,100,2,0.0001,1604,14
0.524,0.001,844,860,100,2,0.0001,1704,14
0.524,0.001,891,913,100,2,0.0001,1804,14
0.524,0.001,937,967,100,2,0.0001,1904,14
0.524,0.001,990,1014,100,2,0.0001,2004,14
0.492,0.001,53,51,100,2,0.0001,104,15
0.492,0.001,100,104,100,2,0.0001,204,15
0.492,0.001,143,161,100,2,0.0001,304,15
0.492,0.001,186,218,100,2,0.0001,404,15
0.492,0.001,244,260,100,2,0.0001,504,15
0.494,0.001,294,310,100,2,0.0001,604,15
0.492,0.001,342,362,100,2,0.0001,704,15
0.492,0.001,392,412,100,2,0.0001,804,15
0.492,0.001,448,456,100,2,0.0001,904,15
0.492,0.001,502,502,100,2,0.0001,1004,15
0.492,0.001,560,544,100,2,0.0001,1104,15
0.492,0.001,607,597,100,2,0.0001,1204,15
0.492,0.001,656,648,100,2,0.0001,1304,15
0.492,0.001,710,694,100,2,0.0001,1404,15
0.492,0.001,758,746,100,2,0.0001,1504,15
0.494,0.001,802,802,100,2,0.0001,1604,15
0.494,0.001,852,852,100,2,0.0001,1704,15
0.496,0.001,909,895,100,2,0.0001,1804,15
0.498,0.001,953,951,100,2,0.0001,1904,15
0.5,0.001,1009,995,100,2,0.0001,2004,15
0.508,0.001,55,49,100,2,0.0001,104,16
0.508,0.001,101,103,100,2,0.0001,204,16
0.508,0.001,155,149,100,2,0.0001,304,16
0.508,0.001,196,208,100,2,0.0001,404,16
0.508,0.001,243,261,100,2,0.0001,504,16
0.508,0.001,301,303,100,2,0.0001,604,16
0.508,0.001,351,353,100,2,0.0001,704,16
0.508,0.001,404,400,100,2,0.0001,804,16
0.508,0.001,455,449,100,2,0.0001,904,16
0.508,0.001,505,499,100,2,0.0001,1004,16
0.508,0.001,551,553,100,2,0.0001,1104,16
0.508,0.001,606,598,100,2,0.0001,1204,16
0.508,0.001,655,649,100,2,0.0001,1304,16
0.508,0.001,713,691,100,2,0.0001,1404,16
0.508,0.001,768,736,100,2,0.0001,1504,16
0.508,0.001,819,785,100,2,0.0001,1604,16
0.508,0.001,869,835,100,2,0.0001,1704,16
0.508,0.001,910,894,100,2,0.0001,1804,16
0.508,0.001,953,951,100,2,0.0001,1904,16
0.508,0.001,1006,998,100,2,0.0001,2004,16
0.494,0.001,52,52,100,2,0.0001,104,17
0.494,0.001,103,101,100,2,0.0001,204,17
0.494,0.001,152,152,100,2,0.0001,304,17
0.494,0.001,212,192,100,2,0.0001,404,17
0.494,0.001,263,241,100,2,0.0001,504,17
0.494,0.001,314,290,100,2,0.0001,604,17
0.494,0.001,372,332,100,2,0.0001,704,17
0.494,0.001,423,381,100,2,0.0001,804,17
0.494,0.001,479,425,100,2,0.0001,904,17
0.494,0.001,537,467,100,2,0.0001,1004,17
0.494,0.001,591,513,100,2,0.0001,1104,17
0.494,0.001,638,566,100,2,0.0001,1204,17
0.494,0.001,681,623,100,2,0.0001,1304,17
0.494,0.001,733,671,100,2,0.0001,1404,17
0.494,0.001,778,726,100,2,0.0001,1504,17
0.494,0.001,827,777,100,2,0.0001,1604,17
0.494,0.001,871,833,100,2,0.0001,1704,17
0.494,0.001,913,891,100,2,0.0001,1804,17
0.494,0.001,963,941,100,2,0.0001,1904,17
0.494,0.001,1005,999,100,2,0.0001,2004,17
0.522,0.001,60,44,100,2,0.0001,104,18
0.522,0.001,105,99,100,2,0.0001,204,18
0.522,0.001,158,146,100,2,0.0001,304,18
0.522,0.001,211,193,100,2,0.0001,404,18
0.524,0.001,270,234,100,2,0.0001,504,18
0.524,0.001,321,283,100,2,0.0001,604,18
0.524,0.001,367,337,100,2,0.0001,704,18
0.524,0.001,425,379,100,2,0.0001,804,18
0.524,0.001,464,440,100,2,0.0001,904,18
0.524,0.001,509,495,100,2,0.0001,1004,18
0.524,0.001,561,543,100,2,0.0001,1104,18
0.524,0.001,616,588,100,2,0.0001,1204,18
0.522,0.001,672,632,100,2,0.0001,1304,18
0.522,0.001,722,682,100,2,0.0001,1404,18
0.522,0.001,766,738,100,2,0.0001,1504,18
0.522,0.001,815,789,100,2,0.0001,1604,18
0.522,0.001,871,833,100,2,0.0001,1704,18
0.522,0.001,925,879,100,2,0.0001,1804,18
0.522,0.001,967,937,100,2,0.0001,1904,18
0.522,0.001,1015,989,100,2,0.0001,2004,18
0.534,0.001,53,51,100,2,0.0001,104,19
0.534,0.001,108,96,100,2,0.0001,204,19
0.534,0.001,157,147,100,2,0.0001,304,19
0.536,0.001,205,199,100,2,0.0001,404,19
0.536,0.001,242,262,100,2,0.0001,504,19
0.536,0.001,285,319,100,2,0.0001,604,19
0.536,0.001,335,369,100,2,0.0001,704,19
0.536,0.001,385,419,100,2,0.0001,804,19
0.536,0.001,432,472,100,2,0.0001,904,19
0.538,0.001,485,519,100,2,0.0001,1004,19
0.538,0.001,543,561,100,2,0.0001,1104,19
0.538,0.001,607,597,100,2,0.0001,1204,19
0.538,0.001,651,653,100,2,0.0001,1304,19
0.538,0.001,698,706,100,2,0.0001,1404,19
0.534,0.001,746,758,100,2,0.0001,1504,19
0.532,0.001,795,809,100,2,0.0001,1604,19
0.532,0.001,853,851,100,2,0.0001,1704,19
0.53,0.001,897,907,100,2,0.0001,1804,19
0.53,0.001,955,949,100,2,0.0001,1904,19
0.53,0.001,1002,1002,100,2,0.0001,2004,19
0.492,0.001,55,49,100,2,0.0001,104,20
0.492,0.001,108,96,100,2,0.0001,204,20
0.492,0.001,164,140,100,2,0.0001,304,20
0.492,0.001,209,195,100,2,0.0001,404,20
0.492,0.001,258,246,100,2,0.0001,504,20
0.492,0.001,309,295,100,2,0.0001,604,20
0.492,0.001,359,345,100,2,0.0001,704,20
0.492,0.001,408,396,100,2,0.0001,804,20
0.492,0.001,457,447,100,2,0.0001,904,20
0.492,0.001,502,502,100,2,0.0001,1004,20
0.494,0.001,545,559,100,2,0.0001,1104,20
0.494,0.001,598,606,100,2,0.0001,1204,20
0.494,0.001,646,658,100,2,0.0001,1304,20
0.496,0.001,694,710,100,2,0.0001,1404,20
0.496,0.001,742,762,100,2,0.0001,1504,20
0.496,0.001,793,811,100,2,0.0001,1604,20
0.496,0.001,855,849,100,2,0.0001,1704,20
0.494,0.001,902,902,100,2,0.0001,1804,20
0.492,0.001,947,957,100,2,0.0001,1904,20
0.492,0.001,997,1007,100,2,0.0001,2004,20
0.536,0.001,51,53,100,2,0.001,104,1
0.538,0.001,100,104,100,2,0.001,204,1
0.538,0.001,144,160,100,2,0.001,304,1
0.538,0.001,192,212,100,2,0.001,404,1
0.538,0.001,244,260,100,2,0.001,504,1
0.538,0.001,302,302,100,2,0.001,604,1
0.54,0.001,356,348,100,2,0.001,704,1
0.54,0.001,396,408,100,2,0.001,804,1
0.544,0.001,435,469,100,2,0.001,904,1
0.544,0.001,482,522,100,2,0.001,1004,1
0.544,0.001,533,571,100,2,0.001,1104,1
0.542,0.001,577,627,100,2,0.001,1204,1
0.548,0.001,635,669,100,2,0.001,1304,1
0.544,0.001,688,716,100,2,0.001,1404,1
0.546,0.001,734,770,100,2,0.001,1504,1
0.544,0.001,784,820,100,2,0.001,1604,1
0.542,0.001,831,873,100,2,0.001,1704,1
0.548,0.001,880,924,100,2,0.001,1804,1
0.554,0.001,930,974,100,2,0.001,1904,1
0.568,0.001,984,1020,100,2,0.001,2004,1
0.504,0.001,50,54,100,2,0.001,104,2
0.504,0.001,101,103,100,2,0.001,204,2
0.504,0.001,145,159,100,2,0.001,304,2
0.504,0.001,197,207,100,2,0.001,404,2
0.504,0.001,245,259,100,2,0.001,504,2
0.504,0.001,287,317,100,2,0.001,604,2
0.504,0.001,346,358,100,2,0.001,704,2
0.504,0.001,397,407,100,2,0.001,804,2
0.504,0.001,456,448,100,2,0.001,904,2
0.504,0.001,505,499,100,2,0.001,1004,2
0.504,0.001,553,551,100,2,0.001,1104,2
0.504,0.001,600,604,100,2,0.001,1204,2
0.504,0.001,645,659,100,2,0.001,1304,2
0.504,0.001,693,711,100,2,0.001,1404,2
0.504,0.001,751,753,100,2,0.001,1504,2
0.504,0.001,804,800,100,2,0.001,1604,2
0.504,0.001,852,852,100,2,0.001,1704,2
0.504,0.001,907,897,100,2,0.001,1804,2
0.504,0.001,948,956,100,2,0.001,1904,2
0.504,0.001,1000,1004,100,2,0.001,2004,2
0.52,0.001,47,57,100,2,0.001,104,3
0.524,0.001,94,110,100,2,0.001,204,3
0.522,0.001,150,154,100,2,0.001,304,3
0.522,0.001,196,208,100,2,0.001,404,3
0.522,0.001,238,266,100,2,0.001,504,3
0.52,0.001,282,322,100,2,0.001,604,3
0.518,0.001,346,358,100,2,0.001,704,3
0.52,0.001,394,410,100,2,0.001,804,3
0.524,0.001,439,465,100,2,0.001,904,3
0.522,0.001,493,511,100,2,0.001,1004,3
0.53,0.001,546,558,100,2,0.001,1104,3
0.53,0.001,591,613,100,2,0.001,1204,3
0.534,0.001,637,667,100,2,0.001,1304,3
0.534,0.001,688,716,100,2,0.001,1404,3
0.536,0.001,743,761,100,2,0.001,1504,3
0.546,0.001,800,804,100,2,0.001,1604,3
0.548,0.001,853,851,100,2,0.001,1704,3
0.558,0.001,903,901,100,2,0.001,1804,3
0.558,0.001,957,947,100,2,0.001,1904,3
0.554,0.001,1003,1001,100,2,0.001,2004,3
0.508,0.001,53,51,100,2,0.001,104,4
0.508,0.001,104,100,100,2,0.001,204,4
0.508,0.001,160,144,100,2,0.001,304,4
0.508,0.001,207,197,100,2,0.001,404,4
0.508,0.001,247,257,100,2,0.001,504,4
0.508,0.001,302,302,100,2,0.001,604,4
0.508,0.001,344,360,100,2,0.001,704,4
0.508,0.001,395,409,100,2,0.001,804,4
0.506,0.001,439,465,100,2,0.001,904,4
0.506,0.001,486,518,100,2,0.001,1004,4
0.506,0.001,539,565,100,2,0.001,1104,4
0.506,0.001,588,616,100,2,0.001,1204,4
0.506,0.001,631,673,100,2,0.001,1304,4
0.506,0.001,684,720,100,2,0.001,1404,4
0.506,0.001,731,773,100,2,0.001,1504,4
0.51,0.001,783,821,100,2,0.001,1604,4
0.514,0.001,847,857,100,2,0.001,1704,4
0.516,0.001,906,898,100,2,0.001,1804,4
0.524,0.001,950,954,100,2,0.001,1904,4
0.532,0.001,998,1006,100,2,0.001,2004,4
0.54,0.001,54,50,100,2,0.001,104,5
0.54,0.001,105,99,100,2,0.001,204,5
0.54,0.001,162,142,100,2,0.001,304,5
0.54,0.001,214,190,100,2,0.001,404,5
0.54,0.001,269,235,100,2,0.001,504,5
0.54,0.001,322,282,100,2,0.001,604,5
0.54,0.001,373,331,100,2,0.001,704,5
0.54,0.001,420,384,100,2,0.001,804,5
0.54,0.001,469,435,100,2,0.001,904,5
0.54,0.001,519,485,100,2,0.001,1004,5
0.54,0.001,566,538,100,2,0.001,1104,5
0.54,0.001,620,584,100,2,0.001,1204,5
0.54,0.001,660,644,100,2,0.001,1304,5
0.54,0.001,710,694,100,2,0.001,1404,5
0.54,0.001,759,745,100,2,0.001,1504,5
0.54,0.001,816,788,100,2,0.001,1604,5
0.54,0.001,862,842,100,2,0.001,1704,5
0.54,0.001,916,888,100,2,0.001,1804,5
0.544,0.001,972,932,100,2,0.001,1904,5
0.542,0.001,1022,982,100,2,0.001,2004,5
0.484,0.001,49,55,100,2,0.001,104,6
0.484,0.001,101,103,100,2,0.001,204,6
0.484,0.001,157,147,100,2,0.001,304,6
0.484,0.001,211,193,100,2,0.001,404,6
0.484,0.001,258,246,100,2,0.001,504,6
0.484,0.001,314,290,100,2,0.001,604,6
0.484,0.001,365,339,100,2,0.001,704,6
0.484,0.001,411,393,100,2,0.001,804,6
0.484,0.001,454,450,100,2,0.001,904,6
0.484,0.001,506,498,100,2,0.001,1004,6
0.484,0.001,552,552,100,2,0.001,1104,6
0.484,0.001,601,603,100,2,0.001,1204,6
0.484,0.001,653,651,100,2,0.001,1304,6
0.484,0.001,709,695,100,2,0.001,1404,6
0.484,0.001,753,751,100,2,0.001,1504,6
0.484,0.001,801,803,100,2,0.001,1604,6
0.484,0.001,842,862,100,2,0.001,1704,6
0.484,0.001,889,915,100,2,0.001,1804,6
0.484,0.001,942,962,100,2,0.001,1904,6
0.484,0.001,994,1010,100,2,0.001,2004,6
0.508,0.001,55,49,100,2,0.001,104,7
0.508,0.001,106,98,100,2,0.001,204,7
0.508,0.001,161,143,100,2,0.001,304,7
0.508,0.001,205,199,100,2,0.001,404,7
0.508,0.001,255,249,100,2,0.001,504,7
0.508,0.001,300,304,100,2,0.001,604,7
0.514,0.001,356,348,100,2,0.001,704,7
0.514,0.001,403,401,100,2,0.001,804,7
0.516,0.001,454,450,100,2,0.001,904,7
0.52,0.001,496,508,100,2,0.001,1004,7
0.524,0.001,551,553,100,2,0.001,1104,7
0.534,0.001,607,597,100,2,0.001,1204,7
0.538,0.001,656,648,100,2,0.001,1304,7
0.542,0.001,707,697,100,2,0.001,1404,7
0.55,0.001,762,742,100,2,0.001,1504,7
0.558,0.001,810,794,100,2,0.001,1604,7
0.566,0.001,861,843,100,2,0.001,1704,7
0.57,0.001,915,889,100,2,0.001,1804,7
0.574,0.001,949,955,100,2,0.001,1904,7
0.586,0.001,997,1007,100,2,0.001,2004,7
0.472,0.001,53,51,100,2,0.001,104,8
0.472,0.001,105,99,100,2,0.001,204,8
0.472,0.001,152,152,100,2,0.001,304,8
0.472,0.001,204,200,100,2,0.001,404,8
0.472,0.001,249,255,100,2,0.001,504,8
0.472,0.001,308,296,100,2,0.001,604,8
0.472,0.001,361,343,100,2,0.001,704,8
0.472,0.001,407,397,100,2,0.001,804,8
0.472,0.001,456,448,100,2,0.001,904,8
0.472,0.001,508,496,100,2,0.001,1004,8
0.472,0.001,554,550,100,2,0.001,1104,8
0.472,0.001,603,601,100,2,0.001,1204,8
0.472,0.001,655,649,100,2,0.001,1304,8
0.472,0.001,707,697,100,2,0.001,1404,8
0.472,0.001,757,747,100,2,0.001,1504,8
0.472,0.001,806,798,100,2,0.001,1604,8
0.472,0.001,860,844,100,2,0.001,1704,8
0.472,0.001,908,896,100,2,0.001,1804,8
0.472,0.001,957,947,100,2,0.001,1904,8
0.472,0.001,1016,988,100,2,0.001,2004,8
0.5,0.001,52,52,100,2,0.001,104,9
0.5,0.001,98,106,100,2,0.001,204,9
0.5,0.001,141,163,100,2,0.001,304,9
0.5,0.001,186,218,100,2,0.001,404,9
0.5,0.001,238,266,100,2,0.001,504,9
0.5,0.001,290,314,100,2,0.001,604,9
0.5,0.001,338,366,100,2,0.001,704,9
0.5,0.001,391,413,100,2,0.001,804,9
0.5,0.001,444,460,100,2,0.001,904,9
0.5,0.001,500,504,100,2,0.001,1004,9
0.5,0.001,551,553,100,2,0.001,1104,9
0.5,0.001,598,606,100,2,0.001,1204,9
0.5,0.001,646,658,100,2,0.001,1304,9
0.5,0.001,697,707,100,2,0.001,1404,9
0.5,0.001,743,761,100,2,0.001,1504,9
0.5,0.001,797,807,100,2,0.001,1604,9
0.5,0.001,845,859,100,2,0.001,1704,9
0.5,0.001,899,905,100,2,0.001,1804,9
0.5,0.001,958,946,100,2,0.001,1904,9
0.5,0.001,1002,1002,100,2,0.001,2004,9
0.49,0.001,38,66,100,2,0.001,104,10
0.49,0.001,85,119,100,2,0.001,204,10
0.49,0.001,137,167,100,2,0.001,304,10
0.488,0.001,188,216,100,2,0.001,404,10
0.488,0.001,230,274,100,2,0.001,504,10
0.488,0.001,281,323,100,2,0.001,604,10
0.488,0.001,330,374,100,2,0.001,704,10
0.49,0.001,383,421,100,2,0.001,804,10
0.49,0.001,431,473,100,2,0.001,904,10
0.492,0.001,478,526,100,2,0.001,1004,10
0.49,0.001,530,574,100,2,0.001,1104,10
0.492,0.001,576,628,100,2,0.001,1204,10
0.494,0.001,626,678,100,2,0.001,1304,10
0.494,0.001,681,723,100,2,0.001,1404,10
0.498,0.001,725,779,100,2,0.001,1504,10
0.498,0.001,785,819,100,2,0.001,1604,10
0.496,0.001,827,877,100,2,0.001,1704,10
0.502,0.001,887,917,100,2,0.001,1804,10
0.504,0.001,936,968,100,2,0.001,1904,10
0.518,0.001,994,1010,100,2,0.001,2004,10
0.5,0.001,52,52,100,2,0.001,104,11
0.502,0.001,106,98,100,2,0.001,204,11
0.502,0.001,157,147,100,2,0.001,304,11
0.506,0.001,210,194,100,2,0.001,404,11
0.504,0.001,260,244,100,2,0.001,504,11
0.508,0.001,307,297,100,2,0.001,604,11
0.508,0.001,358,346,100,2,0.001,704,11
0.518,0.001,404,400,100,2,0.001,804,11
0.52,0.001,454,450,100,2,0.001,904,11
0.518,0.001,506,498,100,2,0.001,1004,11
0.518,0.001,557,547,100,2,0.001,1104,11
0.518,0.001,605,599,100,2,0.001,1204,11
0.524,0.001,659,645,100,2,0.001,1304,11
0.526,0.001,708,696,100,2,0.001,1404,11
0.526,0.001,754,750,100,2,0.001,1504,11
0.52,0.001,806,798,100,2,0.001,1604,11
0.52,0.001,854,850,100,2,0.001,1704,11
0.518,0.001,904,900,100,2,0.001,1804,11
0.512,0.001,955,949,100,2,0.001,1904,11
0.51,0.001,1004,1000,100,2,0.001,2004,11
0.486,0.001,62,42,100,2,0.001,104,12
0.488,0.001,111,93,100,2,0.001,204,12
0.488,0.001,157,147,100,2,0.001,304,12
0.492,0.001,205,199,100,2,0.001,404,12
0.494,0.001,247,257,100,2,0.001,504,12
0.492,0.001,294,310,100,2,0.001,604,12
0.496,0.001,336,368,100,2,0.001,704,12
0.498,0.001,390,414,100,2,0.001,804,12
0.51,0.001,446,458,100,2,0.001,904,12
0.512,0.001,498,506,100,2,0.001,1004,12
0.514,0.001,552,552,100,2,0.001,1104,12
0.51,0.001,603,601,100,2,0.001,1204,12
0.514,0.001,653,651,100,2,0.001,1304,12
0.526,0.001,709,695,100,2,0.001,1404,12
0.534,0.001,767,737,100,2,0.001,1504,12
0.528,0.001,809,795,100,2,0.001,1604,12
0.524,0.001,854,850,100,2,0.001,1704,12
0.526,0.001,907,897,100,2,0.001,1804,12
0.528,0.001,955,949,100,2,0.001,1904,12
0.53,0.001,1006,998,100,2,0.001,2004,12
0.526,0.001,44,60,100,2,0.001,104,13
0.526,0.001,96,108,100,2,0.001,204,13
0.526,0.001,146,158,100,2,0.001,304,13
0.526,0.001,196,208,100,2,0.001,404,13
0.526,0.001,245,259,100,2,0.001,504,13
0.526,0.001,302,302,100,2,0.001,604,13
0.526,0.001,351,353,100,2,0.001,704,13
0.526,0.001,404,400,100,2,0.001,804,13
0.526,0.001,458,446,100,2,0.001,904,13
0.526,0.001,509,495,100,2,0.001,1004,13
0.526,0.001,549,555,100,2,0.001,1104,13
0.526,0.001,602,602,100,2,0.001,1204,13
0.526,0.001,649,655,100,2,0.001,1304,13
0.526,0.001,709,695,100,2,0.001,1404,13
0.526,0.001,752,752,100,2,0.001,1504,13
0.526,0.001,799,805,100,2,0.001,1604,13
0.526,0.001,841,863,100,2,0.001,1704,13
0.526,0.001,888,916,100,2,0.001,1804,13
0.526,0.001,937,967,100,2,0.001,1904,13
0.526,0.001,989,1015,100,2,0.001,2004,13
0.496,0.001,46,58,100,2,0.001,104,14
0.494,0.001,102,102,100,2,0.001,204,14
0.494,0.001,147,157,100,2,0.001,304,14
0.494,0.001,199,205,100,2,0.001,404,14
0.502,0.001,245,259,100,2,0.001,504,14
0.504,0.001,287,317,100,2,0.001,604,14
0.506,0.001,343,361,100,2,0.001,704,14
0.508,0.001,397,407,100,2,0.001,804,14
0.512,0.001,439,465,100,2,0.001,904,14
0.512,0.001,489,515,100,2,0.001,1004,14
0.512,0.001,546,558,100,2,0.001,1104,14
0.516,0.001,601,603,100,2,0.001,1204,14
0.52,0.001,649,655,100,2,0.001,1304,14
0.526,0.001,702,702,100,2,0.001,1404,14
0.53,0.001,755,749,100,2,0.001,1504,14
0.536,0.001,812,792,100,2,0.001,1604,14
0.544,0.001,866,838,100,2,0.001,1704,14
0.54,0.001,919,885,100,2,0.001,1804,14
0.542,0.001,959,945,100,2,0.001,1904,14
0.542,0.001,1008,996,100,2,0.001,2004,14
0.512,0.001,50,54,100,2,0.001,104,15
0.516,0.001,92,112,100,2,0.001,204,15
0.522,0.001,143,161,100,2,0.001,304,15
0.528,0.001,188,216,100,2,0.001,404,15
0.526,0.001,244,260,100,2,0.001,504,15
0.52,0.001,287,317,100,2,0.001,604,15
0.522,0.001,339,365,100,2,0.001,704,15
0.52,0.001,380,424,100,2,0.001,804,15
0.516,0.001,436,468,100,2,0.001,904,15
0.52,0.001,485,519,100,2,0.001,1004,15
0.526,0.001,545,559,100,2,0.001,1104,15
0.53,0.001,595,609,100,2,0.001,1204,15
0.532,0.001,642,662,100,2,0.001,1304,15
0.53,0.001,698,706,100,2,0.001,1404,15
0.532,0.001,752,752,100,2,0.001,1504,15
0.536,0.001,799,805,100,2,0.001,1604,15
0.542,0.001,846,858,100,2,0.001,1704,15
0.552,0.001,894,910,100,2,0.001,1804,15
0.55,0.001,946,958,100,2,0.001,1904,15
0.556,0.001,997,1007,100,2,0.001,2004,15
0.53,0.001,52,52,100,2,0.001,104,16
0.53,0.001,111,93,100,2,0.001,204,16
0.53,0.001,155,149,100,2,0.001,304,16
0.53,0.001,200,204,100,2,0.001,404,16
0.53,0.001,245,259,100,2,0.001,504,16
0.53,0.001,293,311,100,2,0.001,604,16
0.53,0.001,350,354,100,2,0.001,704,16
0.53,0.001,404,400,100,2,0.001,804,16
0.53,0.001,455,449,100,2,0.001,904,16
0.53,0.001,502,502,100,2,0.001,1004,16
0.53,0.001,555,549,100,2,0.001,1104,16
0.53,0.001,598,606,100,2,0.001,1204,16
0.53,0.001,646,658,100,2,0.001,1304,16
0.53,0.001,702,702,100,2,0.001,1404,16
0.53,0.001,755,749,100,2,0.001,1504,16
0.53,0.001,802,802,100,2,0.001,1604,16
0.53,0.001,860,844,100,2,0.001,1704,16
0.53,0.001,914,890,100,2,0.001,1804,16
0.53,0.001,972,932,100,2,0.001,1904,16
0.53,0.001,1017,987,100,2,0.001,2004,16
0.512,0.001,57,47,100,2,0.001,104,17
0.512,0.001,103,101,100,2,0.001,204,17
0.512,0.001,153,151,100,2,0.001,304,17
0.512,0.001,209,195,100,2,0.001,404,17
0.512,0.001,259,245,100,2,0.001,504,17
0.512,0.001,305,299,100,2,0.001,604,17
0.512,0.001,354,350,100,2,0.001,704,17
0.512,0.001,398,406,100,2,0.001,804,17
0.512,0.001,444,460,100,2,0.001,904,17
0.512,0.001,497,507,100,2,0.001,1004,17
0.512,0.001,546,558,100,2,0.001,1104,17
0.512,0.001,599,605,100,2,0.001,1204,17
0.512,0.001,643,661,100,2,0.001,1304,17
0.512,0.001,697,707,100,2,0.001,1404,17
0.512,0.001,748,756,100,2,0.001,1504,17
0.512,0.001,802,802,100,2,0.001,1604,17
0.512,0.001,847,857,100,2,0.001,1704,17
0.512,0.001,901,903,100,2,0.001,1804,17
0.512,0.001,948,956,100,2,0.001,1904,17
0.512,0.001,996,1008,100,2,0.001,2004,17
0.486,0.001,61,43,100,2,0.001,104,18
0.486,0.001,107,97,100,2,0.001,204,18
0.486,0.001,160,144,100,2,0.001,304,18
0.486,0.001,217,187,100,2,0.001,404,18
0.486,0.001,270,234,100,2,0.001,504,18
0.486,0.001,318,286,100,2,0.001,604,18
0.486,0.001,369,335,100,2,0.001,704,18
0.486,0.001,405,399,100,2,0.001,804,18
0.486,0.001,457,447,100,2,0.001,904,18
0.486,0.001,500,504,100,2,0.001,1004,18
0.486,0.001,545,559,100,2,0.001,1104,18
0.486,0.001,597,607,100,2,0.001,1204,18
0.486,0.001,647,657,100,2,0.001,1304,18
0.486,0.001,694,710,100,2,0.001,1404,18
0.486,0.001,751,753,100,2,0.001,1504,18
0.486,0.001,796,808,100,2,0.001,1604,18
0.486,0.001,847,857,100,2,0.001,1704,18
0.486,0.001,903,901,100,2,0.001,1804,18
0.486,0.001,957,947,100,2,0.001,1904,18
0.486,0.001,1009,995,100,2,0.001,2004,18
0.486,0.001,50,54,100,2,0.001,104,19
0.486,0.001,108,96,100,2,0.001,204,19
0.486,0.001,163,141,100,2,0.001,304,19
0.486,0.001,215,189,100,2,0.001,404,19
0.486,0.001,266,238,100,2,0.001,504,19
0.486,0.001,310,294,100,2,0.001,604,19
0.486,0.001,356,348,100,2,0.001,704,19
0.486,0.001,405,399,100,2,0.001,804,19
0.486,0.001,457,447,100,2,0.001,904,19
0.486,0.001,501,503,100,2,0.001,1004,19
0.486,0.001,555,549,100,2,0.001,1104,19
0.486,0.001,603,601,100,2,0.001,1204,19
0.486,0.001,654,650,100,2,0.001,1304,19
0.486,0.001,708,696,100,2,0.001,1404,19
0.486,0.001,762,742,100,2,0.001,1504,19
0.486,0.001,807,797,100,2,0.001,1604,19
0.486,0.001,852,852,100,2,0.001,1704,19
0.486,0.001,898,906,100,2,0.001,1804,19
0.486,0.001,952,952,100,2,0.001,1904,19
0.486,0.001,995,1009,100,2,0.001,2004,19
0.54,0.001,51,53,100,2,0.001,104,20
0.544,0.001,104,100,100,2,0.001,204,20
0.55,0.001,156,148,100,2,0.001,304,20
0.55,0.001,209,195,100,2,0.001,404,20
0.552,0.001,251,253,100,2,0.001,504,20
0.552,0.001,295,309,100,2,0.001,604,20
0.55,0.001,345,359,100,2,0.001,704,20
0.55,0.001,397,407,100,2,0.001,804,20
0.552,0.001,451,453,100,2,0.001,904,20
0.554,0.001,499,505,100,2,0.001,1004,20
0.56,0.001,552,552,100,2,0.001,1104,20
0.56,0.001,605,599,100,2,0.001,1204,20
0.56,0.001,656,648,100,2,0.001,1304,20
0.562,0.001,704,700,100,2,0.001,1404,20
0.566,0.001,754,750,100,2,0.001,1504,20
0.57,0.001,798,806,100,2,0.001,1604,20
0.574,0.001,853,851,100,2,0.001,1704,20
0.582,0.001,906,898,100,2,0.001,1804,20
0.586,0.001,965,939,100,2,0.001,1904,20
0.588,0.001,1015,989,100,2,0.001,2004,20
0.512,0.001,54,50,100,2,0.01,104,1
0.512,0.001,105,99,100,2,0.01,204,1
0.512,0.001,161,143,100,2,0.01,304,1
0.512,0.001,208,196,100,2,0.01,404,1
0.512,0.001,261,243,100,2,0.01,504,1
0.516,0.001,306,298,100,2,0.01,604,1
0.52,0.001,350,354,100,2,0.01,704,1
0.538,0.001,400,404,100,2,0.01,804,1
0.548,0.001,443,461,100,2,0.01,904,1
0.55,0.001,496,508,100,2,0.01,1004,1
0.562,0.001,536,568,100,2,0.01,1104,1
0.59,0.001,585,619,100,2,0.01,1204,1
0.586,0.001,635,669,100,2,0.01,1304,1
0.6,0.001,688,716,100,2,0.01,1404,1
0.612,0.001,739,765,100,2,0.01,1504,1
0.62,0.001,796,808,100,2,0.01,1604,1
0.632,0.001,847,857,100,2,0.01,1704,1
0.638,0.001,900,904,100,2,0.01,1804,1
0.646,0.001,941,963,100,2,0.01,1904,1
0.648,0.001,996,1008,100,2,0.01,2004,1
0.512,0.001,48,56,100,2,0.01,104,2
0.512,0.001,100,104,100,2,0.01,204,2
0.514,0.001,155,149,100,2,0.01,304,2
0.504,0.001,194,210,100,2,0.01,404,2
0.502,0.001,244,260,100,2,0.01,504,2
0.486,0.001,293,311,100,2,0.01,604,2
0.5,0.001,342,362,100,2,0.01,704,2
0.514,0.001,398,406,100,2,0.01,804,2
0.522,0.001,443,461,100,2,0.01,904,2
0.536,0.001,506,498,100,2,0.01,1004,2
0.554,0.001,566,538,100,2,0.01,1104,2
0.592,0.001,611,593,100,2,0.01,1204,2
0.622,0.001,657,647,100,2,0.01,1304,2
0.644,0.001,711,693,100,2,0.01,1404,2
0.658,0.001,767,737,100,2,0.01,1504,2
0.722,0.001,811,793,100,2,0.01,1604,2
0.758,0.001,856,848,100,2,0.01,1704,2
0.816,0.001,904,900,100,2,0.01,1804,2
0.832,0.001,953,951,100,2,0.01,1904,2
0.854,0.001,996,1008,100,2,0.01,2004,2
0.522,0.001,45,59,100,2,0.01,104,3
0.522,0.001,86,118,100,2,0.01,204,3
0.522,0.001,140,164,100,2,0.01,304,3
0.522,0.001,188,216,100,2,0.01,404,3
0.522,0.001,232,272,100,2,0.01,504,3
0.522,0.001,282,322,100,2,0.01,604,3
0.522,0.001,331,373,100,2,0.01,704,3
0.522,0.001,391,413,100,2,0.01,804,3
0.522,0.001,443,461,100,2,0.01,904,3
0.522,0.001,494,510,100,2,0.01,1004,3
0.522,0.001,546,558,100,2,0.01,1104,3
0.522,0.001,591,613,100,2,0.01,1204,3
0.522,0.001,637,667,100,2,0.01,1304,3
0.522,0.001,686,718,100,2,0.01,1404,3
0.522,0.001,740,764,100,2,0.01,1504,3
0.522,0.001,790,814,100,2,0.01,1604,3
0.522,0.001,836,868,100,2,0.01,1704,3
0.522,0.001,892,912,100,2,0.01,1804,3
0.856,0.001,940,964,100,2,0.01,1904,3
0.916,0.001,991,1013,100,2,0.01,2004,3
0.496,0.001,45,59,100,2,0.01,104,4
0.518,0.001,97,107,100,2,0.01,204,4
0.52,0.001,144,160,100,2,0.01,304,4
0.534,0.001,197,207,100,2,0.01,404,4
0.53,0.001,246,258,100,2,0.01,504,4
0.54,0.001,292,312,100,2,0.01,604,4
0.546,0.001,345,359,100,2,0.01,704,4
0.544,0.001,386,418,100,2,0.01,804,4
0.552,0.001,438,466,100,2,0.01,904,4
0.568,0.001,491,513,100,2,0.01,1004,4
0.59,0.001,545,559,100,2,0.01,1104,4
0.604,0.001,589,615,100,2,0.01,1204,4
0.622,0.001,633,671,100,2,0.01,1304,4
0.634,0.001,689,715,100,2,0.01,1404,4
0.648,0.001,741,763,100,2,0.01,1504,4
0.7,0.001,793,811,100,2,0.01,1604,4
0.714,0.001,844,860,100,2,0.01,1704,4
0.712,0.001,891,913,100,2,0.01,1804,4
0.718,0.001,953,951,100,2,0.01,1904,4
0.726,0.001,1006,998,100,2,0.01,2004,4
0.484,0.001,57,47,100,2,0.01,104,5
0.476,0.001,108,96,100,2,0.01,204,5
0.47,0.001,158,146,100,2,0.01,304,5
0.506,0.001,207,197,100,2,0.01,404,5
0.522,0.001,249,255,100,2,0.01,504,5
0.568,0.001,292,312,100,2,0.01,604,5
0.562,0.001,337,367,100,2,0.01,704,5
0.598,0.001,390,414,100,2,0.01,804,5
0.612,0.001,449,455,100,2,0.01,904,5
0.616,0.001,506,498,100,2,0.01,1004,5
0.616,0.001,551,553,100,2,0.01,1104,5
0.634,0.001,606,598,100,2,0.01,1204,5
0.662,0.001,657,647,100,2,0.01,1304,5
0.674,0.001,699,705,100,2,0.01,1404,5
0.658,0.001,747,757,100,2,0.01,1504,5
0.668,0.001,802,802,100,2,0.01,1604,5
0.69,0.001,858,846,100,2,0.01,1704,5
0.692,0.001,910,894,100,2,0.01,1804,5
0.678,0.001,960,944,100,2,0.01,1904,5
0.68,0.001,1008,996,100,2,0.01,2004,5
0.512,0.001,62,42,100,2,0.01,104,6
0.518,0.001,111,93,100,2,0.01,204,6
0.528,0.001,152,152,100,2,0.01,304,6
0.532,0.001,197,207,100,2,0.01,404,6
0.526,0.001,243,261,100,2,0.01,504,6
0.524,0.001,297,307,100,2,0.01,604,6
0.53,0.001,344,360,100,2,0.01,704,6
0.524,0.001,393,411,100,2,0.01,804,6
0.534,0.001,448,456,100,2,0.01,904,6
0.56,0.001,496,508,100,2,0.01,1004,6
0.568,0.001,552,552,100,2,0.01,1104,6
0.576,0.001,613,591,100,2,0.01,1204,6
0.592,0.001,669,635,100,2,0.01,1304,6
0.598,0.001,714,690,100,2,0.01,1404,6
0.598,0.001,755,749,100,2,0.01,1504,6
0.616,0.001,809,795,100,2,0.01,1604,6
0.624,0.001,858,846,100,2,0.01,1704,6
0.626,0.001,905,899,100,2,0.01,1804,6
0.636,0.001,956,948,100,2,0.01,1904,6
0.644,0.001,1007,997,100,2,0.01,2004,6
0.516,0.001,43,61,100,2,0.01,104,7
0.514,0.001,95,109,100,2,0.01,204,7
0.534,0.001,145,159,100,2,0.01,304,7
0.56,0.001,191,213,100,2,0.01,404,7
0.558,0.001,234,270,100,2,0.01,504,7
0.532,0.001,280,324,100,2,0.01,604,7
0.518,0.001,325,379,100,2,0.01,704,7
0.522,0.001,374,430,100,2,0.01,804,7
0.52,0.001,428,476,100,2,0.01,904,7
0.522,0.001,488,516,100,2,0.01,1004,7
0.536,0.001,539,565,100,2,0.01,1104,7
0.552,0.001,590,614,100,2,0.01,1204,7
0.578,0.001,637,667,100,2,0.01,1304,7
0.606,0.001,695,709,100,2,0.01,1404,7
0.606,0.001,743,761,100,2,0.01,1504,7
0.614,0.001,801,803,100,2,0.01,1604,7
0.628,0.001,846,858,100,2,0.01,1704,7
0.658,0.001,898,906,100,2,0.01,1804,7
0.67,0.001,945,959,100,2,0.01,1904,7
0.692,0.001,991,1013,100,2,0.01,2004,7
0.454,0.001,55,49,100,2,0.01,104,8
0.46,0.001,114,90,100,2,0.01,204,8
0.474,0.001,159,145,100,2,0.01,304,8
0.496,0.001,209,195,100,2,0.01,404,8
0.506,0.001,272,232,100,2,0.01,504,8
0.512,0.001,314,290,100,2,0.01,604,8
0.52,0.001,367,337,100,2,0.01,704,8
0.534,0.001,418,386,100,2,0.01,804,8
0.548,0.001,474,430,100,2,0.01,904,8
0.55,0.001,530,474,100,2,0.01,1004,8
0.552,0.001,578,526,100,2,0.01,1104,8
0.578,0.001,620,584,100,2,0.01,1204,8
0.566,0.001,673,631,100,2,0.01,1304,8
0.592,0.001,720,684,100,2,0.01,1404,8
0.578,0.001,773,731,100,2,0.01,1504,8
0.596,0.001,822,782,100,2,0.01,1604,8
0.614,0.001,868,836,100,2,0.01,1704,8
0.618,0.001,906,898,100,2,0.01,1804,8
0.64,0.001,955,949,100,2,0.01,1904,8
0.644,0.001,1018,986,100,2,0.01,2004,8
0.498,0.001,52,52,100,2,0.01,104,9
0.498,0.001,102,102,100,2,0.01,204,9
0.498,0.001,154,150,100,2,0.01,304,9
0.498,0.001,197,207,100,2,0.01,404,9
0.498,0.001,243,261,100,2,0.01,504,9
0.498,0.001,296,308,100,2,0.01,604,9
0.498,0.001,344,360,100,2,0.01,704,9
0.498,0.001,401,403,100,2,0.01,804,9
0.498,0.001,443,461,100,2,0.01,904,9
0.498,0.001,496,508,100,2,0.01,1004,9
0.498,0.001,543,561,100,2,0.01,1104,9
0.498,0.001,588,616,100,2,0.01,1204,9
0.498,0.001,639,665,100,2,0.01,1304,9
0.498,0.001,692,712,100,2,0.01,1404,9
0.498,0.001,743,761,100,2,0.01,1504,9
0.498,0.001,791,813,100,2,0.01,1604,9
0.498,0.001,846,858,100,2,0.01,1704,9
0.498,0.001,901,903,100,2,0.01,1804,9
0.498,0.001,956,948,100,2,0.01,1904,9
0.808,0.001,1003,1001,100,2,0.01,2004,9
0.498,0.001,56,48,100,2,0.01,104,10
0.5,0.001,103,101,100,2,0.01,204,10
0.508,0.001,146,158,100,2,0.01,304,10
0.508,0.001,200,204,100,2,0.01,404,10
0.522,0.001,248,256,100,2,0.01,504,10
0.534,0.001,299,305,100,2,0.01,604,10
0.518,0.001,346,358,100,2,0.01,704,10
0.518,0.001,398,406,100,2,0.01,804,10
0.512,0.001,442,462,100,2,0.01,904,10
0.5,0.001,490,514,100,2,0.01,1004,10
0.524,0.001,547,557,100,2,0.01,1104,10
0.586,0.001,596,608,100,2,0.01,1204,10
0.616,0.001,655,649,100,2,0.01,1304,10
0.636,0.001,714,690,100,2,0.01,1404,10
0.646,0.001,761,743,100,2,0.01,1504,10
0.65,0.001,802,802,100,2,0.01,1604,10
0.656,0.001,845,859,100,2,0.01,1704,10
0.646,0.001,903,901,100,2,0.01,1804,10
0.672,0.001,955,949,100,2,0.01,1904,10
0.666,0.001,1005,999,100,2,0.01,2004,10
0.474,0.001,63,41,100,2,0.01,104,11
0.474,0.001,101,103,100,2,0.01,204,11
0.476,0.001,147,157,100,2,0.01,304,11
0.476,0.001,191,213,100,2,0.01,404,11
0.49,0.001,242,262,100,2,0.01,504,11
0.498,0.001,293,311,100,2,0.01,604,11
0.508,0.001,344,360,100,2,0.01,704,11
0.506,0.001,394,410,100,2,0.01,804,11
0.534,0.001,440,464,100,2,0.01,904,11
0.538,0.001,481,523,100,2,0.01,1004,11
0.534,0.001,544,560,100,2,0.01,1104,11
0.55,0.001,586,618,100,2,0.01,1204,11
0.566,0.001,647,657,100,2,0.01,1304,11
0.57,0.001,703,701,100,2,0.01,1404,11
0.568,0.001,755,749,100,2,0.01,1504,11
0.588,0.001,806,798,100,2,0.01,1604,11
0.598,0.001,858,846,100,2,0.01,1704,11
0.616,0.001,905,899,100,2,0.01,1804,11
0.646,0.001,954,950,100,2,0.01,1904,11
0.66,0.001,996,1008,100,2,0.01,2004,11
0.486,0.001,53,51,100,2,0.01,104,12
0.486,0.001,99,105,100,2,0.01,204,12
0.486,0.001,153,151,100,2,0.01,304,12
0.486,0.001,204,200,100,2,0.01,404,12
0.486,0.001,252,252,100,2,0.01,504,12
0.486,0.001,303,301,100,2,0.01,604,12
0.486,0.001,359,345,100,2,0.01,704,12
0.486,0.001,411,393,100,2,0.01,804,12
0.486,0.001,460,444,100,2,0.01,904,12
0.486,0.001,505,499,100,2,0.01,1004,12
0.486,0.001,554,550,100,2,0.01,1104,12
0.486,0.001,605,599,100,2,0.01,1204,12
0.486,0.001,661,643,100,2,0.01,1304,12
0.486,0.001,712,692,100,2,0.01,1404,12
0.486,0.001,762,742,100,2,0.01,1504,12
0.486,0.001,820,784,100,2,0.01,1604,12
0.486,0.001,865,839,100,2,0.01,1704,12
0.822,0.001,910,894,100,2,0.01,1804,12
0.874,0.001,962,942,100,2,0.01,1904,12
0.934,0.001,1009,995,100,2,0.01,2004,12
0.502,0.001,54,50,100,2,0.01,104,13
0.502,0.001,111,93,100,2,0.01,204,13
0.504,0.001,159,145,100,2,0.01,304,13
0.498,0.001,202,202,100,2,0.01,404,13
0.502,0.001,249,255,100,2,0.01,504,13
0.518,0.001,304,300,100,2,0.01,604,13
0.518,0.001,357,347,100,2,0.01,704,13
0.514,0.001,406,398,100,2,0.01,804,13
0.518,0.001,451,453,100,2,0.01,904,13
0.524,0.001,504,500,100,2,0.01,1004,13
0.562,0.001,554,550,100,2,0.01,1104,13
0.58,0.001,600,604,100,2,0.01,1204,13
0.584,0.001,648,656,100,2,0.01,1304,13
0.58,0.001,694,710,100,2,0.01,1404,13
0.572,0.001,745,759,100,2,0.01,1504,13
0.58,0.001,789,815,100,2,0.01,1604,13
0.6,0.001,838,866,100,2,0.01,1704,13
0.606,0.001,889,915,100,2,0.01,1804,13
0.61,0.001,948,956,100,2,0.01,1904,13
0.614,0.001,1001,1003,100,2,0.01,2004,13
0.5,0.001,47,57,100,2,0.01,104,14
0.5,0.001,97,107,100,2,0.01,204,14
0.5,0.001,146,158,100,2,0.01,304,14
0.5,0.001,193,211,100,2,0.01,404,14
0.5,0.001,244,260,100,2,0.01,504,14
0.5,0.001,291,313,100,2,0.01,604,14
0.5,0.001,347,357,100,2,0.01,704,14
0.5,0.001,397,407,100,2,0.01,804,14
0.5,0.001,438,466,100,2,0.01,904,14
0.5,0.001,485,519,100,2,0.01,1004,14
0.5,0.001,538,566,100,2,0.01,1104,14
0.5,0.001,588,616,100,2,0.01,1204,14
0.5,0.001,638,666,100,2,0.01,1304,14
0.5,0.001,686,718,100,2,0.01,1404,14
0.5,0.001,732,772,100,2,0.01,1504,14
0.5,0.001,793,811,100,2,0.01,1604,14
0.5,0.001,850,854,100,2,0.01,1704,14
0.5,0.001,903,901,100,2,0.01,1804,14
0.5,0.001,953,951,100,2,0.01,1904,14
0.5,0.001,1002,1002,100,2,0.01,2004,14
0.502,0.001,55,49,100,2,0.01,104,15
0.518,0.001,108,96,100,2,0.01,204,15
0.54,0.001,163,141,100,2,0.01,304,15
0.562,0.001,204,200,100,2,0.01,404,15
0.566,0.001,252,252,100,2,0.01,504,15
0.568,0.001,301,303,100,2,0.01,604,15
0.562,0.001,351,353,100,2,0.01,704,15
0.574,0.001,406,398,100,2,0.01,804,15
0.57,0.001,452,452,100,2,0.01,904,15
0.568,0.001,504,500,100,2,0.01,1004,15
0.562,0.001,552,552,100,2,0.01,1104,15
0.584,0.001,604,600,100,2,0.01,1204,15
0.62,0.001,656,648,100,2,0.01,1304,15
0.654,0.001,705,699,100,2,0.01,1404,15
0.696,0.001,758,746,100,2,0.01,1504,15
0.732,0.001,817,787,100,2,0.01,1604,15
0.75,0.001,866,838,100,2,0.01,1704,15
0.788,0.001,908,896,100,2,0.01,1804,15
0.826,0.001,952,952,100,2,0.01,1904,15
0.856,0.001,1002,1002,100,2,0.01,2004,15
0.486,0.001,59,45,100,2,0.01,104,16
0.498,0.001,113,91,100,2,0.01,204,16
0.498,0.001,157,147,100,2,0.01,304,16
0.498,0.001,211,193,100,2,0.01,404,16
0.498,0.001,260,244,100,2,0.01,504,16
0.498,0.001,304,300,100,2,0.01,604,16
0.506,0.001,353,351,100,2,0.01,704,16
0.524,0.001,399,405,100,2,0.01,804,16
0.54,0.001,439,465,100,2,0.01,904,16
0.56,0.001,496,508,100,2,0.01,1004,16
0.582,0.001,542,562,100,2,0.01,1104,16
0.632,0.001,590,614,100,2,0.01,1204,16
0.66,0.001,638,666,100,2,0.01,1304,16
0.722,0.001,697,707,100,2,0.01,1404,16
0.77,0.001,751,753,100,2,0.01,1504,16
0.83,0.001,804,800,100,2,0.01,1604,16
0.84,0.001,856,848,100,2,0.01,1704,16
0.86,0.001,906,898,100,2,0.01,1804,16
0.884,0.001,957,947,100,2,0.01,1904,16
0.904,0.001,1003,1001,100,2,0.01,2004,16
0.508,0.001,52,52,100,2,0.01,104,17
0.502,0.001,97,107,100,2,0.01,204,17
0.502,0.001,139,165,100,2,0.01,304,17
0.508,0.001,193,211,100,2,0.01,404,17
0.5,0.001,247,257,100,2,0.01,504,17
0.512,0.001,296,308,100,2,0.01,604,17
0.528,0.001,345,359,100,2,0.01,704,17
0.53,0.001,396,408,100,2,0.01,804,17
0.536,0.001,445,459,100,2,0.01,904,17
0.556,0.001,495,509,100,2,0.01,1004,17
0.556,0.001,544,560,100,2,0.01,1104,17
0.544,0.001,600,604,100,2,0.01,1204,17
0.546,0.001,649,655,100,2,0.01,1304,17
0.572,0.001,703,701,100,2,0.01,1404,17
0.578,0.001,747,757,100,2,0.01,1504,17
0.602,0.001,795,809,100,2,0.01,1604,17
0.624,0.001,853,851,100,2,0.01,1704,17
0.664,0.001,904,900,100,2,0.01,1804,17
0.672,0.001,956,948,100,2,0.01,1904,17
0.714,0.001,1005,999,100,2,0.01,2004,17
0.508,0.001,47,57,100,2,0.01,104,18
0.522,0.001,105,99,100,2,0.01,204,18
0.538,0.001,152,152,100,2,0.01,304,18
0.534,0.001,208,196,100,2,0.01,404,18
0.544,0.001,262,242,100,2,0.01,504,18
0.568,0.001,305,299,100,2,0.01,604,18
0.592,0.001,355,349,100,2,0.01,704,18
0.606,0.001,412,392,100,2,0.01,804,18
0.63,0.001,464,440,100,2,0.01,904,18
0.648,0.001,512,492,100,2,0.01,1004,18
0.684,0.001,563,541,100,2,0.01,1104,18
0.734,0.001,620,584,100,2,0.01,1204,18
0.762,0.001,664,640,100,2,0.01,1304,18
0.82,0.001,711,693,100,2,0.01,1404,18
0.844,0.001,768,736,100,2,0.01,1504,18
0.87,0.001,818,786,100,2,0.01,1604,18
0.878,0.001,867,837,100,2,0.01,1704,18
0.894,0.001,914,890,100,2,0.01,1804,18
0.896,0.001,965,939,100,2,0.01,1904,18
0.908,0.001,1005,999,100,2,0.01,2004,18
0.522,0.001,51,53,100,2,0.01,104,19
0.534,0.001,98,106,100,2,0.01,204,19
0.522,0.001,158,146,100,2,0.01,304,19
0.522,0.001,219,185,100,2,0.01,404,19
0.518,0.001,267,237,100,2,0.01,504,19
0.52,0.001,311,293,100,2,0.01,604,19
0.542,0.001,359,345,100,2,0.01,704,19
0.546,0.001,402,402,100,2,0.01,804,19
0.556,0.001,452,452,100,2,0.01,904,19
0.55,0.001,507,497,100,2,0.01,1004,19
0.552,0.001,552,552,100,2,0.01,1104,19
0.556,0.001,602,602,100,2,0.01,1204,19
0.576,0.001,659,645,100,2,0.01,1304,19
0.616,0.001,702,702,100,2,0.01,1404,19
0.622,0.001,752,752,100,2,0.01,1504,19
0.64,0.001,812,792,100,2,0.01,1604,19
0.632,0.001,865,839,100,2,0.01,1704,19
0.702,0.001,915,889,100,2,0.01,1804,19
0.7,0.001,964,940,100,2,0.01,1904,19
0.728,0.001,1007,997,100,2,0.01,2004,19
0.522,0.001,45,59,100,2,0.01,104,20
0.516,0.001,94,110,100,2,0.01,204,20
0.516,0.001,144,160,100,2,0.01,304,20
0.522,0.001,191,213,100,2,0.01,404,20
0.526,0.001,238,266,100,2,0.01,504,20
0.538,0.001,297,307,100,2,0.01,604,20
0.546,0.001,346,358,100,2,0.01,704,20
0.54,0.001,391,413,100,2,0.01,804,20
0.54,0.001,439,465,100,2,0.01,904,20
0.552,0.001,496,508,100,2,0.01,1004,20
0.55,0.001,540,564,100,2,0.01,1104,20
0.542,0.001,586,618,100,2,0.01,1204,20
0.546,0.001,636,668,100,2,0.01,1304,20
0.554,0.001,684,720,100,2,0.01,1404,20
0.568,0.001,737,767,100,2,0.01,1504,20
0.57,0.001,778,826,100,2,0.01,1604,20
0.566,0.001,829,875,100,2,0.01,1704,20
0.588,0.001,886,918,100,2,0.01,1804,20
0.618,0.001,928,976,100,2,0.01,1904,20
0.64,0.001,984,1020,100,2,0.01,2004,20
0.49,1e-05,48,56,100,10,0.0001,104,1
0.492,1e-05,107,97,100,10,0.0001,204,1
0.492,1e-05,156,148,100,10,0.0001,304,1
0.492,1e-05,206,198,100,10,0.0001,404,1
0.494,1e-05,259,245,100,10,0.0001,504,1
0.494,1e-05,310,294,100,10,0.0001,604,1
0.492,1e-05,358,346,100,10,0.0001,704,1
0.492,1e-05,415,389,100,10,0.0001,804,1
0.492,1e-05,466,438,100,10,0.0001,904,1
0.492,1e-05,514,490,100,10,0.0001,1004,1
0.49,1e-05,564,540,100,10,0.0001,1104,1
0.492,1e-05,613,591,100,10,0.0001,1204,1
0.492,1e-05,659,645,100,10,0.0001,1304,1
0.496,1e-05,700,704,100,10,0.0001,1404,1
0.494,1e-05,751,753,100,10,0.0001,1504,1
0.496,1e-05,795,809,100,10,0.0001,1604,1
0.496,1e-05,838,866,100,10,0.0001,1704,1
0.496,1e-05,887,917,100,10,0.0001,1804,1
0.498,1e-05,937,967,100,10,0.0001,1904,1
0.5,1e-05,991,1013,100,10,0.0001,2004,1
0.506,1e-05,58,46,100,10,0.0001,104,2
0.506,1e-05,104,100,100,10,0.0001,204,2
0.506,1e-05,151,153,100,10,0.0001,304,2
0.506,1e-05,197,207,100,10,0.0001,404,2
0.506,1e-05,249,255,100,10,0.0001,504,2
0.506,1e-05,309,295,100,10,0.0001,604,2
0.506,1e-05,355,349,100,10,0.0001,704,2
0.506,1e-05,402,402,100,10,0.0001,804,2
0.506,1e-05,445,459,100,10,0.0001,904,2
0.508,1e-05,496,508,100,10,0.0001,1004,2
0.508,1e-05,557,547,100,10,0.0001,1104,2
0.508,1e-05,597,607,100,10,0.0001,1204,2
0.508,1e-05,653,651,100,10,0.0001,1304,2
0.512,1e-05,704,700,100,10,0.0001,1404,2
0.514,1e-05,750,754,100,10,0.0001,1504,2
0.514,1e-05,808,796,100,10,0.0001,1604,2
0.512,1e-05,866,838,100,10,0.0001,1704,2
0.514,1e-05,918,886,100,10,0.0001,1804,2
0.512,1e-05,967,937,100,10,0.0001,1904,2
0.516,1e-05,1007,997,100,10,0.0001,2004,2
0.486,1e-05,55,49,100,10,0.0001,104,3
0.486,1e-05,94,110,100,10,0.0001,204,3
0.486,1e-05,143,161,100,10,0.0001,304,3
0.486,1e-05,196,208,100,10,0.0001,404,3
0.486,1e-05,245,259,100,10,0.0001,504,3
0.486,1e-05,297,307,100,10,0.0001,604,3
0.486,1e-05,355,349,100,10,0.0001,704,3
0.486,1e-05,405,399,100,10,0.0001,804,3
0.486,1e-05,454,450,100,10,0.0001,904,3
0.486,1e-05,505,499,100,10,0.0001,1004,3
0.488,1e-05,550,554,100,10,0.0001,1104,3
0.488,1e-05,608,596,100,10,0.0001,1204,3
0.486,1e-05,661,643,100,10,0.0001,1304,3
0.486,1e-05,709,695,100,10,0.0001,1404,3
0.486,1e-05,753,751,100,10,0.0001,1504,3
0.486,1e-05,803,801,100,10,0.0001,1604,3
0.488,1e-05,853,851,100,10,0.0001,1704,3
0.492,1e-05,897,907,100,10,0.0001,1804,3
0.49,1e-05,946,958,100,10,0.0001,1904,3
0.494,1e-05,1004,1000,100,10,0.0001,2004,3
0.476,1e-05,50,54,100,10,0.0001,104,4
0.476,1e-05,111,93,100,10,0.0001,204,4
0.478,1e-05,163,141,100,10,0.0001,304,4
0.478,1e-05,217,187,100,10,0.0001,404,4
0.478,1e-05,259,245,100,10,0.0001,504,4
0.478,1e-05,315,289,100,10,0.0001,604,4
0.48,1e-05,358,346,100,10,0.0001,704,4
0.48,1e-05,408,396,100,10,0.0001,804,4
0.48,1e-05,465,439,100,10,0.0001,904,4
0.482,1e-05,505,499,100,10,0.0001,1004,4
0.482,1e-05,554,550,100,10,0.0001,1104,4
0.482,1e-05,598,606,100,10,0.0001,1204,4
0.482,1e-05,646,658,100,10,0.0001,1304,4
0.482,1e-05,694,710,100,10,0.0001,1404,4
0.482,1e-05,742,762,100,10,0.0001,1504,4
0.482,1e-05,795,809,100,10,0.0001,1604,4
0.484,1e-05,846,858,100,10,0.0001,1704,4
0.482,1e-05,897,907,100,10,0.0001,1804,4
0.482,1e-05,945,959,100,10,0.0001,1904,4
0.486,1e-05,998,1006,100,10,0.0001,2004,4
0.502,1e-05,50,54,100,10,0.0001,104,5
0.502,1e-05,100,104,100,10,0.0001,204,5
0.504,1e-05,146,158,100,10,0.0001,304,5
0.51,1e-05,192,212,100,10,0.0001,404,5
0.508,1e-05,232,272,100,10,0.0001,504,5
0.508,1e-05,276,328,100,10,0.0001,604,5
0.506,1e-05,320,384,100,10,0.0001,704,5
0.506,1e-05,370,434,100,10,0.0001,804,5
0.506,1e-05,421,483,100,10,0.0001,904,5
0.506,1e-05,464,540,100,10,0.0001,1004,5
0.504,1e-05,513,591,100,10,0.0001,1104,5
0.498,1e-05,560,644,100,10,0.0001,1204,5
0.5,1e-05,609,695,100,10,0.0001,1304,5
0.504,1e-05,664,740,100,10,0.0001,1404,5
0.504,1e-05,718,786,100,10,0.0001,1504,5
0.502,1e-05,770,834,100,10,0.0001,1604,5
0.502,1e-05,818,886,100,10,0.0001,1704,5
0.506,1e-05,870,934,100,10,0.0001,1804,5
0.508,1e-05,927,977,100,10,0.0001,1904,5
0.508,1e-05,983,1021,100,10,0.0001,2004,5
0.448,1e-05,64,40,100,10,0.0001,104,6
0.448,1e-05,118,86,100,10,0.0001,204,6
0.448,1e-05,171,133,100,10,0.0001,304,6
0.448,1e-05,222,182,100,10,0.0001,404,6
0.448,1e-05,278,226,100,10,0.0001,504,6
0.448,1e-05,330,274,100,10,0.0001,604,6
0.448,1e-05,379,325,100,10,0.0001,704,6
0.448,1e-05,429,375,100,10,0.0001,804,6
0.448,1e-05,484,420,100,10,0.0001,904,6
0.446,1e-05,524,480,100,10,0.0001,1004,6
0.446,1e-05,576,528,100,10,0.0001,1104,6
0.444,1e-05,633,571,100,10,0.0001,1204,6
0.442,1e-05,688,616,100,10,0.0001,1304,6
0.44,1e-05,739,665,100,10,0.0001,1404,6
0.44,1e-05,789,715,100,10,0.0001,1504,6
0.44,1e-05,835,769,100,10,0.0001,1604,6
0.44,1e-05,889,815,100,10,0.0001,1704,6
0.44,1e-05,929,875,100,10,0.0001,1804,6
0.44,1e-05,983,921,100,10,0.0001,1904,6
0.44,1e-05,1026,978,100,10,0.0001,2004,6
0.504,1e-05,54,50,100,10,0.0001,104,7
0.504,1e-05,108,96,100,10,0.0001,204,7
0.504,1e-05,163,141,100,10,0.0001,304,7
0.504,1e-05,198,206,100,10,0.0001,404,7
0.504,1e-05,250,254,100,10,0.0001,504,7
0.504,1e-05,301,303,100,10,0.0001,604,7
0.504,1e-05,350,354,100,10,0.0001,704,7
0.504,1e-05,403,401,100,10,0.0001,804,7
0.504,1e-05,448,456,100,10,0.0001,904,7
0.504,1e-05,501,503,100,10,0.0001,1004,7
0.504,1e-05,554,550,100,10,0.0001,1104,7
0.504,1e-05,607,597,100,10,0.0001,1204,7
0.504,1e-05,654,650,100,10,0.0001,1304,7
0.504,1e-05,707,697,100,10,0.0001,1404,7
0.504,1e-05,758,746,100,10,0.0001,1504,7
0.504,1e-05,813,791,100,10,0.0001,1604,7
0.504,1e-05,862,842,100,10,0.0001,1704,7
0.504,1e-05,909,895,100,10,0.0001,1804,7
0.504,1e-05,962,942,100,10,0.0001,1904,7
0.504,1e-05,1004,1000,100,10,0.0001,2004,7
0.518,1e-05,57,47,100,10,0.0001,104,8
0.518,1e-05,96,108,100,10,0.0001,204,8
0.518,1e-05,147,157,100,10,0.0001,304,8
0.518,1e-05,198,206,100,10,0.0001,404,8
0.518,1e-05,256,248,100,10,0.0001,504,8
0.518,1e-05,304,300,100,10,0.0001,604,8
0.518,1e-05,361,343,100,10,0.0001,704,8
0.518,1e-05,411,393,100,10,0.0001,804,8
0.518,1e-05,461,443,100,10,0.0001,904,8
0.522,1e-05,507,497,100,10,0.0001,1004,8
0.524,1e-05,560,544,100,10,0.0001,1104,8
0.524,1e-05,612,592,100,10,0.0001,1204,8
0.522,1e-05,667,637,100,10,0.0001,1304,8
0.524,1e-05,719,685,100,10,0.0001,1404,8
0.524,1e-05,774,730,100,10,0.0001,1504,8
0.524,1e-05,822,782,100,10,0.0001,1604,8
0.524,1e-05,876,828,100,10,0.0001,1704,8
0.524,1e-05,926,878,100,10,0.0001,1804,8
0.526,1e-05,971,933,100,10,0.0001,1904,8
0.528,1e-05,1019,985,100,10,0.0001,2004,8
0.48,1e-05,54,50,100,10,0.0001,104,9
0.48,1e-05,98,106,100,10,0.0001,204,9
0.48,1e-05,148,156,100,10,0.0001,304,9
0.48,1e-05,201,203,100,10,0.0001,404,9
0.48,1e-05,255,249,100,10,0.0001,504,9
0.488,1e-05,309,295,100,10,0.0001,604,9
0.486,1e-05,355,349,100,10,0.0001,704,9
0.488,1e-05,405,399,100,10,0.0001,804,9
0.49,1e-05,453,451,100,10,0.0001,904,9
0.49,1e-05,506,498,100,10,0.0001,1004,9
0.488,1e-05,551,553,100,10,0.0001,1104,9
0.488,1e-05,612,592,100,10,0.0001,1204,9
0.488,1e-05,664,640,100,10,0.0001,1304,9
0.488,1e-05,709,695,100,10,0.0001,1404,9
0.49,1e-05,754,750,100,10,0.0001,1504,9
0.492,1e-05,806,798,100,10,0.0001,1604,9
0.492,1e-05,851,853,100,10,0.0001,1704,9
0.49,1e-05,906,898,100,10,0.0001,1804,9
0.486,1e-05,952,952,100,10,0.0001,1904,9
0.486,1e-05,1002,1002,100,10,0.0001,2004,9
0.496,1e-05,54,50,100,10,0.0001,104,10
0.496,1e-05,103,101,100,10,0.0001,204,10
0.498,1e-05,148,156,100,10,0.0001,304,10
0.498,1e-05,198,206,100,10,0.0001,404,10
0.498,1e-05,248,256,100,10,0.0001,504,10
0.498,1e-05,298,306,100,10,0.0001,604,10
0.498,1e-05,351,353,100,10,0.0001,704,10
0.5,1e-05,397,407,100,10,0.0001,804,10
0.5,1e-05,444,460,100,10,0.0001,904,10
0.5,1e-05,494,510,100,10,0.0001,1004,10
0.498,1e-05,548,556,100,10,0.0001,1104,10
0.5,1e-05,606,598,100,10,0.0001,1204,10
0.5,1e-05,657,647,100,10,0.0001,1304,10
0.502,1e-05,709,695,100,10,0.0001,1404,10
0.502,1e-05,764,740,100,10,0.0001,1504,10
0.504,1e-05,812,792,100,10,0.0001,1604,10
0.508,1e-05,863,841,100,10,0.0001,1704,10
0.508,1e-05,910,894,100,10,0.0001,1804,10
0.51,1e-05,956,948,100,10,0.0001,1904,10
0.51,1e-05,999,1005,100,10,0.0001,2004,10
0.506,1e-05,49,55,100,10,0.0001,104,11
0.506,1e-05,101,103,100,10,0.0001,204,11
0.506,1e-05,153,151,100,10,0.0001,304,11
0.506,1e-05,198,206,100,10,0.0001,404,11
0.506,1e-05,252,252,100,10,0.0001,504,11
0.506,1e-05,305,299,100,10,0.0001,604,11
0.506,1e-05,352,352,100,10,0.0001,704,11
0.506,1e-05,402,402,100,10,0.0001,804,11
0.506,1e-05,449,455,100,10,0.0001,904,11
0.506,1e-05,498,506,100,10,0.0001,1004,11
0.506,1e-05,551,553,100,10,0.0001,1104,11
0.506,1e-05,599,605,100,10,0.0001,1204,11
0.504,1e-05,646,658,100,10,0.0001,1304,11
0.504,1e-05,697,707,100,10,0.0001,1404,11
0.504,1e-05,743,761,100,10,0.0001,1504,11
0.504,1e-05,786,818,100,10,0.0001,1604,11
0.504,1e-05,838,866,100,10,0.0001,1704,11
0.504,1e-05,893,911,100,10,0.0001,1804,11
0.504,1e-05,953,951,100,10,0.0001,1904,11
0.504,1e-05,999,1005,100,10,0.0001,2004,11
0.48,1e-05,59,45,100,10,0.0001,104,12
0.48,1e-05,105,99,100,10,0.0001,204,12
0.48,1e-05,152,152,100,10,0.0001,304,12
0.48,1e-05,208,196,100,10,0.0001,404,12
0.48,1e-05,257,247,100,10,0.0001,504,12
0.482,1e-05,305,299,100,10,0.0001,604,12
0.482,1e-05,349,355,100,10,0.0001,704,12
0.482,1e-05,405,399,100,10,0.0001,804,12
0.482,1e-05,458,446,100,10,0.0001,904,12
0.482,1e-05,508,496,100,10,0.0001,1004,12
0.48,1e-05,564,540,100,10,0.0001,1104,12
0.478,1e-05,607,597,100,10,0.0001,1204,12
0.478,1e-05,653,651,100,10,0.0001,1304,12
0.478,1e-05,701,703,100,10,0.0001,1404,12
0.476,1e-05,744,760,100,10,0.0001,1504,12
0.476,1e-05,794,810,100,10,0.0001,1604,12
0.476,1e-05,841,863,100,10,0.0001,1704,12
0.478,1e-05,890,914,100,10,0.0001,1804,12
0.478,1e-05,945,959,100,10,0.0001,1904,12
0.476,1e-05,992,1012,100,10,0.0001,2004,12
0.49,1e-05,56,48,100,10,0.0001,104,13
0.49,1e-05,113,91,100,10,0.0001,204,13
0.49,1e-05,162,142,100,10,0.0001,304,13
0.49,1e-05,204,200,100,10,0.0001,404,13
0.49,1e-05,255,249,100,10,0.0001,504,13
0.49,1e-05,315,289,100,10,0.0001,604,13
0.488,1e-05,363,341,100,10,0.0001,704,13
0.488,1e-05,409,395,100,10,0.0001,804,13
0.486,1e-05,457,447,100,10,0.0001,904,13
0.486,1e-05,506,498,100,10,0.0001,1004,13
0.49,1e-05,559,545,100,10,0.0001,1104,13
0.492,1e-05,608,596,100,10,0.0001,1204,13
0.492,1e-05,662,642,100,10,0.0001,1304,13
0.492,1e-05,712,692,100,10,0.0001,1404,13
0.49,1e-05,760,744,100,10,0.0001,1504,13
0.492,1e-05,808,796,100,10,0.0001,1604,13
0.49,1e-05,853,851,100,10,0.0001,1704,13
0.49,1e-05,906,898,100,10,0.0001,1804,13
0.486,1e-05,957,947,100,10,0.0001,1904,13
0.486,1e-05,1012,992,100,10,0.0001,2004,13
0.48,1e-05,51,53,100,10,0.0001,104,14
0.48,1e-05,102,102,100,10,0.0001,204,14
0.48,1e-05,159,145,100,10,0.0001,304,14
0.48,1e-05,214,190,100,10,0.0001,404,14
0.48,1e-05,264,240,100,10,0.0001,504,14
0.48,1e-05,316,288,100,10,0.0001,604,14
0.48,1e-05,360,344,100,10,0.0001,704,14
0.48,1e-05,409,395,100,10,0.0001,804,14
0.48,1e-05,463,441,100,10,0.0001,904,14
0.48,1e-05,503,501,100,10,0.0001,1004,14
0.48,1e-05,560,544,100,10,0.0001,1104,14
0.482,1e-05,614,590,100,10,0.0001,1204,14
0.486,1e-05,669,635,100,10,0.0001,1304,14
0.486,1e-05,720,684,100,10,0.0001,1404,14
0.49,1e-05,762,742,100,10,0.0001,1504,14
0.49,1e-05,813,791,100,10,0.0001,1604,14
0.496,1e-05,863,841,100,10,0.0001,1704,14
0.496,1e-05,906,898,100,10,0.0001,1804,14
0.5,1e-05,958,946,100,10,0.0001,1904,14
0.498,1e-05,1009,995,100,10,0.0001,2004,14
0.526,1e-05,60,44,100,10,0.0001,104,15
0.526,1e-05,110,94,100,10,0.0001,204,15
0.526,1e-05,159,145,100,10,0.0001,304,15
0.526,1e-05,217,187,100,10,0.0001,404,15
0.526,1e-05,270,234,100,10,0.0001,504,15
0.526,1e-05,320,284,100,10,0.0001,604,15
0.52,1e-05,377,327,100,10,0.0001,704,15
0.522,1e-05,422,382,100,10,0.0001,804,15
0.52,1e-05,466,438,100,10,0.0001,904,15
0.52,1e-05,515,489,100,10,0.0001,1004,15
0.52,1e-05,556,548,100,10,0.0001,1104,15
0.52,1e-05,606,598,100,10,0.0001,1204,15
0.52,1e-05,650,654,100,10,0.0001,1304,15
0.524,1e-05,707,697,100,10,0.0001,1404,15
0.526,1e-05,766,738,100,10,0.0001,1504,15
0.524,1e-05,815,789,100,10,0.0001,1604,15
0.524,1e-05,874,830,100,10,0.0001,1704,15
0.528,1e-05,914,890,100,10,0.0001,1804,15
0.528,1e-05,952,952,100,10,0.0001,1904,15
0.528,1e-05,1013,991,100,10,0.0001,2004,15
0.488,1e-05,57,47,100,10,0.0001,104,16
0.488,1e-05,106,98,100,10,0.0001,204,16
0.488,1e-05,154,150,100,10,0.0001,304,16
0.488,1e-05,203,201,100,10,0.0001,404,16
0.488,1e-05,256,248,100,10,0.0001,504,16
0.488,1e-05,313,291,100,10,0.0001,604,16
0.49,1e-05,365,339,100,10,0.0001,704,16
0.49,1e-05,406,398,100,10,0.0001,804,16
0.49,1e-05,451,453,100,10,0.0001,904,16
0.49,1e-05,491,513,100,10,0.0001,1004,16
0.488,1e-05,545,559,100,10,0.0001,1104,16
0.486,1e-05,600,604,100,10,0.0001,1204,16
0.486,1e-05,654,650,100,10,0.0001,1304,16
0.482,1e-05,704,700,100,10,0.0001,1404,16
0.484,1e-05,754,750,100,10,0.0001,1504,16
0.482,1e-05,807,797,100,10,0.0001,1604,16
0.484,1e-05,858,846,100,10,0.0001,1704,16
0.484,1e-05,905,899,100,10,0.0001,1804,16
0.488,1e-05,948,956,100,10,0.0001,1904,16
0.49,1e-05,994,1010,100,10,0.0001,2004,16
0.486,1e-05,49,55,100,10,0.0001,104,17
0.486,1e-05,102,102,100,10,0.0001,204,17
0.486,1e-05,146,158,100,10,0.0001,304,17
0.486,1e-05,200,204,100,10,0.0001,404,17
0.488,1e-05,251,253,100,10,0.0001,504,17
0.488,1e-05,296,308,100,10,0.0001,604,17
0.488,1e-05,349,355,100,10,0.0001,704,17
0.488,1e-05,404,400,100,10,0.0001,804,17
0.488,1e-05,453,451,100,10,0.0001,904,17
0.488,1e-05,499,505,100,10,0.0001,1004,17
0.49,1e-05,559,545,100,10,0.0001,1104,17
0.486,1e-05,606,598,100,10,0.0001,1204,17
0.486,1e-05,658,646,100,10,0.0001,1304,17
0.486,1e-05,707,697,100,10,0.0001,1404,17
0.486,1e-05,758,746,100,10,0.0001,1504,17
0.486,1e-05,814,790,100,10,0.0001,1604,17
0.49,1e-05,866,838,100,10,0.0001,1704,17
0.49,1e-05,907,897,100,10,0.0001,1804,17
0.49,1e-05,962,942,100,10,0.0001,1904,17
0.49,1e-05,1014,990,100,10,0.0001,2004,17
0.476,1e-05,57,47,100,10,0.0001,104,18
0.476,1e-05,114,90,100,10,0.0001,204,18
0.476,1e-05,162,142,100,10,0.0001,304,18
0.476,1e-05,210,194,100,10,0.0001,404,18
0.474,1e-05,263,241,100,10,0.0001,504,18
0.476,1e-05,308,296,100,10,0.0001,604,18
0.478,1e-05,352,352,100,10,0.0001,704,18
0.478,1e-05,405,399,100,10,0.0001,804,18
0.476,1e-05,449,455,100,10,0.0001,904,18
0.476,1e-05,500,504,100,10,0.0001,1004,18
0.478,1e-05,546,558,100,10,0.0001,1104,18
0.478,1e-05,587,617,100,10,0.0001,1204,18
0.48,1e-05,637,667,100,10,0.0001,1304,18
0.48,1e-05,692,712,100,10,0.0001,1404,18
0.48,1e-05,742,762,100,10,0.0001,1504,18
0.476,1e-05,792,812,100,10,0.0001,1604,18
0.478,1e-05,845,859,100,10,0.0001,1704,18
0.478,1e-05,898,906,100,10,0.0001,1804,18
0.48,1e-05,945,959,100,10,0.0001,1904,18
0.48,1e-05,999,1005,100,10,0.0001,2004,18
0.492,1e-05,54,50,100,10,0.0001,104,19
0.492,1e-05,106,98,100,10,0.0001,204,19
0.492,1e-05,157,147,100,10,0.0001,304,19
0.492,1e-05,208,196,100,10,0.0001,404,19
0.492,1e-05,257,247,100,10,0.0001,504,19
0.492,1e-05,304,300,100,10,0.0001,604,19
0.492,1e-05,346,358,100,10,0.0001,704,19
0.492,1e-05,399,405,100,10,0.0001,804,19
0.49,1e-05,451,453,100,10,0.0001,904,19
0.49,1e-05,494,510,100,10,0.0001,1004,19
0.49,1e-05,548,556,100,10,0.0001,1104,19
0.49,1e-05,604,600,100,10,0.0001,1204,19
0.49,1e-05,655,649,100,10,0.0001,1304,19
0.492,1e-05,707,697,100,10,0.0001,1404,19
0.492,1e-05,762,742,100,10,0.0001,1504,19
0.492,1e-05,817,787,100,10,0.0001,1604,19
0.496,1e-05,860,844,100,10,0.0001,1704,19
0.496,1e-05,916,888,100,10,0.0001,1804,19
0.496,1e-05,965,939,100,10,0.0001,1904,19
0.494,1e-05,1009,995,100,10,0.0001,2004,19
0.502,1e-05,49,55,100,10,0.0001,104,20
0.504,1e-05,95,109,100,10,0.0001,204,20
0.504,1e-05,140,164,100,10,0.0001,304,20
0.508,1e-05,192,212,100,10,0.0001,404,20
0.512,1e-05,246,258,100,10,0.0001,504,20
0.512,1e-05,296,308,100,10,0.0001,604,20
0.51,1e-05,351,353,100,10,0.0001,704,20
0.51,1e-05,405,399,100,10,0.0001,804,20
0.512,1e-05,456,448,100,10,0.0001,904,20
0.506,1e-05,507,497,100,10,0.0001,1004,20
0.506,1e-05,550,554,100,10,0.0001,1104,20
0.508,1e-05,594,610,100,10,0.0001,1204,20
0.506,1e-05,645,659,100,10,0.0001,1304,20
0.504,1e-05,693,711,100,10,0.0001,1404,20
0.504,1e-05,739,765,100,10,0.0001,1504,20
0.508,1e-05,790,814,100,10,0.0001,1604,20
0.508,1e-05,832,872,100,10,0.0001,1704,20
0.512,1e-05,882,922,100,10,0.0001,1804,20
0.514,1e-05,931,973,100,10,0.0001,1904,20
0.512,1e-05,982,1022,100,10,0.0001,2004,20
0.518,1e-05,45,59,100,10,0.001,104,1
0.516,1e-05,100,104,100,10,0.001,204,1
0.518,1e-05,157,147,100,10,0.001,304,1
0.524,1e-05,204,200,100,10,0.001,404,1
0.526,1e-05,249,255,100,10,0.001,504,1
0.52,1e-05,306,298,100,10,0.001,604,1
0.524,1e-05,358,346,100,10,0.001,704,1
0.52,1e-05,406,398,100,10,0.001,804,1
0.518,1e-05,456,448,100,10,0.001,904,1
0.52,1e-05,506,498,100,10,0.001,1004,1
0.524,1e-05,555,549,100,10,0.001,1104,1
0.526,1e-05,605,599,100,10,0.001,1204,1
0.516,1e-05,662,642,100,10,0.001,1304,1
0.516,1e-05,707,697,100,10,0.001,1404,1
0.514,1e-05,748,756,100,10,0.001,1504,1
0.524,1e-05,797,807,100,10,0.001,1604,1
0.536,1e-05,840,864,100,10,0.001,1704,1
0.552,1e-05,897,907,100,10,0.001,1804,1
0.548,1e-05,951,953,100,10,0.001,1904,1
0.562,1e-05,1000,1004,100,10,0.001,2004,1
0.484,1e-05,59,45,100,10,0.001,104,2
0.48,1e-05,125,79,100,10,0.001,204,2
0.49,1e-05,177,127,100,10,0.001,304,2
0.492,1e-05,223,181,100,10,0.001,404,2
0.498,1e-05,277,227,100,10,0.001,504,2
0.502,1e-05,324,280,100,10,0.001,604,2
0.496,1e-05,372,332,100,10,0.001,704,2
0.508,1e-05,419,385,100,10,0.001,804,2
0.506,1e-05,471,433,100,10,0.001,904,2
0.5,1e-05,521,483,100,10,0.001,1004,2
0.51,1e-05,573,531,100,10,0.001,1104,2
0.52,1e-05,620,584,100,10,0.001,1204,2
0.518,1e-05,666,638,100,10,0.001,1304,2
0.514,1e-05,708,696,100,10,0.001,1404,2
0.522,1e-05,757,747,100,10,0.001,1504,2
0.53,1e-05,818,786,100,10,0.001,1604,2
0.552,1e-05,867,837,100,10,0.001,1704,2
0.556,1e-05,930,874,100,10,0.001,1804,2
0.574,1e-05,978,926,100,10,0.001,1904,2
0.582,1e-05,1021,983,100,10,0.001,2004,2
0.51,1e-05,59,45,100,10,0.001,104,3
0.51,1e-05,109,95,100,10,0.001,204,3
0.508,1e-05,161,143,100,10,0.001,304,3
0.508,1e-05,209,195,100,10,0.001,404,3
0.508,1e-05,259,245,100,10,0.001,504,3
0.51,1e-05,305,299,100,10,0.001,604,3
0.506,1e-05,353,351,100,10,0.001,704,3
0.504,1e-05,405,399,100,10,0.001,804,3
0.506,1e-05,451,453,100,10,0.001,904,3
0.52,1e-05,503,501,100,10,0.001,1004,3
0.528,1e-05,560,544,100,10,0.001,1104,3
0.54,1e-05,602,602,100,10,0.001,1204,3
0.54,1e-05,645,659,100,10,0.001,1304,3
0.546,1e-05,696,708,100,10,0.001,1404,3
0.548,1e-05,747,757,100,10,0.001,1504,3
0.554,1e-05,804,800,100,10,0.001,1604,3
0.56,1e-05,852,852,100,10,0.001,1704,3
0.572,1e-05,896,908,100,10,0.001,1804,3
0.588,1e-05,944,960,100,10,0.001,1904,3
0.586,1e-05,994,1010,100,10,0.001,2004,3
0.504,1e-05,53,51,100,10,0.001,104,4
0.508,1e-05,105,99,100,10,0.001,204,4
0.51,1e-05,156,148,100,10,0.001,304,4
0.51,1e-05,210,194,100,10,0.001,404,4
0.502,1e-05,261,243,100,10,0.001,504,4
0.516,1e-05,316,288,100,10,0.001,604,4
0.52,1e-05,362,342,100,10,0.001,704,4
0.522,1e-05,409,395,100,10,0.001,804,4
0.532,1e-05,466,438,100,10,0.001,904,4
0.538,1e-05,523,481,100,10,0.001,1004,4
0.542,1e-05,569,535,100,10,0.001,1104,4
0.548,1e-05,618,586,100,10,0.001,1204,4
0.55,1e-05,661,643,100,10,0.001,1304,4
0.548,1e-05,713,691,100,10,0.001,1404,4
0.554,1e-05,752,752,100,10,0.001,1504,4
0.56,1e-05,802,802,100,10,0.001,1604,4
0.568,1e-05,851,853,100,10,0.001,1704,4
0.562,1e-05,900,904,100,10,0.001,1804,4
0.566,1e-05,953,951,100,10,0.001,1904,4
0.576,1e-05,1000,1004,100,10,0.001,2004,4
0.534,1e-05,55,49,100,10,0.001,104,5
0.532,1e-05,108,96,100,10,0.001,204,5
0.536,1e-05,167,137,100,10,0.001,304,5
0.536,1e-05,201,203,100,10,0.001,404,5
0.542,1e-05,242,262,100,10,0.001,504,5
0.544,1e-05,288,316,100,10,0.001,604,5
0.544,1e-05,331,373,100,10,0.001,704,5
0.542,1e-05,388,416,100,10,0.001,804,5
0.548,1e-05,451,453,100,10,0.001,904,5
0.552,1e-05,507,497,100,10,0.001,1004,5
0.556,1e-05,556,548,100,10,0.001,1104,5
0.566,1e-05,598,606,100,10,0.001,1204,5
0.57,1e-05,651,653,100,10,0.001,1304,5
0.574,1e-05,698,706,100,10,0.001,1404,5
0.57,1e-05,758,746,100,10,0.001,1504,5
0.574,1e-05,803,801,100,10,0.001,1604,5
0.584,1e-05,846,858,100,10,0.001,1704,5
0.604,1e-05,896,908,100,10,0.001,1804,5
0.608,1e-05,957,947,100,10,0.001,1904,5
0.622,1e-05,1009,995,100,10,0.001,2004,5
0.466,1e-05,51,53,100,10,0.001,104,6
0.468,1e-05,101,103,100,10,0.001,204,6
0.468,1e-05,142,162,100,10,0.001,304,6
0.468,1e-05,200,204,100,10,0.001,404,6
0.47,1e-05,249,255,100,10,0.001,504,6
0.47,1e-05,298,306,100,10,0.001,604,6
0.472,1e-05,343,361,100,10,0.001,704,6
0.478,1e-05,399,405,100,10,0.001,804,6
0.484,1e-05,446,458,100,10,0.001,904,6
0.486,1e-05,499,505,100,10,0.001,1004,6
0.492,1e-05,543,561,100,10,0.001,1104,6
0.494,1e-05,590,614,100,10,0.001,1204,6
0.5,1e-05,640,664,100,10,0.001,1304,6
0.5,1e-05,690,714,100,10,0.001,1404,6
0.508,1e-05,736,768,100,10,0.001,1504,6
0.52,1e-05,775,829,100,10,0.001,1604,6
0.526,1e-05,821,883,100,10,0.001,1704,6
0.54,1e-05,879,925,100,10,0.001,1804,6
0.552,1e-05,927,977,100,10,0.001,1904,6
0.57,1e-05,984,1020,100,10,0.001,2004,6
0.504,1e-05,55,49,100,10,0.001,104,7
0.504,1e-05,101,103,100,10,0.001,204,7
0.504,1e-05,157,147,100,10,0.001,304,7
0.506,1e-05,197,207,100,10,0.001,404,7
0.506,1e-05,246,258,100,10,0.001,504,7
0.502,1e-05,296,308,100,10,0.001,604,7
0.498,1e-05,357,347,100,10,0.001,704,7
0.514,1e-05,402,402,100,10,0.001,804,7
0.518,1e-05,452,452,100,10,0.001,904,7
0.524,1e-05,505,499,100,10,0.001,1004,7
0.532,1e-05,551,553,100,10,0.001,1104,7
0.532,1e-05,600,604,100,10,0.001,1204,7
0.534,1e-05,651,653,100,10,0.001,1304,7
0.546,1e-05,706,698,100,10,0.001,1404,7
0.56,1e-05,752,752,100,10,0.001,1504,7
0.566,1e-05,801,803,100,10,0.001,1604,7
0.582,1e-05,860,844,100,10,0.001,1704,7
0.596,1e-05,906,898,100,10,0.001,1804,7
0.606,1e-05,949,955,100,10,0.001,1904,7
0.624,1e-05,1000,1004,100,10,0.001,2004,7
0.476,1e-05,48,56,100,10,0.001,104,8
0.482,1e-05,98,106,100,10,0.001,204,8
0.486,1e-05,148,156,100,10,0.001,304,8
0.486,1e-05,201,203,100,10,0.001,404,8
0.488,1e-05,244,260,100,10,0.001,504,8
0.488,1e-05,299,305,100,10,0.001,604,8
0.5,1e-05,348,356,100,10,0.001,704,8
0.508,1e-05,403,401,100,10,0.001,804,8
0.508,1e-05,449,455,100,10,0.001,904,8
0.51,1e-05,496,508,100,10,0.001,1004,8
0.514,1e-05,549,555,100,10,0.001,1104,8
0.526,1e-05,597,607,100,10,0.001,1204,8
0.526,1e-05,656,648,100,10,0.001,1304,8
0.532,1e-05,714,690,100,10,0.001,1404,8
0.536,1e-05,764,740,100,10,0.001,1504,8
0.542,1e-05,818,786,100,10,0.001,1604,8
0.548,1e-05,864,840,100,10,0.001,1704,8
0.568,1e-05,910,894,100,10,0.001,1804,8
0.572,1e-05,962,942,100,10,0.001,1904,8
0.578,1e-05,1013,991,100,10,0.001,2004,8
0.504,1e-05,52,52,100,10,0.001,104,9
0.514,1e-05,112,92,100,10,0.001,204,9
0.51,1e-05,169,135,100,10,0.001,304,9
0.51,1e-05,224,180,100,10,0.001,404,9
0.516,1e-05,268,236,100,10,0.001,504,9
0.518,1e-05,320,284,100,10,0.001,604,9
0.526,1e-05,376,328,100,10,0.001,704,9
0.524,1e-05,426,378,100,10,0.001,804,9
0.524,1e-05,488,416,100,10,0.001,904,9
0.532,1e-05,534,470,100,10,0.001,1004,9
0.54,1e-05,586,518,100,10,0.001,1104,9
0.542,1e-05,627,577,100,10,0.001,1204,9
0.548,1e-05,671,633,100,10,0.001,1304,9
0.564,1e-05,711,693,100,10,0.001,1404,9
0.586,1e-05,754,750,100,10,0.001,1504,9
0.602,1e-05,796,808,100,10,0.001,1604,9
0.616,1e-05,853,851,100,10,0.001,1704,9
0.628,1e-05,901,903,100,10,0.001,1804,9
0.64,1e-05,942,962,100,10,0.001,1904,9
0.662,1e-05,1001,1003,100,10,0.001,2004,9
0.49,1e-05,43,61,100,10,0.001,104,10
0.49,1e-05,96,108,100,10,0.001,204,10
0.49,1e-05,147,157,100,10,0.001,304,10
0.49,1e-05,198,206,100,10,0.001,404,10
0.49,1e-05,247,257,100,10,0.001,504,10
0.492,1e-05,299,305,100,10,0.001,604,10
0.492,1e-05,347,357,100,10,0.001,704,10
0.492,1e-05,406,398,100,10,0.001,804,10
0.492,1e-05,457,447,100,10,0.001,904,10
0.498,1e-05,507,497,100,10,0.001,1004,10
0.498,1e-05,553,551,100,10,0.001,1104,10
0.506,1e-05,604,600,100,10,0.001,1204,10
0.51,1e-05,649,655,100,10,0.001,1304,10
0.512,1e-05,698,706,100,10,0.001,1404,10
0.51,1e-05,748,756,100,10,0.001,1504,10
0.518,1e-05,809,795,100,10,0.001,1604,10
0.524,1e-05,852,852,100,10,0.001,1704,10
0.528,1e-05,891,913,100,10,0.001,1804,10
0.542,1e-05,947,957,100,10,0.001,1904,10
0.564,1e-05,997,1007,100,10,0.001,2004,10
0.482,1e-05,52,52,100,10,0.001,104,11
0.486,1e-05,105,99,100,10,0.001,204,11
0.482,1e-05,147,157,100,10,0.001,304,11
0.484,1e-05,189,215,100,10,0.001,404,11
0.484,1e-05,241,263,100,10,0.001,504,11
0.488,1e-05,290,314,100,10,0.001,604,11
0.492,1e-05,345,359,100,10,0.001,704,11
0.488,1e-05,395,409,100,10,0.001,804,11
0.49,1e-05,445,459,100,10,0.001,904,11
0.508,1e-05,491,513,100,10,0.001,1004,11
0.514,1e-05,550,554,100,10,0.001,1104,11
0.522,1e-05,594,610,100,10,0.001,1204,11
0.526,1e-05,643,661,100,10,0.001,1304,11
0.53,1e-05,693,711,100,10,0.001,1404,11
0.536,1e-05,747,757,100,10,0.001,1504,11
0.532,1e-05,806,798,100,10,0.001,1604,11
0.55,1e-05,857,847,100,10,0.001,1704,11
0.566,1e-05,902,902,100,10,0.001,1804,11
0.576,1e-05,953,951,100,10,0.001,1904,11
0.58,1e-05,997,1007,100,10,0.001,2004,11
0.528,1e-05,42,62,100,10,0.001,104,12
0.532,1e-05,87,117,100,10,0.001,204,12
0.534,1e-05,138,166,100,10,0.001,304,12
0.532,1e-05,193,211,100,10,0.001,404,12
0.534,1e-05,248,256,100,10,0.001,504,12
0.54,1e-05,291,313,100,10,0.001,604,12
0.54,1e-05,344,360,100,10,0.001,704,12
0.538,1e-05,395,409,100,10,0.001,804,12
0.534,1e-05,451,453,100,10,0.001,904,12
0.534,1e-05,504,500,100,10,0.001,1004,12
0.54,1e-05,547,557,100,10,0.001,1104,12
0.542,1e-05,594,610,100,10,0.001,1204,12
0.556,1e-05,640,664,100,10,0.001,1304,12
0.562,1e-05,690,714,100,10,0.001,1404,12
0.568,1e-05,744,760,100,10,0.001,1504,12
0.568,1e-05,797,807,100,10,0.001,1604,12
0.576,1e-05,851,853,100,10,0.001,1704,12
0.59,1e-05,900,904,100,10,0.001,1804,12
0.6,1e-05,938,966,100,10,0.001,1904,12
0.608,1e-05,993,1011,100,10,0.001,2004,12
0.46,1e-05,57,47,100,10,0.001,104,13
0.464,1e-05,115,89,100,10,0.001,204,13
0.464,1e-05,167,137,100,10,0.001,304,13
0.466,1e-05,216,188,100,10,0.001,404,13
0.47,1e-05,259,245,100,10,0.001,504,13
0.476,1e-05,308,296,100,10,0.001,604,13
0.482,1e-05,360,344,100,10,0.001,704,13
0.486,1e-05,391,413,100,10,0.001,804,13
0.494,1e-05,438,466,100,10,0.001,904,13
0.496,1e-05,481,523,100,10,0.001,1004,13
0.496,1e-05,531,573,100,10,0.001,1104,13
0.494,1e-05,583,621,100,10,0.001,1204,13
0.486,1e-05,638,666,100,10,0.001,1304,13
0.49,1e-05,692,712,100,10,0.001,1404,13
0.498,1e-05,744,760,100,10,0.001,1504,13
0.516,1e-05,798,806,100,10,0.001,1604,13
0.538,1e-05,849,855,100,10,0.001,1704,13
0.538,1e-05,900,904,100,10,0.001,1804,13
0.54,1e-05,944,960,100,10,0.001,1904,13
0.552,1e-05,985,1019,100,10,0.001,2004,13
0.512,1e-05,55,49,100,10,0.001,104,14
0.504,1e-05,95,109,100,10,0.001,204,14
0.504,1e-05,141,163,100,10,0.001,304,14
0.502,1e-05,189,215,100,10,0.001,404,14
0.494,1e-05,233,271,100,10,0.001,504,14
0.492,1e-05,287,317,100,10,0.001,604,14
0.492,1e-05,335,369,100,10,0.001,704,14
0.494,1e-05,382,422,100,10,0.001,804,14
0.506,1e-05,439,465,100,10,0.001,904,14
0.506,1e-05,482,522,100,10,0.001,1004,14
0.516,1e-05,536,568,100,10,0.001,1104,14
0.522,1e-05,594,610,100,10,0.001,1204,14
0.526,1e-05,647,657,100,10,0.001,1304,14
0.522,1e-05,699,705,100,10,0.001,1404,14
0.526,1e-05,752,752,100,10,0.001,1504,14
0.528,1e-05,800,804,100,10,0.001,1604,14
0.538,1e-05,850,854,100,10,0.001,1704,14
0.544,1e-05,905,899,100,10,0.001,1804,14
0.542,1e-05,957,947,100,10,0.001,1904,14
0.554,1e-05,1005,999,100,10,0.001,2004,14
0.494,1e-05,56,48,100,10,0.001,104,15
0.494,1e-05,103,101,100,10,0.001,204,15
0.49,1e-05,149,155,100,10,0.001,304,15
0.49,1e-05,194,210,100,10,0.001,404,15
0.49,1e-05,256,248,100,10,0.001,504,15
0.49,1e-05,305,299,100,10,0.001,604,15
0.492,1e-05,360,344,100,10,0.001,704,15
0.498,1e-05,408,396,100,10,0.001,804,15
0.498,1e-05,457,447,100,10,0.001,904,15
0.496,1e-05,514,490,100,10,0.001,1004,15
0.5,1e-05,565,539,100,10,0.001,1104,15
0.496,1e-05,612,592,100,10,0.001,1204,15
0.498,1e-05,662,642,100,10,0.001,1304,15
0.51,1e-05,710,694,100,10,0.001,1404,15
0.508,1e-05,767,737,100,10,0.001,1504,15
0.512,1e-05,818,786,100,10,0.001,1604,15
0.518,1e-05,866,838,100,10,0.001,1704,15
0.524,1e-05,916,888,100,10,0.001,1804,15
0.536,1e-05,961,943,100,10,0.001,1904,15
0.56,1e-05,1006,998,100,10,0.001,2004,15
0.488,1e-05,58,46,100,10,0.001,104,16
0.488,1e-05,102,102,100,10,0.001,204,16
0.488,1e-05,164,140,100,10,0.001,304,16
0.492,1e-05,216,188,100,10,0.001,404,16
0.492,1e-05,269,235,100,10,0.001,504,16
0.5,1e-05,317,287,100,10,0.001,604,16
0.5,1e-05,364,340,100,10,0.001,704,16
0.5,1e-05,412,392,100,10,0.001,804,16
0.5,1e-05,459,445,100,10,0.001,904,16
0.506,1e-05,514,490,100,10,0.001,1004,16
0.506,1e-05,567,537,100,10,0.001,1104,16
0.506,1e-05,614,590,100,10,0.001,1204,16
0.52,1e-05,673,631,100,10,0.001,1304,16
0.536,1e-05,718,686,100,10,0.001,1404,16
0.55,1e-05,765,739,100,10,0.001,1504,16
0.572,1e-05,810,794,100,10,0.001,1604,16
0.578,1e-05,859,845,100,10,0.001,1704,16
0.592,1e-05,909,895,100,10,0.001,1804,16
0.612,1e-05,951,953,100,10,0.001,1904,16
0.62,1e-05,1004,1000,100,10,0.001,2004,16
0.476,1e-05,56,48,100,10,0.001,104,17
0.476,1e-05,110,94,100,10,0.001,204,17
0.478,1e-05,155,149,100,10,0.001,304,17
0.466,1e-05,196,208,100,10,0.001,404,17
0.47,1e-05,247,257,100,10,0.001,504,17
0.47,1e-05,295,309,100,10,0.001,604,17
0.474,1e-05,352,352,100,10,0.001,704,17
0.472,1e-05,405,399,100,10,0.001,804,17
0.482,1e-05,454,450,100,10,0.001,904,17
0.484,1e-05,499,505,100,10,0.001,1004,17
0.494,1e-05,541,563,100,10,0.001,1104,17
0.516,1e-05,588,616,100,10,0.001,1204,17
0.508,1e-05,652,652,100,10,0.001,1304,17
0.51,1e-05,711,693,100,10,0.001,1404,17
0.518,1e-05,770,734,100,10,0.001,1504,17
0.528,1e-05,821,783,100,10,0.001,1604,17
0.534,1e-05,878,826,100,10,0.001,1704,17
0.542,1e-05,930,874,100,10,0.001,1804,17
0.554,1e-05,978,926,100,10,0.001,1904,17
0.58,1e-05,1022,982,100,10,0.001,2004,17
0.478,1e-05,60,44,100,10,0.001,104,18
0.488,1e-05,103,101,100,10,0.001,204,18
0.488,1e-05,158,146,100,10,0.001,304,18
0.49,1e-05,201,203,100,10,0.001,404,18
0.49,1e-05,253,251,100,10,0.001,504,18
0.494,1e-05,294,310,100,10,0.001,604,18
0.494,1e-05,345,359,100,10,0.001,704,18
0.496,1e-05,389,415,100,10,0.001,804,18
0.512,1e-05,437,467,100,10,0.001,904,18
0.52,1e-05,485,519,100,10,0.001,1004,18
0.53,1e-05,536,568,100,10,0.001,1104,18
0.532,1e-05,593,611,100,10,0.001,1204,18
0.538,1e-05,643,661,100,10,0.001,1304,18
0.548,1e-05,692,712,100,10,0.001,1404,18
0.546,1e-05,747,757,100,10,0.001,1504,18
0.558,1e-05,793,811,100,10,0.001,1604,18
0.572,1e-05,840,864,100,10,0.001,1704,18
0.584,1e-05,886,918,100,10,0.001,1804,18
0.592,1e-05,940,964,100,10,0.001,1904,18
0.598,1e-05,992,1012,100,10,0.001,2004,18
0.522,1e-05,44,60,100,10,0.001,104,19
0.524,1e-05,95,109,100,10,0.001,204,19
0.522,1e-05,139,165,100,10,0.001,304,19
0.528,1e-05,188,216,100,10,0.001,404,19
0.534,1e-05,236,268,100,10,0.001,504,19
0.534,1e-05,277,327,100,10,0.001,604,19
0.54,1e-05,331,373,100,10,0.001,704,19
0.54,1e-05,379,425,100,10,0.001,804,19
0.546,1e-05,436,468,100,10,0.001,904,19
0.552,1e-05,487,517,100,10,0.001,1004,19
0.552,1e-05,543,561,100,10,0.001,1104,19
0.548,1e-05,595,609,100,10,0.001,1204,19
0.55,1e-05,641,663,100,10,0.001,1304,19
0.554,1e-05,692,712,100,10,0.001,1404,19
0.564,1e-05,743,761,100,10,0.001,1504,19
0.576,1e-05,792,812,100,10,0.001,1604,19
0.574,1e-05,847,857,100,10,0.001,1704,19
0.58,1e-05,901,903,100,10,0.001,1804,19
0.588,1e-05,950,954,100,10,0.001,1904,19
0.602,1e-05,998,1006,100,10,0.001,2004,19
0.526,1e-05,44,60,100,10,0.001,104,20
0.524,1e-05,102,102,100,10,0.001,204,20
0.52,1e-05,143,161,100,10,0.001,304,20
0.518,1e-05,190,214,100,10,0.001,404,20
0.518,1e-05,231,273,100,10,0.001,504,20
0.518,1e-05,278,326,100,10,0.001,604,20
0.508,1e-05,328,376,100,10,0.001,704,20
0.508,1e-05,384,420,100,10,0.001,804,20
0.518,1e-05,428,476,100,10,0.001,904,20
0.534,1e-05,479,525,100,10,0.001,1004,20
0.542,1e-05,530,574,100,10,0.001,1104,20
0.544,1e-05,582,622,100,10,0.001,1204,20
0.55,1e-05,630,674,100,10,0.001,1304,20
0.554,1e-05,686,718,100,10,0.001,1404,20
0.562,1e-05,743,761,100,10,0.001,1504,20
0.57,1e-05,793,811,100,10,0.001,1604,20
0.58,1e-05,845,859,100,10,0.001,1704,20
0.592,1e-05,894,910,100,10,0.001,1804,20
0.59,1e-05,942,962,100,10,0.001,1904,20
0.588,1e-05,990,1014,100,10,0.001,2004,20
0.53,1e-05,64,40,100,10,0.01,104,1
0.53,1e-05,117,87,100,10,0.01,204,1
0.53,1e-05,168,136,100,10,0.01,304,1
0.536,1e-05,217,187,100,10,0.01,404,1
0.544,1e-05,275,229,100,10,0.01,504,1
0.54,1e-05,323,281,100,10,0.01,604,1
0.568,1e-05,374,330,100,10,0.01,704,1
0.598,1e-05,425,379,100,10,0.01,804,1
0.612,1e-05,478,426,100,10,0.01,904,1
0.644,1e-05,527,477,100,10,0.01,1004,1
0.684,1e-05,566,538,100,10,0.01,1104,1
0.71,1e-05,611,593,100,10,0.01,1204,1
0.734,1e-05,660,644,100,10,0.01,1304,1
0.784,1e-05,699,705,100,10,0.01,1404,1
0.824,1e-05,750,754,100,10,0.01,1504,1
0.862,1e-05,795,809,100,10,0.01,1604,1
0.884,1e-05,837,867,100,10,0.01,1704,1
0.9,1e-05,884,920,100,10,0.01,1804,1
0.91,1e-05,935,969,100,10,0.01,1904,1
0.914,1e-05,987,1017,100,10,0.01,2004,1
0.48,1e-05,55,49,100,10,0.01,104,2
0.494,1e-05,104,100,100,10,0.01,204,2
0.518,1e-05,148,156,100,10,0.01,304,2
0.526,1e-05,202,202,100,10,0.01,404,2
0.568,1e-05,249,255,100,10,0.01,504,2
0.606,1e-05,299,305,100,10,0.01,604,2
0.622,1e-05,350,354,100,10,0.01,704,2
0.64,1e-05,398,406,100,10,0.01,804,2
0.664,1e-05,440,464,100,10,0.01,904,2
0.696,1e-05,490,514,100,10,0.01,1004,2
0.73,1e-05,536,568,100,10,0.01,1104,2
0.776,1e-05,584,620,100,10,0.01,1204,2
0.81,1e-05,630,674,100,10,0.01,1304,2
0.862,1e-05,681,723,100,10,0.01,1404,2
0.886,1e-05,728,776,100,10,0.01,1504,2
0.902,1e-05,785,819,100,10,0.01,1604,2
0.922,1e-05,842,862,100,10,0.01,1704,2
0.936,1e-05,892,912,100,10,0.01,1804,2
0.94,1e-05,948,956,100,10,0.01,1904,2
0.944,1e-05,991,1013,100,10,0.01,2004,2
0.488,1e-05,49,55,100,10,0.01,104,3
0.51,1e-05,98,106,100,10,0.01,204,3
0.53,1e-05,151,153,100,10,0.01,304,3
0.526,1e-05,197,207,100,10,0.01,404,3
0.536,1e-05,251,253,100,10,0.01,504,3
0.56,1e-05,302,302,100,10,0.01,604,3
0.538,1e-05,349,355,100,10,0.01,704,3
0.546,1e-05,397,407,100,10,0.01,804,3
0.556,1e-05,450,454,100,10,0.01,904,3
0.61,1e-05,500,504,100,10,0.01,1004,3
0.624,1e-05,548,556,100,10,0.01,1104,3
0.668,1e-05,599,605,100,10,0.01,1204,3
0.688,1e-05,641,663,100,10,0.01,1304,3
0.708,1e-05,700,704,100,10,0.01,1404,3
0.746,1e-05,749,755,100,10,0.01,1504,3
0.788,1e-05,788,816,100,10,0.01,1604,3
0.818,1e-05,833,871,100,10,0.01,1704,3
0.846,1e-05,887,917,100,10,0.01,1804,3
0.852,1e-05,943,961,100,10,0.01,1904,3
0.864,1e-05,989,1015,100,10,0.01,2004,3
0.51,1e-05,60,44,100,10,0.01,104,4
0.492,1e-05,107,97,100,10,0.01,204,4
0.502,1e-05,161,143,100,10,0.01,304,4
0.53,1e-05,215,189,100,10,0.01,404,4
0.54,1e-05,265,239,100,10,0.01,504,4
0.538,1e-05,314,290,100,10,0.01,604,4
0.56,1e-05,364,340,100,10,0.01,704,4
0.574,1e-05,420,384,100,10,0.01,804,4
0.588,1e-05,471,433,100,10,0.01,904,4
0.636,1e-05,528,476,100,10,0.01,1004,4
0.702,1e-05,576,528,100,10,0.01,1104,4
0.76,1e-05,623,581,100,10,0.01,1204,4
0.808,1e-05,673,631,100,10,0.01,1304,4
0.846,1e-05,722,682,100,10,0.01,1404,4
0.888,1e-05,769,735,100,10,0.01,1504,4
0.914,1e-05,825,779,100,10,0.01,1604,4
0.91,1e-05,873,831,100,10,0.01,1704,4
0.94,1e-05,924,880,100,10,0.01,1804,4
0.954,1e-05,974,930,100,10,0.01,1904,4
0.956,1e-05,1013,991,100,10,0.01,2004,4
0.48,1e-05,57,47,100,10,0.01,104,5
0.52,1e-05,103,101,100,10,0.01,204,5
0.53,1e-05,154,150,100,10,0.01,304,5
0.566,1e-05,202,202,100,10,0.01,404,5
0.574,1e-05,255,249,100,10,0.01,504,5
0.592,1e-05,300,304,100,10,0.01,604,5
0.622,1e-05,348,356,100,10,0.01,704,5
0.648,1e-05,400,404,100,10,0.01,804,5
0.664,1e-05,457,447,100,10,0.01,904,5
0.704,1e-05,511,493,100,10,0.01,1004,5
0.736,1e-05,551,553,100,10,0.01,1104,5
0.788,1e-05,606,598,100,10,0.01,1204,5
0.828,1e-05,656,648,100,10,0.01,1304,5
0.884,1e-05,715,689,100,10,0.01,1404,5
0.916,1e-05,766,738,100,10,0.01,1504,5
0.934,1e-05,822,782,100,10,0.01,1604,5
0.938,1e-05,872,832,100,10,0.01,1704,5
0.944,1e-05,916,888,100,10,0.01,1804,5
0.95,1e-05,956,948,100,10,0.01,1904,5
0.954,1e-05,1015,989,100,10,0.01,2004,5
0.506,1e-05,48,56,100,10,0.01,104,6
0.498,1e-05,92,112,100,10,0.01,204,6
0.52,1e-05,138,166,100,10,0.01,304,6
0.536,1e-05,197,207,100,10,0.01,404,6
0.536,1e-05,247,257,100,10,0.01,504,6
0.56,1e-05,298,306,100,10,0.01,604,6
0.574,1e-05,353,351,100,10,0.01,704,6
0.604,1e-05,396,408,100,10,0.01,804,6
0.628,1e-05,443,461,100,10,0.01,904,6
0.666,1e-05,490,514,100,10,0.01,1004,6
0.722,1e-05,541,563,100,10,0.01,1104,6
0.79,1e-05,596,608,100,10,0.01,1204,6
0.838,1e-05,643,661,100,10,0.01,1304,6
0.874,1e-05,695,709,100,10,0.01,1404,6
0.89,1e-05,741,763,100,10,0.01,1504,6
0.918,1e-05,797,807,100,10,0.01,1604,6
0.926,1e-05,845,859,100,10,0.01,1704,6
0.932,1e-05,898,906,100,10,0.01,1804,6
0.932,1e-05,948,956,100,10,0.01,1904,6
0.944,1e-05,999,1005,100,10,0.01,2004,6
0.534,1e-05,57,47,100,10,0.01,104,7
0.55,1e-05,102,102,100,10,0.01,204,7
0.576,1e-05,157,147,100,10,0.01,304,7
0.586,1e-05,208,196,100,10,0.01,404,7
0.596,1e-05,263,241,100,10,0.01,504,7
0.594,1e-05,307,297,100,10,0.01,604,7
0.592,1e-05,356,348,100,10,0.01,704,7
0.638,1e-05,412,392,100,10,0.01,804,7
0.654,1e-05,460,444,100,10,0.01,904,7
0.676,1e-05,511,493,100,10,0.01,1004,7
0.68,1e-05,551,553,100,10,0.01,1104,7
0.724,1e-05,590,614,100,10,0.01,1204,7
0.766,1e-05,647,657,100,10,0.01,1304,7
0.802,1e-05,697,707,100,10,0.01,1404,7
0.824,1e-05,739,765,100,10,0.01,1504,7
0.852,1e-05,785,819,100,10,0.01,1604,7
0.876,1e-05,841,863,100,10,0.01,1704,7
0.902,1e-05,890,914,100,10,0.01,1804,7
0.922,1e-05,952,952,100,10,0.01,1904,7
0.94,1e-05,1003,1001,100,10,0.01,2004,7
0.526,1e-05,47,57,100,10,0.01,104,8
0.554,1e-05,100,104,100,10,0.01,204,8
0.576,1e-05,143,161,100,10,0.01,304,8
0.59,1e-05,194,210,100,10,0.01,404,8
0.58,1e-05,248,256,100,10,0.01,504,8
0.586,1e-05,294,310,100,10,0.01,604,8
0.602,1e-05,345,359,100,10,0.01,704,8
0.624,1e-05,393,411,100,10,0.01,804,8
0.65,1e-05,442,462,100,10,0.01,904,8
0.666,1e-05,490,514,100,10,0.01,1004,8
0.7,1e-05,539,565,100,10,0.01,1104,8
0.756,1e-05,592,612,100,10,0.01,1204,8
0.796,1e-05,643,661,100,10,0.01,1304,8
0.838,1e-05,692,712,100,10,0.01,1404,8
0.86,1e-05,743,761,100,10,0.01,1504,8
0.88,1e-05,788,816,100,10,0.01,1604,8
0.894,1e-05,837,867,100,10,0.01,1704,8
0.914,1e-05,891,913,100,10,0.01,1804,8
0.924,1e-05,946,958,100,10,0.01,1904,8
0.924,1e-05,1002,1002,100,10,0.01,2004,8
0.518,1e-05,45,59,100,10,0.01,104,9
0.532,1e-05,103,101,100,10,0.01,204,9
0.532,1e-05,152,152,100,10,0.01,304,9
0.538,1e-05,196,208,100,10,0.01,404,9
0.548,1e-05,253,251,100,10,0.01,504,9
0.568,1e-05,300,304,100,10,0.01,604,9
0.588,1e-05,345,359,100,10,0.01,704,9
0.626,1e-05,391,413,100,10,0.01,804,9
0.668,1e-05,449,455,100,10,0.01,904,9
0.722,1e-05,493,511,100,10,0.01,1004,9
0.73,1e-05,553,551,100,10,0.01,1104,9
0.784,1e-05,611,593,100,10,0.01,1204,9
0.828,1e-05,662,642,100,10,0.01,1304,9
0.866,1e-05,715,689,100,10,0.01,1404,9
0.882,1e-05,753,751,100,10,0.01,1504,9
0.898,1e-05,798,806,100,10,0.01,1604,9
0.916,1e-05,854,850,100,10,0.01,1704,9
0.924,1e-05,903,901,100,10,0.01,1804,9
0.918,1e-05,951,953,100,10,0.01,1904,9
0.932,1e-05,996,1008,100,10,0.01,2004,9
0.52,1e-05,52,52,100,10,0.01,104,10
0.548,1e-05,102,102,100,10,0.01,204,10
0.554,1e-05,152,152,100,10,0.01,304,10
0.546,1e-05,201,203,100,10,0.01,404,10
0.552,1e-05,245,259,100,10,0.01,504,10
0.576,1e-05,297,307,100,10,0.01,604,10
0.604,1e-05,347,357,100,10,0.01,704,10
0.626,1e-05,396,408,100,10,0.01,804,10
0.646,1e-05,454,450,100,10,0.01,904,10
0.674,1e-05,502,502,100,10,0.01,1004,10
0.712,1e-05,549,555,100,10,0.01,1104,10
0.746,1e-05,601,603,100,10,0.01,1204,10
0.782,1e-05,648,656,100,10,0.01,1304,10
0.834,1e-05,703,701,100,10,0.01,1404,10
0.87,1e-05,753,751,100,10,0.01,1504,10
0.902,1e-05,801,803,100,10,0.01,1604,10
0.916,1e-05,848,856,100,10,0.01,1704,10
0.928,1e-05,901,903,100,10,0.01,1804,10
0.936,1e-05,955,949,100,10,0.01,1904,10
0.938,1e-05,1008,996,100,10,0.01,2004,10
0.494,1e-05,55,49,100,10,0.01,104,11
0.522,1e-05,104,100,100,10,0.01,204,11
0.546,1e-05,156,148,100,10,0.01,304,11
0.568,1e-05,200,204,100,10,0.01,404,11
0.612,1e-05,258,246,100,10,0.01,504,11
0.638,1e-05,308,296,100,10,0.01,604,11
0.658,1e-05,366,338,100,10,0.01,704,11
0.682,1e-05,411,393,100,10,0.01,804,11
0.722,1e-05,465,439,100,10,0.01,904,11
0.772,1e-05,508,496,100,10,0.01,1004,11
0.802,1e-05,559,545,100,10,0.01,1104,11
0.832,1e-05,608,596,100,10,0.01,1204,11
0.864,1e-05,659,645,100,10,0.01,1304,11
0.888,1e-05,703,701,100,10,0.01,1404,11
0.914,1e-05,750,754,100,10,0.01,1504,11
0.926,1e-05,805,799,100,10,0.01,1604,11
0.934,1e-05,855,849,100,10,0.01,1704,11
0.94,1e-05,908,896,100,10,0.01,1804,11
0.94,1e-05,960,944,100,10,0.01,1904,11
0.94,1e-05,1006,998,100,10,0.01,2004,11
0.522,1e-05,55,49,100,10,0.01,104,12
0.53,1e-05,98,106,100,10,0.01,204,12
0.562,1e-05,138,166,100,10,0.01,304,12
0.586,1e-05,182,222,100,10,0.01,404,12
0.598,1e-05,241,263,100,10,0.01,504,12
0.626,1e-05,296,308,100,10,0.01,604,12
0.666,1e-05,342,362,100,10,0.01,704,12
0.694,1e-05,399,405,100,10,0.01,804,12
0.712,1e-05,450,454,100,10,0.01,904,12
0.75,1e-05,504,500,100,10,0.01,1004,12
0.78,1e-05,555,549,100,10,0.01,1104,12
0.814,1e-05,608,596,100,10,0.01,1204,12
0.838,1e-05,655,649,100,10,0.01,1304,12
0.866,1e-05,705,699,100,10,0.01,1404,12
0.884,1e-05,757,747,100,10,0.01,1504,12
0.918,1e-05,816,788,100,10,0.01,1604,12
0.93,1e-05,859,845,100,10,0.01,1704,12
0.94,1e-05,906,898,100,10,0.01,1804,12
0.948,1e-05,955,949,100,10,0.01,1904,12
0.952,1e-05,998,1006,100,10,0.01,2004,12
0.498,1e-05,59,45,100,10,0.01,104,13
0.506,1e-05,106,98,100,10,0.01,204,13
0.502,1e-05,160,144,100,10,0.01,304,13
0.524,1e-05,212,192,100,10,0.01,404,13
0.542,1e-05,258,246,100,10,0.01,504,13
0.562,1e-05,305,299,100,10,0.01,604,13
0.592,1e-05,362,342,100,10,0.01,704,13
0.62,1e-05,409,395,100,10,0.01,804,13
0.67,1e-05,455,449,100,10,0.01,904,13
0.73,1e-05,500,504,100,10,0.01,1004,13
0.778,1e-05,551,553,100,10,0.01,1104,13
0.818,1e-05,592,612,100,10,0.01,1204,13
0.844,1e-05,638,666,100,10,0.01,1304,13
0.868,1e-05,696,708,100,10,0.01,1404,13
0.904,1e-05,745,759,100,10,0.01,1504,13
0.93,1e-05,799,805,100,10,0.01,1604,13
0.944,1e-05,850,854,100,10,0.01,1704,13
0.962,1e-05,905,899,100,10,0.01,1804,13
0.962,1e-05,952,952,100,10,0.01,1904,13
0.964,1e-05,1006,998,100,10,0.01,2004,13
0.474,1e-05,56,48,100,10,0.01,104,14
0.498,1e-05,110,94,100,10,0.01,204,14
0.53,1e-05,168,136,100,10,0.01,304,14
0.558,1e-05,218,186,100,10,0.01,404,14
0.574,1e-05,262,242,100,10,0.01,504,14
0.604,1e-05,309,295,100,10,0.01,604,14
0.608,1e-05,362,342,100,10,0.01,704,14
0.592,1e-05,413,391,100,10,0.01,804,14
0.62,1e-05,461,443,100,10,0.01,904,14
0.656,1e-05,525,479,100,10,0.01,1004,14
0.694,1e-05,579,525,100,10,0.01,1104,14
0.704,1e-05,621,583,100,10,0.01,1204,14
0.732,1e-05,672,632,100,10,0.01,1304,14
0.77,1e-05,715,689,100,10,0.01,1404,14
0.804,1e-05,769,735,100,10,0.01,1504,14
0.84,1e-05,821,783,100,10,0.01,1604,14
0.864,1e-05,867,837,100,10,0.01,1704,14
0.886,1e-05,923,881,100,10,0.01,1804,14
0.902,1e-05,968,936,100,10,0.01,1904,14
0.914,1e-05,1012,992,100,10,0.01,2004,14
0.526,1e-05,54,50,100,10,0.01,104,15
0.55,1e-05,95,109,100,10,0.01,204,15
0.564,1e-05,150,154,100,10,0.01,304,15
0.592,1e-05,202,202,100,10,0.01,404,15
0.614,1e-05,244,260,100,10,0.01,504,15
0.612,1e-05,292,312,100,10,0.01,604,15
0.614,1e-05,342,362,100,10,0.01,704,15
0.64,1e-05,392,412,100,10,0.01,804,15
0.648,1e-05,447,457,100,10,0.01,904,15
0.692,1e-05,490,514,100,10,0.01,1004,15
0.738,1e-05,536,568,100,10,0.01,1104,15
0.766,1e-05,578,626,100,10,0.01,1204,15
0.806,1e-05,630,674,100,10,0.01,1304,15
0.848,1e-05,678,726,100,10,0.01,1404,15
0.88,1e-05,728,776,100,10,0.01,1504,15
0.896,1e-05,780,824,100,10,0.01,1604,15
0.924,1e-05,833,871,100,10,0.01,1704,15
0.94,1e-05,886,918,100,10,0.01,1804,15
0.946,1e-05,937,967,100,10,0.01,1904,15
0.95,1e-05,993,1011,100,10,0.01,2004,15
0.48,1e-05,51,53,100,10,0.01,104,16
0.51,1e-05,110,94,100,10,0.01,204,16
0.524,1e-05,158,146,100,10,0.01,304,16
0.524,1e-05,204,200,100,10,0.01,404,16
0.53,1e-05,250,254,100,10,0.01,504,16
0.534,1e-05,291,313,100,10,0.01,604,16
0.542,1e-05,334,370,100,10,0.01,704,16
0.56,1e-05,382,422,100,10,0.01,804,16
0.564,1e-05,439,465,100,10,0.01,904,16
0.56,1e-05,479,525,100,10,0.01,1004,16
0.558,1e-05,526,578,100,10,0.01,1104,16
0.576,1e-05,569,635,100,10,0.01,1204,16
0.582,1e-05,623,681,100,10,0.01,1304,16
0.598,1e-05,681,723,100,10,0.01,1404,16
0.606,1e-05,725,779,100,10,0.01,1504,16
0.654,1e-05,780,824,100,10,0.01,1604,16
0.698,1e-05,838,866,100,10,0.01,1704,16
0.776,1e-05,888,916,100,10,0.01,1804,16
0.79,1e-05,937,967,100,10,0.01,1904,16
0.84,1e-05,993,1011,100,10,0.01,2004,16
0.508,1e-05,55,49,100,10,0.01,104,17
0.508,1e-05,108,96,100,10,0.01,204,17
0.514,1e-05,154,150,100,10,0.01,304,17
0.54,1e-05,205,199,100,10,0.01,404,17
0.548,1e-05,259,245,100,10,0.01,504,17
0.564,1e-05,312,292,100,10,0.01,604,17
0.564,1e-05,357,347,100,10,0.01,704,17
0.598,1e-05,412,392,100,10,0.01,804,17
0.616,1e-05,471,433,100,10,0.01,904,17
0.646,1e-05,518,486,100,10,0.01,1004,17
0.674,1e-05,563,541,100,10,0.01,1104,17
0.7,1e-05,604,600,100,10,0.01,1204,17
0.74,1e-05,654,650,100,10,0.01,1304,17
0.802,1e-05,699,705,100,10,0.01,1404,17
0.84,1e-05,749,755,100,10,0.01,1504,17
0.872,1e-05,792,812,100,10,0.01,1604,17
0.892,1e-05,848,856,100,10,0.01,1704,17
0.904,1e-05,900,904,100,10,0.01,1804,17
0.922,1e-05,949,955,100,10,0.01,1904,17
0.93,1e-05,1005,999,100,10,0.01,2004,17
0.524,1e-05,48,56,100,10,0.01,104,18
0.516,1e-05,93,111,100,10,0.01,204,18
0.512,1e-05,153,151,100,10,0.01,304,18
0.526,1e-05,203,201,100,10,0.01,404,18
0.532,1e-05,260,244,100,10,0.01,504,18
0.548,1e-05,311,293,100,10,0.01,604,18
0.566,1e-05,350,354,100,10,0.01,704,18
0.586,1e-05,406,398,100,10,0.01,804,18
0.626,1e-05,455,449,100,10,0.01,904,18
0.682,1e-05,502,502,100,10,0.01,1004,18
0.708,1e-05,550,554,100,10,0.01,1104,18
0.774,1e-05,604,600,100,10,0.01,1204,18
0.826,1e-05,653,651,100,10,0.01,1304,18
0.872,1e-05,701,703,100,10,0.01,1404,18
0.898,1e-05,748,756,100,10,0.01,1504,18
0.918,1e-05,793,811,100,10,0.01,1604,18
0.926,1e-05,841,863,100,10,0.01,1704,18
0.93,1e-05,896,908,100,10,0.01,1804,18
0.932,1e-05,948,956,100,10,0.01,1904,18
0.934,1e-05,1005,999,100,10,0.01,2004,18
0.532,1e-05,52,52,100,10,0.01,104,19
0.516,1e-05,100,104,100,10,0.01,204,19
0.512,1e-05,158,146,100,10,0.01,304,19
0.534,1e-05,206,198,100,10,0.01,404,19
0.552,1e-05,260,244,100,10,0.01,504,19
0.584,1e-05,312,292,100,10,0.01,604,19
0.6,1e-05,358,346,100,10,0.01,704,19
0.62,1e-05,414,390,100,10,0.01,804,19
0.644,1e-05,459,445,100,10,0.01,904,19
0.668,1e-05,506,498,100,10,0.01,1004,19
0.71,1e-05,556,548,100,10,0.01,1104,19
0.762,1e-05,613,591,100,10,0.01,1204,19
0.81,1e-05,662,642,100,10,0.01,1304,19
0.86,1e-05,712,692,100,10,0.01,1404,19
0.886,1e-05,765,739,100,10,0.01,1504,19
0.926,1e-05,820,784,100,10,0.01,1604,19
0.928,1e-05,867,837,100,10,0.01,1704,19
0.94,1e-05,919,885,100,10,0.01,1804,19
0.948,1e-05,965,939,100,10,0.01,1904,19
0.952,1e-05,1018,986,100,10,0.01,2004,19
0.506,1e-05,59,45,100,10,0.01,104,20
0.522,1e-05,104,100,100,10,0.01,204,20
0.534,1e-05,161,143,100,10,0.01,304,20
0.54,1e-05,207,197,100,10,0.01,404,20
0.542,1e-05,256,248,100,10,0.01,504,20
0.56,1e-05,306,298,100,10,0.01,604,20
0.568,1e-05,364,340,100,10,0.01,704,20
0.598,1e-05,417,387,100,10,0.01,804,20
0.636,1e-05,470,434,100,10,0.01,904,20
0.672,1e-05,519,485,100,10,0.01,1004,20
0.722,1e-05,568,536,100,10,0.01,1104,20
0.758,1e-05,623,581,100,10,0.01,1204,20
0.8,1e-05,672,632,100,10,0.01,1304,20
0.848,1e-05,725,679,100,10,0.01,1404,20
0.88,1e-05,767,737,100,10,0.01,1504,20
0.916,1e-05,812,792,100,10,0.01,1604,20
0.924,1e-05,857,847,100,10,0.01,1704,20
0.94,1e-05,905,899,100,10,0.01,1804,20
0.946,1e-05,958,946,100,10,0.01,1904,20
0.956,1e-05,1005,999,100,10,0.01,2004,20
0.514,0.0001,47,57,100,10,0.0001,104,1
0.514,0.0001,97,107,100,10,0.0001,204,1
0.514,0.0001,152,152,100,10,0.0001,304,1
0.514,0.0001,199,205,100,10,0.0001,404,1
0.514,0.0001,250,254,100,10,0.0001,504,1
0.514,0.0001,298,306,100,10,0.0001,604,1
0.508,0.0001,350,354,100,10,0.0001,704,1
0.508,0.0001,407,397,100,10,0.0001,804,1
0.508,0.0001,456,448,100,10,0.0001,904,1
0.508,0.0001,503,501,100,10,0.0001,1004,1
0.512,0.0001,548,556,100,10,0.0001,1104,1
0.512,0.0001,588,616,100,10,0.0001,1204,1
0.512,0.0001,633,671,100,10,0.0001,1304,1
0.514,0.0001,680,724,100,10,0.0001,1404,1
0.514,0.0001,742,762,100,10,0.0001,1504,1
0.514,0.0001,789,815,100,10,0.0001,1604,1
0.514,0.0001,837,867,100,10,0.0001,1704,1
0.514,0.0001,882,922,100,10,0.0001,1804,1
0.512,0.0001,928,976,100,10,0.0001,1904,1
0.51,0.0001,993,1011,100,10,0.0001,2004,1
0.518,0.0001,45,59,100,10,0.0001,104,2
0.518,0.0001,98,106,100,10,0.0001,204,2
0.52,0.0001,154,150,100,10,0.0001,304,2
0.52,0.0001,208,196,100,10,0.0001,404,2
0.52,0.0001,260,244,100,10,0.0001,504,2
0.52,0.0001,307,297,100,10,0.0001,604,2
0.52,0.0001,355,349,100,10,0.0001,704,2
0.52,0.0001,403,401,100,10,0.0001,804,2
0.52,0.0001,445,459,100,10,0.0001,904,2
0.52,0.0001,501,503,100,10,0.0001,1004,2
0.52,0.0001,558,546,100,10,0.0001,1104,2
0.524,0.0001,601,603,100,10,0.0001,1204,2
0.524,0.0001,641,663,100,10,0.0001,1304,2
0.52,0.0001,693,711,100,10,0.0001,1404,2
0.522,0.0001,739,765,100,10,0.0001,1504,2
0.522,0.0001,791,813,100,10,0.0001,1604,2
0.524,0.0001,846,858,100,10,0.0001,1704,2
0.524,0.0001,897,907,100,10,0.0001,1804,2
0.524,0.0001,946,958,100,10,0.0001,1904,2
0.526,0.0001,983,1021,100,10,0.0001,2004,2
0.5,0.0001,44,60,100,10,0.0001,104,3
0.504,0.0001,94,110,100,10,0.0001,204,3
0.502,0.0001,148,156,100,10,0.0001,304,3
0.502,0.0001,199,205,100,10,0.0001,404,3
0.5,0.0001,251,253,100,10,0.0001,504,3
0.5,0.0001,294,310,100,10,0.0001,604,3
0.5,0.0001,345,359,100,10,0.0001,704,3
0.5,0.0001,393,411,100,10,0.0001,804,3
0.502,0.0001,437,467,100,10,0.0001,904,3
0.504,0.0001,481,523,100,10,0.0001,1004,3
0.504,0.0001,526,578,100,10,0.0001,1104,3
0.506,0.0001,575,629,100,10,0.0001,1204,3
0.506,0.0001,622,682,100,10,0.0001,1304,3
0.506,0.0001,680,724,100,10,0.0001,1404,3
0.506,0.0001,721,783,100,10,0.0001,1504,3
0.508,0.0001,774,830,100,10,0.0001,1604,3
0.506,0.0001,827,877,100,10,0.0001,1704,3
0.502,0.0001,879,925,100,10,0.0001,1804,3
0.502,0.0001,928,976,100,10,0.0001,1904,3
0.506,0.0001,983,1021,100,10,0.0001,2004,3
0.508,0.0001,57,47,100,10,0.0001,104,4
0.508,0.0001,102,102,100,10,0.0001,204,4
0.508,0.0001,157,147,100,10,0.0001,304,4
0.508,0.0001,197,207,100,10,0.0001,404,4
0.508,0.0001,252,252,100,10,0.0001,504,4
0.508,0.0001,304,300,100,10,0.0001,604,4
0.51,0.0001,354,350,100,10,0.0001,704,4
0.51,0.0001,400,404,100,10,0.0001,804,4
0.51,0.0001,447,457,100,10,0.0001,904,4
0.51,0.0001,494,510,100,10,0.0001,1004,4
0.51,0.0001,543,561,100,10,0.0001,1104,4
0.512,0.0001,593,611,100,10,0.0001,1204,4
0.512,0.0001,641,663,100,10,0.0001,1304,4
0.512,0.0001,691,713,100,10,0.0001,1404,4
0.512,0.0001,744,760,100,10,0.0001,1504,4
0.512,0.0001,799,805,100,10,0.0001,1604,4
0.51,0.0001,847,857,100,10,0.0001,1704,4
0.508,0.0001,899,905,100,10,0.0001,1804,4
0.508,0.0001,948,956,100,10,0.0001,1904,4
0.51,0.0001,997,1007,100,10,0.0001,2004,4
0.494,0.0001,63,41,100,10,0.0001,104,5
0.494,0.0001,121,83,100,10,0.0001,204,5
0.494,0.0001,169,135,100,10,0.0001,304,5
0.494,0.0001,217,187,100,10,0.0001,404,5
0.496,0.0001,266,238,100,10,0.0001,504,5
0.496,0.0001,315,289,100,10,0.0001,604,5
0.496,0.0001,364,340,100,10,0.0001,704,5
0.494,0.0001,415,389,100,10,0.0001,804,5
0.496,0.0001,476,428,100,10,0.0001,904,5
0.496,0.0001,521,483,100,10,0.0001,1004,5
0.496,0.0001,575,529,100,10,0.0001,1104,5
0.496,0.0001,620,584,100,10,0.0001,1204,5
0.496,0.0001,669,635,100,10,0.0001,1304,5
0.496,0.0001,719,685,100,10,0.0001,1404,5
0.496,0.0001,770,734,100,10,0.0001,1504,5
0.496,0.0001,823,781,100,10,0.0001,1604,5
0.494,0.0001,869,835,100,10,0.0001,1704,5
0.494,0.0001,911,893,100,10,0.0001,1804,5
0.492,0.0001,952,952,100,10,0.0001,1904,5
0.494,0.0001,1004,1000,100,10,0.0001,2004,5
0.488,0.0001,46,58,100,10,0.0001,104,6
0.488,0.0001,96,108,100,10,0.0001,204,6
0.49,0.0001,153,151,100,10,0.0001,304,6
0.492,0.0001,200,204,100,10,0.0001,404,6
0.492,0.0001,242,262,100,10,0.0001,504,6
0.492,0.0001,294,310,100,10,0.0001,604,6
0.492,0.0001,347,357,100,10,0.0001,704,6
0.492,0.0001,398,406,100,10,0.0001,804,6
0.492,0.0001,449,455,100,10,0.0001,904,6
0.492,0.0001,497,507,100,10,0.0001,1004,6
0.49,0.0001,546,558,100,10,0.0001,1104,6
0.488,0.0001,604,600,100,10,0.0001,1204,6
0.488,0.0001,661,643,100,10,0.0001,1304,6
0.488,0.0001,717,687,100,10,0.0001,1404,6
0.49,0.0001,766,738,100,10,0.0001,1504,6
0.492,0.0001,810,794,100,10,0.0001,1604,6
0.49,0.0001,863,841,100,10,0.0001,1704,6
0.488,0.0001,915,889,100,10,0.0001,1804,6
0.488,0.0001,961,943,100,10,0.0001,1904,6
0.49,0.0001,1003,1001,100,10,0.0001,2004,6
0.51,0.0001,44,60,100,10,0.0001,104,7
0.51,0.0001,82,122,100,10,0.0001,204,7
0.51,0.0001,140,164,100,10,0.0001,304,7
0.51,0.0001,191,213,100,10,0.0001,404,7
0.51,0.0001,236,268,100,10,0.0001,504,7
0.51,0.0001,285,319,100,10,0.0001,604,7
0.51,0.0001,329,375,100,10,0.0001,704,7
0.51,0.0001,381,423,100,10,0.0001,804,7
0.51,0.0001,429,475,100,10,0.0001,904,7
0.51,0.0001,477,527,100,10,0.0001,1004,7
0.51,0.0001,532,572,100,10,0.0001,1104,7
0.51,0.0001,587,617,100,10,0.0001,1204,7
0.51,0.0001,636,668,100,10,0.0001,1304,7
0.51,0.0001,681,723,100,10,0.0001,1404,7
0.51,0.0001,726,778,100,10,0.0001,1504,7
0.51,0.0001,779,825,100,10,0.0001,1604,7
0.51,0.0001,834,870,100,10,0.0001,1704,7
0.51,0.0001,893,911,100,10,0.0001,1804,7
0.51,0.0001,949,955,100,10,0.0001,1904,7
0.51,0.0001,997,1007,100,10,0.0001,2004,7
0.488,0.0001,58,46,100,10,0.0001,104,8
0.488,0.0001,109,95,100,10,0.0001,204,8
0.488,0.0001,163,141,100,10,0.0001,304,8
0.488,0.0001,212,192,100,10,0.0001,404,8
0.488,0.0001,258,246,100,10,0.0001,504,8
0.488,0.0001,320,284,100,10,0.0001,604,8
0.488,0.0001,365,339,100,10,0.0001,704,8
0.488,0.0001,417,387,100,10,0.0001,804,8
0.488,0.0001,466,438,100,10,0.0001,904,8
0.488,0.0001,519,485,100,10,0.0001,1004,8
0.488,0.0001,570,534,100,10,0.0001,1104,8
0.488,0.0001,622,582,100,10,0.0001,1204,8
0.488,0.0001,667,637,100,10,0.0001,1304,8
0.488,0.0001,713,691,100,10,0.0001,1404,8
0.486,0.0001,766,738,100,10,0.0001,1504,8
0.486,0.0001,810,794,100,10,0.0001,1604,8
0.486,0.0001,855,849,100,10,0.0001,1704,8
0.486,0.0001,911,893,100,10,0.0001,1804,8
0.486,0.0001,958,946,100,10,0.0001,1904,8
0.486,0.0001,1008,996,100,10,0.0001,2004,8
0.46,0.0001,52,52,100,10,0.0001,104,9
0.464,0.0001,104,100,100,10,0.0001,204,9
0.464,0.0001,154,150,100,10,0.0001,304,9
0.466,0.0001,204,200,100,10,0.0001,404,9
0.466,0.0001,248,256,100,10,0.0001,504,9
0.466,0.0001,296,308,100,10,0.0001,604,9
0.466,0.0001,351,353,100,10,0.0001,704,9
0.466,0.0001,398,406,100,10,0.0001,804,9
0.466,0.0001,449,455,100,10,0.0001,904,9
0.468,0.0001,501,503,100,10,0.0001,1004,9
0.47,0.0001,557,547,100,10,0.0001,1104,9
0.47,0.0001,608,596,100,10,0.0001,1204,9
0.472,0.0001,657,647,100,10,0.0001,1304,9
0.474,0.0001,703,701,100,10,0.0001,1404,9
0.476,0.0001,750,754,100,10,0.0001,1504,9
0.478,0.0001,794,810,100,10,0.0001,1604,9
0.478,0.0001,837,867,100,10,0.0001,1704,9
0.48,0.0001,888,916,100,10,0.0001,1804,9
0.48,0.0001,938,966,100,10,0.0001,1904,9
0.478,0.0001,986,1018,100,10,0.0001,2004,9
0.486,0.0001,53,51,100,10,0.0001,104,10
0.486,0.0001,102,102,100,10,0.0001,204,10
0.486,0.0001,159,145,100,10,0.0001,304,10
0.486,0.0001,207,197,100,10,0.0001,404,10
0.484,0.0001,250,254,100,10,0.0001,504,10
0.486,0.0001,299,305,100,10,0.0001,604,10
0.486,0.0001,348,356,100,10,0.0001,704,10
0.486,0.0001,400,404,100,10,0.0001,804,10
0.484,0.0001,448,456,100,10,0.0001,904,10
0.484,0.0001,498,506,100,10,0.0001,1004,10
0.486,0.0001,542,562,100,10,0.0001,1104,10
0.49,0.0001,598,606,100,10,0.0001,1204,10
0.488,0.0001,649,655,100,10,0.0001,1304,10
0.486,0.0001,699,705,100,10,0.0001,1404,10
0.486,0.0001,758,746,100,10,0.0001,1504,10
0.484,0.0001,809,795,100,10,0.0001,1604,10
0.488,0.0001,858,846,100,10,0.0001,1704,10
0.492,0.0001,902,902,100,10,0.0001,1804,10
0.494,0.0001,952,952,100,10,0.0001,1904,10
0.496,0.0001,993,1011,100,10,0.0001,2004,10
0.526,0.0001,48,56,100,10,0.0001,104,11
0.526,0.0001,99,105,100,10,0.0001,204,11
0.526,0.0001,142,162,100,10,0.0001,304,11
0.526,0.0001,197,207,100,10,0.0001,404,11
0.526,0.0001,243,261,100,10,0.0001,504,11
0.528,0.0001,302,302,100,10,0.0001,604,11
0.528,0.0001,351,353,100,10,0.0001,704,11
0.528,0.0001,403,401,100,10,0.0001,804,11
0.528,0.0001,459,445,100,10,0.0001,904,11
0.528,0.0001,503,501,100,10,0.0001,1004,11
0.528,0.0001,552,552,100,10,0.0001,1104,11
0.53,0.0001,603,601,100,10,0.0001,1204,11
0.53,0.0001,651,653,100,10,0.0001,1304,11
0.53,0.0001,702,702,100,10,0.0001,1404,11
0.532,0.0001,757,747,100,10,0.0001,1504,11
0.532,0.0001,805,799,100,10,0.0001,1604,11
0.532,0.0001,857,847,100,10,0.0001,1704,11
0.532,0.0001,902,902,100,10,0.0001,1804,11
0.532,0.0001,950,954,100,10,0.0001,1904,11
0.532,0.0001,1010,994,100,10,0.0001,2004,11
0.484,0.0001,57,47,100,10,0.0001,104,12
0.482,0.0001,104,100,100,10,0.0001,204,12
0.484,0.0001,152,152,100,10,0.0001,304,12
0.484,0.0001,198,206,100,10,0.0001,404,12
0.484,0.0001,254,250,100,10,0.0001,504,12
0.484,0.0001,306,298,100,10,0.0001,604,12
0.486,0.0001,360,344,100,10,0.0001,704,12
0.486,0.0001,406,398,100,10,0.0001,804,12
0.486,0.0001,464,440,100,10,0.0001,904,12
0.486,0.0001,508,496,100,10,0.0001,1004,12
0.486,0.0001,562,542,100,10,0.0001,1104,12
0.486,0.0001,604,600,100,10,0.0001,1204,12
0.486,0.0001,649,655,100,10,0.0001,1304,12
0.486,0.0001,704,700,100,10,0.0001,1404,12
0.488,0.0001,755,749,100,10,0.0001,1504,12
0.49,0.0001,803,801,100,10,0.0001,1604,12
0.49,0.0001,859,845,100,10,0.0001,1704,12
0.492,0.0001,908,896,100,10,0.0001,1804,12
0.492,0.0001,961,943,100,10,0.0001,1904,12
0.49,0.0001,1007,997,100,10,0.0001,2004,12
0.5,0.0001,51,53,100,10,0.0001,104,13
0.5,0.0001,101,103,100,10,0.0001,204,13
0.502,0.0001,155,149,100,10,0.0001,304,13
0.5,0.0001,203,201,100,10,0.0001,404,13
0.498,0.0001,248,256,100,10,0.0001,504,13
0.498,0.0001,300,304,100,10,0.0001,604,13
0.498,0.0001,353,351,100,10,0.0001,704,13
0.5,0.0001,398,406,100,10,0.0001,804,13
0.5,0.0001,451,453,100,10,0.0001,904,13
0.502,0.0001,490,514,100,10,0.0001,1004,13
0.502,0.0001,542,562,100,10,0.0001,1104,13
0.5,0.0001,588,616,100,10,0.0001,1204,13
0.502,0.0001,634,670,100,10,0.0001,1304,13
0.502,0.0001,680,724,100,10,0.0001,1404,13
0.504,0.0001,733,771,100,10,0.0001,1504,13
0.506,0.0001,783,821,100,10,0.0001,1604,13
0.508,0.0001,833,871,100,10,0.0001,1704,13
0.51,0.0001,879,925,100,10,0.0001,1804,13
0.512,0.0001,933,971,100,10,0.0001,1904,13
0.506,0.0001,985,1019,100,10,0.0001,2004,13
0.524,0.0001,50,54,100,10,0.0001,104,14
0.524,0.0001,101,103,100,10,0.0001,204,14
0.524,0.0001,151,153,100,10,0.0001,304,14
0.524,0.0001,205,199,100,10,0.0001,404,14
0.524,0.0001,263,241,100,10,0.0001,504,14
0.524,0.0001,310,294,100,10,0.0001,604,14
0.524,0.0001,355,349,100,10,0.0001,704,14
0.524,0.0001,409,395,100,10,0.0001,804,14
0.524,0.0001,456,448,100,10,0.0001,904,14
0.524,0.0001,507,497,100,10,0.0001,1004,14
0.522,0.0001,557,547,100,10,0.0001,1104,14
0.522,0.0001,603,601,100,10,0.0001,1204,14
0.524,0.0001,647,657,100,10,0.0001,1304,14
0.524,0.0001,692,712,100,10,0.0001,1404,14
0.524,0.0001,744,760,100,10,0.0001,1504,14
0.524,0.0001,787,817,100,10,0.0001,1604,14
0.526,0.0001,837,867,100,10,0.0001,1704,14
0.524,0.0001,885,919,100,10,0.0001,1804,14
0.524,0.0001,936,968,100,10,0.0001,1904,14
0.524,0.0001,992,1012,100,10,0.0001,2004,14
0.504,0.0001,55,49,100,10,0.0001,104,15
0.504,0.0001,106,98,100,10,0.0001,204,15
0.504,0.0001,152,152,100,10,0.0001,304,15
0.504,0.0001,199,205,100,10,0.0001,404,15
0.504,0.0001,251,253,100,10,0.0001,504,15
0.504,0.0001,310,294,100,10,0.0001,604,15
0.504,0.0001,358,346,100,10,0.0001,704,15
0.504,0.0001,402,402,100,10,0.0001,804,15
0.504,0.0001,454,450,100,10,0.0001,904,15
0.504,0.0001,496,508,100,10,0.0001,1004,15
0.504,0.0001,564,540,100,10,0.0001,1104,15
0.506,0.0001,611,593,100,10,0.0001,1204,15
0.506,0.0001,659,645,100,10,0.0001,1304,15
0.506,0.0001,708,696,100,10,0.0001,1404,15
0.506,0.0001,756,748,100,10,0.0001,1504,15
0.506,0.0001,801,803,100,10,0.0001,1604,15
0.506,0.0001,848,856,100,10,0.0001,1704,15
0.504,0.0001,901,903,100,10,0.0001,1804,15
0.504,0.0001,950,954,100,10,0.0001,1904,15
0.506,0.0001,1000,1004,100,10,0.0001,2004,15
0.508,0.0001,51,53,100,10,0.0001,104,16
0.508,0.0001,99,105,100,10,0.0001,204,16
0.508,0.0001,146,158,100,10,0.0001,304,16
0.508,0.0001,190,214,100,10,0.0001,404,16
0.508,0.0001,235,269,100,10,0.0001,504,16
0.512,0.0001,290,314,100,10,0.0001,604,16
0.512,0.0001,349,355,100,10,0.0001,704,16
0.512,0.0001,404,400,100,10,0.0001,804,16
0.514,0.0001,457,447,100,10,0.0001,904,16
0.516,0.0001,512,492,100,10,0.0001,1004,16
0.518,0.0001,563,541,100,10,0.0001,1104,16
0.518,0.0001,607,597,100,10,0.0001,1204,16
0.518,0.0001,658,646,100,10,0.0001,1304,16
0.516,0.0001,707,697,100,10,0.0001,1404,16
0.516,0.0001,759,745,100,10,0.0001,1504,16
0.516,0.0001,811,793,100,10,0.0001,1604,16
0.518,0.0001,869,835,100,10,0.0001,1704,16
0.516,0.0001,924,880,100,10,0.0001,1804,16
0.514,0.0001,966,938,100,10,0.0001,1904,16
0.514,0.0001,1005,999,100,10,0.0001,2004,16
0.526,0.0001,48,56,100,10,0.0001,104,17
0.524,0.0001,94,110,100,10,0.0001,204,17
0.522,0.0001,149,155,100,10,0.0001,304,17
0.52,0.0001,205,199,100,10,0.0001,404,17
0.52,0.0001,260,244,100,10,0.0001,504,17
0.52,0.0001,302,302,100,10,0.0001,604,17
0.522,0.0001,357,347,100,10,0.0001,704,17
0.522,0.0001,409,395,100,10,0.0001,804,17
0.52,0.0001,463,441,100,10,0.0001,904,17
0.52,0.0001,509,495,100,10,0.0001,1004,17
0.522,0.0001,558,546,100,10,0.0001,1104,17
0.522,0.0001,606,598,100,10,0.0001,1204,17
0.522,0.0001,649,655,100,10,0.0001,1304,17
0.524,0.0001,694,710,100,10,0.0001,1404,17
0.526,0.0001,739,765,100,10,0.0001,1504,17
0.528,0.0001,793,811,100,10,0.0001,1604,17
0.526,0.0001,842,862,100,10,0.0001,1704,17
0.526,0.0001,880,924,100,10,0.0001,1804,17
0.526,0.0001,945,959,100,10,0.0001,1904,17
0.528,0.0001,1001,1003,100,10,0.0001,2004,17
0.512,0.0001,50,54,100,10,0.0001,104,18
0.51,0.0001,95,109,100,10,0.0001,204,18
0.51,0.0001,142,162,100,10,0.0001,304,18
0.512,0.0001,186,218,100,10,0.0001,404,18
0.508,0.0001,242,262,100,10,0.0001,504,18
0.508,0.0001,290,314,100,10,0.0001,604,18
0.51,0.0001,341,363,100,10,0.0001,704,18
0.51,0.0001,391,413,100,10,0.0001,804,18
0.51,0.0001,446,458,100,10,0.0001,904,18
0.508,0.0001,502,502,100,10,0.0001,1004,18
0.508,0.0001,555,549,100,10,0.0001,1104,18
0.51,0.0001,603,601,100,10,0.0001,1204,18
0.512,0.0001,657,647,100,10,0.0001,1304,18
0.512,0.0001,700,704,100,10,0.0001,1404,18
0.512,0.0001,740,764,100,10,0.0001,1504,18
0.51,0.0001,795,809,100,10,0.0001,1604,18
0.514,0.0001,837,867,100,10,0.0001,1704,18
0.514,0.0001,887,917,100,10,0.0001,1804,18
0.514,0.0001,938,966,100,10,0.0001,1904,18
0.514,0.0001,994,1010,100,10,0.0001,2004,18
0.508,0.0001,56,48,100,10,0.0001,104,19
0.508,0.0001,109,95,100,10,0.0001,204,19
0.508,0.0001,153,151,100,10,0.0001,304,19
0.508,0.0001,201,203,100,10,0.0001,404,19
0.508,0.0001,248,256,100,10,0.0001,504,19
0.508,0.0001,294,310,100,10,0.0001,604,19
0.508,0.0001,349,355,100,10,0.0001,704,19
0.506,0.0001,398,406,100,10,0.0001,804,19
0.506,0.0001,450,454,100,10,0.0001,904,19
0.508,0.0001,495,509,100,10,0.0001,1004,19
0.508,0.0001,538,566,100,10,0.0001,1104,19
0.506,0.0001,590,614,100,10,0.0001,1204,19
0.506,0.0001,643,661,100,10,0.0001,1304,19
0.502,0.0001,689,715,100,10,0.0001,1404,19
0.502,0.0001,743,761,100,10,0.0001,1504,19
0.5,0.0001,801,803,100,10,0.0001,1604,19
0.5,0.0001,853,851,100,10,0.0001,1704,19
0.5,0.0001,902,902,100,10,0.0001,1804,19
0.5,0.0001,952,952,100,10,0.0001,1904,19
0.5,0.0001,1002,1002,100,10,0.0001,2004,19
0.49,0.0001,51,53,100,10,0.0001,104,20
0.49,0.0001,106,98,100,10,0.0001,204,20
0.492,0.0001,154,150,100,10,0.0001,304,20
0.492,0.0001,208,196,100,10,0.0001,404,20
0.494,0.0001,260,244,100,10,0.0001,504,20
0.494,0.0001,313,291,100,10,0.0001,604,20
0.494,0.0001,352,352,100,10,0.0001,704,20
0.494,0.0001,403,401,100,10,0.0001,804,20
0.492,0.0001,450,454,100,10,0.0001,904,20
0.492,0.0001,502,502,100,10,0.0001,1004,20
0.492,0.0001,553,551,100,10,0.0001,1104,20
0.494,0.0001,604,600,100,10,0.0001,1204,20
0.496,0.0001,649,655,100,10,0.0001,1304,20
0.5,0.0001,705,699,100,10,0.0001,1404,20
0.5,0.0001,754,750,100,10,0.0001,1504,20
0.504,0.0001,798,806,100,10,0.0001,1604,20
0.504,0.0001,846,858,100,10,0.0001,1704,20
0.502,0.0001,905,899,100,10,0.0001,1804,20
0.502,0.0001,951,953,100,10,0.0001,1904,20
0.502,0.0001,998,1006,100,10,0.0001,2004,20
0.504,0.0001,52,52,100,10,0.001,104,1
0.504,0.0001,104,100,100,10,0.001,204,1
0.506,0.0001,154,150,100,10,0.001,304,1
0.504,0.0001,198,206,100,10,0.001,404,1
0.502,0.0001,251,253,100,10,0.001,504,1
0.504,0.0001,301,303,100,10,0.001,604,1
0.502,0.0001,358,346,100,10,0.001,704,1
0.504,0.0001,410,394,100,10,0.001,804,1
0.506,0.0001,459,445,100,10,0.001,904,1
0.506,0.0001,505,499,100,10,0.001,1004,1
0.512,0.0001,560,544,100,10,0.001,1104,1
0.514,0.0001,608,596,100,10,0.001,1204,1
0.516,0.0001,654,650,100,10,0.001,1304,1
0.524,0.0001,702,702,100,10,0.001,1404,1
0.534,0.0001,738,766,100,10,0.001,1504,1
0.542,0.0001,792,812,100,10,0.001,1604,1
0.564,0.0001,834,870,100,10,0.001,1704,1
0.584,0.0001,902,902,100,10,0.001,1804,1
0.628,0.0001,954,950,100,10,0.001,1904,1
0.652,0.0001,1001,1003,100,10,0.001,2004,1
0.514,0.0001,47,57,100,10,0.001,104,2
0.516,0.0001,102,102,100,10,0.001,204,2
0.51,0.0001,146,158,100,10,0.001,304,2
0.504,0.0001,200,204,100,10,0.001,404,2
0.5,0.0001,248,256,100,10,0.001,504,2
0.49,0.0001,298,306,100,10,0.001,604,2
0.492,0.0001,354,350,100,10,0.001,704,2
0.486,0.0001,402,402,100,10,0.001,804,2
0.49,0.0001,452,452,100,10,0.001,904,2
0.494,0.0001,500,504,100,10,0.001,1004,2
0.496,0.0001,548,556,100,10,0.001,1104,2
0.508,0.0001,600,604,100,10,0.001,1204,2
0.518,0.0001,645,659,100,10,0.001,1304,2
0.52,0.0001,698,706,100,10,0.001,1404,2
0.53,0.0001,757,747,100,10,0.001,1504,2
0.542,0.0001,815,789,100,10,0.001,1604,2
0.556,0.0001,866,838,100,10,0.001,1704,2
0.576,0.0001,909,895,100,10,0.001,1804,2
0.586,0.0001,955,949,100,10,0.001,1904,2
0.602,0.0001,1003,1001,100,10,0.001,2004,2
0.542,0.0001,51,53,100,10,0.001,104,3
0.54,0.0001,100,104,100,10,0.001,204,3
0.54,0.0001,148,156,100,10,0.001,304,3
0.54,0.0001,203,201,100,10,0.001,404,3
0.54,0.0001,253,251,100,10,0.001,504,3
0.54,0.0001,303,301,100,10,0.001,604,3
0.54,0.0001,362,342,100,10,0.001,704,3
0.54,0.0001,424,380,100,10,0.001,804,3
0.538,0.0001,474,430,100,10,0.001,904,3
0.538,0.0001,530,474,100,10,0.001,1004,3
0.536,0.0001,583,521,100,10,0.001,1104,3
0.538,0.0001,630,574,100,10,0.001,1204,3
0.538,0.0001,688,616,100,10,0.001,1304,3
0.538,0.0001,734,670,100,10,0.001,1404,3
0.544,0.0001,781,723,100,10,0.001,1504,3
0.554,0.0001,835,769,100,10,0.001,1604,3
0.558,0.0001,881,823,100,10,0.001,1704,3
0.568,0.0001,929,875,100,10,0.001,1804,3
0.576,0.0001,981,923,100,10,0.001,1904,3
0.586,0.0001,1023,981,100,10,0.001,2004,3
0.506,0.0001,54,50,100,10,0.001,104,4
0.506,0.0001,93,111,100,10,0.001,204,4
0.502,0.0001,148,156,100,10,0.001,304,4
0.502,0.0001,207,197,100,10,0.001,404,4
0.502,0.0001,259,245,100,10,0.001,504,4
0.508,0.0001,311,293,100,10,0.001,604,4
0.51,0.0001,362,342,100,10,0.001,704,4
0.506,0.0001,413,391,100,10,0.001,804,4
0.508,0.0001,455,449,100,10,0.001,904,4
0.512,0.0001,512,492,100,10,0.001,1004,4
0.51,0.0001,552,552,100,10,0.001,1104,4
0.512,0.0001,602,602,100,10,0.001,1204,4
0.506,0.0001,654,650,100,10,0.001,1304,4
0.508,0.0001,694,710,100,10,0.001,1404,4
0.504,0.0001,749,755,100,10,0.001,1504,4
0.504,0.0001,798,806,100,10,0.001,1604,4
0.514,0.0001,845,859,100,10,0.001,1704,4
0.522,0.0001,906,898,100,10,0.001,1804,4
0.522,0.0001,952,952,100,10,0.001,1904,4
0.542,0.0001,1001,1003,100,10,0.001,2004,4
0.516,0.0001,56,48,100,10,0.001,104,5
0.518,0.0001,112,92,100,10,0.001,204,5
0.518,0.0001,166,138,100,10,0.001,304,5
0.516,0.0001,217,187,100,10,0.001,404,5
0.516,0.0001,259,245,100,10,0.001,504,5
0.518,0.0001,311,293,100,10,0.001,604,5
0.518,0.0001,366,338,100,10,0.001,704,5
0.518,0.0001,413,391,100,10,0.001,804,5
0.518,0.0001,465,439,100,10,0.001,904,5
0.522,0.0001,507,497,100,10,0.001,1004,5
0.52,0.0001,557,547,100,10,0.001,1104,5
0.524,0.0001,612,592,100,10,0.001,1204,5
0.53,0.0001,668,636,100,10,0.001,1304,5
0.538,0.0001,717,687,100,10,0.001,1404,5
0.54,0.0001,764,740,100,10,0.001,1504,5
0.548,0.0001,808,796,100,10,0.001,1604,5
0.558,0.0001,847,857,100,10,0.001,1704,5
0.576,0.0001,895,909,100,10,0.001,1804,5
0.578,0.0001,947,957,100,10,0.001,1904,5
0.578,0.0001,993,1011,100,10,0.001,2004,5
0.496,0.0001,50,54,100,10,0.001,104,6
0.494,0.0001,101,103,100,10,0.001,204,6
0.502,0.0001,153,151,100,10,0.001,304,6
0.504,0.0001,199,205,100,10,0.001,404,6
0.508,0.0001,251,253,100,10,0.001,504,6
0.512,0.0001,301,303,100,10,0.001,604,6
0.512,0.0001,353,351,100,10,0.001,704,6
0.516,0.0001,399,405,100,10,0.001,804,6
0.536,0.0001,455,449,100,10,0.001,904,6
0.544,0.0001,512,492,100,10,0.001,1004,6
0.54,0.0001,565,539,100,10,0.001,1104,6
0.538,0.0001,609,595,100,10,0.001,1204,6
0.54,0.0001,657,647,100,10,0.001,1304,6
0.558,0.0001,702,702,100,10,0.001,1404,6
0.576,0.0001,759,745,100,10,0.001,1504,6
0.582,0.0001,804,800,100,10,0.001,1604,6
0.59,0.0001,851,853,100,10,0.001,1704,6
0.596,0.0001,909,895,100,10,0.001,1804,6
0.612,0.0001,958,946,100,10,0.001,1904,6
0.632,0.0001,1009,995,100,10,0.001,2004,6
0.51,0.0001,58,46,100,10,0.001,104,7
0.514,0.0001,104,100,100,10,0.001,204,7
0.514,0.0001,155,149,100,10,0.001,304,7
0.516,0.0001,208,196,100,10,0.001,404,7
0.508,0.0001,248,256,100,10,0.001,504,7
0.502,0.0001,293,311,100,10,0.001,604,7
0.502,0.0001,338,366,100,10,0.001,704,7
0.504,0.0001,383,421,100,10,0.001,804,7
0.512,0.0001,432,472,100,10,0.001,904,7
0.516,0.0001,493,511,100,10,0.001,1004,7
0.512,0.0001,539,565,100,10,0.001,1104,7
0.516,0.0001,597,607,100,10,0.001,1204,7
0.532,0.0001,652,652,100,10,0.001,1304,7
0.542,0.0001,703,701,100,10,0.001,1404,7
0.55,0.0001,758,746,100,10,0.001,1504,7
0.548,0.0001,809,795,100,10,0.001,1604,7
0.556,0.0001,855,849,100,10,0.001,1704,7
0.558,0.0001,898,906,100,10,0.001,1804,7
0.568,0.0001,944,960,100,10,0.001,1904,7
0.592,0.0001,996,1008,100,10,0.001,2004,7
0.474,0.0001,53,51,100,10,0.001,104,8
0.472,0.0001,96,108,100,10,0.001,204,8
0.47,0.0001,148,156,100,10,0.001,304,8
0.47,0.0001,189,215,100,10,0.001,404,8
0.468,0.0001,240,264,100,10,0.001,504,8
0.472,0.0001,287,317,100,10,0.001,604,8
0.47,0.0001,338,366,100,10,0.001,704,8
0.476,0.0001,390,414,100,10,0.001,804,8
0.488,0.0001,435,469,100,10,0.001,904,8
0.498,0.0001,492,512,100,10,0.001,1004,8
0.504,0.0001,549,555,100,10,0.001,1104,8
0.514,0.0001,603,601,100,10,0.001,1204,8
0.518,0.0001,659,645,100,10,0.001,1304,8
0.518,0.0001,713,691,100,10,0.001,1404,8
0.524,0.0001,759,745,100,10,0.001,1504,8
0.532,0.0001,806,798,100,10,0.001,1604,8
0.538,0.0001,858,846,100,10,0.001,1704,8
0.54,0.0001,903,901,100,10,0.001,1804,8
0.55,0.0001,955,949,100,10,0.001,1904,8
0.562,0.0001,1010,994,100,10,0.001,2004,8
0.468,0.0001,51,53,100,10,0.001,104,9
0.472,0.0001,103,101,100,10,0.001,204,9
0.472,0.0001,156,148,100,10,0.001,304,9
0.478,0.0001,205,199,100,10,0.001,404,9
0.48,0.0001,253,251,100,10,0.001,504,9
0.484,0.0001,297,307,100,10,0.001,604,9
0.486,0.0001,344,360,100,10,0.001,704,9
0.494,0.0001,396,408,100,10,0.001,804,9
0.498,0.0001,458,446,100,10,0.001,904,9
0.5,0.0001,515,489,100,10,0.001,1004,9
0.508,0.0001,563,541,100,10,0.001,1104,9
0.514,0.0001,607,597,100,10,0.001,1204,9
0.516,0.0001,651,653,100,10,0.001,1304,9
0.526,0.0001,706,698,100,10,0.001,1404,9
0.514,0.0001,758,746,100,10,0.001,1504,9
0.534,0.0001,809,795,100,10,0.001,1604,9
0.532,0.0001,858,846,100,10,0.001,1704,9
0.534,0.0001,901,903,100,10,0.001,1804,9
0.54,0.0001,956,948,100,10,0.001,1904,9
0.558,0.0001,1003,1001,100,10,0.001,2004,9
0.466,0.0001,54,50,100,10,0.001,104,10
0.468,0.0001,109,95,100,10,0.001,204,10
0.478,0.0001,156,148,100,10,0.001,304,10
0.488,0.0001,205,199,100,10,0.001,404,10
0.49,0.0001,249,255,100,10,0.001,504,10
0.494,0.0001,301,303,100,10,0.001,604,10
0.492,0.0001,360,344,100,10,0.001,704,10
0.504,0.0001,416,388,100,10,0.001,804,10
0.502,0.0001,465,439,100,10,0.001,904,10
0.504,0.0001,510,494,100,10,0.001,1004,10
0.516,0.0001,571,533,100,10,0.001,1104,10
0.528,0.0001,624,580,100,10,0.001,1204,10
0.534,0.0001,678,626,100,10,0.001,1304,10
0.546,0.0001,720,684,100,10,0.001,1404,10
0.55,0.0001,761,743,100,10,0.001,1504,10
0.564,0.0001,816,788,100,10,0.001,1604,10
0.574,0.0001,862,842,100,10,0.001,1704,10
0.584,0.0001,912,892,100,10,0.001,1804,10
0.584,0.0001,961,943,100,10,0.001,1904,10
0.6,0.0001,1013,991,100,10,0.001,2004,10
0.516,0.0001,46,58,100,10,0.001,104,11
0.522,0.0001,108,96,100,10,0.001,204,11
0.518,0.0001,157,147,100,10,0.001,304,11
0.514,0.0001,212,192,100,10,0.001,404,11
0.516,0.0001,263,241,100,10,0.001,504,11
0.52,0.0001,310,294,100,10,0.001,604,11
0.522,0.0001,357,347,100,10,0.001,704,11
0.53,0.0001,405,399,100,10,0.001,804,11
0.532,0.0001,448,456,100,10,0.001,904,11
0.548,0.0001,496,508,100,10,0.001,1004,11
0.562,0.0001,548,556,100,10,0.001,1104,11
0.574,0.0001,602,602,100,10,0.001,1204,11
0.58,0.0001,651,653,100,10,0.001,1304,11
0.588,0.0001,696,708,100,10,0.001,1404,11
0.606,0.0001,739,765,100,10,0.001,1504,11
0.628,0.0001,786,818,100,10,0.001,1604,11
0.648,0.0001,845,859,100,10,0.001,1704,11
0.658,0.0001,894,910,100,10,0.001,1804,11
0.676,0.0001,936,968,100,10,0.001,1904,11
0.69,0.0001,988,1016,100,10,0.001,2004,11
0.484,0.0001,56,48,100,10,0.001,104,12
0.484,0.0001,107,97,100,10,0.001,204,12
0.482,0.0001,150,154,100,10,0.001,304,12
0.48,0.0001,197,207,100,10,0.001,404,12
0.482,0.0001,249,255,100,10,0.001,504,12
0.478,0.0001,295,309,100,10,0.001,604,12
0.476,0.0001,342,362,100,10,0.001,704,12
0.482,0.0001,387,417,100,10,0.001,804,12
0.484,0.0001,436,468,100,10,0.001,904,12
0.484,0.0001,478,526,100,10,0.001,1004,12
0.484,0.0001,520,584,100,10,0.001,1104,12
0.486,0.0001,580,624,100,10,0.001,1204,12
0.484,0.0001,642,662,100,10,0.001,1304,12
0.488,0.0001,687,717,100,10,0.001,1404,12
0.488,0.0001,742,762,100,10,0.001,1504,12
0.498,0.0001,791,813,100,10,0.001,1604,12
0.508,0.0001,846,858,100,10,0.001,1704,12
0.516,0.0001,902,902,100,10,0.001,1804,12
0.52,0.0001,959,945,100,10,0.001,1904,12
0.544,0.0001,1006,998,100,10,0.001,2004,12
0.474,0.0001,44,60,100,10,0.001,104,13
0.476,0.0001,94,110,100,10,0.001,204,13
0.472,0.0001,147,157,100,10,0.001,304,13
0.482,0.0001,189,215,100,10,0.001,404,13
0.492,0.0001,242,262,100,10,0.001,504,13
0.5,0.0001,288,316,100,10,0.001,604,13
0.504,0.0001,339,365,100,10,0.001,704,13
0.51,0.0001,389,415,100,10,0.001,804,13
0.518,0.0001,440,464,100,10,0.001,904,13
0.536,0.0001,498,506,100,10,0.001,1004,13
0.546,0.0001,544,560,100,10,0.001,1104,13
0.546,0.0001,587,617,100,10,0.001,1204,13
0.542,0.0001,638,666,100,10,0.001,1304,13
0.56,0.0001,675,729,100,10,0.001,1404,13
0.588,0.0001,734,770,100,10,0.001,1504,13
0.588,0.0001,781,823,100,10,0.001,1604,13
0.602,0.0001,835,869,100,10,0.001,1704,13
0.608,0.0001,889,915,100,10,0.001,1804,13
0.622,0.0001,944,960,100,10,0.001,1904,13
0.64,0.0001,989,1015,100,10,0.001,2004,13
0.506,0.0001,53,51,100,10,0.001,104,14
0.506,0.0001,104,100,100,10,0.001,204,14
0.506,0.0001,155,149,100,10,0.001,304,14
0.506,0.0001,209,195,100,10,0.001,404,14
0.506,0.0001,259,245,100,10,0.001,504,14
0.506,0.0001,310,294,100,10,0.001,604,14
0.506,0.0001,367,337,100,10,0.001,704,14
0.506,0.0001,414,390,100,10,0.001,804,14
0.506,0.0001,463,441,100,10,0.001,904,14
0.506,0.0001,515,489,100,10,0.001,1004,14
0.508,0.0001,570,534,100,10,0.001,1104,14
0.514,0.0001,615,589,100,10,0.001,1204,14
0.514,0.0001,664,640,100,10,0.001,1304,14
0.52,0.0001,714,690,100,10,0.001,1404,14
0.526,0.0001,757,747,100,10,0.001,1504,14
0.53,0.0001,809,795,100,10,0.001,1604,14
0.54,0.0001,851,853,100,10,0.001,1704,14
0.544,0.0001,901,903,100,10,0.001,1804,14
0.554,0.0001,957,947,100,10,0.001,1904,14
0.562,0.0001,1005,999,100,10,0.001,2004,14
0.524,0.0001,45,59,100,10,0.001,104,15
0.522,0.0001,91,113,100,10,0.001,204,15
0.522,0.0001,140,164,100,10,0.001,304,15
0.518,0.0001,195,209,100,10,0.001,404,15
0.512,0.0001,248,256,100,10,0.001,504,15
0.524,0.0001,300,304,100,10,0.001,604,15
0.526,0.0001,348,356,100,10,0.001,704,15
0.522,0.0001,410,394,100,10,0.001,804,15
0.544,0.0001,455,449,100,10,0.001,904,15
0.538,0.0001,511,493,100,10,0.001,1004,15
0.546,0.0001,560,544,100,10,0.001,1104,15
0.556,0.0001,614,590,100,10,0.001,1204,15
0.56,0.0001,660,644,100,10,0.001,1304,15
0.556,0.0001,716,688,100,10,0.001,1404,15
0.564,0.0001,763,741,100,10,0.001,1504,15
0.568,0.0001,808,796,100,10,0.001,1604,15
0.584,0.0001,851,853,100,10,0.001,1704,15
0.586,0.0001,905,899,100,10,0.001,1804,15
0.598,0.0001,952,952,100,10,0.001,1904,15
0.608,0.0001,999,1005,100,10,0.001,2004,15
0.512,0.0001,53,51,100,10,0.001,104,16
0.506,0.0001,104,100,100,10,0.001,204,16
0.51,0.0001,147,157,100,10,0.001,304,16
0.514,0.0001,196,208,100,10,0.001,404,16
0.52,0.0001,245,259,100,10,0.001,504,16
0.522,0.0001,299,305,100,10,0.001,604,16
0.53,0.0001,344,360,100,10,0.001,704,16
0.544,0.0001,391,413,100,10,0.001,804,16
0.536,0.0001,445,459,100,10,0.001,904,16
0.542,0.0001,498,506,100,10,0.001,1004,16
0.556,0.0001,555,549,100,10,0.001,1104,16
0.556,0.0001,598,606,100,10,0.001,1204,16
0.56,0.0001,653,651,100,10,0.001,1304,16
0.564,0.0001,707,697,100,10,0.001,1404,16
0.574,0.0001,759,745,100,10,0.001,1504,16
0.586,0.0001,804,800,100,10,0.001,1604,16
0.598,0.0001,864,840,100,10,0.001,1704,16
0.608,0.0001,921,883,100,10,0.001,1804,16
0.622,0.0001,974,930,100,10,0.001,1904,16
0.644,0.0001,1015,989,100,10,0.001,2004,16
0.508,0.0001,51,53,100,10,0.001,104,17
0.52,0.0001,101,103,100,10,0.001,204,17
0.526,0.0001,159,145,100,10,0.001,304,17
0.532,0.0001,208,196,100,10,0.001,404,17
0.532,0.0001,253,251,100,10,0.001,504,17
0.542,0.0001,302,302,100,10,0.001,604,17
0.532,0.0001,352,352,100,10,0.001,704,17
0.54,0.0001,409,395,100,10,0.001,804,17
0.554,0.0001,460,444,100,10,0.001,904,17
0.56,0.0001,506,498,100,10,0.001,1004,17
0.57,0.0001,556,548,100,10,0.001,1104,17
0.574,0.0001,610,594,100,10,0.001,1204,17
0.582,0.0001,659,645,100,10,0.001,1304,17
0.596,0.0001,706,698,100,10,0.001,1404,17
0.61,0.0001,755,749,100,10,0.001,1504,17
0.614,0.0001,803,801,100,10,0.001,1604,17
0.608,0.0001,852,852,100,10,0.001,1704,17
0.622,0.0001,899,905,100,10,0.001,1804,17
0.63,0.0001,947,957,100,10,0.001,1904,17
0.65,0.0001,996,1008,100,10,0.001,2004,17
0.542,0.0001,57,47,100,10,0.001,104,18
0.546,0.0001,98,106,100,10,0.001,204,18
0.544,0.0001,146,158,100,10,0.001,304,18
0.544,0.0001,197,207,100,10,0.001,404,18
0.544,0.0001,246,258,100,10,0.001,504,18
0.542,0.0001,299,305,100,10,0.001,604,18
0.55,0.0001,354,350,100,10,0.001,704,18
0.55,0.0001,402,402,100,10,0.001,804,18
0.554,0.0001,456,448,100,10,0.001,904,18
0.55,0.0001,501,503,100,10,0.001,1004,18
0.552,0.0001,551,553,100,10,0.001,1104,18
0.568,0.0001,601,603,100,10,0.001,1204,18
0.574,0.0001,652,652,100,10,0.001,1304,18
0.574,0.0001,700,704,100,10,0.001,1404,18
0.594,0.0001,756,748,100,10,0.001,1504,18
0.61,0.0001,807,797,100,10,0.001,1604,18
0.604,0.0001,848,856,100,10,0.001,1704,18
0.608,0.0001,907,897,100,10,0.001,1804,18
0.618,0.0001,964,940,100,10,0.001,1904,18
0.62,0.0001,1017,987,100,10,0.001,2004,18
0.516,0.0001,50,54,100,10,0.001,104,19
0.516,0.0001,98,106,100,10,0.001,204,19
0.514,0.0001,151,153,100,10,0.001,304,19
0.504,0.0001,198,206,100,10,0.001,404,19
0.506,0.0001,242,262,100,10,0.001,504,19
0.506,0.0001,298,306,100,10,0.001,604,19
0.502,0.0001,341,363,100,10,0.001,704,19
0.502,0.0001,388,416,100,10,0.001,804,19
0.518,0.0001,447,457,100,10,0.001,904,19
0.514,0.0001,486,518,100,10,0.001,1004,19
0.52,0.0001,536,568,100,10,0.001,1104,19
0.524,0.0001,587,617,100,10,0.001,1204,19
0.528,0.0001,634,670,100,10,0.001,1304,19
0.542,0.0001,682,722,100,10,0.001,1404,19
0.546,0.0001,732,772,100,10,0.001,1504,19
0.54,0.0001,791,813,100,10,0.001,1604,19
0.54,0.0001,843,861,100,10,0.001,1704,19
0.558,0.0001,903,901,100,10,0.001,1804,19
0.568,0.0001,955,949,100,10,0.001,1904,19
0.588,0.0001,1006,998,100,10,0.001,2004,19
0.476,0.0001,52,52,100,10,0.001,104,20
0.47,0.0001,108,96,100,10,0.001,204,20
0.472,0.0001,158,146,100,10,0.001,304,20
0.486,0.0001,210,194,100,10,0.001,404,20
0.492,0.0001,253,251,100,10,0.001,504,20
0.498,0.0001,302,302,100,10,0.001,604,20
0.492,0.0001,351,353,100,10,0.001,704,20
0.496,0.0001,407,397,100,10,0.001,804,20
0.502,0.0001,449,455,100,10,0.001,904,20
0.506,0.0001,503,501,100,10,0.001,1004,20
0.506,0.0001,555,549,100,10,0.001,1104,20
0.514,0.0001,606,598,100,10,0.001,1204,20
0.526,0.0001,653,651,100,10,0.001,1304,20
0.526,0.0001,703,701,100,10,0.001,1404,20
0.532,0.0001,748,756,100,10,0.001,1504,20
0.536,0.0001,798,806,100,10,0.001,1604,20
0.548,0.0001,846,858,100,10,0.001,1704,20
0.552,0.0001,896,908,100,10,0.001,1804,20
0.568,0.0001,944,960,100,10,0.001,1904,20
0.584,0.0001,991,1013,100,10,0.001,2004,20
0.516,0.0001,48,56,100,10,0.01,104,1
0.552,0.0001,101,103,100,10,0.01,204,1
0.558,0.0001,144,160,100,10,0.01,304,1
0.576,0.0001,195,209,100,10,0.01,404,1
0.588,0.0001,253,251,100,10,0.01,504,1
0.616,0.0001,296,308,100,10,0.01,604,1
0.616,0.0001,349,355,100,10,0.01,704,1
0.632,0.0001,402,402,100,10,0.01,804,1
0.654,0.0001,445,459,100,10,0.01,904,1
0.724,0.0001,490,514,100,10,0.01,1004,1
0.756,0.0001,547,557,100,10,0.01,1104,1
0.812,0.0001,598,606,100,10,0.01,1204,1
0.848,0.0001,651,653,100,10,0.01,1304,1
0.888,0.0001,704,700,100,10,0.01,1404,1
0.908,0.0001,756,748,100,10,0.01,1504,1
0.924,0.0001,810,794,100,10,0.01,1604,1
0.932,0.0001,861,843,100,10,0.01,1704,1
0.944,0.0001,913,891,100,10,0.01,1804,1
0.94,0.0001,956,948,100,10,0.01,1904,1
0.946,0.0001,1009,995,100,10,0.01,2004,1
0.51,0.0001,53,51,100,10,0.01,104,2
0.548,0.0001,104,100,100,10,0.01,204,2
0.558,0.0001,152,152,100,10,0.01,304,2
0.57,0.0001,209,195,100,10,0.01,404,2
0.622,0.0001,257,247,100,10,0.01,504,2
0.648,0.0001,303,301,100,10,0.01,604,2
0.67,0.0001,351,353,100,10,0.01,704,2
0.702,0.0001,407,397,100,10,0.01,804,2
0.716,0.0001,454,450,100,10,0.01,904,2
0.746,0.0001,503,501,100,10,0.01,1004,2
0.764,0.0001,555,549,100,10,0.01,1104,2
0.792,0.0001,601,603,100,10,0.01,1204,2
0.81,0.0001,653,651,100,10,0.01,1304,2
0.84,0.0001,706,698,100,10,0.01,1404,2
0.852,0.0001,753,751,100,10,0.01,1504,2
0.884,0.0001,801,803,100,10,0.01,1604,2
0.896,0.0001,857,847,100,10,0.01,1704,2
0.918,0.0001,910,894,100,10,0.01,1804,2
0.896,0.0001,957,947,100,10,0.01,1904,2
0.922,0.0001,1010,994,100,10,0.01,2004,2
0.502,0.0001,45,59,100,10,0.01,104,3
0.504,0.0001,91,113,100,10,0.01,204,3
0.506,0.0001,140,164,100,10,0.01,304,3
0.514,0.0001,194,210,100,10,0.01,404,3
0.528,0.0001,243,261,100,10,0.01,504,3
0.522,0.0001,293,311,100,10,0.01,604,3
0.552,0.0001,342,362,100,10,0.01,704,3
0.566,0.0001,391,413,100,10,0.01,804,3
0.614,0.0001,444,460,100,10,0.01,904,3
0.612,0.0001,501,503,100,10,0.01,1004,3
0.668,0.0001,542,562,100,10,0.01,1104,3
0.73,0.0001,597,607,100,10,0.01,1204,3
0.762,0.0001,641,663,100,10,0.01,1304,3
0.808,0.0001,688,716,100,10,0.01,1404,3
0.85,0.0001,739,765,100,10,0.01,1504,3
0.892,0.0001,793,811,100,10,0.01,1604,3
0.916,0.0001,846,858,100,10,0.01,1704,3
0.922,0.0001,910,894,100,10,0.01,1804,3
0.936,0.0001,961,943,100,10,0.01,1904,3
0.942,0.0001,1009,995,100,10,0.01,2004,3
0.544,0.0001,47,57,100,10,0.01,104,4
0.59,0.0001,98,106,100,10,0.01,204,4
0.59,0.0001,142,162,100,10,0.01,304,4
0.608,0.0001,190,214,100,10,0.01,404,4
0.606,0.0001,237,267,100,10,0.01,504,4
0.626,0.0001,280,324,100,10,0.01,604,4
0.632,0.0001,338,366,100,10,0.01,704,4
0.664,0.0001,390,414,100,10,0.01,804,4
0.688,0.0001,436,468,100,10,0.01,904,4
0.748,0.0001,490,514,100,10,0.01,1004,4
0.756,0.0001,539,565,100,10,0.01,1104,4
0.796,0.0001,590,614,100,10,0.01,1204,4
0.84,0.0001,643,661,100,10,0.01,1304,4
0.866,0.0001,693,711,100,10,0.01,1404,4
0.888,0.0001,744,760,100,10,0.01,1504,4
0.902,0.0001,791,813,100,10,0.01,1604,4
0.918,0.0001,846,858,100,10,0.01,1704,4
0.934,0.0001,905,899,100,10,0.01,1804,4
0.936,0.0001,951,953,100,10,0.01,1904,4
0.934,0.0001,1000,1004,100,10,0.01,2004,4
0.528,0.0001,47,57,100,10,0.01,104,5
0.53,0.0001,95,109,100,10,0.01,204,5
0.508,0.0001,143,161,100,10,0.01,304,5
0.51,0.0001,187,217,100,10,0.01,404,5
0.526,0.0001,237,267,100,10,0.01,504,5
0.524,0.0001,282,322,100,10,0.01,604,5
0.544,0.0001,326,378,100,10,0.01,704,5
0.558,0.0001,383,421,100,10,0.01,804,5
0.574,0.0001,432,472,100,10,0.01,904,5
0.616,0.0001,487,517,100,10,0.01,1004,5
0.662,0.0001,531,573,100,10,0.01,1104,5
0.722,0.0001,571,633,100,10,0.01,1204,5
0.748,0.0001,627,677,100,10,0.01,1304,5
0.804,0.0001,673,731,100,10,0.01,1404,5
0.832,0.0001,722,782,100,10,0.01,1504,5
0.872,0.0001,780,824,100,10,0.01,1604,5
0.884,0.0001,819,885,100,10,0.01,1704,5
0.912,0.0001,864,940,100,10,0.01,1804,5
0.92,0.0001,921,983,100,10,0.01,1904,5
0.93,0.0001,984,1020,100,10,0.01,2004,5
0.488,0.0001,47,57,100,10,0.01,104,6
0.498,0.0001,98,106,100,10,0.01,204,6
0.508,0.0001,152,152,100,10,0.01,304,6
0.514,0.0001,195,209,100,10,0.01,404,6
0.544,0.0001,252,252,100,10,0.01,504,6
0.548,0.0001,304,300,100,10,0.01,604,6
0.588,0.0001,350,354,100,10,0.01,704,6
0.608,0.0001,398,406,100,10,0.01,804,6
0.628,0.0001,451,453,100,10,0.01,904,6
0.648,0.0001,498,506,100,10,0.01,1004,6
0.676,0.0001,547,557,100,10,0.01,1104,6
0.704,0.0001,596,608,100,10,0.01,1204,6
0.734,0.0001,641,663,100,10,0.01,1304,6
0.776,0.0001,695,709,100,10,0.01,1404,6
0.802,0.0001,745,759,100,10,0.01,1504,6
0.822,0.0001,795,809,100,10,0.01,1604,6
0.846,0.0001,843,861,100,10,0.01,1704,6
0.862,0.0001,897,907,100,10,0.01,1804,6
0.87,0.0001,947,957,100,10,0.01,1904,6
0.896,0.0001,995,1009,100,10,0.01,2004,6
0.478,0.0001,50,54,100,10,0.01,104,7
0.502,0.0001,97,107,100,10,0.01,204,7
0.498,0.0001,141,163,100,10,0.01,304,7
0.502,0.0001,186,218,100,10,0.01,404,7
0.53,0.0001,234,270,100,10,0.01,504,7
0.566,0.0001,287,317,100,10,0.01,604,7
0.57,0.0001,341,363,100,10,0.01,704,7
0.596,0.0001,395,409,100,10,0.01,804,7
0.638,0.0001,450,454,100,10,0.01,904,7
0.686,0.0001,494,510,100,10,0.01,1004,7
0.724,0.0001,539,565,100,10,0.01,1104,7
0.774,0.0001,586,618,100,10,0.01,1204,7
0.808,0.0001,633,671,100,10,0.01,1304,7
0.84,0.0001,689,715,100,10,0.01,1404,7
0.864,0.0001,746,758,100,10,0.01,1504,7
0.886,0.0001,796,808,100,10,0.01,1604,7
0.9,0.0001,851,853,100,10,0.01,1704,7
0.918,0.0001,883,921,100,10,0.01,1804,7
0.92,0.0001,933,971,100,10,0.01,1904,7
0.928,0.0001,984,1020,100,10,0.01,2004,7
0.494,0.0001,51,53,100,10,0.01,104,8
0.528,0.0001,100,104,100,10,0.01,204,8
0.544,0.0001,156,148,100,10,0.01,304,8
0.576,0.0001,193,211,100,10,0.01,404,8
0.59,0.0001,246,258,100,10,0.01,504,8
0.61,0.0001,301,303,100,10,0.01,604,8
0.618,0.0001,348,356,100,10,0.01,704,8
0.646,0.0001,398,406,100,10,0.01,804,8
0.662,0.0001,450,454,100,10,0.01,904,8
0.716,0.0001,500,504,100,10,0.01,1004,8
0.728,0.0001,551,553,100,10,0.01,1104,8
0.766,0.0001,602,602,100,10,0.01,1204,8
0.846,0.0001,655,649,100,10,0.01,1304,8
0.866,0.0001,700,704,100,10,0.01,1404,8
0.864,0.0001,749,755,100,10,0.01,1504,8
0.924,0.0001,800,804,100,10,0.01,1604,8
0.944,0.0001,852,852,100,10,0.01,1704,8
0.948,0.0001,905,899,100,10,0.01,1804,8
0.952,0.0001,957,947,100,10,0.01,1904,8
0.962,0.0001,1005,999,100,10,0.01,2004,8
0.534,0.0001,51,53,100,10,0.01,104,9
0.54,0.0001,101,103,100,10,0.01,204,9
0.536,0.0001,151,153,100,10,0.01,304,9
0.554,0.0001,205,199,100,10,0.01,404,9
0.546,0.0001,247,257,100,10,0.01,504,9
0.54,0.0001,307,297,100,10,0.01,604,9
0.558,0.0001,349,355,100,10,0.01,704,9
0.59,0.0001,402,402,100,10,0.01,804,9
0.622,0.0001,443,461,100,10,0.01,904,9
0.662,0.0001,500,504,100,10,0.01,1004,9
0.68,0.0001,550,554,100,10,0.01,1104,9
0.728,0.0001,597,607,100,10,0.01,1204,9
0.766,0.0001,647,657,100,10,0.01,1304,9
0.816,0.0001,695,709,100,10,0.01,1404,9
0.844,0.0001,747,757,100,10,0.01,1504,9
0.884,0.0001,800,804,100,10,0.01,1604,9
0.906,0.0001,850,854,100,10,0.01,1704,9
0.918,0.0001,899,905,100,10,0.01,1804,9
0.922,0.0001,954,950,100,10,0.01,1904,9
0.932,0.0001,1018,986,100,10,0.01,2004,9
0.532,0.0001,47,57,100,10,0.01,104,10
0.534,0.0001,103,101,100,10,0.01,204,10
0.536,0.0001,159,145,100,10,0.01,304,10
0.558,0.0001,210,194,100,10,0.01,404,10
0.574,0.0001,260,244,100,10,0.01,504,10
0.602,0.0001,311,293,100,10,0.01,604,10
0.618,0.0001,359,345,100,10,0.01,704,10
0.642,0.0001,409,395,100,10,0.01,804,10
0.668,0.0001,459,445,100,10,0.01,904,10
0.698,0.0001,511,493,100,10,0.01,1004,10
0.74,0.0001,556,548,100,10,0.01,1104,10
0.79,0.0001,614,590,100,10,0.01,1204,10
0.812,0.0001,659,645,100,10,0.01,1304,10
0.878,0.0001,710,694,100,10,0.01,1404,10
0.9,0.0001,764,740,100,10,0.01,1504,10
0.928,0.0001,814,790,100,10,0.01,1604,10
0.938,0.0001,858,846,100,10,0.01,1704,10
0.95,0.0001,900,904,100,10,0.01,1804,10
0.968,0.0001,952,952,100,10,0.01,1904,10
0.972,0.0001,1005,999,100,10,0.01,2004,10
0.51,0.0001,55,49,100,10,0.01,104,11
0.526,0.0001,105,99,100,10,0.01,204,11
0.53,0.0001,159,145,100,10,0.01,304,11
0.542,0.0001,207,197,100,10,0.01,404,11
0.572,0.0001,260,244,100,10,0.01,504,11
0.572,0.0001,319,285,100,10,0.01,604,11
0.604,0.0001,361,343,100,10,0.01,704,11
0.612,0.0001,407,397,100,10,0.01,804,11
0.64,0.0001,452,452,100,10,0.01,904,11
0.676,0.0001,501,503,100,10,0.01,1004,11
0.724,0.0001,561,543,100,10,0.01,1104,11
0.76,0.0001,610,594,100,10,0.01,1204,11
0.776,0.0001,666,638,100,10,0.01,1304,11
0.82,0.0001,714,690,100,10,0.01,1404,11
0.854,0.0001,756,748,100,10,0.01,1504,11
0.886,0.0001,805,799,100,10,0.01,1604,11
0.91,0.0001,858,846,100,10,0.01,1704,11
0.928,0.0001,903,901,100,10,0.01,1804,11
0.936,0.0001,950,954,100,10,0.01,1904,11
0.938,0.0001,1002,1002,100,10,0.01,2004,11
0.5,0.0001,55,49,100,10,0.01,104,12
0.536,0.0001,112,92,100,10,0.01,204,12
0.576,0.0001,152,152,100,10,0.01,304,12
0.588,0.0001,199,205,100,10,0.01,404,12
0.612,0.0001,255,249,100,10,0.01,504,12
0.642,0.0001,298,306,100,10,0.01,604,12
0.654,0.0001,351,353,100,10,0.01,704,12
0.672,0.0001,400,404,100,10,0.01,804,12
0.68,0.0001,451,453,100,10,0.01,904,12
0.714,0.0001,492,512,100,10,0.01,1004,12
0.74,0.0001,542,562,100,10,0.01,1104,12
0.784,0.0001,595,609,100,10,0.01,1204,12
0.818,0.0001,654,650,100,10,0.01,1304,12
0.844,0.0001,695,709,100,10,0.01,1404,12
0.87,0.0001,746,758,100,10,0.01,1504,12
0.91,0.0001,799,805,100,10,0.01,1604,12
0.924,0.0001,845,859,100,10,0.01,1704,12
0.932,0.0001,900,904,100,10,0.01,1804,12
0.942,0.0001,957,947,100,10,0.01,1904,12
0.958,0.0001,1000,1004,100,10,0.01,2004,12
0.49,0.0001,54,50,100,10,0.01,104,13
0.492,0.0001,101,103,100,10,0.01,204,13
0.492,0.0001,154,150,100,10,0.01,304,13
0.488,0.0001,203,201,100,10,0.01,404,13
0.488,0.0001,250,254,100,10,0.01,504,13
0.488,0.0001,295,309,100,10,0.01,604,13
0.516,0.0001,346,358,100,10,0.01,704,13
0.552,0.0001,395,409,100,10,0.01,804,13
0.562,0.0001,441,463,100,10,0.01,904,13
0.57,0.0001,492,512,100,10,0.01,1004,13
0.564,0.0001,542,562,100,10,0.01,1104,13
0.566,0.0001,600,604,100,10,0.01,1204,13
0.584,0.0001,650,654,100,10,0.01,1304,13
0.596,0.0001,695,709,100,10,0.01,1404,13
0.61,0.0001,743,761,100,10,0.01,1504,13
0.614,0.0001,793,811,100,10,0.01,1604,13
0.646,0.0001,846,858,100,10,0.01,1704,13
0.662,0.0001,890,914,100,10,0.01,1804,13
0.674,0.0001,941,963,100,10,0.01,1904,13
0.692,0.0001,997,1007,100,10,0.01,2004,13
0.506,0.0001,54,50,100,10,0.01,104,14
0.558,0.0001,104,100,100,10,0.01,204,14
0.574,0.0001,147,157,100,10,0.01,304,14
0.584,0.0001,198,206,100,10,0.01,404,14
0.586,0.0001,242,262,100,10,0.01,504,14
0.614,0.0001,299,305,100,10,0.01,604,14
0.616,0.0001,351,353,100,10,0.01,704,14
0.656,0.0001,402,402,100,10,0.01,804,14
0.664,0.0001,450,454,100,10,0.01,904,14
0.718,0.0001,500,504,100,10,0.01,1004,14
0.744,0.0001,557,547,100,10,0.01,1104,14
0.788,0.0001,613,591,100,10,0.01,1204,14
0.824,0.0001,659,645,100,10,0.01,1304,14
0.868,0.0001,720,684,100,10,0.01,1404,14
0.912,0.0001,767,737,100,10,0.01,1504,14
0.944,0.0001,808,796,100,10,0.01,1604,14
0.938,0.0001,866,838,100,10,0.01,1704,14
0.952,0.0001,917,887,100,10,0.01,1804,14
0.958,0.0001,968,936,100,10,0.01,1904,14
0.97,0.0001,1008,996,100,10,0.01,2004,14
0.506,0.0001,50,54,100,10,0.01,104,15
0.514,0.0001,98,106,100,10,0.01,204,15
0.506,0.0001,154,150,100,10,0.01,304,15
0.512,0.0001,203,201,100,10,0.01,404,15
0.54,0.0001,252,252,100,10,0.01,504,15
0.562,0.0001,303,301,100,10,0.01,604,15
0.594,0.0001,352,352,100,10,0.01,704,15
0.618,0.0001,402,402,100,10,0.01,804,15
0.63,0.0001,461,443,100,10,0.01,904,15
0.668,0.0001,514,490,100,10,0.01,1004,15
0.69,0.0001,562,542,100,10,0.01,1104,15
0.736,0.0001,610,594,100,10,0.01,1204,15
0.796,0.0001,654,650,100,10,0.01,1304,15
0.842,0.0001,705,699,100,10,0.01,1404,15
0.86,0.0001,759,745,100,10,0.01,1504,15
0.906,0.0001,811,793,100,10,0.01,1604,15
0.922,0.0001,865,839,100,10,0.01,1704,15
0.928,0.0001,914,890,100,10,0.01,1804,15
0.936,0.0001,959,945,100,10,0.01,1904,15
0.946,0.0001,1006,998,100,10,0.01,2004,15
0.45,0.0001,42,62,100,10,0.01,104,16
0.46,0.0001,79,125,100,10,0.01,204,16
0.47,0.0001,132,172,100,10,0.01,304,16
0.476,0.0001,171,233,100,10,0.01,404,16
0.488,0.0001,226,278,100,10,0.01,504,16
0.502,0.0001,276,328,100,10,0.01,604,16
0.534,0.0001,328,376,100,10,0.01,704,16
0.568,0.0001,379,425,100,10,0.01,804,16
0.592,0.0001,428,476,100,10,0.01,904,16
0.594,0.0001,481,523,100,10,0.01,1004,16
0.634,0.0001,537,567,100,10,0.01,1104,16
0.692,0.0001,583,621,100,10,0.01,1204,16
0.722,0.0001,630,674,100,10,0.01,1304,16
0.782,0.0001,687,717,100,10,0.01,1404,16
0.824,0.0001,739,765,100,10,0.01,1504,16
0.87,0.0001,786,818,100,10,0.01,1604,16
0.906,0.0001,830,874,100,10,0.01,1704,16
0.928,0.0001,876,928,100,10,0.01,1804,16
0.938,0.0001,924,980,100,10,0.01,1904,16
0.94,0.0001,983,1021,100,10,0.01,2004,16
0.51,0.0001,53,51,100,10,0.01,104,17
0.508,0.0001,109,95,100,10,0.01,204,17
0.522,0.0001,159,145,100,10,0.01,304,17
0.54,0.0001,216,188,100,10,0.01,404,17
0.54,0.0001,263,241,100,10,0.01,504,17
0.568,0.0001,312,292,100,10,0.01,604,17
0.588,0.0001,361,343,100,10,0.01,704,17
0.6,0.0001,413,391,100,10,0.01,804,17
0.652,0.0001,465,439,100,10,0.01,904,17
0.692,0.0001,505,499,100,10,0.01,1004,17
0.724,0.0001,555,549,100,10,0.01,1104,17
0.8,0.0001,600,604,100,10,0.01,1204,17
0.828,0.0001,649,655,100,10,0.01,1304,17
0.86,0.0001,698,706,100,10,0.01,1404,17
0.874,0.0001,746,758,100,10,0.01,1504,17
0.89,0.0001,799,805,100,10,0.01,1604,17
0.9,0.0001,854,850,100,10,0.01,1704,17
0.918,0.0001,898,906,100,10,0.01,1804,17
0.924,0.0001,947,957,100,10,0.01,1904,17
0.922,0.0001,996,1008,100,10,0.01,2004,17
0.522,0.0001,42,62,100,10,0.01,104,18
0.546,0.0001,89,115,100,10,0.01,204,18
0.542,0.0001,143,161,100,10,0.01,304,18
0.552,0.0001,192,212,100,10,0.01,404,18
0.55,0.0001,250,254,100,10,0.01,504,18
0.562,0.0001,302,302,100,10,0.01,604,18
0.552,0.0001,344,360,100,10,0.01,704,18
0.592,0.0001,390,414,100,10,0.01,804,18
0.616,0.0001,445,459,100,10,0.01,904,18
0.68,0.0001,503,501,100,10,0.01,1004,18
0.728,0.0001,551,553,100,10,0.01,1104,18
0.798,0.0001,598,606,100,10,0.01,1204,18
0.826,0.0001,650,654,100,10,0.01,1304,18
0.848,0.0001,698,706,100,10,0.01,1404,18
0.876,0.0001,747,757,100,10,0.01,1504,18
0.906,0.0001,799,805,100,10,0.01,1604,18
0.92,0.0001,848,856,100,10,0.01,1704,18
0.948,0.0001,902,902,100,10,0.01,1804,18
0.93,0.0001,946,958,100,10,0.01,1904,18
0.954,0.0001,1000,1004,100,10,0.01,2004,18
0.526,0.0001,54,50,100,10,0.01,104,19
0.528,0.0001,105,99,100,10,0.01,204,19
0.534,0.0001,155,149,100,10,0.01,304,19
0.532,0.0001,206,198,100,10,0.01,404,19
0.544,0.0001,259,245,100,10,0.01,504,19
0.57,0.0001,314,290,100,10,0.01,604,19
0.576,0.0001,367,337,100,10,0.01,704,19
0.59,0.0001,412,392,100,10,0.01,804,19
0.59,0.0001,462,442,100,10,0.01,904,19
0.594,0.0001,519,485,100,10,0.01,1004,19
0.63,0.0001,568,536,100,10,0.01,1104,19
0.694,0.0001,614,590,100,10,0.01,1204,19
0.766,0.0001,658,646,100,10,0.01,1304,19
0.828,0.0001,714,690,100,10,0.01,1404,19
0.856,0.0001,767,737,100,10,0.01,1504,19
0.876,0.0001,819,785,100,10,0.01,1604,19
0.904,0.0001,870,834,100,10,0.01,1704,19
0.912,0.0001,919,885,100,10,0.01,1804,19
0.922,0.0001,970,934,100,10,0.01,1904,19
0.938,0.0001,1013,991,100,10,0.01,2004,19
0.496,0.0001,51,53,100,10,0.01,104,20
0.504,0.0001,102,102,100,10,0.01,204,20
0.526,0.0001,150,154,100,10,0.01,304,20
0.54,0.0001,200,204,100,10,0.01,404,20
0.554,0.0001,252,252,100,10,0.01,504,20
0.582,0.0001,310,294,100,10,0.01,604,20
0.604,0.0001,367,337,100,10,0.01,704,20
0.63,0.0001,420,384,100,10,0.01,804,20
0.644,0.0001,478,426,100,10,0.01,904,20
0.664,0.0001,527,477,100,10,0.01,1004,20
0.692,0.0001,582,522,100,10,0.01,1104,20
0.734,0.0001,620,584,100,10,0.01,1204,20
0.774,0.0001,661,643,100,10,0.01,1304,20
0.816,0.0001,714,690,100,10,0.01,1404,20
0.844,0.0001,758,746,100,10,0.01,1504,20
0.88,0.0001,810,794,100,10,0.01,1604,20
0.884,0.0001,852,852,100,10,0.01,1704,20
0.914,0.0001,902,902,100,10,0.01,1804,20
0.922,0.0001,951,953,100,10,0.01,1904,20
0.934,0.0001,995,1009,100,10,0.01,2004,20
0.502,0.001,47,57,100,10,0.0001,104,1
0.498,0.001,100,104,100,10,0.0001,204,1
0.496,0.001,149,155,100,10,0.0001,304,1
0.496,0.001,201,203,100,10,0.0001,404,1
0.498,0.001,248,256,100,10,0.0001,504,1
0.498,0.001,294,310,100,10,0.0001,604,1
0.496,0.001,343,361,100,10,0.0001,704,1
0.494,0.001,394,410,100,10,0.0001,804,1
0.494,0.001,447,457,100,10,0.0001,904,1
0.494,0.001,492,512,100,10,0.0001,1004,1
0.494,0.001,547,557,100,10,0.0001,1104,1
0.494,0.001,599,605,100,10,0.0001,1204,1
0.492,0.001,645,659,100,10,0.0001,1304,1
0.488,0.001,699,705,100,10,0.0001,1404,1
0.486,0.001,742,762,100,10,0.0001,1504,1
0.49,0.001,788,816,100,10,0.0001,1604,1
0.492,0.001,838,866,100,10,0.0001,1704,1
0.492,0.001,892,912,100,10,0.0001,1804,1
0.494,0.001,942,962,100,10,0.0001,1904,1
0.496,0.001,983,1021,100,10,0.0001,2004,1
0.458,0.001,48,56,100,10,0.0001,104,2
0.46,0.001,98,106,100,10,0.0001,204,2
0.46,0.001,153,151,100,10,0.0001,304,2
0.46,0.001,206,198,100,10,0.0001,404,2
0.46,0.001,256,248,100,10,0.0001,504,2
0.46,0.001,303,301,100,10,0.0001,604,2
0.458,0.001,350,354,100,10,0.0001,704,2
0.458,0.001,397,407,100,10,0.0001,804,2
0.458,0.001,451,453,100,10,0.0001,904,2
0.458,0.001,505,499,100,10,0.0001,1004,2
0.46,0.001,554,550,100,10,0.0001,1104,2
0.462,0.001,608,596,100,10,0.0001,1204,2
0.462,0.001,663,641,100,10,0.0001,1304,2
0.462,0.001,717,687,100,10,0.0001,1404,2
0.462,0.001,770,734,100,10,0.0001,1504,2
0.462,0.001,814,790,100,10,0.0001,1604,2
0.464,0.001,869,835,100,10,0.0001,1704,2
0.464,0.001,912,892,100,10,0.0001,1804,2
0.468,0.001,960,944,100,10,0.0001,1904,2
0.47,0.001,1010,994,100,10,0.0001,2004,2
0.478,0.001,48,56,100,10,0.0001,104,3
0.478,0.001,94,110,100,10,0.0001,204,3
0.478,0.001,146,158,100,10,0.0001,304,3
0.478,0.001,197,207,100,10,0.0001,404,3
0.478,0.001,250,254,100,10,0.0001,504,3
0.478,0.001,307,297,100,10,0.0001,604,3
0.478,0.001,360,344,100,10,0.0001,704,3
0.478,0.001,412,392,100,10,0.0001,804,3
0.478,0.001,465,439,100,10,0.0001,904,3
0.478,0.001,512,492,100,10,0.0001,1004,3
0.478,0.001,566,538,100,10,0.0001,1104,3
0.478,0.001,614,590,100,10,0.0001,1204,3
0.478,0.001,673,631,100,10,0.0001,1304,3
0.478,0.001,727,677,100,10,0.0001,1404,3
0.478,0.001,766,738,100,10,0.0001,1504,3
0.478,0.001,811,793,100,10,0.0001,1604,3
0.478,0.001,868,836,100,10,0.0001,1704,3
0.478,0.001,913,891,100,10,0.0001,1804,3
0.478,0.001,963,941,100,10,0.0001,1904,3
0.478,0.001,1013,991,100,10,0.0001,2004,3
0.532,0.001,43,61,100,10,0.0001,104,4
0.532,0.001,89,115,100,10,0.0001,204,4
0.532,0.001,142,162,100,10,0.0001,304,4
0.532,0.001,186,218,100,10,0.0001,404,4
0.53,0.001,239,265,100,10,0.0001,504,4
0.53,0.001,292,312,100,10,0.0001,604,4
0.53,0.001,342,362,100,10,0.0001,704,4
0.53,0.001,385,419,100,10,0.0001,804,4
0.53,0.001,441,463,100,10,0.0001,904,4
0.53,0.001,494,510,100,10,0.0001,1004,4
0.53,0.001,542,562,100,10,0.0001,1104,4
0.532,0.001,597,607,100,10,0.0001,1204,4
0.536,0.001,653,651,100,10,0.0001,1304,4
0.538,0.001,703,701,100,10,0.0001,1404,4
0.536,0.001,755,749,100,10,0.0001,1504,4
0.534,0.001,798,806,100,10,0.0001,1604,4
0.538,0.001,848,856,100,10,0.0001,1704,4
0.542,0.001,895,909,100,10,0.0001,1804,4
0.544,0.001,944,960,100,10,0.0001,1904,4
0.542,0.001,1004,1000,100,10,0.0001,2004,4
0.514,0.001,40,64,100,10,0.0001,104,5
0.516,0.001,98,106,100,10,0.0001,204,5
0.516,0.001,156,148,100,10,0.0001,304,5
0.516,0.001,201,203,100,10,0.0001,404,5
0.518,0.001,262,242,100,10,0.0001,504,5
0.518,0.001,309,295,100,10,0.0001,604,5
0.516,0.001,356,348,100,10,0.0001,704,5
0.516,0.001,403,401,100,10,0.0001,804,5
0.514,0.001,457,447,100,10,0.0001,904,5
0.516,0.001,505,499,100,10,0.0001,1004,5
0.514,0.001,551,553,100,10,0.0001,1104,5
0.512,0.001,597,607,100,10,0.0001,1204,5
0.516,0.001,650,654,100,10,0.0001,1304,5
0.516,0.001,709,695,100,10,0.0001,1404,5
0.518,0.001,753,751,100,10,0.0001,1504,5
0.516,0.001,811,793,100,10,0.0001,1604,5
0.52,0.001,870,834,100,10,0.0001,1704,5
0.522,0.001,915,889,100,10,0.0001,1804,5
0.52,0.001,962,942,100,10,0.0001,1904,5
0.518,0.001,1001,1003,100,10,0.0001,2004,5
0.534,0.001,57,47,100,10,0.0001,104,6
0.538,0.001,101,103,100,10,0.0001,204,6
0.54,0.001,155,149,100,10,0.0001,304,6
0.54,0.001,196,208,100,10,0.0001,404,6
0.538,0.001,243,261,100,10,0.0001,504,6
0.538,0.001,291,313,100,10,0.0001,604,6
0.538,0.001,344,360,100,10,0.0001,704,6
0.538,0.001,390,414,100,10,0.0001,804,6
0.54,0.001,446,458,100,10,0.0001,904,6
0.542,0.001,493,511,100,10,0.0001,1004,6
0.542,0.001,536,568,100,10,0.0001,1104,6
0.54,0.001,589,615,100,10,0.0001,1204,6
0.542,0.001,640,664,100,10,0.0001,1304,6
0.54,0.001,682,722,100,10,0.0001,1404,6
0.538,0.001,740,764,100,10,0.0001,1504,6
0.538,0.001,792,812,100,10,0.0001,1604,6
0.538,0.001,837,867,100,10,0.0001,1704,6
0.54,0.001,884,920,100,10,0.0001,1804,6
0.544,0.001,939,965,100,10,0.0001,1904,6
0.548,0.001,1000,1004,100,10,0.0001,2004,6
0.488,0.001,52,52,100,10,0.0001,104,7
0.486,0.001,94,110,100,10,0.0001,204,7
0.486,0.001,143,161,100,10,0.0001,304,7
0.488,0.001,189,215,100,10,0.0001,404,7
0.488,0.001,240,264,100,10,0.0001,504,7
0.486,0.001,287,317,100,10,0.0001,604,7
0.488,0.001,341,363,100,10,0.0001,704,7
0.488,0.001,397,407,100,10,0.0001,804,7
0.488,0.001,454,450,100,10,0.0001,904,7
0.49,0.001,502,502,100,10,0.0001,1004,7
0.49,0.001,554,550,100,10,0.0001,1104,7
0.49,0.001,591,613,100,10,0.0001,1204,7
0.49,0.001,638,666,100,10,0.0001,1304,7
0.49,0.001,687,717,100,10,0.0001,1404,7
0.486,0.001,743,761,100,10,0.0001,1504,7
0.486,0.001,793,811,100,10,0.0001,1604,7
0.488,0.001,845,859,100,10,0.0001,1704,7
0.49,0.001,897,907,100,10,0.0001,1804,7
0.49,0.001,945,959,100,10,0.0001,1904,7
0.49,0.001,996,1008,100,10,0.0001,2004,7
0.478,0.001,46,58,100,10,0.0001,104,8
0.478,0.001,95,109,100,10,0.0001,204,8
0.476,0.001,146,158,100,10,0.0001,304,8
0.478,0.001,200,204,100,10,0.0001,404,8
0.476,0.001,252,252,100,10,0.0001,504,8
0.476,0.001,301,303,100,10,0.0001,604,8
0.476,0.001,354,350,100,10,0.0001,704,8
0.478,0.001,393,411,100,10,0.0001,804,8
0.478,0.001,446,458,100,10,0.0001,904,8
0.48,0.001,500,504,100,10,0.0001,1004,8
0.48,0.001,554,550,100,10,0.0001,1104,8
0.48,0.001,608,596,100,10,0.0001,1204,8
0.486,0.001,659,645,100,10,0.0001,1304,8
0.486,0.001,703,701,100,10,0.0001,1404,8
0.486,0.001,757,747,100,10,0.0001,1504,8
0.486,0.001,809,795,100,10,0.0001,1604,8
0.49,0.001,858,846,100,10,0.0001,1704,8
0.49,0.001,915,889,100,10,0.0001,1804,8
0.496,0.001,967,937,100,10,0.0001,1904,8
0.498,0.001,1008,996,100,10,0.0001,2004,8
0.472,0.001,45,59,100,10,0.0001,104,9
0.472,0.001,92,112,100,10,0.0001,204,9
0.472,0.001,150,154,100,10,0.0001,304,9
0.472,0.001,202,202,100,10,0.0001,404,9
0.47,0.001,252,252,100,10,0.0001,504,9
0.472,0.001,303,301,100,10,0.0001,604,9
0.472,0.001,357,347,100,10,0.0001,704,9
0.472,0.001,414,390,100,10,0.0001,804,9
0.472,0.001,457,447,100,10,0.0001,904,9
0.472,0.001,513,491,100,10,0.0001,1004,9
0.474,0.001,562,542,100,10,0.0001,1104,9
0.474,0.001,606,598,100,10,0.0001,1204,9
0.474,0.001,650,654,100,10,0.0001,1304,9
0.472,0.001,703,701,100,10,0.0001,1404,9
0.472,0.001,755,749,100,10,0.0001,1504,9
0.472,0.001,808,796,100,10,0.0001,1604,9
0.472,0.001,859,845,100,10,0.0001,1704,9
0.472,0.001,910,894,100,10,0.0001,1804,9
0.47,0.001,959,945,100,10,0.0001,1904,9
0.468,0.001,1012,992,100,10,0.0001,2004,9
0.494,0.001,48,56,100,10,0.0001,104,10
0.494,0.001,109,95,100,10,0.0001,204,10
0.494,0.001,162,142,100,10,0.0001,304,10
0.494,0.001,214,190,100,10,0.0001,404,10
0.494,0.001,258,246,100,10,0.0001,504,10
0.494,0.001,300,304,100,10,0.0001,604,10
0.492,0.001,350,354,100,10,0.0001,704,10
0.494,0.001,399,405,100,10,0.0001,804,10
0.496,0.001,449,455,100,10,0.0001,904,10
0.496,0.001,505,499,100,10,0.0001,1004,10
0.496,0.001,553,551,100,10,0.0001,1104,10
0.496,0.001,606,598,100,10,0.0001,1204,10
0.496,0.001,652,652,100,10,0.0001,1304,10
0.494,0.001,709,695,100,10,0.0001,1404,10
0.492,0.001,766,738,100,10,0.0001,1504,10
0.492,0.001,815,789,100,10,0.0001,1604,10
0.492,0.001,870,834,100,10,0.0001,1704,10
0.492,0.001,908,896,100,10,0.0001,1804,10
0.492,0.001,954,950,100,10,0.0001,1904,10
0.494,0.001,1000,1004,100,10,0.0001,2004,10
0.494,0.001,55,49,100,10,0.0001,104,11
0.494,0.001,100,104,100,10,0.0001,204,11
0.494,0.001,155,149,100,10,0.0001,304,11
0.494,0.001,205,199,100,10,0.0001,404,11
0.494,0.001,244,260,100,10,0.0001,504,11
0.494,0.001,292,312,100,10,0.0001,604,11
0.494,0.001,346,358,100,10,0.0001,704,11
0.494,0.001,385,419,100,10,0.0001,804,11
0.494,0.001,432,472,100,10,0.0001,904,11
0.494,0.001,488,516,100,10,0.0001,1004,11
0.494,0.001,534,570,100,10,0.0001,1104,11
0.494,0.001,575,629,100,10,0.0001,1204,11
0.494,0.001,621,683,100,10,0.0001,1304,11
0.494,0.001,677,727,100,10,0.0001,1404,11
0.494,0.001,721,783,100,10,0.0001,1504,11
0.494,0.001,771,833,100,10,0.0001,1604,11
0.494,0.001,830,874,100,10,0.0001,1704,11
0.494,0.001,889,915,100,10,0.0001,1804,11
0.494,0.001,941,963,100,10,0.0001,1904,11
0.494,0.001,1003,1001,100,10,0.0001,2004,11
0.502,0.001,50,54,100,10,0.0001,104,12
0.504,0.001,103,101,100,10,0.0001,204,12
0.504,0.001,150,154,100,10,0.0001,304,12
0.506,0.001,199,205,100,10,0.0001,404,12
0.506,0.001,242,262,100,10,0.0001,504,12
0.504,0.001,296,308,100,10,0.0001,604,12
0.504,0.001,343,361,100,10,0.0001,704,12
0.502,0.001,394,410,100,10,0.0001,804,12
0.502,0.001,440,464,100,10,0.0001,904,12
0.5,0.001,496,508,100,10,0.0001,1004,12
0.5,0.001,546,558,100,10,0.0001,1104,12
0.5,0.001,597,607,100,10,0.0001,1204,12
0.502,0.001,644,660,100,10,0.0001,1304,12
0.502,0.001,688,716,100,10,0.0001,1404,12
0.504,0.001,740,764,100,10,0.0001,1504,12
0.51,0.001,790,814,100,10,0.0001,1604,12
0.51,0.001,844,860,100,10,0.0001,1704,12
0.512,0.001,895,909,100,10,0.0001,1804,12
0.512,0.001,950,954,100,10,0.0001,1904,12
0.514,0.001,1004,1000,100,10,0.0001,2004,12
0.492,0.001,53,51,100,10,0.0001,104,13
0.492,0.001,101,103,100,10,0.0001,204,13
0.49,0.001,157,147,100,10,0.0001,304,13
0.49,0.001,211,193,100,10,0.0001,404,13
0.49,0.001,268,236,100,10,0.0001,504,13
0.488,0.001,319,285,100,10,0.0001,604,13
0.488,0.001,364,340,100,10,0.0001,704,13
0.49,0.001,408,396,100,10,0.0001,804,13
0.49,0.001,455,449,100,10,0.0001,904,13
0.49,0.001,497,507,100,10,0.0001,1004,13
0.49,0.001,539,565,100,10,0.0001,1104,13
0.49,0.001,589,615,100,10,0.0001,1204,13
0.49,0.001,635,669,100,10,0.0001,1304,13
0.492,0.001,690,714,100,10,0.0001,1404,13
0.492,0.001,746,758,100,10,0.0001,1504,13
0.494,0.001,797,807,100,10,0.0001,1604,13
0.492,0.001,849,855,100,10,0.0001,1704,13
0.49,0.001,901,903,100,10,0.0001,1804,13
0.49,0.001,955,949,100,10,0.0001,1904,13
0.49,0.001,1006,998,100,10,0.0001,2004,13
0.474,0.001,52,52,100,10,0.0001,104,14
0.474,0.001,105,99,100,10,0.0001,204,14
0.474,0.001,155,149,100,10,0.0001,304,14
0.478,0.001,206,198,100,10,0.0001,404,14
0.478,0.001,255,249,100,10,0.0001,504,14
0.478,0.001,302,302,100,10,0.0001,604,14
0.48,0.001,359,345,100,10,0.0001,704,14
0.48,0.001,402,402,100,10,0.0001,804,14
0.482,0.001,458,446,100,10,0.0001,904,14
0.486,0.001,511,493,100,10,0.0001,1004,14
0.484,0.001,557,547,100,10,0.0001,1104,14
0.48,0.001,614,590,100,10,0.0001,1204,14
0.484,0.001,656,648,100,10,0.0001,1304,14
0.484,0.001,702,702,100,10,0.0001,1404,14
0.488,0.001,754,750,100,10,0.0001,1504,14
0.488,0.001,813,791,100,10,0.0001,1604,14
0.49,0.001,870,834,100,10,0.0001,1704,14
0.49,0.001,919,885,100,10,0.0001,1804,14
0.488,0.001,969,935,100,10,0.0001,1904,14
0.49,0.001,1015,989,100,10,0.0001,2004,14
0.524,0.001,48,56,100,10,0.0001,104,15
0.526,0.001,110,94,100,10,0.0001,204,15
0.526,0.001,152,152,100,10,0.0001,304,15
0.526,0.001,207,197,100,10,0.0001,404,15
0.526,0.001,255,249,100,10,0.0001,504,15
0.53,0.001,301,303,100,10,0.0001,604,15
0.53,0.001,349,355,100,10,0.0001,704,15
0.53,0.001,403,401,100,10,0.0001,804,15
0.528,0.001,445,459,100,10,0.0001,904,15
0.526,0.001,501,503,100,10,0.0001,1004,15
0.532,0.001,546,558,100,10,0.0001,1104,15
0.534,0.001,589,615,100,10,0.0001,1204,15
0.53,0.001,637,667,100,10,0.0001,1304,15
0.534,0.001,695,709,100,10,0.0001,1404,15
0.532,0.001,744,760,100,10,0.0001,1504,15
0.53,0.001,790,814,100,10,0.0001,1604,15
0.532,0.001,842,862,100,10,0.0001,1704,15
0.53,0.001,896,908,100,10,0.0001,1804,15
0.532,0.001,946,958,100,10,0.0001,1904,15
0.534,0.001,989,1015,100,10,0.0001,2004,15
0.504,0.001,47,57,100,10,0.0001,104,16
0.498,0.001,103,101,100,10,0.0001,204,16
0.5,0.001,152,152,100,10,0.0001,304,16
0.5,0.001,193,211,100,10,0.0001,404,16
0.498,0.001,256,248,100,10,0.0001,504,16
0.498,0.001,309,295,100,10,0.0001,604,16
0.5,0.001,360,344,100,10,0.0001,704,16
0.504,0.001,412,392,100,10,0.0001,804,16
0.506,0.001,465,439,100,10,0.0001,904,16
0.504,0.001,512,492,100,10,0.0001,1004,16
0.504,0.001,565,539,100,10,0.0001,1104,16
0.506,0.001,611,593,100,10,0.0001,1204,16
0.508,0.001,667,637,100,10,0.0001,1304,16
0.508,0.001,712,692,100,10,0.0001,1404,16
0.506,0.001,766,738,100,10,0.0001,1504,16
0.504,0.001,804,800,100,10,0.0001,1604,16
0.502,0.001,858,846,100,10,0.0001,1704,16
0.5,0.001,904,900,100,10,0.0001,1804,16
0.506,0.001,950,954,100,10,0.0001,1904,16
0.502,0.001,999,1005,100,10,0.0001,2004,16
0.496,0.001,49,55,100,10,0.0001,104,17
0.496,0.001,101,103,100,10,0.0001,204,17
0.496,0.001,153,151,100,10,0.0001,304,17
0.498,0.001,208,196,100,10,0.0001,404,17
0.502,0.001,258,246,100,10,0.0001,504,17
0.502,0.001,309,295,100,10,0.0001,604,17
0.502,0.001,354,350,100,10,0.0001,704,17
0.502,0.001,398,406,100,10,0.0001,804,17
0.502,0.001,450,454,100,10,0.0001,904,17
0.502,0.001,495,509,100,10,0.0001,1004,17
0.502,0.001,545,559,100,10,0.0001,1104,17
0.502,0.001,595,609,100,10,0.0001,1204,17
0.504,0.001,638,666,100,10,0.0001,1304,17
0.506,0.001,688,716,100,10,0.0001,1404,17
0.504,0.001,741,763,100,10,0.0001,1504,17
0.506,0.001,792,812,100,10,0.0001,1604,17
0.512,0.001,849,855,100,10,0.0001,1704,17
0.512,0.001,899,905,100,10,0.0001,1804,17
0.514,0.001,952,952,100,10,0.0001,1904,17
0.51,0.001,1007,997,100,10,0.0001,2004,17
0.506,0.001,50,54,100,10,0.0001,104,18
0.506,0.001,96,108,100,10,0.0001,204,18
0.506,0.001,142,162,100,10,0.0001,304,18
0.506,0.001,189,215,100,10,0.0001,404,18
0.506,0.001,240,264,100,10,0.0001,504,18
0.506,0.001,292,312,100,10,0.0001,604,18
0.506,0.001,340,364,100,10,0.0001,704,18
0.506,0.001,398,406,100,10,0.0001,804,18
0.506,0.001,451,453,100,10,0.0001,904,18
0.506,0.001,497,507,100,10,0.0001,1004,18
0.506,0.001,542,562,100,10,0.0001,1104,18
0.506,0.001,592,612,100,10,0.0001,1204,18
0.506,0.001,643,661,100,10,0.0001,1304,18
0.506,0.001,698,706,100,10,0.0001,1404,18
0.508,0.001,752,752,100,10,0.0001,1504,18
0.508,0.001,802,802,100,10,0.0001,1604,18
0.508,0.001,859,845,100,10,0.0001,1704,18
0.508,0.001,905,899,100,10,0.0001,1804,18
0.508,0.001,953,951,100,10,0.0001,1904,18
0.508,0.001,997,1007,100,10,0.0001,2004,18
0.494,0.001,61,43,100,10,0.0001,104,19
0.494,0.001,116,88,100,10,0.0001,204,19
0.492,0.001,169,135,100,10,0.0001,304,19
0.492,0.001,224,180,100,10,0.0001,404,19
0.492,0.001,269,235,100,10,0.0001,504,19
0.49,0.001,317,287,100,10,0.0001,604,19
0.49,0.001,372,332,100,10,0.0001,704,19
0.492,0.001,415,389,100,10,0.0001,804,19
0.49,0.001,468,436,100,10,0.0001,904,19
0.49,0.001,518,486,100,10,0.0001,1004,19
0.49,0.001,570,534,100,10,0.0001,1104,19
0.488,0.001,624,580,100,10,0.0001,1204,19
0.49,0.001,677,627,100,10,0.0001,1304,19
0.494,0.001,724,680,100,10,0.0001,1404,19
0.494,0.001,773,731,100,10,0.0001,1504,19
0.494,0.001,814,790,100,10,0.0001,1604,19
0.496,0.001,863,841,100,10,0.0001,1704,19
0.496,0.001,912,892,100,10,0.0001,1804,19
0.496,0.001,956,948,100,10,0.0001,1904,19
0.496,0.001,1012,992,100,10,0.0001,2004,19
0.516,0.001,44,60,100,10,0.0001,104,20
0.516,0.001,93,111,100,10,0.0001,204,20
0.516,0.001,144,160,100,10,0.0001,304,20
0.518,0.001,194,210,100,10,0.0001,404,20
0.518,0.001,243,261,100,10,0.0001,504,20
0.518,0.001,289,315,100,10,0.0001,604,20
0.518,0.001,329,375,100,10,0.0001,704,20
0.516,0.001,388,416,100,10,0.0001,804,20
0.516,0.001,445,459,100,10,0.0001,904,20
0.518,0.001,500,504,100,10,0.0001,1004,20
0.518,0.001,554,550,100,10,0.0001,1104,20
0.518,0.001,606,598,100,10,0.0001,1204,20
0.518,0.001,659,645,100,10,0.0001,1304,20
0.518,0.001,699,705,100,10,0.0001,1404,20
0.518,0.001,748,756,100,10,0.0001,1504,20
0.522,0.001,789,815,100,10,0.0001,1604,20
0.522,0.001,847,857,100,10,0.0001,1704,20
0.524,0.001,903,901,100,10,0.0001,1804,20
0.52,0.001,951,953,100,10,0.0001,1904,20
0.522,0.001,1003,1001,100,10,0.0001,2004,20
0.502,0.001,56,48,100,10,0.001,104,1
0.504,0.001,107,97,100,10,0.001,204,1
0.496,0.001,151,153,100,10,0.001,304,1
0.492,0.001,197,207,100,10,0.001,404,1
0.496,0.001,247,257,100,10,0.001,504,1
0.496,0.001,296,308,100,10,0.001,604,1
0.498,0.001,338,366,100,10,0.001,704,1
0.498,0.001,390,414,100,10,0.001,804,1
0.498,0.001,442,462,100,10,0.001,904,1
0.5,0.001,497,507,100,10,0.001,1004,1
0.498,0.001,542,562,100,10,0.001,1104,1
0.518,0.001,596,608,100,10,0.001,1204,1
0.532,0.001,647,657,100,10,0.001,1304,1
0.54,0.001,700,704,100,10,0.001,1404,1
0.55,0.001,754,750,100,10,0.001,1504,1
0.556,0.001,801,803,100,10,0.001,1604,1
0.556,0.001,852,852,100,10,0.001,1704,1
0.58,0.001,902,902,100,10,0.001,1804,1
0.58,0.001,958,946,100,10,0.001,1904,1
0.588,0.001,1012,992,100,10,0.001,2004,1
0.496,0.001,48,56,100,10,0.001,104,2
0.494,0.001,99,105,100,10,0.001,204,2
0.494,0.001,148,156,100,10,0.001,304,2
0.5,0.001,202,202,100,10,0.001,404,2
0.502,0.001,256,248,100,10,0.001,504,2
0.496,0.001,307,297,100,10,0.001,604,2
0.498,0.001,361,343,100,10,0.001,704,2
0.498,0.001,411,393,100,10,0.001,804,2
0.5,0.001,465,439,100,10,0.001,904,2
0.508,0.001,515,489,100,10,0.001,1004,2
0.498,0.001,565,539,100,10,0.001,1104,2
0.498,0.001,613,591,100,10,0.001,1204,2
0.506,0.001,663,641,100,10,0.001,1304,2
0.512,0.001,719,685,100,10,0.001,1404,2
0.522,0.001,768,736,100,10,0.001,1504,2
0.536,0.001,811,793,100,10,0.001,1604,2
0.548,0.001,856,848,100,10,0.001,1704,2
0.57,0.001,909,895,100,10,0.001,1804,2
0.576,0.001,960,944,100,10,0.001,1904,2
0.592,0.001,1004,1000,100,10,0.001,2004,2
0.506,0.001,54,50,100,10,0.001,104,3
0.508,0.001,99,105,100,10,0.001,204,3
0.51,0.001,149,155,100,10,0.001,304,3
0.506,0.001,207,197,100,10,0.001,404,3
0.506,0.001,252,252,100,10,0.001,504,3
0.504,0.001,304,300,100,10,0.001,604,3
0.516,0.001,356,348,100,10,0.001,704,3
0.52,0.001,402,402,100,10,0.001,804,3
0.522,0.001,452,452,100,10,0.001,904,3
0.532,0.001,500,504,100,10,0.001,1004,3
0.546,0.001,547,557,100,10,0.001,1104,3
0.558,0.001,600,604,100,10,0.001,1204,3
0.558,0.001,653,651,100,10,0.001,1304,3
0.562,0.001,702,702,100,10,0.001,1404,3
0.572,0.001,753,751,100,10,0.001,1504,3
0.576,0.001,798,806,100,10,0.001,1604,3
0.592,0.001,844,860,100,10,0.001,1704,3
0.592,0.001,890,914,100,10,0.001,1804,3
0.596,0.001,945,959,100,10,0.001,1904,3
0.602,0.001,993,1011,100,10,0.001,2004,3
0.524,0.001,52,52,100,10,0.001,104,4
0.536,0.001,96,108,100,10,0.001,204,4
0.546,0.001,154,150,100,10,0.001,304,4
0.546,0.001,202,202,100,10,0.001,404,4
0.546,0.001,249,255,100,10,0.001,504,4
0.544,0.001,292,312,100,10,0.001,604,4
0.55,0.001,346,358,100,10,0.001,704,4
0.556,0.001,398,406,100,10,0.001,804,4
0.56,0.001,450,454,100,10,0.001,904,4
0.562,0.001,493,511,100,10,0.001,1004,4
0.568,0.001,540,564,100,10,0.001,1104,4
0.572,0.001,591,613,100,10,0.001,1204,4
0.58,0.001,640,664,100,10,0.001,1304,4
0.582,0.001,692,712,100,10,0.001,1404,4
0.578,0.001,744,760,100,10,0.001,1504,4
0.59,0.001,803,801,100,10,0.001,1604,4
0.592,0.001,864,840,100,10,0.001,1704,4
0.6,0.001,918,886,100,10,0.001,1804,4
0.61,0.001,959,945,100,10,0.001,1904,4
0.62,0.001,1003,1001,100,10,0.001,2004,4
0.49,0.001,58,46,100,10,0.001,104,5
0.492,0.001,102,102,100,10,0.001,204,5
0.494,0.001,152,152,100,10,0.001,304,5
0.494,0.001,193,211,100,10,0.001,404,5
0.49,0.001,239,265,100,10,0.001,504,5
0.492,0.001,284,320,100,10,0.001,604,5
0.494,0.001,332,372,100,10,0.001,704,5
0.496,0.001,388,416,100,10,0.001,804,5
0.5,0.001,444,460,100,10,0.001,904,5
0.502,0.001,497,507,100,10,0.001,1004,5
0.502,0.001,548,556,100,10,0.001,1104,5
0.512,0.001,599,605,100,10,0.001,1204,5
0.518,0.001,654,650,100,10,0.001,1304,5
0.53,0.001,699,705,100,10,0.001,1404,5
0.536,0.001,743,761,100,10,0.001,1504,5
0.544,0.001,791,813,100,10,0.001,1604,5
0.564,0.001,840,864,100,10,0.001,1704,5
0.588,0.001,890,914,100,10,0.001,1804,5
0.616,0.001,943,961,100,10,0.001,1904,5
0.638,0.001,990,1014,100,10,0.001,2004,5
0.488,0.001,52,52,100,10,0.001,104,6
0.488,0.001,108,96,100,10,0.001,204,6
0.494,0.001,158,146,100,10,0.001,304,6
0.486,0.001,207,197,100,10,0.001,404,6
0.492,0.001,249,255,100,10,0.001,504,6
0.494,0.001,291,313,100,10,0.001,604,6
0.492,0.001,340,364,100,10,0.001,704,6
0.49,0.001,384,420,100,10,0.001,804,6
0.484,0.001,438,466,100,10,0.001,904,6
0.49,0.001,492,512,100,10,0.001,1004,6
0.486,0.001,541,563,100,10,0.001,1104,6
0.5,0.001,594,610,100,10,0.001,1204,6
0.494,0.001,642,662,100,10,0.001,1304,6
0.5,0.001,686,718,100,10,0.001,1404,6
0.508,0.001,727,777,100,10,0.001,1504,6
0.524,0.001,774,830,100,10,0.001,1604,6
0.528,0.001,823,881,100,10,0.001,1704,6
0.544,0.001,874,930,100,10,0.001,1804,6
0.548,0.001,928,976,100,10,0.001,1904,6
0.558,0.001,987,1017,100,10,0.001,2004,6
0.576,0.001,40,64,100,10,0.001,104,7
0.574,0.001,93,111,100,10,0.001,204,7
0.576,0.001,146,158,100,10,0.001,304,7
0.574,0.001,192,212,100,10,0.001,404,7
0.58,0.001,236,268,100,10,0.001,504,7
0.582,0.001,292,312,100,10,0.001,604,7
0.578,0.001,345,359,100,10,0.001,704,7
0.578,0.001,392,412,100,10,0.001,804,7
0.574,0.001,435,469,100,10,0.001,904,7
0.582,0.001,478,526,100,10,0.001,1004,7
0.586,0.001,525,579,100,10,0.001,1104,7
0.59,0.001,579,625,100,10,0.001,1204,7
0.6,0.001,628,676,100,10,0.001,1304,7
0.608,0.001,678,726,100,10,0.001,1404,7
0.612,0.001,722,782,100,10,0.001,1504,7
0.618,0.001,775,829,100,10,0.001,1604,7
0.634,0.001,823,881,100,10,0.001,1704,7
0.64,0.001,879,925,100,10,0.001,1804,7
0.656,0.001,932,972,100,10,0.001,1904,7
0.672,0.001,991,1013,100,10,0.001,2004,7
0.504,0.001,48,56,100,10,0.001,104,8
0.506,0.001,100,104,100,10,0.001,204,8
0.506,0.001,150,154,100,10,0.001,304,8
0.508,0.001,204,200,100,10,0.001,404,8
0.508,0.001,252,252,100,10,0.001,504,8
0.516,0.001,305,299,100,10,0.001,604,8
0.524,0.001,356,348,100,10,0.001,704,8
0.532,0.001,408,396,100,10,0.001,804,8
0.538,0.001,457,447,100,10,0.001,904,8
0.544,0.001,500,504,100,10,0.001,1004,8
0.552,0.001,552,552,100,10,0.001,1104,8
0.548,0.001,600,604,100,10,0.001,1204,8
0.548,0.001,650,654,100,10,0.001,1304,8
0.55,0.001,699,705,100,10,0.001,1404,8
0.548,0.001,746,758,100,10,0.001,1504,8
0.544,0.001,800,804,100,10,0.001,1604,8
0.552,0.001,858,846,100,10,0.001,1704,8
0.562,0.001,899,905,100,10,0.001,1804,8
0.574,0.001,951,953,100,10,0.001,1904,8
0.592,0.001,998,1006,100,10,0.001,2004,8
0.48,0.001,52,52,100,10,0.001,104,9
0.484,0.001,98,106,100,10,0.001,204,9
0.488,0.001,140,164,100,10,0.001,304,9
0.49,0.001,188,216,100,10,0.001,404,9
0.49,0.001,238,266,100,10,0.001,504,9
0.496,0.001,282,322,100,10,0.001,604,9
0.496,0.001,337,367,100,10,0.001,704,9
0.498,0.001,387,417,100,10,0.001,804,9
0.502,0.001,438,466,100,10,0.001,904,9
0.504,0.001,486,518,100,10,0.001,1004,9
0.502,0.001,539,565,100,10,0.001,1104,9
0.5,0.001,598,606,100,10,0.001,1204,9
0.502,0.001,649,655,100,10,0.001,1304,9
0.506,0.001,694,710,100,10,0.001,1404,9
0.518,0.001,749,755,100,10,0.001,1504,9
0.534,0.001,797,807,100,10,0.001,1604,9
0.542,0.001,854,850,100,10,0.001,1704,9
0.558,0.001,905,899,100,10,0.001,1804,9
0.56,0.001,952,952,100,10,0.001,1904,9
0.584,0.001,1004,1000,100,10,0.001,2004,9
0.494,0.001,53,51,100,10,0.001,104,10
0.496,0.001,105,99,100,10,0.001,204,10
0.502,0.001,155,149,100,10,0.001,304,10
0.506,0.001,207,197,100,10,0.001,404,10
0.506,0.001,251,253,100,10,0.001,504,10
0.51,0.001,301,303,100,10,0.001,604,10
0.52,0.001,349,355,100,10,0.001,704,10
0.518,0.001,400,404,100,10,0.001,804,10
0.524,0.001,443,461,100,10,0.001,904,10
0.53,0.001,491,513,100,10,0.001,1004,10
0.534,0.001,544,560,100,10,0.001,1104,10
0.552,0.001,589,615,100,10,0.001,1204,10
0.558,0.001,631,673,100,10,0.001,1304,10
0.56,0.001,682,722,100,10,0.001,1404,10
0.56,0.001,729,775,100,10,0.001,1504,10
0.574,0.001,788,816,100,10,0.001,1604,10
0.59,0.001,845,859,100,10,0.001,1704,10
0.6,0.001,899,905,100,10,0.001,1804,10
0.606,0.001,950,954,100,10,0.001,1904,10
0.628,0.001,997,1007,100,10,0.001,2004,10
0.51,0.001,45,59,100,10,0.001,104,11
0.51,0.001,87,117,100,10,0.001,204,11
0.51,0.001,144,160,100,10,0.001,304,11
0.514,0.001,200,204,100,10,0.001,404,11
0.516,0.001,255,249,100,10,0.001,504,11
0.518,0.001,305,299,100,10,0.001,604,11
0.52,0.001,357,347,100,10,0.001,704,11
0.522,0.001,393,411,100,10,0.001,804,11
0.522,0.001,443,461,100,10,0.001,904,11
0.522,0.001,493,511,100,10,0.001,1004,11
0.526,0.001,543,561,100,10,0.001,1104,11
0.526,0.001,587,617,100,10,0.001,1204,11
0.53,0.001,639,665,100,10,0.001,1304,11
0.536,0.001,693,711,100,10,0.001,1404,11
0.544,0.001,745,759,100,10,0.001,1504,11
0.556,0.001,798,806,100,10,0.001,1604,11
0.558,0.001,846,858,100,10,0.001,1704,11
0.562,0.001,901,903,100,10,0.001,1804,11
0.572,0.001,957,947,100,10,0.001,1904,11
0.58,0.001,1006,998,100,10,0.001,2004,11
0.454,0.001,56,48,100,10,0.001,104,12
0.454,0.001,120,84,100,10,0.001,204,12
0.462,0.001,177,127,100,10,0.001,304,12
0.468,0.001,226,178,100,10,0.001,404,12
0.468,0.001,277,227,100,10,0.001,504,12
0.462,0.001,332,272,100,10,0.001,604,12
0.458,0.001,377,327,100,10,0.001,704,12
0.454,0.001,423,381,100,10,0.001,804,12
0.458,0.001,463,441,100,10,0.001,904,12
0.456,0.001,512,492,100,10,0.001,1004,12
0.468,0.001,559,545,100,10,0.001,1104,12
0.468,0.001,615,589,100,10,0.001,1204,12
0.466,0.001,663,641,100,10,0.001,1304,12
0.47,0.001,715,689,100,10,0.001,1404,12
0.488,0.001,763,741,100,10,0.001,1504,12
0.494,0.001,804,800,100,10,0.001,1604,12
0.508,0.001,850,854,100,10,0.001,1704,12
0.51,0.001,899,905,100,10,0.001,1804,12
0.528,0.001,943,961,100,10,0.001,1904,12
0.554,0.001,1001,1003,100,10,0.001,2004,12
0.488,0.001,48,56,100,10,0.001,104,13
0.488,0.001,101,103,100,10,0.001,204,13
0.49,0.001,152,152,100,10,0.001,304,13
0.488,0.001,200,204,100,10,0.001,404,13
0.486,0.001,255,249,100,10,0.001,504,13
0.486,0.001,303,301,100,10,0.001,604,13
0.488,0.001,356,348,100,10,0.001,704,13
0.486,0.001,396,408,100,10,0.001,804,13
0.488,0.001,450,454,100,10,0.001,904,13
0.476,0.001,505,499,100,10,0.001,1004,13
0.482,0.001,555,549,100,10,0.001,1104,13
0.482,0.001,598,606,100,10,0.001,1204,13
0.498,0.001,648,656,100,10,0.001,1304,13
0.51,0.001,703,701,100,10,0.001,1404,13
0.52,0.001,749,755,100,10,0.001,1504,13
0.528,0.001,787,817,100,10,0.001,1604,13
0.546,0.001,847,857,100,10,0.001,1704,13
0.552,0.001,903,901,100,10,0.001,1804,13
0.58,0.001,951,953,100,10,0.001,1904,13
0.58,0.001,1005,999,100,10,0.001,2004,13
0.536,0.001,53,51,100,10,0.001,104,14
0.542,0.001,101,103,100,10,0.001,204,14
0.544,0.001,149,155,100,10,0.001,304,14
0.55,0.001,202,202,100,10,0.001,404,14
0.548,0.001,253,251,100,10,0.001,504,14
0.542,0.001,299,305,100,10,0.001,604,14
0.54,0.001,345,359,100,10,0.001,704,14
0.544,0.001,399,405,100,10,0.001,804,14
0.55,0.001,447,457,100,10,0.001,904,14
0.552,0.001,501,503,100,10,0.001,1004,14
0.564,0.001,557,547,100,10,0.001,1104,14
0.574,0.001,601,603,100,10,0.001,1204,14
0.572,0.001,652,652,100,10,0.001,1304,14
0.582,0.001,695,709,100,10,0.001,1404,14
0.59,0.001,745,759,100,10,0.001,1504,14
0.586,0.001,793,811,100,10,0.001,1604,14
0.582,0.001,846,858,100,10,0.001,1704,14
0.6,0.001,888,916,100,10,0.001,1804,14
0.598,0.001,932,972,100,10,0.001,1904,14
0.618,0.001,984,1020,100,10,0.001,2004,14
0.494,0.001,55,49,100,10,0.001,104,15
0.494,0.001,104,100,100,10,0.001,204,15
0.498,0.001,146,158,100,10,0.001,304,15
0.498,0.001,197,207,100,10,0.001,404,15
0.498,0.001,245,259,100,10,0.001,504,15
0.498,0.001,297,307,100,10,0.001,604,15
0.504,0.001,348,356,100,10,0.001,704,15
0.51,0.001,397,407,100,10,0.001,804,15
0.51,0.001,441,463,100,10,0.001,904,15
0.514,0.001,491,513,100,10,0.001,1004,15
0.516,0.001,542,562,100,10,0.001,1104,15
0.518,0.001,590,614,100,10,0.001,1204,15
0.522,0.001,646,658,100,10,0.001,1304,15
0.534,0.001,689,715,100,10,0.001,1404,15
0.532,0.001,743,761,100,10,0.001,1504,15
0.552,0.001,791,813,100,10,0.001,1604,15
0.554,0.001,847,857,100,10,0.001,1704,15
0.566,0.001,897,907,100,10,0.001,1804,15
0.582,0.001,942,962,100,10,0.001,1904,15
0.604,0.001,994,1010,100,10,0.001,2004,15
0.508,0.001,48,56,100,10,0.001,104,16
0.508,0.001,104,100,100,10,0.001,204,16
0.508,0.001,146,158,100,10,0.001,304,16
0.508,0.001,201,203,100,10,0.001,404,16
0.51,0.001,248,256,100,10,0.001,504,16
0.512,0.001,295,309,100,10,0.001,604,16
0.512,0.001,344,360,100,10,0.001,704,16
0.512,0.001,382,422,100,10,0.001,804,16
0.512,0.001,434,470,100,10,0.001,904,16
0.512,0.001,486,518,100,10,0.001,1004,16
0.514,0.001,530,574,100,10,0.001,1104,16
0.514,0.001,583,621,100,10,0.001,1204,16
0.518,0.001,634,670,100,10,0.001,1304,16
0.526,0.001,686,718,100,10,0.001,1404,16
0.532,0.001,735,769,100,10,0.001,1504,16
0.546,0.001,787,817,100,10,0.001,1604,16
0.554,0.001,832,872,100,10,0.001,1704,16
0.554,0.001,885,919,100,10,0.001,1804,16
0.554,0.001,945,959,100,10,0.001,1904,16
0.556,0.001,1006,998,100,10,0.001,2004,16
0.532,0.001,47,57,100,10,0.001,104,17
0.544,0.001,97,107,100,10,0.001,204,17
0.546,0.001,151,153,100,10,0.001,304,17
0.548,0.001,193,211,100,10,0.001,404,17
0.546,0.001,250,254,100,10,0.001,504,17
0.55,0.001,304,300,100,10,0.001,604,17
0.554,0.001,345,359,100,10,0.001,704,17
0.562,0.001,396,408,100,10,0.001,804,17
0.566,0.001,453,451,100,10,0.001,904,17
0.572,0.001,493,511,100,10,0.001,1004,17
0.572,0.001,539,565,100,10,0.001,1104,17
0.57,0.001,587,617,100,10,0.001,1204,17
0.574,0.001,639,665,100,10,0.001,1304,17
0.576,0.001,678,726,100,10,0.001,1404,17
0.582,0.001,733,771,100,10,0.001,1504,17
0.596,0.001,788,816,100,10,0.001,1604,17
0.598,0.001,846,858,100,10,0.001,1704,17
0.594,0.001,895,909,100,10,0.001,1804,17
0.612,0.001,943,961,100,10,0.001,1904,17
0.628,0.001,989,1015,100,10,0.001,2004,17
0.512,0.001,50,54,100,10,0.001,104,18
0.518,0.001,83,121,100,10,0.001,204,18
0.512,0.001,131,173,100,10,0.001,304,18
0.506,0.001,179,225,100,10,0.001,404,18
0.506,0.001,226,278,100,10,0.001,504,18
0.516,0.001,277,327,100,10,0.001,604,18
0.516,0.001,337,367,100,10,0.001,704,18
0.532,0.001,389,415,100,10,0.001,804,18
0.536,0.001,438,466,100,10,0.001,904,18
0.538,0.001,490,514,100,10,0.001,1004,18
0.536,0.001,546,558,100,10,0.001,1104,18
0.55,0.001,591,613,100,10,0.001,1204,18
0.546,0.001,643,661,100,10,0.001,1304,18
0.556,0.001,694,710,100,10,0.001,1404,18
0.574,0.001,736,768,100,10,0.001,1504,18
0.576,0.001,789,815,100,10,0.001,1604,18
0.596,0.001,844,860,100,10,0.001,1704,18
0.602,0.001,896,908,100,10,0.001,1804,18
0.616,0.001,951,953,100,10,0.001,1904,18
0.638,0.001,1004,1000,100,10,0.001,2004,18
0.482,0.001,58,46,100,10,0.001,104,19
0.484,0.001,108,96,100,10,0.001,204,19
0.482,0.001,165,139,100,10,0.001,304,19
0.49,0.001,215,189,100,10,0.001,404,19
0.504,0.001,262,242,100,10,0.001,504,19
0.51,0.001,310,294,100,10,0.001,604,19
0.52,0.001,350,354,100,10,0.001,704,19
0.528,0.001,417,387,100,10,0.001,804,19
0.538,0.001,466,438,100,10,0.001,904,19
0.55,0.001,514,490,100,10,0.001,1004,19
0.552,0.001,562,542,100,10,0.001,1104,19
0.572,0.001,601,603,100,10,0.001,1204,19
0.58,0.001,647,657,100,10,0.001,1304,19
0.586,0.001,690,714,100,10,0.001,1404,19
0.59,0.001,739,765,100,10,0.001,1504,19
0.606,0.001,788,816,100,10,0.001,1604,19
0.618,0.001,841,863,100,10,0.001,1704,19
0.62,0.001,897,907,100,10,0.001,1804,19
0.636,0.001,951,953,100,10,0.001,1904,19
0.64,0.001,1002,1002,100,10,0.001,2004,19
0.524,0.001,57,47,100,10,0.001,104,20
0.524,0.001,109,95,100,10,0.001,204,20
0.52,0.001,153,151,100,10,0.001,304,20
0.524,0.001,201,203,100,10,0.001,404,20
0.528,0.001,249,255,100,10,0.001,504,20
0.532,0.001,301,303,100,10,0.001,604,20
0.534,0.001,346,358,100,10,0.001,704,20
0.534,0.001,399,405,100,10,0.001,804,20
0.546,0.001,436,468,100,10,0.001,904,20
0.54,0.001,484,520,100,10,0.001,1004,20
0.542,0.001,536,568,100,10,0.001,1104,20
0.556,0.001,585,619,100,10,0.001,1204,20
0.56,0.001,635,669,100,10,0.001,1304,20
0.564,0.001,687,717,100,10,0.001,1404,20
0.566,0.001,742,762,100,10,0.001,1504,20
0.572,0.001,794,810,100,10,0.001,1604,20
0.588,0.001,842,862,100,10,0.001,1704,20
0.598,0.001,890,914,100,10,0.001,1804,20
0.608,0.001,950,954,100,10,0.001,1904,20
0.628,0.001,1006,998,100,10,0.001,2004,20
0.528,0.001,60,44,100,10,0.01,104,1
0.534,0.001,108,96,100,10,0.01,204,1
0.534,0.001,152,152,100,10,0.01,304,1
0.556,0.001,201,203,100,10,0.01,404,1
0.562,0.001,240,264,100,10,0.01,504,1
0.598,0.001,286,318,100,10,0.01,604,1
0.612,0.001,336,368,100,10,0.01,704,1
0.656,0.001,374,430,100,10,0.01,804,1
0.668,0.001,419,485,100,10,0.01,904,1
0.706,0.001,478,526,100,10,0.01,1004,1
0.738,0.001,525,579,100,10,0.01,1104,1
0.794,0.001,578,626,100,10,0.01,1204,1
0.844,0.001,629,675,100,10,0.01,1304,1
0.88,0.001,670,734,100,10,0.01,1404,1
0.896,0.001,720,784,100,10,0.01,1504,1
0.914,0.001,769,835,100,10,0.01,1604,1
0.924,0.001,825,879,100,10,0.01,1704,1
0.944,0.001,878,926,100,10,0.01,1804,1
0.956,0.001,933,971,100,10,0.01,1904,1
0.956,0.001,987,1017,100,10,0.01,2004,1
0.482,0.001,48,56,100,10,0.01,104,2
0.5,0.001,96,108,100,10,0.01,204,2
0.506,0.001,147,157,100,10,0.01,304,2
0.514,0.001,201,203,100,10,0.01,404,2
0.534,0.001,252,252,100,10,0.01,504,2
0.55,0.001,307,297,100,10,0.01,604,2
0.56,0.001,361,343,100,10,0.01,704,2
0.59,0.001,409,395,100,10,0.01,804,2
0.604,0.001,453,451,100,10,0.01,904,2
0.644,0.001,492,512,100,10,0.01,1004,2
0.684,0.001,542,562,100,10,0.01,1104,2
0.732,0.001,591,613,100,10,0.01,1204,2
0.778,0.001,645,659,100,10,0.01,1304,2
0.828,0.001,700,704,100,10,0.01,1404,2
0.86,0.001,753,751,100,10,0.01,1504,2
0.91,0.001,804,800,100,10,0.01,1604,2
0.938,0.001,854,850,100,10,0.01,1704,2
0.946,0.001,911,893,100,10,0.01,1804,2
0.95,0.001,959,945,100,10,0.01,1904,2
0.966,0.001,1011,993,100,10,0.01,2004,2
0.51,0.001,48,56,100,10,0.01,104,3
0.522,0.001,90,114,100,10,0.01,204,3
0.528,0.001,146,158,100,10,0.01,304,3
0.528,0.001,196,208,100,10,0.01,404,3
0.53,0.001,253,251,100,10,0.01,504,3
0.562,0.001,295,309,100,10,0.01,604,3
0.574,0.001,336,368,100,10,0.01,704,3
0.612,0.001,385,419,100,10,0.01,804,3
0.632,0.001,441,463,100,10,0.01,904,3
0.676,0.001,489,515,100,10,0.01,1004,3
0.712,0.001,541,563,100,10,0.01,1104,3
0.748,0.001,602,602,100,10,0.01,1204,3
0.78,0.001,655,649,100,10,0.01,1304,3
0.812,0.001,709,695,100,10,0.01,1404,3
0.846,0.001,743,761,100,10,0.01,1504,3
0.882,0.001,791,813,100,10,0.01,1604,3
0.902,0.001,842,862,100,10,0.01,1704,3
0.928,0.001,885,919,100,10,0.01,1804,3
0.938,0.001,938,966,100,10,0.01,1904,3
0.942,0.001,992,1012,100,10,0.01,2004,3
0.514,0.001,58,46,100,10,0.01,104,4
0.524,0.001,108,96,100,10,0.01,204,4
0.504,0.001,156,148,100,10,0.01,304,4
0.524,0.001,206,198,100,10,0.01,404,4
0.556,0.001,250,254,100,10,0.01,504,4
0.576,0.001,295,309,100,10,0.01,604,4
0.598,0.001,352,352,100,10,0.01,704,4
0.622,0.001,398,406,100,10,0.01,804,4
0.67,0.001,452,452,100,10,0.01,904,4
0.726,0.001,508,496,100,10,0.01,1004,4
0.744,0.001,547,557,100,10,0.01,1104,4
0.79,0.001,600,604,100,10,0.01,1204,4
0.824,0.001,647,657,100,10,0.01,1304,4
0.872,0.001,698,706,100,10,0.01,1404,4
0.892,0.001,749,755,100,10,0.01,1504,4
0.92,0.001,796,808,100,10,0.01,1604,4
0.93,0.001,848,856,100,10,0.01,1704,4
0.944,0.001,903,901,100,10,0.01,1804,4
0.944,0.001,949,955,100,10,0.01,1904,4
0.95,0.001,996,1008,100,10,0.01,2004,4
0.496,0.001,57,47,100,10,0.01,104,5
0.51,0.001,108,96,100,10,0.01,204,5
0.544,0.001,156,148,100,10,0.01,304,5
0.576,0.001,206,198,100,10,0.01,404,5
0.596,0.001,252,252,100,10,0.01,504,5
0.582,0.001,300,304,100,10,0.01,604,5
0.606,0.001,348,356,100,10,0.01,704,5
0.62,0.001,402,402,100,10,0.01,804,5
0.652,0.001,454,450,100,10,0.01,904,5
0.684,0.001,491,513,100,10,0.01,1004,5
0.702,0.001,538,566,100,10,0.01,1104,5
0.744,0.001,597,607,100,10,0.01,1204,5
0.788,0.001,649,655,100,10,0.01,1304,5
0.838,0.001,700,704,100,10,0.01,1404,5
0.862,0.001,757,747,100,10,0.01,1504,5
0.898,0.001,813,791,100,10,0.01,1604,5
0.918,0.001,857,847,100,10,0.01,1704,5
0.93,0.001,908,896,100,10,0.01,1804,5
0.936,0.001,957,947,100,10,0.01,1904,5
0.938,0.001,1001,1003,100,10,0.01,2004,5
0.476,0.001,52,52,100,10,0.01,104,6
0.468,0.001,100,104,100,10,0.01,204,6
0.494,0.001,148,156,100,10,0.01,304,6
0.494,0.001,198,206,100,10,0.01,404,6
0.492,0.001,246,258,100,10,0.01,504,6
0.514,0.001,301,303,100,10,0.01,604,6
0.534,0.001,342,362,100,10,0.01,704,6
0.58,0.001,390,414,100,10,0.01,804,6
0.61,0.001,439,465,100,10,0.01,904,6
0.654,0.001,493,511,100,10,0.01,1004,6
0.716,0.001,543,561,100,10,0.01,1104,6
0.744,0.001,594,610,100,10,0.01,1204,6
0.796,0.001,639,665,100,10,0.01,1304,6
0.852,0.001,693,711,100,10,0.01,1404,6
0.904,0.001,743,761,100,10,0.01,1504,6
0.914,0.001,802,802,100,10,0.01,1604,6
0.922,0.001,855,849,100,10,0.01,1704,6
0.93,0.001,908,896,100,10,0.01,1804,6
0.946,0.001,956,948,100,10,0.01,1904,6
0.95,0.001,1011,993,100,10,0.01,2004,6
0.496,0.001,56,48,100,10,0.01,104,7
0.524,0.001,103,101,100,10,0.01,204,7
0.556,0.001,167,137,100,10,0.01,304,7
0.584,0.001,219,185,100,10,0.01,404,7
0.58,0.001,275,229,100,10,0.01,504,7
0.598,0.001,326,278,100,10,0.01,604,7
0.612,0.001,374,330,100,10,0.01,704,7
0.64,0.001,423,381,100,10,0.01,804,7
0.674,0.001,477,427,100,10,0.01,904,7
0.71,0.001,526,478,100,10,0.01,1004,7
0.752,0.001,574,530,100,10,0.01,1104,7
0.784,0.001,624,580,100,10,0.01,1204,7
0.818,0.001,673,631,100,10,0.01,1304,7
0.846,0.001,726,678,100,10,0.01,1404,7
0.872,0.001,769,735,100,10,0.01,1504,7
0.904,0.001,817,787,100,10,0.01,1604,7
0.92,0.001,869,835,100,10,0.01,1704,7
0.93,0.001,917,887,100,10,0.01,1804,7
0.942,0.001,964,940,100,10,0.01,1904,7
0.952,0.001,1010,994,100,10,0.01,2004,7
0.504,0.001,44,60,100,10,0.01,104,8
0.508,0.001,98,106,100,10,0.01,204,8
0.52,0.001,146,158,100,10,0.01,304,8
0.536,0.001,197,207,100,10,0.01,404,8
0.566,0.001,239,265,100,10,0.01,504,8
0.618,0.001,299,305,100,10,0.01,604,8
0.638,0.001,346,358,100,10,0.01,704,8
0.638,0.001,397,407,100,10,0.01,804,8
0.62,0.001,449,455,100,10,0.01,904,8
0.642,0.001,495,509,100,10,0.01,1004,8
0.664,0.001,542,562,100,10,0.01,1104,8
0.714,0.001,593,611,100,10,0.01,1204,8
0.742,0.001,633,671,100,10,0.01,1304,8
0.774,0.001,692,712,100,10,0.01,1404,8
0.798,0.001,748,756,100,10,0.01,1504,8
0.834,0.001,797,807,100,10,0.01,1604,8
0.862,0.001,851,853,100,10,0.01,1704,8
0.872,0.001,897,907,100,10,0.01,1804,8
0.894,0.001,950,954,100,10,0.01,1904,8
0.918,0.001,999,1005,100,10,0.01,2004,8
0.47,0.001,51,53,100,10,0.01,104,9
0.474,0.001,96,108,100,10,0.01,204,9
0.5,0.001,151,153,100,10,0.01,304,9
0.538,0.001,199,205,100,10,0.01,404,9
0.55,0.001,252,252,100,10,0.01,504,9
0.568,0.001,299,305,100,10,0.01,604,9
0.588,0.001,349,355,100,10,0.01,704,9
0.64,0.001,403,401,100,10,0.01,804,9
0.646,0.001,456,448,100,10,0.01,904,9
0.652,0.001,503,501,100,10,0.01,1004,9
0.66,0.001,557,547,100,10,0.01,1104,9
0.72,0.001,608,596,100,10,0.01,1204,9
0.77,0.001,658,646,100,10,0.01,1304,9
0.804,0.001,714,690,100,10,0.01,1404,9
0.822,0.001,757,747,100,10,0.01,1504,9
0.856,0.001,804,800,100,10,0.01,1604,9
0.882,0.001,851,853,100,10,0.01,1704,9
0.896,0.001,903,901,100,10,0.01,1804,9
0.916,0.001,948,956,100,10,0.01,1904,9
0.924,0.001,1009,995,100,10,0.01,2004,9
0.502,0.001,59,45,100,10,0.01,104,10
0.528,0.001,110,94,100,10,0.01,204,10
0.546,0.001,171,133,100,10,0.01,304,10
0.586,0.001,220,184,100,10,0.01,404,10
0.582,0.001,277,227,100,10,0.01,504,10
0.602,0.001,327,277,100,10,0.01,604,10
0.606,0.001,378,326,100,10,0.01,704,10
0.65,0.001,428,376,100,10,0.01,804,10
0.694,0.001,479,425,100,10,0.01,904,10
0.728,0.001,530,474,100,10,0.01,1004,10
0.754,0.001,566,538,100,10,0.01,1104,10
0.79,0.001,604,600,100,10,0.01,1204,10
0.812,0.001,651,653,100,10,0.01,1304,10
0.87,0.001,701,703,100,10,0.01,1404,10
0.886,0.001,750,754,100,10,0.01,1504,10
0.908,0.001,809,795,100,10,0.01,1604,10
0.93,0.001,862,842,100,10,0.01,1704,10
0.952,0.001,914,890,100,10,0.01,1804,10
0.94,0.001,961,943,100,10,0.01,1904,10
0.948,0.001,1005,999,100,10,0.01,2004,10
0.548,0.001,56,48,100,10,0.01,104,11
0.558,0.001,108,96,100,10,0.01,204,11
0.562,0.001,154,150,100,10,0.01,304,11
0.574,0.001,197,207,100,10,0.01,404,11
0.578,0.001,239,265,100,10,0.01,504,11
0.572,0.001,283,321,100,10,0.01,604,11
0.584,0.001,330,374,100,10,0.01,704,11
0.63,0.001,387,417,100,10,0.01,804,11
0.644,0.001,431,473,100,10,0.01,904,11
0.7,0.001,478,526,100,10,0.01,1004,11
0.736,0.001,528,576,100,10,0.01,1104,11
0.758,0.001,588,616,100,10,0.01,1204,11
0.794,0.001,635,669,100,10,0.01,1304,11
0.836,0.001,691,713,100,10,0.01,1404,11
0.868,0.001,735,769,100,10,0.01,1504,11
0.914,0.001,788,816,100,10,0.01,1604,11
0.928,0.001,833,871,100,10,0.01,1704,11
0.934,0.001,880,924,100,10,0.01,1804,11
0.946,0.001,930,974,100,10,0.01,1904,11
0.946,0.001,982,1022,100,10,0.01,2004,11
0.502,0.001,51,53,100,10,0.01,104,12
0.524,0.001,107,97,100,10,0.01,204,12
0.528,0.001,163,141,100,10,0.01,304,12
0.556,0.001,214,190,100,10,0.01,404,12
0.55,0.001,262,242,100,10,0.01,504,12
0.56,0.001,313,291,100,10,0.01,604,12
0.574,0.001,364,340,100,10,0.01,704,12
0.586,0.001,408,396,100,10,0.01,804,12
0.608,0.001,459,445,100,10,0.01,904,12
0.64,0.001,510,494,100,10,0.01,1004,12
0.664,0.001,546,558,100,10,0.01,1104,12
0.724,0.001,589,615,100,10,0.01,1204,12
0.752,0.001,643,661,100,10,0.01,1304,12
0.786,0.001,693,711,100,10,0.01,1404,12
0.83,0.001,743,761,100,10,0.01,1504,12
0.846,0.001,793,811,100,10,0.01,1604,12
0.85,0.001,843,861,100,10,0.01,1704,12
0.874,0.001,889,915,100,10,0.01,1804,12
0.886,0.001,940,964,100,10,0.01,1904,12
0.896,0.001,992,1012,100,10,0.01,2004,12
0.494,0.001,56,48,100,10,0.01,104,13
0.502,0.001,109,95,100,10,0.01,204,13
0.506,0.001,160,144,100,10,0.01,304,13
0.508,0.001,202,202,100,10,0.01,404,13
0.522,0.001,247,257,100,10,0.01,504,13
0.544,0.001,296,308,100,10,0.01,604,13
0.59,0.001,348,356,100,10,0.01,704,13
0.61,0.001,397,407,100,10,0.01,804,13
0.62,0.001,445,459,100,10,0.01,904,13
0.658,0.001,494,510,100,10,0.01,1004,13
0.684,0.001,534,570,100,10,0.01,1104,13
0.724,0.001,585,619,100,10,0.01,1204,13
0.748,0.001,641,663,100,10,0.01,1304,13
0.77,0.001,700,704,100,10,0.01,1404,13
0.784,0.001,745,759,100,10,0.01,1504,13
0.852,0.001,798,806,100,10,0.01,1604,13
0.876,0.001,851,853,100,10,0.01,1704,13
0.888,0.001,908,896,100,10,0.01,1804,13
0.914,0.001,958,946,100,10,0.01,1904,13
0.93,0.001,1000,1004,100,10,0.01,2004,13
0.512,0.001,56,48,100,10,0.01,104,14
0.512,0.001,105,99,100,10,0.01,204,14
0.51,0.001,161,143,100,10,0.01,304,14
0.532,0.001,220,184,100,10,0.01,404,14
0.548,0.001,269,235,100,10,0.01,504,14
0.598,0.001,327,277,100,10,0.01,604,14
0.632,0.001,373,331,100,10,0.01,704,14
0.662,0.001,420,384,100,10,0.01,804,14
0.694,0.001,471,433,100,10,0.01,904,14
0.714,0.001,524,480,100,10,0.01,1004,14
0.762,0.001,573,531,100,10,0.01,1104,14
0.788,0.001,626,578,100,10,0.01,1204,14
0.808,0.001,674,630,100,10,0.01,1304,14
0.848,0.001,718,686,100,10,0.01,1404,14
0.874,0.001,765,739,100,10,0.01,1504,14
0.904,0.001,801,803,100,10,0.01,1604,14
0.922,0.001,848,856,100,10,0.01,1704,14
0.932,0.001,901,903,100,10,0.01,1804,14
0.932,0.001,950,954,100,10,0.01,1904,14
0.944,0.001,1002,1002,100,10,0.01,2004,14
0.508,0.001,52,52,100,10,0.01,104,15
0.51,0.001,106,98,100,10,0.01,204,15
0.522,0.001,155,149,100,10,0.01,304,15
0.542,0.001,200,204,100,10,0.01,404,15
0.548,0.001,247,257,100,10,0.01,504,15
0.58,0.001,294,310,100,10,0.01,604,15
0.594,0.001,346,358,100,10,0.01,704,15
0.616,0.001,399,405,100,10,0.01,804,15
0.626,0.001,454,450,100,10,0.01,904,15
0.644,0.001,502,502,100,10,0.01,1004,15
0.644,0.001,557,547,100,10,0.01,1104,15
0.68,0.001,601,603,100,10,0.01,1204,15
0.73,0.001,657,647,100,10,0.01,1304,15
0.782,0.001,715,689,100,10,0.01,1404,15
0.808,0.001,778,726,100,10,0.01,1504,15
0.83,0.001,835,769,100,10,0.01,1604,15
0.854,0.001,873,831,100,10,0.01,1704,15
0.88,0.001,927,877,100,10,0.01,1804,15
0.898,0.001,978,926,100,10,0.01,1904,15
0.93,0.001,1024,980,100,10,0.01,2004,15
0.532,0.001,50,54,100,10,0.01,104,16
0.552,0.001,106,98,100,10,0.01,204,16
0.572,0.001,155,149,100,10,0.01,304,16
0.58,0.001,208,196,100,10,0.01,404,16
0.586,0.001,257,247,100,10,0.01,504,16
0.582,0.001,297,307,100,10,0.01,604,16
0.6,0.001,353,351,100,10,0.01,704,16
0.612,0.001,402,402,100,10,0.01,804,16
0.626,0.001,447,457,100,10,0.01,904,16
0.65,0.001,504,500,100,10,0.01,1004,16
0.692,0.001,555,549,100,10,0.01,1104,16
0.712,0.001,607,597,100,10,0.01,1204,16
0.754,0.001,658,646,100,10,0.01,1304,16
0.814,0.001,707,697,100,10,0.01,1404,16
0.848,0.001,756,748,100,10,0.01,1504,16
0.876,0.001,797,807,100,10,0.01,1604,16
0.906,0.001,843,861,100,10,0.01,1704,16
0.918,0.001,897,907,100,10,0.01,1804,16
0.918,0.001,953,951,100,10,0.01,1904,16
0.93,0.001,1003,1001,100,10,0.01,2004,16
0.486,0.001,52,52,100,10,0.01,104,17
0.504,0.001,103,101,100,10,0.01,204,17
0.516,0.001,153,151,100,10,0.01,304,17
0.514,0.001,204,200,100,10,0.01,404,17
0.526,0.001,254,250,100,10,0.01,504,17
0.556,0.001,296,308,100,10,0.01,604,17
0.584,0.001,353,351,100,10,0.01,704,17
0.604,0.001,401,403,100,10,0.01,804,17
0.62,0.001,456,448,100,10,0.01,904,17
0.664,0.001,502,502,100,10,0.01,1004,17
0.67,0.001,545,559,100,10,0.01,1104,17
0.708,0.001,595,609,100,10,0.01,1204,17
0.736,0.001,643,661,100,10,0.01,1304,17
0.784,0.001,685,719,100,10,0.01,1404,17
0.818,0.001,739,765,100,10,0.01,1504,17
0.85,0.001,793,811,100,10,0.01,1604,17
0.864,0.001,843,861,100,10,0.01,1704,17
0.89,0.001,895,909,100,10,0.01,1804,17
0.91,0.001,943,961,100,10,0.01,1904,17
0.93,0.001,996,1008,100,10,0.01,2004,17
0.534,0.001,53,51,100,10,0.01,104,18
0.532,0.001,108,96,100,10,0.01,204,18
0.538,0.001,162,142,100,10,0.01,304,18
0.546,0.001,212,192,100,10,0.01,404,18
0.56,0.001,256,248,100,10,0.01,504,18
0.58,0.001,314,290,100,10,0.01,604,18
0.612,0.001,363,341,100,10,0.01,704,18
0.634,0.001,412,392,100,10,0.01,804,18
0.674,0.001,460,444,100,10,0.01,904,18
0.702,0.001,506,498,100,10,0.01,1004,18
0.742,0.001,560,544,100,10,0.01,1104,18
0.786,0.001,615,589,100,10,0.01,1204,18
0.828,0.001,662,642,100,10,0.01,1304,18
0.892,0.001,711,693,100,10,0.01,1404,18
0.918,0.001,761,743,100,10,0.01,1504,18
0.928,0.001,803,801,100,10,0.01,1604,18
0.948,0.001,848,856,100,10,0.01,1704,18
0.954,0.001,896,908,100,10,0.01,1804,18
0.96,0.001,941,963,100,10,0.01,1904,18
0.96,0.001,985,1019,100,10,0.01,2004,18
0.518,0.001,45,59,100,10,0.01,104,19
0.572,0.001,86,118,100,10,0.01,204,19
0.592,0.001,132,172,100,10,0.01,304,19
0.64,0.001,176,228,100,10,0.01,404,19
0.652,0.001,221,283,100,10,0.01,504,19
0.688,0.001,270,334,100,10,0.01,604,19
0.734,0.001,323,381,100,10,0.01,704,19
0.786,0.001,383,421,100,10,0.01,804,19
0.818,0.001,422,482,100,10,0.01,904,19
0.858,0.001,469,535,100,10,0.01,1004,19
0.882,0.001,524,580,100,10,0.01,1104,19
0.932,0.001,584,620,100,10,0.01,1204,19
0.954,0.001,633,671,100,10,0.01,1304,19
0.96,0.001,679,725,100,10,0.01,1404,19
0.968,0.001,731,773,100,10,0.01,1504,19
0.972,0.001,793,811,100,10,0.01,1604,19
0.978,0.001,843,861,100,10,0.01,1704,19
0.98,0.001,891,913,100,10,0.01,1804,19
0.984,0.001,943,961,100,10,0.01,1904,19
0.986,0.001,1001,1003,100,10,0.01,2004,19
0.47,0.001,62,42,100,10,0.01,104,20
0.504,0.001,108,96,100,10,0.01,204,20
0.504,0.001,163,141,100,10,0.01,304,20
0.522,0.001,215,189,100,10,0.01,404,20
0.53,0.001,264,240,100,10,0.01,504,20
0.558,0.001,317,287,100,10,0.01,604,20
0.582,0.001,361,343,100,10,0.01,704,20
0.622,0.001,405,399,100,10,0.01,804,20
0.642,0.001,460,444,100,10,0.01,904,20
0.658,0.001,509,495,100,10,0.01,1004,20
0.692,0.001,562,542,100,10,0.01,1104,20
0.756,0.001,617,587,100,10,0.01,1204,20
0.806,0.001,672,632,100,10,0.01,1304,20
0.85,0.001,732,672,100,10,0.01,1404,20
0.878,0.001,783,721,100,10,0.01,1504,20
0.92,0.001,833,771,100,10,0.01,1604,20
0.918,0.001,882,822,100,10,0.01,1704,20
0.936,0.001,931,873,100,10,0.01,1804,20
0.954,0.001,975,929,100,10,0.01,1904,20
0.958,0.001,1026,978,100,10,0.01,2004,20
0.48,1e-05,55,49,100,25,0.0001,104,1
0.48,1e-05,104,100,100,25,0.0001,204,1
0.48,1e-05,155,149,100,25,0.0001,304,1
0.48,1e-05,207,197,100,25,0.0001,404,1
0.48,1e-05,261,243,100,25,0.0001,504,1
0.48,1e-05,318,286,100,25,0.0001,604,1
0.482,1e-05,365,339,100,25,0.0001,704,1
0.482,1e-05,411,393,100,25,0.0001,804,1
0.482,1e-05,460,444,100,25,0.0001,904,1
0.482,1e-05,502,502,100,25,0.0001,1004,1
0.482,1e-05,550,554,100,25,0.0001,1104,1
0.482,1e-05,598,606,100,25,0.0001,1204,1
0.482,1e-05,648,656,100,25,0.0001,1304,1
0.48,1e-05,698,706,100,25,0.0001,1404,1
0.48,1e-05,750,754,100,25,0.0001,1504,1
0.482,1e-05,805,799,100,25,0.0001,1604,1
0.482,1e-05,853,851,100,25,0.0001,1704,1
0.48,1e-05,906,898,100,25,0.0001,1804,1
0.48,1e-05,957,947,100,25,0.0001,1904,1
0.48,1e-05,1010,994,100,25,0.0001,2004,1
0.524,1e-05,52,52,100,25,0.0001,104,2
0.524,1e-05,107,97,100,25,0.0001,204,2
0.524,1e-05,163,141,100,25,0.0001,304,2
0.524,1e-05,217,187,100,25,0.0001,404,2
0.524,1e-05,270,234,100,25,0.0001,504,2
0.524,1e-05,317,287,100,25,0.0001,604,2
0.524,1e-05,363,341,100,25,0.0001,704,2
0.526,1e-05,422,382,100,25,0.0001,804,2
0.526,1e-05,461,443,100,25,0.0001,904,2
0.528,1e-05,501,503,100,25,0.0001,1004,2
0.524,1e-05,551,553,100,25,0.0001,1104,2
0.524,1e-05,609,595,100,25,0.0001,1204,2
0.524,1e-05,659,645,100,25,0.0001,1304,2
0.522,1e-05,716,688,100,25,0.0001,1404,2
0.522,1e-05,765,739,100,25,0.0001,1504,2
0.522,1e-05,810,794,100,25,0.0001,1604,2
0.522,1e-05,853,851,100,25,0.0001,1704,2
0.518,1e-05,901,903,100,25,0.0001,1804,2
0.518,1e-05,940,964,100,25,0.0001,1904,2
0.528,1e-05,992,1012,100,25,0.0001,2004,2
0.49,1e-05,50,54,100,25,0.0001,104,3
0.49,1e-05,97,107,100,25,0.0001,204,3
0.49,1e-05,148,156,100,25,0.0001,304,3
0.49,1e-05,196,208,100,25,0.0001,404,3
0.49,1e-05,244,260,100,25,0.0001,504,3
0.492,1e-05,290,314,100,25,0.0001,604,3
0.49,1e-05,342,362,100,25,0.0001,704,3
0.492,1e-05,383,421,100,25,0.0001,804,3
0.49,1e-05,436,468,100,25,0.0001,904,3
0.492,1e-05,486,518,100,25,0.0001,1004,3
0.494,1e-05,540,564,100,25,0.0001,1104,3
0.496,1e-05,586,618,100,25,0.0001,1204,3
0.494,1e-05,630,674,100,25,0.0001,1304,3
0.496,1e-05,682,722,100,25,0.0001,1404,3
0.498,1e-05,727,777,100,25,0.0001,1504,3
0.5,1e-05,777,827,100,25,0.0001,1604,3
0.502,1e-05,831,873,100,25,0.0001,1704,3
0.508,1e-05,891,913,100,25,0.0001,1804,3
0.508,1e-05,939,965,100,25,0.0001,1904,3
0.51,1e-05,995,1009,100,25,0.0001,2004,3
0.53,1e-05,45,59,100,25,0.0001,104,4
0.53,1e-05,100,104,100,25,0.0001,204,4
0.528,1e-05,151,153,100,25,0.0001,304,4
0.528,1e-05,202,202,100,25,0.0001,404,4
0.528,1e-05,264,240,100,25,0.0001,504,4
0.528,1e-05,308,296,100,25,0.0001,604,4
0.528,1e-05,349,355,100,25,0.0001,704,4
0.526,1e-05,402,402,100,25,0.0001,804,4
0.526,1e-05,453,451,100,25,0.0001,904,4
0.53,1e-05,505,499,100,25,0.0001,1004,4
0.536,1e-05,553,551,100,25,0.0001,1104,4
0.538,1e-05,602,602,100,25,0.0001,1204,4
0.54,1e-05,658,646,100,25,0.0001,1304,4
0.54,1e-05,703,701,100,25,0.0001,1404,4
0.542,1e-05,746,758,100,25,0.0001,1504,4
0.544,1e-05,800,804,100,25,0.0001,1604,4
0.546,1e-05,853,851,100,25,0.0001,1704,4
0.554,1e-05,894,910,100,25,0.0001,1804,4
0.554,1e-05,942,962,100,25,0.0001,1904,4
0.554,1e-05,992,1012,100,25,0.0001,2004,4
0.502,1e-05,52,52,100,25,0.0001,104,5
0.5,1e-05,98,106,100,25,0.0001,204,5
0.5,1e-05,151,153,100,25,0.0001,304,5
0.5,1e-05,199,205,100,25,0.0001,404,5
0.5,1e-05,249,255,100,25,0.0001,504,5
0.5,1e-05,301,303,100,25,0.0001,604,5
0.502,1e-05,354,350,100,25,0.0001,704,5
0.502,1e-05,399,405,100,25,0.0001,804,5
0.498,1e-05,447,457,100,25,0.0001,904,5
0.5,1e-05,498,506,100,25,0.0001,1004,5
0.502,1e-05,550,554,100,25,0.0001,1104,5
0.504,1e-05,595,609,100,25,0.0001,1204,5
0.504,1e-05,645,659,100,25,0.0001,1304,5
0.502,1e-05,705,699,100,25,0.0001,1404,5
0.504,1e-05,757,747,100,25,0.0001,1504,5
0.504,1e-05,809,795,100,25,0.0001,1604,5
0.504,1e-05,855,849,100,25,0.0001,1704,5
0.512,1e-05,907,897,100,25,0.0001,1804,5
0.512,1e-05,963,941,100,25,0.0001,1904,5
0.518,1e-05,1013,991,100,25,0.0001,2004,5
0.482,1e-05,49,55,100,25,0.0001,104,6
0.48,1e-05,97,107,100,25,0.0001,204,6
0.478,1e-05,153,151,100,25,0.0001,304,6
0.478,1e-05,210,194,100,25,0.0001,404,6
0.476,1e-05,259,245,100,25,0.0001,504,6
0.476,1e-05,314,290,100,25,0.0001,604,6
0.476,1e-05,361,343,100,25,0.0001,704,6
0.476,1e-05,404,400,100,25,0.0001,804,6
0.478,1e-05,450,454,100,25,0.0001,904,6
0.48,1e-05,495,509,100,25,0.0001,1004,6
0.48,1e-05,540,564,100,25,0.0001,1104,6
0.482,1e-05,590,614,100,25,0.0001,1204,6
0.488,1e-05,642,662,100,25,0.0001,1304,6
0.488,1e-05,693,711,100,25,0.0001,1404,6
0.488,1e-05,738,766,100,25,0.0001,1504,6
0.488,1e-05,787,817,100,25,0.0001,1604,6
0.49,1e-05,846,858,100,25,0.0001,1704,6
0.492,1e-05,901,903,100,25,0.0001,1804,6
0.494,1e-05,952,952,100,25,0.0001,1904,6
0.494,1e-05,999,1005,100,25,0.0001,2004,6
0.492,1e-05,51,53,100,25,0.0001,104,7
0.492,1e-05,103,101,100,25,0.0001,204,7
0.492,1e-05,153,151,100,25,0.0001,304,7
0.492,1e-05,201,203,100,25,0.0001,404,7
0.492,1e-05,247,257,100,25,0.0001,504,7
0.492,1e-05,293,311,100,25,0.0001,604,7
0.488,1e-05,339,365,100,25,0.0001,704,7
0.488,1e-05,398,406,100,25,0.0001,804,7
0.488,1e-05,452,452,100,25,0.0001,904,7
0.488,1e-05,501,503,100,25,0.0001,1004,7
0.488,1e-05,547,557,100,25,0.0001,1104,7
0.488,1e-05,601,603,100,25,0.0001,1204,7
0.488,1e-05,650,654,100,25,0.0001,1304,7
0.49,1e-05,708,696,100,25,0.0001,1404,7
0.49,1e-05,754,750,100,25,0.0001,1504,7
0.486,1e-05,803,801,100,25,0.0001,1604,7
0.49,1e-05,848,856,100,25,0.0001,1704,7
0.49,1e-05,894,910,100,25,0.0001,1804,7
0.494,1e-05,950,954,100,25,0.0001,1904,7
0.494,1e-05,995,1009,100,25,0.0001,2004,7
0.538,1e-05,59,45,100,25,0.0001,104,8
0.538,1e-05,110,94,100,25,0.0001,204,8
0.538,1e-05,158,146,100,25,0.0001,304,8
0.538,1e-05,206,198,100,25,0.0001,404,8
0.536,1e-05,257,247,100,25,0.0001,504,8
0.536,1e-05,299,305,100,25,0.0001,604,8
0.534,1e-05,352,352,100,25,0.0001,704,8
0.534,1e-05,403,401,100,25,0.0001,804,8
0.534,1e-05,455,449,100,25,0.0001,904,8
0.534,1e-05,506,498,100,25,0.0001,1004,8
0.532,1e-05,548,556,100,25,0.0001,1104,8
0.534,1e-05,592,612,100,25,0.0001,1204,8
0.532,1e-05,640,664,100,25,0.0001,1304,8
0.53,1e-05,683,721,100,25,0.0001,1404,8
0.528,1e-05,730,774,100,25,0.0001,1504,8
0.528,1e-05,791,813,100,25,0.0001,1604,8
0.526,1e-05,838,866,100,25,0.0001,1704,8
0.526,1e-05,885,919,100,25,0.0001,1804,8
0.526,1e-05,939,965,100,25,0.0001,1904,8
0.526,1e-05,982,1022,100,25,0.0001,2004,8
0.448,1e-05,44,60,100,25,0.0001,104,9
0.448,1e-05,91,113,100,25,0.0001,204,9
0.448,1e-05,139,165,100,25,0.0001,304,9
0.448,1e-05,195,209,100,25,0.0001,404,9
0.448,1e-05,252,252,100,25,0.0001,504,9
0.45,1e-05,300,304,100,25,0.0001,604,9
0.45,1e-05,351,353,100,25,0.0001,704,9
0.448,1e-05,402,402,100,25,0.0001,804,9
0.446,1e-05,460,444,100,25,0.0001,904,9
0.444,1e-05,500,504,100,25,0.0001,1004,9
0.444,1e-05,550,554,100,25,0.0001,1104,9
0.444,1e-05,602,602,100,25,0.0001,1204,9
0.448,1e-05,658,646,100,25,0.0001,1304,9
0.448,1e-05,707,697,100,25,0.0001,1404,9
0.448,1e-05,754,750,100,25,0.0001,1504,9
0.45,1e-05,800,804,100,25,0.0001,1604,9
0.45,1e-05,858,846,100,25,0.0001,1704,9
0.452,1e-05,907,897,100,25,0.0001,1804,9
0.456,1e-05,951,953,100,25,0.0001,1904,9
0.454,1e-05,994,1010,100,25,0.0001,2004,9
0.514,1e-05,59,45,100,25,0.0001,104,10
0.512,1e-05,111,93,100,25,0.0001,204,10
0.512,1e-05,159,145,100,25,0.0001,304,10
0.51,1e-05,211,193,100,25,0.0001,404,10
0.512,1e-05,262,242,100,25,0.0001,504,10
0.512,1e-05,320,284,100,25,0.0001,604,10
0.512,1e-05,374,330,100,25,0.0001,704,10
0.514,1e-05,423,381,100,25,0.0001,804,10
0.514,1e-05,472,432,100,25,0.0001,904,10
0.516,1e-05,518,486,100,25,0.0001,1004,10
0.518,1e-05,567,537,100,25,0.0001,1104,10
0.52,1e-05,612,592,100,25,0.0001,1204,10
0.526,1e-05,658,646,100,25,0.0001,1304,10
0.528,1e-05,704,700,100,25,0.0001,1404,10
0.522,1e-05,748,756,100,25,0.0001,1504,10
0.522,1e-05,793,811,100,25,0.0001,1604,10
0.522,1e-05,847,857,100,25,0.0001,1704,10
0.524,1e-05,897,907,100,25,0.0001,1804,10
0.532,1e-05,947,957,100,25,0.0001,1904,10
0.534,1e-05,998,1006,100,25,0.0001,2004,10
0.552,1e-05,49,55,100,25,0.0001,104,11
0.552,1e-05,88,116,100,25,0.0001,204,11
0.552,1e-05,142,162,100,25,0.0001,304,11
0.552,1e-05,180,224,100,25,0.0001,404,11
0.55,1e-05,225,279,100,25,0.0001,504,11
0.554,1e-05,285,319,100,25,0.0001,604,11
0.556,1e-05,335,369,100,25,0.0001,704,11
0.55,1e-05,395,409,100,25,0.0001,804,11
0.552,1e-05,442,462,100,25,0.0001,904,11
0.55,1e-05,486,518,100,25,0.0001,1004,11
0.556,1e-05,535,569,100,25,0.0001,1104,11
0.556,1e-05,587,617,100,25,0.0001,1204,11
0.556,1e-05,644,660,100,25,0.0001,1304,11
0.556,1e-05,701,703,100,25,0.0001,1404,11
0.556,1e-05,750,754,100,25,0.0001,1504,11
0.56,1e-05,802,802,100,25,0.0001,1604,11
0.558,1e-05,855,849,100,25,0.0001,1704,11
0.56,1e-05,896,908,100,25,0.0001,1804,11
0.562,1e-05,940,964,100,25,0.0001,1904,11
0.564,1e-05,986,1018,100,25,0.0001,2004,11
0.504,1e-05,51,53,100,25,0.0001,104,12
0.504,1e-05,112,92,100,25,0.0001,204,12
0.504,1e-05,160,144,100,25,0.0001,304,12
0.504,1e-05,210,194,100,25,0.0001,404,12
0.504,1e-05,263,241,100,25,0.0001,504,12
0.504,1e-05,316,288,100,25,0.0001,604,12
0.502,1e-05,369,335,100,25,0.0001,704,12
0.502,1e-05,420,384,100,25,0.0001,804,12
0.502,1e-05,467,437,100,25,0.0001,904,12
0.502,1e-05,506,498,100,25,0.0001,1004,12
0.502,1e-05,561,543,100,25,0.0001,1104,12
0.5,1e-05,605,599,100,25,0.0001,1204,12
0.5,1e-05,653,651,100,25,0.0001,1304,12
0.5,1e-05,711,693,100,25,0.0001,1404,12
0.5,1e-05,762,742,100,25,0.0001,1504,12
0.5,1e-05,805,799,100,25,0.0001,1604,12
0.5,1e-05,851,853,100,25,0.0001,1704,12
0.498,1e-05,906,898,100,25,0.0001,1804,12
0.5,1e-05,950,954,100,25,0.0001,1904,12
0.496,1e-05,1005,999,100,25,0.0001,2004,12
0.512,1e-05,55,49,100,25,0.0001,104,13
0.51,1e-05,104,100,100,25,0.0001,204,13
0.514,1e-05,156,148,100,25,0.0001,304,13
0.514,1e-05,207,197,100,25,0.0001,404,13
0.512,1e-05,254,250,100,25,0.0001,504,13
0.512,1e-05,311,293,100,25,0.0001,604,13
0.512,1e-05,358,346,100,25,0.0001,704,13
0.512,1e-05,404,400,100,25,0.0001,804,13
0.512,1e-05,463,441,100,25,0.0001,904,13
0.512,1e-05,515,489,100,25,0.0001,1004,13
0.52,1e-05,569,535,100,25,0.0001,1104,13
0.52,1e-05,612,592,100,25,0.0001,1204,13
0.52,1e-05,663,641,100,25,0.0001,1304,13
0.526,1e-05,704,700,100,25,0.0001,1404,13
0.526,1e-05,748,756,100,25,0.0001,1504,13
0.526,1e-05,794,810,100,25,0.0001,1604,13
0.53,1e-05,842,862,100,25,0.0001,1704,13
0.532,1e-05,888,916,100,25,0.0001,1804,13
0.532,1e-05,950,954,100,25,0.0001,1904,13
0.536,1e-05,1003,1001,100,25,0.0001,2004,13
0.52,1e-05,51,53,100,25,0.0001,104,14
0.52,1e-05,101,103,100,25,0.0001,204,14
0.522,1e-05,148,156,100,25,0.0001,304,14
0.524,1e-05,204,200,100,25,0.0001,404,14
0.524,1e-05,256,248,100,25,0.0001,504,14
0.52,1e-05,311,293,100,25,0.0001,604,14
0.522,1e-05,364,340,100,25,0.0001,704,14
0.522,1e-05,406,398,100,25,0.0001,804,14
0.524,1e-05,457,447,100,25,0.0001,904,14
0.526,1e-05,510,494,100,25,0.0001,1004,14
0.526,1e-05,561,543,100,25,0.0001,1104,14
0.526,1e-05,616,588,100,25,0.0001,1204,14
0.524,1e-05,678,626,100,25,0.0001,1304,14
0.526,1e-05,728,676,100,25,0.0001,1404,14
0.53,1e-05,779,725,100,25,0.0001,1504,14
0.532,1e-05,823,781,100,25,0.0001,1604,14
0.528,1e-05,872,832,100,25,0.0001,1704,14
0.528,1e-05,918,886,100,25,0.0001,1804,14
0.532,1e-05,963,941,100,25,0.0001,1904,14
0.534,1e-05,1014,990,100,25,0.0001,2004,14
0.46,1e-05,54,50,100,25,0.0001,104,15
0.46,1e-05,103,101,100,25,0.0001,204,15
0.46,1e-05,153,151,100,25,0.0001,304,15
0.46,1e-05,200,204,100,25,0.0001,404,15
0.46,1e-05,248,256,100,25,0.0001,504,15
0.462,1e-05,302,302,100,25,0.0001,604,15
0.464,1e-05,352,352,100,25,0.0001,704,15
0.466,1e-05,405,399,100,25,0.0001,804,15
0.468,1e-05,458,446,100,25,0.0001,904,15
0.472,1e-05,507,497,100,25,0.0001,1004,15
0.472,1e-05,550,554,100,25,0.0001,1104,15
0.47,1e-05,596,608,100,25,0.0001,1204,15
0.468,1e-05,647,657,100,25,0.0001,1304,15
0.47,1e-05,703,701,100,25,0.0001,1404,15
0.468,1e-05,750,754,100,25,0.0001,1504,15
0.47,1e-05,803,801,100,25,0.0001,1604,15
0.47,1e-05,861,843,100,25,0.0001,1704,15
0.474,1e-05,914,890,100,25,0.0001,1804,15
0.48,1e-05,951,953,100,25,0.0001,1904,15
0.482,1e-05,1010,994,100,25,0.0001,2004,15
0.504,1e-05,61,43,100,25,0.0001,104,16
0.504,1e-05,109,95,100,25,0.0001,204,16
0.504,1e-05,153,151,100,25,0.0001,304,16
0.504,1e-05,211,193,100,25,0.0001,404,16
0.5,1e-05,263,241,100,25,0.0001,504,16
0.5,1e-05,315,289,100,25,0.0001,604,16
0.5,1e-05,366,338,100,25,0.0001,704,16
0.5,1e-05,420,384,100,25,0.0001,804,16
0.5,1e-05,468,436,100,25,0.0001,904,16
0.5,1e-05,516,488,100,25,0.0001,1004,16
0.5,1e-05,573,531,100,25,0.0001,1104,16
0.504,1e-05,622,582,100,25,0.0001,1204,16
0.504,1e-05,672,632,100,25,0.0001,1304,16
0.506,1e-05,724,680,100,25,0.0001,1404,16
0.508,1e-05,785,719,100,25,0.0001,1504,16
0.508,1e-05,840,764,100,25,0.0001,1604,16
0.508,1e-05,892,812,100,25,0.0001,1704,16
0.508,1e-05,942,862,100,25,0.0001,1804,16
0.512,1e-05,988,916,100,25,0.0001,1904,16
0.512,1e-05,1032,972,100,25,0.0001,2004,16
0.53,1e-05,45,59,100,25,0.0001,104,17
0.53,1e-05,95,109,100,25,0.0001,204,17
0.53,1e-05,143,161,100,25,0.0001,304,17
0.53,1e-05,187,217,100,25,0.0001,404,17
0.53,1e-05,240,264,100,25,0.0001,504,17
0.53,1e-05,297,307,100,25,0.0001,604,17
0.528,1e-05,342,362,100,25,0.0001,704,17
0.528,1e-05,394,410,100,25,0.0001,804,17
0.528,1e-05,442,462,100,25,0.0001,904,17
0.526,1e-05,494,510,100,25,0.0001,1004,17
0.524,1e-05,545,559,100,25,0.0001,1104,17
0.524,1e-05,595,609,100,25,0.0001,1204,17
0.524,1e-05,650,654,100,25,0.0001,1304,17
0.526,1e-05,699,705,100,25,0.0001,1404,17
0.528,1e-05,757,747,100,25,0.0001,1504,17
0.528,1e-05,808,796,100,25,0.0001,1604,17
0.528,1e-05,856,848,100,25,0.0001,1704,17
0.528,1e-05,908,896,100,25,0.0001,1804,17
0.532,1e-05,964,940,100,25,0.0001,1904,17
0.53,1e-05,1015,989,100,25,0.0001,2004,17
0.52,1e-05,50,54,100,25,0.0001,104,18
0.52,1e-05,98,106,100,25,0.0001,204,18
0.518,1e-05,138,166,100,25,0.0001,304,18
0.52,1e-05,193,211,100,25,0.0001,404,18
0.52,1e-05,244,260,100,25,0.0001,504,18
0.52,1e-05,297,307,100,25,0.0001,604,18
0.524,1e-05,343,361,100,25,0.0001,704,18
0.52,1e-05,393,411,100,25,0.0001,804,18
0.518,1e-05,441,463,100,25,0.0001,904,18
0.52,1e-05,483,521,100,25,0.0001,1004,18
0.52,1e-05,538,566,100,25,0.0001,1104,18
0.52,1e-05,585,619,100,25,0.0001,1204,18
0.518,1e-05,633,671,100,25,0.0001,1304,18
0.518,1e-05,682,722,100,25,0.0001,1404,18
0.522,1e-05,727,777,100,25,0.0001,1504,18
0.528,1e-05,783,821,100,25,0.0001,1604,18
0.528,1e-05,837,867,100,25,0.0001,1704,18
0.526,1e-05,893,911,100,25,0.0001,1804,18
0.534,1e-05,941,963,100,25,0.0001,1904,18
0.532,1e-05,995,1009,100,25,0.0001,2004,18
0.506,1e-05,45,59,100,25,0.0001,104,19
0.508,1e-05,91,113,100,25,0.0001,204,19
0.508,1e-05,139,165,100,25,0.0001,304,19
0.506,1e-05,192,212,100,25,0.0001,404,19
0.508,1e-05,243,261,100,25,0.0001,504,19
0.51,1e-05,299,305,100,25,0.0001,604,19
0.514,1e-05,349,355,100,25,0.0001,704,19
0.514,1e-05,402,402,100,25,0.0001,804,19
0.514,1e-05,451,453,100,25,0.0001,904,19
0.512,1e-05,498,506,100,25,0.0001,1004,19
0.514,1e-05,544,560,100,25,0.0001,1104,19
0.518,1e-05,599,605,100,25,0.0001,1204,19
0.518,1e-05,646,658,100,25,0.0001,1304,19
0.518,1e-05,694,710,100,25,0.0001,1404,19
0.518,1e-05,746,758,100,25,0.0001,1504,19
0.522,1e-05,799,805,100,25,0.0001,1604,19
0.524,1e-05,843,861,100,25,0.0001,1704,19
0.526,1e-05,892,912,100,25,0.0001,1804,19
0.53,1e-05,943,961,100,25,0.0001,1904,19
0.532,1e-05,999,1005,100,25,0.0001,2004,19
0.526,1e-05,55,49,100,25,0.0001,104,20
0.524,1e-05,96,108,100,25,0.0001,204,20
0.524,1e-05,141,163,100,25,0.0001,304,20
0.526,1e-05,190,214,100,25,0.0001,404,20
0.528,1e-05,235,269,100,25,0.0001,504,20
0.528,1e-05,282,322,100,25,0.0001,604,20
0.53,1e-05,330,374,100,25,0.0001,704,20
0.53,1e-05,374,430,100,25,0.0001,804,20
0.534,1e-05,421,483,100,25,0.0001,904,20
0.534,1e-05,470,534,100,25,0.0001,1004,20
0.536,1e-05,520,584,100,25,0.0001,1104,20
0.536,1e-05,570,634,100,25,0.0001,1204,20
0.536,1e-05,624,680,100,25,0.0001,1304,20
0.54,1e-05,670,734,100,25,0.0001,1404,20
0.538,1e-05,719,785,100,25,0.0001,1504,20
0.538,1e-05,773,831,100,25,0.0001,1604,20
0.54,1e-05,825,879,100,25,0.0001,1704,20
0.538,1e-05,886,918,100,25,0.0001,1804,20
0.536,1e-05,939,965,100,25,0.0001,1904,20
0.538,1e-05,987,1017,100,25,0.0001,2004,20
0.512,1e-05,41,63,100,25,0.001,104,1
0.516,1e-05,97,107,100,25,0.001,204,1
0.52,1e-05,146,158,100,25,0.001,304,1
0.514,1e-05,197,207,100,25,0.001,404,1
0.516,1e-05,244,260,100,25,0.001,504,1
0.526,1e-05,298,306,100,25,0.001,604,1
0.536,1e-05,346,358,100,25,0.001,704,1
0.524,1e-05,400,404,100,25,0.001,804,1
0.518,1e-05,448,456,100,25,0.001,904,1
0.522,1e-05,492,512,100,25,0.001,1004,1
0.524,1e-05,548,556,100,25,0.001,1104,1
0.542,1e-05,593,611,100,25,0.001,1204,1
0.54,1e-05,638,666,100,25,0.001,1304,1
0.554,1e-05,695,709,100,25,0.001,1404,1
0.56,1e-05,747,757,100,25,0.001,1504,1
0.572,1e-05,797,807,100,25,0.001,1604,1
0.594,1e-05,846,858,100,25,0.001,1704,1
0.61,1e-05,899,905,100,25,0.001,1804,1
0.622,1e-05,950,954,100,25,0.001,1904,1
0.634,1e-05,998,1006,100,25,0.001,2004,1
0.454,1e-05,65,39,100,25,0.001,104,2
0.45,1e-05,119,85,100,25,0.001,204,2
0.448,1e-05,174,130,100,25,0.001,304,2
0.466,1e-05,226,178,100,25,0.001,404,2
0.47,1e-05,270,234,100,25,0.001,504,2
0.48,1e-05,327,277,100,25,0.001,604,2
0.484,1e-05,371,333,100,25,0.001,704,2
0.486,1e-05,416,388,100,25,0.001,804,2
0.498,1e-05,472,432,100,25,0.001,904,2
0.514,1e-05,522,482,100,25,0.001,1004,2
0.526,1e-05,577,527,100,25,0.001,1104,2
0.54,1e-05,623,581,100,25,0.001,1204,2
0.564,1e-05,666,638,100,25,0.001,1304,2
0.58,1e-05,720,684,100,25,0.001,1404,2
0.596,1e-05,781,723,100,25,0.001,1504,2
0.598,1e-05,833,771,100,25,0.001,1604,2
0.614,1e-05,873,831,100,25,0.001,1704,2
0.628,1e-05,928,876,100,25,0.001,1804,2
0.646,1e-05,984,920,100,25,0.001,1904,2
0.684,1e-05,1025,979,100,25,0.001,2004,2
0.46,1e-05,47,57,100,25,0.001,104,3
0.464,1e-05,92,112,100,25,0.001,204,3
0.46,1e-05,140,164,100,25,0.001,304,3
0.476,1e-05,191,213,100,25,0.001,404,3
0.48,1e-05,248,256,100,25,0.001,504,3
0.486,1e-05,300,304,100,25,0.001,604,3
0.478,1e-05,349,355,100,25,0.001,704,3
0.48,1e-05,408,396,100,25,0.001,804,3
0.496,1e-05,464,440,100,25,0.001,904,3
0.504,1e-05,506,498,100,25,0.001,1004,3
0.514,1e-05,558,546,100,25,0.001,1104,3
0.522,1e-05,605,599,100,25,0.001,1204,3
0.55,1e-05,653,651,100,25,0.001,1304,3
0.564,1e-05,705,699,100,25,0.001,1404,3
0.578,1e-05,748,756,100,25,0.001,1504,3
0.596,1e-05,799,805,100,25,0.001,1604,3
0.604,1e-05,851,853,100,25,0.001,1704,3
0.62,1e-05,903,901,100,25,0.001,1804,3
0.63,1e-05,954,950,100,25,0.001,1904,3
0.636,1e-05,1006,998,100,25,0.001,2004,3
0.508,1e-05,62,42,100,25,0.001,104,4
0.51,1e-05,116,88,100,25,0.001,204,4
0.51,1e-05,163,141,100,25,0.001,304,4
0.512,1e-05,215,189,100,25,0.001,404,4
0.516,1e-05,260,244,100,25,0.001,504,4
0.512,1e-05,304,300,100,25,0.001,604,4
0.516,1e-05,360,344,100,25,0.001,704,4
0.524,1e-05,416,388,100,25,0.001,804,4
0.534,1e-05,467,437,100,25,0.001,904,4
0.542,1e-05,519,485,100,25,0.001,1004,4
0.556,1e-05,571,533,100,25,0.001,1104,4
0.57,1e-05,618,586,100,25,0.001,1204,4
0.582,1e-05,669,635,100,25,0.001,1304,4
0.598,1e-05,721,683,100,25,0.001,1404,4
0.62,1e-05,775,729,100,25,0.001,1504,4
0.632,1e-05,822,782,100,25,0.001,1604,4
0.656,1e-05,874,830,100,25,0.001,1704,4
0.678,1e-05,920,884,100,25,0.001,1804,4
0.7,1e-05,970,934,100,25,0.001,1904,4
0.71,1e-05,1001,1003,100,25,0.001,2004,4
0.492,1e-05,55,49,100,25,0.001,104,5
0.486,1e-05,107,97,100,25,0.001,204,5
0.496,1e-05,145,159,100,25,0.001,304,5
0.506,1e-05,194,210,100,25,0.001,404,5
0.516,1e-05,243,261,100,25,0.001,504,5
0.542,1e-05,289,315,100,25,0.001,604,5
0.54,1e-05,337,367,100,25,0.001,704,5
0.552,1e-05,385,419,100,25,0.001,804,5
0.55,1e-05,431,473,100,25,0.001,904,5
0.548,1e-05,490,514,100,25,0.001,1004,5
0.566,1e-05,537,567,100,25,0.001,1104,5
0.574,1e-05,584,620,100,25,0.001,1204,5
0.588,1e-05,635,669,100,25,0.001,1304,5
0.6,1e-05,683,721,100,25,0.001,1404,5
0.622,1e-05,742,762,100,25,0.001,1504,5
0.622,1e-05,792,812,100,25,0.001,1604,5
0.648,1e-05,838,866,100,25,0.001,1704,5
0.672,1e-05,890,914,100,25,0.001,1804,5
0.684,1e-05,938,966,100,25,0.001,1904,5
0.698,1e-05,998,1006,100,25,0.001,2004,5
0.532,1e-05,49,55,100,25,0.001,104,6
0.54,1e-05,103,101,100,25,0.001,204,6
0.544,1e-05,149,155,100,25,0.001,304,6
0.548,1e-05,201,203,100,25,0.001,404,6
0.548,1e-05,254,250,100,25,0.001,504,6
0.554,1e-05,297,307,100,25,0.001,604,6
0.558,1e-05,348,356,100,25,0.001,704,6
0.556,1e-05,397,407,100,25,0.001,804,6
0.562,1e-05,443,461,100,25,0.001,904,6
0.588,1e-05,499,505,100,25,0.001,1004,6
0.588,1e-05,547,557,100,25,0.001,1104,6
0.59,1e-05,589,615,100,25,0.001,1204,6
0.594,1e-05,642,662,100,25,0.001,1304,6
0.598,1e-05,696,708,100,25,0.001,1404,6
0.61,1e-05,746,758,100,25,0.001,1504,6
0.628,1e-05,800,804,100,25,0.001,1604,6
0.636,1e-05,852,852,100,25,0.001,1704,6
0.674,1e-05,902,902,100,25,0.001,1804,6
0.676,1e-05,953,951,100,25,0.001,1904,6
0.7,1e-05,1004,1000,100,25,0.001,2004,6
0.514,1e-05,45,59,100,25,0.001,104,7
0.51,1e-05,96,108,100,25,0.001,204,7
0.508,1e-05,136,168,100,25,0.001,304,7
0.514,1e-05,185,219,100,25,0.001,404,7
0.524,1e-05,240,264,100,25,0.001,504,7
0.528,1e-05,282,322,100,25,0.001,604,7
0.528,1e-05,330,374,100,25,0.001,704,7
0.524,1e-05,388,416,100,25,0.001,804,7
0.524,1e-05,428,476,100,25,0.001,904,7
0.518,1e-05,483,521,100,25,0.001,1004,7
0.518,1e-05,541,563,100,25,0.001,1104,7
0.524,1e-05,595,609,100,25,0.001,1204,7
0.54,1e-05,654,650,100,25,0.001,1304,7
0.558,1e-05,696,708,100,25,0.001,1404,7
0.578,1e-05,750,754,100,25,0.001,1504,7
0.586,1e-05,805,799,100,25,0.001,1604,7
0.588,1e-05,847,857,100,25,0.001,1704,7
0.61,1e-05,904,900,100,25,0.001,1804,7
0.63,1e-05,955,949,100,25,0.001,1904,7
0.644,1e-05,1003,1001,100,25,0.001,2004,7
0.502,1e-05,49,55,100,25,0.001,104,8
0.5,1e-05,98,106,100,25,0.001,204,8
0.492,1e-05,147,157,100,25,0.001,304,8
0.48,1e-05,188,216,100,25,0.001,404,8
0.474,1e-05,241,263,100,25,0.001,504,8
0.482,1e-05,295,309,100,25,0.001,604,8
0.48,1e-05,350,354,100,25,0.001,704,8
0.482,1e-05,397,407,100,25,0.001,804,8
0.486,1e-05,440,464,100,25,0.001,904,8
0.498,1e-05,501,503,100,25,0.001,1004,8
0.502,1e-05,552,552,100,25,0.001,1104,8
0.52,1e-05,605,599,100,25,0.001,1204,8
0.53,1e-05,654,650,100,25,0.001,1304,8
0.544,1e-05,703,701,100,25,0.001,1404,8
0.538,1e-05,759,745,100,25,0.001,1504,8
0.558,1e-05,811,793,100,25,0.001,1604,8
0.572,1e-05,859,845,100,25,0.001,1704,8
0.586,1e-05,905,899,100,25,0.001,1804,8
0.604,1e-05,949,955,100,25,0.001,1904,8
0.626,1e-05,994,1010,100,25,0.001,2004,8
0.504,1e-05,58,46,100,25,0.001,104,9
0.504,1e-05,107,97,100,25,0.001,204,9
0.506,1e-05,155,149,100,25,0.001,304,9
0.504,1e-05,200,204,100,25,0.001,404,9
0.51,1e-05,260,244,100,25,0.001,504,9
0.508,1e-05,305,299,100,25,0.001,604,9
0.514,1e-05,355,349,100,25,0.001,704,9
0.524,1e-05,403,401,100,25,0.001,804,9
0.518,1e-05,451,453,100,25,0.001,904,9
0.518,1e-05,497,507,100,25,0.001,1004,9
0.516,1e-05,542,562,100,25,0.001,1104,9
0.538,1e-05,594,610,100,25,0.001,1204,9
0.558,1e-05,646,658,100,25,0.001,1304,9
0.588,1e-05,705,699,100,25,0.001,1404,9
0.616,1e-05,758,746,100,25,0.001,1504,9
0.63,1e-05,809,795,100,25,0.001,1604,9
0.644,1e-05,851,853,100,25,0.001,1704,9
0.66,1e-05,905,899,100,25,0.001,1804,9
0.682,1e-05,947,957,100,25,0.001,1904,9
0.7,1e-05,995,1009,100,25,0.001,2004,9
0.5,1e-05,56,48,100,25,0.001,104,10
0.494,1e-05,112,92,100,25,0.001,204,10
0.496,1e-05,158,146,100,25,0.001,304,10
0.512,1e-05,212,192,100,25,0.001,404,10
0.512,1e-05,264,240,100,25,0.001,504,10
0.512,1e-05,309,295,100,25,0.001,604,10
0.524,1e-05,354,350,100,25,0.001,704,10
0.532,1e-05,410,394,100,25,0.001,804,10
0.536,1e-05,461,443,100,25,0.001,904,10
0.552,1e-05,517,487,100,25,0.001,1004,10
0.568,1e-05,567,537,100,25,0.001,1104,10
0.568,1e-05,622,582,100,25,0.001,1204,10
0.58,1e-05,668,636,100,25,0.001,1304,10
0.596,1e-05,724,680,100,25,0.001,1404,10
0.604,1e-05,774,730,100,25,0.001,1504,10
0.616,1e-05,821,783,100,25,0.001,1604,10
0.638,1e-05,866,838,100,25,0.001,1704,10
0.634,1e-05,917,887,100,25,0.001,1804,10
0.652,1e-05,964,940,100,25,0.001,1904,10
0.668,1e-05,1006,998,100,25,0.001,2004,10
0.446,1e-05,56,48,100,25,0.001,104,11
0.454,1e-05,109,95,100,25,0.001,204,11
0.456,1e-05,156,148,100,25,0.001,304,11
0.466,1e-05,204,200,100,25,0.001,404,11
0.474,1e-05,254,250,100,25,0.001,504,11
0.492,1e-05,319,285,100,25,0.001,604,11
0.502,1e-05,366,338,100,25,0.001,704,11
0.51,1e-05,410,394,100,25,0.001,804,11
0.518,1e-05,460,444,100,25,0.001,904,11
0.522,1e-05,510,494,100,25,0.001,1004,11
0.532,1e-05,559,545,100,25,0.001,1104,11
0.544,1e-05,608,596,100,25,0.001,1204,11
0.556,1e-05,659,645,100,25,0.001,1304,11
0.564,1e-05,708,696,100,25,0.001,1404,11
0.578,1e-05,757,747,100,25,0.001,1504,11
0.592,1e-05,798,806,100,25,0.001,1604,11
0.608,1e-05,856,848,100,25,0.001,1704,11
0.63,1e-05,917,887,100,25,0.001,1804,11
0.656,1e-05,961,943,100,25,0.001,1904,11
0.686,1e-05,1013,991,100,25,0.001,2004,11
0.488,1e-05,55,49,100,25,0.001,104,12
0.49,1e-05,103,101,100,25,0.001,204,12
0.49,1e-05,149,155,100,25,0.001,304,12
0.498,1e-05,215,189,100,25,0.001,404,12
0.508,1e-05,269,235,100,25,0.001,504,12
0.518,1e-05,318,286,100,25,0.001,604,12
0.514,1e-05,359,345,100,25,0.001,704,12
0.512,1e-05,418,386,100,25,0.001,804,12
0.512,1e-05,462,442,100,25,0.001,904,12
0.516,1e-05,512,492,100,25,0.001,1004,12
0.518,1e-05,556,548,100,25,0.001,1104,12
0.52,1e-05,602,602,100,25,0.001,1204,12
0.536,1e-05,652,652,100,25,0.001,1304,12
0.55,1e-05,702,702,100,25,0.001,1404,12
0.566,1e-05,760,744,100,25,0.001,1504,12
0.576,1e-05,809,795,100,25,0.001,1604,12
0.6,1e-05,857,847,100,25,0.001,1704,12
0.626,1e-05,909,895,100,25,0.001,1804,12
0.638,1e-05,952,952,100,25,0.001,1904,12
0.646,1e-05,997,1007,100,25,0.001,2004,12
0.488,1e-05,50,54,100,25,0.001,104,13
0.494,1e-05,97,107,100,25,0.001,204,13
0.488,1e-05,154,150,100,25,0.001,304,13
0.49,1e-05,211,193,100,25,0.001,404,13
0.486,1e-05,257,247,100,25,0.001,504,13
0.488,1e-05,319,285,100,25,0.001,604,13
0.488,1e-05,377,327,100,25,0.001,704,13
0.498,1e-05,429,375,100,25,0.001,804,13
0.504,1e-05,473,431,100,25,0.001,904,13
0.522,1e-05,518,486,100,25,0.001,1004,13
0.532,1e-05,572,532,100,25,0.001,1104,13
0.552,1e-05,620,584,100,25,0.001,1204,13
0.566,1e-05,669,635,100,25,0.001,1304,13
0.578,1e-05,716,688,100,25,0.001,1404,13
0.586,1e-05,761,743,100,25,0.001,1504,13
0.606,1e-05,807,797,100,25,0.001,1604,13
0.618,1e-05,852,852,100,25,0.001,1704,13
0.628,1e-05,907,897,100,25,0.001,1804,13
0.634,1e-05,957,947,100,25,0.001,1904,13
0.638,1e-05,998,1006,100,25,0.001,2004,13
0.482,1e-05,54,50,100,25,0.001,104,14
0.486,1e-05,105,99,100,25,0.001,204,14
0.484,1e-05,150,154,100,25,0.001,304,14
0.486,1e-05,195,209,100,25,0.001,404,14
0.484,1e-05,246,258,100,25,0.001,504,14
0.488,1e-05,292,312,100,25,0.001,604,14
0.496,1e-05,345,359,100,25,0.001,704,14
0.514,1e-05,399,405,100,25,0.001,804,14
0.52,1e-05,440,464,100,25,0.001,904,14
0.52,1e-05,485,519,100,25,0.001,1004,14
0.534,1e-05,536,568,100,25,0.001,1104,14
0.54,1e-05,586,618,100,25,0.001,1204,14
0.538,1e-05,633,671,100,25,0.001,1304,14
0.546,1e-05,685,719,100,25,0.001,1404,14
0.55,1e-05,737,767,100,25,0.001,1504,14
0.56,1e-05,794,810,100,25,0.001,1604,14
0.576,1e-05,852,852,100,25,0.001,1704,14
0.588,1e-05,900,904,100,25,0.001,1804,14
0.6,1e-05,952,952,100,25,0.001,1904,14
0.622,1e-05,999,1005,100,25,0.001,2004,14
0.498,1e-05,51,53,100,25,0.001,104,15
0.508,1e-05,108,96,100,25,0.001,204,15
0.508,1e-05,154,150,100,25,0.001,304,15
0.508,1e-05,198,206,100,25,0.001,404,15
0.5,1e-05,244,260,100,25,0.001,504,15
0.514,1e-05,291,313,100,25,0.001,604,15
0.516,1e-05,340,364,100,25,0.001,704,15
0.536,1e-05,384,420,100,25,0.001,804,15
0.54,1e-05,432,472,100,25,0.001,904,15
0.556,1e-05,482,522,100,25,0.001,1004,15
0.548,1e-05,534,570,100,25,0.001,1104,15
0.576,1e-05,587,617,100,25,0.001,1204,15
0.58,1e-05,647,657,100,25,0.001,1304,15
0.596,1e-05,696,708,100,25,0.001,1404,15
0.6,1e-05,755,749,100,25,0.001,1504,15
0.62,1e-05,808,796,100,25,0.001,1604,15
0.638,1e-05,858,846,100,25,0.001,1704,15
0.666,1e-05,906,898,100,25,0.001,1804,15
0.678,1e-05,958,946,100,25,0.001,1904,15
0.704,1e-05,1002,1002,100,25,0.001,2004,15
0.498,1e-05,57,47,100,25,0.001,104,16
0.498,1e-05,105,99,100,25,0.001,204,16
0.498,1e-05,152,152,100,25,0.001,304,16
0.504,1e-05,211,193,100,25,0.001,404,16
0.508,1e-05,259,245,100,25,0.001,504,16
0.51,1e-05,309,295,100,25,0.001,604,16
0.518,1e-05,360,344,100,25,0.001,704,16
0.518,1e-05,414,390,100,25,0.001,804,16
0.524,1e-05,458,446,100,25,0.001,904,16
0.528,1e-05,506,498,100,25,0.001,1004,16
0.546,1e-05,547,557,100,25,0.001,1104,16
0.566,1e-05,596,608,100,25,0.001,1204,16
0.562,1e-05,643,661,100,25,0.001,1304,16
0.574,1e-05,696,708,100,25,0.001,1404,16
0.578,1e-05,742,762,100,25,0.001,1504,16
0.61,1e-05,790,814,100,25,0.001,1604,16
0.62,1e-05,843,861,100,25,0.001,1704,16
0.65,1e-05,890,914,100,25,0.001,1804,16
0.666,1e-05,944,960,100,25,0.001,1904,16
0.684,1e-05,1002,1002,100,25,0.001,2004,16
0.508,1e-05,60,44,100,25,0.001,104,17
0.51,1e-05,112,92,100,25,0.001,204,17
0.51,1e-05,165,139,100,25,0.001,304,17
0.516,1e-05,219,185,100,25,0.001,404,17
0.524,1e-05,267,237,100,25,0.001,504,17
0.528,1e-05,313,291,100,25,0.001,604,17
0.54,1e-05,366,338,100,25,0.001,704,17
0.546,1e-05,415,389,100,25,0.001,804,17
0.554,1e-05,465,439,100,25,0.001,904,17
0.56,1e-05,512,492,100,25,0.001,1004,17
0.568,1e-05,558,546,100,25,0.001,1104,17
0.584,1e-05,611,593,100,25,0.001,1204,17
0.596,1e-05,658,646,100,25,0.001,1304,17
0.614,1e-05,699,705,100,25,0.001,1404,17
0.634,1e-05,753,751,100,25,0.001,1504,17
0.648,1e-05,813,791,100,25,0.001,1604,17
0.66,1e-05,855,849,100,25,0.001,1704,17
0.68,1e-05,909,895,100,25,0.001,1804,17
0.692,1e-05,952,952,100,25,0.001,1904,17
0.696,1e-05,996,1008,100,25,0.001,2004,17
0.472,1e-05,53,51,100,25,0.001,104,18
0.472,1e-05,99,105,100,25,0.001,204,18
0.474,1e-05,144,160,100,25,0.001,304,18
0.48,1e-05,196,208,100,25,0.001,404,18
0.492,1e-05,245,259,100,25,0.001,504,18
0.492,1e-05,301,303,100,25,0.001,604,18
0.506,1e-05,352,352,100,25,0.001,704,18
0.516,1e-05,400,404,100,25,0.001,804,18
0.526,1e-05,445,459,100,25,0.001,904,18
0.554,1e-05,494,510,100,25,0.001,1004,18
0.564,1e-05,547,557,100,25,0.001,1104,18
0.576,1e-05,596,608,100,25,0.001,1204,18
0.61,1e-05,653,651,100,25,0.001,1304,18
0.63,1e-05,700,704,100,25,0.001,1404,18
0.642,1e-05,748,756,100,25,0.001,1504,18
0.672,1e-05,798,806,100,25,0.001,1604,18
0.698,1e-05,852,852,100,25,0.001,1704,18
0.708,1e-05,903,901,100,25,0.001,1804,18
0.714,1e-05,957,947,100,25,0.001,1904,18
0.718,1e-05,1008,996,100,25,0.001,2004,18
0.526,1e-05,50,54,100,25,0.001,104,19
0.522,1e-05,94,110,100,25,0.001,204,19
0.524,1e-05,145,159,100,25,0.001,304,19
0.522,1e-05,192,212,100,25,0.001,404,19
0.524,1e-05,244,260,100,25,0.001,504,19
0.526,1e-05,291,313,100,25,0.001,604,19
0.526,1e-05,330,374,100,25,0.001,704,19
0.53,1e-05,378,426,100,25,0.001,804,19
0.532,1e-05,437,467,100,25,0.001,904,19
0.538,1e-05,487,517,100,25,0.001,1004,19
0.54,1e-05,537,567,100,25,0.001,1104,19
0.534,1e-05,594,610,100,25,0.001,1204,19
0.554,1e-05,642,662,100,25,0.001,1304,19
0.578,1e-05,704,700,100,25,0.001,1404,19
0.584,1e-05,753,751,100,25,0.001,1504,19
0.598,1e-05,809,795,100,25,0.001,1604,19
0.604,1e-05,862,842,100,25,0.001,1704,19
0.622,1e-05,915,889,100,25,0.001,1804,19
0.646,1e-05,964,940,100,25,0.001,1904,19
0.678,1e-05,1006,998,100,25,0.001,2004,19
0.504,1e-05,62,42,100,25,0.001,104,20
0.5,1e-05,107,97,100,25,0.001,204,20
0.494,1e-05,160,144,100,25,0.001,304,20
0.494,1e-05,209,195,100,25,0.001,404,20
0.502,1e-05,264,240,100,25,0.001,504,20
0.498,1e-05,311,293,100,25,0.001,604,20
0.498,1e-05,359,345,100,25,0.001,704,20
0.506,1e-05,407,397,100,25,0.001,804,20
0.51,1e-05,461,443,100,25,0.001,904,20
0.51,1e-05,507,497,100,25,0.001,1004,20
0.52,1e-05,557,547,100,25,0.001,1104,20
0.526,1e-05,600,604,100,25,0.001,1204,20
0.544,1e-05,652,652,100,25,0.001,1304,20
0.556,1e-05,708,696,100,25,0.001,1404,20
0.56,1e-05,758,746,100,25,0.001,1504,20
0.564,1e-05,804,800,100,25,0.001,1604,20
0.602,1e-05,858,846,100,25,0.001,1704,20
0.624,1e-05,905,899,100,25,0.001,1804,20
0.652,1e-05,957,947,100,25,0.001,1904,20
0.678,1e-05,1005,999,100,25,0.001,2004,20
0.494,1e-05,49,55,100,25,0.01,104,1
0.534,1e-05,101,103,100,25,0.01,204,1
0.568,1e-05,151,153,100,25,0.01,304,1
0.578,1e-05,211,193,100,25,0.01,404,1
0.618,1e-05,266,238,100,25,0.01,504,1
0.634,1e-05,315,289,100,25,0.01,604,1
0.64,1e-05,364,340,100,25,0.01,704,1
0.668,1e-05,410,394,100,25,0.01,804,1
0.69,1e-05,461,443,100,25,0.01,904,1
0.72,1e-05,517,487,100,25,0.01,1004,1
0.774,1e-05,569,535,100,25,0.01,1104,1
0.826,1e-05,621,583,100,25,0.01,1204,1
0.854,1e-05,666,638,100,25,0.01,1304,1
0.884,1e-05,723,681,100,25,0.01,1404,1
0.912,1e-05,777,727,100,25,0.01,1504,1
0.928,1e-05,825,779,100,25,0.01,1604,1
0.934,1e-05,870,834,100,25,0.01,1704,1
0.938,1e-05,921,883,100,25,0.01,1804,1
0.946,1e-05,969,935,100,25,0.01,1904,1
0.95,1e-05,1017,987,100,25,0.01,2004,1
0.486,1e-05,56,48,100,25,0.01,104,2
0.482,1e-05,112,92,100,25,0.01,204,2
0.498,1e-05,162,142,100,25,0.01,304,2
0.522,1e-05,215,189,100,25,0.01,404,2
0.536,1e-05,272,232,100,25,0.01,504,2
0.568,1e-05,321,283,100,25,0.01,604,2
0.588,1e-05,376,328,100,25,0.01,704,2
0.63,1e-05,429,375,100,25,0.01,804,2
0.666,1e-05,477,427,100,25,0.01,904,2
0.708,1e-05,521,483,100,25,0.01,1004,2
0.71,1e-05,575,529,100,25,0.01,1104,2
0.772,1e-05,628,576,100,25,0.01,1204,2
0.82,1e-05,672,632,100,25,0.01,1304,2
0.858,1e-05,713,691,100,25,0.01,1404,2
0.882,1e-05,764,740,100,25,0.01,1504,2
0.908,1e-05,813,791,100,25,0.01,1604,2
0.922,1e-05,866,838,100,25,0.01,1704,2
0.932,1e-05,919,885,100,25,0.01,1804,2
0.932,1e-05,974,930,100,25,0.01,1904,2
0.936,1e-05,1020,984,100,25,0.01,2004,2
0.506,1e-05,50,54,100,25,0.01,104,3
0.578,1e-05,98,106,100,25,0.01,204,3
0.594,1e-05,152,152,100,25,0.01,304,3
0.596,1e-05,199,205,100,25,0.01,404,3
0.61,1e-05,262,242,100,25,0.01,504,3
0.618,1e-05,308,296,100,25,0.01,604,3
0.666,1e-05,347,357,100,25,0.01,704,3
0.716,1e-05,400,404,100,25,0.01,804,3
0.724,1e-05,457,447,100,25,0.01,904,3
0.746,1e-05,504,500,100,25,0.01,1004,3
0.78,1e-05,560,544,100,25,0.01,1104,3
0.824,1e-05,608,596,100,25,0.01,1204,3
0.85,1e-05,660,644,100,25,0.01,1304,3
0.892,1e-05,699,705,100,25,0.01,1404,3
0.906,1e-05,747,757,100,25,0.01,1504,3
0.93,1e-05,791,813,100,25,0.01,1604,3
0.942,1e-05,849,855,100,25,0.01,1704,3
0.952,1e-05,896,908,100,25,0.01,1804,3
0.952,1e-05,952,952,100,25,0.01,1904,3
0.95,1e-05,995,1009,100,25,0.01,2004,3
0.516,1e-05,49,55,100,25,0.01,104,4
0.568,1e-05,105,99,100,25,0.01,204,4
0.596,1e-05,151,153,100,25,0.01,304,4
0.626,1e-05,203,201,100,25,0.01,404,4
0.626,1e-05,258,246,100,25,0.01,504,4
0.64,1e-05,309,295,100,25,0.01,604,4
0.67,1e-05,368,336,100,25,0.01,704,4
0.71,1e-05,420,384,100,25,0.01,804,4
0.754,1e-05,468,436,100,25,0.01,904,4
0.806,1e-05,509,495,100,25,0.01,1004,4
0.824,1e-05,561,543,100,25,0.01,1104,4
0.868,1e-05,611,593,100,25,0.01,1204,4
0.898,1e-05,652,652,100,25,0.01,1304,4
0.908,1e-05,702,702,100,25,0.01,1404,4
0.922,1e-05,750,754,100,25,0.01,1504,4
0.94,1e-05,798,806,100,25,0.01,1604,4
0.958,1e-05,846,858,100,25,0.01,1704,4
0.958,1e-05,902,902,100,25,0.01,1804,4
0.956,1e-05,949,955,100,25,0.01,1904,4
0.962,1e-05,1003,1001,100,25,0.01,2004,4
0.492,1e-05,51,53,100,25,0.01,104,5
0.55,1e-05,103,101,100,25,0.01,204,5
0.564,1e-05,153,151,100,25,0.01,304,5
0.594,1e-05,199,205,100,25,0.01,404,5
0.616,1e-05,246,258,100,25,0.01,504,5
0.634,1e-05,291,313,100,25,0.01,604,5
0.652,1e-05,342,362,100,25,0.01,704,5
0.662,1e-05,398,406,100,25,0.01,804,5
0.66,1e-05,450,454,100,25,0.01,904,5
0.696,1e-05,503,501,100,25,0.01,1004,5
0.74,1e-05,555,549,100,25,0.01,1104,5
0.802,1e-05,609,595,100,25,0.01,1204,5
0.832,1e-05,666,638,100,25,0.01,1304,5
0.882,1e-05,719,685,100,25,0.01,1404,5
0.908,1e-05,772,732,100,25,0.01,1504,5
0.928,1e-05,816,788,100,25,0.01,1604,5
0.938,1e-05,857,847,100,25,0.01,1704,5
0.94,1e-05,910,894,100,25,0.01,1804,5
0.948,1e-05,956,948,100,25,0.01,1904,5
0.952,1e-05,1010,994,100,25,0.01,2004,5
0.55,1e-05,47,57,100,25,0.01,104,6
0.568,1e-05,98,106,100,25,0.01,204,6
0.61,1e-05,148,156,100,25,0.01,304,6
0.592,1e-05,196,208,100,25,0.01,404,6
0.606,1e-05,247,257,100,25,0.01,504,6
0.632,1e-05,298,306,100,25,0.01,604,6
0.644,1e-05,341,363,100,25,0.01,704,6
0.67,1e-05,398,406,100,25,0.01,804,6
0.68,1e-05,450,454,100,25,0.01,904,6
0.722,1e-05,491,513,100,25,0.01,1004,6
0.776,1e-05,545,559,100,25,0.01,1104,6
0.828,1e-05,591,613,100,25,0.01,1204,6
0.86,1e-05,642,662,100,25,0.01,1304,6
0.886,1e-05,696,708,100,25,0.01,1404,6
0.908,1e-05,752,752,100,25,0.01,1504,6
0.928,1e-05,798,806,100,25,0.01,1604,6
0.934,1e-05,848,856,100,25,0.01,1704,6
0.95,1e-05,892,912,100,25,0.01,1804,6
0.952,1e-05,949,955,100,25,0.01,1904,6
0.956,1e-05,1000,1004,100,25,0.01,2004,6
0.524,1e-05,46,58,100,25,0.01,104,7
0.56,1e-05,97,107,100,25,0.01,204,7
0.526,1e-05,149,155,100,25,0.01,304,7
0.528,1e-05,197,207,100,25,0.01,404,7
0.554,1e-05,248,256,100,25,0.01,504,7
0.614,1e-05,300,304,100,25,0.01,604,7
0.638,1e-05,355,349,100,25,0.01,704,7
0.702,1e-05,405,399,100,25,0.01,804,7
0.742,1e-05,453,451,100,25,0.01,904,7
0.788,1e-05,503,501,100,25,0.01,1004,7
0.84,1e-05,548,556,100,25,0.01,1104,7
0.88,1e-05,601,603,100,25,0.01,1204,7
0.908,1e-05,642,662,100,25,0.01,1304,7
0.92,1e-05,682,722,100,25,0.01,1404,7
0.922,1e-05,736,768,100,25,0.01,1504,7
0.932,1e-05,782,822,100,25,0.01,1604,7
0.926,1e-05,836,868,100,25,0.01,1704,7
0.936,1e-05,886,918,100,25,0.01,1804,7
0.94,1e-05,933,971,100,25,0.01,1904,7
0.94,1e-05,980,1024,100,25,0.01,2004,7
0.536,1e-05,56,48,100,25,0.01,104,8
0.538,1e-05,108,96,100,25,0.01,204,8
0.536,1e-05,159,145,100,25,0.01,304,8
0.55,1e-05,204,200,100,25,0.01,404,8
0.574,1e-05,255,249,100,25,0.01,504,8
0.592,1e-05,310,294,100,25,0.01,604,8
0.612,1e-05,372,332,100,25,0.01,704,8
0.654,1e-05,414,390,100,25,0.01,804,8
0.682,1e-05,467,437,100,25,0.01,904,8
0.734,1e-05,515,489,100,25,0.01,1004,8
0.774,1e-05,559,545,100,25,0.01,1104,8
0.812,1e-05,602,602,100,25,0.01,1204,8
0.85,1e-05,646,658,100,25,0.01,1304,8
0.902,1e-05,688,716,100,25,0.01,1404,8
0.914,1e-05,738,766,100,25,0.01,1504,8
0.932,1e-05,784,820,100,25,0.01,1604,8
0.942,1e-05,845,859,100,25,0.01,1704,8
0.948,1e-05,896,908,100,25,0.01,1804,8
0.944,1e-05,946,958,100,25,0.01,1904,8
0.95,1e-05,1000,1004,100,25,0.01,2004,8
0.526,1e-05,51,53,100,25,0.01,104,9
0.542,1e-05,106,98,100,25,0.01,204,9
0.532,1e-05,159,145,100,25,0.01,304,9
0.544,1e-05,215,189,100,25,0.01,404,9
0.578,1e-05,253,251,100,25,0.01,504,9
0.586,1e-05,304,300,100,25,0.01,604,9
0.598,1e-05,349,355,100,25,0.01,704,9
0.638,1e-05,393,411,100,25,0.01,804,9
0.66,1e-05,436,468,100,25,0.01,904,9
0.712,1e-05,488,516,100,25,0.01,1004,9
0.754,1e-05,536,568,100,25,0.01,1104,9
0.822,1e-05,594,610,100,25,0.01,1204,9
0.838,1e-05,641,663,100,25,0.01,1304,9
0.872,1e-05,691,713,100,25,0.01,1404,9
0.88,1e-05,737,767,100,25,0.01,1504,9
0.9,1e-05,786,818,100,25,0.01,1604,9
0.912,1e-05,836,868,100,25,0.01,1704,9
0.924,1e-05,891,913,100,25,0.01,1804,9
0.934,1e-05,945,959,100,25,0.01,1904,9
0.944,1e-05,993,1011,100,25,0.01,2004,9
0.528,1e-05,52,52,100,25,0.01,104,10
0.534,1e-05,100,104,100,25,0.01,204,10
0.552,1e-05,157,147,100,25,0.01,304,10
0.56,1e-05,202,202,100,25,0.01,404,10
0.554,1e-05,247,257,100,25,0.01,504,10
0.606,1e-05,292,312,100,25,0.01,604,10
0.632,1e-05,345,359,100,25,0.01,704,10
0.666,1e-05,391,413,100,25,0.01,804,10
0.672,1e-05,444,460,100,25,0.01,904,10
0.73,1e-05,495,509,100,25,0.01,1004,10
0.79,1e-05,546,558,100,25,0.01,1104,10
0.838,1e-05,589,615,100,25,0.01,1204,10
0.86,1e-05,649,655,100,25,0.01,1304,10
0.892,1e-05,696,708,100,25,0.01,1404,10
0.916,1e-05,750,754,100,25,0.01,1504,10
0.936,1e-05,805,799,100,25,0.01,1604,10
0.942,1e-05,860,844,100,25,0.01,1704,10
0.942,1e-05,907,897,100,25,0.01,1804,10
0.944,1e-05,964,940,100,25,0.01,1904,10
0.95,1e-05,1018,986,100,25,0.01,2004,10
0.49,1e-05,56,48,100,25,0.01,104,11
0.514,1e-05,100,104,100,25,0.01,204,11
0.526,1e-05,144,160,100,25,0.01,304,11
0.534,1e-05,194,210,100,25,0.01,404,11
0.566,1e-05,247,257,100,25,0.01,504,11
0.594,1e-05,300,304,100,25,0.01,604,11
0.61,1e-05,352,352,100,25,0.01,704,11
0.65,1e-05,400,404,100,25,0.01,804,11
0.68,1e-05,447,457,100,25,0.01,904,11
0.732,1e-05,494,510,100,25,0.01,1004,11
0.772,1e-05,546,558,100,25,0.01,1104,11
0.814,1e-05,601,603,100,25,0.01,1204,11
0.85,1e-05,655,649,100,25,0.01,1304,11
0.896,1e-05,702,702,100,25,0.01,1404,11
0.924,1e-05,758,746,100,25,0.01,1504,11
0.93,1e-05,800,804,100,25,0.01,1604,11
0.944,1e-05,853,851,100,25,0.01,1704,11
0.946,1e-05,901,903,100,25,0.01,1804,11
0.948,1e-05,953,951,100,25,0.01,1904,11
0.956,1e-05,1006,998,100,25,0.01,2004,11
0.536,1e-05,54,50,100,25,0.01,104,12
0.564,1e-05,98,106,100,25,0.01,204,12
0.558,1e-05,159,145,100,25,0.01,304,12
0.598,1e-05,207,197,100,25,0.01,404,12
0.62,1e-05,254,250,100,25,0.01,504,12
0.644,1e-05,304,300,100,25,0.01,604,12
0.638,1e-05,351,353,100,25,0.01,704,12
0.686,1e-05,402,402,100,25,0.01,804,12
0.718,1e-05,450,454,100,25,0.01,904,12
0.752,1e-05,497,507,100,25,0.01,1004,12
0.78,1e-05,544,560,100,25,0.01,1104,12
0.828,1e-05,592,612,100,25,0.01,1204,12
0.854,1e-05,648,656,100,25,0.01,1304,12
0.884,1e-05,698,706,100,25,0.01,1404,12
0.9,1e-05,747,757,100,25,0.01,1504,12
0.91,1e-05,808,796,100,25,0.01,1604,12
0.92,1e-05,860,844,100,25,0.01,1704,12
0.932,1e-05,912,892,100,25,0.01,1804,12
0.934,1e-05,963,941,100,25,0.01,1904,12
0.936,1e-05,1014,990,100,25,0.01,2004,12
0.53,1e-05,50,54,100,25,0.01,104,13
0.538,1e-05,96,108,100,25,0.01,204,13
0.558,1e-05,152,152,100,25,0.01,304,13
0.582,1e-05,194,210,100,25,0.01,404,13
0.596,1e-05,245,259,100,25,0.01,504,13
0.634,1e-05,296,308,100,25,0.01,604,13
0.656,1e-05,352,352,100,25,0.01,704,13
0.682,1e-05,400,404,100,25,0.01,804,13
0.71,1e-05,457,447,100,25,0.01,904,13
0.736,1e-05,505,499,100,25,0.01,1004,13
0.766,1e-05,553,551,100,25,0.01,1104,13
0.834,1e-05,591,613,100,25,0.01,1204,13
0.844,1e-05,646,658,100,25,0.01,1304,13
0.866,1e-05,703,701,100,25,0.01,1404,13
0.894,1e-05,758,746,100,25,0.01,1504,13
0.918,1e-05,809,795,100,25,0.01,1604,13
0.93,1e-05,859,845,100,25,0.01,1704,13
0.93,1e-05,912,892,100,25,0.01,1804,13
0.928,1e-05,964,940,100,25,0.01,1904,13
0.934,1e-05,1015,989,100,25,0.01,2004,13
0.47,1e-05,46,58,100,25,0.01,104,14
0.486,1e-05,104,100,100,25,0.01,204,14
0.5,1e-05,145,159,100,25,0.01,304,14
0.534,1e-05,199,205,100,25,0.01,404,14
0.57,1e-05,247,257,100,25,0.01,504,14
0.594,1e-05,290,314,100,25,0.01,604,14
0.618,1e-05,338,366,100,25,0.01,704,14
0.632,1e-05,383,421,100,25,0.01,804,14
0.682,1e-05,437,467,100,25,0.01,904,14
0.73,1e-05,486,518,100,25,0.01,1004,14
0.74,1e-05,540,564,100,25,0.01,1104,14
0.796,1e-05,584,620,100,25,0.01,1204,14
0.82,1e-05,636,668,100,25,0.01,1304,14
0.856,1e-05,684,720,100,25,0.01,1404,14
0.882,1e-05,741,763,100,25,0.01,1504,14
0.904,1e-05,788,816,100,25,0.01,1604,14
0.908,1e-05,835,869,100,25,0.01,1704,14
0.924,1e-05,885,919,100,25,0.01,1804,14
0.926,1e-05,935,969,100,25,0.01,1904,14
0.932,1e-05,988,1016,100,25,0.01,2004,14
0.532,1e-05,47,57,100,25,0.01,104,15
0.522,1e-05,90,114,100,25,0.01,204,15
0.522,1e-05,136,168,100,25,0.01,304,15
0.532,1e-05,187,217,100,25,0.01,404,15
0.536,1e-05,233,271,100,25,0.01,504,15
0.558,1e-05,280,324,100,25,0.01,604,15
0.576,1e-05,335,369,100,25,0.01,704,15
0.618,1e-05,389,415,100,25,0.01,804,15
0.672,1e-05,436,468,100,25,0.01,904,15
0.72,1e-05,498,506,100,25,0.01,1004,15
0.76,1e-05,547,557,100,25,0.01,1104,15
0.834,1e-05,599,605,100,25,0.01,1204,15
0.88,1e-05,648,656,100,25,0.01,1304,15
0.914,1e-05,695,709,100,25,0.01,1404,15
0.92,1e-05,748,756,100,25,0.01,1504,15
0.942,1e-05,796,808,100,25,0.01,1604,15
0.944,1e-05,844,860,100,25,0.01,1704,15
0.936,1e-05,899,905,100,25,0.01,1804,15
0.938,1e-05,947,957,100,25,0.01,1904,15
0.944,1e-05,992,1012,100,25,0.01,2004,15
0.488,1e-05,60,44,100,25,0.01,104,16
0.5,1e-05,100,104,100,25,0.01,204,16
0.528,1e-05,150,154,100,25,0.01,304,16
0.542,1e-05,202,202,100,25,0.01,404,16
0.57,1e-05,242,262,100,25,0.01,504,16
0.59,1e-05,291,313,100,25,0.01,604,16
0.626,1e-05,340,364,100,25,0.01,704,16
0.676,1e-05,387,417,100,25,0.01,804,16
0.74,1e-05,446,458,100,25,0.01,904,16
0.792,1e-05,494,510,100,25,0.01,1004,16
0.836,1e-05,542,562,100,25,0.01,1104,16
0.874,1e-05,598,606,100,25,0.01,1204,16
0.904,1e-05,651,653,100,25,0.01,1304,16
0.926,1e-05,705,699,100,25,0.01,1404,16
0.94,1e-05,755,749,100,25,0.01,1504,16
0.946,1e-05,796,808,100,25,0.01,1604,16
0.952,1e-05,844,860,100,25,0.01,1704,16
0.952,1e-05,893,911,100,25,0.01,1804,16
0.952,1e-05,949,955,100,25,0.01,1904,16
0.952,1e-05,995,1009,100,25,0.01,2004,16
0.486,1e-05,42,62,100,25,0.01,104,17
0.508,1e-05,92,112,100,25,0.01,204,17
0.518,1e-05,146,158,100,25,0.01,304,17
0.55,1e-05,197,207,100,25,0.01,404,17
0.556,1e-05,245,259,100,25,0.01,504,17
0.61,1e-05,291,313,100,25,0.01,604,17
0.624,1e-05,341,363,100,25,0.01,704,17
0.674,1e-05,390,414,100,25,0.01,804,17
0.714,1e-05,436,468,100,25,0.01,904,17
0.778,1e-05,487,517,100,25,0.01,1004,17
0.798,1e-05,547,557,100,25,0.01,1104,17
0.832,1e-05,595,609,100,25,0.01,1204,17
0.866,1e-05,641,663,100,25,0.01,1304,17
0.91,1e-05,696,708,100,25,0.01,1404,17
0.92,1e-05,744,760,100,25,0.01,1504,17
0.932,1e-05,797,807,100,25,0.01,1604,17
0.932,1e-05,843,861,100,25,0.01,1704,17
0.93,1e-05,895,909,100,25,0.01,1804,17
0.938,1e-05,946,958,100,25,0.01,1904,17
0.946,1e-05,994,1010,100,25,0.01,2004,17
0.514,1e-05,51,53,100,25,0.01,104,18
0.546,1e-05,94,110,100,25,0.01,204,18
0.546,1e-05,154,150,100,25,0.01,304,18
0.562,1e-05,203,201,100,25,0.01,404,18
0.588,1e-05,259,245,100,25,0.01,504,18
0.618,1e-05,310,294,100,25,0.01,604,18
0.612,1e-05,358,346,100,25,0.01,704,18
0.67,1e-05,409,395,100,25,0.01,804,18
0.714,1e-05,449,455,100,25,0.01,904,18
0.758,1e-05,510,494,100,25,0.01,1004,18
0.814,1e-05,560,544,100,25,0.01,1104,18
0.856,1e-05,617,587,100,25,0.01,1204,18
0.896,1e-05,661,643,100,25,0.01,1304,18
0.926,1e-05,709,695,100,25,0.01,1404,18
0.944,1e-05,750,754,100,25,0.01,1504,18
0.942,1e-05,800,804,100,25,0.01,1604,18
0.952,1e-05,852,852,100,25,0.01,1704,18
0.954,1e-05,909,895,100,25,0.01,1804,18
0.96,1e-05,961,943,100,25,0.01,1904,18
0.964,1e-05,1006,998,100,25,0.01,2004,18
0.49,1e-05,53,51,100,25,0.01,104,19
0.502,1e-05,101,103,100,25,0.01,204,19
0.52,1e-05,154,150,100,25,0.01,304,19
0.516,1e-05,195,209,100,25,0.01,404,19
0.53,1e-05,248,256,100,25,0.01,504,19
0.544,1e-05,297,307,100,25,0.01,604,19
0.574,1e-05,339,365,100,25,0.01,704,19
0.622,1e-05,386,418,100,25,0.01,804,19
0.67,1e-05,432,472,100,25,0.01,904,19
0.74,1e-05,487,517,100,25,0.01,1004,19
0.798,1e-05,541,563,100,25,0.01,1104,19
0.84,1e-05,593,611,100,25,0.01,1204,19
0.858,1e-05,635,669,100,25,0.01,1304,19
0.9,1e-05,682,722,100,25,0.01,1404,19
0.912,1e-05,728,776,100,25,0.01,1504,19
0.93,1e-05,781,823,100,25,0.01,1604,19
0.94,1e-05,828,876,100,25,0.01,1704,19
0.944,1e-05,887,917,100,25,0.01,1804,19
0.946,1e-05,940,964,100,25,0.01,1904,19
0.948,1e-05,995,1009,100,25,0.01,2004,19
0.484,1e-05,59,45,100,25,0.01,104,20
0.522,1e-05,104,100,100,25,0.01,204,20
0.504,1e-05,150,154,100,25,0.01,304,20
0.544,1e-05,195,209,100,25,0.01,404,20
0.554,1e-05,248,256,100,25,0.01,504,20
0.56,1e-05,303,301,100,25,0.01,604,20
0.584,1e-05,365,339,100,25,0.01,704,20
0.628,1e-05,409,395,100,25,0.01,804,20
0.622,1e-05,467,437,100,25,0.01,904,20
0.672,1e-05,509,495,100,25,0.01,1004,20
0.72,1e-05,565,539,100,25,0.01,1104,20
0.762,1e-05,609,595,100,25,0.01,1204,20
0.802,1e-05,655,649,100,25,0.01,1304,20
0.846,1e-05,704,700,100,25,0.01,1404,20
0.89,1e-05,760,744,100,25,0.01,1504,20
0.912,1e-05,811,793,100,25,0.01,1604,20
0.934,1e-05,863,841,100,25,0.01,1704,20
0.948,1e-05,921,883,100,25,0.01,1804,20
0.956,1e-05,973,931,100,25,0.01,1904,20
0.954,1e-05,1023,981,100,25,0.01,2004,20
0.466,0.0001,48,56,100,25,0.0001,104,1
0.472,0.0001,92,112,100,25,0.0001,204,1
0.472,0.0001,135,169,100,25,0.0001,304,1
0.476,0.0001,188,216,100,25,0.0001,404,1
0.478,0.0001,237,267,100,25,0.0001,504,1
0.478,0.0001,292,312,100,25,0.0001,604,1
0.48,0.0001,352,352,100,25,0.0001,704,1
0.476,0.0001,404,400,100,25,0.0001,804,1
0.474,0.0001,455,449,100,25,0.0001,904,1
0.474,0.0001,503,501,100,25,0.0001,1004,1
0.478,0.0001,552,552,100,25,0.0001,1104,1
0.478,0.0001,607,597,100,25,0.0001,1204,1
0.476,0.0001,647,657,100,25,0.0001,1304,1
0.48,0.0001,699,705,100,25,0.0001,1404,1
0.484,0.0001,739,765,100,25,0.0001,1504,1
0.484,0.0001,787,817,100,25,0.0001,1604,1
0.484,0.0001,839,865,100,25,0.0001,1704,1
0.49,0.0001,893,911,100,25,0.0001,1804,1
0.49,0.0001,940,964,100,25,0.0001,1904,1
0.498,0.0001,989,1015,100,25,0.0001,2004,1
0.486,0.0001,45,59,100,25,0.0001,104,2
0.488,0.0001,92,112,100,25,0.0001,204,2
0.488,0.0001,140,164,100,25,0.0001,304,2
0.49,0.0001,193,211,100,25,0.0001,404,2
0.488,0.0001,235,269,100,25,0.0001,504,2
0.488,0.0001,283,321,100,25,0.0001,604,2
0.49,0.0001,332,372,100,25,0.0001,704,2
0.492,0.0001,381,423,100,25,0.0001,804,2
0.494,0.0001,433,471,100,25,0.0001,904,2
0.494,0.0001,484,520,100,25,0.0001,1004,2
0.496,0.0001,534,570,100,25,0.0001,1104,2
0.498,0.0001,589,615,100,25,0.0001,1204,2
0.5,0.0001,647,657,100,25,0.0001,1304,2
0.5,0.0001,694,710,100,25,0.0001,1404,2
0.502,0.0001,742,762,100,25,0.0001,1504,2
0.504,0.0001,793,811,100,25,0.0001,1604,2
0.506,0.0001,846,858,100,25,0.0001,1704,2
0.504,0.0001,897,907,100,25,0.0001,1804,2
0.504,0.0001,958,946,100,25,0.0001,1904,2
0.504,0.0001,1004,1000,100,25,0.0001,2004,2
0.452,0.0001,56,48,100,25,0.0001,104,3
0.454,0.0001,107,97,100,25,0.0001,204,3
0.452,0.0001,156,148,100,25,0.0001,304,3
0.454,0.0001,213,191,100,25,0.0001,404,3
0.454,0.0001,264,240,100,25,0.0001,504,3
0.456,0.0001,306,298,100,25,0.0001,604,3
0.456,0.0001,354,350,100,25,0.0001,704,3
0.454,0.0001,408,396,100,25,0.0001,804,3
0.456,0.0001,454,450,100,25,0.0001,904,3
0.458,0.0001,503,501,100,25,0.0001,1004,3
0.46,0.0001,548,556,100,25,0.0001,1104,3
0.46,0.0001,601,603,100,25,0.0001,1204,3
0.46,0.0001,642,662,100,25,0.0001,1304,3
0.464,0.0001,690,714,100,25,0.0001,1404,3
0.464,0.0001,737,767,100,25,0.0001,1504,3
0.464,0.0001,784,820,100,25,0.0001,1604,3
0.464,0.0001,834,870,100,25,0.0001,1704,3
0.464,0.0001,886,918,100,25,0.0001,1804,3
0.466,0.0001,939,965,100,25,0.0001,1904,3
0.468,0.0001,996,1008,100,25,0.0001,2004,3
0.496,0.0001,50,54,100,25,0.0001,104,4
0.496,0.0001,103,101,100,25,0.0001,204,4
0.496,0.0001,156,148,100,25,0.0001,304,4
0.496,0.0001,206,198,100,25,0.0001,404,4
0.496,0.0001,253,251,100,25,0.0001,504,4
0.496,0.0001,294,310,100,25,0.0001,604,4
0.496,0.0001,346,358,100,25,0.0001,704,4
0.498,0.0001,399,405,100,25,0.0001,804,4
0.498,0.0001,454,450,100,25,0.0001,904,4
0.498,0.0001,504,500,100,25,0.0001,1004,4
0.496,0.0001,550,554,100,25,0.0001,1104,4
0.496,0.0001,603,601,100,25,0.0001,1204,4
0.498,0.0001,655,649,100,25,0.0001,1304,4
0.498,0.0001,708,696,100,25,0.0001,1404,4
0.5,0.0001,755,749,100,25,0.0001,1504,4
0.5,0.0001,806,798,100,25,0.0001,1604,4
0.5,0.0001,861,843,100,25,0.0001,1704,4
0.5,0.0001,909,895,100,25,0.0001,1804,4
0.5,0.0001,956,948,100,25,0.0001,1904,4
0.5,0.0001,999,1005,100,25,0.0001,2004,4
0.51,0.0001,52,52,100,25,0.0001,104,5
0.51,0.0001,111,93,100,25,0.0001,204,5
0.51,0.0001,163,141,100,25,0.0001,304,5
0.508,0.0001,222,182,100,25,0.0001,404,5
0.506,0.0001,267,237,100,25,0.0001,504,5
0.5,0.0001,327,277,100,25,0.0001,604,5
0.498,0.0001,368,336,100,25,0.0001,704,5
0.498,0.0001,410,394,100,25,0.0001,804,5
0.498,0.0001,458,446,100,25,0.0001,904,5
0.498,0.0001,507,497,100,25,0.0001,1004,5
0.498,0.0001,558,546,100,25,0.0001,1104,5
0.5,0.0001,609,595,100,25,0.0001,1204,5
0.5,0.0001,655,649,100,25,0.0001,1304,5
0.5,0.0001,700,704,100,25,0.0001,1404,5
0.496,0.0001,756,748,100,25,0.0001,1504,5
0.494,0.0001,809,795,100,25,0.0001,1604,5
0.496,0.0001,853,851,100,25,0.0001,1704,5
0.496,0.0001,903,901,100,25,0.0001,1804,5
0.494,0.0001,948,956,100,25,0.0001,1904,5
0.494,0.0001,1002,1002,100,25,0.0001,2004,5
0.506,0.0001,54,50,100,25,0.0001,104,6
0.502,0.0001,102,102,100,25,0.0001,204,6
0.504,0.0001,150,154,100,25,0.0001,304,6
0.506,0.0001,201,203,100,25,0.0001,404,6
0.506,0.0001,246,258,100,25,0.0001,504,6
0.506,0.0001,299,305,100,25,0.0001,604,6
0.508,0.0001,341,363,100,25,0.0001,704,6
0.506,0.0001,391,413,100,25,0.0001,804,6
0.5,0.0001,451,453,100,25,0.0001,904,6
0.5,0.0001,508,496,100,25,0.0001,1004,6
0.5,0.0001,564,540,100,25,0.0001,1104,6
0.502,0.0001,614,590,100,25,0.0001,1204,6
0.51,0.0001,653,651,100,25,0.0001,1304,6
0.516,0.0001,702,702,100,25,0.0001,1404,6
0.518,0.0001,758,746,100,25,0.0001,1504,6
0.522,0.0001,806,798,100,25,0.0001,1604,6
0.52,0.0001,855,849,100,25,0.0001,1704,6
0.526,0.0001,902,902,100,25,0.0001,1804,6
0.53,0.0001,954,950,100,25,0.0001,1904,6
0.528,0.0001,998,1006,100,25,0.0001,2004,6
0.502,0.0001,68,36,100,25,0.0001,104,7
0.502,0.0001,118,86,100,25,0.0001,204,7
0.502,0.0001,169,135,100,25,0.0001,304,7
0.502,0.0001,215,189,100,25,0.0001,404,7
0.504,0.0001,269,235,100,25,0.0001,504,7
0.504,0.0001,324,280,100,25,0.0001,604,7
0.506,0.0001,370,334,100,25,0.0001,704,7
0.508,0.0001,424,380,100,25,0.0001,804,7
0.51,0.0001,473,431,100,25,0.0001,904,7
0.51,0.0001,517,487,100,25,0.0001,1004,7
0.51,0.0001,564,540,100,25,0.0001,1104,7
0.518,0.0001,618,586,100,25,0.0001,1204,7
0.518,0.0001,660,644,100,25,0.0001,1304,7
0.52,0.0001,711,693,100,25,0.0001,1404,7
0.518,0.0001,763,741,100,25,0.0001,1504,7
0.516,0.0001,811,793,100,25,0.0001,1604,7
0.518,0.0001,854,850,100,25,0.0001,1704,7
0.518,0.0001,906,898,100,25,0.0001,1804,7
0.518,0.0001,962,942,100,25,0.0001,1904,7
0.518,0.0001,1006,998,100,25,0.0001,2004,7
0.516,0.0001,38,66,100,25,0.0001,104,8
0.516,0.0001,87,117,100,25,0.0001,204,8
0.516,0.0001,133,171,100,25,0.0001,304,8
0.516,0.0001,183,221,100,25,0.0001,404,8
0.516,0.0001,239,265,100,25,0.0001,504,8
0.518,0.0001,295,309,100,25,0.0001,604,8
0.518,0.0001,342,362,100,25,0.0001,704,8
0.518,0.0001,384,420,100,25,0.0001,804,8
0.518,0.0001,430,474,100,25,0.0001,904,8
0.518,0.0001,473,531,100,25,0.0001,1004,8
0.52,0.0001,521,583,100,25,0.0001,1104,8
0.52,0.0001,567,637,100,25,0.0001,1204,8
0.518,0.0001,619,685,100,25,0.0001,1304,8
0.522,0.0001,673,731,100,25,0.0001,1404,8
0.52,0.0001,724,780,100,25,0.0001,1504,8
0.524,0.0001,786,818,100,25,0.0001,1604,8
0.524,0.0001,842,862,100,25,0.0001,1704,8
0.528,0.0001,900,904,100,25,0.0001,1804,8
0.53,0.0001,953,951,100,25,0.0001,1904,8
0.53,0.0001,1007,997,100,25,0.0001,2004,8
0.536,0.0001,50,54,100,25,0.0001,104,9
0.538,0.0001,93,111,100,25,0.0001,204,9
0.54,0.0001,145,159,100,25,0.0001,304,9
0.54,0.0001,199,205,100,25,0.0001,404,9
0.542,0.0001,253,251,100,25,0.0001,504,9
0.542,0.0001,305,299,100,25,0.0001,604,9
0.54,0.0001,351,353,100,25,0.0001,704,9
0.54,0.0001,404,400,100,25,0.0001,804,9
0.542,0.0001,451,453,100,25,0.0001,904,9
0.542,0.0001,510,494,100,25,0.0001,1004,9
0.542,0.0001,552,552,100,25,0.0001,1104,9
0.546,0.0001,595,609,100,25,0.0001,1204,9
0.546,0.0001,640,664,100,25,0.0001,1304,9
0.552,0.0001,694,710,100,25,0.0001,1404,9
0.554,0.0001,745,759,100,25,0.0001,1504,9
0.556,0.0001,794,810,100,25,0.0001,1604,9
0.554,0.0001,837,867,100,25,0.0001,1704,9
0.554,0.0001,894,910,100,25,0.0001,1804,9
0.554,0.0001,950,954,100,25,0.0001,1904,9
0.554,0.0001,1002,1002,100,25,0.0001,2004,9
0.548,0.0001,48,56,100,25,0.0001,104,10
0.552,0.0001,104,100,100,25,0.0001,204,10
0.552,0.0001,141,163,100,25,0.0001,304,10
0.552,0.0001,185,219,100,25,0.0001,404,10
0.552,0.0001,232,272,100,25,0.0001,504,10
0.552,0.0001,285,319,100,25,0.0001,604,10
0.552,0.0001,335,369,100,25,0.0001,704,10
0.552,0.0001,391,413,100,25,0.0001,804,10
0.552,0.0001,446,458,100,25,0.0001,904,10
0.552,0.0001,490,514,100,25,0.0001,1004,10
0.554,0.0001,544,560,100,25,0.0001,1104,10
0.554,0.0001,583,621,100,25,0.0001,1204,10
0.556,0.0001,633,671,100,25,0.0001,1304,10
0.554,0.0001,682,722,100,25,0.0001,1404,10
0.554,0.0001,728,776,100,25,0.0001,1504,10
0.556,0.0001,779,825,100,25,0.0001,1604,10
0.558,0.0001,820,884,100,25,0.0001,1704,10
0.556,0.0001,877,927,100,25,0.0001,1804,10
0.56,0.0001,931,973,100,25,0.0001,1904,10
0.558,0.0001,978,1026,100,25,0.0001,2004,10
0.488,0.0001,53,51,100,25,0.0001,104,11
0.488,0.0001,100,104,100,25,0.0001,204,11
0.488,0.0001,150,154,100,25,0.0001,304,11
0.488,0.0001,201,203,100,25,0.0001,404,11
0.488,0.0001,253,251,100,25,0.0001,504,11
0.49,0.0001,308,296,100,25,0.0001,604,11
0.488,0.0001,352,352,100,25,0.0001,704,11
0.492,0.0001,403,401,100,25,0.0001,804,11
0.492,0.0001,456,448,100,25,0.0001,904,11
0.492,0.0001,508,496,100,25,0.0001,1004,11
0.494,0.0001,554,550,100,25,0.0001,1104,11
0.498,0.0001,607,597,100,25,0.0001,1204,11
0.502,0.0001,660,644,100,25,0.0001,1304,11
0.506,0.0001,710,694,100,25,0.0001,1404,11
0.508,0.0001,758,746,100,25,0.0001,1504,11
0.51,0.0001,808,796,100,25,0.0001,1604,11
0.506,0.0001,864,840,100,25,0.0001,1704,11
0.508,0.0001,907,897,100,25,0.0001,1804,11
0.51,0.0001,961,943,100,25,0.0001,1904,11
0.512,0.0001,1012,992,100,25,0.0001,2004,11
0.5,0.0001,58,46,100,25,0.0001,104,12
0.5,0.0001,111,93,100,25,0.0001,204,12
0.5,0.0001,165,139,100,25,0.0001,304,12
0.5,0.0001,204,200,100,25,0.0001,404,12
0.5,0.0001,253,251,100,25,0.0001,504,12
0.502,0.0001,304,300,100,25,0.0001,604,12
0.502,0.0001,350,354,100,25,0.0001,704,12
0.502,0.0001,400,404,100,25,0.0001,804,12
0.502,0.0001,445,459,100,25,0.0001,904,12
0.502,0.0001,498,506,100,25,0.0001,1004,12
0.504,0.0001,550,554,100,25,0.0001,1104,12
0.504,0.0001,611,593,100,25,0.0001,1204,12
0.504,0.0001,655,649,100,25,0.0001,1304,12
0.504,0.0001,705,699,100,25,0.0001,1404,12
0.504,0.0001,758,746,100,25,0.0001,1504,12
0.504,0.0001,809,795,100,25,0.0001,1604,12
0.506,0.0001,863,841,100,25,0.0001,1704,12
0.51,0.0001,905,899,100,25,0.0001,1804,12
0.51,0.0001,954,950,100,25,0.0001,1904,12
0.51,0.0001,1007,997,100,25,0.0001,2004,12
0.506,0.0001,47,57,100,25,0.0001,104,13
0.506,0.0001,94,110,100,25,0.0001,204,13
0.502,0.0001,149,155,100,25,0.0001,304,13
0.502,0.0001,205,199,100,25,0.0001,404,13
0.506,0.0001,255,249,100,25,0.0001,504,13
0.508,0.0001,308,296,100,25,0.0001,604,13
0.506,0.0001,364,340,100,25,0.0001,704,13
0.508,0.0001,408,396,100,25,0.0001,804,13
0.51,0.0001,450,454,100,25,0.0001,904,13
0.51,0.0001,495,509,100,25,0.0001,1004,13
0.51,0.0001,541,563,100,25,0.0001,1104,13
0.516,0.0001,600,604,100,25,0.0001,1204,13
0.518,0.0001,647,657,100,25,0.0001,1304,13
0.518,0.0001,701,703,100,25,0.0001,1404,13
0.524,0.0001,749,755,100,25,0.0001,1504,13
0.524,0.0001,801,803,100,25,0.0001,1604,13
0.522,0.0001,848,856,100,25,0.0001,1704,13
0.522,0.0001,898,906,100,25,0.0001,1804,13
0.524,0.0001,949,955,100,25,0.0001,1904,13
0.528,0.0001,1001,1003,100,25,0.0001,2004,13
0.486,0.0001,57,47,100,25,0.0001,104,14
0.486,0.0001,104,100,100,25,0.0001,204,14
0.484,0.0001,146,158,100,25,0.0001,304,14
0.486,0.0001,190,214,100,25,0.0001,404,14
0.486,0.0001,234,270,100,25,0.0001,504,14
0.488,0.0001,275,329,100,25,0.0001,604,14
0.488,0.0001,326,378,100,25,0.0001,704,14
0.488,0.0001,376,428,100,25,0.0001,804,14
0.488,0.0001,425,479,100,25,0.0001,904,14
0.49,0.0001,477,527,100,25,0.0001,1004,14
0.49,0.0001,529,575,100,25,0.0001,1104,14
0.496,0.0001,582,622,100,25,0.0001,1204,14
0.496,0.0001,634,670,100,25,0.0001,1304,14
0.494,0.0001,692,712,100,25,0.0001,1404,14
0.498,0.0001,739,765,100,25,0.0001,1504,14
0.498,0.0001,791,813,100,25,0.0001,1604,14
0.494,0.0001,843,861,100,25,0.0001,1704,14
0.496,0.0001,883,921,100,25,0.0001,1804,14
0.498,0.0001,938,966,100,25,0.0001,1904,14
0.496,0.0001,997,1007,100,25,0.0001,2004,14
0.504,0.0001,50,54,100,25,0.0001,104,15
0.504,0.0001,95,109,100,25,0.0001,204,15
0.504,0.0001,142,162,100,25,0.0001,304,15
0.504,0.0001,193,211,100,25,0.0001,404,15
0.504,0.0001,248,256,100,25,0.0001,504,15
0.504,0.0001,290,314,100,25,0.0001,604,15
0.504,0.0001,345,359,100,25,0.0001,704,15
0.504,0.0001,391,413,100,25,0.0001,804,15
0.506,0.0001,444,460,100,25,0.0001,904,15
0.506,0.0001,497,507,100,25,0.0001,1004,15
0.506,0.0001,556,548,100,25,0.0001,1104,15
0.508,0.0001,600,604,100,25,0.0001,1204,15
0.512,0.0001,653,651,100,25,0.0001,1304,15
0.514,0.0001,701,703,100,25,0.0001,1404,15
0.512,0.0001,755,749,100,25,0.0001,1504,15
0.512,0.0001,793,811,100,25,0.0001,1604,15
0.514,0.0001,844,860,100,25,0.0001,1704,15
0.514,0.0001,890,914,100,25,0.0001,1804,15
0.516,0.0001,941,963,100,25,0.0001,1904,15
0.514,0.0001,997,1007,100,25,0.0001,2004,15
0.478,0.0001,46,58,100,25,0.0001,104,16
0.478,0.0001,94,110,100,25,0.0001,204,16
0.478,0.0001,146,158,100,25,0.0001,304,16
0.478,0.0001,189,215,100,25,0.0001,404,16
0.478,0.0001,239,265,100,25,0.0001,504,16
0.478,0.0001,284,320,100,25,0.0001,604,16
0.478,0.0001,324,380,100,25,0.0001,704,16
0.478,0.0001,369,435,100,25,0.0001,804,16
0.478,0.0001,418,486,100,25,0.0001,904,16
0.48,0.0001,467,537,100,25,0.0001,1004,16
0.482,0.0001,518,586,100,25,0.0001,1104,16
0.488,0.0001,571,633,100,25,0.0001,1204,16
0.484,0.0001,624,680,100,25,0.0001,1304,16
0.482,0.0001,679,725,100,25,0.0001,1404,16
0.482,0.0001,731,773,100,25,0.0001,1504,16
0.484,0.0001,774,830,100,25,0.0001,1604,16
0.486,0.0001,833,871,100,25,0.0001,1704,16
0.49,0.0001,890,914,100,25,0.0001,1804,16
0.49,0.0001,948,956,100,25,0.0001,1904,16
0.492,0.0001,993,1011,100,25,0.0001,2004,16
0.49,0.0001,50,54,100,25,0.0001,104,17
0.49,0.0001,96,108,100,25,0.0001,204,17
0.488,0.0001,150,154,100,25,0.0001,304,17
0.488,0.0001,199,205,100,25,0.0001,404,17
0.49,0.0001,250,254,100,25,0.0001,504,17
0.492,0.0001,292,312,100,25,0.0001,604,17
0.494,0.0001,353,351,100,25,0.0001,704,17
0.494,0.0001,412,392,100,25,0.0001,804,17
0.498,0.0001,466,438,100,25,0.0001,904,17
0.494,0.0001,515,489,100,25,0.0001,1004,17
0.498,0.0001,565,539,100,25,0.0001,1104,17
0.5,0.0001,617,587,100,25,0.0001,1204,17
0.5,0.0001,673,631,100,25,0.0001,1304,17
0.504,0.0001,721,683,100,25,0.0001,1404,17
0.506,0.0001,772,732,100,25,0.0001,1504,17
0.506,0.0001,824,780,100,25,0.0001,1604,17
0.508,0.0001,869,835,100,25,0.0001,1704,17
0.506,0.0001,912,892,100,25,0.0001,1804,17
0.504,0.0001,960,944,100,25,0.0001,1904,17
0.504,0.0001,1009,995,100,25,0.0001,2004,17
0.53,0.0001,51,53,100,25,0.0001,104,18
0.528,0.0001,97,107,100,25,0.0001,204,18
0.532,0.0001,143,161,100,25,0.0001,304,18
0.532,0.0001,195,209,100,25,0.0001,404,18
0.53,0.0001,240,264,100,25,0.0001,504,18
0.532,0.0001,287,317,100,25,0.0001,604,18
0.532,0.0001,341,363,100,25,0.0001,704,18
0.53,0.0001,391,413,100,25,0.0001,804,18
0.53,0.0001,438,466,100,25,0.0001,904,18
0.532,0.0001,485,519,100,25,0.0001,1004,18
0.53,0.0001,525,579,100,25,0.0001,1104,18
0.532,0.0001,570,634,100,25,0.0001,1204,18
0.53,0.0001,615,689,100,25,0.0001,1304,18
0.54,0.0001,673,731,100,25,0.0001,1404,18
0.54,0.0001,721,783,100,25,0.0001,1504,18
0.54,0.0001,770,834,100,25,0.0001,1604,18
0.544,0.0001,831,873,100,25,0.0001,1704,18
0.54,0.0001,879,925,100,25,0.0001,1804,18
0.544,0.0001,922,982,100,25,0.0001,1904,18
0.55,0.0001,967,1037,100,25,0.0001,2004,18
0.51,0.0001,57,47,100,25,0.0001,104,19
0.51,0.0001,113,91,100,25,0.0001,204,19
0.51,0.0001,163,141,100,25,0.0001,304,19
0.51,0.0001,210,194,100,25,0.0001,404,19
0.51,0.0001,254,250,100,25,0.0001,504,19
0.51,0.0001,308,296,100,25,0.0001,604,19
0.51,0.0001,355,349,100,25,0.0001,704,19
0.51,0.0001,401,403,100,25,0.0001,804,19
0.508,0.0001,451,453,100,25,0.0001,904,19
0.512,0.0001,499,505,100,25,0.0001,1004,19
0.512,0.0001,555,549,100,25,0.0001,1104,19
0.516,0.0001,601,603,100,25,0.0001,1204,19
0.516,0.0001,650,654,100,25,0.0001,1304,19
0.516,0.0001,704,700,100,25,0.0001,1404,19
0.518,0.0001,759,745,100,25,0.0001,1504,19
0.518,0.0001,810,794,100,25,0.0001,1604,19
0.518,0.0001,855,849,100,25,0.0001,1704,19
0.518,0.0001,901,903,100,25,0.0001,1804,19
0.518,0.0001,950,954,100,25,0.0001,1904,19
0.518,0.0001,1006,998,100,25,0.0001,2004,19
0.526,0.0001,56,48,100,25,0.0001,104,20
0.532,0.0001,105,99,100,25,0.0001,204,20
0.532,0.0001,159,145,100,25,0.0001,304,20
0.532,0.0001,212,192,100,25,0.0001,404,20
0.532,0.0001,267,237,100,25,0.0001,504,20
0.532,0.0001,310,294,100,25,0.0001,604,20
0.534,0.0001,356,348,100,25,0.0001,704,20
0.532,0.0001,405,399,100,25,0.0001,804,20
0.53,0.0001,455,449,100,25,0.0001,904,20
0.53,0.0001,502,502,100,25,0.0001,1004,20
0.526,0.0001,544,560,100,25,0.0001,1104,20
0.534,0.0001,587,617,100,25,0.0001,1204,20
0.532,0.0001,633,671,100,25,0.0001,1304,20
0.532,0.0001,678,726,100,25,0.0001,1404,20
0.534,0.0001,726,778,100,25,0.0001,1504,20
0.534,0.0001,784,820,100,25,0.0001,1604,20
0.536,0.0001,838,866,100,25,0.0001,1704,20
0.536,0.0001,897,907,100,25,0.0001,1804,20
0.534,0.0001,947,957,100,25,0.0001,1904,20
0.54,0.0001,994,1010,100,25,0.0001,2004,20
0.536,0.0001,54,50,100,25,0.001,104,1
0.534,0.0001,106,98,100,25,0.001,204,1
0.532,0.0001,154,150,100,25,0.001,304,1
0.548,0.0001,217,187,100,25,0.001,404,1
0.544,0.0001,264,240,100,25,0.001,504,1
0.548,0.0001,306,298,100,25,0.001,604,1
0.54,0.0001,356,348,100,25,0.001,704,1
0.538,0.0001,410,394,100,25,0.001,804,1
0.55,0.0001,465,439,100,25,0.001,904,1
0.564,0.0001,520,484,100,25,0.001,1004,1
0.562,0.0001,567,537,100,25,0.001,1104,1
0.57,0.0001,615,589,100,25,0.001,1204,1
0.57,0.0001,671,633,100,25,0.001,1304,1
0.6,0.0001,723,681,100,25,0.001,1404,1
0.592,0.0001,774,730,100,25,0.001,1504,1
0.594,0.0001,825,779,100,25,0.001,1604,1
0.614,0.0001,873,831,100,25,0.001,1704,1
0.636,0.0001,922,882,100,25,0.001,1804,1
0.654,0.0001,970,934,100,25,0.001,1904,1
0.684,0.0001,1021,983,100,25,0.001,2004,1
0.498,0.0001,55,49,100,25,0.001,104,2
0.504,0.0001,106,98,100,25,0.001,204,2
0.51,0.0001,161,143,100,25,0.001,304,2
0.512,0.0001,210,194,100,25,0.001,404,2
0.508,0.0001,259,245,100,25,0.001,504,2
0.512,0.0001,307,297,100,25,0.001,604,2
0.528,0.0001,356,348,100,25,0.001,704,2
0.53,0.0001,404,400,100,25,0.001,804,2
0.54,0.0001,457,447,100,25,0.001,904,2
0.55,0.0001,511,493,100,25,0.001,1004,2
0.558,0.0001,558,546,100,25,0.001,1104,2
0.568,0.0001,607,597,100,25,0.001,1204,2
0.58,0.0001,656,648,100,25,0.001,1304,2
0.582,0.0001,707,697,100,25,0.001,1404,2
0.598,0.0001,752,752,100,25,0.001,1504,2
0.612,0.0001,803,801,100,25,0.001,1604,2
0.63,0.0001,850,854,100,25,0.001,1704,2
0.646,0.0001,899,905,100,25,0.001,1804,2
0.668,0.0001,953,951,100,25,0.001,1904,2
0.694,0.0001,1002,1002,100,25,0.001,2004,2
0.502,0.0001,55,49,100,25,0.001,104,3
0.504,0.0001,107,97,100,25,0.001,204,3
0.498,0.0001,159,145,100,25,0.001,304,3
0.504,0.0001,208,196,100,25,0.001,404,3
0.514,0.0001,256,248,100,25,0.001,504,3
0.516,0.0001,307,297,100,25,0.001,604,3
0.508,0.0001,354,350,100,25,0.001,704,3
0.51,0.0001,403,401,100,25,0.001,804,3
0.508,0.0001,443,461,100,25,0.001,904,3
0.518,0.0001,491,513,100,25,0.001,1004,3
0.522,0.0001,543,561,100,25,0.001,1104,3
0.544,0.0001,596,608,100,25,0.001,1204,3
0.544,0.0001,640,664,100,25,0.001,1304,3
0.55,0.0001,695,709,100,25,0.001,1404,3
0.562,0.0001,744,760,100,25,0.001,1504,3
0.59,0.0001,794,810,100,25,0.001,1604,3
0.616,0.0001,833,871,100,25,0.001,1704,3
0.624,0.0001,880,924,100,25,0.001,1804,3
0.634,0.0001,935,969,100,25,0.001,1904,3
0.648,0.0001,988,1016,100,25,0.001,2004,3
0.468,0.0001,52,52,100,25,0.001,104,4
0.482,0.0001,105,99,100,25,0.001,204,4
0.492,0.0001,155,149,100,25,0.001,304,4
0.488,0.0001,204,200,100,25,0.001,404,4
0.488,0.0001,254,250,100,25,0.001,504,4
0.494,0.0001,303,301,100,25,0.001,604,4
0.482,0.0001,345,359,100,25,0.001,704,4
0.49,0.0001,408,396,100,25,0.001,804,4
0.494,0.0001,463,441,100,25,0.001,904,4
0.506,0.0001,509,495,100,25,0.001,1004,4
0.506,0.0001,559,545,100,25,0.001,1104,4
0.528,0.0001,608,596,100,25,0.001,1204,4
0.552,0.0001,648,656,100,25,0.001,1304,4
0.562,0.0001,691,713,100,25,0.001,1404,4
0.574,0.0001,752,752,100,25,0.001,1504,4
0.584,0.0001,801,803,100,25,0.001,1604,4
0.604,0.0001,844,860,100,25,0.001,1704,4
0.632,0.0001,905,899,100,25,0.001,1804,4
0.646,0.0001,964,940,100,25,0.001,1904,4
0.654,0.0001,1013,991,100,25,0.001,2004,4
0.468,0.0001,53,51,100,25,0.001,104,5
0.476,0.0001,97,107,100,25,0.001,204,5
0.476,0.0001,150,154,100,25,0.001,304,5
0.476,0.0001,213,191,100,25,0.001,404,5
0.476,0.0001,274,230,100,25,0.001,504,5
0.482,0.0001,326,278,100,25,0.001,604,5
0.482,0.0001,373,331,100,25,0.001,704,5
0.486,0.0001,421,383,100,25,0.001,804,5
0.502,0.0001,474,430,100,25,0.001,904,5
0.522,0.0001,525,479,100,25,0.001,1004,5
0.536,0.0001,574,530,100,25,0.001,1104,5
0.548,0.0001,622,582,100,25,0.001,1204,5
0.556,0.0001,667,637,100,25,0.001,1304,5
0.566,0.0001,707,697,100,25,0.001,1404,5
0.564,0.0001,751,753,100,25,0.001,1504,5
0.596,0.0001,807,797,100,25,0.001,1604,5
0.62,0.0001,854,850,100,25,0.001,1704,5
0.628,0.0001,902,902,100,25,0.001,1804,5
0.65,0.0001,956,948,100,25,0.001,1904,5
0.672,0.0001,1000,1004,100,25,0.001,2004,5
0.556,0.0001,54,50,100,25,0.001,104,6
0.556,0.0001,113,91,100,25,0.001,204,6
0.572,0.0001,165,139,100,25,0.001,304,6
0.574,0.0001,215,189,100,25,0.001,404,6
0.582,0.0001,262,242,100,25,0.001,504,6
0.59,0.0001,319,285,100,25,0.001,604,6
0.59,0.0001,371,333,100,25,0.001,704,6
0.602,0.0001,425,379,100,25,0.001,804,6
0.602,0.0001,470,434,100,25,0.001,904,6
0.61,0.0001,517,487,100,25,0.001,1004,6
0.604,0.0001,561,543,100,25,0.001,1104,6
0.606,0.0001,618,586,100,25,0.001,1204,6
0.62,0.0001,666,638,100,25,0.001,1304,6
0.624,0.0001,717,687,100,25,0.001,1404,6
0.63,0.0001,761,743,100,25,0.001,1504,6
0.632,0.0001,809,795,100,25,0.001,1604,6
0.65,0.0001,864,840,100,25,0.001,1704,6
0.658,0.0001,916,888,100,25,0.001,1804,6
0.666,0.0001,969,935,100,25,0.001,1904,6
0.688,0.0001,1018,986,100,25,0.001,2004,6
0.492,0.0001,57,47,100,25,0.001,104,7
0.494,0.0001,100,104,100,25,0.001,204,7
0.494,0.0001,144,160,100,25,0.001,304,7
0.504,0.0001,188,216,100,25,0.001,404,7
0.504,0.0001,246,258,100,25,0.001,504,7
0.502,0.0001,298,306,100,25,0.001,604,7
0.492,0.0001,354,350,100,25,0.001,704,7
0.5,0.0001,405,399,100,25,0.001,804,7
0.512,0.0001,447,457,100,25,0.001,904,7
0.512,0.0001,500,504,100,25,0.001,1004,7
0.512,0.0001,544,560,100,25,0.001,1104,7
0.512,0.0001,596,608,100,25,0.001,1204,7
0.518,0.0001,646,658,100,25,0.001,1304,7
0.53,0.0001,700,704,100,25,0.001,1404,7
0.536,0.0001,751,753,100,25,0.001,1504,7
0.55,0.0001,798,806,100,25,0.001,1604,7
0.568,0.0001,853,851,100,25,0.001,1704,7
0.592,0.0001,897,907,100,25,0.001,1804,7
0.594,0.0001,942,962,100,25,0.001,1904,7
0.604,0.0001,1001,1003,100,25,0.001,2004,7
0.534,0.0001,58,46,100,25,0.001,104,8
0.536,0.0001,109,95,100,25,0.001,204,8
0.54,0.0001,164,140,100,25,0.001,304,8
0.542,0.0001,206,198,100,25,0.001,404,8
0.546,0.0001,252,252,100,25,0.001,504,8
0.55,0.0001,300,304,100,25,0.001,604,8
0.558,0.0001,349,355,100,25,0.001,704,8
0.564,0.0001,401,403,100,25,0.001,804,8
0.562,0.0001,458,446,100,25,0.001,904,8
0.57,0.0001,500,504,100,25,0.001,1004,8
0.574,0.0001,548,556,100,25,0.001,1104,8
0.588,0.0001,598,606,100,25,0.001,1204,8
0.602,0.0001,651,653,100,25,0.001,1304,8
0.606,0.0001,701,703,100,25,0.001,1404,8
0.618,0.0001,748,756,100,25,0.001,1504,8
0.624,0.0001,789,815,100,25,0.001,1604,8
0.634,0.0001,840,864,100,25,0.001,1704,8
0.658,0.0001,899,905,100,25,0.001,1804,8
0.68,0.0001,951,953,100,25,0.001,1904,8
0.696,0.0001,1005,999,100,25,0.001,2004,8
0.524,0.0001,49,55,100,25,0.001,104,9
0.524,0.0001,101,103,100,25,0.001,204,9
0.516,0.0001,159,145,100,25,0.001,304,9
0.516,0.0001,205,199,100,25,0.001,404,9
0.516,0.0001,259,245,100,25,0.001,504,9
0.514,0.0001,303,301,100,25,0.001,604,9
0.516,0.0001,348,356,100,25,0.001,704,9
0.524,0.0001,390,414,100,25,0.001,804,9
0.538,0.0001,433,471,100,25,0.001,904,9
0.55,0.0001,480,524,100,25,0.001,1004,9
0.556,0.0001,531,573,100,25,0.001,1104,9
0.566,0.0001,583,621,100,25,0.001,1204,9
0.582,0.0001,631,673,100,25,0.001,1304,9
0.61,0.0001,685,719,100,25,0.001,1404,9
0.636,0.0001,737,767,100,25,0.001,1504,9
0.642,0.0001,790,814,100,25,0.001,1604,9
0.656,0.0001,846,858,100,25,0.001,1704,9
0.662,0.0001,895,909,100,25,0.001,1804,9
0.7,0.0001,943,961,100,25,0.001,1904,9
0.73,0.0001,995,1009,100,25,0.001,2004,9
0.504,0.0001,45,59,100,25,0.001,104,10
0.508,0.0001,86,118,100,25,0.001,204,10
0.52,0.0001,136,168,100,25,0.001,304,10
0.516,0.0001,184,220,100,25,0.001,404,10
0.514,0.0001,232,272,100,25,0.001,504,10
0.512,0.0001,282,322,100,25,0.001,604,10
0.514,0.0001,331,373,100,25,0.001,704,10
0.524,0.0001,394,410,100,25,0.001,804,10
0.532,0.0001,451,453,100,25,0.001,904,10
0.548,0.0001,490,514,100,25,0.001,1004,10
0.556,0.0001,547,557,100,25,0.001,1104,10
0.562,0.0001,594,610,100,25,0.001,1204,10
0.568,0.0001,642,662,100,25,0.001,1304,10
0.578,0.0001,697,707,100,25,0.001,1404,10
0.592,0.0001,759,745,100,25,0.001,1504,10
0.594,0.0001,810,794,100,25,0.001,1604,10
0.608,0.0001,864,840,100,25,0.001,1704,10
0.634,0.0001,917,887,100,25,0.001,1804,10
0.654,0.0001,965,939,100,25,0.001,1904,10
0.68,0.0001,1012,992,100,25,0.001,2004,10
0.496,0.0001,51,53,100,25,0.001,104,11
0.486,0.0001,114,90,100,25,0.001,204,11
0.484,0.0001,164,140,100,25,0.001,304,11
0.504,0.0001,220,184,100,25,0.001,404,11
0.512,0.0001,269,235,100,25,0.001,504,11
0.522,0.0001,324,280,100,25,0.001,604,11
0.534,0.0001,380,324,100,25,0.001,704,11
0.54,0.0001,431,373,100,25,0.001,804,11
0.548,0.0001,482,422,100,25,0.001,904,11
0.55,0.0001,530,474,100,25,0.001,1004,11
0.56,0.0001,578,526,100,25,0.001,1104,11
0.566,0.0001,632,572,100,25,0.001,1204,11
0.566,0.0001,670,634,100,25,0.001,1304,11
0.578,0.0001,718,686,100,25,0.001,1404,11
0.58,0.0001,763,741,100,25,0.001,1504,11
0.588,0.0001,810,794,100,25,0.001,1604,11
0.614,0.0001,854,850,100,25,0.001,1704,11
0.646,0.0001,901,903,100,25,0.001,1804,11
0.66,0.0001,955,949,100,25,0.001,1904,11
0.686,0.0001,997,1007,100,25,0.001,2004,11
0.498,0.0001,48,56,100,25,0.001,104,12
0.504,0.0001,105,99,100,25,0.001,204,12
0.52,0.0001,152,152,100,25,0.001,304,12
0.524,0.0001,204,200,100,25,0.001,404,12
0.522,0.0001,252,252,100,25,0.001,504,12
0.534,0.0001,305,299,100,25,0.001,604,12
0.536,0.0001,352,352,100,25,0.001,704,12
0.542,0.0001,405,399,100,25,0.001,804,12
0.552,0.0001,461,443,100,25,0.001,904,12
0.556,0.0001,511,493,100,25,0.001,1004,12
0.564,0.0001,559,545,100,25,0.001,1104,12
0.562,0.0001,608,596,100,25,0.001,1204,12
0.572,0.0001,659,645,100,25,0.001,1304,12
0.576,0.0001,708,696,100,25,0.001,1404,12
0.6,0.0001,761,743,100,25,0.001,1504,12
0.596,0.0001,802,802,100,25,0.001,1604,12
0.604,0.0001,856,848,100,25,0.001,1704,12
0.612,0.0001,911,893,100,25,0.001,1804,12
0.624,0.0001,960,944,100,25,0.001,1904,12
0.628,0.0001,1008,996,100,25,0.001,2004,12
0.526,0.0001,54,50,100,25,0.001,104,13
0.534,0.0001,108,96,100,25,0.001,204,13
0.536,0.0001,151,153,100,25,0.001,304,13
0.548,0.0001,191,213,100,25,0.001,404,13
0.548,0.0001,244,260,100,25,0.001,504,13
0.564,0.0001,286,318,100,25,0.001,604,13
0.568,0.0001,338,366,100,25,0.001,704,13
0.578,0.0001,385,419,100,25,0.001,804,13
0.58,0.0001,434,470,100,25,0.001,904,13
0.588,0.0001,493,511,100,25,0.001,1004,13
0.598,0.0001,547,557,100,25,0.001,1104,13
0.602,0.0001,594,610,100,25,0.001,1204,13
0.608,0.0001,650,654,100,25,0.001,1304,13
0.622,0.0001,691,713,100,25,0.001,1404,13
0.62,0.0001,745,759,100,25,0.001,1504,13
0.64,0.0001,795,809,100,25,0.001,1604,13
0.658,0.0001,849,855,100,25,0.001,1704,13
0.67,0.0001,897,907,100,25,0.001,1804,13
0.696,0.0001,952,952,100,25,0.001,1904,13
0.714,0.0001,1007,997,100,25,0.001,2004,13
0.514,0.0001,37,67,100,25,0.001,104,14
0.516,0.0001,95,109,100,25,0.001,204,14
0.52,0.0001,142,162,100,25,0.001,304,14
0.53,0.0001,201,203,100,25,0.001,404,14
0.518,0.0001,254,250,100,25,0.001,504,14
0.524,0.0001,296,308,100,25,0.001,604,14
0.526,0.0001,341,363,100,25,0.001,704,14
0.522,0.0001,385,419,100,25,0.001,804,14
0.526,0.0001,435,469,100,25,0.001,904,14
0.53,0.0001,481,523,100,25,0.001,1004,14
0.54,0.0001,537,567,100,25,0.001,1104,14
0.554,0.0001,583,621,100,25,0.001,1204,14
0.568,0.0001,632,672,100,25,0.001,1304,14
0.58,0.0001,678,726,100,25,0.001,1404,14
0.594,0.0001,728,776,100,25,0.001,1504,14
0.61,0.0001,775,829,100,25,0.001,1604,14
0.634,0.0001,827,877,100,25,0.001,1704,14
0.658,0.0001,888,916,100,25,0.001,1804,14
0.676,0.0001,934,970,100,25,0.001,1904,14
0.692,0.0001,985,1019,100,25,0.001,2004,14
0.494,0.0001,59,45,100,25,0.001,104,15
0.496,0.0001,107,97,100,25,0.001,204,15
0.498,0.0001,165,139,100,25,0.001,304,15
0.5,0.0001,214,190,100,25,0.001,404,15
0.504,0.0001,277,227,100,25,0.001,504,15
0.51,0.0001,322,282,100,25,0.001,604,15
0.514,0.0001,367,337,100,25,0.001,704,15
0.526,0.0001,421,383,100,25,0.001,804,15
0.532,0.0001,466,438,100,25,0.001,904,15
0.548,0.0001,517,487,100,25,0.001,1004,15
0.558,0.0001,570,534,100,25,0.001,1104,15
0.574,0.0001,616,588,100,25,0.001,1204,15
0.584,0.0001,661,643,100,25,0.001,1304,15
0.584,0.0001,711,693,100,25,0.001,1404,15
0.592,0.0001,755,749,100,25,0.001,1504,15
0.616,0.0001,792,812,100,25,0.001,1604,15
0.634,0.0001,846,858,100,25,0.001,1704,15
0.644,0.0001,902,902,100,25,0.001,1804,15
0.67,0.0001,950,954,100,25,0.001,1904,15
0.682,0.0001,1004,1000,100,25,0.001,2004,15
0.526,0.0001,51,53,100,25,0.001,104,16
0.528,0.0001,100,104,100,25,0.001,204,16
0.53,0.0001,149,155,100,25,0.001,304,16
0.53,0.0001,204,200,100,25,0.001,404,16
0.536,0.0001,260,244,100,25,0.001,504,16
0.542,0.0001,317,287,100,25,0.001,604,16
0.544,0.0001,370,334,100,25,0.001,704,16
0.55,0.0001,420,384,100,25,0.001,804,16
0.552,0.0001,466,438,100,25,0.001,904,16
0.56,0.0001,520,484,100,25,0.001,1004,16
0.556,0.0001,564,540,100,25,0.001,1104,16
0.564,0.0001,614,590,100,25,0.001,1204,16
0.582,0.0001,670,634,100,25,0.001,1304,16
0.594,0.0001,721,683,100,25,0.001,1404,16
0.596,0.0001,774,730,100,25,0.001,1504,16
0.618,0.0001,818,786,100,25,0.001,1604,16
0.632,0.0001,872,832,100,25,0.001,1704,16
0.64,0.0001,919,885,100,25,0.001,1804,16
0.674,0.0001,971,933,100,25,0.001,1904,16
0.676,0.0001,1017,987,100,25,0.001,2004,16
0.5,0.0001,52,52,100,25,0.001,104,17
0.5,0.0001,101,103,100,25,0.001,204,17
0.5,0.0001,158,146,100,25,0.001,304,17
0.5,0.0001,202,202,100,25,0.001,404,17
0.498,0.0001,250,254,100,25,0.001,504,17
0.5,0.0001,300,304,100,25,0.001,604,17
0.5,0.0001,347,357,100,25,0.001,704,17
0.502,0.0001,393,411,100,25,0.001,804,17
0.498,0.0001,446,458,100,25,0.001,904,17
0.502,0.0001,496,508,100,25,0.001,1004,17
0.508,0.0001,555,549,100,25,0.001,1104,17
0.502,0.0001,606,598,100,25,0.001,1204,17
0.512,0.0001,649,655,100,25,0.001,1304,17
0.52,0.0001,696,708,100,25,0.001,1404,17
0.522,0.0001,753,751,100,25,0.001,1504,17
0.52,0.0001,801,803,100,25,0.001,1604,17
0.53,0.0001,852,852,100,25,0.001,1704,17
0.558,0.0001,902,902,100,25,0.001,1804,17
0.584,0.0001,954,950,100,25,0.001,1904,17
0.618,0.0001,1002,1002,100,25,0.001,2004,17
0.5,0.0001,57,47,100,25,0.001,104,18
0.508,0.0001,103,101,100,25,0.001,204,18
0.508,0.0001,148,156,100,25,0.001,304,18
0.518,0.0001,207,197,100,25,0.001,404,18
0.522,0.0001,253,251,100,25,0.001,504,18
0.538,0.0001,302,302,100,25,0.001,604,18
0.54,0.0001,344,360,100,25,0.001,704,18
0.554,0.0001,398,406,100,25,0.001,804,18
0.566,0.0001,440,464,100,25,0.001,904,18
0.574,0.0001,498,506,100,25,0.001,1004,18
0.58,0.0001,547,557,100,25,0.001,1104,18
0.584,0.0001,592,612,100,25,0.001,1204,18
0.586,0.0001,641,663,100,25,0.001,1304,18
0.606,0.0001,690,714,100,25,0.001,1404,18
0.606,0.0001,747,757,100,25,0.001,1504,18
0.622,0.0001,797,807,100,25,0.001,1604,18
0.642,0.0001,841,863,100,25,0.001,1704,18
0.638,0.0001,896,908,100,25,0.001,1804,18
0.65,0.0001,955,949,100,25,0.001,1904,18
0.66,0.0001,998,1006,100,25,0.001,2004,18
0.474,0.0001,53,51,100,25,0.001,104,19
0.476,0.0001,109,95,100,25,0.001,204,19
0.47,0.0001,158,146,100,25,0.001,304,19
0.482,0.0001,199,205,100,25,0.001,404,19
0.482,0.0001,252,252,100,25,0.001,504,19
0.48,0.0001,307,297,100,25,0.001,604,19
0.484,0.0001,372,332,100,25,0.001,704,19
0.49,0.0001,411,393,100,25,0.001,804,19
0.498,0.0001,449,455,100,25,0.001,904,19
0.508,0.0001,503,501,100,25,0.001,1004,19
0.522,0.0001,558,546,100,25,0.001,1104,19
0.532,0.0001,607,597,100,25,0.001,1204,19
0.544,0.0001,670,634,100,25,0.001,1304,19
0.562,0.0001,712,692,100,25,0.001,1404,19
0.57,0.0001,771,733,100,25,0.001,1504,19
0.59,0.0001,822,782,100,25,0.001,1604,19
0.596,0.0001,878,826,100,25,0.001,1704,19
0.616,0.0001,926,878,100,25,0.001,1804,19
0.634,0.0001,975,929,100,25,0.001,1904,19
0.652,0.0001,1021,983,100,25,0.001,2004,19
0.464,0.0001,57,47,100,25,0.001,104,20
0.472,0.0001,104,100,100,25,0.001,204,20
0.472,0.0001,154,150,100,25,0.001,304,20
0.472,0.0001,208,196,100,25,0.001,404,20
0.474,0.0001,264,240,100,25,0.001,504,20
0.478,0.0001,319,285,100,25,0.001,604,20
0.484,0.0001,375,329,100,25,0.001,704,20
0.49,0.0001,424,380,100,25,0.001,804,20
0.498,0.0001,474,430,100,25,0.001,904,20
0.506,0.0001,516,488,100,25,0.001,1004,20
0.518,0.0001,572,532,100,25,0.001,1104,20
0.524,0.0001,617,587,100,25,0.001,1204,20
0.548,0.0001,670,634,100,25,0.001,1304,20
0.56,0.0001,719,685,100,25,0.001,1404,20
0.562,0.0001,773,731,100,25,0.001,1504,20
0.578,0.0001,820,784,100,25,0.001,1604,20
0.592,0.0001,873,831,100,25,0.001,1704,20
0.624,0.0001,920,884,100,25,0.001,1804,20
0.644,0.0001,965,939,100,25,0.001,1904,20
0.664,0.0001,1016,988,100,25,0.001,2004,20
0.552,0.0001,54,50,100,25,0.01,104,1
0.562,0.0001,104,100,100,25,0.01,204,1
0.588,0.0001,154,150,100,25,0.01,304,1
0.602,0.0001,204,200,100,25,0.01,404,1
0.616,0.0001,248,256,100,25,0.01,504,1
0.622,0.0001,292,312,100,25,0.01,604,1
0.632,0.0001,341,363,100,25,0.01,704,1
0.676,0.0001,392,412,100,25,0.01,804,1
0.7,0.0001,444,460,100,25,0.01,904,1
0.76,0.0001,491,513,100,25,0.01,1004,1
0.796,0.0001,540,564,100,25,0.01,1104,1
0.846,0.0001,594,610,100,25,0.01,1204,1
0.872,0.0001,648,656,100,25,0.01,1304,1
0.894,0.0001,692,712,100,25,0.01,1404,1
0.9,0.0001,746,758,100,25,0.01,1504,1
0.922,0.0001,799,805,100,25,0.01,1604,1
0.926,0.0001,855,849,100,25,0.01,1704,1
0.938,0.0001,895,909,100,25,0.01,1804,1
0.944,0.0001,940,964,100,25,0.01,1904,1
0.946,0.0001,992,1012,100,25,0.01,2004,1
0.52,0.0001,50,54,100,25,0.01,104,2
0.54,0.0001,95,109,100,25,0.01,204,2
0.534,0.0001,144,160,100,25,0.01,304,2
0.552,0.0001,194,210,100,25,0.01,404,2
0.56,0.0001,240,264,100,25,0.01,504,2
0.582,0.0001,290,314,100,25,0.01,604,2
0.58,0.0001,337,367,100,25,0.01,704,2
0.614,0.0001,390,414,100,25,0.01,804,2
0.67,0.0001,446,458,100,25,0.01,904,2
0.716,0.0001,502,502,100,25,0.01,1004,2
0.748,0.0001,560,544,100,25,0.01,1104,2
0.776,0.0001,609,595,100,25,0.01,1204,2
0.816,0.0001,667,637,100,25,0.01,1304,2
0.862,0.0001,708,696,100,25,0.01,1404,2
0.882,0.0001,768,736,100,25,0.01,1504,2
0.914,0.0001,816,788,100,25,0.01,1604,2
0.928,0.0001,855,849,100,25,0.01,1704,2
0.946,0.0001,904,900,100,25,0.01,1804,2
0.952,0.0001,952,952,100,25,0.01,1904,2
0.956,0.0001,1000,1004,100,25,0.01,2004,2
0.532,0.0001,52,52,100,25,0.01,104,3
0.56,0.0001,95,109,100,25,0.01,204,3
0.54,0.0001,144,160,100,25,0.01,304,3
0.516,0.0001,193,211,100,25,0.01,404,3
0.536,0.0001,246,258,100,25,0.01,504,3
0.564,0.0001,303,301,100,25,0.01,604,3
0.622,0.0001,361,343,100,25,0.01,704,3
0.658,0.0001,409,395,100,25,0.01,804,3
0.676,0.0001,456,448,100,25,0.01,904,3
0.722,0.0001,508,496,100,25,0.01,1004,3
0.754,0.0001,561,543,100,25,0.01,1104,3
0.81,0.0001,613,591,100,25,0.01,1204,3
0.862,0.0001,668,636,100,25,0.01,1304,3
0.894,0.0001,715,689,100,25,0.01,1404,3
0.932,0.0001,762,742,100,25,0.01,1504,3
0.94,0.0001,816,788,100,25,0.01,1604,3
0.936,0.0001,863,841,100,25,0.01,1704,3
0.94,0.0001,909,895,100,25,0.01,1804,3
0.958,0.0001,958,946,100,25,0.01,1904,3
0.948,0.0001,1004,1000,100,25,0.01,2004,3
0.522,0.0001,57,47,100,25,0.01,104,4
0.536,0.0001,101,103,100,25,0.01,204,4
0.532,0.0001,148,156,100,25,0.01,304,4
0.544,0.0001,200,204,100,25,0.01,404,4
0.564,0.0001,250,254,100,25,0.01,504,4
0.604,0.0001,292,312,100,25,0.01,604,4
0.64,0.0001,340,364,100,25,0.01,704,4
0.682,0.0001,394,410,100,25,0.01,804,4
0.73,0.0001,436,468,100,25,0.01,904,4
0.76,0.0001,488,516,100,25,0.01,1004,4
0.796,0.0001,541,563,100,25,0.01,1104,4
0.85,0.0001,589,615,100,25,0.01,1204,4
0.872,0.0001,637,667,100,25,0.01,1304,4
0.894,0.0001,692,712,100,25,0.01,1404,4
0.886,0.0001,742,762,100,25,0.01,1504,4
0.914,0.0001,791,813,100,25,0.01,1604,4
0.918,0.0001,848,856,100,25,0.01,1704,4
0.926,0.0001,904,900,100,25,0.01,1804,4
0.94,0.0001,951,953,100,25,0.01,1904,4
0.938,0.0001,1000,1004,100,25,0.01,2004,4
0.514,0.0001,55,49,100,25,0.01,104,5
0.498,0.0001,98,106,100,25,0.01,204,5
0.506,0.0001,142,162,100,25,0.01,304,5
0.526,0.0001,191,213,100,25,0.01,404,5
0.55,0.0001,234,270,100,25,0.01,504,5
0.572,0.0001,286,318,100,25,0.01,604,5
0.594,0.0001,338,366,100,25,0.01,704,5
0.622,0.0001,388,416,100,25,0.01,804,5
0.682,0.0001,432,472,100,25,0.01,904,5
0.742,0.0001,487,517,100,25,0.01,1004,5
0.798,0.0001,538,566,100,25,0.01,1104,5
0.842,0.0001,593,611,100,25,0.01,1204,5
0.848,0.0001,641,663,100,25,0.01,1304,5
0.876,0.0001,698,706,100,25,0.01,1404,5
0.902,0.0001,748,756,100,25,0.01,1504,5
0.92,0.0001,798,806,100,25,0.01,1604,5
0.936,0.0001,848,856,100,25,0.01,1704,5
0.944,0.0001,896,908,100,25,0.01,1804,5
0.952,0.0001,946,958,100,25,0.01,1904,5
0.956,0.0001,1001,1003,100,25,0.01,2004,5
0.562,0.0001,56,48,100,25,0.01,104,6
0.578,0.0001,102,102,100,25,0.01,204,6
0.59,0.0001,147,157,100,25,0.01,304,6
0.596,0.0001,198,206,100,25,0.01,404,6
0.622,0.0001,242,262,100,25,0.01,504,6
0.644,0.0001,296,308,100,25,0.01,604,6
0.682,0.0001,345,359,100,25,0.01,704,6
0.706,0.0001,398,406,100,25,0.01,804,6
0.702,0.0001,449,455,100,25,0.01,904,6
0.768,0.0001,501,503,100,25,0.01,1004,6
0.798,0.0001,551,553,100,25,0.01,1104,6
0.834,0.0001,603,601,100,25,0.01,1204,6
0.852,0.0001,658,646,100,25,0.01,1304,6
0.88,0.0001,697,707,100,25,0.01,1404,6
0.898,0.0001,754,750,100,25,0.01,1504,6
0.926,0.0001,810,794,100,25,0.01,1604,6
0.936,0.0001,852,852,100,25,0.01,1704,6
0.94,0.0001,897,907,100,25,0.01,1804,6
0.946,0.0001,953,951,100,25,0.01,1904,6
0.952,0.0001,1001,1003,100,25,0.01,2004,6
0.52,0.0001,54,50,100,25,0.01,104,7
0.542,0.0001,100,104,100,25,0.01,204,7
0.566,0.0001,157,147,100,25,0.01,304,7
0.586,0.0001,203,201,100,25,0.01,404,7
0.588,0.0001,250,254,100,25,0.01,504,7
0.6,0.0001,296,308,100,25,0.01,604,7
0.616,0.0001,342,362,100,25,0.01,704,7
0.668,0.0001,394,410,100,25,0.01,804,7
0.71,0.0001,442,462,100,25,0.01,904,7
0.736,0.0001,489,515,100,25,0.01,1004,7
0.778,0.0001,542,562,100,25,0.01,1104,7
0.814,0.0001,593,611,100,25,0.01,1204,7
0.828,0.0001,644,660,100,25,0.01,1304,7
0.874,0.0001,704,700,100,25,0.01,1404,7
0.908,0.0001,744,760,100,25,0.01,1504,7
0.916,0.0001,800,804,100,25,0.01,1604,7
0.926,0.0001,847,857,100,25,0.01,1704,7
0.944,0.0001,899,905,100,25,0.01,1804,7
0.948,0.0001,953,951,100,25,0.01,1904,7
0.948,0.0001,1002,1002,100,25,0.01,2004,7
0.486,0.0001,45,59,100,25,0.01,104,8
0.506,0.0001,99,105,100,25,0.01,204,8
0.524,0.0001,157,147,100,25,0.01,304,8
0.53,0.0001,210,194,100,25,0.01,404,8
0.53,0.0001,266,238,100,25,0.01,504,8
0.56,0.0001,314,290,100,25,0.01,604,8
0.594,0.0001,364,340,100,25,0.01,704,8
0.632,0.0001,408,396,100,25,0.01,804,8
0.696,0.0001,453,451,100,25,0.01,904,8
0.74,0.0001,504,500,100,25,0.01,1004,8
0.792,0.0001,556,548,100,25,0.01,1104,8
0.834,0.0001,616,588,100,25,0.01,1204,8
0.872,0.0001,671,633,100,25,0.01,1304,8
0.89,0.0001,721,683,100,25,0.01,1404,8
0.906,0.0001,766,738,100,25,0.01,1504,8
0.928,0.0001,818,786,100,25,0.01,1604,8
0.942,0.0001,865,839,100,25,0.01,1704,8
0.954,0.0001,911,893,100,25,0.01,1804,8
0.946,0.0001,961,943,100,25,0.01,1904,8
0.96,0.0001,1015,989,100,25,0.01,2004,8
0.502,0.0001,56,48,100,25,0.01,104,9
0.522,0.0001,110,94,100,25,0.01,204,9
0.54,0.0001,156,148,100,25,0.01,304,9
0.562,0.0001,205,199,100,25,0.01,404,9
0.59,0.0001,257,247,100,25,0.01,504,9
0.638,0.0001,306,298,100,25,0.01,604,9
0.666,0.0001,362,342,100,25,0.01,704,9
0.702,0.0001,409,395,100,25,0.01,804,9
0.738,0.0001,464,440,100,25,0.01,904,9
0.772,0.0001,508,496,100,25,0.01,1004,9
0.816,0.0001,561,543,100,25,0.01,1104,9
0.878,0.0001,611,593,100,25,0.01,1204,9
0.902,0.0001,654,650,100,25,0.01,1304,9
0.934,0.0001,708,696,100,25,0.01,1404,9
0.946,0.0001,751,753,100,25,0.01,1504,9
0.946,0.0001,800,804,100,25,0.01,1604,9
0.95,0.0001,857,847,100,25,0.01,1704,9
0.956,0.0001,906,898,100,25,0.01,1804,9
0.968,0.0001,952,952,100,25,0.01,1904,9
0.97,0.0001,1001,1003,100,25,0.01,2004,9
0.496,0.0001,55,49,100,25,0.01,104,10
0.508,0.0001,100,104,100,25,0.01,204,10
0.514,0.0001,156,148,100,25,0.01,304,10
0.542,0.0001,203,201,100,25,0.01,404,10
0.534,0.0001,254,250,100,25,0.01,504,10
0.576,0.0001,299,305,100,25,0.01,604,10
0.622,0.0001,354,350,100,25,0.01,704,10
0.716,0.0001,403,401,100,25,0.01,804,10
0.75,0.0001,457,447,100,25,0.01,904,10
0.81,0.0001,506,498,100,25,0.01,1004,10
0.82,0.0001,554,550,100,25,0.01,1104,10
0.884,0.0001,605,599,100,25,0.01,1204,10
0.898,0.0001,656,648,100,25,0.01,1304,10
0.912,0.0001,709,695,100,25,0.01,1404,10
0.924,0.0001,752,752,100,25,0.01,1504,10
0.934,0.0001,797,807,100,25,0.01,1604,10
0.938,0.0001,850,854,100,25,0.01,1704,10
0.942,0.0001,904,900,100,25,0.01,1804,10
0.946,0.0001,959,945,100,25,0.01,1904,10
0.946,0.0001,1012,992,100,25,0.01,2004,10
0.532,0.0001,53,51,100,25,0.01,104,11
0.578,0.0001,111,93,100,25,0.01,204,11
0.542,0.0001,161,143,100,25,0.01,304,11
0.558,0.0001,219,185,100,25,0.01,404,11
0.57,0.0001,267,237,100,25,0.01,504,11
0.596,0.0001,309,295,100,25,0.01,604,11
0.612,0.0001,355,349,100,25,0.01,704,11
0.644,0.0001,396,408,100,25,0.01,804,11
0.666,0.0001,453,451,100,25,0.01,904,11
0.706,0.0001,503,501,100,25,0.01,1004,11
0.78,0.0001,555,549,100,25,0.01,1104,11
0.812,0.0001,618,586,100,25,0.01,1204,11
0.846,0.0001,669,635,100,25,0.01,1304,11
0.868,0.0001,709,695,100,25,0.01,1404,11
0.892,0.0001,752,752,100,25,0.01,1504,11
0.916,0.0001,797,807,100,25,0.01,1604,11
0.926,0.0001,849,855,100,25,0.01,1704,11
0.932,0.0001,896,908,100,25,0.01,1804,11
0.936,0.0001,940,964,100,25,0.01,1904,11
0.94,0.0001,980,1024,100,25,0.01,2004,11
0.534,0.0001,35,69,100,25,0.01,104,12
0.532,0.0001,82,122,100,25,0.01,204,12
0.536,0.0001,132,172,100,25,0.01,304,12
0.544,0.0001,179,225,100,25,0.01,404,12
0.548,0.0001,235,269,100,25,0.01,504,12
0.586,0.0001,289,315,100,25,0.01,604,12
0.61,0.0001,346,358,100,25,0.01,704,12
0.646,0.0001,397,407,100,25,0.01,804,12
0.684,0.0001,441,463,100,25,0.01,904,12
0.738,0.0001,495,509,100,25,0.01,1004,12
0.788,0.0001,552,552,100,25,0.01,1104,12
0.86,0.0001,591,613,100,25,0.01,1204,12
0.884,0.0001,639,665,100,25,0.01,1304,12
0.91,0.0001,693,711,100,25,0.01,1404,12
0.912,0.0001,743,761,100,25,0.01,1504,12
0.93,0.0001,787,817,100,25,0.01,1604,12
0.936,0.0001,844,860,100,25,0.01,1704,12
0.948,0.0001,896,908,100,25,0.01,1804,12
0.954,0.0001,946,958,100,25,0.01,1904,12
0.954,0.0001,1006,998,100,25,0.01,2004,12
0.532,0.0001,43,61,100,25,0.01,104,13
0.544,0.0001,95,109,100,25,0.01,204,13
0.546,0.0001,136,168,100,25,0.01,304,13
0.57,0.0001,186,218,100,25,0.01,404,13
0.582,0.0001,232,272,100,25,0.01,504,13
0.62,0.0001,283,321,100,25,0.01,604,13
0.654,0.0001,342,362,100,25,0.01,704,13
0.684,0.0001,396,408,100,25,0.01,804,13
0.702,0.0001,445,459,100,25,0.01,904,13
0.758,0.0001,500,504,100,25,0.01,1004,13
0.79,0.0001,550,554,100,25,0.01,1104,13
0.838,0.0001,598,606,100,25,0.01,1204,13
0.866,0.0001,642,662,100,25,0.01,1304,13
0.91,0.0001,693,711,100,25,0.01,1404,13
0.928,0.0001,737,767,100,25,0.01,1504,13
0.934,0.0001,790,814,100,25,0.01,1604,13
0.93,0.0001,840,864,100,25,0.01,1704,13
0.95,0.0001,896,908,100,25,0.01,1804,13
0.954,0.0001,954,950,100,25,0.01,1904,13
0.96,0.0001,1004,1000,100,25,0.01,2004,13
0.47,0.0001,49,55,100,25,0.01,104,14
0.492,0.0001,99,105,100,25,0.01,204,14
0.48,0.0001,150,154,100,25,0.01,304,14
0.498,0.0001,207,197,100,25,0.01,404,14
0.52,0.0001,261,243,100,25,0.01,504,14
0.552,0.0001,310,294,100,25,0.01,604,14
0.602,0.0001,354,350,100,25,0.01,704,14
0.678,0.0001,410,394,100,25,0.01,804,14
0.724,0.0001,455,449,100,25,0.01,904,14
0.782,0.0001,505,499,100,25,0.01,1004,14
0.828,0.0001,565,539,100,25,0.01,1104,14
0.87,0.0001,613,591,100,25,0.01,1204,14
0.894,0.0001,660,644,100,25,0.01,1304,14
0.918,0.0001,700,704,100,25,0.01,1404,14
0.924,0.0001,738,766,100,25,0.01,1504,14
0.92,0.0001,795,809,100,25,0.01,1604,14
0.932,0.0001,843,861,100,25,0.01,1704,14
0.946,0.0001,892,912,100,25,0.01,1804,14
0.946,0.0001,942,962,100,25,0.01,1904,14
0.958,0.0001,997,1007,100,25,0.01,2004,14
0.5,0.0001,56,48,100,25,0.01,104,15
0.516,0.0001,110,94,100,25,0.01,204,15
0.55,0.0001,158,146,100,25,0.01,304,15
0.556,0.0001,208,196,100,25,0.01,404,15
0.57,0.0001,253,251,100,25,0.01,504,15
0.618,0.0001,298,306,100,25,0.01,604,15
0.656,0.0001,351,353,100,25,0.01,704,15
0.704,0.0001,397,407,100,25,0.01,804,15
0.74,0.0001,444,460,100,25,0.01,904,15
0.764,0.0001,496,508,100,25,0.01,1004,15
0.802,0.0001,554,550,100,25,0.01,1104,15
0.864,0.0001,599,605,100,25,0.01,1204,15
0.9,0.0001,649,655,100,25,0.01,1304,15
0.92,0.0001,698,706,100,25,0.01,1404,15
0.93,0.0001,752,752,100,25,0.01,1504,15
0.948,0.0001,800,804,100,25,0.01,1604,15
0.952,0.0001,853,851,100,25,0.01,1704,15
0.954,0.0001,905,899,100,25,0.01,1804,15
0.956,0.0001,957,947,100,25,0.01,1904,15
0.96,0.0001,1016,988,100,25,0.01,2004,15
0.526,0.0001,49,55,100,25,0.01,104,16
0.53,0.0001,100,104,100,25,0.01,204,16
0.55,0.0001,159,145,100,25,0.01,304,16
0.576,0.0001,206,198,100,25,0.01,404,16
0.598,0.0001,252,252,100,25,0.01,504,16
0.626,0.0001,304,300,100,25,0.01,604,16
0.652,0.0001,356,348,100,25,0.01,704,16
0.704,0.0001,406,398,100,25,0.01,804,16
0.742,0.0001,453,451,100,25,0.01,904,16
0.792,0.0001,487,517,100,25,0.01,1004,16
0.818,0.0001,533,571,100,25,0.01,1104,16
0.846,0.0001,588,616,100,25,0.01,1204,16
0.878,0.0001,638,666,100,25,0.01,1304,16
0.91,0.0001,688,716,100,25,0.01,1404,16
0.926,0.0001,734,770,100,25,0.01,1504,16
0.948,0.0001,788,816,100,25,0.01,1604,16
0.944,0.0001,845,859,100,25,0.01,1704,16
0.948,0.0001,896,908,100,25,0.01,1804,16
0.942,0.0001,942,962,100,25,0.01,1904,16
0.948,0.0001,990,1014,100,25,0.01,2004,16
0.52,0.0001,45,59,100,25,0.01,104,17
0.542,0.0001,99,105,100,25,0.01,204,17
0.544,0.0001,145,159,100,25,0.01,304,17
0.556,0.0001,198,206,100,25,0.01,404,17
0.566,0.0001,248,256,100,25,0.01,504,17
0.576,0.0001,301,303,100,25,0.01,604,17
0.586,0.0001,355,349,100,25,0.01,704,17
0.618,0.0001,401,403,100,25,0.01,804,17
0.63,0.0001,448,456,100,25,0.01,904,17
0.7,0.0001,497,507,100,25,0.01,1004,17
0.762,0.0001,543,561,100,25,0.01,1104,17
0.828,0.0001,587,617,100,25,0.01,1204,17
0.862,0.0001,635,669,100,25,0.01,1304,17
0.908,0.0001,682,722,100,25,0.01,1404,17
0.902,0.0001,741,763,100,25,0.01,1504,17
0.92,0.0001,800,804,100,25,0.01,1604,17
0.928,0.0001,854,850,100,25,0.01,1704,17
0.932,0.0001,905,899,100,25,0.01,1804,17
0.942,0.0001,950,954,100,25,0.01,1904,17
0.946,0.0001,1004,1000,100,25,0.01,2004,17
0.542,0.0001,56,48,100,25,0.01,104,18
0.562,0.0001,96,108,100,25,0.01,204,18
0.582,0.0001,148,156,100,25,0.01,304,18
0.592,0.0001,200,204,100,25,0.01,404,18
0.604,0.0001,244,260,100,25,0.01,504,18
0.624,0.0001,294,310,100,25,0.01,604,18
0.642,0.0001,350,354,100,25,0.01,704,18
0.688,0.0001,397,407,100,25,0.01,804,18
0.712,0.0001,446,458,100,25,0.01,904,18
0.776,0.0001,492,512,100,25,0.01,1004,18
0.832,0.0001,531,573,100,25,0.01,1104,18
0.866,0.0001,585,619,100,25,0.01,1204,18
0.902,0.0001,630,674,100,25,0.01,1304,18
0.924,0.0001,679,725,100,25,0.01,1404,18
0.94,0.0001,727,777,100,25,0.01,1504,18
0.952,0.0001,781,823,100,25,0.01,1604,18
0.956,0.0001,838,866,100,25,0.01,1704,18
0.954,0.0001,886,918,100,25,0.01,1804,18
0.95,0.0001,947,957,100,25,0.01,1904,18
0.958,0.0001,997,1007,100,25,0.01,2004,18
0.504,0.0001,46,58,100,25,0.01,104,19
0.538,0.0001,97,107,100,25,0.01,204,19
0.552,0.0001,148,156,100,25,0.01,304,19
0.582,0.0001,208,196,100,25,0.01,404,19
0.592,0.0001,252,252,100,25,0.01,504,19
0.622,0.0001,298,306,100,25,0.01,604,19
0.638,0.0001,350,354,100,25,0.01,704,19
0.664,0.0001,395,409,100,25,0.01,804,19
0.706,0.0001,446,458,100,25,0.01,904,19
0.73,0.0001,496,508,100,25,0.01,1004,19
0.784,0.0001,549,555,100,25,0.01,1104,19
0.832,0.0001,590,614,100,25,0.01,1204,19
0.852,0.0001,643,661,100,25,0.01,1304,19
0.898,0.0001,698,706,100,25,0.01,1404,19
0.918,0.0001,750,754,100,25,0.01,1504,19
0.922,0.0001,803,801,100,25,0.01,1604,19
0.928,0.0001,853,851,100,25,0.01,1704,19
0.93,0.0001,901,903,100,25,0.01,1804,19
0.932,0.0001,950,954,100,25,0.01,1904,19
0.934,0.0001,999,1005,100,25,0.01,2004,19
0.492,0.0001,55,49,100,25,0.01,104,20
0.504,0.0001,101,103,100,25,0.01,204,20
0.53,0.0001,150,154,100,25,0.01,304,20
0.54,0.0001,203,201,100,25,0.01,404,20
0.552,0.0001,248,256,100,25,0.01,504,20
0.584,0.0001,296,308,100,25,0.01,604,20
0.636,0.0001,342,362,100,25,0.01,704,20
0.68,0.0001,396,408,100,25,0.01,804,20
0.712,0.0001,450,454,100,25,0.01,904,20
0.742,0.0001,497,507,100,25,0.01,1004,20
0.768,0.0001,549,555,100,25,0.01,1104,20
0.822,0.0001,599,605,100,25,0.01,1204,20
0.85,0.0001,650,654,100,25,0.01,1304,20
0.878,0.0001,700,704,100,25,0.01,1404,20
0.906,0.0001,749,755,100,25,0.01,1504,20
0.912,0.0001,794,810,100,25,0.01,1604,20
0.918,0.0001,845,859,100,25,0.01,1704,20
0.918,0.0001,895,909,100,25,0.01,1804,20
0.918,0.0001,942,962,100,25,0.01,1904,20
0.924,0.0001,988,1016,100,25,0.01,2004,20
0.528,0.001,45,59,100,25,0.0001,104,1
0.524,0.001,101,103,100,25,0.0001,204,1
0.524,0.001,153,151,100,25,0.0001,304,1
0.524,0.001,207,197,100,25,0.0001,404,1
0.524,0.001,268,236,100,25,0.0001,504,1
0.524,0.001,326,278,100,25,0.0001,604,1
0.524,0.001,370,334,100,25,0.0001,704,1
0.522,0.001,417,387,100,25,0.0001,804,1
0.522,0.001,461,443,100,25,0.0001,904,1
0.524,0.001,510,494,100,25,0.0001,1004,1
0.526,0.001,560,544,100,25,0.0001,1104,1
0.524,0.001,623,581,100,25,0.0001,1204,1
0.524,0.001,675,629,100,25,0.0001,1304,1
0.524,0.001,720,684,100,25,0.0001,1404,1
0.526,0.001,773,731,100,25,0.0001,1504,1
0.526,0.001,822,782,100,25,0.0001,1604,1
0.522,0.001,864,840,100,25,0.0001,1704,1
0.522,0.001,917,887,100,25,0.0001,1804,1
0.522,0.001,961,943,100,25,0.0001,1904,1
0.524,0.001,1009,995,100,25,0.0001,2004,1
0.514,0.001,61,43,100,25,0.0001,104,2
0.514,0.001,115,89,100,25,0.0001,204,2
0.514,0.001,163,141,100,25,0.0001,304,2
0.512,0.001,219,185,100,25,0.0001,404,2
0.512,0.001,267,237,100,25,0.0001,504,2
0.512,0.001,314,290,100,25,0.0001,604,2
0.514,0.001,360,344,100,25,0.0001,704,2
0.514,0.001,408,396,100,25,0.0001,804,2
0.514,0.001,457,447,100,25,0.0001,904,2
0.514,0.001,503,501,100,25,0.0001,1004,2
0.516,0.001,550,554,100,25,0.0001,1104,2
0.518,0.001,602,602,100,25,0.0001,1204,2
0.518,0.001,648,656,100,25,0.0001,1304,2
0.516,0.001,698,706,100,25,0.0001,1404,2
0.516,0.001,745,759,100,25,0.0001,1504,2
0.516,0.001,791,813,100,25,0.0001,1604,2
0.52,0.001,850,854,100,25,0.0001,1704,2
0.52,0.001,903,901,100,25,0.0001,1804,2
0.518,0.001,945,959,100,25,0.0001,1904,2
0.518,0.001,999,1005,100,25,0.0001,2004,2
0.492,0.001,55,49,100,25,0.0001,104,3
0.494,0.001,105,99,100,25,0.0001,204,3
0.494,0.001,160,144,100,25,0.0001,304,3
0.494,0.001,211,193,100,25,0.0001,404,3
0.496,0.001,257,247,100,25,0.0001,504,3
0.502,0.001,309,295,100,25,0.0001,604,3
0.502,0.001,359,345,100,25,0.0001,704,3
0.504,0.001,410,394,100,25,0.0001,804,3
0.502,0.001,460,444,100,25,0.0001,904,3
0.498,0.001,508,496,100,25,0.0001,1004,3
0.498,0.001,561,543,100,25,0.0001,1104,3
0.496,0.001,614,590,100,25,0.0001,1204,3
0.496,0.001,665,639,100,25,0.0001,1304,3
0.498,0.001,712,692,100,25,0.0001,1404,3
0.496,0.001,758,746,100,25,0.0001,1504,3
0.498,0.001,805,799,100,25,0.0001,1604,3
0.502,0.001,862,842,100,25,0.0001,1704,3
0.5,0.001,909,895,100,25,0.0001,1804,3
0.498,0.001,953,951,100,25,0.0001,1904,3
0.502,0.001,1000,1004,100,25,0.0001,2004,3
0.476,0.001,46,58,100,25,0.0001,104,4
0.476,0.001,107,97,100,25,0.0001,204,4
0.478,0.001,157,147,100,25,0.0001,304,4
0.476,0.001,206,198,100,25,0.0001,404,4
0.476,0.001,249,255,100,25,0.0001,504,4
0.478,0.001,292,312,100,25,0.0001,604,4
0.478,0.001,341,363,100,25,0.0001,704,4
0.48,0.001,399,405,100,25,0.0001,804,4
0.482,0.001,458,446,100,25,0.0001,904,4
0.482,0.001,505,499,100,25,0.0001,1004,4
0.484,0.001,557,547,100,25,0.0001,1104,4
0.484,0.001,607,597,100,25,0.0001,1204,4
0.484,0.001,654,650,100,25,0.0001,1304,4
0.486,0.001,711,693,100,25,0.0001,1404,4
0.486,0.001,765,739,100,25,0.0001,1504,4
0.484,0.001,815,789,100,25,0.0001,1604,4
0.482,0.001,868,836,100,25,0.0001,1704,4
0.484,0.001,914,890,100,25,0.0001,1804,4
0.488,0.001,960,944,100,25,0.0001,1904,4
0.49,0.001,1004,1000,100,25,0.0001,2004,4
0.484,0.001,61,43,100,25,0.0001,104,5
0.484,0.001,117,87,100,25,0.0001,204,5
0.484,0.001,166,138,100,25,0.0001,304,5
0.484,0.001,217,187,100,25,0.0001,404,5
0.484,0.001,259,245,100,25,0.0001,504,5
0.484,0.001,309,295,100,25,0.0001,604,5
0.484,0.001,363,341,100,25,0.0001,704,5
0.484,0.001,407,397,100,25,0.0001,804,5
0.484,0.001,453,451,100,25,0.0001,904,5
0.484,0.001,505,499,100,25,0.0001,1004,5
0.484,0.001,562,542,100,25,0.0001,1104,5
0.484,0.001,612,592,100,25,0.0001,1204,5
0.484,0.001,662,642,100,25,0.0001,1304,5
0.484,0.001,712,692,100,25,0.0001,1404,5
0.484,0.001,760,744,100,25,0.0001,1504,5
0.484,0.001,810,794,100,25,0.0001,1604,5
0.486,0.001,854,850,100,25,0.0001,1704,5
0.486,0.001,889,915,100,25,0.0001,1804,5
0.488,0.001,946,958,100,25,0.0001,1904,5
0.488,0.001,991,1013,100,25,0.0001,2004,5
0.51,0.001,59,45,100,25,0.0001,104,6
0.51,0.001,111,93,100,25,0.0001,204,6
0.508,0.001,168,136,100,25,0.0001,304,6
0.508,0.001,227,177,100,25,0.0001,404,6
0.508,0.001,284,220,100,25,0.0001,504,6
0.506,0.001,333,271,100,25,0.0001,604,6
0.506,0.001,380,324,100,25,0.0001,704,6
0.504,0.001,431,373,100,25,0.0001,804,6
0.504,0.001,480,424,100,25,0.0001,904,6
0.506,0.001,531,473,100,25,0.0001,1004,6
0.506,0.001,577,527,100,25,0.0001,1104,6
0.506,0.001,626,578,100,25,0.0001,1204,6
0.506,0.001,663,641,100,25,0.0001,1304,6
0.508,0.001,714,690,100,25,0.0001,1404,6
0.508,0.001,760,744,100,25,0.0001,1504,6
0.508,0.001,801,803,100,25,0.0001,1604,6
0.506,0.001,851,853,100,25,0.0001,1704,6
0.504,0.001,901,903,100,25,0.0001,1804,6
0.502,0.001,953,951,100,25,0.0001,1904,6
0.504,0.001,999,1005,100,25,0.0001,2004,6
0.5,0.001,49,55,100,25,0.0001,104,7
0.502,0.001,106,98,100,25,0.0001,204,7
0.5,0.001,159,145,100,25,0.0001,304,7
0.5,0.001,204,200,100,25,0.0001,404,7
0.5,0.001,254,250,100,25,0.0001,504,7
0.502,0.001,310,294,100,25,0.0001,604,7
0.502,0.001,359,345,100,25,0.0001,704,7
0.502,0.001,412,392,100,25,0.0001,804,7
0.504,0.001,461,443,100,25,0.0001,904,7
0.504,0.001,506,498,100,25,0.0001,1004,7
0.506,0.001,554,550,100,25,0.0001,1104,7
0.502,0.001,607,597,100,25,0.0001,1204,7
0.506,0.001,660,644,100,25,0.0001,1304,7
0.512,0.001,704,700,100,25,0.0001,1404,7
0.512,0.001,755,749,100,25,0.0001,1504,7
0.514,0.001,809,795,100,25,0.0001,1604,7
0.516,0.001,857,847,100,25,0.0001,1704,7
0.524,0.001,907,897,100,25,0.0001,1804,7
0.524,0.001,957,947,100,25,0.0001,1904,7
0.526,0.001,1004,1000,100,25,0.0001,2004,7
0.506,0.001,53,51,100,25,0.0001,104,8
0.506,0.001,110,94,100,25,0.0001,204,8
0.506,0.001,156,148,100,25,0.0001,304,8
0.5,0.001,196,208,100,25,0.0001,404,8
0.506,0.001,247,257,100,25,0.0001,504,8
0.506,0.001,301,303,100,25,0.0001,604,8
0.508,0.001,355,349,100,25,0.0001,704,8
0.51,0.001,405,399,100,25,0.0001,804,8
0.506,0.001,456,448,100,25,0.0001,904,8
0.504,0.001,504,500,100,25,0.0001,1004,8
0.508,0.001,562,542,100,25,0.0001,1104,8
0.506,0.001,611,593,100,25,0.0001,1204,8
0.506,0.001,654,650,100,25,0.0001,1304,8
0.506,0.001,699,705,100,25,0.0001,1404,8
0.504,0.001,756,748,100,25,0.0001,1504,8
0.504,0.001,806,798,100,25,0.0001,1604,8
0.506,0.001,857,847,100,25,0.0001,1704,8
0.506,0.001,908,896,100,25,0.0001,1804,8
0.506,0.001,955,949,100,25,0.0001,1904,8
0.51,0.001,1007,997,100,25,0.0001,2004,8
0.472,0.001,49,55,100,25,0.0001,104,9
0.476,0.001,101,103,100,25,0.0001,204,9
0.476,0.001,143,161,100,25,0.0001,304,9
0.472,0.001,190,214,100,25,0.0001,404,9
0.472,0.001,243,261,100,25,0.0001,504,9
0.474,0.001,302,302,100,25,0.0001,604,9
0.474,0.001,357,347,100,25,0.0001,704,9
0.474,0.001,414,390,100,25,0.0001,804,9
0.474,0.001,467,437,100,25,0.0001,904,9
0.48,0.001,516,488,100,25,0.0001,1004,9
0.484,0.001,567,537,100,25,0.0001,1104,9
0.482,0.001,624,580,100,25,0.0001,1204,9
0.48,0.001,671,633,100,25,0.0001,1304,9
0.482,0.001,718,686,100,25,0.0001,1404,9
0.482,0.001,768,736,100,25,0.0001,1504,9
0.478,0.001,819,785,100,25,0.0001,1604,9
0.478,0.001,864,840,100,25,0.0001,1704,9
0.476,0.001,907,897,100,25,0.0001,1804,9
0.476,0.001,948,956,100,25,0.0001,1904,9
0.476,0.001,994,1010,100,25,0.0001,2004,9
0.534,0.001,47,57,100,25,0.0001,104,10
0.534,0.001,97,107,100,25,0.0001,204,10
0.534,0.001,139,165,100,25,0.0001,304,10
0.534,0.001,179,225,100,25,0.0001,404,10
0.538,0.001,239,265,100,25,0.0001,504,10
0.54,0.001,286,318,100,25,0.0001,604,10
0.542,0.001,330,374,100,25,0.0001,704,10
0.544,0.001,380,424,100,25,0.0001,804,10
0.546,0.001,432,472,100,25,0.0001,904,10
0.55,0.001,485,519,100,25,0.0001,1004,10
0.55,0.001,536,568,100,25,0.0001,1104,10
0.556,0.001,582,622,100,25,0.0001,1204,10
0.554,0.001,632,672,100,25,0.0001,1304,10
0.556,0.001,686,718,100,25,0.0001,1404,10
0.556,0.001,743,761,100,25,0.0001,1504,10
0.56,0.001,791,813,100,25,0.0001,1604,10
0.558,0.001,844,860,100,25,0.0001,1704,10
0.558,0.001,899,905,100,25,0.0001,1804,10
0.558,0.001,957,947,100,25,0.0001,1904,10
0.558,0.001,1005,999,100,25,0.0001,2004,10
0.446,0.001,56,48,100,25,0.0001,104,11
0.446,0.001,99,105,100,25,0.0001,204,11
0.446,0.001,153,151,100,25,0.0001,304,11
0.446,0.001,202,202,100,25,0.0001,404,11
0.446,0.001,247,257,100,25,0.0001,504,11
0.444,0.001,292,312,100,25,0.0001,604,11
0.444,0.001,334,370,100,25,0.0001,704,11
0.444,0.001,388,416,100,25,0.0001,804,11
0.444,0.001,440,464,100,25,0.0001,904,11
0.444,0.001,488,516,100,25,0.0001,1004,11
0.444,0.001,533,571,100,25,0.0001,1104,11
0.446,0.001,584,620,100,25,0.0001,1204,11
0.446,0.001,639,665,100,25,0.0001,1304,11
0.448,0.001,693,711,100,25,0.0001,1404,11
0.444,0.001,745,759,100,25,0.0001,1504,11
0.446,0.001,794,810,100,25,0.0001,1604,11
0.448,0.001,847,857,100,25,0.0001,1704,11
0.448,0.001,891,913,100,25,0.0001,1804,11
0.444,0.001,935,969,100,25,0.0001,1904,11
0.444,0.001,990,1014,100,25,0.0001,2004,11
0.434,0.001,55,49,100,25,0.0001,104,12
0.432,0.001,106,98,100,25,0.0001,204,12
0.43,0.001,159,145,100,25,0.0001,304,12
0.432,0.001,207,197,100,25,0.0001,404,12
0.432,0.001,265,239,100,25,0.0001,504,12
0.43,0.001,313,291,100,25,0.0001,604,12
0.432,0.001,359,345,100,25,0.0001,704,12
0.434,0.001,409,395,100,25,0.0001,804,12
0.434,0.001,456,448,100,25,0.0001,904,12
0.432,0.001,505,499,100,25,0.0001,1004,12
0.44,0.001,559,545,100,25,0.0001,1104,12
0.44,0.001,619,585,100,25,0.0001,1204,12
0.442,0.001,669,635,100,25,0.0001,1304,12
0.438,0.001,718,686,100,25,0.0001,1404,12
0.434,0.001,757,747,100,25,0.0001,1504,12
0.43,0.001,803,801,100,25,0.0001,1604,12
0.432,0.001,864,840,100,25,0.0001,1704,12
0.432,0.001,920,884,100,25,0.0001,1804,12
0.438,0.001,972,932,100,25,0.0001,1904,12
0.444,0.001,1026,978,100,25,0.0001,2004,12
0.446,0.001,47,57,100,25,0.0001,104,13
0.446,0.001,101,103,100,25,0.0001,204,13
0.446,0.001,157,147,100,25,0.0001,304,13
0.448,0.001,205,199,100,25,0.0001,404,13
0.448,0.001,249,255,100,25,0.0001,504,13
0.45,0.001,300,304,100,25,0.0001,604,13
0.45,0.001,353,351,100,25,0.0001,704,13
0.45,0.001,405,399,100,25,0.0001,804,13
0.448,0.001,452,452,100,25,0.0001,904,13
0.448,0.001,503,501,100,25,0.0001,1004,13
0.448,0.001,557,547,100,25,0.0001,1104,13
0.45,0.001,605,599,100,25,0.0001,1204,13
0.452,0.001,649,655,100,25,0.0001,1304,13
0.452,0.001,699,705,100,25,0.0001,1404,13
0.454,0.001,751,753,100,25,0.0001,1504,13
0.456,0.001,801,803,100,25,0.0001,1604,13
0.458,0.001,854,850,100,25,0.0001,1704,13
0.46,0.001,909,895,100,25,0.0001,1804,13
0.464,0.001,956,948,100,25,0.0001,1904,13
0.464,0.001,1009,995,100,25,0.0001,2004,13
0.53,0.001,53,51,100,25,0.0001,104,14
0.526,0.001,107,97,100,25,0.0001,204,14
0.528,0.001,155,149,100,25,0.0001,304,14
0.528,0.001,208,196,100,25,0.0001,404,14
0.528,0.001,253,251,100,25,0.0001,504,14
0.532,0.001,308,296,100,25,0.0001,604,14
0.532,0.001,352,352,100,25,0.0001,704,14
0.532,0.001,401,403,100,25,0.0001,804,14
0.532,0.001,457,447,100,25,0.0001,904,14
0.53,0.001,513,491,100,25,0.0001,1004,14
0.532,0.001,565,539,100,25,0.0001,1104,14
0.538,0.001,613,591,100,25,0.0001,1204,14
0.536,0.001,661,643,100,25,0.0001,1304,14
0.536,0.001,714,690,100,25,0.0001,1404,14
0.538,0.001,756,748,100,25,0.0001,1504,14
0.538,0.001,806,798,100,25,0.0001,1604,14
0.538,0.001,858,846,100,25,0.0001,1704,14
0.536,0.001,901,903,100,25,0.0001,1804,14
0.534,0.001,958,946,100,25,0.0001,1904,14
0.534,0.001,998,1006,100,25,0.0001,2004,14
0.514,0.001,45,59,100,25,0.0001,104,15
0.512,0.001,89,115,100,25,0.0001,204,15
0.51,0.001,145,159,100,25,0.0001,304,15
0.512,0.001,196,208,100,25,0.0001,404,15
0.512,0.001,246,258,100,25,0.0001,504,15
0.51,0.001,284,320,100,25,0.0001,604,15
0.51,0.001,334,370,100,25,0.0001,704,15
0.51,0.001,377,427,100,25,0.0001,804,15
0.514,0.001,428,476,100,25,0.0001,904,15
0.512,0.001,477,527,100,25,0.0001,1004,15
0.512,0.001,528,576,100,25,0.0001,1104,15
0.512,0.001,577,627,100,25,0.0001,1204,15
0.516,0.001,625,679,100,25,0.0001,1304,15
0.516,0.001,670,734,100,25,0.0001,1404,15
0.518,0.001,726,778,100,25,0.0001,1504,15
0.518,0.001,774,830,100,25,0.0001,1604,15
0.526,0.001,827,877,100,25,0.0001,1704,15
0.524,0.001,891,913,100,25,0.0001,1804,15
0.532,0.001,947,957,100,25,0.0001,1904,15
0.536,0.001,1000,1004,100,25,0.0001,2004,15
0.46,0.001,57,47,100,25,0.0001,104,16
0.46,0.001,110,94,100,25,0.0001,204,16
0.458,0.001,170,134,100,25,0.0001,304,16
0.458,0.001,222,182,100,25,0.0001,404,16
0.46,0.001,270,234,100,25,0.0001,504,16
0.46,0.001,318,286,100,25,0.0001,604,16
0.46,0.001,360,344,100,25,0.0001,704,16
0.462,0.001,406,398,100,25,0.0001,804,16
0.462,0.001,454,450,100,25,0.0001,904,16
0.462,0.001,506,498,100,25,0.0001,1004,16
0.46,0.001,553,551,100,25,0.0001,1104,16
0.46,0.001,599,605,100,25,0.0001,1204,16
0.46,0.001,650,654,100,25,0.0001,1304,16
0.462,0.001,688,716,100,25,0.0001,1404,16
0.462,0.001,737,767,100,25,0.0001,1504,16
0.462,0.001,786,818,100,25,0.0001,1604,16
0.462,0.001,824,880,100,25,0.0001,1704,16
0.462,0.001,862,942,100,25,0.0001,1804,16
0.462,0.001,925,979,100,25,0.0001,1904,16
0.462,0.001,982,1022,100,25,0.0001,2004,16
0.45,0.001,58,46,100,25,0.0001,104,17
0.454,0.001,111,93,100,25,0.0001,204,17
0.456,0.001,156,148,100,25,0.0001,304,17
0.456,0.001,202,202,100,25,0.0001,404,17
0.456,0.001,250,254,100,25,0.0001,504,17
0.456,0.001,298,306,100,25,0.0001,604,17
0.456,0.001,347,357,100,25,0.0001,704,17
0.464,0.001,385,419,100,25,0.0001,804,17
0.464,0.001,443,461,100,25,0.0001,904,17
0.464,0.001,490,514,100,25,0.0001,1004,17
0.466,0.001,538,566,100,25,0.0001,1104,17
0.466,0.001,582,622,100,25,0.0001,1204,17
0.466,0.001,630,674,100,25,0.0001,1304,17
0.468,0.001,686,718,100,25,0.0001,1404,17
0.47,0.001,740,764,100,25,0.0001,1504,17
0.474,0.001,802,802,100,25,0.0001,1604,17
0.478,0.001,851,853,100,25,0.0001,1704,17
0.478,0.001,899,905,100,25,0.0001,1804,17
0.484,0.001,946,958,100,25,0.0001,1904,17
0.484,0.001,994,1010,100,25,0.0001,2004,17
0.476,0.001,51,53,100,25,0.0001,104,18
0.476,0.001,98,106,100,25,0.0001,204,18
0.476,0.001,147,157,100,25,0.0001,304,18
0.476,0.001,196,208,100,25,0.0001,404,18
0.476,0.001,243,261,100,25,0.0001,504,18
0.476,0.001,299,305,100,25,0.0001,604,18
0.476,0.001,343,361,100,25,0.0001,704,18
0.478,0.001,402,402,100,25,0.0001,804,18
0.48,0.001,448,456,100,25,0.0001,904,18
0.482,0.001,497,507,100,25,0.0001,1004,18
0.484,0.001,550,554,100,25,0.0001,1104,18
0.486,0.001,599,605,100,25,0.0001,1204,18
0.486,0.001,646,658,100,25,0.0001,1304,18
0.48,0.001,696,708,100,25,0.0001,1404,18
0.474,0.001,744,760,100,25,0.0001,1504,18
0.476,0.001,798,806,100,25,0.0001,1604,18
0.474,0.001,851,853,100,25,0.0001,1704,18
0.476,0.001,902,902,100,25,0.0001,1804,18
0.478,0.001,960,944,100,25,0.0001,1904,18
0.478,0.001,1012,992,100,25,0.0001,2004,18
0.474,0.001,60,44,100,25,0.0001,104,19
0.474,0.001,107,97,100,25,0.0001,204,19
0.474,0.001,159,145,100,25,0.0001,304,19
0.474,0.001,205,199,100,25,0.0001,404,19
0.476,0.001,254,250,100,25,0.0001,504,19
0.476,0.001,306,298,100,25,0.0001,604,19
0.476,0.001,354,350,100,25,0.0001,704,19
0.476,0.001,414,390,100,25,0.0001,804,19
0.476,0.001,462,442,100,25,0.0001,904,19
0.474,0.001,505,499,100,25,0.0001,1004,19
0.474,0.001,550,554,100,25,0.0001,1104,19
0.474,0.001,601,603,100,25,0.0001,1204,19
0.474,0.001,655,649,100,25,0.0001,1304,19
0.476,0.001,703,701,100,25,0.0001,1404,19
0.478,0.001,760,744,100,25,0.0001,1504,19
0.48,0.001,806,798,100,25,0.0001,1604,19
0.484,0.001,858,846,100,25,0.0001,1704,19
0.484,0.001,908,896,100,25,0.0001,1804,19
0.484,0.001,960,944,100,25,0.0001,1904,19
0.486,0.001,1017,987,100,25,0.0001,2004,19
0.506,0.001,49,55,100,25,0.0001,104,20
0.506,0.001,102,102,100,25,0.0001,204,20
0.506,0.001,148,156,100,25,0.0001,304,20
0.506,0.001,195,209,100,25,0.0001,404,20
0.506,0.001,241,263,100,25,0.0001,504,20
0.508,0.001,280,324,100,25,0.0001,604,20
0.512,0.001,342,362,100,25,0.0001,704,20
0.512,0.001,400,404,100,25,0.0001,804,20
0.512,0.001,450,454,100,25,0.0001,904,20
0.512,0.001,496,508,100,25,0.0001,1004,20
0.512,0.001,547,557,100,25,0.0001,1104,20
0.51,0.001,598,606,100,25,0.0001,1204,20
0.512,0.001,649,655,100,25,0.0001,1304,20
0.508,0.001,700,704,100,25,0.0001,1404,20
0.506,0.001,744,760,100,25,0.0001,1504,20
0.504,0.001,797,807,100,25,0.0001,1604,20
0.502,0.001,845,859,100,25,0.0001,1704,20
0.502,0.001,898,906,100,25,0.0001,1804,20
0.502,0.001,946,958,100,25,0.0001,1904,20
0.5,0.001,1005,999,100,25,0.0001,2004,20
0.516,0.001,53,51,100,25,0.001,104,1
0.524,0.001,106,98,100,25,0.001,204,1
0.528,0.001,153,151,100,25,0.001,304,1
0.532,0.001,195,209,100,25,0.001,404,1
0.536,0.001,249,255,100,25,0.001,504,1
0.538,0.001,307,297,100,25,0.001,604,1
0.546,0.001,357,347,100,25,0.001,704,1
0.562,0.001,404,400,100,25,0.001,804,1
0.554,0.001,456,448,100,25,0.001,904,1
0.566,0.001,511,493,100,25,0.001,1004,1
0.576,0.001,557,547,100,25,0.001,1104,1
0.584,0.001,610,594,100,25,0.001,1204,1
0.6,0.001,662,642,100,25,0.001,1304,1
0.616,0.001,707,697,100,25,0.001,1404,1
0.648,0.001,757,747,100,25,0.001,1504,1
0.658,0.001,811,793,100,25,0.001,1604,1
0.684,0.001,858,846,100,25,0.001,1704,1
0.692,0.001,903,901,100,25,0.001,1804,1
0.704,0.001,946,958,100,25,0.001,1904,1
0.712,0.001,998,1006,100,25,0.001,2004,1
0.488,0.001,51,53,100,25,0.001,104,2
0.492,0.001,99,105,100,25,0.001,204,2
0.504,0.001,155,149,100,25,0.001,304,2
0.498,0.001,211,193,100,25,0.001,404,2
0.504,0.001,265,239,100,25,0.001,504,2
0.516,0.001,310,294,100,25,0.001,604,2
0.522,0.001,366,338,100,25,0.001,704,2
0.538,0.001,414,390,100,25,0.001,804,2
0.556,0.001,468,436,100,25,0.001,904,2
0.554,0.001,523,481,100,25,0.001,1004,2
0.572,0.001,576,528,100,25,0.001,1104,2
0.574,0.001,624,580,100,25,0.001,1204,2
0.576,0.001,683,621,100,25,0.001,1304,2
0.582,0.001,729,675,100,25,0.001,1404,2
0.59,0.001,777,727,100,25,0.001,1504,2
0.596,0.001,828,776,100,25,0.001,1604,2
0.6,0.001,870,834,100,25,0.001,1704,2
0.61,0.001,919,885,100,25,0.001,1804,2
0.612,0.001,971,933,100,25,0.001,1904,2
0.63,0.001,1010,994,100,25,0.001,2004,2
0.536,0.001,58,46,100,25,0.001,104,3
0.532,0.001,105,99,100,25,0.001,204,3
0.534,0.001,160,144,100,25,0.001,304,3
0.542,0.001,209,195,100,25,0.001,404,3
0.544,0.001,253,251,100,25,0.001,504,3
0.54,0.001,296,308,100,25,0.001,604,3
0.542,0.001,352,352,100,25,0.001,704,3
0.556,0.001,406,398,100,25,0.001,804,3
0.572,0.001,445,459,100,25,0.001,904,3
0.582,0.001,499,505,100,25,0.001,1004,3
0.6,0.001,546,558,100,25,0.001,1104,3
0.594,0.001,597,607,100,25,0.001,1204,3
0.608,0.001,650,654,100,25,0.001,1304,3
0.618,0.001,696,708,100,25,0.001,1404,3
0.61,0.001,743,761,100,25,0.001,1504,3
0.626,0.001,792,812,100,25,0.001,1604,3
0.654,0.001,844,860,100,25,0.001,1704,3
0.674,0.001,897,907,100,25,0.001,1804,3
0.698,0.001,950,954,100,25,0.001,1904,3
0.714,0.001,1000,1004,100,25,0.001,2004,3
0.49,0.001,39,65,100,25,0.001,104,4
0.5,0.001,76,128,100,25,0.001,204,4
0.502,0.001,123,181,100,25,0.001,304,4
0.524,0.001,180,224,100,25,0.001,404,4
0.526,0.001,228,276,100,25,0.001,504,4
0.53,0.001,278,326,100,25,0.001,604,4
0.548,0.001,326,378,100,25,0.001,704,4
0.554,0.001,379,425,100,25,0.001,804,4
0.57,0.001,439,465,100,25,0.001,904,4
0.568,0.001,496,508,100,25,0.001,1004,4
0.566,0.001,553,551,100,25,0.001,1104,4
0.572,0.001,610,594,100,25,0.001,1204,4
0.58,0.001,664,640,100,25,0.001,1304,4
0.588,0.001,717,687,100,25,0.001,1404,4
0.588,0.001,758,746,100,25,0.001,1504,4
0.598,0.001,806,798,100,25,0.001,1604,4
0.608,0.001,857,847,100,25,0.001,1704,4
0.622,0.001,908,896,100,25,0.001,1804,4
0.634,0.001,965,939,100,25,0.001,1904,4
0.656,0.001,1011,993,100,25,0.001,2004,4
0.508,0.001,43,61,100,25,0.001,104,5
0.508,0.001,96,108,100,25,0.001,204,5
0.512,0.001,140,164,100,25,0.001,304,5
0.51,0.001,191,213,100,25,0.001,404,5
0.516,0.001,237,267,100,25,0.001,504,5
0.52,0.001,292,312,100,25,0.001,604,5
0.524,0.001,344,360,100,25,0.001,704,5
0.528,0.001,387,417,100,25,0.001,804,5
0.538,0.001,436,468,100,25,0.001,904,5
0.538,0.001,485,519,100,25,0.001,1004,5
0.538,0.001,534,570,100,25,0.001,1104,5
0.55,0.001,581,623,100,25,0.001,1204,5
0.554,0.001,639,665,100,25,0.001,1304,5
0.564,0.001,686,718,100,25,0.001,1404,5
0.576,0.001,739,765,100,25,0.001,1504,5
0.586,0.001,790,814,100,25,0.001,1604,5
0.594,0.001,834,870,100,25,0.001,1704,5
0.61,0.001,887,917,100,25,0.001,1804,5
0.628,0.001,951,953,100,25,0.001,1904,5
0.644,0.001,1006,998,100,25,0.001,2004,5
0.508,0.001,57,47,100,25,0.001,104,6
0.514,0.001,104,100,100,25,0.001,204,6
0.52,0.001,148,156,100,25,0.001,304,6
0.52,0.001,188,216,100,25,0.001,404,6
0.518,0.001,238,266,100,25,0.001,504,6
0.522,0.001,281,323,100,25,0.001,604,6
0.524,0.001,329,375,100,25,0.001,704,6
0.528,0.001,378,426,100,25,0.001,804,6
0.532,0.001,425,479,100,25,0.001,904,6
0.538,0.001,482,522,100,25,0.001,1004,6
0.538,0.001,532,572,100,25,0.001,1104,6
0.552,0.001,587,617,100,25,0.001,1204,6
0.574,0.001,641,663,100,25,0.001,1304,6
0.572,0.001,697,707,100,25,0.001,1404,6
0.582,0.001,745,759,100,25,0.001,1504,6
0.606,0.001,794,810,100,25,0.001,1604,6
0.616,0.001,847,857,100,25,0.001,1704,6
0.638,0.001,902,902,100,25,0.001,1804,6
0.654,0.001,948,956,100,25,0.001,1904,6
0.674,0.001,996,1008,100,25,0.001,2004,6
0.512,0.001,52,52,100,25,0.001,104,7
0.51,0.001,107,97,100,25,0.001,204,7
0.512,0.001,162,142,100,25,0.001,304,7
0.518,0.001,214,190,100,25,0.001,404,7
0.524,0.001,270,234,100,25,0.001,504,7
0.536,0.001,322,282,100,25,0.001,604,7
0.54,0.001,375,329,100,25,0.001,704,7
0.548,0.001,422,382,100,25,0.001,804,7
0.544,0.001,477,427,100,25,0.001,904,7
0.554,0.001,526,478,100,25,0.001,1004,7
0.564,0.001,576,528,100,25,0.001,1104,7
0.564,0.001,618,586,100,25,0.001,1204,7
0.568,0.001,671,633,100,25,0.001,1304,7
0.58,0.001,724,680,100,25,0.001,1404,7
0.598,0.001,771,733,100,25,0.001,1504,7
0.608,0.001,814,790,100,25,0.001,1604,7
0.636,0.001,860,844,100,25,0.001,1704,7
0.656,0.001,911,893,100,25,0.001,1804,7
0.674,0.001,965,939,100,25,0.001,1904,7
0.696,0.001,1014,990,100,25,0.001,2004,7
0.496,0.001,46,58,100,25,0.001,104,8
0.49,0.001,100,104,100,25,0.001,204,8
0.494,0.001,153,151,100,25,0.001,304,8
0.502,0.001,205,199,100,25,0.001,404,8
0.502,0.001,259,245,100,25,0.001,504,8
0.506,0.001,314,290,100,25,0.001,604,8
0.51,0.001,364,340,100,25,0.001,704,8
0.51,0.001,421,383,100,25,0.001,804,8
0.516,0.001,464,440,100,25,0.001,904,8
0.524,0.001,514,490,100,25,0.001,1004,8
0.522,0.001,572,532,100,25,0.001,1104,8
0.518,0.001,622,582,100,25,0.001,1204,8
0.524,0.001,676,628,100,25,0.001,1304,8
0.54,0.001,725,679,100,25,0.001,1404,8
0.54,0.001,779,725,100,25,0.001,1504,8
0.55,0.001,824,780,100,25,0.001,1604,8
0.57,0.001,867,837,100,25,0.001,1704,8
0.586,0.001,918,886,100,25,0.001,1804,8
0.6,0.001,966,938,100,25,0.001,1904,8
0.614,0.001,1013,991,100,25,0.001,2004,8
0.462,0.001,46,58,100,25,0.001,104,9
0.464,0.001,93,111,100,25,0.001,204,9
0.462,0.001,143,161,100,25,0.001,304,9
0.464,0.001,189,215,100,25,0.001,404,9
0.472,0.001,247,257,100,25,0.001,504,9
0.482,0.001,294,310,100,25,0.001,604,9
0.484,0.001,340,364,100,25,0.001,704,9
0.504,0.001,393,411,100,25,0.001,804,9
0.498,0.001,448,456,100,25,0.001,904,9
0.518,0.001,501,503,100,25,0.001,1004,9
0.52,0.001,553,551,100,25,0.001,1104,9
0.538,0.001,603,601,100,25,0.001,1204,9
0.562,0.001,648,656,100,25,0.001,1304,9
0.568,0.001,699,705,100,25,0.001,1404,9
0.582,0.001,747,757,100,25,0.001,1504,9
0.608,0.001,789,815,100,25,0.001,1604,9
0.65,0.001,846,858,100,25,0.001,1704,9
0.672,0.001,893,911,100,25,0.001,1804,9
0.686,0.001,936,968,100,25,0.001,1904,9
0.706,0.001,994,1010,100,25,0.001,2004,9
0.516,0.001,52,52,100,25,0.001,104,10
0.52,0.001,99,105,100,25,0.001,204,10
0.524,0.001,146,158,100,25,0.001,304,10
0.524,0.001,189,215,100,25,0.001,404,10
0.52,0.001,239,265,100,25,0.001,504,10
0.524,0.001,294,310,100,25,0.001,604,10
0.53,0.001,338,366,100,25,0.001,704,10
0.528,0.001,391,413,100,25,0.001,804,10
0.532,0.001,444,460,100,25,0.001,904,10
0.548,0.001,497,507,100,25,0.001,1004,10
0.55,0.001,557,547,100,25,0.001,1104,10
0.562,0.001,599,605,100,25,0.001,1204,10
0.58,0.001,639,665,100,25,0.001,1304,10
0.596,0.001,691,713,100,25,0.001,1404,10
0.61,0.001,736,768,100,25,0.001,1504,10
0.62,0.001,788,816,100,25,0.001,1604,10
0.62,0.001,838,866,100,25,0.001,1704,10
0.654,0.001,900,904,100,25,0.001,1804,10
0.658,0.001,954,950,100,25,0.001,1904,10
0.686,0.001,1004,1000,100,25,0.001,2004,10
0.536,0.001,62,42,100,25,0.001,104,11
0.532,0.001,103,101,100,25,0.001,204,11
0.546,0.001,155,149,100,25,0.001,304,11
0.548,0.001,204,200,100,25,0.001,404,11
0.552,0.001,255,249,100,25,0.001,504,11
0.554,0.001,305,299,100,25,0.001,604,11
0.552,0.001,350,354,100,25,0.001,704,11
0.55,0.001,402,402,100,25,0.001,804,11
0.542,0.001,452,452,100,25,0.001,904,11
0.552,0.001,505,499,100,25,0.001,1004,11
0.562,0.001,561,543,100,25,0.001,1104,11
0.572,0.001,618,586,100,25,0.001,1204,11
0.582,0.001,660,644,100,25,0.001,1304,11
0.592,0.001,710,694,100,25,0.001,1404,11
0.618,0.001,753,751,100,25,0.001,1504,11
0.63,0.001,809,795,100,25,0.001,1604,11
0.638,0.001,856,848,100,25,0.001,1704,11
0.656,0.001,910,894,100,25,0.001,1804,11
0.666,0.001,958,946,100,25,0.001,1904,11
0.682,0.001,1004,1000,100,25,0.001,2004,11
0.476,0.001,57,47,100,25,0.001,104,12
0.478,0.001,108,96,100,25,0.001,204,12
0.478,0.001,154,150,100,25,0.001,304,12
0.468,0.001,201,203,100,25,0.001,404,12
0.482,0.001,255,249,100,25,0.001,504,12
0.496,0.001,309,295,100,25,0.001,604,12
0.488,0.001,353,351,100,25,0.001,704,12
0.5,0.001,409,395,100,25,0.001,804,12
0.502,0.001,458,446,100,25,0.001,904,12
0.514,0.001,505,499,100,25,0.001,1004,12
0.522,0.001,554,550,100,25,0.001,1104,12
0.526,0.001,606,598,100,25,0.001,1204,12
0.532,0.001,650,654,100,25,0.001,1304,12
0.538,0.001,703,701,100,25,0.001,1404,12
0.548,0.001,754,750,100,25,0.001,1504,12
0.562,0.001,800,804,100,25,0.001,1604,12
0.592,0.001,853,851,100,25,0.001,1704,12
0.616,0.001,899,905,100,25,0.001,1804,12
0.634,0.001,948,956,100,25,0.001,1904,12
0.652,0.001,995,1009,100,25,0.001,2004,12
0.508,0.001,58,46,100,25,0.001,104,13
0.514,0.001,110,94,100,25,0.001,204,13
0.518,0.001,161,143,100,25,0.001,304,13
0.52,0.001,221,183,100,25,0.001,404,13
0.518,0.001,269,235,100,25,0.001,504,13
0.53,0.001,318,286,100,25,0.001,604,13
0.538,0.001,372,332,100,25,0.001,704,13
0.546,0.001,417,387,100,25,0.001,804,13
0.556,0.001,470,434,100,25,0.001,904,13
0.56,0.001,520,484,100,25,0.001,1004,13
0.574,0.001,568,536,100,25,0.001,1104,13
0.58,0.001,613,591,100,25,0.001,1204,13
0.576,0.001,665,639,100,25,0.001,1304,13
0.58,0.001,714,690,100,25,0.001,1404,13
0.588,0.001,768,736,100,25,0.001,1504,13
0.61,0.001,818,786,100,25,0.001,1604,13
0.61,0.001,864,840,100,25,0.001,1704,13
0.628,0.001,912,892,100,25,0.001,1804,13
0.658,0.001,964,940,100,25,0.001,1904,13
0.68,0.001,1018,986,100,25,0.001,2004,13
0.494,0.001,50,54,100,25,0.001,104,14
0.496,0.001,95,109,100,25,0.001,204,14
0.496,0.001,148,156,100,25,0.001,304,14
0.506,0.001,195,209,100,25,0.001,404,14
0.504,0.001,263,241,100,25,0.001,504,14
0.502,0.001,316,288,100,25,0.001,604,14
0.52,0.001,361,343,100,25,0.001,704,14
0.536,0.001,410,394,100,25,0.001,804,14
0.536,0.001,457,447,100,25,0.001,904,14
0.538,0.001,507,497,100,25,0.001,1004,14
0.556,0.001,558,546,100,25,0.001,1104,14
0.562,0.001,607,597,100,25,0.001,1204,14
0.572,0.001,654,650,100,25,0.001,1304,14
0.586,0.001,707,697,100,25,0.001,1404,14
0.594,0.001,755,749,100,25,0.001,1504,14
0.596,0.001,806,798,100,25,0.001,1604,14
0.604,0.001,851,853,100,25,0.001,1704,14
0.626,0.001,900,904,100,25,0.001,1804,14
0.646,0.001,950,954,100,25,0.001,1904,14
0.654,0.001,1001,1003,100,25,0.001,2004,14
0.506,0.001,48,56,100,25,0.001,104,15
0.514,0.001,106,98,100,25,0.001,204,15
0.512,0.001,160,144,100,25,0.001,304,15
0.516,0.001,212,192,100,25,0.001,404,15
0.52,0.001,263,241,100,25,0.001,504,15
0.51,0.001,310,294,100,25,0.001,604,15
0.524,0.001,365,339,100,25,0.001,704,15
0.538,0.001,410,394,100,25,0.001,804,15
0.538,0.001,459,445,100,25,0.001,904,15
0.55,0.001,510,494,100,25,0.001,1004,15
0.55,0.001,568,536,100,25,0.001,1104,15
0.57,0.001,618,586,100,25,0.001,1204,15
0.568,0.001,671,633,100,25,0.001,1304,15
0.576,0.001,725,679,100,25,0.001,1404,15
0.586,0.001,776,728,100,25,0.001,1504,15
0.59,0.001,824,780,100,25,0.001,1604,15
0.594,0.001,874,830,100,25,0.001,1704,15
0.6,0.001,928,876,100,25,0.001,1804,15
0.602,0.001,976,928,100,25,0.001,1904,15
0.614,0.001,1028,976,100,25,0.001,2004,15
0.508,0.001,51,53,100,25,0.001,104,16
0.508,0.001,102,102,100,25,0.001,204,16
0.51,0.001,148,156,100,25,0.001,304,16
0.508,0.001,199,205,100,25,0.001,404,16
0.506,0.001,241,263,100,25,0.001,504,16
0.504,0.001,294,310,100,25,0.001,604,16
0.504,0.001,335,369,100,25,0.001,704,16
0.5,0.001,389,415,100,25,0.001,804,16
0.506,0.001,441,463,100,25,0.001,904,16
0.522,0.001,481,523,100,25,0.001,1004,16
0.526,0.001,535,569,100,25,0.001,1104,16
0.54,0.001,582,622,100,25,0.001,1204,16
0.552,0.001,635,669,100,25,0.001,1304,16
0.552,0.001,693,711,100,25,0.001,1404,16
0.56,0.001,739,765,100,25,0.001,1504,16
0.568,0.001,787,817,100,25,0.001,1604,16
0.572,0.001,842,862,100,25,0.001,1704,16
0.572,0.001,901,903,100,25,0.001,1804,16
0.596,0.001,958,946,100,25,0.001,1904,16
0.608,0.001,1002,1002,100,25,0.001,2004,16
0.496,0.001,50,54,100,25,0.001,104,17
0.496,0.001,106,98,100,25,0.001,204,17
0.5,0.001,157,147,100,25,0.001,304,17
0.496,0.001,207,197,100,25,0.001,404,17
0.494,0.001,261,243,100,25,0.001,504,17
0.492,0.001,308,296,100,25,0.001,604,17
0.494,0.001,350,354,100,25,0.001,704,17
0.5,0.001,393,411,100,25,0.001,804,17
0.5,0.001,448,456,100,25,0.001,904,17
0.5,0.001,501,503,100,25,0.001,1004,17
0.506,0.001,555,549,100,25,0.001,1104,17
0.516,0.001,613,591,100,25,0.001,1204,17
0.52,0.001,663,641,100,25,0.001,1304,17
0.526,0.001,710,694,100,25,0.001,1404,17
0.544,0.001,768,736,100,25,0.001,1504,17
0.546,0.001,817,787,100,25,0.001,1604,17
0.564,0.001,865,839,100,25,0.001,1704,17
0.582,0.001,907,897,100,25,0.001,1804,17
0.594,0.001,955,949,100,25,0.001,1904,17
0.612,0.001,1003,1001,100,25,0.001,2004,17
0.546,0.001,41,63,100,25,0.001,104,18
0.55,0.001,83,121,100,25,0.001,204,18
0.552,0.001,135,169,100,25,0.001,304,18
0.554,0.001,190,214,100,25,0.001,404,18
0.562,0.001,241,263,100,25,0.001,504,18
0.566,0.001,289,315,100,25,0.001,604,18
0.582,0.001,350,354,100,25,0.001,704,18
0.592,0.001,400,404,100,25,0.001,804,18
0.59,0.001,445,459,100,25,0.001,904,18
0.618,0.001,494,510,100,25,0.001,1004,18
0.622,0.001,541,563,100,25,0.001,1104,18
0.624,0.001,591,613,100,25,0.001,1204,18
0.622,0.001,643,661,100,25,0.001,1304,18
0.626,0.001,691,713,100,25,0.001,1404,18
0.642,0.001,735,769,100,25,0.001,1504,18
0.65,0.001,777,827,100,25,0.001,1604,18
0.668,0.001,832,872,100,25,0.001,1704,18
0.686,0.001,887,917,100,25,0.001,1804,18
0.698,0.001,940,964,100,25,0.001,1904,18
0.72,0.001,994,1010,100,25,0.001,2004,18
0.512,0.001,47,57,100,25,0.001,104,19
0.51,0.001,98,106,100,25,0.001,204,19
0.51,0.001,138,166,100,25,0.001,304,19
0.506,0.001,183,221,100,25,0.001,404,19
0.508,0.001,235,269,100,25,0.001,504,19
0.504,0.001,283,321,100,25,0.001,604,19
0.506,0.001,336,368,100,25,0.001,704,19
0.508,0.001,385,419,100,25,0.001,804,19
0.514,0.001,443,461,100,25,0.001,904,19
0.512,0.001,492,512,100,25,0.001,1004,19
0.526,0.001,541,563,100,25,0.001,1104,19
0.55,0.001,590,614,100,25,0.001,1204,19
0.566,0.001,639,665,100,25,0.001,1304,19
0.58,0.001,696,708,100,25,0.001,1404,19
0.604,0.001,747,757,100,25,0.001,1504,19
0.608,0.001,804,800,100,25,0.001,1604,19
0.628,0.001,851,853,100,25,0.001,1704,19
0.644,0.001,910,894,100,25,0.001,1804,19
0.66,0.001,952,952,100,25,0.001,1904,19
0.668,0.001,1000,1004,100,25,0.001,2004,19
0.484,0.001,53,51,100,25,0.001,104,20
0.486,0.001,107,97,100,25,0.001,204,20
0.49,0.001,156,148,100,25,0.001,304,20
0.496,0.001,204,200,100,25,0.001,404,20
0.504,0.001,253,251,100,25,0.001,504,20
0.508,0.001,311,293,100,25,0.001,604,20
0.524,0.001,355,349,100,25,0.001,704,20
0.546,0.001,404,400,100,25,0.001,804,20
0.546,0.001,458,446,100,25,0.001,904,20
0.554,0.001,499,505,100,25,0.001,1004,20
0.566,0.001,549,555,100,25,0.001,1104,20
0.572,0.001,600,604,100,25,0.001,1204,20
0.582,0.001,650,654,100,25,0.001,1304,20
0.594,0.001,700,704,100,25,0.001,1404,20
0.612,0.001,754,750,100,25,0.001,1504,20
0.624,0.001,806,798,100,25,0.001,1604,20
0.644,0.001,864,840,100,25,0.001,1704,20
0.664,0.001,905,899,100,25,0.001,1804,20
0.668,0.001,959,945,100,25,0.001,1904,20
0.684,0.001,1008,996,100,25,0.001,2004,20
0.524,0.001,60,44,100,25,0.01,104,1
0.528,0.001,110,94,100,25,0.01,204,1
0.522,0.001,153,151,100,25,0.01,304,1
0.552,0.001,202,202,100,25,0.01,404,1
0.572,0.001,253,251,100,25,0.01,504,1
0.628,0.001,305,299,100,25,0.01,604,1
0.678,0.001,368,336,100,25,0.01,704,1
0.706,0.001,416,388,100,25,0.01,804,1
0.736,0.001,454,450,100,25,0.01,904,1
0.788,0.001,507,497,100,25,0.01,1004,1
0.816,0.001,553,551,100,25,0.01,1104,1
0.858,0.001,594,610,100,25,0.01,1204,1
0.882,0.001,637,667,100,25,0.01,1304,1
0.918,0.001,689,715,100,25,0.01,1404,1
0.914,0.001,738,766,100,25,0.01,1504,1
0.926,0.001,781,823,100,25,0.01,1604,1
0.938,0.001,837,867,100,25,0.01,1704,1
0.952,0.001,891,913,100,25,0.01,1804,1
0.954,0.001,936,968,100,25,0.01,1904,1
0.96,0.001,988,1016,100,25,0.01,2004,1
0.52,0.001,51,53,100,25,0.01,104,2
0.55,0.001,110,94,100,25,0.01,204,2
0.568,0.001,149,155,100,25,0.01,304,2
0.584,0.001,188,216,100,25,0.01,404,2
0.594,0.001,243,261,100,25,0.01,504,2
0.618,0.001,292,312,100,25,0.01,604,2
0.654,0.001,337,367,100,25,0.01,704,2
0.666,0.001,375,429,100,25,0.01,804,2
0.664,0.001,426,478,100,25,0.01,904,2
0.712,0.001,480,524,100,25,0.01,1004,2
0.724,0.001,530,574,100,25,0.01,1104,2
0.798,0.001,574,630,100,25,0.01,1204,2
0.836,0.001,629,675,100,25,0.01,1304,2
0.866,0.001,677,727,100,25,0.01,1404,2
0.902,0.001,733,771,100,25,0.01,1504,2
0.93,0.001,788,816,100,25,0.01,1604,2
0.936,0.001,844,860,100,25,0.01,1704,2
0.95,0.001,902,902,100,25,0.01,1804,2
0.95,0.001,949,955,100,25,0.01,1904,2
0.956,0.001,1007,997,100,25,0.01,2004,2
0.518,0.001,59,45,100,25,0.01,104,3
0.55,0.001,109,95,100,25,0.01,204,3
0.566,0.001,159,145,100,25,0.01,304,3
0.582,0.001,205,199,100,25,0.01,404,3
0.574,0.001,253,251,100,25,0.01,504,3
0.608,0.001,300,304,100,25,0.01,604,3
0.618,0.001,351,353,100,25,0.01,704,3
0.66,0.001,397,407,100,25,0.01,804,3
0.69,0.001,444,460,100,25,0.01,904,3
0.726,0.001,490,514,100,25,0.01,1004,3
0.764,0.001,535,569,100,25,0.01,1104,3
0.814,0.001,595,609,100,25,0.01,1204,3
0.834,0.001,639,665,100,25,0.01,1304,3
0.888,0.001,693,711,100,25,0.01,1404,3
0.91,0.001,743,761,100,25,0.01,1504,3
0.922,0.001,801,803,100,25,0.01,1604,3
0.93,0.001,854,850,100,25,0.01,1704,3
0.942,0.001,906,898,100,25,0.01,1804,3
0.946,0.001,953,951,100,25,0.01,1904,3
0.952,0.001,1001,1003,100,25,0.01,2004,3
0.536,0.001,56,48,100,25,0.01,104,4
0.572,0.001,99,105,100,25,0.01,204,4
0.588,0.001,145,159,100,25,0.01,304,4
0.582,0.001,210,194,100,25,0.01,404,4
0.594,0.001,255,249,100,25,0.01,504,4
0.596,0.001,302,302,100,25,0.01,604,4
0.622,0.001,347,357,100,25,0.01,704,4
0.662,0.001,400,404,100,25,0.01,804,4
0.68,0.001,450,454,100,25,0.01,904,4
0.728,0.001,497,507,100,25,0.01,1004,4
0.738,0.001,539,565,100,25,0.01,1104,4
0.802,0.001,598,606,100,25,0.01,1204,4
0.85,0.001,653,651,100,25,0.01,1304,4
0.884,0.001,698,706,100,25,0.01,1404,4
0.92,0.001,747,757,100,25,0.01,1504,4
0.936,0.001,803,801,100,25,0.01,1604,4
0.94,0.001,853,851,100,25,0.01,1704,4
0.952,0.001,905,899,100,25,0.01,1804,4
0.956,0.001,959,945,100,25,0.01,1904,4
0.958,0.001,1001,1003,100,25,0.01,2004,4
0.518,0.001,46,58,100,25,0.01,104,5
0.546,0.001,90,114,100,25,0.01,204,5
0.52,0.001,139,165,100,25,0.01,304,5
0.536,0.001,185,219,100,25,0.01,404,5
0.57,0.001,232,272,100,25,0.01,504,5
0.598,0.001,282,322,100,25,0.01,604,5
0.638,0.001,335,369,100,25,0.01,704,5
0.692,0.001,390,414,100,25,0.01,804,5
0.738,0.001,442,462,100,25,0.01,904,5
0.796,0.001,499,505,100,25,0.01,1004,5
0.838,0.001,546,558,100,25,0.01,1104,5
0.892,0.001,594,610,100,25,0.01,1204,5
0.918,0.001,646,658,100,25,0.01,1304,5
0.94,0.001,699,705,100,25,0.01,1404,5
0.948,0.001,751,753,100,25,0.01,1504,5
0.954,0.001,809,795,100,25,0.01,1604,5
0.956,0.001,850,854,100,25,0.01,1704,5
0.966,0.001,903,901,100,25,0.01,1804,5
0.964,0.001,947,957,100,25,0.01,1904,5
0.966,0.001,994,1010,100,25,0.01,2004,5
0.512,0.001,57,47,100,25,0.01,104,6
0.528,0.001,102,102,100,25,0.01,204,6
0.532,0.001,149,155,100,25,0.01,304,6
0.546,0.001,190,214,100,25,0.01,404,6
0.552,0.001,239,265,100,25,0.01,504,6
0.568,0.001,285,319,100,25,0.01,604,6
0.612,0.001,333,371,100,25,0.01,704,6
0.634,0.001,379,425,100,25,0.01,804,6
0.664,0.001,427,477,100,25,0.01,904,6
0.682,0.001,478,526,100,25,0.01,1004,6
0.728,0.001,529,575,100,25,0.01,1104,6
0.79,0.001,585,619,100,25,0.01,1204,6
0.842,0.001,635,669,100,25,0.01,1304,6
0.904,0.001,696,708,100,25,0.01,1404,6
0.912,0.001,749,755,100,25,0.01,1504,6
0.938,0.001,795,809,100,25,0.01,1604,6
0.946,0.001,844,860,100,25,0.01,1704,6
0.95,0.001,895,909,100,25,0.01,1804,6
0.956,0.001,943,961,100,25,0.01,1904,6
0.958,0.001,993,1011,100,25,0.01,2004,6
0.504,0.001,61,43,100,25,0.01,104,7
0.512,0.001,110,94,100,25,0.01,204,7
0.546,0.001,164,140,100,25,0.01,304,7
0.55,0.001,209,195,100,25,0.01,404,7
0.596,0.001,262,242,100,25,0.01,504,7
0.626,0.001,311,293,100,25,0.01,604,7
0.632,0.001,357,347,100,25,0.01,704,7
0.688,0.001,408,396,100,25,0.01,804,7
0.72,0.001,470,434,100,25,0.01,904,7
0.742,0.001,525,479,100,25,0.01,1004,7
0.778,0.001,565,539,100,25,0.01,1104,7
0.824,0.001,607,597,100,25,0.01,1204,7
0.852,0.001,658,646,100,25,0.01,1304,7
0.894,0.001,714,690,100,25,0.01,1404,7
0.926,0.001,764,740,100,25,0.01,1504,7
0.936,0.001,814,790,100,25,0.01,1604,7
0.94,0.001,861,843,100,25,0.01,1704,7
0.94,0.001,897,907,100,25,0.01,1804,7
0.946,0.001,951,953,100,25,0.01,1904,7
0.95,0.001,996,1008,100,25,0.01,2004,7
0.47,0.001,52,52,100,25,0.01,104,8
0.504,0.001,104,100,100,25,0.01,204,8
0.526,0.001,156,148,100,25,0.01,304,8
0.522,0.001,209,195,100,25,0.01,404,8
0.536,0.001,247,257,100,25,0.01,504,8
0.562,0.001,295,309,100,25,0.01,604,8
0.574,0.001,343,361,100,25,0.01,704,8
0.614,0.001,394,410,100,25,0.01,804,8
0.636,0.001,440,464,100,25,0.01,904,8
0.7,0.001,488,516,100,25,0.01,1004,8
0.742,0.001,535,569,100,25,0.01,1104,8
0.804,0.001,591,613,100,25,0.01,1204,8
0.856,0.001,645,659,100,25,0.01,1304,8
0.882,0.001,703,701,100,25,0.01,1404,8
0.894,0.001,751,753,100,25,0.01,1504,8
0.916,0.001,797,807,100,25,0.01,1604,8
0.926,0.001,843,861,100,25,0.01,1704,8
0.932,0.001,892,912,100,25,0.01,1804,8
0.936,0.001,950,954,100,25,0.01,1904,8
0.94,0.001,997,1007,100,25,0.01,2004,8
0.5,0.001,41,63,100,25,0.01,104,9
0.554,0.001,88,116,100,25,0.01,204,9
0.556,0.001,138,166,100,25,0.01,304,9
0.588,0.001,193,211,100,25,0.01,404,9
0.576,0.001,249,255,100,25,0.01,504,9
0.592,0.001,304,300,100,25,0.01,604,9
0.61,0.001,357,347,100,25,0.01,704,9
0.628,0.001,404,400,100,25,0.01,804,9
0.666,0.001,453,451,100,25,0.01,904,9
0.71,0.001,497,507,100,25,0.01,1004,9
0.734,0.001,556,548,100,25,0.01,1104,9
0.802,0.001,599,605,100,25,0.01,1204,9
0.818,0.001,649,655,100,25,0.01,1304,9
0.872,0.001,696,708,100,25,0.01,1404,9
0.888,0.001,756,748,100,25,0.01,1504,9
0.914,0.001,811,793,100,25,0.01,1604,9
0.93,0.001,859,845,100,25,0.01,1704,9
0.934,0.001,909,895,100,25,0.01,1804,9
0.948,0.001,958,946,100,25,0.01,1904,9
0.952,0.001,1011,993,100,25,0.01,2004,9
0.556,0.001,48,56,100,25,0.01,104,10
0.596,0.001,100,104,100,25,0.01,204,10
0.61,0.001,149,155,100,25,0.01,304,10
0.622,0.001,206,198,100,25,0.01,404,10
0.648,0.001,257,247,100,25,0.01,504,10
0.66,0.001,309,295,100,25,0.01,604,10
0.684,0.001,361,343,100,25,0.01,704,10
0.684,0.001,410,394,100,25,0.01,804,10
0.726,0.001,457,447,100,25,0.01,904,10
0.762,0.001,512,492,100,25,0.01,1004,10
0.78,0.001,566,538,100,25,0.01,1104,10
0.822,0.001,614,590,100,25,0.01,1204,10
0.846,0.001,668,636,100,25,0.01,1304,10
0.89,0.001,715,689,100,25,0.01,1404,10
0.914,0.001,764,740,100,25,0.01,1504,10
0.93,0.001,814,790,100,25,0.01,1604,10
0.944,0.001,863,841,100,25,0.01,1704,10
0.958,0.001,918,886,100,25,0.01,1804,10
0.976,0.001,973,931,100,25,0.01,1904,10
0.956,0.001,1015,989,100,25,0.01,2004,10
0.55,0.001,51,53,100,25,0.01,104,11
0.6,0.001,98,106,100,25,0.01,204,11
0.6,0.001,149,155,100,25,0.01,304,11
0.614,0.001,198,206,100,25,0.01,404,11
0.624,0.001,251,253,100,25,0.01,504,11
0.652,0.001,304,300,100,25,0.01,604,11
0.662,0.001,351,353,100,25,0.01,704,11
0.71,0.001,400,404,100,25,0.01,804,11
0.748,0.001,449,455,100,25,0.01,904,11
0.77,0.001,502,502,100,25,0.01,1004,11
0.814,0.001,553,551,100,25,0.01,1104,11
0.866,0.001,604,600,100,25,0.01,1204,11
0.896,0.001,650,654,100,25,0.01,1304,11
0.91,0.001,695,709,100,25,0.01,1404,11
0.924,0.001,746,758,100,25,0.01,1504,11
0.93,0.001,793,811,100,25,0.01,1604,11
0.93,0.001,842,862,100,25,0.01,1704,11
0.932,0.001,891,913,100,25,0.01,1804,11
0.938,0.001,943,961,100,25,0.01,1904,11
0.944,0.001,998,1006,100,25,0.01,2004,11
0.57,0.001,47,57,100,25,0.01,104,12
0.582,0.001,96,108,100,25,0.01,204,12
0.588,0.001,151,153,100,25,0.01,304,12
0.6,0.001,206,198,100,25,0.01,404,12
0.632,0.001,260,244,100,25,0.01,504,12
0.654,0.001,302,302,100,25,0.01,604,12
0.646,0.001,353,351,100,25,0.01,704,12
0.68,0.001,399,405,100,25,0.01,804,12
0.704,0.001,449,455,100,25,0.01,904,12
0.74,0.001,497,507,100,25,0.01,1004,12
0.78,0.001,542,562,100,25,0.01,1104,12
0.842,0.001,583,621,100,25,0.01,1204,12
0.874,0.001,631,673,100,25,0.01,1304,12
0.902,0.001,683,721,100,25,0.01,1404,12
0.916,0.001,732,772,100,25,0.01,1504,12
0.93,0.001,785,819,100,25,0.01,1604,12
0.932,0.001,830,874,100,25,0.01,1704,12
0.936,0.001,885,919,100,25,0.01,1804,12
0.942,0.001,936,968,100,25,0.01,1904,12
0.942,0.001,995,1009,100,25,0.01,2004,12
0.498,0.001,53,51,100,25,0.01,104,13
0.53,0.001,104,100,100,25,0.01,204,13
0.542,0.001,146,158,100,25,0.01,304,13
0.564,0.001,202,202,100,25,0.01,404,13
0.586,0.001,253,251,100,25,0.01,504,13
0.634,0.001,294,310,100,25,0.01,604,13
0.666,0.001,340,364,100,25,0.01,704,13
0.706,0.001,393,411,100,25,0.01,804,13
0.75,0.001,447,457,100,25,0.01,904,13
0.808,0.001,488,516,100,25,0.01,1004,13
0.838,0.001,543,561,100,25,0.01,1104,13
0.868,0.001,592,612,100,25,0.01,1204,13
0.874,0.001,636,668,100,25,0.01,1304,13
0.896,0.001,685,719,100,25,0.01,1404,13
0.912,0.001,743,761,100,25,0.01,1504,13
0.938,0.001,794,810,100,25,0.01,1604,13
0.94,0.001,842,862,100,25,0.01,1704,13
0.952,0.001,903,901,100,25,0.01,1804,13
0.952,0.001,954,950,100,25,0.01,1904,13
0.954,0.001,1008,996,100,25,0.01,2004,13
0.55,0.001,65,39,100,25,0.01,104,14
0.558,0.001,119,85,100,25,0.01,204,14
0.534,0.001,169,135,100,25,0.01,304,14
0.556,0.001,210,194,100,25,0.01,404,14
0.57,0.001,247,257,100,25,0.01,504,14
0.584,0.001,288,316,100,25,0.01,604,14
0.628,0.001,342,362,100,25,0.01,704,14
0.654,0.001,392,412,100,25,0.01,804,14
0.71,0.001,446,458,100,25,0.01,904,14
0.748,0.001,495,509,100,25,0.01,1004,14
0.79,0.001,553,551,100,25,0.01,1104,14
0.826,0.001,603,601,100,25,0.01,1204,14
0.858,0.001,652,652,100,25,0.01,1304,14
0.878,0.001,695,709,100,25,0.01,1404,14
0.906,0.001,745,759,100,25,0.01,1504,14
0.924,0.001,797,807,100,25,0.01,1604,14
0.934,0.001,851,853,100,25,0.01,1704,14
0.94,0.001,894,910,100,25,0.01,1804,14
0.942,0.001,948,956,100,25,0.01,1904,14
0.946,0.001,1000,1004,100,25,0.01,2004,14
0.556,0.001,55,49,100,25,0.01,104,15
0.558,0.001,113,91,100,25,0.01,204,15
0.538,0.001,167,137,100,25,0.01,304,15
0.572,0.001,212,192,100,25,0.01,404,15
0.602,0.001,263,241,100,25,0.01,504,15
0.634,0.001,308,296,100,25,0.01,604,15
0.664,0.001,358,346,100,25,0.01,704,15
0.7,0.001,410,394,100,25,0.01,804,15
0.73,0.001,461,443,100,25,0.01,904,15
0.776,0.001,514,490,100,25,0.01,1004,15
0.81,0.001,560,544,100,25,0.01,1104,15
0.842,0.001,604,600,100,25,0.01,1204,15
0.866,0.001,660,644,100,25,0.01,1304,15
0.898,0.001,714,690,100,25,0.01,1404,15
0.926,0.001,769,735,100,25,0.01,1504,15
0.938,0.001,820,784,100,25,0.01,1604,15
0.932,0.001,873,831,100,25,0.01,1704,15
0.934,0.001,921,883,100,25,0.01,1804,15
0.938,0.001,968,936,100,25,0.01,1904,15
0.94,0.001,1009,995,100,25,0.01,2004,15
0.528,0.001,45,59,100,25,0.01,104,16
0.578,0.001,101,103,100,25,0.01,204,16
0.586,0.001,145,159,100,25,0.01,304,16
0.59,0.001,187,217,100,25,0.01,404,16
0.632,0.001,238,266,100,25,0.01,504,16
0.67,0.001,285,319,100,25,0.01,604,16
0.696,0.001,344,360,100,25,0.01,704,16
0.738,0.001,398,406,100,25,0.01,804,16
0.746,0.001,452,452,100,25,0.01,904,16
0.81,0.001,502,502,100,25,0.01,1004,16
0.836,0.001,548,556,100,25,0.01,1104,16
0.864,0.001,598,606,100,25,0.01,1204,16
0.876,0.001,648,656,100,25,0.01,1304,16
0.902,0.001,708,696,100,25,0.01,1404,16
0.922,0.001,756,748,100,25,0.01,1504,16
0.94,0.001,806,798,100,25,0.01,1604,16
0.946,0.001,857,847,100,25,0.01,1704,16
0.952,0.001,905,899,100,25,0.01,1804,16
0.96,0.001,967,937,100,25,0.01,1904,16
0.962,0.001,1008,996,100,25,0.01,2004,16
0.504,0.001,46,58,100,25,0.01,104,17
0.528,0.001,94,110,100,25,0.01,204,17
0.54,0.001,138,166,100,25,0.01,304,17
0.554,0.001,187,217,100,25,0.01,404,17
0.584,0.001,230,274,100,25,0.01,504,17
0.616,0.001,274,330,100,25,0.01,604,17
0.638,0.001,324,380,100,25,0.01,704,17
0.686,0.001,370,434,100,25,0.01,804,17
0.716,0.001,422,482,100,25,0.01,904,17
0.768,0.001,475,529,100,25,0.01,1004,17
0.792,0.001,530,574,100,25,0.01,1104,17
0.842,0.001,584,620,100,25,0.01,1204,17
0.876,0.001,640,664,100,25,0.01,1304,17
0.906,0.001,690,714,100,25,0.01,1404,17
0.92,0.001,752,752,100,25,0.01,1504,17
0.934,0.001,801,803,100,25,0.01,1604,17
0.94,0.001,855,849,100,25,0.01,1704,17
0.954,0.001,915,889,100,25,0.01,1804,17
0.956,0.001,966,938,100,25,0.01,1904,17
0.948,0.001,1017,987,100,25,0.01,2004,17
0.506,0.001,48,56,100,25,0.01,104,18
0.538,0.001,103,101,100,25,0.01,204,18
0.542,0.001,159,145,100,25,0.01,304,18
0.572,0.001,202,202,100,25,0.01,404,18
0.592,0.001,246,258,100,25,0.01,504,18
0.608,0.001,302,302,100,25,0.01,604,18
0.65,0.001,356,348,100,25,0.01,704,18
0.69,0.001,406,398,100,25,0.01,804,18
0.74,0.001,451,453,100,25,0.01,904,18
0.806,0.001,504,500,100,25,0.01,1004,18
0.832,0.001,554,550,100,25,0.01,1104,18
0.876,0.001,603,601,100,25,0.01,1204,18
0.874,0.001,657,647,100,25,0.01,1304,18
0.888,0.001,702,702,100,25,0.01,1404,18
0.91,0.001,754,750,100,25,0.01,1504,18
0.926,0.001,810,794,100,25,0.01,1604,18
0.942,0.001,861,843,100,25,0.01,1704,18
0.946,0.001,915,889,100,25,0.01,1804,18
0.952,0.001,959,945,100,25,0.01,1904,18
0.96,0.001,1010,994,100,25,0.01,2004,18
0.556,0.001,49,55,100,25,0.01,104,19
0.562,0.001,98,106,100,25,0.01,204,19
0.564,0.001,148,156,100,25,0.01,304,19
0.596,0.001,189,215,100,25,0.01,404,19
0.634,0.001,239,265,100,25,0.01,504,19
0.64,0.001,294,310,100,25,0.01,604,19
0.656,0.001,345,359,100,25,0.01,704,19
0.696,0.001,393,411,100,25,0.01,804,19
0.766,0.001,442,462,100,25,0.01,904,19
0.856,0.001,491,513,100,25,0.01,1004,19
0.872,0.001,542,562,100,25,0.01,1104,19
0.898,0.001,600,604,100,25,0.01,1204,19
0.914,0.001,655,649,100,25,0.01,1304,19
0.924,0.001,700,704,100,25,0.01,1404,19
0.932,0.001,747,757,100,25,0.01,1504,19
0.936,0.001,805,799,100,25,0.01,1604,19
0.938,0.001,846,858,100,25,0.01,1704,19
0.938,0.001,899,905,100,25,0.01,1804,19
0.942,0.001,954,950,100,25,0.01,1904,19
0.952,0.001,997,1007,100,25,0.01,2004,19
0.48,0.001,48,56,100,25,0.01,104,20
0.556,0.001,99,105,100,25,0.01,204,20
0.554,0.001,146,158,100,25,0.01,304,20
0.57,0.001,199,205,100,25,0.01,404,20
0.59,0.001,244,260,100,25,0.01,504,20
0.612,0.001,294,310,100,25,0.01,604,20
0.612,0.001,353,351,100,25,0.01,704,20
0.64,0.001,403,401,100,25,0.01,804,20
0.664,0.001,455,449,100,25,0.01,904,20
0.71,0.001,500,504,100,25,0.01,1004,20
0.752,0.001,555,549,100,25,0.01,1104,20
0.798,0.001,606,598,100,25,0.01,1204,20
0.836,0.001,662,642,100,25,0.01,1304,20
0.874,0.001,712,692,100,25,0.01,1404,20
0.892,0.001,764,740,100,25,0.01,1504,20
0.904,0.001,821,783,100,25,0.01,1604,20
0.928,0.001,867,837,100,25,0.01,1704,20
0.934,0.001,911,893,100,25,0.01,1804,20
0.94,0.001,964,940,100,25,0.01,1904,20
0.942,0.001,1017,987,100,25,0.01,2004,20
0.516,1e-05,50,54,100,50,0.0001,104,1
0.514,1e-05,99,105,100,50,0.0001,204,1
0.512,1e-05,156,148,100,50,0.0001,304,1
0.514,1e-05,204,200,100,50,0.0001,404,1
0.514,1e-05,251,253,100,50,0.0001,504,1
0.514,1e-05,303,301,100,50,0.0001,604,1
0.514,1e-05,355,349,100,50,0.0001,704,1
0.514,1e-05,413,391,100,50,0.0001,804,1
0.518,1e-05,468,436,100,50,0.0001,904,1
0.522,1e-05,514,490,100,50,0.0001,1004,1
0.522,1e-05,563,541,100,50,0.0001,1104,1
0.524,1e-05,622,582,100,50,0.0001,1204,1
0.52,1e-05,669,635,100,50,0.0001,1304,1
0.518,1e-05,711,693,100,50,0.0001,1404,1
0.514,1e-05,760,744,100,50,0.0001,1504,1
0.52,1e-05,810,794,100,50,0.0001,1604,1
0.53,1e-05,861,843,100,50,0.0001,1704,1
0.53,1e-05,913,891,100,50,0.0001,1804,1
0.532,1e-05,962,942,100,50,0.0001,1904,1
0.528,1e-05,1019,985,100,50,0.0001,2004,1
0.514,1e-05,58,46,100,50,0.0001,104,2
0.518,1e-05,117,87,100,50,0.0001,204,2
0.518,1e-05,163,141,100,50,0.0001,304,2
0.52,1e-05,218,186,100,50,0.0001,404,2
0.518,1e-05,262,242,100,50,0.0001,504,2
0.52,1e-05,310,294,100,50,0.0001,604,2
0.52,1e-05,364,340,100,50,0.0001,704,2
0.52,1e-05,418,386,100,50,0.0001,804,2
0.524,1e-05,470,434,100,50,0.0001,904,2
0.526,1e-05,524,480,100,50,0.0001,1004,2
0.528,1e-05,573,531,100,50,0.0001,1104,2
0.522,1e-05,630,574,100,50,0.0001,1204,2
0.528,1e-05,682,622,100,50,0.0001,1304,2
0.526,1e-05,721,683,100,50,0.0001,1404,2
0.526,1e-05,767,737,100,50,0.0001,1504,2
0.528,1e-05,819,785,100,50,0.0001,1604,2
0.53,1e-05,868,836,100,50,0.0001,1704,2
0.53,1e-05,912,892,100,50,0.0001,1804,2
0.536,1e-05,967,937,100,50,0.0001,1904,2
0.54,1e-05,1015,989,100,50,0.0001,2004,2
0.534,1e-05,49,55,100,50,0.0001,104,3
0.536,1e-05,85,119,100,50,0.0001,204,3
0.534,1e-05,134,170,100,50,0.0001,304,3
0.536,1e-05,188,216,100,50,0.0001,404,3
0.534,1e-05,241,263,100,50,0.0001,504,3
0.534,1e-05,292,312,100,50,0.0001,604,3
0.534,1e-05,336,368,100,50,0.0001,704,3
0.536,1e-05,390,414,100,50,0.0001,804,3
0.536,1e-05,432,472,100,50,0.0001,904,3
0.536,1e-05,482,522,100,50,0.0001,1004,3
0.536,1e-05,541,563,100,50,0.0001,1104,3
0.536,1e-05,596,608,100,50,0.0001,1204,3
0.536,1e-05,641,663,100,50,0.0001,1304,3
0.54,1e-05,688,716,100,50,0.0001,1404,3
0.548,1e-05,737,767,100,50,0.0001,1504,3
0.55,1e-05,777,827,100,50,0.0001,1604,3
0.554,1e-05,832,872,100,50,0.0001,1704,3
0.556,1e-05,885,919,100,50,0.0001,1804,3
0.558,1e-05,937,967,100,50,0.0001,1904,3
0.56,1e-05,997,1007,100,50,0.0001,2004,3
0.492,1e-05,53,51,100,50,0.0001,104,4
0.494,1e-05,96,108,100,50,0.0001,204,4
0.498,1e-05,134,170,100,50,0.0001,304,4
0.5,1e-05,178,226,100,50,0.0001,404,4
0.502,1e-05,227,277,100,50,0.0001,504,4
0.504,1e-05,277,327,100,50,0.0001,604,4
0.502,1e-05,325,379,100,50,0.0001,704,4
0.502,1e-05,374,430,100,50,0.0001,804,4
0.504,1e-05,416,488,100,50,0.0001,904,4
0.504,1e-05,475,529,100,50,0.0001,1004,4
0.504,1e-05,531,573,100,50,0.0001,1104,4
0.508,1e-05,575,629,100,50,0.0001,1204,4
0.51,1e-05,635,669,100,50,0.0001,1304,4
0.51,1e-05,686,718,100,50,0.0001,1404,4
0.514,1e-05,742,762,100,50,0.0001,1504,4
0.518,1e-05,788,816,100,50,0.0001,1604,4
0.516,1e-05,836,868,100,50,0.0001,1704,4
0.518,1e-05,885,919,100,50,0.0001,1804,4
0.52,1e-05,937,967,100,50,0.0001,1904,4
0.528,1e-05,985,1019,100,50,0.0001,2004,4
0.476,1e-05,54,50,100,50,0.0001,104,5
0.476,1e-05,104,100,100,50,0.0001,204,5
0.474,1e-05,155,149,100,50,0.0001,304,5
0.476,1e-05,205,199,100,50,0.0001,404,5
0.476,1e-05,254,250,100,50,0.0001,504,5
0.482,1e-05,308,296,100,50,0.0001,604,5
0.48,1e-05,360,344,100,50,0.0001,704,5
0.482,1e-05,409,395,100,50,0.0001,804,5
0.484,1e-05,464,440,100,50,0.0001,904,5
0.486,1e-05,506,498,100,50,0.0001,1004,5
0.486,1e-05,556,548,100,50,0.0001,1104,5
0.49,1e-05,602,602,100,50,0.0001,1204,5
0.49,1e-05,653,651,100,50,0.0001,1304,5
0.494,1e-05,711,693,100,50,0.0001,1404,5
0.496,1e-05,770,734,100,50,0.0001,1504,5
0.498,1e-05,815,789,100,50,0.0001,1604,5
0.5,1e-05,873,831,100,50,0.0001,1704,5
0.51,1e-05,928,876,100,50,0.0001,1804,5
0.504,1e-05,972,932,100,50,0.0001,1904,5
0.51,1e-05,1016,988,100,50,0.0001,2004,5
0.478,1e-05,46,58,100,50,0.0001,104,6
0.476,1e-05,86,118,100,50,0.0001,204,6
0.476,1e-05,135,169,100,50,0.0001,304,6
0.478,1e-05,175,229,100,50,0.0001,404,6
0.48,1e-05,228,276,100,50,0.0001,504,6
0.48,1e-05,278,326,100,50,0.0001,604,6
0.48,1e-05,331,373,100,50,0.0001,704,6
0.48,1e-05,384,420,100,50,0.0001,804,6
0.48,1e-05,442,462,100,50,0.0001,904,6
0.482,1e-05,485,519,100,50,0.0001,1004,6
0.484,1e-05,535,569,100,50,0.0001,1104,6
0.486,1e-05,584,620,100,50,0.0001,1204,6
0.486,1e-05,640,664,100,50,0.0001,1304,6
0.484,1e-05,687,717,100,50,0.0001,1404,6
0.488,1e-05,739,765,100,50,0.0001,1504,6
0.49,1e-05,785,819,100,50,0.0001,1604,6
0.494,1e-05,833,871,100,50,0.0001,1704,6
0.5,1e-05,877,927,100,50,0.0001,1804,6
0.5,1e-05,927,977,100,50,0.0001,1904,6
0.504,1e-05,976,1028,100,50,0.0001,2004,6
0.502,1e-05,54,50,100,50,0.0001,104,7
0.502,1e-05,95,109,100,50,0.0001,204,7
0.502,1e-05,152,152,100,50,0.0001,304,7
0.502,1e-05,206,198,100,50,0.0001,404,7
0.506,1e-05,257,247,100,50,0.0001,504,7
0.508,1e-05,299,305,100,50,0.0001,604,7
0.506,1e-05,352,352,100,50,0.0001,704,7
0.506,1e-05,402,402,100,50,0.0001,804,7
0.51,1e-05,448,456,100,50,0.0001,904,7
0.506,1e-05,500,504,100,50,0.0001,1004,7
0.512,1e-05,552,552,100,50,0.0001,1104,7
0.514,1e-05,602,602,100,50,0.0001,1204,7
0.514,1e-05,653,651,100,50,0.0001,1304,7
0.512,1e-05,713,691,100,50,0.0001,1404,7
0.512,1e-05,755,749,100,50,0.0001,1504,7
0.508,1e-05,804,800,100,50,0.0001,1604,7
0.512,1e-05,856,848,100,50,0.0001,1704,7
0.516,1e-05,904,900,100,50,0.0001,1804,7
0.52,1e-05,948,956,100,50,0.0001,1904,7
0.526,1e-05,1001,1003,100,50,0.0001,2004,7
0.486,1e-05,58,46,100,50,0.0001,104,8
0.484,1e-05,112,92,100,50,0.0001,204,8
0.484,1e-05,155,149,100,50,0.0001,304,8
0.486,1e-05,201,203,100,50,0.0001,404,8
0.486,1e-05,249,255,100,50,0.0001,504,8
0.486,1e-05,301,303,100,50,0.0001,604,8
0.486,1e-05,342,362,100,50,0.0001,704,8
0.488,1e-05,394,410,100,50,0.0001,804,8
0.486,1e-05,445,459,100,50,0.0001,904,8
0.486,1e-05,497,507,100,50,0.0001,1004,8
0.486,1e-05,543,561,100,50,0.0001,1104,8
0.488,1e-05,600,604,100,50,0.0001,1204,8
0.49,1e-05,650,654,100,50,0.0001,1304,8
0.49,1e-05,697,707,100,50,0.0001,1404,8
0.492,1e-05,756,748,100,50,0.0001,1504,8
0.492,1e-05,803,801,100,50,0.0001,1604,8
0.492,1e-05,849,855,100,50,0.0001,1704,8
0.498,1e-05,903,901,100,50,0.0001,1804,8
0.496,1e-05,959,945,100,50,0.0001,1904,8
0.496,1e-05,1003,1001,100,50,0.0001,2004,8
0.508,1e-05,51,53,100,50,0.0001,104,9
0.504,1e-05,96,108,100,50,0.0001,204,9
0.5,1e-05,144,160,100,50,0.0001,304,9
0.504,1e-05,189,215,100,50,0.0001,404,9
0.502,1e-05,244,260,100,50,0.0001,504,9
0.498,1e-05,288,316,100,50,0.0001,604,9
0.5,1e-05,343,361,100,50,0.0001,704,9
0.498,1e-05,394,410,100,50,0.0001,804,9
0.502,1e-05,442,462,100,50,0.0001,904,9
0.508,1e-05,495,509,100,50,0.0001,1004,9
0.51,1e-05,538,566,100,50,0.0001,1104,9
0.51,1e-05,584,620,100,50,0.0001,1204,9
0.512,1e-05,634,670,100,50,0.0001,1304,9
0.516,1e-05,687,717,100,50,0.0001,1404,9
0.52,1e-05,742,762,100,50,0.0001,1504,9
0.528,1e-05,797,807,100,50,0.0001,1604,9
0.532,1e-05,848,856,100,50,0.0001,1704,9
0.534,1e-05,893,911,100,50,0.0001,1804,9
0.536,1e-05,946,958,100,50,0.0001,1904,9
0.536,1e-05,1006,998,100,50,0.0001,2004,9
0.506,1e-05,50,54,100,50,0.0001,104,10
0.506,1e-05,97,107,100,50,0.0001,204,10
0.504,1e-05,145,159,100,50,0.0001,304,10
0.504,1e-05,206,198,100,50,0.0001,404,10
0.504,1e-05,253,251,100,50,0.0001,504,10
0.502,1e-05,306,298,100,50,0.0001,604,10
0.5,1e-05,359,345,100,50,0.0001,704,10
0.502,1e-05,416,388,100,50,0.0001,804,10
0.5,1e-05,464,440,100,50,0.0001,904,10
0.5,1e-05,511,493,100,50,0.0001,1004,10
0.502,1e-05,562,542,100,50,0.0001,1104,10
0.5,1e-05,617,587,100,50,0.0001,1204,10
0.506,1e-05,662,642,100,50,0.0001,1304,10
0.508,1e-05,711,693,100,50,0.0001,1404,10
0.512,1e-05,761,743,100,50,0.0001,1504,10
0.512,1e-05,807,797,100,50,0.0001,1604,10
0.51,1e-05,854,850,100,50,0.0001,1704,10
0.51,1e-05,900,904,100,50,0.0001,1804,10
0.514,1e-05,957,947,100,50,0.0001,1904,10
0.518,1e-05,1007,997,100,50,0.0001,2004,10
0.454,1e-05,56,48,100,50,0.0001,104,11
0.454,1e-05,104,100,100,50,0.0001,204,11
0.454,1e-05,154,150,100,50,0.0001,304,11
0.456,1e-05,200,204,100,50,0.0001,404,11
0.456,1e-05,251,253,100,50,0.0001,504,11
0.458,1e-05,299,305,100,50,0.0001,604,11
0.458,1e-05,360,344,100,50,0.0001,704,11
0.458,1e-05,407,397,100,50,0.0001,804,11
0.458,1e-05,458,446,100,50,0.0001,904,11
0.46,1e-05,504,500,100,50,0.0001,1004,11
0.46,1e-05,555,549,100,50,0.0001,1104,11
0.464,1e-05,609,595,100,50,0.0001,1204,11
0.468,1e-05,665,639,100,50,0.0001,1304,11
0.47,1e-05,718,686,100,50,0.0001,1404,11
0.47,1e-05,767,737,100,50,0.0001,1504,11
0.472,1e-05,826,778,100,50,0.0001,1604,11
0.474,1e-05,871,833,100,50,0.0001,1704,11
0.472,1e-05,910,894,100,50,0.0001,1804,11
0.468,1e-05,956,948,100,50,0.0001,1904,11
0.464,1e-05,1000,1004,100,50,0.0001,2004,11
0.542,1e-05,48,56,100,50,0.0001,104,12
0.542,1e-05,101,103,100,50,0.0001,204,12
0.542,1e-05,148,156,100,50,0.0001,304,12
0.544,1e-05,191,213,100,50,0.0001,404,12
0.542,1e-05,247,257,100,50,0.0001,504,12
0.544,1e-05,293,311,100,50,0.0001,604,12
0.542,1e-05,343,361,100,50,0.0001,704,12
0.544,1e-05,393,411,100,50,0.0001,804,12
0.546,1e-05,440,464,100,50,0.0001,904,12
0.548,1e-05,483,521,100,50,0.0001,1004,12
0.548,1e-05,532,572,100,50,0.0001,1104,12
0.546,1e-05,577,627,100,50,0.0001,1204,12
0.546,1e-05,628,676,100,50,0.0001,1304,12
0.548,1e-05,674,730,100,50,0.0001,1404,12
0.548,1e-05,719,785,100,50,0.0001,1504,12
0.55,1e-05,773,831,100,50,0.0001,1604,12
0.552,1e-05,828,876,100,50,0.0001,1704,12
0.55,1e-05,888,916,100,50,0.0001,1804,12
0.55,1e-05,939,965,100,50,0.0001,1904,12
0.55,1e-05,991,1013,100,50,0.0001,2004,12
0.486,1e-05,50,54,100,50,0.0001,104,13
0.49,1e-05,88,116,100,50,0.0001,204,13
0.486,1e-05,142,162,100,50,0.0001,304,13
0.49,1e-05,200,204,100,50,0.0001,404,13
0.492,1e-05,247,257,100,50,0.0001,504,13
0.49,1e-05,290,314,100,50,0.0001,604,13
0.492,1e-05,350,354,100,50,0.0001,704,13
0.49,1e-05,410,394,100,50,0.0001,804,13
0.49,1e-05,462,442,100,50,0.0001,904,13
0.496,1e-05,512,492,100,50,0.0001,1004,13
0.496,1e-05,556,548,100,50,0.0001,1104,13
0.502,1e-05,608,596,100,50,0.0001,1204,13
0.498,1e-05,663,641,100,50,0.0001,1304,13
0.502,1e-05,713,691,100,50,0.0001,1404,13
0.504,1e-05,764,740,100,50,0.0001,1504,13
0.506,1e-05,813,791,100,50,0.0001,1604,13
0.506,1e-05,871,833,100,50,0.0001,1704,13
0.514,1e-05,916,888,100,50,0.0001,1804,13
0.516,1e-05,970,934,100,50,0.0001,1904,13
0.52,1e-05,1025,979,100,50,0.0001,2004,13
0.494,1e-05,52,52,100,50,0.0001,104,14
0.494,1e-05,101,103,100,50,0.0001,204,14
0.496,1e-05,152,152,100,50,0.0001,304,14
0.496,1e-05,204,200,100,50,0.0001,404,14
0.496,1e-05,241,263,100,50,0.0001,504,14
0.498,1e-05,289,315,100,50,0.0001,604,14
0.498,1e-05,335,369,100,50,0.0001,704,14
0.502,1e-05,383,421,100,50,0.0001,804,14
0.504,1e-05,427,477,100,50,0.0001,904,14
0.5,1e-05,478,526,100,50,0.0001,1004,14
0.502,1e-05,532,572,100,50,0.0001,1104,14
0.51,1e-05,582,622,100,50,0.0001,1204,14
0.516,1e-05,635,669,100,50,0.0001,1304,14
0.518,1e-05,693,711,100,50,0.0001,1404,14
0.518,1e-05,741,763,100,50,0.0001,1504,14
0.518,1e-05,794,810,100,50,0.0001,1604,14
0.516,1e-05,836,868,100,50,0.0001,1704,14
0.516,1e-05,894,910,100,50,0.0001,1804,14
0.524,1e-05,946,958,100,50,0.0001,1904,14
0.524,1e-05,997,1007,100,50,0.0001,2004,14
0.512,1e-05,56,48,100,50,0.0001,104,15
0.51,1e-05,102,102,100,50,0.0001,204,15
0.512,1e-05,157,147,100,50,0.0001,304,15
0.512,1e-05,209,195,100,50,0.0001,404,15
0.514,1e-05,264,240,100,50,0.0001,504,15
0.516,1e-05,319,285,100,50,0.0001,604,15
0.516,1e-05,364,340,100,50,0.0001,704,15
0.52,1e-05,416,388,100,50,0.0001,804,15
0.518,1e-05,458,446,100,50,0.0001,904,15
0.516,1e-05,516,488,100,50,0.0001,1004,15
0.516,1e-05,575,529,100,50,0.0001,1104,15
0.52,1e-05,619,585,100,50,0.0001,1204,15
0.516,1e-05,674,630,100,50,0.0001,1304,15
0.516,1e-05,713,691,100,50,0.0001,1404,15
0.516,1e-05,775,729,100,50,0.0001,1504,15
0.516,1e-05,822,782,100,50,0.0001,1604,15
0.514,1e-05,857,847,100,50,0.0001,1704,15
0.516,1e-05,897,907,100,50,0.0001,1804,15
0.518,1e-05,949,955,100,50,0.0001,1904,15
0.516,1e-05,999,1005,100,50,0.0001,2004,15
0.47,1e-05,48,56,100,50,0.0001,104,16
0.47,1e-05,97,107,100,50,0.0001,204,16
0.47,1e-05,149,155,100,50,0.0001,304,16
0.47,1e-05,190,214,100,50,0.0001,404,16
0.47,1e-05,241,263,100,50,0.0001,504,16
0.472,1e-05,291,313,100,50,0.0001,604,16
0.472,1e-05,342,362,100,50,0.0001,704,16
0.472,1e-05,390,414,100,50,0.0001,804,16
0.472,1e-05,440,464,100,50,0.0001,904,16
0.47,1e-05,498,506,100,50,0.0001,1004,16
0.472,1e-05,546,558,100,50,0.0001,1104,16
0.476,1e-05,593,611,100,50,0.0001,1204,16
0.476,1e-05,636,668,100,50,0.0001,1304,16
0.484,1e-05,690,714,100,50,0.0001,1404,16
0.484,1e-05,747,757,100,50,0.0001,1504,16
0.49,1e-05,799,805,100,50,0.0001,1604,16
0.492,1e-05,851,853,100,50,0.0001,1704,16
0.496,1e-05,899,905,100,50,0.0001,1804,16
0.5,1e-05,958,946,100,50,0.0001,1904,16
0.5,1e-05,1010,994,100,50,0.0001,2004,16
0.488,1e-05,49,55,100,50,0.0001,104,17
0.49,1e-05,92,112,100,50,0.0001,204,17
0.49,1e-05,146,158,100,50,0.0001,304,17
0.492,1e-05,195,209,100,50,0.0001,404,17
0.492,1e-05,249,255,100,50,0.0001,504,17
0.492,1e-05,301,303,100,50,0.0001,604,17
0.492,1e-05,355,349,100,50,0.0001,704,17
0.488,1e-05,404,400,100,50,0.0001,804,17
0.492,1e-05,460,444,100,50,0.0001,904,17
0.496,1e-05,506,498,100,50,0.0001,1004,17
0.494,1e-05,556,548,100,50,0.0001,1104,17
0.496,1e-05,609,595,100,50,0.0001,1204,17
0.5,1e-05,656,648,100,50,0.0001,1304,17
0.506,1e-05,706,698,100,50,0.0001,1404,17
0.506,1e-05,755,749,100,50,0.0001,1504,17
0.506,1e-05,811,793,100,50,0.0001,1604,17
0.504,1e-05,861,843,100,50,0.0001,1704,17
0.506,1e-05,912,892,100,50,0.0001,1804,17
0.51,1e-05,970,934,100,50,0.0001,1904,17
0.506,1e-05,1020,984,100,50,0.0001,2004,17
0.492,1e-05,60,44,100,50,0.0001,104,18
0.496,1e-05,106,98,100,50,0.0001,204,18
0.494,1e-05,156,148,100,50,0.0001,304,18
0.496,1e-05,213,191,100,50,0.0001,404,18
0.498,1e-05,268,236,100,50,0.0001,504,18
0.5,1e-05,317,287,100,50,0.0001,604,18
0.502,1e-05,359,345,100,50,0.0001,704,18
0.502,1e-05,413,391,100,50,0.0001,804,18
0.5,1e-05,465,439,100,50,0.0001,904,18
0.5,1e-05,510,494,100,50,0.0001,1004,18
0.5,1e-05,552,552,100,50,0.0001,1104,18
0.5,1e-05,610,594,100,50,0.0001,1204,18
0.502,1e-05,662,642,100,50,0.0001,1304,18
0.5,1e-05,703,701,100,50,0.0001,1404,18
0.5,1e-05,760,744,100,50,0.0001,1504,18
0.506,1e-05,807,797,100,50,0.0001,1604,18
0.504,1e-05,853,851,100,50,0.0001,1704,18
0.504,1e-05,909,895,100,50,0.0001,1804,18
0.514,1e-05,962,942,100,50,0.0001,1904,18
0.52,1e-05,1012,992,100,50,0.0001,2004,18
0.512,1e-05,54,50,100,50,0.0001,104,19
0.512,1e-05,102,102,100,50,0.0001,204,19
0.512,1e-05,154,150,100,50,0.0001,304,19
0.512,1e-05,206,198,100,50,0.0001,404,19
0.512,1e-05,254,250,100,50,0.0001,504,19
0.512,1e-05,303,301,100,50,0.0001,604,19
0.512,1e-05,352,352,100,50,0.0001,704,19
0.512,1e-05,396,408,100,50,0.0001,804,19
0.516,1e-05,450,454,100,50,0.0001,904,19
0.516,1e-05,498,506,100,50,0.0001,1004,19
0.514,1e-05,550,554,100,50,0.0001,1104,19
0.518,1e-05,606,598,100,50,0.0001,1204,19
0.522,1e-05,650,654,100,50,0.0001,1304,19
0.524,1e-05,694,710,100,50,0.0001,1404,19
0.534,1e-05,743,761,100,50,0.0001,1504,19
0.534,1e-05,791,813,100,50,0.0001,1604,19
0.534,1e-05,844,860,100,50,0.0001,1704,19
0.534,1e-05,891,913,100,50,0.0001,1804,19
0.532,1e-05,945,959,100,50,0.0001,1904,19
0.53,1e-05,995,1009,100,50,0.0001,2004,19
0.53,1e-05,49,55,100,50,0.0001,104,20
0.53,1e-05,95,109,100,50,0.0001,204,20
0.532,1e-05,149,155,100,50,0.0001,304,20
0.532,1e-05,195,209,100,50,0.0001,404,20
0.534,1e-05,245,259,100,50,0.0001,504,20
0.532,1e-05,297,307,100,50,0.0001,604,20
0.532,1e-05,348,356,100,50,0.0001,704,20
0.534,1e-05,398,406,100,50,0.0001,804,20
0.534,1e-05,447,457,100,50,0.0001,904,20
0.534,1e-05,498,506,100,50,0.0001,1004,20
0.53,1e-05,539,565,100,50,0.0001,1104,20
0.526,1e-05,596,608,100,50,0.0001,1204,20
0.528,1e-05,640,664,100,50,0.0001,1304,20
0.526,1e-05,688,716,100,50,0.0001,1404,20
0.522,1e-05,744,760,100,50,0.0001,1504,20
0.522,1e-05,795,809,100,50,0.0001,1604,20
0.522,1e-05,842,862,100,50,0.0001,1704,20
0.528,1e-05,893,911,100,50,0.0001,1804,20
0.53,1e-05,942,962,100,50,0.0001,1904,20
0.536,1e-05,987,1017,100,50,0.0001,2004,20
0.542,1e-05,55,49,100,50,0.001,104,1
0.536,1e-05,102,102,100,50,0.001,204,1
0.534,1e-05,157,147,100,50,0.001,304,1
0.54,1e-05,203,201,100,50,0.001,404,1
0.536,1e-05,257,247,100,50,0.001,504,1
0.544,1e-05,302,302,100,50,0.001,604,1
0.56,1e-05,351,353,100,50,0.001,704,1
0.574,1e-05,404,400,100,50,0.001,804,1
0.58,1e-05,454,450,100,50,0.001,904,1
0.594,1e-05,507,497,100,50,0.001,1004,1
0.586,1e-05,563,541,100,50,0.001,1104,1
0.594,1e-05,612,592,100,50,0.001,1204,1
0.636,1e-05,665,639,100,50,0.001,1304,1
0.65,1e-05,704,700,100,50,0.001,1404,1
0.672,1e-05,755,749,100,50,0.001,1504,1
0.696,1e-05,804,800,100,50,0.001,1604,1
0.722,1e-05,850,854,100,50,0.001,1704,1
0.758,1e-05,906,898,100,50,0.001,1804,1
0.768,1e-05,956,948,100,50,0.001,1904,1
0.8,1e-05,1010,994,100,50,0.001,2004,1
0.486,1e-05,55,49,100,50,0.001,104,2
0.476,1e-05,107,97,100,50,0.001,204,2
0.476,1e-05,151,153,100,50,0.001,304,2
0.48,1e-05,191,213,100,50,0.001,404,2
0.478,1e-05,240,264,100,50,0.001,504,2
0.488,1e-05,291,313,100,50,0.001,604,2
0.492,1e-05,333,371,100,50,0.001,704,2
0.498,1e-05,372,432,100,50,0.001,804,2
0.502,1e-05,424,480,100,50,0.001,904,2
0.518,1e-05,478,526,100,50,0.001,1004,2
0.53,1e-05,537,567,100,50,0.001,1104,2
0.532,1e-05,583,621,100,50,0.001,1204,2
0.536,1e-05,634,670,100,50,0.001,1304,2
0.562,1e-05,679,725,100,50,0.001,1404,2
0.588,1e-05,720,784,100,50,0.001,1504,2
0.614,1e-05,782,822,100,50,0.001,1604,2
0.638,1e-05,838,866,100,50,0.001,1704,2
0.658,1e-05,884,920,100,50,0.001,1804,2
0.678,1e-05,941,963,100,50,0.001,1904,2
0.698,1e-05,990,1014,100,50,0.001,2004,2
0.506,1e-05,52,52,100,50,0.001,104,3
0.506,1e-05,100,104,100,50,0.001,204,3
0.508,1e-05,144,160,100,50,0.001,304,3
0.506,1e-05,192,212,100,50,0.001,404,3
0.51,1e-05,242,262,100,50,0.001,504,3
0.512,1e-05,285,319,100,50,0.001,604,3
0.52,1e-05,339,365,100,50,0.001,704,3
0.518,1e-05,393,411,100,50,0.001,804,3
0.52,1e-05,446,458,100,50,0.001,904,3
0.514,1e-05,486,518,100,50,0.001,1004,3
0.528,1e-05,545,559,100,50,0.001,1104,3
0.55,1e-05,601,603,100,50,0.001,1204,3
0.56,1e-05,646,658,100,50,0.001,1304,3
0.586,1e-05,697,707,100,50,0.001,1404,3
0.63,1e-05,741,763,100,50,0.001,1504,3
0.652,1e-05,791,813,100,50,0.001,1604,3
0.662,1e-05,843,861,100,50,0.001,1704,3
0.686,1e-05,902,902,100,50,0.001,1804,3
0.706,1e-05,953,951,100,50,0.001,1904,3
0.732,1e-05,1007,997,100,50,0.001,2004,3
0.516,1e-05,49,55,100,50,0.001,104,4
0.52,1e-05,86,118,100,50,0.001,204,4
0.526,1e-05,140,164,100,50,0.001,304,4
0.55,1e-05,186,218,100,50,0.001,404,4
0.55,1e-05,242,262,100,50,0.001,504,4
0.56,1e-05,292,312,100,50,0.001,604,4
0.564,1e-05,351,353,100,50,0.001,704,4
0.572,1e-05,409,395,100,50,0.001,804,4
0.576,1e-05,453,451,100,50,0.001,904,4
0.602,1e-05,498,506,100,50,0.001,1004,4
0.606,1e-05,547,557,100,50,0.001,1104,4
0.62,1e-05,592,612,100,50,0.001,1204,4
0.624,1e-05,639,665,100,50,0.001,1304,4
0.648,1e-05,686,718,100,50,0.001,1404,4
0.652,1e-05,735,769,100,50,0.001,1504,4
0.656,1e-05,785,819,100,50,0.001,1604,4
0.666,1e-05,844,860,100,50,0.001,1704,4
0.69,1e-05,894,910,100,50,0.001,1804,4
0.706,1e-05,946,958,100,50,0.001,1904,4
0.74,1e-05,1003,1001,100,50,0.001,2004,4
0.488,1e-05,50,54,100,50,0.001,104,5
0.486,1e-05,103,101,100,50,0.001,204,5
0.484,1e-05,156,148,100,50,0.001,304,5
0.494,1e-05,199,205,100,50,0.001,404,5
0.494,1e-05,248,256,100,50,0.001,504,5
0.496,1e-05,299,305,100,50,0.001,604,5
0.508,1e-05,341,363,100,50,0.001,704,5
0.52,1e-05,392,412,100,50,0.001,804,5
0.532,1e-05,444,460,100,50,0.001,904,5
0.546,1e-05,500,504,100,50,0.001,1004,5
0.556,1e-05,549,555,100,50,0.001,1104,5
0.564,1e-05,597,607,100,50,0.001,1204,5
0.574,1e-05,650,654,100,50,0.001,1304,5
0.588,1e-05,699,705,100,50,0.001,1404,5
0.608,1e-05,743,761,100,50,0.001,1504,5
0.616,1e-05,802,802,100,50,0.001,1604,5
0.632,1e-05,857,847,100,50,0.001,1704,5
0.67,1e-05,904,900,100,50,0.001,1804,5
0.698,1e-05,953,951,100,50,0.001,1904,5
0.734,1e-05,1005,999,100,50,0.001,2004,5
0.462,1e-05,57,47,100,50,0.001,104,6
0.464,1e-05,102,102,100,50,0.001,204,6
0.474,1e-05,156,148,100,50,0.001,304,6
0.49,1e-05,197,207,100,50,0.001,404,6
0.492,1e-05,245,259,100,50,0.001,504,6
0.508,1e-05,300,304,100,50,0.001,604,6
0.518,1e-05,347,357,100,50,0.001,704,6
0.516,1e-05,392,412,100,50,0.001,804,6
0.53,1e-05,436,468,100,50,0.001,904,6
0.544,1e-05,475,529,100,50,0.001,1004,6
0.554,1e-05,519,585,100,50,0.001,1104,6
0.572,1e-05,572,632,100,50,0.001,1204,6
0.568,1e-05,621,683,100,50,0.001,1304,6
0.58,1e-05,668,736,100,50,0.001,1404,6
0.6,1e-05,721,783,100,50,0.001,1504,6
0.63,1e-05,770,834,100,50,0.001,1604,6
0.642,1e-05,825,879,100,50,0.001,1704,6
0.682,1e-05,878,926,100,50,0.001,1804,6
0.69,1e-05,925,979,100,50,0.001,1904,6
0.722,1e-05,977,1027,100,50,0.001,2004,6
0.484,1e-05,49,55,100,50,0.001,104,7
0.484,1e-05,104,100,100,50,0.001,204,7
0.492,1e-05,156,148,100,50,0.001,304,7
0.494,1e-05,202,202,100,50,0.001,404,7
0.502,1e-05,253,251,100,50,0.001,504,7
0.498,1e-05,293,311,100,50,0.001,604,7
0.504,1e-05,339,365,100,50,0.001,704,7
0.516,1e-05,388,416,100,50,0.001,804,7
0.518,1e-05,434,470,100,50,0.001,904,7
0.544,1e-05,476,528,100,50,0.001,1004,7
0.552,1e-05,528,576,100,50,0.001,1104,7
0.562,1e-05,567,637,100,50,0.001,1204,7
0.57,1e-05,613,691,100,50,0.001,1304,7
0.59,1e-05,665,739,100,50,0.001,1404,7
0.62,1e-05,719,785,100,50,0.001,1504,7
0.64,1e-05,768,836,100,50,0.001,1604,7
0.67,1e-05,821,883,100,50,0.001,1704,7
0.702,1e-05,879,925,100,50,0.001,1804,7
0.73,1e-05,933,971,100,50,0.001,1904,7
0.75,1e-05,989,1015,100,50,0.001,2004,7
0.48,1e-05,54,50,100,50,0.001,104,8
0.482,1e-05,105,99,100,50,0.001,204,8
0.488,1e-05,150,154,100,50,0.001,304,8
0.494,1e-05,203,201,100,50,0.001,404,8
0.504,1e-05,257,247,100,50,0.001,504,8
0.5,1e-05,307,297,100,50,0.001,604,8
0.51,1e-05,348,356,100,50,0.001,704,8
0.522,1e-05,393,411,100,50,0.001,804,8
0.546,1e-05,442,462,100,50,0.001,904,8
0.578,1e-05,488,516,100,50,0.001,1004,8
0.594,1e-05,539,565,100,50,0.001,1104,8
0.606,1e-05,596,608,100,50,0.001,1204,8
0.626,1e-05,643,661,100,50,0.001,1304,8
0.66,1e-05,695,709,100,50,0.001,1404,8
0.668,1e-05,751,753,100,50,0.001,1504,8
0.704,1e-05,798,806,100,50,0.001,1604,8
0.712,1e-05,850,854,100,50,0.001,1704,8
0.736,1e-05,897,907,100,50,0.001,1804,8
0.752,1e-05,949,955,100,50,0.001,1904,8
0.782,1e-05,1000,1004,100,50,0.001,2004,8
0.562,1e-05,47,57,100,50,0.001,104,9
0.574,1e-05,94,110,100,50,0.001,204,9
0.572,1e-05,141,163,100,50,0.001,304,9
0.574,1e-05,185,219,100,50,0.001,404,9
0.564,1e-05,232,272,100,50,0.001,504,9
0.574,1e-05,286,318,100,50,0.001,604,9
0.578,1e-05,334,370,100,50,0.001,704,9
0.58,1e-05,387,417,100,50,0.001,804,9
0.596,1e-05,437,467,100,50,0.001,904,9
0.604,1e-05,479,525,100,50,0.001,1004,9
0.61,1e-05,531,573,100,50,0.001,1104,9
0.618,1e-05,586,618,100,50,0.001,1204,9
0.624,1e-05,633,671,100,50,0.001,1304,9
0.656,1e-05,684,720,100,50,0.001,1404,9
0.684,1e-05,741,763,100,50,0.001,1504,9
0.704,1e-05,792,812,100,50,0.001,1604,9
0.72,1e-05,836,868,100,50,0.001,1704,9
0.758,1e-05,892,912,100,50,0.001,1804,9
0.768,1e-05,942,962,100,50,0.001,1904,9
0.8,1e-05,991,1013,100,50,0.001,2004,9
0.524,1e-05,57,47,100,50,0.001,104,10
0.518,1e-05,109,95,100,50,0.001,204,10
0.524,1e-05,163,141,100,50,0.001,304,10
0.53,1e-05,217,187,100,50,0.001,404,10
0.532,1e-05,272,232,100,50,0.001,504,10
0.536,1e-05,311,293,100,50,0.001,604,10
0.548,1e-05,364,340,100,50,0.001,704,10
0.542,1e-05,408,396,100,50,0.001,804,10
0.546,1e-05,455,449,100,50,0.001,904,10
0.552,1e-05,506,498,100,50,0.001,1004,10
0.572,1e-05,555,549,100,50,0.001,1104,10
0.574,1e-05,605,599,100,50,0.001,1204,10
0.588,1e-05,654,650,100,50,0.001,1304,10
0.612,1e-05,708,696,100,50,0.001,1404,10
0.64,1e-05,760,744,100,50,0.001,1504,10
0.644,1e-05,802,802,100,50,0.001,1604,10
0.672,1e-05,849,855,100,50,0.001,1704,10
0.696,1e-05,900,904,100,50,0.001,1804,10
0.718,1e-05,956,948,100,50,0.001,1904,10
0.724,1e-05,999,1005,100,50,0.001,2004,10
0.512,1e-05,62,42,100,50,0.001,104,11
0.51,1e-05,106,98,100,50,0.001,204,11
0.518,1e-05,161,143,100,50,0.001,304,11
0.52,1e-05,214,190,100,50,0.001,404,11
0.524,1e-05,265,239,100,50,0.001,504,11
0.53,1e-05,314,290,100,50,0.001,604,11
0.534,1e-05,373,331,100,50,0.001,704,11
0.54,1e-05,417,387,100,50,0.001,804,11
0.542,1e-05,460,444,100,50,0.001,904,11
0.548,1e-05,510,494,100,50,0.001,1004,11
0.566,1e-05,559,545,100,50,0.001,1104,11
0.568,1e-05,607,597,100,50,0.001,1204,11
0.588,1e-05,655,649,100,50,0.001,1304,11
0.604,1e-05,708,696,100,50,0.001,1404,11
0.616,1e-05,754,750,100,50,0.001,1504,11
0.64,1e-05,807,797,100,50,0.001,1604,11
0.646,1e-05,861,843,100,50,0.001,1704,11
0.674,1e-05,913,891,100,50,0.001,1804,11
0.692,1e-05,957,947,100,50,0.001,1904,11
0.73,1e-05,1004,1000,100,50,0.001,2004,11
0.54,1e-05,54,50,100,50,0.001,104,12
0.54,1e-05,110,94,100,50,0.001,204,12
0.534,1e-05,161,143,100,50,0.001,304,12
0.532,1e-05,207,197,100,50,0.001,404,12
0.536,1e-05,254,250,100,50,0.001,504,12
0.548,1e-05,299,305,100,50,0.001,604,12
0.552,1e-05,349,355,100,50,0.001,704,12
0.568,1e-05,403,401,100,50,0.001,804,12
0.576,1e-05,446,458,100,50,0.001,904,12
0.582,1e-05,486,518,100,50,0.001,1004,12
0.578,1e-05,549,555,100,50,0.001,1104,12
0.588,1e-05,590,614,100,50,0.001,1204,12
0.616,1e-05,638,666,100,50,0.001,1304,12
0.632,1e-05,692,712,100,50,0.001,1404,12
0.634,1e-05,739,765,100,50,0.001,1504,12
0.642,1e-05,794,810,100,50,0.001,1604,12
0.656,1e-05,854,850,100,50,0.001,1704,12
0.68,1e-05,902,902,100,50,0.001,1804,12
0.7,1e-05,959,945,100,50,0.001,1904,12
0.734,1e-05,1006,998,100,50,0.001,2004,12
0.476,1e-05,58,46,100,50,0.001,104,13
0.48,1e-05,112,92,100,50,0.001,204,13
0.492,1e-05,161,143,100,50,0.001,304,13
0.494,1e-05,210,194,100,50,0.001,404,13
0.496,1e-05,267,237,100,50,0.001,504,13
0.5,1e-05,315,289,100,50,0.001,604,13
0.508,1e-05,360,344,100,50,0.001,704,13
0.514,1e-05,410,394,100,50,0.001,804,13
0.524,1e-05,464,440,100,50,0.001,904,13
0.528,1e-05,517,487,100,50,0.001,1004,13
0.55,1e-05,564,540,100,50,0.001,1104,13
0.566,1e-05,614,590,100,50,0.001,1204,13
0.588,1e-05,664,640,100,50,0.001,1304,13
0.61,1e-05,717,687,100,50,0.001,1404,13
0.638,1e-05,759,745,100,50,0.001,1504,13
0.66,1e-05,798,806,100,50,0.001,1604,13
0.662,1e-05,852,852,100,50,0.001,1704,13
0.67,1e-05,901,903,100,50,0.001,1804,13
0.704,1e-05,952,952,100,50,0.001,1904,13
0.712,1e-05,1006,998,100,50,0.001,2004,13
0.504,1e-05,41,63,100,50,0.001,104,14
0.508,1e-05,91,113,100,50,0.001,204,14
0.508,1e-05,139,165,100,50,0.001,304,14
0.504,1e-05,191,213,100,50,0.001,404,14
0.51,1e-05,236,268,100,50,0.001,504,14
0.528,1e-05,281,323,100,50,0.001,604,14
0.526,1e-05,332,372,100,50,0.001,704,14
0.524,1e-05,389,415,100,50,0.001,804,14
0.522,1e-05,433,471,100,50,0.001,904,14
0.534,1e-05,483,521,100,50,0.001,1004,14
0.542,1e-05,532,572,100,50,0.001,1104,14
0.552,1e-05,590,614,100,50,0.001,1204,14
0.574,1e-05,640,664,100,50,0.001,1304,14
0.596,1e-05,690,714,100,50,0.001,1404,14
0.626,1e-05,741,763,100,50,0.001,1504,14
0.632,1e-05,788,816,100,50,0.001,1604,14
0.652,1e-05,835,869,100,50,0.001,1704,14
0.662,1e-05,889,915,100,50,0.001,1804,14
0.696,1e-05,946,958,100,50,0.001,1904,14
0.718,1e-05,1000,1004,100,50,0.001,2004,14
0.518,1e-05,51,53,100,50,0.001,104,15
0.512,1e-05,102,102,100,50,0.001,204,15
0.52,1e-05,155,149,100,50,0.001,304,15
0.53,1e-05,201,203,100,50,0.001,404,15
0.534,1e-05,263,241,100,50,0.001,504,15
0.534,1e-05,308,296,100,50,0.001,604,15
0.542,1e-05,360,344,100,50,0.001,704,15
0.536,1e-05,418,386,100,50,0.001,804,15
0.542,1e-05,472,432,100,50,0.001,904,15
0.54,1e-05,516,488,100,50,0.001,1004,15
0.546,1e-05,571,533,100,50,0.001,1104,15
0.55,1e-05,615,589,100,50,0.001,1204,15
0.556,1e-05,660,644,100,50,0.001,1304,15
0.566,1e-05,714,690,100,50,0.001,1404,15
0.582,1e-05,763,741,100,50,0.001,1504,15
0.6,1e-05,820,784,100,50,0.001,1604,15
0.616,1e-05,865,839,100,50,0.001,1704,15
0.64,1e-05,917,887,100,50,0.001,1804,15
0.682,1e-05,962,942,100,50,0.001,1904,15
0.712,1e-05,1006,998,100,50,0.001,2004,15
0.508,1e-05,55,49,100,50,0.001,104,16
0.512,1e-05,106,98,100,50,0.001,204,16
0.506,1e-05,155,149,100,50,0.001,304,16
0.504,1e-05,197,207,100,50,0.001,404,16
0.508,1e-05,249,255,100,50,0.001,504,16
0.506,1e-05,304,300,100,50,0.001,604,16
0.532,1e-05,354,350,100,50,0.001,704,16
0.532,1e-05,403,401,100,50,0.001,804,16
0.568,1e-05,456,448,100,50,0.001,904,16
0.582,1e-05,512,492,100,50,0.001,1004,16
0.614,1e-05,557,547,100,50,0.001,1104,16
0.63,1e-05,603,601,100,50,0.001,1204,16
0.644,1e-05,651,653,100,50,0.001,1304,16
0.654,1e-05,706,698,100,50,0.001,1404,16
0.678,1e-05,755,749,100,50,0.001,1504,16
0.704,1e-05,816,788,100,50,0.001,1604,16
0.72,1e-05,867,837,100,50,0.001,1704,16
0.728,1e-05,911,893,100,50,0.001,1804,16
0.75,1e-05,953,951,100,50,0.001,1904,16
0.784,1e-05,1002,1002,100,50,0.001,2004,16
0.524,1e-05,48,56,100,50,0.001,104,17
0.522,1e-05,100,104,100,50,0.001,204,17
0.532,1e-05,135,169,100,50,0.001,304,17
0.54,1e-05,181,223,100,50,0.001,404,17
0.54,1e-05,230,274,100,50,0.001,504,17
0.562,1e-05,280,324,100,50,0.001,604,17
0.556,1e-05,329,375,100,50,0.001,704,17
0.57,1e-05,382,422,100,50,0.001,804,17
0.576,1e-05,431,473,100,50,0.001,904,17
0.596,1e-05,487,517,100,50,0.001,1004,17
0.604,1e-05,542,562,100,50,0.001,1104,17
0.6,1e-05,593,611,100,50,0.001,1204,17
0.594,1e-05,645,659,100,50,0.001,1304,17
0.612,1e-05,690,714,100,50,0.001,1404,17
0.636,1e-05,735,769,100,50,0.001,1504,17
0.646,1e-05,789,815,100,50,0.001,1604,17
0.65,1e-05,841,863,100,50,0.001,1704,17
0.668,1e-05,887,917,100,50,0.001,1804,17
0.672,1e-05,938,966,100,50,0.001,1904,17
0.692,1e-05,997,1007,100,50,0.001,2004,17
0.518,1e-05,44,60,100,50,0.001,104,18
0.52,1e-05,87,117,100,50,0.001,204,18
0.522,1e-05,137,167,100,50,0.001,304,18
0.528,1e-05,184,220,100,50,0.001,404,18
0.53,1e-05,244,260,100,50,0.001,504,18
0.536,1e-05,294,310,100,50,0.001,604,18
0.546,1e-05,348,356,100,50,0.001,704,18
0.544,1e-05,393,411,100,50,0.001,804,18
0.542,1e-05,444,460,100,50,0.001,904,18
0.546,1e-05,494,510,100,50,0.001,1004,18
0.558,1e-05,545,559,100,50,0.001,1104,18
0.57,1e-05,588,616,100,50,0.001,1204,18
0.574,1e-05,642,662,100,50,0.001,1304,18
0.578,1e-05,690,714,100,50,0.001,1404,18
0.588,1e-05,740,764,100,50,0.001,1504,18
0.604,1e-05,792,812,100,50,0.001,1604,18
0.62,1e-05,854,850,100,50,0.001,1704,18
0.638,1e-05,909,895,100,50,0.001,1804,18
0.664,1e-05,953,951,100,50,0.001,1904,18
0.69,1e-05,1009,995,100,50,0.001,2004,18
0.49,1e-05,49,55,100,50,0.001,104,19
0.482,1e-05,97,107,100,50,0.001,204,19
0.486,1e-05,141,163,100,50,0.001,304,19
0.498,1e-05,196,208,100,50,0.001,404,19
0.5,1e-05,244,260,100,50,0.001,504,19
0.512,1e-05,296,308,100,50,0.001,604,19
0.514,1e-05,352,352,100,50,0.001,704,19
0.542,1e-05,403,401,100,50,0.001,804,19
0.558,1e-05,459,445,100,50,0.001,904,19
0.568,1e-05,505,499,100,50,0.001,1004,19
0.596,1e-05,556,548,100,50,0.001,1104,19
0.62,1e-05,605,599,100,50,0.001,1204,19
0.646,1e-05,653,651,100,50,0.001,1304,19
0.668,1e-05,705,699,100,50,0.001,1404,19
0.672,1e-05,754,750,100,50,0.001,1504,19
0.7,1e-05,803,801,100,50,0.001,1604,19
0.71,1e-05,856,848,100,50,0.001,1704,19
0.736,1e-05,905,899,100,50,0.001,1804,19
0.746,1e-05,965,939,100,50,0.001,1904,19
0.776,1e-05,1011,993,100,50,0.001,2004,19
0.506,1e-05,56,48,100,50,0.001,104,20
0.508,1e-05,99,105,100,50,0.001,204,20
0.508,1e-05,148,156,100,50,0.001,304,20
0.506,1e-05,202,202,100,50,0.001,404,20
0.506,1e-05,250,254,100,50,0.001,504,20
0.514,1e-05,305,299,100,50,0.001,604,20
0.516,1e-05,354,350,100,50,0.001,704,20
0.518,1e-05,405,399,100,50,0.001,804,20
0.528,1e-05,462,442,100,50,0.001,904,20
0.522,1e-05,504,500,100,50,0.001,1004,20
0.528,1e-05,541,563,100,50,0.001,1104,20
0.552,1e-05,589,615,100,50,0.001,1204,20
0.568,1e-05,645,659,100,50,0.001,1304,20
0.58,1e-05,699,705,100,50,0.001,1404,20
0.588,1e-05,756,748,100,50,0.001,1504,20
0.624,1e-05,807,797,100,50,0.001,1604,20
0.628,1e-05,861,843,100,50,0.001,1704,20
0.644,1e-05,908,896,100,50,0.001,1804,20
0.66,1e-05,955,949,100,50,0.001,1904,20
0.674,1e-05,1006,998,100,50,0.001,2004,20
0.57,1e-05,53,51,100,50,0.01,104,1
0.574,1e-05,110,94,100,50,0.01,204,1
0.608,1e-05,170,134,100,50,0.01,304,1
0.618,1e-05,224,180,100,50,0.01,404,1
0.624,1e-05,285,219,100,50,0.01,504,1
0.65,1e-05,324,280,100,50,0.01,604,1
0.676,1e-05,368,336,100,50,0.01,704,1
0.732,1e-05,421,383,100,50,0.01,804,1
0.79,1e-05,470,434,100,50,0.01,904,1
0.838,1e-05,519,485,100,50,0.01,1004,1
0.866,1e-05,566,538,100,50,0.01,1104,1
0.916,1e-05,621,583,100,50,0.01,1204,1
0.928,1e-05,664,640,100,50,0.01,1304,1
0.938,1e-05,713,691,100,50,0.01,1404,1
0.944,1e-05,758,746,100,50,0.01,1504,1
0.948,1e-05,805,799,100,50,0.01,1604,1
0.948,1e-05,848,856,100,50,0.01,1704,1
0.956,1e-05,908,896,100,50,0.01,1804,1
0.966,1e-05,956,948,100,50,0.01,1904,1
0.964,1e-05,1003,1001,100,50,0.01,2004,1
0.548,1e-05,46,58,100,50,0.01,104,2
0.556,1e-05,98,106,100,50,0.01,204,2
0.584,1e-05,142,162,100,50,0.01,304,2
0.614,1e-05,187,217,100,50,0.01,404,2
0.634,1e-05,240,264,100,50,0.01,504,2
0.674,1e-05,292,312,100,50,0.01,604,2
0.688,1e-05,349,355,100,50,0.01,704,2
0.752,1e-05,400,404,100,50,0.01,804,2
0.756,1e-05,446,458,100,50,0.01,904,2
0.826,1e-05,497,507,100,50,0.01,1004,2
0.856,1e-05,553,551,100,50,0.01,1104,2
0.868,1e-05,605,599,100,50,0.01,1204,2
0.902,1e-05,655,649,100,50,0.01,1304,2
0.918,1e-05,706,698,100,50,0.01,1404,2
0.926,1e-05,753,751,100,50,0.01,1504,2
0.938,1e-05,807,797,100,50,0.01,1604,2
0.942,1e-05,856,848,100,50,0.01,1704,2
0.942,1e-05,902,902,100,50,0.01,1804,2
0.952,1e-05,952,952,100,50,0.01,1904,2
0.954,1e-05,1006,998,100,50,0.01,2004,2
0.51,1e-05,45,59,100,50,0.01,104,3
0.546,1e-05,94,110,100,50,0.01,204,3
0.564,1e-05,151,153,100,50,0.01,304,3
0.612,1e-05,198,206,100,50,0.01,404,3
0.642,1e-05,248,256,100,50,0.01,504,3
0.676,1e-05,305,299,100,50,0.01,604,3
0.71,1e-05,359,345,100,50,0.01,704,3
0.752,1e-05,411,393,100,50,0.01,804,3
0.776,1e-05,468,436,100,50,0.01,904,3
0.816,1e-05,515,489,100,50,0.01,1004,3
0.844,1e-05,564,540,100,50,0.01,1104,3
0.882,1e-05,617,587,100,50,0.01,1204,3
0.862,1e-05,663,641,100,50,0.01,1304,3
0.912,1e-05,707,697,100,50,0.01,1404,3
0.922,1e-05,767,737,100,50,0.01,1504,3
0.916,1e-05,811,793,100,50,0.01,1604,3
0.922,1e-05,858,846,100,50,0.01,1704,3
0.934,1e-05,905,899,100,50,0.01,1804,3
0.928,1e-05,956,948,100,50,0.01,1904,3
0.942,1e-05,1013,991,100,50,0.01,2004,3
0.514,1e-05,56,48,100,50,0.01,104,4
0.55,1e-05,112,92,100,50,0.01,204,4
0.538,1e-05,161,143,100,50,0.01,304,4
0.58,1e-05,207,197,100,50,0.01,404,4
0.608,1e-05,258,246,100,50,0.01,504,4
0.65,1e-05,304,300,100,50,0.01,604,4
0.658,1e-05,362,342,100,50,0.01,704,4
0.69,1e-05,412,392,100,50,0.01,804,4
0.74,1e-05,456,448,100,50,0.01,904,4
0.788,1e-05,511,493,100,50,0.01,1004,4
0.826,1e-05,556,548,100,50,0.01,1104,4
0.884,1e-05,602,602,100,50,0.01,1204,4
0.914,1e-05,658,646,100,50,0.01,1304,4
0.942,1e-05,712,692,100,50,0.01,1404,4
0.952,1e-05,765,739,100,50,0.01,1504,4
0.956,1e-05,820,784,100,50,0.01,1604,4
0.962,1e-05,866,838,100,50,0.01,1704,4
0.96,1e-05,912,892,100,50,0.01,1804,4
0.96,1e-05,962,942,100,50,0.01,1904,4
0.966,1e-05,1016,988,100,50,0.01,2004,4
0.582,1e-05,55,49,100,50,0.01,104,5
0.614,1e-05,109,95,100,50,0.01,204,5
0.638,1e-05,152,152,100,50,0.01,304,5
0.63,1e-05,198,206,100,50,0.01,404,5
0.652,1e-05,252,252,100,50,0.01,504,5
0.684,1e-05,297,307,100,50,0.01,604,5
0.694,1e-05,353,351,100,50,0.01,704,5
0.732,1e-05,402,402,100,50,0.01,804,5
0.76,1e-05,452,452,100,50,0.01,904,5
0.81,1e-05,498,506,100,50,0.01,1004,5
0.84,1e-05,553,551,100,50,0.01,1104,5
0.878,1e-05,595,609,100,50,0.01,1204,5
0.916,1e-05,643,661,100,50,0.01,1304,5
0.932,1e-05,694,710,100,50,0.01,1404,5
0.942,1e-05,736,768,100,50,0.01,1504,5
0.942,1e-05,788,816,100,50,0.01,1604,5
0.928,1e-05,841,863,100,50,0.01,1704,5
0.944,1e-05,888,916,100,50,0.01,1804,5
0.942,1e-05,942,962,100,50,0.01,1904,5
0.944,1e-05,1000,1004,100,50,0.01,2004,5
0.498,1e-05,53,51,100,50,0.01,104,6
0.548,1e-05,106,98,100,50,0.01,204,6
0.56,1e-05,154,150,100,50,0.01,304,6
0.58,1e-05,209,195,100,50,0.01,404,6
0.592,1e-05,254,250,100,50,0.01,504,6
0.614,1e-05,304,300,100,50,0.01,604,6
0.634,1e-05,356,348,100,50,0.01,704,6
0.67,1e-05,404,400,100,50,0.01,804,6
0.722,1e-05,447,457,100,50,0.01,904,6
0.78,1e-05,493,511,100,50,0.01,1004,6
0.792,1e-05,538,566,100,50,0.01,1104,6
0.854,1e-05,587,617,100,50,0.01,1204,6
0.87,1e-05,642,662,100,50,0.01,1304,6
0.896,1e-05,691,713,100,50,0.01,1404,6
0.912,1e-05,737,767,100,50,0.01,1504,6
0.93,1e-05,790,814,100,50,0.01,1604,6
0.934,1e-05,831,873,100,50,0.01,1704,6
0.94,1e-05,881,923,100,50,0.01,1804,6
0.938,1e-05,933,971,100,50,0.01,1904,6
0.95,1e-05,987,1017,100,50,0.01,2004,6
0.528,1e-05,46,58,100,50,0.01,104,7
0.546,1e-05,97,107,100,50,0.01,204,7
0.558,1e-05,146,158,100,50,0.01,304,7
0.588,1e-05,199,205,100,50,0.01,404,7
0.622,1e-05,255,249,100,50,0.01,504,7
0.664,1e-05,299,305,100,50,0.01,604,7
0.706,1e-05,344,360,100,50,0.01,704,7
0.746,1e-05,395,409,100,50,0.01,804,7
0.774,1e-05,441,463,100,50,0.01,904,7
0.814,1e-05,485,519,100,50,0.01,1004,7
0.826,1e-05,537,567,100,50,0.01,1104,7
0.876,1e-05,578,626,100,50,0.01,1204,7
0.896,1e-05,637,667,100,50,0.01,1304,7
0.918,1e-05,680,724,100,50,0.01,1404,7
0.94,1e-05,734,770,100,50,0.01,1504,7
0.948,1e-05,793,811,100,50,0.01,1604,7
0.952,1e-05,845,859,100,50,0.01,1704,7
0.962,1e-05,897,907,100,50,0.01,1804,7
0.964,1e-05,962,942,100,50,0.01,1904,7
0.964,1e-05,1002,1002,100,50,0.01,2004,7
0.538,1e-05,49,55,100,50,0.01,104,8
0.516,1e-05,99,105,100,50,0.01,204,8
0.526,1e-05,156,148,100,50,0.01,304,8
0.542,1e-05,209,195,100,50,0.01,404,8
0.566,1e-05,257,247,100,50,0.01,504,8
0.6,1e-05,299,305,100,50,0.01,604,8
0.638,1e-05,350,354,100,50,0.01,704,8
0.674,1e-05,395,409,100,50,0.01,804,8
0.692,1e-05,444,460,100,50,0.01,904,8
0.728,1e-05,503,501,100,50,0.01,1004,8
0.77,1e-05,558,546,100,50,0.01,1104,8
0.836,1e-05,603,601,100,50,0.01,1204,8
0.88,1e-05,653,651,100,50,0.01,1304,8
0.912,1e-05,700,704,100,50,0.01,1404,8
0.932,1e-05,751,753,100,50,0.01,1504,8
0.944,1e-05,797,807,100,50,0.01,1604,8
0.948,1e-05,856,848,100,50,0.01,1704,8
0.956,1e-05,910,894,100,50,0.01,1804,8
0.964,1e-05,960,944,100,50,0.01,1904,8
0.976,1e-05,1005,999,100,50,0.01,2004,8
0.51,1e-05,52,52,100,50,0.01,104,9
0.55,1e-05,103,101,100,50,0.01,204,9
0.554,1e-05,150,154,100,50,0.01,304,9
0.566,1e-05,202,202,100,50,0.01,404,9
0.546,1e-05,257,247,100,50,0.01,504,9
0.578,1e-05,308,296,100,50,0.01,604,9
0.62,1e-05,361,343,100,50,0.01,704,9
0.682,1e-05,408,396,100,50,0.01,804,9
0.77,1e-05,457,447,100,50,0.01,904,9
0.826,1e-05,510,494,100,50,0.01,1004,9
0.86,1e-05,556,548,100,50,0.01,1104,9
0.896,1e-05,606,598,100,50,0.01,1204,9
0.902,1e-05,655,649,100,50,0.01,1304,9
0.934,1e-05,706,698,100,50,0.01,1404,9
0.942,1e-05,757,747,100,50,0.01,1504,9
0.958,1e-05,813,791,100,50,0.01,1604,9
0.952,1e-05,857,847,100,50,0.01,1704,9
0.958,1e-05,912,892,100,50,0.01,1804,9
0.956,1e-05,951,953,100,50,0.01,1904,9
0.956,1e-05,1002,1002,100,50,0.01,2004,9
0.524,1e-05,50,54,100,50,0.01,104,10
0.558,1e-05,108,96,100,50,0.01,204,10
0.582,1e-05,163,141,100,50,0.01,304,10
0.584,1e-05,206,198,100,50,0.01,404,10
0.598,1e-05,263,241,100,50,0.01,504,10
0.642,1e-05,308,296,100,50,0.01,604,10
0.684,1e-05,360,344,100,50,0.01,704,10
0.732,1e-05,405,399,100,50,0.01,804,10
0.754,1e-05,460,444,100,50,0.01,904,10
0.808,1e-05,513,491,100,50,0.01,1004,10
0.852,1e-05,565,539,100,50,0.01,1104,10
0.892,1e-05,617,587,100,50,0.01,1204,10
0.92,1e-05,670,634,100,50,0.01,1304,10
0.932,1e-05,721,683,100,50,0.01,1404,10
0.938,1e-05,768,736,100,50,0.01,1504,10
0.934,1e-05,817,787,100,50,0.01,1604,10
0.946,1e-05,865,839,100,50,0.01,1704,10
0.952,1e-05,911,893,100,50,0.01,1804,10
0.95,1e-05,954,950,100,50,0.01,1904,10
0.95,1e-05,1006,998,100,50,0.01,2004,10
0.542,1e-05,53,51,100,50,0.01,104,11
0.556,1e-05,104,100,100,50,0.01,204,11
0.538,1e-05,154,150,100,50,0.01,304,11
0.574,1e-05,208,196,100,50,0.01,404,11
0.618,1e-05,255,249,100,50,0.01,504,11
0.616,1e-05,294,310,100,50,0.01,604,11
0.648,1e-05,345,359,100,50,0.01,704,11
0.68,1e-05,402,402,100,50,0.01,804,11
0.73,1e-05,452,452,100,50,0.01,904,11
0.768,1e-05,504,500,100,50,0.01,1004,11
0.84,1e-05,553,551,100,50,0.01,1104,11
0.868,1e-05,606,598,100,50,0.01,1204,11
0.91,1e-05,658,646,100,50,0.01,1304,11
0.928,1e-05,708,696,100,50,0.01,1404,11
0.948,1e-05,756,748,100,50,0.01,1504,11
0.962,1e-05,800,804,100,50,0.01,1604,11
0.966,1e-05,849,855,100,50,0.01,1704,11
0.958,1e-05,891,913,100,50,0.01,1804,11
0.97,1e-05,944,960,100,50,0.01,1904,11
0.97,1e-05,997,1007,100,50,0.01,2004,11
0.532,1e-05,54,50,100,50,0.01,104,12
0.546,1e-05,104,100,100,50,0.01,204,12
0.584,1e-05,161,143,100,50,0.01,304,12
0.602,1e-05,210,194,100,50,0.01,404,12
0.624,1e-05,266,238,100,50,0.01,504,12
0.636,1e-05,314,290,100,50,0.01,604,12
0.656,1e-05,363,341,100,50,0.01,704,12
0.7,1e-05,405,399,100,50,0.01,804,12
0.72,1e-05,462,442,100,50,0.01,904,12
0.786,1e-05,509,495,100,50,0.01,1004,12
0.824,1e-05,560,544,100,50,0.01,1104,12
0.852,1e-05,608,596,100,50,0.01,1204,12
0.864,1e-05,656,648,100,50,0.01,1304,12
0.896,1e-05,709,695,100,50,0.01,1404,12
0.928,1e-05,761,743,100,50,0.01,1504,12
0.942,1e-05,808,796,100,50,0.01,1604,12
0.95,1e-05,861,843,100,50,0.01,1704,12
0.958,1e-05,915,889,100,50,0.01,1804,12
0.956,1e-05,964,940,100,50,0.01,1904,12
0.964,1e-05,1012,992,100,50,0.01,2004,12
0.54,1e-05,56,48,100,50,0.01,104,13
0.556,1e-05,101,103,100,50,0.01,204,13
0.558,1e-05,151,153,100,50,0.01,304,13
0.564,1e-05,204,200,100,50,0.01,404,13
0.576,1e-05,252,252,100,50,0.01,504,13
0.608,1e-05,308,296,100,50,0.01,604,13
0.636,1e-05,350,354,100,50,0.01,704,13
0.69,1e-05,392,412,100,50,0.01,804,13
0.74,1e-05,439,465,100,50,0.01,904,13
0.784,1e-05,487,517,100,50,0.01,1004,13
0.818,1e-05,548,556,100,50,0.01,1104,13
0.858,1e-05,598,606,100,50,0.01,1204,13
0.898,1e-05,655,649,100,50,0.01,1304,13
0.912,1e-05,701,703,100,50,0.01,1404,13
0.922,1e-05,742,762,100,50,0.01,1504,13
0.922,1e-05,793,811,100,50,0.01,1604,13
0.924,1e-05,847,857,100,50,0.01,1704,13
0.944,1e-05,894,910,100,50,0.01,1804,13
0.938,1e-05,946,958,100,50,0.01,1904,13
0.94,1e-05,992,1012,100,50,0.01,2004,13
0.54,1e-05,42,62,100,50,0.01,104,14
0.562,1e-05,88,116,100,50,0.01,204,14
0.57,1e-05,134,170,100,50,0.01,304,14
0.566,1e-05,184,220,100,50,0.01,404,14
0.58,1e-05,236,268,100,50,0.01,504,14
0.582,1e-05,290,314,100,50,0.01,604,14
0.6,1e-05,338,366,100,50,0.01,704,14
0.642,1e-05,387,417,100,50,0.01,804,14
0.664,1e-05,435,469,100,50,0.01,904,14
0.722,1e-05,486,518,100,50,0.01,1004,14
0.786,1e-05,527,577,100,50,0.01,1104,14
0.842,1e-05,577,627,100,50,0.01,1204,14
0.866,1e-05,637,667,100,50,0.01,1304,14
0.924,1e-05,689,715,100,50,0.01,1404,14
0.92,1e-05,740,764,100,50,0.01,1504,14
0.938,1e-05,789,815,100,50,0.01,1604,14
0.946,1e-05,847,857,100,50,0.01,1704,14
0.946,1e-05,896,908,100,50,0.01,1804,14
0.954,1e-05,944,960,100,50,0.01,1904,14
0.956,1e-05,996,1008,100,50,0.01,2004,14
0.542,1e-05,53,51,100,50,0.01,104,15
0.59,1e-05,101,103,100,50,0.01,204,15
0.612,1e-05,156,148,100,50,0.01,304,15
0.636,1e-05,197,207,100,50,0.01,404,15
0.652,1e-05,247,257,100,50,0.01,504,15
0.696,1e-05,290,314,100,50,0.01,604,15
0.718,1e-05,348,356,100,50,0.01,704,15
0.772,1e-05,397,407,100,50,0.01,804,15
0.8,1e-05,449,455,100,50,0.01,904,15
0.836,1e-05,499,505,100,50,0.01,1004,15
0.88,1e-05,552,552,100,50,0.01,1104,15
0.92,1e-05,600,604,100,50,0.01,1204,15
0.932,1e-05,654,650,100,50,0.01,1304,15
0.95,1e-05,699,705,100,50,0.01,1404,15
0.956,1e-05,752,752,100,50,0.01,1504,15
0.958,1e-05,804,800,100,50,0.01,1604,15
0.956,1e-05,847,857,100,50,0.01,1704,15
0.956,1e-05,905,899,100,50,0.01,1804,15
0.958,1e-05,949,955,100,50,0.01,1904,15
0.966,1e-05,1003,1001,100,50,0.01,2004,15
0.546,1e-05,47,57,100,50,0.01,104,16
0.53,1e-05,96,108,100,50,0.01,204,16
0.536,1e-05,136,168,100,50,0.01,304,16
0.558,1e-05,190,214,100,50,0.01,404,16
0.588,1e-05,238,266,100,50,0.01,504,16
0.63,1e-05,287,317,100,50,0.01,604,16
0.654,1e-05,338,366,100,50,0.01,704,16
0.7,1e-05,392,412,100,50,0.01,804,16
0.742,1e-05,443,461,100,50,0.01,904,16
0.81,1e-05,493,511,100,50,0.01,1004,16
0.858,1e-05,545,559,100,50,0.01,1104,16
0.892,1e-05,608,596,100,50,0.01,1204,16
0.908,1e-05,657,647,100,50,0.01,1304,16
0.924,1e-05,708,696,100,50,0.01,1404,16
0.938,1e-05,762,742,100,50,0.01,1504,16
0.94,1e-05,818,786,100,50,0.01,1604,16
0.946,1e-05,872,832,100,50,0.01,1704,16
0.952,1e-05,911,893,100,50,0.01,1804,16
0.952,1e-05,963,941,100,50,0.01,1904,16
0.958,1e-05,1011,993,100,50,0.01,2004,16
0.52,1e-05,56,48,100,50,0.01,104,17
0.53,1e-05,105,99,100,50,0.01,204,17
0.534,1e-05,151,153,100,50,0.01,304,17
0.546,1e-05,203,201,100,50,0.01,404,17
0.566,1e-05,254,250,100,50,0.01,504,17
0.61,1e-05,306,298,100,50,0.01,604,17
0.662,1e-05,355,349,100,50,0.01,704,17
0.734,1e-05,391,413,100,50,0.01,804,17
0.77,1e-05,445,459,100,50,0.01,904,17
0.818,1e-05,500,504,100,50,0.01,1004,17
0.848,1e-05,548,556,100,50,0.01,1104,17
0.918,1e-05,597,607,100,50,0.01,1204,17
0.924,1e-05,646,658,100,50,0.01,1304,17
0.95,1e-05,695,709,100,50,0.01,1404,17
0.948,1e-05,751,753,100,50,0.01,1504,17
0.952,1e-05,821,783,100,50,0.01,1604,17
0.96,1e-05,866,838,100,50,0.01,1704,17
0.964,1e-05,914,890,100,50,0.01,1804,17
0.966,1e-05,962,942,100,50,0.01,1904,17
0.968,1e-05,1010,994,100,50,0.01,2004,17
0.51,1e-05,47,57,100,50,0.01,104,18
0.55,1e-05,93,111,100,50,0.01,204,18
0.546,1e-05,147,157,100,50,0.01,304,18
0.57,1e-05,200,204,100,50,0.01,404,18
0.614,1e-05,248,256,100,50,0.01,504,18
0.644,1e-05,298,306,100,50,0.01,604,18
0.66,1e-05,346,358,100,50,0.01,704,18
0.71,1e-05,399,405,100,50,0.01,804,18
0.738,1e-05,457,447,100,50,0.01,904,18
0.804,1e-05,497,507,100,50,0.01,1004,18
0.84,1e-05,551,553,100,50,0.01,1104,18
0.878,1e-05,604,600,100,50,0.01,1204,18
0.894,1e-05,654,650,100,50,0.01,1304,18
0.936,1e-05,705,699,100,50,0.01,1404,18
0.942,1e-05,750,754,100,50,0.01,1504,18
0.932,1e-05,793,811,100,50,0.01,1604,18
0.934,1e-05,841,863,100,50,0.01,1704,18
0.938,1e-05,891,913,100,50,0.01,1804,18
0.948,1e-05,939,965,100,50,0.01,1904,18
0.95,1e-05,992,1012,100,50,0.01,2004,18
0.534,1e-05,52,52,100,50,0.01,104,19
0.544,1e-05,106,98,100,50,0.01,204,19
0.584,1e-05,158,146,100,50,0.01,304,19
0.608,1e-05,202,202,100,50,0.01,404,19
0.626,1e-05,249,255,100,50,0.01,504,19
0.656,1e-05,296,308,100,50,0.01,604,19
0.668,1e-05,339,365,100,50,0.01,704,19
0.748,1e-05,382,422,100,50,0.01,804,19
0.766,1e-05,429,475,100,50,0.01,904,19
0.812,1e-05,490,514,100,50,0.01,1004,19
0.84,1e-05,539,565,100,50,0.01,1104,19
0.876,1e-05,590,614,100,50,0.01,1204,19
0.898,1e-05,648,656,100,50,0.01,1304,19
0.922,1e-05,698,706,100,50,0.01,1404,19
0.932,1e-05,756,748,100,50,0.01,1504,19
0.95,1e-05,812,792,100,50,0.01,1604,19
0.95,1e-05,857,847,100,50,0.01,1704,19
0.958,1e-05,908,896,100,50,0.01,1804,19
0.958,1e-05,960,944,100,50,0.01,1904,19
0.96,1e-05,1011,993,100,50,0.01,2004,19
0.52,1e-05,56,48,100,50,0.01,104,20
0.554,1e-05,103,101,100,50,0.01,204,20
0.56,1e-05,156,148,100,50,0.01,304,20
0.56,1e-05,206,198,100,50,0.01,404,20
0.56,1e-05,254,250,100,50,0.01,504,20
0.614,1e-05,310,294,100,50,0.01,604,20
0.644,1e-05,367,337,100,50,0.01,704,20
0.684,1e-05,414,390,100,50,0.01,804,20
0.714,1e-05,465,439,100,50,0.01,904,20
0.782,1e-05,520,484,100,50,0.01,1004,20
0.814,1e-05,573,531,100,50,0.01,1104,20
0.844,1e-05,614,590,100,50,0.01,1204,20
0.88,1e-05,669,635,100,50,0.01,1304,20
0.914,1e-05,721,683,100,50,0.01,1404,20
0.922,1e-05,775,729,100,50,0.01,1504,20
0.942,1e-05,823,781,100,50,0.01,1604,20
0.936,1e-05,872,832,100,50,0.01,1704,20
0.94,1e-05,921,883,100,50,0.01,1804,20
0.942,1e-05,965,939,100,50,0.01,1904,20
0.946,1e-05,1019,985,100,50,0.01,2004,20
0.506,0.0001,48,56,100,50,0.0001,104,1
0.51,0.0001,103,101,100,50,0.0001,204,1
0.51,0.0001,150,154,100,50,0.0001,304,1
0.508,0.0001,204,200,100,50,0.0001,404,1
0.506,0.0001,253,251,100,50,0.0001,504,1
0.508,0.0001,312,292,100,50,0.0001,604,1
0.506,0.0001,354,350,100,50,0.0001,704,1
0.51,0.0001,403,401,100,50,0.0001,804,1
0.514,0.0001,453,451,100,50,0.0001,904,1
0.512,0.0001,500,504,100,50,0.0001,1004,1
0.516,0.0001,552,552,100,50,0.0001,1104,1
0.514,0.0001,595,609,100,50,0.0001,1204,1
0.516,0.0001,649,655,100,50,0.0001,1304,1
0.512,0.0001,695,709,100,50,0.0001,1404,1
0.516,0.0001,750,754,100,50,0.0001,1504,1
0.52,0.0001,804,800,100,50,0.0001,1604,1
0.522,0.0001,856,848,100,50,0.0001,1704,1
0.532,0.0001,904,900,100,50,0.0001,1804,1
0.528,0.0001,953,951,100,50,0.0001,1904,1
0.532,0.0001,1001,1003,100,50,0.0001,2004,1
0.522,0.0001,55,49,100,50,0.0001,104,2
0.524,0.0001,104,100,100,50,0.0001,204,2
0.526,0.0001,160,144,100,50,0.0001,304,2
0.528,0.0001,206,198,100,50,0.0001,404,2
0.526,0.0001,253,251,100,50,0.0001,504,2
0.526,0.0001,303,301,100,50,0.0001,604,2
0.528,0.0001,353,351,100,50,0.0001,704,2
0.528,0.0001,407,397,100,50,0.0001,804,2
0.524,0.0001,453,451,100,50,0.0001,904,2
0.524,0.0001,511,493,100,50,0.0001,1004,2
0.528,0.0001,555,549,100,50,0.0001,1104,2
0.532,0.0001,601,603,100,50,0.0001,1204,2
0.53,0.0001,651,653,100,50,0.0001,1304,2
0.534,0.0001,698,706,100,50,0.0001,1404,2
0.53,0.0001,755,749,100,50,0.0001,1504,2
0.538,0.0001,811,793,100,50,0.0001,1604,2
0.54,0.0001,862,842,100,50,0.0001,1704,2
0.548,0.0001,915,889,100,50,0.0001,1804,2
0.552,0.0001,955,949,100,50,0.0001,1904,2
0.558,0.0001,1003,1001,100,50,0.0001,2004,2
0.5,0.0001,53,51,100,50,0.0001,104,3
0.5,0.0001,92,112,100,50,0.0001,204,3
0.502,0.0001,134,170,100,50,0.0001,304,3
0.5,0.0001,182,222,100,50,0.0001,404,3
0.502,0.0001,236,268,100,50,0.0001,504,3
0.502,0.0001,288,316,100,50,0.0001,604,3
0.5,0.0001,337,367,100,50,0.0001,704,3
0.502,0.0001,384,420,100,50,0.0001,804,3
0.504,0.0001,433,471,100,50,0.0001,904,3
0.5,0.0001,473,531,100,50,0.0001,1004,3
0.5,0.0001,518,586,100,50,0.0001,1104,3
0.502,0.0001,563,641,100,50,0.0001,1204,3
0.504,0.0001,608,696,100,50,0.0001,1304,3
0.512,0.0001,656,748,100,50,0.0001,1404,3
0.514,0.0001,709,795,100,50,0.0001,1504,3
0.52,0.0001,764,840,100,50,0.0001,1604,3
0.514,0.0001,821,883,100,50,0.0001,1704,3
0.516,0.0001,874,930,100,50,0.0001,1804,3
0.526,0.0001,925,979,100,50,0.0001,1904,3
0.53,0.0001,983,1021,100,50,0.0001,2004,3
0.504,0.0001,53,51,100,50,0.0001,104,4
0.5,0.0001,107,97,100,50,0.0001,204,4
0.496,0.0001,152,152,100,50,0.0001,304,4
0.498,0.0001,198,206,100,50,0.0001,404,4
0.498,0.0001,245,259,100,50,0.0001,504,4
0.496,0.0001,297,307,100,50,0.0001,604,4
0.496,0.0001,347,357,100,50,0.0001,704,4
0.502,0.0001,396,408,100,50,0.0001,804,4
0.504,0.0001,453,451,100,50,0.0001,904,4
0.504,0.0001,497,507,100,50,0.0001,1004,4
0.508,0.0001,543,561,100,50,0.0001,1104,4
0.512,0.0001,584,620,100,50,0.0001,1204,4
0.512,0.0001,639,665,100,50,0.0001,1304,4
0.51,0.0001,689,715,100,50,0.0001,1404,4
0.506,0.0001,735,769,100,50,0.0001,1504,4
0.512,0.0001,790,814,100,50,0.0001,1604,4
0.514,0.0001,843,861,100,50,0.0001,1704,4
0.512,0.0001,891,913,100,50,0.0001,1804,4
0.512,0.0001,945,959,100,50,0.0001,1904,4
0.518,0.0001,997,1007,100,50,0.0001,2004,4
0.502,0.0001,62,42,100,50,0.0001,104,5
0.502,0.0001,119,85,100,50,0.0001,204,5
0.502,0.0001,162,142,100,50,0.0001,304,5
0.504,0.0001,217,187,100,50,0.0001,404,5
0.502,0.0001,273,231,100,50,0.0001,504,5
0.504,0.0001,319,285,100,50,0.0001,604,5
0.504,0.0001,364,340,100,50,0.0001,704,5
0.504,0.0001,414,390,100,50,0.0001,804,5
0.504,0.0001,454,450,100,50,0.0001,904,5
0.506,0.0001,504,500,100,50,0.0001,1004,5
0.508,0.0001,554,550,100,50,0.0001,1104,5
0.508,0.0001,607,597,100,50,0.0001,1204,5
0.514,0.0001,651,653,100,50,0.0001,1304,5
0.512,0.0001,706,698,100,50,0.0001,1404,5
0.51,0.0001,759,745,100,50,0.0001,1504,5
0.51,0.0001,804,800,100,50,0.0001,1604,5
0.514,0.0001,847,857,100,50,0.0001,1704,5
0.52,0.0001,890,914,100,50,0.0001,1804,5
0.526,0.0001,944,960,100,50,0.0001,1904,5
0.536,0.0001,997,1007,100,50,0.0001,2004,5
0.494,0.0001,58,46,100,50,0.0001,104,6
0.492,0.0001,108,96,100,50,0.0001,204,6
0.49,0.0001,155,149,100,50,0.0001,304,6
0.49,0.0001,209,195,100,50,0.0001,404,6
0.492,0.0001,258,246,100,50,0.0001,504,6
0.492,0.0001,307,297,100,50,0.0001,604,6
0.492,0.0001,363,341,100,50,0.0001,704,6
0.492,0.0001,413,391,100,50,0.0001,804,6
0.492,0.0001,459,445,100,50,0.0001,904,6
0.494,0.0001,509,495,100,50,0.0001,1004,6
0.49,0.0001,556,548,100,50,0.0001,1104,6
0.492,0.0001,600,604,100,50,0.0001,1204,6
0.502,0.0001,644,660,100,50,0.0001,1304,6
0.5,0.0001,692,712,100,50,0.0001,1404,6
0.498,0.0001,750,754,100,50,0.0001,1504,6
0.498,0.0001,797,807,100,50,0.0001,1604,6
0.5,0.0001,842,862,100,50,0.0001,1704,6
0.506,0.0001,888,916,100,50,0.0001,1804,6
0.504,0.0001,945,959,100,50,0.0001,1904,6
0.51,0.0001,992,1012,100,50,0.0001,2004,6
0.528,0.0001,55,49,100,50,0.0001,104,7
0.526,0.0001,99,105,100,50,0.0001,204,7
0.526,0.0001,141,163,100,50,0.0001,304,7
0.526,0.0001,186,218,100,50,0.0001,404,7
0.526,0.0001,233,271,100,50,0.0001,504,7
0.524,0.0001,281,323,100,50,0.0001,604,7
0.524,0.0001,337,367,100,50,0.0001,704,7
0.524,0.0001,387,417,100,50,0.0001,804,7
0.524,0.0001,445,459,100,50,0.0001,904,7
0.526,0.0001,491,513,100,50,0.0001,1004,7
0.53,0.0001,544,560,100,50,0.0001,1104,7
0.534,0.0001,605,599,100,50,0.0001,1204,7
0.534,0.0001,661,643,100,50,0.0001,1304,7
0.532,0.0001,719,685,100,50,0.0001,1404,7
0.536,0.0001,765,739,100,50,0.0001,1504,7
0.538,0.0001,816,788,100,50,0.0001,1604,7
0.544,0.0001,866,838,100,50,0.0001,1704,7
0.544,0.0001,910,894,100,50,0.0001,1804,7
0.546,0.0001,962,942,100,50,0.0001,1904,7
0.55,0.0001,1017,987,100,50,0.0001,2004,7
0.512,0.0001,50,54,100,50,0.0001,104,8
0.512,0.0001,99,105,100,50,0.0001,204,8
0.512,0.0001,150,154,100,50,0.0001,304,8
0.512,0.0001,198,206,100,50,0.0001,404,8
0.514,0.0001,245,259,100,50,0.0001,504,8
0.514,0.0001,301,303,100,50,0.0001,604,8
0.516,0.0001,353,351,100,50,0.0001,704,8
0.516,0.0001,400,404,100,50,0.0001,804,8
0.518,0.0001,446,458,100,50,0.0001,904,8
0.52,0.0001,495,509,100,50,0.0001,1004,8
0.52,0.0001,545,559,100,50,0.0001,1104,8
0.524,0.0001,591,613,100,50,0.0001,1204,8
0.522,0.0001,645,659,100,50,0.0001,1304,8
0.522,0.0001,686,718,100,50,0.0001,1404,8
0.52,0.0001,738,766,100,50,0.0001,1504,8
0.522,0.0001,797,807,100,50,0.0001,1604,8
0.526,0.0001,845,859,100,50,0.0001,1704,8
0.528,0.0001,898,906,100,50,0.0001,1804,8
0.528,0.0001,945,959,100,50,0.0001,1904,8
0.53,0.0001,990,1014,100,50,0.0001,2004,8
0.51,0.0001,49,55,100,50,0.0001,104,9
0.51,0.0001,100,104,100,50,0.0001,204,9
0.51,0.0001,142,162,100,50,0.0001,304,9
0.51,0.0001,194,210,100,50,0.0001,404,9
0.51,0.0001,244,260,100,50,0.0001,504,9
0.51,0.0001,300,304,100,50,0.0001,604,9
0.51,0.0001,352,352,100,50,0.0001,704,9
0.51,0.0001,400,404,100,50,0.0001,804,9
0.51,0.0001,447,457,100,50,0.0001,904,9
0.512,0.0001,490,514,100,50,0.0001,1004,9
0.512,0.0001,541,563,100,50,0.0001,1104,9
0.51,0.0001,592,612,100,50,0.0001,1204,9
0.51,0.0001,642,662,100,50,0.0001,1304,9
0.518,0.0001,692,712,100,50,0.0001,1404,9
0.516,0.0001,744,760,100,50,0.0001,1504,9
0.516,0.0001,791,813,100,50,0.0001,1604,9
0.516,0.0001,838,866,100,50,0.0001,1704,9
0.516,0.0001,891,913,100,50,0.0001,1804,9
0.516,0.0001,947,957,100,50,0.0001,1904,9
0.512,0.0001,999,1005,100,50,0.0001,2004,9
0.52,0.0001,47,57,100,50,0.0001,104,10
0.52,0.0001,98,106,100,50,0.0001,204,10
0.52,0.0001,148,156,100,50,0.0001,304,10
0.52,0.0001,203,201,100,50,0.0001,404,10
0.522,0.0001,247,257,100,50,0.0001,504,10
0.526,0.0001,295,309,100,50,0.0001,604,10
0.526,0.0001,345,359,100,50,0.0001,704,10
0.526,0.0001,401,403,100,50,0.0001,804,10
0.528,0.0001,447,457,100,50,0.0001,904,10
0.528,0.0001,495,509,100,50,0.0001,1004,10
0.526,0.0001,538,566,100,50,0.0001,1104,10
0.528,0.0001,585,619,100,50,0.0001,1204,10
0.528,0.0001,640,664,100,50,0.0001,1304,10
0.532,0.0001,693,711,100,50,0.0001,1404,10
0.534,0.0001,750,754,100,50,0.0001,1504,10
0.532,0.0001,804,800,100,50,0.0001,1604,10
0.53,0.0001,848,856,100,50,0.0001,1704,10
0.532,0.0001,896,908,100,50,0.0001,1804,10
0.534,0.0001,943,961,100,50,0.0001,1904,10
0.534,0.0001,995,1009,100,50,0.0001,2004,10
0.494,0.0001,53,51,100,50,0.0001,104,11
0.494,0.0001,95,109,100,50,0.0001,204,11
0.492,0.0001,145,159,100,50,0.0001,304,11
0.496,0.0001,200,204,100,50,0.0001,404,11
0.496,0.0001,247,257,100,50,0.0001,504,11
0.498,0.0001,303,301,100,50,0.0001,604,11
0.5,0.0001,359,345,100,50,0.0001,704,11
0.502,0.0001,404,400,100,50,0.0001,804,11
0.504,0.0001,452,452,100,50,0.0001,904,11
0.508,0.0001,511,493,100,50,0.0001,1004,11
0.51,0.0001,554,550,100,50,0.0001,1104,11
0.512,0.0001,597,607,100,50,0.0001,1204,11
0.514,0.0001,648,656,100,50,0.0001,1304,11
0.518,0.0001,703,701,100,50,0.0001,1404,11
0.522,0.0001,756,748,100,50,0.0001,1504,11
0.522,0.0001,810,794,100,50,0.0001,1604,11
0.524,0.0001,861,843,100,50,0.0001,1704,11
0.53,0.0001,914,890,100,50,0.0001,1804,11
0.534,0.0001,965,939,100,50,0.0001,1904,11
0.542,0.0001,1016,988,100,50,0.0001,2004,11
0.502,0.0001,53,51,100,50,0.0001,104,12
0.498,0.0001,107,97,100,50,0.0001,204,12
0.5,0.0001,152,152,100,50,0.0001,304,12
0.5,0.0001,209,195,100,50,0.0001,404,12
0.504,0.0001,256,248,100,50,0.0001,504,12
0.506,0.0001,298,306,100,50,0.0001,604,12
0.504,0.0001,348,356,100,50,0.0001,704,12
0.504,0.0001,399,405,100,50,0.0001,804,12
0.504,0.0001,446,458,100,50,0.0001,904,12
0.51,0.0001,485,519,100,50,0.0001,1004,12
0.508,0.0001,536,568,100,50,0.0001,1104,12
0.508,0.0001,581,623,100,50,0.0001,1204,12
0.508,0.0001,624,680,100,50,0.0001,1304,12
0.51,0.0001,682,722,100,50,0.0001,1404,12
0.512,0.0001,735,769,100,50,0.0001,1504,12
0.512,0.0001,791,813,100,50,0.0001,1604,12
0.514,0.0001,837,867,100,50,0.0001,1704,12
0.516,0.0001,893,911,100,50,0.0001,1804,12
0.518,0.0001,947,957,100,50,0.0001,1904,12
0.522,0.0001,1000,1004,100,50,0.0001,2004,12
0.492,0.0001,54,50,100,50,0.0001,104,13
0.49,0.0001,102,102,100,50,0.0001,204,13
0.49,0.0001,160,144,100,50,0.0001,304,13
0.492,0.0001,213,191,100,50,0.0001,404,13
0.494,0.0001,262,242,100,50,0.0001,504,13
0.496,0.0001,313,291,100,50,0.0001,604,13
0.496,0.0001,356,348,100,50,0.0001,704,13
0.494,0.0001,409,395,100,50,0.0001,804,13
0.494,0.0001,461,443,100,50,0.0001,904,13
0.498,0.0001,515,489,100,50,0.0001,1004,13
0.502,0.0001,564,540,100,50,0.0001,1104,13
0.504,0.0001,612,592,100,50,0.0001,1204,13
0.51,0.0001,664,640,100,50,0.0001,1304,13
0.512,0.0001,711,693,100,50,0.0001,1404,13
0.512,0.0001,763,741,100,50,0.0001,1504,13
0.512,0.0001,812,792,100,50,0.0001,1604,13
0.512,0.0001,868,836,100,50,0.0001,1704,13
0.514,0.0001,914,890,100,50,0.0001,1804,13
0.52,0.0001,962,942,100,50,0.0001,1904,13
0.526,0.0001,1012,992,100,50,0.0001,2004,13
0.536,0.0001,52,52,100,50,0.0001,104,14
0.538,0.0001,99,105,100,50,0.0001,204,14
0.538,0.0001,163,141,100,50,0.0001,304,14
0.538,0.0001,207,197,100,50,0.0001,404,14
0.538,0.0001,256,248,100,50,0.0001,504,14
0.538,0.0001,307,297,100,50,0.0001,604,14
0.538,0.0001,353,351,100,50,0.0001,704,14
0.536,0.0001,403,401,100,50,0.0001,804,14
0.534,0.0001,460,444,100,50,0.0001,904,14
0.534,0.0001,506,498,100,50,0.0001,1004,14
0.534,0.0001,555,549,100,50,0.0001,1104,14
0.532,0.0001,601,603,100,50,0.0001,1204,14
0.534,0.0001,654,650,100,50,0.0001,1304,14
0.538,0.0001,715,689,100,50,0.0001,1404,14
0.536,0.0001,769,735,100,50,0.0001,1504,14
0.536,0.0001,816,788,100,50,0.0001,1604,14
0.542,0.0001,867,837,100,50,0.0001,1704,14
0.546,0.0001,910,894,100,50,0.0001,1804,14
0.542,0.0001,964,940,100,50,0.0001,1904,14
0.542,0.0001,1016,988,100,50,0.0001,2004,14
0.472,0.0001,50,54,100,50,0.0001,104,15
0.47,0.0001,108,96,100,50,0.0001,204,15
0.47,0.0001,166,138,100,50,0.0001,304,15
0.468,0.0001,217,187,100,50,0.0001,404,15
0.47,0.0001,266,238,100,50,0.0001,504,15
0.472,0.0001,318,286,100,50,0.0001,604,15
0.472,0.0001,364,340,100,50,0.0001,704,15
0.476,0.0001,408,396,100,50,0.0001,804,15
0.478,0.0001,453,451,100,50,0.0001,904,15
0.478,0.0001,492,512,100,50,0.0001,1004,15
0.476,0.0001,545,559,100,50,0.0001,1104,15
0.476,0.0001,599,605,100,50,0.0001,1204,15
0.476,0.0001,648,656,100,50,0.0001,1304,15
0.478,0.0001,696,708,100,50,0.0001,1404,15
0.48,0.0001,746,758,100,50,0.0001,1504,15
0.472,0.0001,795,809,100,50,0.0001,1604,15
0.478,0.0001,842,862,100,50,0.0001,1704,15
0.48,0.0001,905,899,100,50,0.0001,1804,15
0.494,0.0001,956,948,100,50,0.0001,1904,15
0.492,0.0001,1007,997,100,50,0.0001,2004,15
0.49,0.0001,51,53,100,50,0.0001,104,16
0.494,0.0001,104,100,100,50,0.0001,204,16
0.496,0.0001,156,148,100,50,0.0001,304,16
0.5,0.0001,206,198,100,50,0.0001,404,16
0.498,0.0001,259,245,100,50,0.0001,504,16
0.498,0.0001,308,296,100,50,0.0001,604,16
0.498,0.0001,353,351,100,50,0.0001,704,16
0.502,0.0001,396,408,100,50,0.0001,804,16
0.504,0.0001,442,462,100,50,0.0001,904,16
0.504,0.0001,495,509,100,50,0.0001,1004,16
0.506,0.0001,543,561,100,50,0.0001,1104,16
0.506,0.0001,593,611,100,50,0.0001,1204,16
0.506,0.0001,650,654,100,50,0.0001,1304,16
0.506,0.0001,699,705,100,50,0.0001,1404,16
0.51,0.0001,752,752,100,50,0.0001,1504,16
0.514,0.0001,810,794,100,50,0.0001,1604,16
0.506,0.0001,857,847,100,50,0.0001,1704,16
0.508,0.0001,907,897,100,50,0.0001,1804,16
0.502,0.0001,959,945,100,50,0.0001,1904,16
0.508,0.0001,1002,1002,100,50,0.0001,2004,16
0.534,0.0001,51,53,100,50,0.0001,104,17
0.532,0.0001,102,102,100,50,0.0001,204,17
0.532,0.0001,152,152,100,50,0.0001,304,17
0.53,0.0001,205,199,100,50,0.0001,404,17
0.53,0.0001,253,251,100,50,0.0001,504,17
0.536,0.0001,299,305,100,50,0.0001,604,17
0.536,0.0001,354,350,100,50,0.0001,704,17
0.538,0.0001,402,402,100,50,0.0001,804,17
0.538,0.0001,460,444,100,50,0.0001,904,17
0.538,0.0001,515,489,100,50,0.0001,1004,17
0.536,0.0001,568,536,100,50,0.0001,1104,17
0.538,0.0001,620,584,100,50,0.0001,1204,17
0.538,0.0001,673,631,100,50,0.0001,1304,17
0.54,0.0001,720,684,100,50,0.0001,1404,17
0.544,0.0001,770,734,100,50,0.0001,1504,17
0.54,0.0001,823,781,100,50,0.0001,1604,17
0.546,0.0001,862,842,100,50,0.0001,1704,17
0.544,0.0001,920,884,100,50,0.0001,1804,17
0.542,0.0001,977,927,100,50,0.0001,1904,17
0.544,0.0001,1024,980,100,50,0.0001,2004,17
0.51,0.0001,55,49,100,50,0.0001,104,18
0.508,0.0001,104,100,100,50,0.0001,204,18
0.512,0.0001,147,157,100,50,0.0001,304,18
0.51,0.0001,198,206,100,50,0.0001,404,18
0.51,0.0001,256,248,100,50,0.0001,504,18
0.51,0.0001,309,295,100,50,0.0001,604,18
0.512,0.0001,353,351,100,50,0.0001,704,18
0.516,0.0001,406,398,100,50,0.0001,804,18
0.516,0.0001,448,456,100,50,0.0001,904,18
0.516,0.0001,499,505,100,50,0.0001,1004,18
0.518,0.0001,554,550,100,50,0.0001,1104,18
0.518,0.0001,603,601,100,50,0.0001,1204,18
0.516,0.0001,657,647,100,50,0.0001,1304,18
0.52,0.0001,704,700,100,50,0.0001,1404,18
0.522,0.0001,755,749,100,50,0.0001,1504,18
0.532,0.0001,805,799,100,50,0.0001,1604,18
0.538,0.0001,849,855,100,50,0.0001,1704,18
0.538,0.0001,899,905,100,50,0.0001,1804,18
0.534,0.0001,954,950,100,50,0.0001,1904,18
0.536,0.0001,1002,1002,100,50,0.0001,2004,18
0.48,0.0001,51,53,100,50,0.0001,104,19
0.482,0.0001,95,109,100,50,0.0001,204,19
0.482,0.0001,140,164,100,50,0.0001,304,19
0.482,0.0001,183,221,100,50,0.0001,404,19
0.484,0.0001,233,271,100,50,0.0001,504,19
0.48,0.0001,280,324,100,50,0.0001,604,19
0.48,0.0001,331,373,100,50,0.0001,704,19
0.484,0.0001,389,415,100,50,0.0001,804,19
0.482,0.0001,446,458,100,50,0.0001,904,19
0.488,0.0001,490,514,100,50,0.0001,1004,19
0.49,0.0001,540,564,100,50,0.0001,1104,19
0.494,0.0001,589,615,100,50,0.0001,1204,19
0.496,0.0001,640,664,100,50,0.0001,1304,19
0.5,0.0001,690,714,100,50,0.0001,1404,19
0.496,0.0001,750,754,100,50,0.0001,1504,19
0.5,0.0001,795,809,100,50,0.0001,1604,19
0.498,0.0001,840,864,100,50,0.0001,1704,19
0.502,0.0001,891,913,100,50,0.0001,1804,19
0.508,0.0001,942,962,100,50,0.0001,1904,19
0.512,0.0001,1003,1001,100,50,0.0001,2004,19
0.506,0.0001,52,52,100,50,0.0001,104,20
0.506,0.0001,107,97,100,50,0.0001,204,20
0.51,0.0001,152,152,100,50,0.0001,304,20
0.508,0.0001,206,198,100,50,0.0001,404,20
0.508,0.0001,255,249,100,50,0.0001,504,20
0.506,0.0001,298,306,100,50,0.0001,604,20
0.506,0.0001,349,355,100,50,0.0001,704,20
0.506,0.0001,395,409,100,50,0.0001,804,20
0.51,0.0001,450,454,100,50,0.0001,904,20
0.512,0.0001,500,504,100,50,0.0001,1004,20
0.51,0.0001,559,545,100,50,0.0001,1104,20
0.51,0.0001,609,595,100,50,0.0001,1204,20
0.514,0.0001,657,647,100,50,0.0001,1304,20
0.512,0.0001,710,694,100,50,0.0001,1404,20
0.51,0.0001,757,747,100,50,0.0001,1504,20
0.512,0.0001,801,803,100,50,0.0001,1604,20
0.512,0.0001,852,852,100,50,0.0001,1704,20
0.508,0.0001,892,912,100,50,0.0001,1804,20
0.508,0.0001,939,965,100,50,0.0001,1904,20
0.512,0.0001,995,1009,100,50,0.0001,2004,20
0.53,0.0001,51,53,100,50,0.001,104,1
0.532,0.0001,100,104,100,50,0.001,204,1
0.536,0.0001,151,153,100,50,0.001,304,1
0.532,0.0001,203,201,100,50,0.001,404,1
0.542,0.0001,250,254,100,50,0.001,504,1
0.544,0.0001,301,303,100,50,0.001,604,1
0.548,0.0001,361,343,100,50,0.001,704,1
0.562,0.0001,409,395,100,50,0.001,804,1
0.558,0.0001,460,444,100,50,0.001,904,1
0.582,0.0001,502,502,100,50,0.001,1004,1
0.594,0.0001,551,553,100,50,0.001,1104,1
0.606,0.0001,604,600,100,50,0.001,1204,1
0.614,0.0001,654,650,100,50,0.001,1304,1
0.638,0.0001,700,704,100,50,0.001,1404,1
0.66,0.0001,748,756,100,50,0.001,1504,1
0.674,0.0001,801,803,100,50,0.001,1604,1
0.682,0.0001,844,860,100,50,0.001,1704,1
0.702,0.0001,895,909,100,50,0.001,1804,1
0.708,0.0001,948,956,100,50,0.001,1904,1
0.734,0.0001,999,1005,100,50,0.001,2004,1
0.47,0.0001,58,46,100,50,0.001,104,2
0.478,0.0001,93,111,100,50,0.001,204,2
0.48,0.0001,140,164,100,50,0.001,304,2
0.494,0.0001,181,223,100,50,0.001,404,2
0.5,0.0001,232,272,100,50,0.001,504,2
0.502,0.0001,279,325,100,50,0.001,604,2
0.504,0.0001,329,375,100,50,0.001,704,2
0.52,0.0001,373,431,100,50,0.001,804,2
0.53,0.0001,427,477,100,50,0.001,904,2
0.532,0.0001,478,526,100,50,0.001,1004,2
0.534,0.0001,533,571,100,50,0.001,1104,2
0.554,0.0001,584,620,100,50,0.001,1204,2
0.578,0.0001,637,667,100,50,0.001,1304,2
0.586,0.0001,680,724,100,50,0.001,1404,2
0.592,0.0001,730,774,100,50,0.001,1504,2
0.6,0.0001,774,830,100,50,0.001,1604,2
0.61,0.0001,828,876,100,50,0.001,1704,2
0.628,0.0001,885,919,100,50,0.001,1804,2
0.642,0.0001,943,961,100,50,0.001,1904,2
0.674,0.0001,997,1007,100,50,0.001,2004,2
0.488,0.0001,55,49,100,50,0.001,104,3
0.49,0.0001,114,90,100,50,0.001,204,3
0.49,0.0001,155,149,100,50,0.001,304,3
0.49,0.0001,206,198,100,50,0.001,404,3
0.492,0.0001,252,252,100,50,0.001,504,3
0.502,0.0001,300,304,100,50,0.001,604,3
0.518,0.0001,347,357,100,50,0.001,704,3
0.536,0.0001,398,406,100,50,0.001,804,3
0.552,0.0001,442,462,100,50,0.001,904,3
0.564,0.0001,491,513,100,50,0.001,1004,3
0.57,0.0001,543,561,100,50,0.001,1104,3
0.594,0.0001,598,606,100,50,0.001,1204,3
0.618,0.0001,647,657,100,50,0.001,1304,3
0.646,0.0001,693,711,100,50,0.001,1404,3
0.65,0.0001,742,762,100,50,0.001,1504,3
0.668,0.0001,796,808,100,50,0.001,1604,3
0.686,0.0001,848,856,100,50,0.001,1704,3
0.716,0.0001,901,903,100,50,0.001,1804,3
0.75,0.0001,961,943,100,50,0.001,1904,3
0.782,0.0001,1013,991,100,50,0.001,2004,3
0.45,0.0001,53,51,100,50,0.001,104,4
0.482,0.0001,104,100,100,50,0.001,204,4
0.484,0.0001,147,157,100,50,0.001,304,4
0.508,0.0001,195,209,100,50,0.001,404,4
0.522,0.0001,245,259,100,50,0.001,504,4
0.538,0.0001,300,304,100,50,0.001,604,4
0.54,0.0001,354,350,100,50,0.001,704,4
0.556,0.0001,400,404,100,50,0.001,804,4
0.562,0.0001,455,449,100,50,0.001,904,4
0.574,0.0001,499,505,100,50,0.001,1004,4
0.586,0.0001,545,559,100,50,0.001,1104,4
0.588,0.0001,596,608,100,50,0.001,1204,4
0.598,0.0001,650,654,100,50,0.001,1304,4
0.61,0.0001,712,692,100,50,0.001,1404,4
0.626,0.0001,762,742,100,50,0.001,1504,4
0.656,0.0001,812,792,100,50,0.001,1604,4
0.674,0.0001,857,847,100,50,0.001,1704,4
0.694,0.0001,905,899,100,50,0.001,1804,4
0.738,0.0001,954,950,100,50,0.001,1904,4
0.75,0.0001,1006,998,100,50,0.001,2004,4
0.488,0.0001,51,53,100,50,0.001,104,5
0.508,0.0001,96,108,100,50,0.001,204,5
0.494,0.0001,148,156,100,50,0.001,304,5
0.494,0.0001,198,206,100,50,0.001,404,5
0.508,0.0001,247,257,100,50,0.001,504,5
0.516,0.0001,299,305,100,50,0.001,604,5
0.524,0.0001,349,355,100,50,0.001,704,5
0.536,0.0001,404,400,100,50,0.001,804,5
0.546,0.0001,453,451,100,50,0.001,904,5
0.55,0.0001,501,503,100,50,0.001,1004,5
0.57,0.0001,555,549,100,50,0.001,1104,5
0.586,0.0001,611,593,100,50,0.001,1204,5
0.594,0.0001,655,649,100,50,0.001,1304,5
0.596,0.0001,710,694,100,50,0.001,1404,5
0.61,0.0001,767,737,100,50,0.001,1504,5
0.63,0.0001,822,782,100,50,0.001,1604,5
0.636,0.0001,872,832,100,50,0.001,1704,5
0.656,0.0001,918,886,100,50,0.001,1804,5
0.686,0.0001,963,941,100,50,0.001,1904,5
0.71,0.0001,1007,997,100,50,0.001,2004,5
0.486,0.0001,61,43,100,50,0.001,104,6
0.492,0.0001,112,92,100,50,0.001,204,6
0.488,0.0001,159,145,100,50,0.001,304,6
0.492,0.0001,207,197,100,50,0.001,404,6
0.492,0.0001,249,255,100,50,0.001,504,6
0.498,0.0001,296,308,100,50,0.001,604,6
0.508,0.0001,345,359,100,50,0.001,704,6
0.52,0.0001,400,404,100,50,0.001,804,6
0.53,0.0001,446,458,100,50,0.001,904,6
0.556,0.0001,496,508,100,50,0.001,1004,6
0.566,0.0001,547,557,100,50,0.001,1104,6
0.58,0.0001,591,613,100,50,0.001,1204,6
0.6,0.0001,644,660,100,50,0.001,1304,6
0.618,0.0001,699,705,100,50,0.001,1404,6
0.642,0.0001,754,750,100,50,0.001,1504,6
0.676,0.0001,805,799,100,50,0.001,1604,6
0.696,0.0001,853,851,100,50,0.001,1704,6
0.718,0.0001,904,900,100,50,0.001,1804,6
0.746,0.0001,960,944,100,50,0.001,1904,6
0.782,0.0001,1020,984,100,50,0.001,2004,6
0.504,0.0001,58,46,100,50,0.001,104,7
0.51,0.0001,108,96,100,50,0.001,204,7
0.522,0.0001,155,149,100,50,0.001,304,7
0.536,0.0001,214,190,100,50,0.001,404,7
0.544,0.0001,266,238,100,50,0.001,504,7
0.562,0.0001,313,291,100,50,0.001,604,7
0.57,0.0001,369,335,100,50,0.001,704,7
0.564,0.0001,418,386,100,50,0.001,804,7
0.57,0.0001,471,433,100,50,0.001,904,7
0.59,0.0001,518,486,100,50,0.001,1004,7
0.618,0.0001,573,531,100,50,0.001,1104,7
0.63,0.0001,626,578,100,50,0.001,1204,7
0.652,0.0001,674,630,100,50,0.001,1304,7
0.66,0.0001,719,685,100,50,0.001,1404,7
0.682,0.0001,765,739,100,50,0.001,1504,7
0.698,0.0001,809,795,100,50,0.001,1604,7
0.702,0.0001,856,848,100,50,0.001,1704,7
0.722,0.0001,906,898,100,50,0.001,1804,7
0.74,0.0001,960,944,100,50,0.001,1904,7
0.764,0.0001,1000,1004,100,50,0.001,2004,7
0.524,0.0001,48,56,100,50,0.001,104,8
0.522,0.0001,89,115,100,50,0.001,204,8
0.528,0.0001,131,173,100,50,0.001,304,8
0.528,0.0001,185,219,100,50,0.001,404,8
0.536,0.0001,237,267,100,50,0.001,504,8
0.534,0.0001,280,324,100,50,0.001,604,8
0.536,0.0001,339,365,100,50,0.001,704,8
0.54,0.0001,391,413,100,50,0.001,804,8
0.55,0.0001,437,467,100,50,0.001,904,8
0.548,0.0001,488,516,100,50,0.001,1004,8
0.546,0.0001,539,565,100,50,0.001,1104,8
0.544,0.0001,595,609,100,50,0.001,1204,8
0.548,0.0001,647,657,100,50,0.001,1304,8
0.56,0.0001,702,702,100,50,0.001,1404,8
0.568,0.0001,757,747,100,50,0.001,1504,8
0.584,0.0001,803,801,100,50,0.001,1604,8
0.594,0.0001,857,847,100,50,0.001,1704,8
0.622,0.0001,909,895,100,50,0.001,1804,8
0.644,0.0001,958,946,100,50,0.001,1904,8
0.67,0.0001,1015,989,100,50,0.001,2004,8
0.49,0.0001,52,52,100,50,0.001,104,9
0.494,0.0001,103,101,100,50,0.001,204,9
0.498,0.0001,156,148,100,50,0.001,304,9
0.508,0.0001,204,200,100,50,0.001,404,9
0.528,0.0001,261,243,100,50,0.001,504,9
0.54,0.0001,309,295,100,50,0.001,604,9
0.546,0.0001,367,337,100,50,0.001,704,9
0.554,0.0001,423,381,100,50,0.001,804,9
0.562,0.0001,475,429,100,50,0.001,904,9
0.572,0.0001,519,485,100,50,0.001,1004,9
0.574,0.0001,572,532,100,50,0.001,1104,9
0.586,0.0001,618,586,100,50,0.001,1204,9
0.598,0.0001,667,637,100,50,0.001,1304,9
0.616,0.0001,719,685,100,50,0.001,1404,9
0.632,0.0001,763,741,100,50,0.001,1504,9
0.65,0.0001,809,795,100,50,0.001,1604,9
0.67,0.0001,861,843,100,50,0.001,1704,9
0.69,0.0001,902,902,100,50,0.001,1804,9
0.702,0.0001,955,949,100,50,0.001,1904,9
0.728,0.0001,1009,995,100,50,0.001,2004,9
0.496,0.0001,46,58,100,50,0.001,104,10
0.492,0.0001,104,100,100,50,0.001,204,10
0.492,0.0001,143,161,100,50,0.001,304,10
0.496,0.0001,200,204,100,50,0.001,404,10
0.496,0.0001,253,251,100,50,0.001,504,10
0.496,0.0001,307,297,100,50,0.001,604,10
0.498,0.0001,362,342,100,50,0.001,704,10
0.508,0.0001,413,391,100,50,0.001,804,10
0.506,0.0001,459,445,100,50,0.001,904,10
0.518,0.0001,511,493,100,50,0.001,1004,10
0.52,0.0001,567,537,100,50,0.001,1104,10
0.532,0.0001,621,583,100,50,0.001,1204,10
0.544,0.0001,670,634,100,50,0.001,1304,10
0.564,0.0001,715,689,100,50,0.001,1404,10
0.602,0.0001,763,741,100,50,0.001,1504,10
0.616,0.0001,808,796,100,50,0.001,1604,10
0.64,0.0001,861,843,100,50,0.001,1704,10
0.67,0.0001,916,888,100,50,0.001,1804,10
0.692,0.0001,968,936,100,50,0.001,1904,10
0.726,0.0001,1017,987,100,50,0.001,2004,10
0.488,0.0001,53,51,100,50,0.001,104,11
0.494,0.0001,103,101,100,50,0.001,204,11
0.498,0.0001,149,155,100,50,0.001,304,11
0.488,0.0001,199,205,100,50,0.001,404,11
0.49,0.0001,247,257,100,50,0.001,504,11
0.486,0.0001,300,304,100,50,0.001,604,11
0.496,0.0001,349,355,100,50,0.001,704,11
0.494,0.0001,402,402,100,50,0.001,804,11
0.502,0.0001,444,460,100,50,0.001,904,11
0.52,0.0001,485,519,100,50,0.001,1004,11
0.532,0.0001,538,566,100,50,0.001,1104,11
0.542,0.0001,589,615,100,50,0.001,1204,11
0.552,0.0001,639,665,100,50,0.001,1304,11
0.564,0.0001,691,713,100,50,0.001,1404,11
0.574,0.0001,746,758,100,50,0.001,1504,11
0.604,0.0001,795,809,100,50,0.001,1604,11
0.626,0.0001,845,859,100,50,0.001,1704,11
0.658,0.0001,898,906,100,50,0.001,1804,11
0.68,0.0001,946,958,100,50,0.001,1904,11
0.706,0.0001,991,1013,100,50,0.001,2004,11
0.534,0.0001,54,50,100,50,0.001,104,12
0.54,0.0001,96,108,100,50,0.001,204,12
0.55,0.0001,135,169,100,50,0.001,304,12
0.542,0.0001,192,212,100,50,0.001,404,12
0.532,0.0001,242,262,100,50,0.001,504,12
0.556,0.0001,287,317,100,50,0.001,604,12
0.562,0.0001,334,370,100,50,0.001,704,12
0.546,0.0001,385,419,100,50,0.001,804,12
0.552,0.0001,438,466,100,50,0.001,904,12
0.582,0.0001,492,512,100,50,0.001,1004,12
0.598,0.0001,540,564,100,50,0.001,1104,12
0.608,0.0001,589,615,100,50,0.001,1204,12
0.624,0.0001,636,668,100,50,0.001,1304,12
0.632,0.0001,677,727,100,50,0.001,1404,12
0.644,0.0001,728,776,100,50,0.001,1504,12
0.66,0.0001,773,831,100,50,0.001,1604,12
0.698,0.0001,813,891,100,50,0.001,1704,12
0.702,0.0001,866,938,100,50,0.001,1804,12
0.732,0.0001,924,980,100,50,0.001,1904,12
0.756,0.0001,980,1024,100,50,0.001,2004,12
0.51,0.0001,49,55,100,50,0.001,104,13
0.516,0.0001,103,101,100,50,0.001,204,13
0.512,0.0001,155,149,100,50,0.001,304,13
0.528,0.0001,209,195,100,50,0.001,404,13
0.544,0.0001,257,247,100,50,0.001,504,13
0.546,0.0001,307,297,100,50,0.001,604,13
0.548,0.0001,365,339,100,50,0.001,704,13
0.552,0.0001,418,386,100,50,0.001,804,13
0.558,0.0001,471,433,100,50,0.001,904,13
0.584,0.0001,513,491,100,50,0.001,1004,13
0.594,0.0001,562,542,100,50,0.001,1104,13
0.608,0.0001,609,595,100,50,0.001,1204,13
0.624,0.0001,660,644,100,50,0.001,1304,13
0.636,0.0001,710,694,100,50,0.001,1404,13
0.654,0.0001,762,742,100,50,0.001,1504,13
0.676,0.0001,803,801,100,50,0.001,1604,13
0.706,0.0001,849,855,100,50,0.001,1704,13
0.722,0.0001,909,895,100,50,0.001,1804,13
0.736,0.0001,954,950,100,50,0.001,1904,13
0.758,0.0001,1008,996,100,50,0.001,2004,13
0.506,0.0001,54,50,100,50,0.001,104,14
0.504,0.0001,109,95,100,50,0.001,204,14
0.508,0.0001,164,140,100,50,0.001,304,14
0.508,0.0001,219,185,100,50,0.001,404,14
0.512,0.0001,268,236,100,50,0.001,504,14
0.514,0.0001,316,288,100,50,0.001,604,14
0.528,0.0001,368,336,100,50,0.001,704,14
0.542,0.0001,417,387,100,50,0.001,804,14
0.55,0.0001,459,445,100,50,0.001,904,14
0.56,0.0001,507,497,100,50,0.001,1004,14
0.556,0.0001,556,548,100,50,0.001,1104,14
0.57,0.0001,597,607,100,50,0.001,1204,14
0.578,0.0001,647,657,100,50,0.001,1304,14
0.592,0.0001,707,697,100,50,0.001,1404,14
0.6,0.0001,756,748,100,50,0.001,1504,14
0.634,0.0001,800,804,100,50,0.001,1604,14
0.664,0.0001,841,863,100,50,0.001,1704,14
0.684,0.0001,894,910,100,50,0.001,1804,14
0.716,0.0001,937,967,100,50,0.001,1904,14
0.752,0.0001,988,1016,100,50,0.001,2004,14
0.512,0.0001,55,49,100,50,0.001,104,15
0.51,0.0001,112,92,100,50,0.001,204,15
0.514,0.0001,164,140,100,50,0.001,304,15
0.524,0.0001,213,191,100,50,0.001,404,15
0.534,0.0001,264,240,100,50,0.001,504,15
0.546,0.0001,312,292,100,50,0.001,604,15
0.556,0.0001,357,347,100,50,0.001,704,15
0.542,0.0001,409,395,100,50,0.001,804,15
0.55,0.0001,451,453,100,50,0.001,904,15
0.562,0.0001,510,494,100,50,0.001,1004,15
0.564,0.0001,561,543,100,50,0.001,1104,15
0.596,0.0001,610,594,100,50,0.001,1204,15
0.624,0.0001,661,643,100,50,0.001,1304,15
0.648,0.0001,696,708,100,50,0.001,1404,15
0.652,0.0001,752,752,100,50,0.001,1504,15
0.664,0.0001,802,802,100,50,0.001,1604,15
0.672,0.0001,855,849,100,50,0.001,1704,15
0.7,0.0001,902,902,100,50,0.001,1804,15
0.732,0.0001,951,953,100,50,0.001,1904,15
0.758,0.0001,996,1008,100,50,0.001,2004,15
0.51,0.0001,49,55,100,50,0.001,104,16
0.53,0.0001,97,107,100,50,0.001,204,16
0.54,0.0001,148,156,100,50,0.001,304,16
0.538,0.0001,202,202,100,50,0.001,404,16
0.544,0.0001,255,249,100,50,0.001,504,16
0.544,0.0001,307,297,100,50,0.001,604,16
0.548,0.0001,363,341,100,50,0.001,704,16
0.552,0.0001,414,390,100,50,0.001,804,16
0.558,0.0001,459,445,100,50,0.001,904,16
0.564,0.0001,512,492,100,50,0.001,1004,16
0.566,0.0001,550,554,100,50,0.001,1104,16
0.58,0.0001,599,605,100,50,0.001,1204,16
0.604,0.0001,656,648,100,50,0.001,1304,16
0.632,0.0001,707,697,100,50,0.001,1404,16
0.638,0.0001,750,754,100,50,0.001,1504,16
0.652,0.0001,798,806,100,50,0.001,1604,16
0.666,0.0001,848,856,100,50,0.001,1704,16
0.686,0.0001,900,904,100,50,0.001,1804,16
0.718,0.0001,946,958,100,50,0.001,1904,16
0.74,0.0001,999,1005,100,50,0.001,2004,16
0.536,0.0001,48,56,100,50,0.001,104,17
0.538,0.0001,105,99,100,50,0.001,204,17
0.546,0.0001,152,152,100,50,0.001,304,17
0.548,0.0001,202,202,100,50,0.001,404,17
0.55,0.0001,240,264,100,50,0.001,504,17
0.542,0.0001,291,313,100,50,0.001,604,17
0.548,0.0001,341,363,100,50,0.001,704,17
0.548,0.0001,387,417,100,50,0.001,804,17
0.556,0.0001,438,466,100,50,0.001,904,17
0.564,0.0001,486,518,100,50,0.001,1004,17
0.566,0.0001,545,559,100,50,0.001,1104,17
0.572,0.0001,600,604,100,50,0.001,1204,17
0.586,0.0001,647,657,100,50,0.001,1304,17
0.592,0.0001,695,709,100,50,0.001,1404,17
0.62,0.0001,743,761,100,50,0.001,1504,17
0.64,0.0001,788,816,100,50,0.001,1604,17
0.668,0.0001,833,871,100,50,0.001,1704,17
0.692,0.0001,886,918,100,50,0.001,1804,17
0.688,0.0001,938,966,100,50,0.001,1904,17
0.712,0.0001,989,1015,100,50,0.001,2004,17
0.504,0.0001,53,51,100,50,0.001,104,18
0.522,0.0001,98,106,100,50,0.001,204,18
0.52,0.0001,156,148,100,50,0.001,304,18
0.528,0.0001,207,197,100,50,0.001,404,18
0.518,0.0001,257,247,100,50,0.001,504,18
0.53,0.0001,311,293,100,50,0.001,604,18
0.546,0.0001,365,339,100,50,0.001,704,18
0.552,0.0001,403,401,100,50,0.001,804,18
0.548,0.0001,459,445,100,50,0.001,904,18
0.572,0.0001,522,482,100,50,0.001,1004,18
0.588,0.0001,560,544,100,50,0.001,1104,18
0.616,0.0001,611,593,100,50,0.001,1204,18
0.638,0.0001,657,647,100,50,0.001,1304,18
0.65,0.0001,710,694,100,50,0.001,1404,18
0.666,0.0001,761,743,100,50,0.001,1504,18
0.682,0.0001,813,791,100,50,0.001,1604,18
0.702,0.0001,868,836,100,50,0.001,1704,18
0.73,0.0001,908,896,100,50,0.001,1804,18
0.732,0.0001,952,952,100,50,0.001,1904,18
0.754,0.0001,1001,1003,100,50,0.001,2004,18
0.492,0.0001,52,52,100,50,0.001,104,19
0.51,0.0001,113,91,100,50,0.001,204,19
0.508,0.0001,152,152,100,50,0.001,304,19
0.512,0.0001,205,199,100,50,0.001,404,19
0.512,0.0001,255,249,100,50,0.001,504,19
0.524,0.0001,296,308,100,50,0.001,604,19
0.536,0.0001,346,358,100,50,0.001,704,19
0.54,0.0001,401,403,100,50,0.001,804,19
0.548,0.0001,446,458,100,50,0.001,904,19
0.562,0.0001,500,504,100,50,0.001,1004,19
0.576,0.0001,549,555,100,50,0.001,1104,19
0.592,0.0001,590,614,100,50,0.001,1204,19
0.594,0.0001,647,657,100,50,0.001,1304,19
0.614,0.0001,696,708,100,50,0.001,1404,19
0.632,0.0001,743,761,100,50,0.001,1504,19
0.638,0.0001,791,813,100,50,0.001,1604,19
0.656,0.0001,847,857,100,50,0.001,1704,19
0.68,0.0001,893,911,100,50,0.001,1804,19
0.696,0.0001,942,962,100,50,0.001,1904,19
0.728,0.0001,991,1013,100,50,0.001,2004,19
0.52,0.0001,54,50,100,50,0.001,104,20
0.522,0.0001,111,93,100,50,0.001,204,20
0.522,0.0001,164,140,100,50,0.001,304,20
0.53,0.0001,206,198,100,50,0.001,404,20
0.53,0.0001,247,257,100,50,0.001,504,20
0.528,0.0001,292,312,100,50,0.001,604,20
0.532,0.0001,340,364,100,50,0.001,704,20
0.534,0.0001,394,410,100,50,0.001,804,20
0.548,0.0001,444,460,100,50,0.001,904,20
0.552,0.0001,494,510,100,50,0.001,1004,20
0.566,0.0001,547,557,100,50,0.001,1104,20
0.59,0.0001,601,603,100,50,0.001,1204,20
0.6,0.0001,657,647,100,50,0.001,1304,20
0.61,0.0001,694,710,100,50,0.001,1404,20
0.652,0.0001,743,761,100,50,0.001,1504,20
0.672,0.0001,791,813,100,50,0.001,1604,20
0.686,0.0001,839,865,100,50,0.001,1704,20
0.7,0.0001,889,915,100,50,0.001,1804,20
0.734,0.0001,948,956,100,50,0.001,1904,20
0.752,0.0001,993,1011,100,50,0.001,2004,20
0.538,0.0001,60,44,100,50,0.01,104,1
0.56,0.0001,111,93,100,50,0.01,204,1
0.586,0.0001,161,143,100,50,0.01,304,1
0.604,0.0001,211,193,100,50,0.01,404,1
0.614,0.0001,258,246,100,50,0.01,504,1
0.636,0.0001,307,297,100,50,0.01,604,1
0.662,0.0001,352,352,100,50,0.01,704,1
0.72,0.0001,408,396,100,50,0.01,804,1
0.752,0.0001,457,447,100,50,0.01,904,1
0.782,0.0001,505,499,100,50,0.01,1004,1
0.826,0.0001,552,552,100,50,0.01,1104,1
0.852,0.0001,607,597,100,50,0.01,1204,1
0.884,0.0001,660,644,100,50,0.01,1304,1
0.916,0.0001,711,693,100,50,0.01,1404,1
0.94,0.0001,765,739,100,50,0.01,1504,1
0.94,0.0001,807,797,100,50,0.01,1604,1
0.948,0.0001,856,848,100,50,0.01,1704,1
0.958,0.0001,901,903,100,50,0.01,1804,1
0.96,0.0001,949,955,100,50,0.01,1904,1
0.966,0.0001,999,1005,100,50,0.01,2004,1
0.538,0.0001,54,50,100,50,0.01,104,2
0.562,0.0001,104,100,100,50,0.01,204,2
0.584,0.0001,144,160,100,50,0.01,304,2
0.608,0.0001,201,203,100,50,0.01,404,2
0.642,0.0001,249,255,100,50,0.01,504,2
0.672,0.0001,297,307,100,50,0.01,604,2
0.706,0.0001,346,358,100,50,0.01,704,2
0.752,0.0001,386,418,100,50,0.01,804,2
0.786,0.0001,431,473,100,50,0.01,904,2
0.824,0.0001,481,523,100,50,0.01,1004,2
0.848,0.0001,526,578,100,50,0.01,1104,2
0.884,0.0001,578,626,100,50,0.01,1204,2
0.902,0.0001,635,669,100,50,0.01,1304,2
0.922,0.0001,691,713,100,50,0.01,1404,2
0.92,0.0001,743,761,100,50,0.01,1504,2
0.94,0.0001,794,810,100,50,0.01,1604,2
0.944,0.0001,847,857,100,50,0.01,1704,2
0.946,0.0001,894,910,100,50,0.01,1804,2
0.948,0.0001,947,957,100,50,0.01,1904,2
0.95,0.0001,1001,1003,100,50,0.01,2004,2
0.532,0.0001,55,49,100,50,0.01,104,3
0.568,0.0001,90,114,100,50,0.01,204,3
0.588,0.0001,140,164,100,50,0.01,304,3
0.618,0.0001,185,219,100,50,0.01,404,3
0.626,0.0001,238,266,100,50,0.01,504,3
0.668,0.0001,290,314,100,50,0.01,604,3
0.698,0.0001,334,370,100,50,0.01,704,3
0.736,0.0001,387,417,100,50,0.01,804,3
0.762,0.0001,437,467,100,50,0.01,904,3
0.818,0.0001,495,509,100,50,0.01,1004,3
0.848,0.0001,549,555,100,50,0.01,1104,3
0.886,0.0001,598,606,100,50,0.01,1204,3
0.904,0.0001,653,651,100,50,0.01,1304,3
0.946,0.0001,704,700,100,50,0.01,1404,3
0.954,0.0001,747,757,100,50,0.01,1504,3
0.958,0.0001,794,810,100,50,0.01,1604,3
0.958,0.0001,842,862,100,50,0.01,1704,3
0.962,0.0001,886,918,100,50,0.01,1804,3
0.966,0.0001,939,965,100,50,0.01,1904,3
0.964,0.0001,997,1007,100,50,0.01,2004,3
0.566,0.0001,50,54,100,50,0.01,104,4
0.594,0.0001,104,100,100,50,0.01,204,4
0.586,0.0001,149,155,100,50,0.01,304,4
0.612,0.0001,198,206,100,50,0.01,404,4
0.63,0.0001,245,259,100,50,0.01,504,4
0.68,0.0001,287,317,100,50,0.01,604,4
0.714,0.0001,340,364,100,50,0.01,704,4
0.764,0.0001,395,409,100,50,0.01,804,4
0.792,0.0001,443,461,100,50,0.01,904,4
0.834,0.0001,502,502,100,50,0.01,1004,4
0.862,0.0001,553,551,100,50,0.01,1104,4
0.904,0.0001,612,592,100,50,0.01,1204,4
0.912,0.0001,659,645,100,50,0.01,1304,4
0.928,0.0001,705,699,100,50,0.01,1404,4
0.942,0.0001,763,741,100,50,0.01,1504,4
0.952,0.0001,808,796,100,50,0.01,1604,4
0.956,0.0001,855,849,100,50,0.01,1704,4
0.962,0.0001,904,900,100,50,0.01,1804,4
0.966,0.0001,961,943,100,50,0.01,1904,4
0.966,0.0001,1013,991,100,50,0.01,2004,4
0.536,0.0001,51,53,100,50,0.01,104,5
0.564,0.0001,99,105,100,50,0.01,204,5
0.574,0.0001,148,156,100,50,0.01,304,5
0.588,0.0001,195,209,100,50,0.01,404,5
0.622,0.0001,237,267,100,50,0.01,504,5
0.646,0.0001,288,316,100,50,0.01,604,5
0.678,0.0001,340,364,100,50,0.01,704,5
0.734,0.0001,390,414,100,50,0.01,804,5
0.782,0.0001,441,463,100,50,0.01,904,5
0.828,0.0001,504,500,100,50,0.01,1004,5
0.862,0.0001,543,561,100,50,0.01,1104,5
0.892,0.0001,590,614,100,50,0.01,1204,5
0.898,0.0001,633,671,100,50,0.01,1304,5
0.904,0.0001,685,719,100,50,0.01,1404,5
0.886,0.0001,736,768,100,50,0.01,1504,5
0.914,0.0001,788,816,100,50,0.01,1604,5
0.922,0.0001,835,869,100,50,0.01,1704,5
0.924,0.0001,880,924,100,50,0.01,1804,5
0.932,0.0001,939,965,100,50,0.01,1904,5
0.934,0.0001,999,1005,100,50,0.01,2004,5
0.554,0.0001,51,53,100,50,0.01,104,6
0.612,0.0001,99,105,100,50,0.01,204,6
0.614,0.0001,151,153,100,50,0.01,304,6
0.618,0.0001,195,209,100,50,0.01,404,6
0.628,0.0001,235,269,100,50,0.01,504,6
0.654,0.0001,285,319,100,50,0.01,604,6
0.696,0.0001,332,372,100,50,0.01,704,6
0.722,0.0001,383,421,100,50,0.01,804,6
0.744,0.0001,428,476,100,50,0.01,904,6
0.806,0.0001,481,523,100,50,0.01,1004,6
0.866,0.0001,531,573,100,50,0.01,1104,6
0.914,0.0001,589,615,100,50,0.01,1204,6
0.934,0.0001,646,658,100,50,0.01,1304,6
0.942,0.0001,693,711,100,50,0.01,1404,6
0.952,0.0001,745,759,100,50,0.01,1504,6
0.956,0.0001,798,806,100,50,0.01,1604,6
0.962,0.0001,855,849,100,50,0.01,1704,6
0.96,0.0001,908,896,100,50,0.01,1804,6
0.964,0.0001,957,947,100,50,0.01,1904,6
0.972,0.0001,1004,1000,100,50,0.01,2004,6
0.534,0.0001,57,47,100,50,0.01,104,7
0.546,0.0001,103,101,100,50,0.01,204,7
0.562,0.0001,164,140,100,50,0.01,304,7
0.586,0.0001,203,201,100,50,0.01,404,7
0.596,0.0001,252,252,100,50,0.01,504,7
0.63,0.0001,298,306,100,50,0.01,604,7
0.652,0.0001,355,349,100,50,0.01,704,7
0.676,0.0001,403,401,100,50,0.01,804,7
0.73,0.0001,451,453,100,50,0.01,904,7
0.778,0.0001,500,504,100,50,0.01,1004,7
0.824,0.0001,550,554,100,50,0.01,1104,7
0.88,0.0001,602,602,100,50,0.01,1204,7
0.894,0.0001,656,648,100,50,0.01,1304,7
0.928,0.0001,708,696,100,50,0.01,1404,7
0.94,0.0001,766,738,100,50,0.01,1504,7
0.946,0.0001,813,791,100,50,0.01,1604,7
0.946,0.0001,869,835,100,50,0.01,1704,7
0.952,0.0001,918,886,100,50,0.01,1804,7
0.954,0.0001,962,942,100,50,0.01,1904,7
0.958,0.0001,1012,992,100,50,0.01,2004,7
0.522,0.0001,53,51,100,50,0.01,104,8
0.542,0.0001,103,101,100,50,0.01,204,8
0.55,0.0001,151,153,100,50,0.01,304,8
0.588,0.0001,204,200,100,50,0.01,404,8
0.602,0.0001,257,247,100,50,0.01,504,8
0.614,0.0001,308,296,100,50,0.01,604,8
0.616,0.0001,353,351,100,50,0.01,704,8
0.686,0.0001,395,409,100,50,0.01,804,8
0.714,0.0001,446,458,100,50,0.01,904,8
0.768,0.0001,503,501,100,50,0.01,1004,8
0.808,0.0001,545,559,100,50,0.01,1104,8
0.852,0.0001,603,601,100,50,0.01,1204,8
0.888,0.0001,654,650,100,50,0.01,1304,8
0.906,0.0001,704,700,100,50,0.01,1404,8
0.924,0.0001,750,754,100,50,0.01,1504,8
0.928,0.0001,794,810,100,50,0.01,1604,8
0.95,0.0001,849,855,100,50,0.01,1704,8
0.948,0.0001,894,910,100,50,0.01,1804,8
0.952,0.0001,944,960,100,50,0.01,1904,8
0.956,0.0001,993,1011,100,50,0.01,2004,8
0.53,0.0001,60,44,100,50,0.01,104,9
0.558,0.0001,108,96,100,50,0.01,204,9
0.56,0.0001,160,144,100,50,0.01,304,9
0.612,0.0001,209,195,100,50,0.01,404,9
0.606,0.0001,263,241,100,50,0.01,504,9
0.66,0.0001,313,291,100,50,0.01,604,9
0.67,0.0001,362,342,100,50,0.01,704,9
0.72,0.0001,408,396,100,50,0.01,804,9
0.734,0.0001,457,447,100,50,0.01,904,9
0.808,0.0001,511,493,100,50,0.01,1004,9
0.84,0.0001,559,545,100,50,0.01,1104,9
0.884,0.0001,611,593,100,50,0.01,1204,9
0.902,0.0001,654,650,100,50,0.01,1304,9
0.936,0.0001,704,700,100,50,0.01,1404,9
0.954,0.0001,755,749,100,50,0.01,1504,9
0.956,0.0001,806,798,100,50,0.01,1604,9
0.958,0.0001,859,845,100,50,0.01,1704,9
0.958,0.0001,907,897,100,50,0.01,1804,9
0.958,0.0001,952,952,100,50,0.01,1904,9
0.958,0.0001,986,1018,100,50,0.01,2004,9
0.552,0.0001,44,60,100,50,0.01,104,10
0.554,0.0001,96,108,100,50,0.01,204,10
0.576,0.0001,149,155,100,50,0.01,304,10
0.588,0.0001,205,199,100,50,0.01,404,10
0.624,0.0001,257,247,100,50,0.01,504,10
0.634,0.0001,308,296,100,50,0.01,604,10
0.638,0.0001,359,345,100,50,0.01,704,10
0.69,0.0001,408,396,100,50,0.01,804,10
0.744,0.0001,458,446,100,50,0.01,904,10
0.818,0.0001,507,497,100,50,0.01,1004,10
0.858,0.0001,556,548,100,50,0.01,1104,10
0.89,0.0001,609,595,100,50,0.01,1204,10
0.924,0.0001,657,647,100,50,0.01,1304,10
0.938,0.0001,711,693,100,50,0.01,1404,10
0.936,0.0001,757,747,100,50,0.01,1504,10
0.942,0.0001,808,796,100,50,0.01,1604,10
0.94,0.0001,857,847,100,50,0.01,1704,10
0.94,0.0001,914,890,100,50,0.01,1804,10
0.948,0.0001,968,936,100,50,0.01,1904,10
0.954,0.0001,1014,990,100,50,0.01,2004,10
0.508,0.0001,44,60,100,50,0.01,104,11
0.516,0.0001,101,103,100,50,0.01,204,11
0.536,0.0001,149,155,100,50,0.01,304,11
0.55,0.0001,199,205,100,50,0.01,404,11
0.556,0.0001,246,258,100,50,0.01,504,11
0.566,0.0001,290,314,100,50,0.01,604,11
0.574,0.0001,347,357,100,50,0.01,704,11
0.63,0.0001,405,399,100,50,0.01,804,11
0.702,0.0001,459,445,100,50,0.01,904,11
0.734,0.0001,503,501,100,50,0.01,1004,11
0.788,0.0001,556,548,100,50,0.01,1104,11
0.818,0.0001,607,597,100,50,0.01,1204,11
0.872,0.0001,655,649,100,50,0.01,1304,11
0.904,0.0001,701,703,100,50,0.01,1404,11
0.922,0.0001,749,755,100,50,0.01,1504,11
0.932,0.0001,801,803,100,50,0.01,1604,11
0.928,0.0001,849,855,100,50,0.01,1704,11
0.946,0.0001,904,900,100,50,0.01,1804,11
0.946,0.0001,946,958,100,50,0.01,1904,11
0.96,0.0001,1003,1001,100,50,0.01,2004,11
0.51,0.0001,51,53,100,50,0.01,104,12
0.514,0.0001,99,105,100,50,0.01,204,12
0.546,0.0001,145,159,100,50,0.01,304,12
0.57,0.0001,189,215,100,50,0.01,404,12
0.596,0.0001,239,265,100,50,0.01,504,12
0.646,0.0001,293,311,100,50,0.01,604,12
0.688,0.0001,342,362,100,50,0.01,704,12
0.736,0.0001,398,406,100,50,0.01,804,12
0.78,0.0001,446,458,100,50,0.01,904,12
0.838,0.0001,494,510,100,50,0.01,1004,12
0.868,0.0001,543,561,100,50,0.01,1104,12
0.91,0.0001,588,616,100,50,0.01,1204,12
0.924,0.0001,636,668,100,50,0.01,1304,12
0.944,0.0001,692,712,100,50,0.01,1404,12
0.952,0.0001,741,763,100,50,0.01,1504,12
0.954,0.0001,791,813,100,50,0.01,1604,12
0.958,0.0001,842,862,100,50,0.01,1704,12
0.96,0.0001,888,916,100,50,0.01,1804,12
0.962,0.0001,945,959,100,50,0.01,1904,12
0.96,0.0001,990,1014,100,50,0.01,2004,12
0.518,0.0001,61,43,100,50,0.01,104,13
0.554,0.0001,108,96,100,50,0.01,204,13
0.546,0.0001,160,144,100,50,0.01,304,13
0.58,0.0001,213,191,100,50,0.01,404,13
0.616,0.0001,260,244,100,50,0.01,504,13
0.64,0.0001,316,288,100,50,0.01,604,13
0.65,0.0001,359,345,100,50,0.01,704,13
0.718,0.0001,405,399,100,50,0.01,804,13
0.758,0.0001,449,455,100,50,0.01,904,13
0.788,0.0001,504,500,100,50,0.01,1004,13
0.818,0.0001,550,554,100,50,0.01,1104,13
0.874,0.0001,604,600,100,50,0.01,1204,13
0.882,0.0001,656,648,100,50,0.01,1304,13
0.902,0.0001,701,703,100,50,0.01,1404,13
0.914,0.0001,762,742,100,50,0.01,1504,13
0.922,0.0001,807,797,100,50,0.01,1604,13
0.928,0.0001,859,845,100,50,0.01,1704,13
0.938,0.0001,905,899,100,50,0.01,1804,13
0.942,0.0001,953,951,100,50,0.01,1904,13
0.948,0.0001,999,1005,100,50,0.01,2004,13
0.544,0.0001,60,44,100,50,0.01,104,14
0.59,0.0001,108,96,100,50,0.01,204,14
0.616,0.0001,149,155,100,50,0.01,304,14
0.62,0.0001,200,204,100,50,0.01,404,14
0.652,0.0001,245,259,100,50,0.01,504,14
0.696,0.0001,299,305,100,50,0.01,604,14
0.736,0.0001,357,347,100,50,0.01,704,14
0.774,0.0001,408,396,100,50,0.01,804,14
0.788,0.0001,458,446,100,50,0.01,904,14
0.848,0.0001,510,494,100,50,0.01,1004,14
0.864,0.0001,556,548,100,50,0.01,1104,14
0.896,0.0001,600,604,100,50,0.01,1204,14
0.908,0.0001,645,659,100,50,0.01,1304,14
0.928,0.0001,694,710,100,50,0.01,1404,14
0.936,0.0001,737,767,100,50,0.01,1504,14
0.94,0.0001,789,815,100,50,0.01,1604,14
0.948,0.0001,839,865,100,50,0.01,1704,14
0.952,0.0001,887,917,100,50,0.01,1804,14
0.95,0.0001,934,970,100,50,0.01,1904,14
0.956,0.0001,986,1018,100,50,0.01,2004,14
0.506,0.0001,51,53,100,50,0.01,104,15
0.526,0.0001,102,102,100,50,0.01,204,15
0.568,0.0001,148,156,100,50,0.01,304,15
0.604,0.0001,196,208,100,50,0.01,404,15
0.616,0.0001,239,265,100,50,0.01,504,15
0.646,0.0001,281,323,100,50,0.01,604,15
0.668,0.0001,340,364,100,50,0.01,704,15
0.708,0.0001,394,410,100,50,0.01,804,15
0.74,0.0001,445,459,100,50,0.01,904,15
0.79,0.0001,499,505,100,50,0.01,1004,15
0.842,0.0001,554,550,100,50,0.01,1104,15
0.87,0.0001,602,602,100,50,0.01,1204,15
0.892,0.0001,650,654,100,50,0.01,1304,15
0.894,0.0001,705,699,100,50,0.01,1404,15
0.908,0.0001,754,750,100,50,0.01,1504,15
0.922,0.0001,805,799,100,50,0.01,1604,15
0.93,0.0001,855,849,100,50,0.01,1704,15
0.942,0.0001,902,902,100,50,0.01,1804,15
0.95,0.0001,955,949,100,50,0.01,1904,15
0.954,0.0001,1007,997,100,50,0.01,2004,15
0.542,0.0001,48,56,100,50,0.01,104,16
0.584,0.0001,93,111,100,50,0.01,204,16
0.616,0.0001,145,159,100,50,0.01,304,16
0.644,0.0001,197,207,100,50,0.01,404,16
0.638,0.0001,255,249,100,50,0.01,504,16
0.656,0.0001,310,294,100,50,0.01,604,16
0.666,0.0001,363,341,100,50,0.01,704,16
0.706,0.0001,415,389,100,50,0.01,804,16
0.746,0.0001,464,440,100,50,0.01,904,16
0.802,0.0001,518,486,100,50,0.01,1004,16
0.824,0.0001,569,535,100,50,0.01,1104,16
0.868,0.0001,620,584,100,50,0.01,1204,16
0.864,0.0001,676,628,100,50,0.01,1304,16
0.872,0.0001,728,676,100,50,0.01,1404,16
0.932,0.0001,768,736,100,50,0.01,1504,16
0.938,0.0001,814,790,100,50,0.01,1604,16
0.954,0.0001,866,838,100,50,0.01,1704,16
0.954,0.0001,917,887,100,50,0.01,1804,16
0.95,0.0001,974,930,100,50,0.01,1904,16
0.954,0.0001,1025,979,100,50,0.01,2004,16
0.538,0.0001,48,56,100,50,0.01,104,17
0.584,0.0001,99,105,100,50,0.01,204,17
0.564,0.0001,154,150,100,50,0.01,304,17
0.578,0.0001,210,194,100,50,0.01,404,17
0.588,0.0001,254,250,100,50,0.01,504,17
0.632,0.0001,299,305,100,50,0.01,604,17
0.662,0.0001,342,362,100,50,0.01,704,17
0.71,0.0001,393,411,100,50,0.01,804,17
0.758,0.0001,446,458,100,50,0.01,904,17
0.84,0.0001,494,510,100,50,0.01,1004,17
0.866,0.0001,543,561,100,50,0.01,1104,17
0.926,0.0001,596,608,100,50,0.01,1204,17
0.934,0.0001,645,659,100,50,0.01,1304,17
0.932,0.0001,694,710,100,50,0.01,1404,17
0.946,0.0001,744,760,100,50,0.01,1504,17
0.948,0.0001,790,814,100,50,0.01,1604,17
0.958,0.0001,836,868,100,50,0.01,1704,17
0.964,0.0001,895,909,100,50,0.01,1804,17
0.966,0.0001,944,960,100,50,0.01,1904,17
0.97,0.0001,996,1008,100,50,0.01,2004,17
0.496,0.0001,49,55,100,50,0.01,104,18
0.558,0.0001,100,104,100,50,0.01,204,18
0.58,0.0001,149,155,100,50,0.01,304,18
0.628,0.0001,198,206,100,50,0.01,404,18
0.64,0.0001,244,260,100,50,0.01,504,18
0.654,0.0001,298,306,100,50,0.01,604,18
0.66,0.0001,352,352,100,50,0.01,704,18
0.704,0.0001,399,405,100,50,0.01,804,18
0.772,0.0001,446,458,100,50,0.01,904,18
0.806,0.0001,500,504,100,50,0.01,1004,18
0.816,0.0001,554,550,100,50,0.01,1104,18
0.876,0.0001,600,604,100,50,0.01,1204,18
0.9,0.0001,645,659,100,50,0.01,1304,18
0.916,0.0001,687,717,100,50,0.01,1404,18
0.932,0.0001,742,762,100,50,0.01,1504,18
0.946,0.0001,790,814,100,50,0.01,1604,18
0.948,0.0001,831,873,100,50,0.01,1704,18
0.954,0.0001,883,921,100,50,0.01,1804,18
0.948,0.0001,928,976,100,50,0.01,1904,18
0.956,0.0001,977,1027,100,50,0.01,2004,18
0.482,0.0001,49,55,100,50,0.01,104,19
0.522,0.0001,101,103,100,50,0.01,204,19
0.554,0.0001,148,156,100,50,0.01,304,19
0.572,0.0001,189,215,100,50,0.01,404,19
0.584,0.0001,250,254,100,50,0.01,504,19
0.614,0.0001,296,308,100,50,0.01,604,19
0.63,0.0001,350,354,100,50,0.01,704,19
0.676,0.0001,395,409,100,50,0.01,804,19
0.7,0.0001,442,462,100,50,0.01,904,19
0.758,0.0001,487,517,100,50,0.01,1004,19
0.794,0.0001,540,564,100,50,0.01,1104,19
0.842,0.0001,594,610,100,50,0.01,1204,19
0.878,0.0001,634,670,100,50,0.01,1304,19
0.902,0.0001,683,721,100,50,0.01,1404,19
0.914,0.0001,751,753,100,50,0.01,1504,19
0.924,0.0001,797,807,100,50,0.01,1604,19
0.924,0.0001,852,852,100,50,0.01,1704,19
0.924,0.0001,898,906,100,50,0.01,1804,19
0.938,0.0001,941,963,100,50,0.01,1904,19
0.944,0.0001,998,1006,100,50,0.01,2004,19
0.502,0.0001,47,57,100,50,0.01,104,20
0.512,0.0001,90,114,100,50,0.01,204,20
0.524,0.0001,138,166,100,50,0.01,304,20
0.55,0.0001,190,214,100,50,0.01,404,20
0.564,0.0001,243,261,100,50,0.01,504,20
0.596,0.0001,287,317,100,50,0.01,604,20
0.626,0.0001,334,370,100,50,0.01,704,20
0.668,0.0001,387,417,100,50,0.01,804,20
0.73,0.0001,432,472,100,50,0.01,904,20
0.782,0.0001,487,517,100,50,0.01,1004,20
0.84,0.0001,540,564,100,50,0.01,1104,20
0.89,0.0001,589,615,100,50,0.01,1204,20
0.896,0.0001,644,660,100,50,0.01,1304,20
0.922,0.0001,694,710,100,50,0.01,1404,20
0.93,0.0001,747,757,100,50,0.01,1504,20
0.948,0.0001,805,799,100,50,0.01,1604,20
0.956,0.0001,852,852,100,50,0.01,1704,20
0.96,0.0001,910,894,100,50,0.01,1804,20
0.962,0.0001,959,945,100,50,0.01,1904,20
0.96,0.0001,1001,1003,100,50,0.01,2004,20
0.486,0.001,52,52,100,50,0.0001,104,1
0.486,0.001,99,105,100,50,0.0001,204,1
0.484,0.001,145,159,100,50,0.0001,304,1
0.49,0.001,199,205,100,50,0.0001,404,1
0.49,0.001,243,261,100,50,0.0001,504,1
0.49,0.001,293,311,100,50,0.0001,604,1
0.49,0.001,350,354,100,50,0.0001,704,1
0.492,0.001,402,402,100,50,0.0001,804,1
0.488,0.001,458,446,100,50,0.0001,904,1
0.486,0.001,507,497,100,50,0.0001,1004,1
0.486,0.001,560,544,100,50,0.0001,1104,1
0.49,0.001,616,588,100,50,0.0001,1204,1
0.492,0.001,670,634,100,50,0.0001,1304,1
0.49,0.001,716,688,100,50,0.0001,1404,1
0.492,0.001,769,735,100,50,0.0001,1504,1
0.492,0.001,821,783,100,50,0.0001,1604,1
0.494,0.001,874,830,100,50,0.0001,1704,1
0.496,0.001,920,884,100,50,0.0001,1804,1
0.498,0.001,966,938,100,50,0.0001,1904,1
0.5,0.001,1009,995,100,50,0.0001,2004,1
0.51,0.001,47,57,100,50,0.0001,104,2
0.512,0.001,101,103,100,50,0.0001,204,2
0.514,0.001,154,150,100,50,0.0001,304,2
0.516,0.001,202,202,100,50,0.0001,404,2
0.516,0.001,253,251,100,50,0.0001,504,2
0.516,0.001,303,301,100,50,0.0001,604,2
0.512,0.001,351,353,100,50,0.0001,704,2
0.512,0.001,405,399,100,50,0.0001,804,2
0.512,0.001,448,456,100,50,0.0001,904,2
0.514,0.001,498,506,100,50,0.0001,1004,2
0.518,0.001,554,550,100,50,0.0001,1104,2
0.52,0.001,606,598,100,50,0.0001,1204,2
0.522,0.001,649,655,100,50,0.0001,1304,2
0.524,0.001,699,705,100,50,0.0001,1404,2
0.53,0.001,745,759,100,50,0.0001,1504,2
0.526,0.001,793,811,100,50,0.0001,1604,2
0.528,0.001,851,853,100,50,0.0001,1704,2
0.53,0.001,895,909,100,50,0.0001,1804,2
0.534,0.001,941,963,100,50,0.0001,1904,2
0.536,0.001,992,1012,100,50,0.0001,2004,2
0.512,0.001,49,55,100,50,0.0001,104,3
0.514,0.001,100,104,100,50,0.0001,204,3
0.51,0.001,151,153,100,50,0.0001,304,3
0.512,0.001,198,206,100,50,0.0001,404,3
0.51,0.001,253,251,100,50,0.0001,504,3
0.504,0.001,306,298,100,50,0.0001,604,3
0.506,0.001,360,344,100,50,0.0001,704,3
0.506,0.001,409,395,100,50,0.0001,804,3
0.51,0.001,456,448,100,50,0.0001,904,3
0.514,0.001,505,499,100,50,0.0001,1004,3
0.508,0.001,555,549,100,50,0.0001,1104,3
0.508,0.001,613,591,100,50,0.0001,1204,3
0.514,0.001,661,643,100,50,0.0001,1304,3
0.514,0.001,709,695,100,50,0.0001,1404,3
0.51,0.001,761,743,100,50,0.0001,1504,3
0.51,0.001,806,798,100,50,0.0001,1604,3
0.518,0.001,851,853,100,50,0.0001,1704,3
0.518,0.001,900,904,100,50,0.0001,1804,3
0.522,0.001,960,944,100,50,0.0001,1904,3
0.528,0.001,1006,998,100,50,0.0001,2004,3
0.538,0.001,47,57,100,50,0.0001,104,4
0.54,0.001,97,107,100,50,0.0001,204,4
0.544,0.001,149,155,100,50,0.0001,304,4
0.548,0.001,200,204,100,50,0.0001,404,4
0.548,0.001,256,248,100,50,0.0001,504,4
0.546,0.001,306,298,100,50,0.0001,604,4
0.546,0.001,354,350,100,50,0.0001,704,4
0.544,0.001,404,400,100,50,0.0001,804,4
0.542,0.001,460,444,100,50,0.0001,904,4
0.546,0.001,514,490,100,50,0.0001,1004,4
0.546,0.001,563,541,100,50,0.0001,1104,4
0.552,0.001,623,581,100,50,0.0001,1204,4
0.552,0.001,670,634,100,50,0.0001,1304,4
0.558,0.001,718,686,100,50,0.0001,1404,4
0.562,0.001,760,744,100,50,0.0001,1504,4
0.564,0.001,809,795,100,50,0.0001,1604,4
0.566,0.001,858,846,100,50,0.0001,1704,4
0.572,0.001,903,901,100,50,0.0001,1804,4
0.574,0.001,961,943,100,50,0.0001,1904,4
0.578,0.001,1002,1002,100,50,0.0001,2004,4
0.5,0.001,63,41,100,50,0.0001,104,5
0.5,0.001,112,92,100,50,0.0001,204,5
0.498,0.001,164,140,100,50,0.0001,304,5
0.498,0.001,212,192,100,50,0.0001,404,5
0.498,0.001,263,241,100,50,0.0001,504,5
0.498,0.001,310,294,100,50,0.0001,604,5
0.504,0.001,358,346,100,50,0.0001,704,5
0.502,0.001,411,393,100,50,0.0001,804,5
0.498,0.001,464,440,100,50,0.0001,904,5
0.496,0.001,513,491,100,50,0.0001,1004,5
0.502,0.001,567,537,100,50,0.0001,1104,5
0.504,0.001,614,590,100,50,0.0001,1204,5
0.506,0.001,667,637,100,50,0.0001,1304,5
0.502,0.001,717,687,100,50,0.0001,1404,5
0.502,0.001,761,743,100,50,0.0001,1504,5
0.502,0.001,807,797,100,50,0.0001,1604,5
0.508,0.001,853,851,100,50,0.0001,1704,5
0.516,0.001,904,900,100,50,0.0001,1804,5
0.51,0.001,952,952,100,50,0.0001,1904,5
0.51,0.001,1011,993,100,50,0.0001,2004,5
0.556,0.001,53,51,100,50,0.0001,104,6
0.554,0.001,118,86,100,50,0.0001,204,6
0.552,0.001,162,142,100,50,0.0001,304,6
0.552,0.001,208,196,100,50,0.0001,404,6
0.552,0.001,253,251,100,50,0.0001,504,6
0.554,0.001,298,306,100,50,0.0001,604,6
0.554,0.001,350,354,100,50,0.0001,704,6
0.554,0.001,398,406,100,50,0.0001,804,6
0.55,0.001,446,458,100,50,0.0001,904,6
0.55,0.001,491,513,100,50,0.0001,1004,6
0.552,0.001,544,560,100,50,0.0001,1104,6
0.556,0.001,588,616,100,50,0.0001,1204,6
0.554,0.001,635,669,100,50,0.0001,1304,6
0.554,0.001,685,719,100,50,0.0001,1404,6
0.562,0.001,740,764,100,50,0.0001,1504,6
0.562,0.001,795,809,100,50,0.0001,1604,6
0.564,0.001,848,856,100,50,0.0001,1704,6
0.57,0.001,894,910,100,50,0.0001,1804,6
0.572,0.001,941,963,100,50,0.0001,1904,6
0.574,0.001,992,1012,100,50,0.0001,2004,6
0.536,0.001,45,59,100,50,0.0001,104,7
0.538,0.001,102,102,100,50,0.0001,204,7
0.538,0.001,150,154,100,50,0.0001,304,7
0.54,0.001,201,203,100,50,0.0001,404,7
0.54,0.001,253,251,100,50,0.0001,504,7
0.54,0.001,310,294,100,50,0.0001,604,7
0.54,0.001,367,337,100,50,0.0001,704,7
0.544,0.001,425,379,100,50,0.0001,804,7
0.544,0.001,477,427,100,50,0.0001,904,7
0.544,0.001,529,475,100,50,0.0001,1004,7
0.546,0.001,578,526,100,50,0.0001,1104,7
0.55,0.001,631,573,100,50,0.0001,1204,7
0.546,0.001,679,625,100,50,0.0001,1304,7
0.548,0.001,731,673,100,50,0.0001,1404,7
0.546,0.001,780,724,100,50,0.0001,1504,7
0.552,0.001,828,776,100,50,0.0001,1604,7
0.552,0.001,879,825,100,50,0.0001,1704,7
0.556,0.001,930,874,100,50,0.0001,1804,7
0.558,0.001,969,935,100,50,0.0001,1904,7
0.562,0.001,1012,992,100,50,0.0001,2004,7
0.446,0.001,56,48,100,50,0.0001,104,8
0.448,0.001,101,103,100,50,0.0001,204,8
0.448,0.001,149,155,100,50,0.0001,304,8
0.456,0.001,202,202,100,50,0.0001,404,8
0.46,0.001,263,241,100,50,0.0001,504,8
0.456,0.001,312,292,100,50,0.0001,604,8
0.458,0.001,362,342,100,50,0.0001,704,8
0.456,0.001,409,395,100,50,0.0001,804,8
0.458,0.001,450,454,100,50,0.0001,904,8
0.462,0.001,497,507,100,50,0.0001,1004,8
0.46,0.001,543,561,100,50,0.0001,1104,8
0.466,0.001,601,603,100,50,0.0001,1204,8
0.464,0.001,650,654,100,50,0.0001,1304,8
0.466,0.001,703,701,100,50,0.0001,1404,8
0.464,0.001,753,751,100,50,0.0001,1504,8
0.468,0.001,806,798,100,50,0.0001,1604,8
0.472,0.001,861,843,100,50,0.0001,1704,8
0.474,0.001,912,892,100,50,0.0001,1804,8
0.48,0.001,955,949,100,50,0.0001,1904,8
0.478,0.001,999,1005,100,50,0.0001,2004,8
0.5,0.001,57,47,100,50,0.0001,104,9
0.5,0.001,109,95,100,50,0.0001,204,9
0.502,0.001,159,145,100,50,0.0001,304,9
0.5,0.001,201,203,100,50,0.0001,404,9
0.5,0.001,253,251,100,50,0.0001,504,9
0.498,0.001,303,301,100,50,0.0001,604,9
0.498,0.001,345,359,100,50,0.0001,704,9
0.502,0.001,394,410,100,50,0.0001,804,9
0.506,0.001,439,465,100,50,0.0001,904,9
0.506,0.001,492,512,100,50,0.0001,1004,9
0.506,0.001,539,565,100,50,0.0001,1104,9
0.51,0.001,594,610,100,50,0.0001,1204,9
0.516,0.001,641,663,100,50,0.0001,1304,9
0.514,0.001,696,708,100,50,0.0001,1404,9
0.518,0.001,742,762,100,50,0.0001,1504,9
0.518,0.001,797,807,100,50,0.0001,1604,9
0.52,0.001,840,864,100,50,0.0001,1704,9
0.524,0.001,890,914,100,50,0.0001,1804,9
0.526,0.001,936,968,100,50,0.0001,1904,9
0.526,0.001,986,1018,100,50,0.0001,2004,9
0.51,0.001,47,57,100,50,0.0001,104,10
0.51,0.001,94,110,100,50,0.0001,204,10
0.512,0.001,144,160,100,50,0.0001,304,10
0.516,0.001,199,205,100,50,0.0001,404,10
0.52,0.001,241,263,100,50,0.0001,504,10
0.52,0.001,298,306,100,50,0.0001,604,10
0.518,0.001,351,353,100,50,0.0001,704,10
0.516,0.001,400,404,100,50,0.0001,804,10
0.514,0.001,449,455,100,50,0.0001,904,10
0.514,0.001,497,507,100,50,0.0001,1004,10
0.514,0.001,548,556,100,50,0.0001,1104,10
0.512,0.001,596,608,100,50,0.0001,1204,10
0.512,0.001,651,653,100,50,0.0001,1304,10
0.512,0.001,703,701,100,50,0.0001,1404,10
0.51,0.001,755,749,100,50,0.0001,1504,10
0.52,0.001,798,806,100,50,0.0001,1604,10
0.52,0.001,850,854,100,50,0.0001,1704,10
0.52,0.001,898,906,100,50,0.0001,1804,10
0.522,0.001,941,963,100,50,0.0001,1904,10
0.522,0.001,990,1014,100,50,0.0001,2004,10
0.5,0.001,50,54,100,50,0.0001,104,11
0.502,0.001,104,100,100,50,0.0001,204,11
0.502,0.001,153,151,100,50,0.0001,304,11
0.504,0.001,200,204,100,50,0.0001,404,11
0.508,0.001,246,258,100,50,0.0001,504,11
0.506,0.001,299,305,100,50,0.0001,604,11
0.506,0.001,349,355,100,50,0.0001,704,11
0.504,0.001,397,407,100,50,0.0001,804,11
0.508,0.001,447,457,100,50,0.0001,904,11
0.512,0.001,501,503,100,50,0.0001,1004,11
0.512,0.001,554,550,100,50,0.0001,1104,11
0.516,0.001,602,602,100,50,0.0001,1204,11
0.516,0.001,653,651,100,50,0.0001,1304,11
0.518,0.001,699,705,100,50,0.0001,1404,11
0.522,0.001,749,755,100,50,0.0001,1504,11
0.528,0.001,804,800,100,50,0.0001,1604,11
0.528,0.001,861,843,100,50,0.0001,1704,11
0.526,0.001,901,903,100,50,0.0001,1804,11
0.52,0.001,952,952,100,50,0.0001,1904,11
0.528,0.001,1003,1001,100,50,0.0001,2004,11
0.444,0.001,44,60,100,50,0.0001,104,12
0.444,0.001,97,107,100,50,0.0001,204,12
0.444,0.001,148,156,100,50,0.0001,304,12
0.444,0.001,198,206,100,50,0.0001,404,12
0.444,0.001,252,252,100,50,0.0001,504,12
0.442,0.001,294,310,100,50,0.0001,604,12
0.444,0.001,335,369,100,50,0.0001,704,12
0.446,0.001,376,428,100,50,0.0001,804,12
0.446,0.001,427,477,100,50,0.0001,904,12
0.446,0.001,478,526,100,50,0.0001,1004,12
0.45,0.001,533,571,100,50,0.0001,1104,12
0.452,0.001,581,623,100,50,0.0001,1204,12
0.452,0.001,635,669,100,50,0.0001,1304,12
0.452,0.001,695,709,100,50,0.0001,1404,12
0.45,0.001,729,775,100,50,0.0001,1504,12
0.456,0.001,779,825,100,50,0.0001,1604,12
0.458,0.001,836,868,100,50,0.0001,1704,12
0.464,0.001,891,913,100,50,0.0001,1804,12
0.466,0.001,940,964,100,50,0.0001,1904,12
0.47,0.001,992,1012,100,50,0.0001,2004,12
0.488,0.001,40,64,100,50,0.0001,104,13
0.488,0.001,89,115,100,50,0.0001,204,13
0.486,0.001,141,163,100,50,0.0001,304,13
0.488,0.001,203,201,100,50,0.0001,404,13
0.488,0.001,257,247,100,50,0.0001,504,13
0.486,0.001,303,301,100,50,0.0001,604,13
0.49,0.001,364,340,100,50,0.0001,704,13
0.494,0.001,410,394,100,50,0.0001,804,13
0.492,0.001,458,446,100,50,0.0001,904,13
0.49,0.001,511,493,100,50,0.0001,1004,13
0.492,0.001,550,554,100,50,0.0001,1104,13
0.496,0.001,602,602,100,50,0.0001,1204,13
0.498,0.001,647,657,100,50,0.0001,1304,13
0.5,0.001,698,706,100,50,0.0001,1404,13
0.504,0.001,743,761,100,50,0.0001,1504,13
0.504,0.001,789,815,100,50,0.0001,1604,13
0.504,0.001,838,866,100,50,0.0001,1704,13
0.5,0.001,890,914,100,50,0.0001,1804,13
0.508,0.001,946,958,100,50,0.0001,1904,13
0.506,0.001,992,1012,100,50,0.0001,2004,13
0.478,0.001,55,49,100,50,0.0001,104,14
0.478,0.001,111,93,100,50,0.0001,204,14
0.478,0.001,159,145,100,50,0.0001,304,14
0.478,0.001,210,194,100,50,0.0001,404,14
0.476,0.001,255,249,100,50,0.0001,504,14
0.476,0.001,307,297,100,50,0.0001,604,14
0.478,0.001,353,351,100,50,0.0001,704,14
0.482,0.001,398,406,100,50,0.0001,804,14
0.486,0.001,448,456,100,50,0.0001,904,14
0.486,0.001,504,500,100,50,0.0001,1004,14
0.488,0.001,566,538,100,50,0.0001,1104,14
0.494,0.001,616,588,100,50,0.0001,1204,14
0.5,0.001,666,638,100,50,0.0001,1304,14
0.498,0.001,709,695,100,50,0.0001,1404,14
0.496,0.001,762,742,100,50,0.0001,1504,14
0.498,0.001,816,788,100,50,0.0001,1604,14
0.508,0.001,874,830,100,50,0.0001,1704,14
0.514,0.001,913,891,100,50,0.0001,1804,14
0.512,0.001,964,940,100,50,0.0001,1904,14
0.508,0.001,1025,979,100,50,0.0001,2004,14
0.534,0.001,48,56,100,50,0.0001,104,15
0.534,0.001,105,99,100,50,0.0001,204,15
0.536,0.001,157,147,100,50,0.0001,304,15
0.536,0.001,206,198,100,50,0.0001,404,15
0.532,0.001,253,251,100,50,0.0001,504,15
0.53,0.001,309,295,100,50,0.0001,604,15
0.53,0.001,354,350,100,50,0.0001,704,15
0.532,0.001,398,406,100,50,0.0001,804,15
0.53,0.001,446,458,100,50,0.0001,904,15
0.538,0.001,503,501,100,50,0.0001,1004,15
0.542,0.001,551,553,100,50,0.0001,1104,15
0.544,0.001,606,598,100,50,0.0001,1204,15
0.544,0.001,656,648,100,50,0.0001,1304,15
0.546,0.001,703,701,100,50,0.0001,1404,15
0.554,0.001,753,751,100,50,0.0001,1504,15
0.554,0.001,801,803,100,50,0.0001,1604,15
0.552,0.001,847,857,100,50,0.0001,1704,15
0.552,0.001,899,905,100,50,0.0001,1804,15
0.552,0.001,945,959,100,50,0.0001,1904,15
0.554,0.001,994,1010,100,50,0.0001,2004,15
0.52,0.001,55,49,100,50,0.0001,104,16
0.524,0.001,108,96,100,50,0.0001,204,16
0.524,0.001,160,144,100,50,0.0001,304,16
0.524,0.001,210,194,100,50,0.0001,404,16
0.522,0.001,263,241,100,50,0.0001,504,16
0.522,0.001,314,290,100,50,0.0001,604,16
0.524,0.001,367,337,100,50,0.0001,704,16
0.53,0.001,422,382,100,50,0.0001,804,16
0.528,0.001,464,440,100,50,0.0001,904,16
0.53,0.001,510,494,100,50,0.0001,1004,16
0.532,0.001,558,546,100,50,0.0001,1104,16
0.53,0.001,609,595,100,50,0.0001,1204,16
0.53,0.001,659,645,100,50,0.0001,1304,16
0.53,0.001,709,695,100,50,0.0001,1404,16
0.534,0.001,756,748,100,50,0.0001,1504,16
0.534,0.001,811,793,100,50,0.0001,1604,16
0.534,0.001,857,847,100,50,0.0001,1704,16
0.536,0.001,900,904,100,50,0.0001,1804,16
0.54,0.001,949,955,100,50,0.0001,1904,16
0.544,0.001,993,1011,100,50,0.0001,2004,16
0.456,0.001,41,63,100,50,0.0001,104,17
0.458,0.001,94,110,100,50,0.0001,204,17
0.46,0.001,136,168,100,50,0.0001,304,17
0.458,0.001,189,215,100,50,0.0001,404,17
0.458,0.001,238,266,100,50,0.0001,504,17
0.462,0.001,285,319,100,50,0.0001,604,17
0.466,0.001,332,372,100,50,0.0001,704,17
0.466,0.001,385,419,100,50,0.0001,804,17
0.468,0.001,432,472,100,50,0.0001,904,17
0.47,0.001,478,526,100,50,0.0001,1004,17
0.474,0.001,525,579,100,50,0.0001,1104,17
0.476,0.001,569,635,100,50,0.0001,1204,17
0.474,0.001,621,683,100,50,0.0001,1304,17
0.482,0.001,661,743,100,50,0.0001,1404,17
0.482,0.001,722,782,100,50,0.0001,1504,17
0.488,0.001,778,826,100,50,0.0001,1604,17
0.484,0.001,832,872,100,50,0.0001,1704,17
0.486,0.001,888,916,100,50,0.0001,1804,17
0.486,0.001,940,964,100,50,0.0001,1904,17
0.492,0.001,982,1022,100,50,0.0001,2004,17
0.524,0.001,50,54,100,50,0.0001,104,18
0.524,0.001,99,105,100,50,0.0001,204,18
0.524,0.001,154,150,100,50,0.0001,304,18
0.524,0.001,197,207,100,50,0.0001,404,18
0.524,0.001,249,255,100,50,0.0001,504,18
0.524,0.001,290,314,100,50,0.0001,604,18
0.526,0.001,340,364,100,50,0.0001,704,18
0.526,0.001,388,416,100,50,0.0001,804,18
0.526,0.001,432,472,100,50,0.0001,904,18
0.526,0.001,490,514,100,50,0.0001,1004,18
0.528,0.001,543,561,100,50,0.0001,1104,18
0.532,0.001,593,611,100,50,0.0001,1204,18
0.532,0.001,640,664,100,50,0.0001,1304,18
0.534,0.001,692,712,100,50,0.0001,1404,18
0.534,0.001,745,759,100,50,0.0001,1504,18
0.536,0.001,794,810,100,50,0.0001,1604,18
0.536,0.001,853,851,100,50,0.0001,1704,18
0.534,0.001,897,907,100,50,0.0001,1804,18
0.534,0.001,961,943,100,50,0.0001,1904,18
0.542,0.001,1016,988,100,50,0.0001,2004,18
0.516,0.001,50,54,100,50,0.0001,104,19
0.516,0.001,99,105,100,50,0.0001,204,19
0.516,0.001,152,152,100,50,0.0001,304,19
0.516,0.001,203,201,100,50,0.0001,404,19
0.516,0.001,257,247,100,50,0.0001,504,19
0.518,0.001,311,293,100,50,0.0001,604,19
0.518,0.001,358,346,100,50,0.0001,704,19
0.518,0.001,416,388,100,50,0.0001,804,19
0.516,0.001,464,440,100,50,0.0001,904,19
0.516,0.001,508,496,100,50,0.0001,1004,19
0.518,0.001,559,545,100,50,0.0001,1104,19
0.52,0.001,615,589,100,50,0.0001,1204,19
0.52,0.001,662,642,100,50,0.0001,1304,19
0.52,0.001,711,693,100,50,0.0001,1404,19
0.522,0.001,757,747,100,50,0.0001,1504,19
0.52,0.001,813,791,100,50,0.0001,1604,19
0.522,0.001,867,837,100,50,0.0001,1704,19
0.52,0.001,918,886,100,50,0.0001,1804,19
0.518,0.001,971,933,100,50,0.0001,1904,19
0.518,0.001,1014,990,100,50,0.0001,2004,19
0.48,0.001,44,60,100,50,0.0001,104,20
0.48,0.001,98,106,100,50,0.0001,204,20
0.482,0.001,155,149,100,50,0.0001,304,20
0.484,0.001,203,201,100,50,0.0001,404,20
0.49,0.001,254,250,100,50,0.0001,504,20
0.496,0.001,305,299,100,50,0.0001,604,20
0.496,0.001,357,347,100,50,0.0001,704,20
0.498,0.001,416,388,100,50,0.0001,804,20
0.498,0.001,461,443,100,50,0.0001,904,20
0.498,0.001,507,497,100,50,0.0001,1004,20
0.498,0.001,556,548,100,50,0.0001,1104,20
0.506,0.001,603,601,100,50,0.0001,1204,20
0.51,0.001,662,642,100,50,0.0001,1304,20
0.51,0.001,712,692,100,50,0.0001,1404,20
0.514,0.001,769,735,100,50,0.0001,1504,20
0.518,0.001,815,789,100,50,0.0001,1604,20
0.522,0.001,860,844,100,50,0.0001,1704,20
0.522,0.001,909,895,100,50,0.0001,1804,20
0.53,0.001,949,955,100,50,0.0001,1904,20
0.536,0.001,999,1005,100,50,0.0001,2004,20
0.478,0.001,50,54,100,50,0.001,104,1
0.494,0.001,103,101,100,50,0.001,204,1
0.492,0.001,147,157,100,50,0.001,304,1
0.508,0.001,195,209,100,50,0.001,404,1
0.512,0.001,252,252,100,50,0.001,504,1
0.526,0.001,302,302,100,50,0.001,604,1
0.528,0.001,351,353,100,50,0.001,704,1
0.542,0.001,408,396,100,50,0.001,804,1
0.566,0.001,455,449,100,50,0.001,904,1
0.572,0.001,502,502,100,50,0.001,1004,1
0.584,0.001,557,547,100,50,0.001,1104,1
0.604,0.001,607,597,100,50,0.001,1204,1
0.618,0.001,650,654,100,50,0.001,1304,1
0.636,0.001,692,712,100,50,0.001,1404,1
0.662,0.001,741,763,100,50,0.001,1504,1
0.67,0.001,787,817,100,50,0.001,1604,1
0.686,0.001,833,871,100,50,0.001,1704,1
0.708,0.001,887,917,100,50,0.001,1804,1
0.74,0.001,934,970,100,50,0.001,1904,1
0.778,0.001,991,1013,100,50,0.001,2004,1
0.486,0.001,48,56,100,50,0.001,104,2
0.496,0.001,94,110,100,50,0.001,204,2
0.492,0.001,143,161,100,50,0.001,304,2
0.498,0.001,195,209,100,50,0.001,404,2
0.508,0.001,246,258,100,50,0.001,504,2
0.514,0.001,297,307,100,50,0.001,604,2
0.52,0.001,344,360,100,50,0.001,704,2
0.53,0.001,394,410,100,50,0.001,804,2
0.53,0.001,448,456,100,50,0.001,904,2
0.53,0.001,497,507,100,50,0.001,1004,2
0.558,0.001,543,561,100,50,0.001,1104,2
0.558,0.001,584,620,100,50,0.001,1204,2
0.568,0.001,633,671,100,50,0.001,1304,2
0.584,0.001,678,726,100,50,0.001,1404,2
0.588,0.001,735,769,100,50,0.001,1504,2
0.608,0.001,786,818,100,50,0.001,1604,2
0.634,0.001,846,858,100,50,0.001,1704,2
0.648,0.001,889,915,100,50,0.001,1804,2
0.66,0.001,939,965,100,50,0.001,1904,2
0.696,0.001,986,1018,100,50,0.001,2004,2
0.512,0.001,55,49,100,50,0.001,104,3
0.506,0.001,105,99,100,50,0.001,204,3
0.532,0.001,162,142,100,50,0.001,304,3
0.516,0.001,208,196,100,50,0.001,404,3
0.512,0.001,264,240,100,50,0.001,504,3
0.51,0.001,315,289,100,50,0.001,604,3
0.514,0.001,381,323,100,50,0.001,704,3
0.528,0.001,420,384,100,50,0.001,804,3
0.532,0.001,466,438,100,50,0.001,904,3
0.54,0.001,528,476,100,50,0.001,1004,3
0.546,0.001,568,536,100,50,0.001,1104,3
0.566,0.001,622,582,100,50,0.001,1204,3
0.564,0.001,669,635,100,50,0.001,1304,3
0.578,0.001,719,685,100,50,0.001,1404,3
0.606,0.001,766,738,100,50,0.001,1504,3
0.63,0.001,809,795,100,50,0.001,1604,3
0.654,0.001,863,841,100,50,0.001,1704,3
0.684,0.001,916,888,100,50,0.001,1804,3
0.71,0.001,969,935,100,50,0.001,1904,3
0.74,0.001,1015,989,100,50,0.001,2004,3
0.53,0.001,41,63,100,50,0.001,104,4
0.538,0.001,93,111,100,50,0.001,204,4
0.53,0.001,144,160,100,50,0.001,304,4
0.538,0.001,198,206,100,50,0.001,404,4
0.534,0.001,247,257,100,50,0.001,504,4
0.534,0.001,297,307,100,50,0.001,604,4
0.546,0.001,339,365,100,50,0.001,704,4
0.542,0.001,384,420,100,50,0.001,804,4
0.544,0.001,440,464,100,50,0.001,904,4
0.56,0.001,490,514,100,50,0.001,1004,4
0.578,0.001,540,564,100,50,0.001,1104,4
0.578,0.001,587,617,100,50,0.001,1204,4
0.596,0.001,639,665,100,50,0.001,1304,4
0.62,0.001,689,715,100,50,0.001,1404,4
0.648,0.001,747,757,100,50,0.001,1504,4
0.658,0.001,803,801,100,50,0.001,1604,4
0.68,0.001,851,853,100,50,0.001,1704,4
0.698,0.001,899,905,100,50,0.001,1804,4
0.728,0.001,949,955,100,50,0.001,1904,4
0.752,0.001,1000,1004,100,50,0.001,2004,4
0.526,0.001,54,50,100,50,0.001,104,5
0.532,0.001,99,105,100,50,0.001,204,5
0.528,0.001,152,152,100,50,0.001,304,5
0.526,0.001,203,201,100,50,0.001,404,5
0.536,0.001,252,252,100,50,0.001,504,5
0.536,0.001,307,297,100,50,0.001,604,5
0.534,0.001,360,344,100,50,0.001,704,5
0.516,0.001,407,397,100,50,0.001,804,5
0.526,0.001,454,450,100,50,0.001,904,5
0.528,0.001,509,495,100,50,0.001,1004,5
0.532,0.001,562,542,100,50,0.001,1104,5
0.524,0.001,607,597,100,50,0.001,1204,5
0.542,0.001,653,651,100,50,0.001,1304,5
0.554,0.001,704,700,100,50,0.001,1404,5
0.542,0.001,762,742,100,50,0.001,1504,5
0.552,0.001,814,790,100,50,0.001,1604,5
0.59,0.001,859,845,100,50,0.001,1704,5
0.604,0.001,916,888,100,50,0.001,1804,5
0.624,0.001,963,941,100,50,0.001,1904,5
0.648,0.001,1009,995,100,50,0.001,2004,5
0.496,0.001,51,53,100,50,0.001,104,6
0.5,0.001,107,97,100,50,0.001,204,6
0.5,0.001,153,151,100,50,0.001,304,6
0.51,0.001,204,200,100,50,0.001,404,6
0.534,0.001,253,251,100,50,0.001,504,6
0.53,0.001,302,302,100,50,0.001,604,6
0.54,0.001,352,352,100,50,0.001,704,6
0.538,0.001,404,400,100,50,0.001,804,6
0.554,0.001,452,452,100,50,0.001,904,6
0.56,0.001,501,503,100,50,0.001,1004,6
0.562,0.001,550,554,100,50,0.001,1104,6
0.568,0.001,599,605,100,50,0.001,1204,6
0.59,0.001,648,656,100,50,0.001,1304,6
0.622,0.001,700,704,100,50,0.001,1404,6
0.634,0.001,747,757,100,50,0.001,1504,6
0.646,0.001,793,811,100,50,0.001,1604,6
0.676,0.001,851,853,100,50,0.001,1704,6
0.692,0.001,896,908,100,50,0.001,1804,6
0.72,0.001,953,951,100,50,0.001,1904,6
0.748,0.001,998,1006,100,50,0.001,2004,6
0.516,0.001,48,56,100,50,0.001,104,7
0.514,0.001,102,102,100,50,0.001,204,7
0.512,0.001,154,150,100,50,0.001,304,7
0.508,0.001,208,196,100,50,0.001,404,7
0.514,0.001,253,251,100,50,0.001,504,7
0.506,0.001,308,296,100,50,0.001,604,7
0.506,0.001,357,347,100,50,0.001,704,7
0.504,0.001,407,397,100,50,0.001,804,7
0.524,0.001,458,446,100,50,0.001,904,7
0.536,0.001,512,492,100,50,0.001,1004,7
0.544,0.001,571,533,100,50,0.001,1104,7
0.548,0.001,620,584,100,50,0.001,1204,7
0.56,0.001,667,637,100,50,0.001,1304,7
0.58,0.001,715,689,100,50,0.001,1404,7
0.592,0.001,763,741,100,50,0.001,1504,7
0.624,0.001,809,795,100,50,0.001,1604,7
0.65,0.001,855,849,100,50,0.001,1704,7
0.662,0.001,908,896,100,50,0.001,1804,7
0.686,0.001,951,953,100,50,0.001,1904,7
0.72,0.001,999,1005,100,50,0.001,2004,7
0.474,0.001,47,57,100,50,0.001,104,8
0.48,0.001,94,110,100,50,0.001,204,8
0.494,0.001,143,161,100,50,0.001,304,8
0.502,0.001,190,214,100,50,0.001,404,8
0.512,0.001,247,257,100,50,0.001,504,8
0.52,0.001,298,306,100,50,0.001,604,8
0.528,0.001,347,357,100,50,0.001,704,8
0.54,0.001,400,404,100,50,0.001,804,8
0.55,0.001,455,449,100,50,0.001,904,8
0.568,0.001,500,504,100,50,0.001,1004,8
0.58,0.001,554,550,100,50,0.001,1104,8
0.588,0.001,597,607,100,50,0.001,1204,8
0.616,0.001,641,663,100,50,0.001,1304,8
0.626,0.001,701,703,100,50,0.001,1404,8
0.66,0.001,753,751,100,50,0.001,1504,8
0.686,0.001,803,801,100,50,0.001,1604,8
0.698,0.001,857,847,100,50,0.001,1704,8
0.72,0.001,898,906,100,50,0.001,1804,8
0.762,0.001,950,954,100,50,0.001,1904,8
0.788,0.001,1000,1004,100,50,0.001,2004,8
0.478,0.001,56,48,100,50,0.001,104,9
0.492,0.001,120,84,100,50,0.001,204,9
0.502,0.001,169,135,100,50,0.001,304,9
0.508,0.001,214,190,100,50,0.001,404,9
0.52,0.001,267,237,100,50,0.001,504,9
0.518,0.001,317,287,100,50,0.001,604,9
0.512,0.001,360,344,100,50,0.001,704,9
0.526,0.001,410,394,100,50,0.001,804,9
0.546,0.001,457,447,100,50,0.001,904,9
0.572,0.001,514,490,100,50,0.001,1004,9
0.59,0.001,561,543,100,50,0.001,1104,9
0.608,0.001,603,601,100,50,0.001,1204,9
0.616,0.001,652,652,100,50,0.001,1304,9
0.628,0.001,702,702,100,50,0.001,1404,9
0.648,0.001,753,751,100,50,0.001,1504,9
0.67,0.001,808,796,100,50,0.001,1604,9
0.682,0.001,860,844,100,50,0.001,1704,9
0.712,0.001,910,894,100,50,0.001,1804,9
0.72,0.001,960,944,100,50,0.001,1904,9
0.752,0.001,1001,1003,100,50,0.001,2004,9
0.514,0.001,54,50,100,50,0.001,104,10
0.528,0.001,104,100,100,50,0.001,204,10
0.526,0.001,153,151,100,50,0.001,304,10
0.524,0.001,203,201,100,50,0.001,404,10
0.53,0.001,254,250,100,50,0.001,504,10
0.536,0.001,304,300,100,50,0.001,604,10
0.544,0.001,353,351,100,50,0.001,704,10
0.554,0.001,409,395,100,50,0.001,804,10
0.57,0.001,459,445,100,50,0.001,904,10
0.584,0.001,511,493,100,50,0.001,1004,10
0.6,0.001,559,545,100,50,0.001,1104,10
0.604,0.001,603,601,100,50,0.001,1204,10
0.602,0.001,655,649,100,50,0.001,1304,10
0.606,0.001,711,693,100,50,0.001,1404,10
0.612,0.001,753,751,100,50,0.001,1504,10
0.634,0.001,807,797,100,50,0.001,1604,10
0.664,0.001,861,843,100,50,0.001,1704,10
0.684,0.001,907,897,100,50,0.001,1804,10
0.706,0.001,951,953,100,50,0.001,1904,10
0.73,0.001,996,1008,100,50,0.001,2004,10
0.518,0.001,47,57,100,50,0.001,104,11
0.522,0.001,103,101,100,50,0.001,204,11
0.526,0.001,155,149,100,50,0.001,304,11
0.532,0.001,202,202,100,50,0.001,404,11
0.536,0.001,242,262,100,50,0.001,504,11
0.54,0.001,293,311,100,50,0.001,604,11
0.556,0.001,340,364,100,50,0.001,704,11
0.578,0.001,390,414,100,50,0.001,804,11
0.594,0.001,435,469,100,50,0.001,904,11
0.588,0.001,488,516,100,50,0.001,1004,11
0.602,0.001,541,563,100,50,0.001,1104,11
0.612,0.001,591,613,100,50,0.001,1204,11
0.624,0.001,637,667,100,50,0.001,1304,11
0.634,0.001,684,720,100,50,0.001,1404,11
0.644,0.001,732,772,100,50,0.001,1504,11
0.668,0.001,776,828,100,50,0.001,1604,11
0.688,0.001,829,875,100,50,0.001,1704,11
0.716,0.001,881,923,100,50,0.001,1804,11
0.746,0.001,934,970,100,50,0.001,1904,11
0.768,0.001,992,1012,100,50,0.001,2004,11
0.462,0.001,56,48,100,50,0.001,104,12
0.462,0.001,98,106,100,50,0.001,204,12
0.462,0.001,150,154,100,50,0.001,304,12
0.458,0.001,198,206,100,50,0.001,404,12
0.456,0.001,245,259,100,50,0.001,504,12
0.458,0.001,298,306,100,50,0.001,604,12
0.46,0.001,345,359,100,50,0.001,704,12
0.47,0.001,383,421,100,50,0.001,804,12
0.482,0.001,430,474,100,50,0.001,904,12
0.492,0.001,488,516,100,50,0.001,1004,12
0.502,0.001,537,567,100,50,0.001,1104,12
0.506,0.001,591,613,100,50,0.001,1204,12
0.506,0.001,636,668,100,50,0.001,1304,12
0.53,0.001,685,719,100,50,0.001,1404,12
0.536,0.001,729,775,100,50,0.001,1504,12
0.562,0.001,782,822,100,50,0.001,1604,12
0.566,0.001,831,873,100,50,0.001,1704,12
0.588,0.001,879,925,100,50,0.001,1804,12
0.63,0.001,932,972,100,50,0.001,1904,12
0.652,0.001,982,1022,100,50,0.001,2004,12
0.472,0.001,51,53,100,50,0.001,104,13
0.482,0.001,102,102,100,50,0.001,204,13
0.484,0.001,150,154,100,50,0.001,304,13
0.496,0.001,201,203,100,50,0.001,404,13
0.494,0.001,245,259,100,50,0.001,504,13
0.504,0.001,294,310,100,50,0.001,604,13
0.508,0.001,345,359,100,50,0.001,704,13
0.526,0.001,399,405,100,50,0.001,804,13
0.538,0.001,452,452,100,50,0.001,904,13
0.544,0.001,505,499,100,50,0.001,1004,13
0.556,0.001,556,548,100,50,0.001,1104,13
0.582,0.001,610,594,100,50,0.001,1204,13
0.586,0.001,659,645,100,50,0.001,1304,13
0.588,0.001,703,701,100,50,0.001,1404,13
0.604,0.001,746,758,100,50,0.001,1504,13
0.628,0.001,793,811,100,50,0.001,1604,13
0.642,0.001,846,858,100,50,0.001,1704,13
0.666,0.001,895,909,100,50,0.001,1804,13
0.696,0.001,940,964,100,50,0.001,1904,13
0.732,0.001,998,1006,100,50,0.001,2004,13
0.492,0.001,55,49,100,50,0.001,104,14
0.486,0.001,114,90,100,50,0.001,204,14
0.492,0.001,173,131,100,50,0.001,304,14
0.498,0.001,224,180,100,50,0.001,404,14
0.51,0.001,268,236,100,50,0.001,504,14
0.518,0.001,310,294,100,50,0.001,604,14
0.522,0.001,359,345,100,50,0.001,704,14
0.536,0.001,408,396,100,50,0.001,804,14
0.536,0.001,456,448,100,50,0.001,904,14
0.554,0.001,502,502,100,50,0.001,1004,14
0.566,0.001,549,555,100,50,0.001,1104,14
0.6,0.001,600,604,100,50,0.001,1204,14
0.64,0.001,652,652,100,50,0.001,1304,14
0.646,0.001,703,701,100,50,0.001,1404,14
0.668,0.001,756,748,100,50,0.001,1504,14
0.7,0.001,803,801,100,50,0.001,1604,14
0.718,0.001,851,853,100,50,0.001,1704,14
0.734,0.001,898,906,100,50,0.001,1804,14
0.744,0.001,954,950,100,50,0.001,1904,14
0.758,0.001,1011,993,100,50,0.001,2004,14
0.486,0.001,51,53,100,50,0.001,104,15
0.5,0.001,108,96,100,50,0.001,204,15
0.5,0.001,161,143,100,50,0.001,304,15
0.498,0.001,205,199,100,50,0.001,404,15
0.502,0.001,255,249,100,50,0.001,504,15
0.514,0.001,295,309,100,50,0.001,604,15
0.518,0.001,343,361,100,50,0.001,704,15
0.522,0.001,388,416,100,50,0.001,804,15
0.524,0.001,438,466,100,50,0.001,904,15
0.534,0.001,494,510,100,50,0.001,1004,15
0.544,0.001,548,556,100,50,0.001,1104,15
0.576,0.001,591,613,100,50,0.001,1204,15
0.596,0.001,647,657,100,50,0.001,1304,15
0.622,0.001,695,709,100,50,0.001,1404,15
0.644,0.001,742,762,100,50,0.001,1504,15
0.686,0.001,795,809,100,50,0.001,1604,15
0.704,0.001,845,859,100,50,0.001,1704,15
0.712,0.001,891,913,100,50,0.001,1804,15
0.746,0.001,933,971,100,50,0.001,1904,15
0.77,0.001,981,1023,100,50,0.001,2004,15
0.498,0.001,54,50,100,50,0.001,104,16
0.492,0.001,104,100,100,50,0.001,204,16
0.5,0.001,151,153,100,50,0.001,304,16
0.494,0.001,202,202,100,50,0.001,404,16
0.496,0.001,246,258,100,50,0.001,504,16
0.498,0.001,295,309,100,50,0.001,604,16
0.51,0.001,352,352,100,50,0.001,704,16
0.526,0.001,399,405,100,50,0.001,804,16
0.532,0.001,453,451,100,50,0.001,904,16
0.534,0.001,513,491,100,50,0.001,1004,16
0.58,0.001,564,540,100,50,0.001,1104,16
0.612,0.001,615,589,100,50,0.001,1204,16
0.614,0.001,660,644,100,50,0.001,1304,16
0.642,0.001,719,685,100,50,0.001,1404,16
0.67,0.001,780,724,100,50,0.001,1504,16
0.692,0.001,828,776,100,50,0.001,1604,16
0.708,0.001,879,825,100,50,0.001,1704,16
0.732,0.001,921,883,100,50,0.001,1804,16
0.756,0.001,957,947,100,50,0.001,1904,16
0.774,0.001,1007,997,100,50,0.001,2004,16
0.536,0.001,53,51,100,50,0.001,104,17
0.536,0.001,104,100,100,50,0.001,204,17
0.542,0.001,155,149,100,50,0.001,304,17
0.542,0.001,215,189,100,50,0.001,404,17
0.546,0.001,273,231,100,50,0.001,504,17
0.554,0.001,320,284,100,50,0.001,604,17
0.562,0.001,364,340,100,50,0.001,704,17
0.558,0.001,412,392,100,50,0.001,804,17
0.576,0.001,465,439,100,50,0.001,904,17
0.586,0.001,520,484,100,50,0.001,1004,17
0.59,0.001,571,533,100,50,0.001,1104,17
0.612,0.001,619,585,100,50,0.001,1204,17
0.628,0.001,661,643,100,50,0.001,1304,17
0.646,0.001,711,693,100,50,0.001,1404,17
0.65,0.001,755,749,100,50,0.001,1504,17
0.672,0.001,799,805,100,50,0.001,1604,17
0.698,0.001,846,858,100,50,0.001,1704,17
0.718,0.001,897,907,100,50,0.001,1804,17
0.728,0.001,941,963,100,50,0.001,1904,17
0.754,0.001,994,1010,100,50,0.001,2004,17
0.504,0.001,55,49,100,50,0.001,104,18
0.506,0.001,108,96,100,50,0.001,204,18
0.504,0.001,161,143,100,50,0.001,304,18
0.512,0.001,209,195,100,50,0.001,404,18
0.52,0.001,252,252,100,50,0.001,504,18
0.532,0.001,306,298,100,50,0.001,604,18
0.538,0.001,346,358,100,50,0.001,704,18
0.542,0.001,398,406,100,50,0.001,804,18
0.558,0.001,461,443,100,50,0.001,904,18
0.586,0.001,509,495,100,50,0.001,1004,18
0.606,0.001,566,538,100,50,0.001,1104,18
0.628,0.001,623,581,100,50,0.001,1204,18
0.63,0.001,671,633,100,50,0.001,1304,18
0.64,0.001,724,680,100,50,0.001,1404,18
0.662,0.001,764,740,100,50,0.001,1504,18
0.682,0.001,812,792,100,50,0.001,1604,18
0.706,0.001,855,849,100,50,0.001,1704,18
0.734,0.001,907,897,100,50,0.001,1804,18
0.764,0.001,954,950,100,50,0.001,1904,18
0.786,0.001,999,1005,100,50,0.001,2004,18
0.488,0.001,51,53,100,50,0.001,104,19
0.494,0.001,104,100,100,50,0.001,204,19
0.496,0.001,156,148,100,50,0.001,304,19
0.524,0.001,207,197,100,50,0.001,404,19
0.532,0.001,253,251,100,50,0.001,504,19
0.548,0.001,300,304,100,50,0.001,604,19
0.568,0.001,350,354,100,50,0.001,704,19
0.568,0.001,401,403,100,50,0.001,804,19
0.568,0.001,450,454,100,50,0.001,904,19
0.586,0.001,503,501,100,50,0.001,1004,19
0.59,0.001,554,550,100,50,0.001,1104,19
0.6,0.001,597,607,100,50,0.001,1204,19
0.61,0.001,646,658,100,50,0.001,1304,19
0.622,0.001,698,706,100,50,0.001,1404,19
0.642,0.001,741,763,100,50,0.001,1504,19
0.658,0.001,800,804,100,50,0.001,1604,19
0.67,0.001,844,860,100,50,0.001,1704,19
0.688,0.001,893,911,100,50,0.001,1804,19
0.7,0.001,940,964,100,50,0.001,1904,19
0.724,0.001,991,1013,100,50,0.001,2004,19
0.524,0.001,47,57,100,50,0.001,104,20
0.526,0.001,100,104,100,50,0.001,204,20
0.526,0.001,154,150,100,50,0.001,304,20
0.524,0.001,205,199,100,50,0.001,404,20
0.522,0.001,249,255,100,50,0.001,504,20
0.528,0.001,297,307,100,50,0.001,604,20
0.524,0.001,344,360,100,50,0.001,704,20
0.53,0.001,400,404,100,50,0.001,804,20
0.534,0.001,460,444,100,50,0.001,904,20
0.53,0.001,505,499,100,50,0.001,1004,20
0.538,0.001,551,553,100,50,0.001,1104,20
0.542,0.001,607,597,100,50,0.001,1204,20
0.552,0.001,664,640,100,50,0.001,1304,20
0.588,0.001,717,687,100,50,0.001,1404,20
0.584,0.001,763,741,100,50,0.001,1504,20
0.618,0.001,819,785,100,50,0.001,1604,20
0.618,0.001,859,845,100,50,0.001,1704,20
0.664,0.001,908,896,100,50,0.001,1804,20
0.684,0.001,964,940,100,50,0.001,1904,20
0.708,0.001,1009,995,100,50,0.001,2004,20
0.522,0.001,54,50,100,50,0.01,104,1
0.578,0.001,106,98,100,50,0.01,204,1
0.586,0.001,162,142,100,50,0.01,304,1
0.59,0.001,215,189,100,50,0.01,404,1
0.618,0.001,259,245,100,50,0.01,504,1
0.64,0.001,308,296,100,50,0.01,604,1
0.67,0.001,358,346,100,50,0.01,704,1
0.696,0.001,413,391,100,50,0.01,804,1
0.714,0.001,459,445,100,50,0.01,904,1
0.76,0.001,512,492,100,50,0.01,1004,1
0.802,0.001,559,545,100,50,0.01,1104,1
0.864,0.001,608,596,100,50,0.01,1204,1
0.884,0.001,658,646,100,50,0.01,1304,1
0.902,0.001,708,696,100,50,0.01,1404,1
0.908,0.001,753,751,100,50,0.01,1504,1
0.928,0.001,802,802,100,50,0.01,1604,1
0.946,0.001,860,844,100,50,0.01,1704,1
0.95,0.001,912,892,100,50,0.01,1804,1
0.946,0.001,961,943,100,50,0.01,1904,1
0.956,0.001,1004,1000,100,50,0.01,2004,1
0.536,0.001,53,51,100,50,0.01,104,2
0.562,0.001,109,95,100,50,0.01,204,2
0.574,0.001,164,140,100,50,0.01,304,2
0.584,0.001,210,194,100,50,0.01,404,2
0.606,0.001,255,249,100,50,0.01,504,2
0.638,0.001,302,302,100,50,0.01,604,2
0.65,0.001,345,359,100,50,0.01,704,2
0.684,0.001,399,405,100,50,0.01,804,2
0.722,0.001,448,456,100,50,0.01,904,2
0.776,0.001,507,497,100,50,0.01,1004,2
0.818,0.001,552,552,100,50,0.01,1104,2
0.872,0.001,593,611,100,50,0.01,1204,2
0.896,0.001,652,652,100,50,0.01,1304,2
0.922,0.001,712,692,100,50,0.01,1404,2
0.926,0.001,760,744,100,50,0.01,1504,2
0.94,0.001,811,793,100,50,0.01,1604,2
0.942,0.001,859,845,100,50,0.01,1704,2
0.948,0.001,904,900,100,50,0.01,1804,2
0.952,0.001,958,946,100,50,0.01,1904,2
0.954,0.001,1004,1000,100,50,0.01,2004,2
0.586,0.001,51,53,100,50,0.01,104,3
0.578,0.001,106,98,100,50,0.01,204,3
0.596,0.001,165,139,100,50,0.01,304,3
0.624,0.001,212,192,100,50,0.01,404,3
0.632,0.001,257,247,100,50,0.01,504,3
0.674,0.001,305,299,100,50,0.01,604,3
0.682,0.001,354,350,100,50,0.01,704,3
0.738,0.001,412,392,100,50,0.01,804,3
0.75,0.001,464,440,100,50,0.01,904,3
0.768,0.001,512,492,100,50,0.01,1004,3
0.79,0.001,568,536,100,50,0.01,1104,3
0.826,0.001,621,583,100,50,0.01,1204,3
0.868,0.001,670,634,100,50,0.01,1304,3
0.904,0.001,714,690,100,50,0.01,1404,3
0.918,0.001,758,746,100,50,0.01,1504,3
0.926,0.001,806,798,100,50,0.01,1604,3
0.934,0.001,862,842,100,50,0.01,1704,3
0.936,0.001,905,899,100,50,0.01,1804,3
0.94,0.001,963,941,100,50,0.01,1904,3
0.94,0.001,1010,994,100,50,0.01,2004,3
0.504,0.001,55,49,100,50,0.01,104,4
0.548,0.001,109,95,100,50,0.01,204,4
0.562,0.001,159,145,100,50,0.01,304,4
0.598,0.001,208,196,100,50,0.01,404,4
0.602,0.001,266,238,100,50,0.01,504,4
0.664,0.001,321,283,100,50,0.01,604,4
0.672,0.001,370,334,100,50,0.01,704,4
0.706,0.001,415,389,100,50,0.01,804,4
0.758,0.001,465,439,100,50,0.01,904,4
0.804,0.001,514,490,100,50,0.01,1004,4
0.816,0.001,572,532,100,50,0.01,1104,4
0.872,0.001,620,584,100,50,0.01,1204,4
0.866,0.001,660,644,100,50,0.01,1304,4
0.906,0.001,709,695,100,50,0.01,1404,4
0.918,0.001,757,747,100,50,0.01,1504,4
0.932,0.001,795,809,100,50,0.01,1604,4
0.938,0.001,849,855,100,50,0.01,1704,4
0.946,0.001,903,901,100,50,0.01,1804,4
0.944,0.001,951,953,100,50,0.01,1904,4
0.946,0.001,993,1011,100,50,0.01,2004,4
0.538,0.001,46,58,100,50,0.01,104,5
0.542,0.001,92,112,100,50,0.01,204,5
0.562,0.001,142,162,100,50,0.01,304,5
0.596,0.001,186,218,100,50,0.01,404,5
0.618,0.001,236,268,100,50,0.01,504,5
0.652,0.001,286,318,100,50,0.01,604,5
0.694,0.001,331,373,100,50,0.01,704,5
0.734,0.001,383,421,100,50,0.01,804,5
0.774,0.001,437,467,100,50,0.01,904,5
0.856,0.001,494,510,100,50,0.01,1004,5
0.896,0.001,549,555,100,50,0.01,1104,5
0.914,0.001,594,610,100,50,0.01,1204,5
0.93,0.001,636,668,100,50,0.01,1304,5
0.96,0.001,691,713,100,50,0.01,1404,5
0.964,0.001,745,759,100,50,0.01,1504,5
0.958,0.001,790,814,100,50,0.01,1604,5
0.956,0.001,845,859,100,50,0.01,1704,5
0.966,0.001,892,912,100,50,0.01,1804,5
0.962,0.001,953,951,100,50,0.01,1904,5
0.964,0.001,1004,1000,100,50,0.01,2004,5
0.494,0.001,48,56,100,50,0.01,104,6
0.54,0.001,91,113,100,50,0.01,204,6
0.552,0.001,146,158,100,50,0.01,304,6
0.568,0.001,191,213,100,50,0.01,404,6
0.6,0.001,246,258,100,50,0.01,504,6
0.618,0.001,296,308,100,50,0.01,604,6
0.642,0.001,340,364,100,50,0.01,704,6
0.726,0.001,386,418,100,50,0.01,804,6
0.772,0.001,436,468,100,50,0.01,904,6
0.824,0.001,490,514,100,50,0.01,1004,6
0.862,0.001,545,559,100,50,0.01,1104,6
0.898,0.001,592,612,100,50,0.01,1204,6
0.916,0.001,638,666,100,50,0.01,1304,6
0.924,0.001,686,718,100,50,0.01,1404,6
0.942,0.001,733,771,100,50,0.01,1504,6
0.942,0.001,782,822,100,50,0.01,1604,6
0.948,0.001,831,873,100,50,0.01,1704,6
0.948,0.001,874,930,100,50,0.01,1804,6
0.952,0.001,933,971,100,50,0.01,1904,6
0.954,0.001,984,1020,100,50,0.01,2004,6
0.514,0.001,56,48,100,50,0.01,104,7
0.532,0.001,100,104,100,50,0.01,204,7
0.532,0.001,150,154,100,50,0.01,304,7
0.56,0.001,198,206,100,50,0.01,404,7
0.588,0.001,260,244,100,50,0.01,504,7
0.626,0.001,314,290,100,50,0.01,604,7
0.624,0.001,363,341,100,50,0.01,704,7
0.676,0.001,414,390,100,50,0.01,804,7
0.696,0.001,470,434,100,50,0.01,904,7
0.782,0.001,519,485,100,50,0.01,1004,7
0.834,0.001,571,533,100,50,0.01,1104,7
0.868,0.001,615,589,100,50,0.01,1204,7
0.878,0.001,668,636,100,50,0.01,1304,7
0.92,0.001,714,690,100,50,0.01,1404,7
0.928,0.001,751,753,100,50,0.01,1504,7
0.932,0.001,799,805,100,50,0.01,1604,7
0.934,0.001,845,859,100,50,0.01,1704,7
0.94,0.001,903,901,100,50,0.01,1804,7
0.948,0.001,953,951,100,50,0.01,1904,7
0.95,0.001,996,1008,100,50,0.01,2004,7
0.512,0.001,54,50,100,50,0.01,104,8
0.538,0.001,95,109,100,50,0.01,204,8
0.554,0.001,144,160,100,50,0.01,304,8
0.604,0.001,194,210,100,50,0.01,404,8
0.622,0.001,257,247,100,50,0.01,504,8
0.648,0.001,312,292,100,50,0.01,604,8
0.682,0.001,352,352,100,50,0.01,704,8
0.752,0.001,405,399,100,50,0.01,804,8
0.782,0.001,447,457,100,50,0.01,904,8
0.824,0.001,498,506,100,50,0.01,1004,8
0.86,0.001,547,557,100,50,0.01,1104,8
0.89,0.001,593,611,100,50,0.01,1204,8
0.902,0.001,647,657,100,50,0.01,1304,8
0.924,0.001,704,700,100,50,0.01,1404,8
0.924,0.001,751,753,100,50,0.01,1504,8
0.928,0.001,806,798,100,50,0.01,1604,8
0.93,0.001,854,850,100,50,0.01,1704,8
0.938,0.001,903,901,100,50,0.01,1804,8
0.94,0.001,946,958,100,50,0.01,1904,8
0.932,0.001,991,1013,100,50,0.01,2004,8
0.502,0.001,56,48,100,50,0.01,104,9
0.544,0.001,97,107,100,50,0.01,204,9
0.568,0.001,145,159,100,50,0.01,304,9
0.6,0.001,189,215,100,50,0.01,404,9
0.622,0.001,246,258,100,50,0.01,504,9
0.654,0.001,297,307,100,50,0.01,604,9
0.674,0.001,344,360,100,50,0.01,704,9
0.714,0.001,402,402,100,50,0.01,804,9
0.77,0.001,455,449,100,50,0.01,904,9
0.834,0.001,500,504,100,50,0.01,1004,9
0.888,0.001,548,556,100,50,0.01,1104,9
0.92,0.001,601,603,100,50,0.01,1204,9
0.928,0.001,645,659,100,50,0.01,1304,9
0.95,0.001,690,714,100,50,0.01,1404,9
0.96,0.001,737,767,100,50,0.01,1504,9
0.958,0.001,785,819,100,50,0.01,1604,9
0.952,0.001,837,867,100,50,0.01,1704,9
0.95,0.001,887,917,100,50,0.01,1804,9
0.956,0.001,938,966,100,50,0.01,1904,9
0.966,0.001,990,1014,100,50,0.01,2004,9
0.482,0.001,54,50,100,50,0.01,104,10
0.528,0.001,105,99,100,50,0.01,204,10
0.568,0.001,161,143,100,50,0.01,304,10
0.604,0.001,210,194,100,50,0.01,404,10
0.632,0.001,247,257,100,50,0.01,504,10
0.662,0.001,301,303,100,50,0.01,604,10
0.696,0.001,351,353,100,50,0.01,704,10
0.724,0.001,392,412,100,50,0.01,804,10
0.758,0.001,445,459,100,50,0.01,904,10
0.818,0.001,500,504,100,50,0.01,1004,10
0.852,0.001,554,550,100,50,0.01,1104,10
0.892,0.001,600,604,100,50,0.01,1204,10
0.914,0.001,645,659,100,50,0.01,1304,10
0.934,0.001,696,708,100,50,0.01,1404,10
0.948,0.001,746,758,100,50,0.01,1504,10
0.952,0.001,794,810,100,50,0.01,1604,10
0.956,0.001,850,854,100,50,0.01,1704,10
0.962,0.001,897,907,100,50,0.01,1804,10
0.962,0.001,949,955,100,50,0.01,1904,10
0.966,0.001,1002,1002,100,50,0.01,2004,10
0.548,0.001,57,47,100,50,0.01,104,11
0.574,0.001,106,98,100,50,0.01,204,11
0.57,0.001,157,147,100,50,0.01,304,11
0.566,0.001,206,198,100,50,0.01,404,11
0.592,0.001,257,247,100,50,0.01,504,11
0.624,0.001,306,298,100,50,0.01,604,11
0.64,0.001,349,355,100,50,0.01,704,11
0.68,0.001,403,401,100,50,0.01,804,11
0.72,0.001,453,451,100,50,0.01,904,11
0.794,0.001,500,504,100,50,0.01,1004,11
0.828,0.001,558,546,100,50,0.01,1104,11
0.854,0.001,612,592,100,50,0.01,1204,11
0.896,0.001,657,647,100,50,0.01,1304,11
0.924,0.001,713,691,100,50,0.01,1404,11
0.946,0.001,765,739,100,50,0.01,1504,11
0.96,0.001,819,785,100,50,0.01,1604,11
0.95,0.001,868,836,100,50,0.01,1704,11
0.954,0.001,913,891,100,50,0.01,1804,11
0.956,0.001,962,942,100,50,0.01,1904,11
0.958,0.001,1010,994,100,50,0.01,2004,11
0.488,0.001,48,56,100,50,0.01,104,12
0.504,0.001,95,109,100,50,0.01,204,12
0.508,0.001,146,158,100,50,0.01,304,12
0.532,0.001,191,213,100,50,0.01,404,12
0.572,0.001,233,271,100,50,0.01,504,12
0.586,0.001,275,329,100,50,0.01,604,12
0.61,0.001,327,377,100,50,0.01,704,12
0.676,0.001,371,433,100,50,0.01,804,12
0.694,0.001,417,487,100,50,0.01,904,12
0.744,0.001,465,539,100,50,0.01,1004,12
0.782,0.001,522,582,100,50,0.01,1104,12
0.848,0.001,568,636,100,50,0.01,1204,12
0.874,0.001,622,682,100,50,0.01,1304,12
0.912,0.001,669,735,100,50,0.01,1404,12
0.932,0.001,713,791,100,50,0.01,1504,12
0.94,0.001,758,846,100,50,0.01,1604,12
0.948,0.001,813,891,100,50,0.01,1704,12
0.958,0.001,875,929,100,50,0.01,1804,12
0.958,0.001,923,981,100,50,0.01,1904,12
0.964,0.001,977,1027,100,50,0.01,2004,12
0.488,0.001,51,53,100,50,0.01,104,13
0.506,0.001,107,97,100,50,0.01,204,13
0.524,0.001,162,142,100,50,0.01,304,13
0.536,0.001,211,193,100,50,0.01,404,13
0.556,0.001,255,249,100,50,0.01,504,13
0.548,0.001,303,301,100,50,0.01,604,13
0.586,0.001,359,345,100,50,0.01,704,13
0.636,0.001,412,392,100,50,0.01,804,13
0.672,0.001,456,448,100,50,0.01,904,13
0.732,0.001,510,494,100,50,0.01,1004,13
0.756,0.001,559,545,100,50,0.01,1104,13
0.818,0.001,600,604,100,50,0.01,1204,13
0.846,0.001,647,657,100,50,0.01,1304,13
0.87,0.001,693,711,100,50,0.01,1404,13
0.898,0.001,741,763,100,50,0.01,1504,13
0.932,0.001,788,816,100,50,0.01,1604,13
0.944,0.001,842,862,100,50,0.01,1704,13
0.954,0.001,902,902,100,50,0.01,1804,13
0.952,0.001,957,947,100,50,0.01,1904,13
0.956,0.001,1002,1002,100,50,0.01,2004,13
0.516,0.001,42,62,100,50,0.01,104,14
0.532,0.001,93,111,100,50,0.01,204,14
0.566,0.001,140,164,100,50,0.01,304,14
0.592,0.001,196,208,100,50,0.01,404,14
0.596,0.001,244,260,100,50,0.01,504,14
0.628,0.001,286,318,100,50,0.01,604,14
0.66,0.001,335,369,100,50,0.01,704,14
0.716,0.001,387,417,100,50,0.01,804,14
0.73,0.001,443,461,100,50,0.01,904,14
0.784,0.001,505,499,100,50,0.01,1004,14
0.828,0.001,557,547,100,50,0.01,1104,14
0.86,0.001,597,607,100,50,0.01,1204,14
0.884,0.001,648,656,100,50,0.01,1304,14
0.906,0.001,697,707,100,50,0.01,1404,14
0.922,0.001,749,755,100,50,0.01,1504,14
0.93,0.001,801,803,100,50,0.01,1604,14
0.936,0.001,862,842,100,50,0.01,1704,14
0.942,0.001,911,893,100,50,0.01,1804,14
0.948,0.001,958,946,100,50,0.01,1904,14
0.946,0.001,1011,993,100,50,0.01,2004,14
0.534,0.001,54,50,100,50,0.01,104,15
0.538,0.001,98,106,100,50,0.01,204,15
0.528,0.001,148,156,100,50,0.01,304,15
0.552,0.001,201,203,100,50,0.01,404,15
0.578,0.001,243,261,100,50,0.01,504,15
0.596,0.001,297,307,100,50,0.01,604,15
0.634,0.001,351,353,100,50,0.01,704,15
0.67,0.001,400,404,100,50,0.01,804,15
0.712,0.001,453,451,100,50,0.01,904,15
0.77,0.001,497,507,100,50,0.01,1004,15
0.818,0.001,540,564,100,50,0.01,1104,15
0.882,0.001,591,613,100,50,0.01,1204,15
0.91,0.001,645,659,100,50,0.01,1304,15
0.93,0.001,697,707,100,50,0.01,1404,15
0.932,0.001,742,762,100,50,0.01,1504,15
0.938,0.001,790,814,100,50,0.01,1604,15
0.942,0.001,842,862,100,50,0.01,1704,15
0.954,0.001,896,908,100,50,0.01,1804,15
0.954,0.001,946,958,100,50,0.01,1904,15
0.958,0.001,999,1005,100,50,0.01,2004,15
0.51,0.001,55,49,100,50,0.01,104,16
0.554,0.001,107,97,100,50,0.01,204,16
0.534,0.001,161,143,100,50,0.01,304,16
0.542,0.001,208,196,100,50,0.01,404,16
0.53,0.001,258,246,100,50,0.01,504,16
0.566,0.001,312,292,100,50,0.01,604,16
0.628,0.001,359,345,100,50,0.01,704,16
0.676,0.001,403,401,100,50,0.01,804,16
0.712,0.001,454,450,100,50,0.01,904,16
0.758,0.001,500,504,100,50,0.01,1004,16
0.822,0.001,545,559,100,50,0.01,1104,16
0.844,0.001,604,600,100,50,0.01,1204,16
0.87,0.001,649,655,100,50,0.01,1304,16
0.914,0.001,701,703,100,50,0.01,1404,16
0.922,0.001,746,758,100,50,0.01,1504,16
0.944,0.001,789,815,100,50,0.01,1604,16
0.952,0.001,847,857,100,50,0.01,1704,16
0.954,0.001,896,908,100,50,0.01,1804,16
0.956,0.001,946,958,100,50,0.01,1904,16
0.96,0.001,993,1011,100,50,0.01,2004,16
0.498,0.001,41,63,100,50,0.01,104,17
0.526,0.001,91,113,100,50,0.01,204,17
0.542,0.001,149,155,100,50,0.01,304,17
0.562,0.001,189,215,100,50,0.01,404,17
0.574,0.001,241,263,100,50,0.01,504,17
0.604,0.001,293,311,100,50,0.01,604,17
0.618,0.001,355,349,100,50,0.01,704,17
0.656,0.001,400,404,100,50,0.01,804,17
0.658,0.001,454,450,100,50,0.01,904,17
0.734,0.001,498,506,100,50,0.01,1004,17
0.776,0.001,555,549,100,50,0.01,1104,17
0.834,0.001,600,604,100,50,0.01,1204,17
0.866,0.001,649,655,100,50,0.01,1304,17
0.902,0.001,694,710,100,50,0.01,1404,17
0.93,0.001,745,759,100,50,0.01,1504,17
0.93,0.001,802,802,100,50,0.01,1604,17
0.936,0.001,847,857,100,50,0.01,1704,17
0.942,0.001,895,909,100,50,0.01,1804,17
0.944,0.001,948,956,100,50,0.01,1904,17
0.952,0.001,1006,998,100,50,0.01,2004,17
0.534,0.001,46,58,100,50,0.01,104,18
0.536,0.001,94,110,100,50,0.01,204,18
0.534,0.001,136,168,100,50,0.01,304,18
0.574,0.001,191,213,100,50,0.01,404,18
0.612,0.001,245,259,100,50,0.01,504,18
0.624,0.001,297,307,100,50,0.01,604,18
0.652,0.001,353,351,100,50,0.01,704,18
0.698,0.001,407,397,100,50,0.01,804,18
0.752,0.001,463,441,100,50,0.01,904,18
0.794,0.001,505,499,100,50,0.01,1004,18
0.84,0.001,560,544,100,50,0.01,1104,18
0.866,0.001,607,597,100,50,0.01,1204,18
0.876,0.001,653,651,100,50,0.01,1304,18
0.904,0.001,696,708,100,50,0.01,1404,18
0.918,0.001,747,757,100,50,0.01,1504,18
0.926,0.001,804,800,100,50,0.01,1604,18
0.934,0.001,854,850,100,50,0.01,1704,18
0.942,0.001,902,902,100,50,0.01,1804,18
0.946,0.001,957,947,100,50,0.01,1904,18
0.958,0.001,1005,999,100,50,0.01,2004,18
0.512,0.001,51,53,100,50,0.01,104,19
0.558,0.001,105,99,100,50,0.01,204,19
0.552,0.001,152,152,100,50,0.01,304,19
0.572,0.001,208,196,100,50,0.01,404,19
0.582,0.001,254,250,100,50,0.01,504,19
0.608,0.001,301,303,100,50,0.01,604,19
0.624,0.001,348,356,100,50,0.01,704,19
0.674,0.001,398,406,100,50,0.01,804,19
0.702,0.001,439,465,100,50,0.01,904,19
0.76,0.001,494,510,100,50,0.01,1004,19
0.794,0.001,545,559,100,50,0.01,1104,19
0.836,0.001,596,608,100,50,0.01,1204,19
0.846,0.001,647,657,100,50,0.01,1304,19
0.882,0.001,699,705,100,50,0.01,1404,19
0.906,0.001,754,750,100,50,0.01,1504,19
0.932,0.001,807,797,100,50,0.01,1604,19
0.938,0.001,852,852,100,50,0.01,1704,19
0.938,0.001,905,899,100,50,0.01,1804,19
0.946,0.001,957,947,100,50,0.01,1904,19
0.956,0.001,1010,994,100,50,0.01,2004,19
0.49,0.001,56,48,100,50,0.01,104,20
0.514,0.001,103,101,100,50,0.01,204,20
0.508,0.001,150,154,100,50,0.01,304,20
0.568,0.001,203,201,100,50,0.01,404,20
0.612,0.001,251,253,100,50,0.01,504,20
0.622,0.001,306,298,100,50,0.01,604,20
0.64,0.001,361,343,100,50,0.01,704,20
0.692,0.001,413,391,100,50,0.01,804,20
0.728,0.001,458,446,100,50,0.01,904,20
0.77,0.001,510,494,100,50,0.01,1004,20
0.832,0.001,549,555,100,50,0.01,1104,20
0.868,0.001,598,606,100,50,0.01,1204,20
0.89,0.001,648,656,100,50,0.01,1304,20
0.902,0.001,708,696,100,50,0.01,1404,20
0.932,0.001,759,745,100,50,0.01,1504,20
0.938,0.001,803,801,100,50,0.01,1604,20
0.948,0.001,853,851,100,50,0.01,1704,20
0.948,0.001,903,901,100,50,0.01,1804,20
0.946,0.001,954,950,100,50,0.01,1904,20
0.946,0.001,999,1005,100,50,0.01,2004,20
0.458,1e-05,55,49,100,100,0.0001,104,1
0.46,1e-05,104,100,100,100,0.0001,204,1
0.458,1e-05,157,147,100,100,0.0001,304,1
0.46,1e-05,201,203,100,100,0.0001,404,1
0.46,1e-05,256,248,100,100,0.0001,504,1
0.46,1e-05,303,301,100,100,0.0001,604,1
0.466,1e-05,351,353,100,100,0.0001,704,1
0.464,1e-05,402,402,100,100,0.0001,804,1
0.472,1e-05,457,447,100,100,0.0001,904,1
0.472,1e-05,510,494,100,100,0.0001,1004,1
0.472,1e-05,550,554,100,100,0.0001,1104,1
0.48,1e-05,604,600,100,100,0.0001,1204,1
0.482,1e-05,648,656,100,100,0.0001,1304,1
0.486,1e-05,698,706,100,100,0.0001,1404,1
0.488,1e-05,743,761,100,100,0.0001,1504,1
0.488,1e-05,785,819,100,100,0.0001,1604,1
0.49,1e-05,834,870,100,100,0.0001,1704,1
0.494,1e-05,888,916,100,100,0.0001,1804,1
0.498,1e-05,936,968,100,100,0.0001,1904,1
0.504,1e-05,992,1012,100,100,0.0001,2004,1
0.47,1e-05,49,55,100,100,0.0001,104,2
0.47,1e-05,97,107,100,100,0.0001,204,2
0.474,1e-05,146,158,100,100,0.0001,304,2
0.474,1e-05,204,200,100,100,0.0001,404,2
0.474,1e-05,266,238,100,100,0.0001,504,2
0.48,1e-05,317,287,100,100,0.0001,604,2
0.478,1e-05,370,334,100,100,0.0001,704,2
0.478,1e-05,418,386,100,100,0.0001,804,2
0.484,1e-05,462,442,100,100,0.0001,904,2
0.484,1e-05,514,490,100,100,0.0001,1004,2
0.488,1e-05,562,542,100,100,0.0001,1104,2
0.49,1e-05,614,590,100,100,0.0001,1204,2
0.496,1e-05,669,635,100,100,0.0001,1304,2
0.5,1e-05,721,683,100,100,0.0001,1404,2
0.504,1e-05,775,729,100,100,0.0001,1504,2
0.502,1e-05,831,773,100,100,0.0001,1604,2
0.502,1e-05,879,825,100,100,0.0001,1704,2
0.5,1e-05,921,883,100,100,0.0001,1804,2
0.496,1e-05,963,941,100,100,0.0001,1904,2
0.496,1e-05,1008,996,100,100,0.0001,2004,2
0.512,1e-05,49,55,100,100,0.0001,104,3
0.514,1e-05,93,111,100,100,0.0001,204,3
0.514,1e-05,148,156,100,100,0.0001,304,3
0.514,1e-05,198,206,100,100,0.0001,404,3
0.514,1e-05,249,255,100,100,0.0001,504,3
0.514,1e-05,302,302,100,100,0.0001,604,3
0.516,1e-05,342,362,100,100,0.0001,704,3
0.516,1e-05,387,417,100,100,0.0001,804,3
0.516,1e-05,439,465,100,100,0.0001,904,3
0.518,1e-05,481,523,100,100,0.0001,1004,3
0.522,1e-05,529,575,100,100,0.0001,1104,3
0.522,1e-05,579,625,100,100,0.0001,1204,3
0.528,1e-05,631,673,100,100,0.0001,1304,3
0.53,1e-05,692,712,100,100,0.0001,1404,3
0.534,1e-05,749,755,100,100,0.0001,1504,3
0.534,1e-05,796,808,100,100,0.0001,1604,3
0.534,1e-05,840,864,100,100,0.0001,1704,3
0.538,1e-05,888,916,100,100,0.0001,1804,3
0.542,1e-05,937,967,100,100,0.0001,1904,3
0.552,1e-05,994,1010,100,100,0.0001,2004,3
0.51,1e-05,52,52,100,100,0.0001,104,4
0.516,1e-05,96,108,100,100,0.0001,204,4
0.508,1e-05,151,153,100,100,0.0001,304,4
0.512,1e-05,202,202,100,100,0.0001,404,4
0.514,1e-05,252,252,100,100,0.0001,504,4
0.518,1e-05,298,306,100,100,0.0001,604,4
0.514,1e-05,352,352,100,100,0.0001,704,4
0.518,1e-05,399,405,100,100,0.0001,804,4
0.518,1e-05,453,451,100,100,0.0001,904,4
0.518,1e-05,501,503,100,100,0.0001,1004,4
0.52,1e-05,555,549,100,100,0.0001,1104,4
0.526,1e-05,608,596,100,100,0.0001,1204,4
0.526,1e-05,660,644,100,100,0.0001,1304,4
0.52,1e-05,713,691,100,100,0.0001,1404,4
0.522,1e-05,761,743,100,100,0.0001,1504,4
0.52,1e-05,809,795,100,100,0.0001,1604,4
0.52,1e-05,845,859,100,100,0.0001,1704,4
0.526,1e-05,892,912,100,100,0.0001,1804,4
0.53,1e-05,936,968,100,100,0.0001,1904,4
0.534,1e-05,986,1018,100,100,0.0001,2004,4
0.528,1e-05,54,50,100,100,0.0001,104,5
0.53,1e-05,107,97,100,100,0.0001,204,5
0.532,1e-05,155,149,100,100,0.0001,304,5
0.528,1e-05,199,205,100,100,0.0001,404,5
0.532,1e-05,245,259,100,100,0.0001,504,5
0.53,1e-05,295,309,100,100,0.0001,604,5
0.528,1e-05,348,356,100,100,0.0001,704,5
0.522,1e-05,403,401,100,100,0.0001,804,5
0.526,1e-05,448,456,100,100,0.0001,904,5
0.524,1e-05,500,504,100,100,0.0001,1004,5
0.522,1e-05,554,550,100,100,0.0001,1104,5
0.522,1e-05,599,605,100,100,0.0001,1204,5
0.524,1e-05,652,652,100,100,0.0001,1304,5
0.524,1e-05,704,700,100,100,0.0001,1404,5
0.522,1e-05,754,750,100,100,0.0001,1504,5
0.52,1e-05,807,797,100,100,0.0001,1604,5
0.518,1e-05,868,836,100,100,0.0001,1704,5
0.52,1e-05,913,891,100,100,0.0001,1804,5
0.532,1e-05,963,941,100,100,0.0001,1904,5
0.532,1e-05,1011,993,100,100,0.0001,2004,5
0.494,1e-05,42,62,100,100,0.0001,104,6
0.492,1e-05,89,115,100,100,0.0001,204,6
0.496,1e-05,138,166,100,100,0.0001,304,6
0.502,1e-05,192,212,100,100,0.0001,404,6
0.5,1e-05,243,261,100,100,0.0001,504,6
0.496,1e-05,294,310,100,100,0.0001,604,6
0.5,1e-05,348,356,100,100,0.0001,704,6
0.5,1e-05,404,400,100,100,0.0001,804,6
0.5,1e-05,462,442,100,100,0.0001,904,6
0.504,1e-05,507,497,100,100,0.0001,1004,6
0.508,1e-05,558,546,100,100,0.0001,1104,6
0.514,1e-05,609,595,100,100,0.0001,1204,6
0.518,1e-05,656,648,100,100,0.0001,1304,6
0.518,1e-05,709,695,100,100,0.0001,1404,6
0.524,1e-05,751,753,100,100,0.0001,1504,6
0.526,1e-05,810,794,100,100,0.0001,1604,6
0.528,1e-05,856,848,100,100,0.0001,1704,6
0.534,1e-05,903,901,100,100,0.0001,1804,6
0.536,1e-05,951,953,100,100,0.0001,1904,6
0.542,1e-05,994,1010,100,100,0.0001,2004,6
0.514,1e-05,50,54,100,100,0.0001,104,7
0.516,1e-05,106,98,100,100,0.0001,204,7
0.514,1e-05,164,140,100,100,0.0001,304,7
0.516,1e-05,211,193,100,100,0.0001,404,7
0.516,1e-05,270,234,100,100,0.0001,504,7
0.518,1e-05,317,287,100,100,0.0001,604,7
0.516,1e-05,357,347,100,100,0.0001,704,7
0.518,1e-05,399,405,100,100,0.0001,804,7
0.518,1e-05,455,449,100,100,0.0001,904,7
0.52,1e-05,508,496,100,100,0.0001,1004,7
0.526,1e-05,556,548,100,100,0.0001,1104,7
0.524,1e-05,604,600,100,100,0.0001,1204,7
0.524,1e-05,652,652,100,100,0.0001,1304,7
0.526,1e-05,700,704,100,100,0.0001,1404,7
0.534,1e-05,755,749,100,100,0.0001,1504,7
0.534,1e-05,805,799,100,100,0.0001,1604,7
0.534,1e-05,850,854,100,100,0.0001,1704,7
0.538,1e-05,891,913,100,100,0.0001,1804,7
0.542,1e-05,937,967,100,100,0.0001,1904,7
0.546,1e-05,989,1015,100,100,0.0001,2004,7
0.492,1e-05,59,45,100,100,0.0001,104,8
0.49,1e-05,105,99,100,100,0.0001,204,8
0.492,1e-05,153,151,100,100,0.0001,304,8
0.49,1e-05,194,210,100,100,0.0001,404,8
0.49,1e-05,239,265,100,100,0.0001,504,8
0.494,1e-05,284,320,100,100,0.0001,604,8
0.496,1e-05,344,360,100,100,0.0001,704,8
0.492,1e-05,389,415,100,100,0.0001,804,8
0.5,1e-05,440,464,100,100,0.0001,904,8
0.504,1e-05,488,516,100,100,0.0001,1004,8
0.504,1e-05,535,569,100,100,0.0001,1104,8
0.506,1e-05,581,623,100,100,0.0001,1204,8
0.506,1e-05,635,669,100,100,0.0001,1304,8
0.504,1e-05,696,708,100,100,0.0001,1404,8
0.51,1e-05,744,760,100,100,0.0001,1504,8
0.512,1e-05,788,816,100,100,0.0001,1604,8
0.516,1e-05,841,863,100,100,0.0001,1704,8
0.522,1e-05,890,914,100,100,0.0001,1804,8
0.52,1e-05,938,966,100,100,0.0001,1904,8
0.528,1e-05,982,1022,100,100,0.0001,2004,8
0.54,1e-05,49,55,100,100,0.0001,104,9
0.542,1e-05,99,105,100,100,0.0001,204,9
0.542,1e-05,150,154,100,100,0.0001,304,9
0.544,1e-05,196,208,100,100,0.0001,404,9
0.544,1e-05,240,264,100,100,0.0001,504,9
0.546,1e-05,294,310,100,100,0.0001,604,9
0.548,1e-05,345,359,100,100,0.0001,704,9
0.554,1e-05,405,399,100,100,0.0001,804,9
0.554,1e-05,450,454,100,100,0.0001,904,9
0.562,1e-05,497,507,100,100,0.0001,1004,9
0.558,1e-05,544,560,100,100,0.0001,1104,9
0.564,1e-05,587,617,100,100,0.0001,1204,9
0.57,1e-05,634,670,100,100,0.0001,1304,9
0.572,1e-05,683,721,100,100,0.0001,1404,9
0.578,1e-05,740,764,100,100,0.0001,1504,9
0.584,1e-05,795,809,100,100,0.0001,1604,9
0.584,1e-05,837,867,100,100,0.0001,1704,9
0.586,1e-05,889,915,100,100,0.0001,1804,9
0.586,1e-05,942,962,100,100,0.0001,1904,9
0.596,1e-05,998,1006,100,100,0.0001,2004,9
0.498,1e-05,54,50,100,100,0.0001,104,10
0.498,1e-05,109,95,100,100,0.0001,204,10
0.5,1e-05,158,146,100,100,0.0001,304,10
0.498,1e-05,207,197,100,100,0.0001,404,10
0.502,1e-05,260,244,100,100,0.0001,504,10
0.502,1e-05,313,291,100,100,0.0001,604,10
0.502,1e-05,362,342,100,100,0.0001,704,10
0.498,1e-05,412,392,100,100,0.0001,804,10
0.5,1e-05,456,448,100,100,0.0001,904,10
0.502,1e-05,506,498,100,100,0.0001,1004,10
0.506,1e-05,559,545,100,100,0.0001,1104,10
0.51,1e-05,612,592,100,100,0.0001,1204,10
0.506,1e-05,660,644,100,100,0.0001,1304,10
0.51,1e-05,712,692,100,100,0.0001,1404,10
0.516,1e-05,761,743,100,100,0.0001,1504,10
0.524,1e-05,814,790,100,100,0.0001,1604,10
0.528,1e-05,853,851,100,100,0.0001,1704,10
0.528,1e-05,906,898,100,100,0.0001,1804,10
0.534,1e-05,951,953,100,100,0.0001,1904,10
0.532,1e-05,996,1008,100,100,0.0001,2004,10
0.458,1e-05,62,42,100,100,0.0001,104,11
0.46,1e-05,111,93,100,100,0.0001,204,11
0.462,1e-05,159,145,100,100,0.0001,304,11
0.468,1e-05,205,199,100,100,0.0001,404,11
0.466,1e-05,251,253,100,100,0.0001,504,11
0.464,1e-05,306,298,100,100,0.0001,604,11
0.464,1e-05,354,350,100,100,0.0001,704,11
0.466,1e-05,393,411,100,100,0.0001,804,11
0.464,1e-05,443,461,100,100,0.0001,904,11
0.468,1e-05,492,512,100,100,0.0001,1004,11
0.47,1e-05,547,557,100,100,0.0001,1104,11
0.474,1e-05,591,613,100,100,0.0001,1204,11
0.478,1e-05,642,662,100,100,0.0001,1304,11
0.478,1e-05,700,704,100,100,0.0001,1404,11
0.48,1e-05,751,753,100,100,0.0001,1504,11
0.484,1e-05,799,805,100,100,0.0001,1604,11
0.49,1e-05,847,857,100,100,0.0001,1704,11
0.498,1e-05,894,910,100,100,0.0001,1804,11
0.5,1e-05,942,962,100,100,0.0001,1904,11
0.504,1e-05,990,1014,100,100,0.0001,2004,11
0.498,1e-05,51,53,100,100,0.0001,104,12
0.496,1e-05,103,101,100,100,0.0001,204,12
0.496,1e-05,150,154,100,100,0.0001,304,12
0.494,1e-05,198,206,100,100,0.0001,404,12
0.496,1e-05,254,250,100,100,0.0001,504,12
0.498,1e-05,307,297,100,100,0.0001,604,12
0.496,1e-05,359,345,100,100,0.0001,704,12
0.498,1e-05,411,393,100,100,0.0001,804,12
0.504,1e-05,464,440,100,100,0.0001,904,12
0.506,1e-05,511,493,100,100,0.0001,1004,12
0.508,1e-05,554,550,100,100,0.0001,1104,12
0.508,1e-05,605,599,100,100,0.0001,1204,12
0.51,1e-05,660,644,100,100,0.0001,1304,12
0.514,1e-05,714,690,100,100,0.0001,1404,12
0.518,1e-05,765,739,100,100,0.0001,1504,12
0.522,1e-05,808,796,100,100,0.0001,1604,12
0.526,1e-05,855,849,100,100,0.0001,1704,12
0.526,1e-05,901,903,100,100,0.0001,1804,12
0.538,1e-05,961,943,100,100,0.0001,1904,12
0.538,1e-05,1020,984,100,100,0.0001,2004,12
0.528,1e-05,52,52,100,100,0.0001,104,13
0.528,1e-05,106,98,100,100,0.0001,204,13
0.524,1e-05,147,157,100,100,0.0001,304,13
0.526,1e-05,196,208,100,100,0.0001,404,13
0.524,1e-05,247,257,100,100,0.0001,504,13
0.522,1e-05,293,311,100,100,0.0001,604,13
0.524,1e-05,346,358,100,100,0.0001,704,13
0.53,1e-05,394,410,100,100,0.0001,804,13
0.53,1e-05,444,460,100,100,0.0001,904,13
0.534,1e-05,484,520,100,100,0.0001,1004,13
0.536,1e-05,535,569,100,100,0.0001,1104,13
0.55,1e-05,596,608,100,100,0.0001,1204,13
0.552,1e-05,649,655,100,100,0.0001,1304,13
0.554,1e-05,697,707,100,100,0.0001,1404,13
0.556,1e-05,750,754,100,100,0.0001,1504,13
0.562,1e-05,797,807,100,100,0.0001,1604,13
0.568,1e-05,852,852,100,100,0.0001,1704,13
0.572,1e-05,901,903,100,100,0.0001,1804,13
0.586,1e-05,950,954,100,100,0.0001,1904,13
0.59,1e-05,995,1009,100,100,0.0001,2004,13
0.484,1e-05,48,56,100,100,0.0001,104,14
0.48,1e-05,95,109,100,100,0.0001,204,14
0.478,1e-05,146,158,100,100,0.0001,304,14
0.478,1e-05,199,205,100,100,0.0001,404,14
0.48,1e-05,247,257,100,100,0.0001,504,14
0.48,1e-05,297,307,100,100,0.0001,604,14
0.48,1e-05,346,358,100,100,0.0001,704,14
0.482,1e-05,400,404,100,100,0.0001,804,14
0.482,1e-05,455,449,100,100,0.0001,904,14
0.486,1e-05,508,496,100,100,0.0001,1004,14
0.488,1e-05,556,548,100,100,0.0001,1104,14
0.484,1e-05,612,592,100,100,0.0001,1204,14
0.488,1e-05,656,648,100,100,0.0001,1304,14
0.496,1e-05,708,696,100,100,0.0001,1404,14
0.502,1e-05,756,748,100,100,0.0001,1504,14
0.508,1e-05,802,802,100,100,0.0001,1604,14
0.508,1e-05,853,851,100,100,0.0001,1704,14
0.51,1e-05,898,906,100,100,0.0001,1804,14
0.512,1e-05,948,956,100,100,0.0001,1904,14
0.518,1e-05,999,1005,100,100,0.0001,2004,14
0.49,1e-05,46,58,100,100,0.0001,104,15
0.49,1e-05,87,117,100,100,0.0001,204,15
0.49,1e-05,133,171,100,100,0.0001,304,15
0.49,1e-05,185,219,100,100,0.0001,404,15
0.49,1e-05,229,275,100,100,0.0001,504,15
0.492,1e-05,285,319,100,100,0.0001,604,15
0.494,1e-05,326,378,100,100,0.0001,704,15
0.496,1e-05,377,427,100,100,0.0001,804,15
0.494,1e-05,424,480,100,100,0.0001,904,15
0.494,1e-05,474,530,100,100,0.0001,1004,15
0.494,1e-05,525,579,100,100,0.0001,1104,15
0.498,1e-05,583,621,100,100,0.0001,1204,15
0.502,1e-05,637,667,100,100,0.0001,1304,15
0.5,1e-05,697,707,100,100,0.0001,1404,15
0.498,1e-05,745,759,100,100,0.0001,1504,15
0.494,1e-05,801,803,100,100,0.0001,1604,15
0.496,1e-05,845,859,100,100,0.0001,1704,15
0.492,1e-05,896,908,100,100,0.0001,1804,15
0.492,1e-05,948,956,100,100,0.0001,1904,15
0.498,1e-05,1001,1003,100,100,0.0001,2004,15
0.54,1e-05,49,55,100,100,0.0001,104,16
0.54,1e-05,102,102,100,100,0.0001,204,16
0.544,1e-05,144,160,100,100,0.0001,304,16
0.546,1e-05,189,215,100,100,0.0001,404,16
0.548,1e-05,235,269,100,100,0.0001,504,16
0.548,1e-05,287,317,100,100,0.0001,604,16
0.546,1e-05,337,367,100,100,0.0001,704,16
0.546,1e-05,381,423,100,100,0.0001,804,16
0.544,1e-05,437,467,100,100,0.0001,904,16
0.548,1e-05,489,515,100,100,0.0001,1004,16
0.544,1e-05,535,569,100,100,0.0001,1104,16
0.546,1e-05,584,620,100,100,0.0001,1204,16
0.558,1e-05,638,666,100,100,0.0001,1304,16
0.56,1e-05,692,712,100,100,0.0001,1404,16
0.566,1e-05,741,763,100,100,0.0001,1504,16
0.57,1e-05,792,812,100,100,0.0001,1604,16
0.57,1e-05,848,856,100,100,0.0001,1704,16
0.568,1e-05,889,915,100,100,0.0001,1804,16
0.568,1e-05,948,956,100,100,0.0001,1904,16
0.572,1e-05,998,1006,100,100,0.0001,2004,16
0.476,1e-05,56,48,100,100,0.0001,104,17
0.472,1e-05,109,95,100,100,0.0001,204,17
0.466,1e-05,158,146,100,100,0.0001,304,17
0.466,1e-05,208,196,100,100,0.0001,404,17
0.466,1e-05,261,243,100,100,0.0001,504,17
0.464,1e-05,305,299,100,100,0.0001,604,17
0.468,1e-05,354,350,100,100,0.0001,704,17
0.468,1e-05,405,399,100,100,0.0001,804,17
0.468,1e-05,456,448,100,100,0.0001,904,17
0.472,1e-05,500,504,100,100,0.0001,1004,17
0.476,1e-05,555,549,100,100,0.0001,1104,17
0.48,1e-05,603,601,100,100,0.0001,1204,17
0.478,1e-05,656,648,100,100,0.0001,1304,17
0.48,1e-05,701,703,100,100,0.0001,1404,17
0.486,1e-05,752,752,100,100,0.0001,1504,17
0.486,1e-05,803,801,100,100,0.0001,1604,17
0.486,1e-05,859,845,100,100,0.0001,1704,17
0.488,1e-05,907,897,100,100,0.0001,1804,17
0.494,1e-05,954,950,100,100,0.0001,1904,17
0.5,1e-05,997,1007,100,100,0.0001,2004,17
0.498,1e-05,52,52,100,100,0.0001,104,18
0.498,1e-05,108,96,100,100,0.0001,204,18
0.498,1e-05,147,157,100,100,0.0001,304,18
0.494,1e-05,203,201,100,100,0.0001,404,18
0.494,1e-05,250,254,100,100,0.0001,504,18
0.504,1e-05,300,304,100,100,0.0001,604,18
0.508,1e-05,353,351,100,100,0.0001,704,18
0.51,1e-05,410,394,100,100,0.0001,804,18
0.51,1e-05,457,447,100,100,0.0001,904,18
0.514,1e-05,499,505,100,100,0.0001,1004,18
0.512,1e-05,550,554,100,100,0.0001,1104,18
0.512,1e-05,598,606,100,100,0.0001,1204,18
0.512,1e-05,645,659,100,100,0.0001,1304,18
0.516,1e-05,688,716,100,100,0.0001,1404,18
0.512,1e-05,740,764,100,100,0.0001,1504,18
0.518,1e-05,780,824,100,100,0.0001,1604,18
0.52,1e-05,828,876,100,100,0.0001,1704,18
0.522,1e-05,893,911,100,100,0.0001,1804,18
0.522,1e-05,949,955,100,100,0.0001,1904,18
0.524,1e-05,1003,1001,100,100,0.0001,2004,18
0.478,1e-05,50,54,100,100,0.0001,104,19
0.478,1e-05,107,97,100,100,0.0001,204,19
0.478,1e-05,163,141,100,100,0.0001,304,19
0.478,1e-05,214,190,100,100,0.0001,404,19
0.48,1e-05,256,248,100,100,0.0001,504,19
0.48,1e-05,309,295,100,100,0.0001,604,19
0.478,1e-05,363,341,100,100,0.0001,704,19
0.48,1e-05,421,383,100,100,0.0001,804,19
0.48,1e-05,470,434,100,100,0.0001,904,19
0.484,1e-05,510,494,100,100,0.0001,1004,19
0.482,1e-05,555,549,100,100,0.0001,1104,19
0.48,1e-05,603,601,100,100,0.0001,1204,19
0.48,1e-05,649,655,100,100,0.0001,1304,19
0.482,1e-05,699,705,100,100,0.0001,1404,19
0.484,1e-05,751,753,100,100,0.0001,1504,19
0.488,1e-05,792,812,100,100,0.0001,1604,19
0.488,1e-05,841,863,100,100,0.0001,1704,19
0.492,1e-05,893,911,100,100,0.0001,1804,19
0.492,1e-05,944,960,100,100,0.0001,1904,19
0.494,1e-05,989,1015,100,100,0.0001,2004,19
0.484,1e-05,57,47,100,100,0.0001,104,20
0.478,1e-05,112,92,100,100,0.0001,204,20
0.478,1e-05,152,152,100,100,0.0001,304,20
0.478,1e-05,198,206,100,100,0.0001,404,20
0.48,1e-05,249,255,100,100,0.0001,504,20
0.484,1e-05,297,307,100,100,0.0001,604,20
0.486,1e-05,348,356,100,100,0.0001,704,20
0.488,1e-05,396,408,100,100,0.0001,804,20
0.488,1e-05,443,461,100,100,0.0001,904,20
0.5,1e-05,495,509,100,100,0.0001,1004,20
0.498,1e-05,558,546,100,100,0.0001,1104,20
0.502,1e-05,605,599,100,100,0.0001,1204,20
0.506,1e-05,654,650,100,100,0.0001,1304,20
0.508,1e-05,704,700,100,100,0.0001,1404,20
0.508,1e-05,754,750,100,100,0.0001,1504,20
0.51,1e-05,801,803,100,100,0.0001,1604,20
0.512,1e-05,852,852,100,100,0.0001,1704,20
0.518,1e-05,907,897,100,100,0.0001,1804,20
0.518,1e-05,959,945,100,100,0.0001,1904,20
0.528,1e-05,1006,998,100,100,0.0001,2004,20
0.502,1e-05,56,48,100,100,0.001,104,1
0.51,1e-05,110,94,100,100,0.001,204,1
0.51,1e-05,164,140,100,100,0.001,304,1
0.514,1e-05,214,190,100,100,0.001,404,1
0.532,1e-05,259,245,100,100,0.001,504,1
0.55,1e-05,315,289,100,100,0.001,604,1
0.58,1e-05,361,343,100,100,0.001,704,1
0.59,1e-05,410,394,100,100,0.001,804,1
0.612,1e-05,467,437,100,100,0.001,904,1
0.636,1e-05,512,492,100,100,0.001,1004,1
0.64,1e-05,555,549,100,100,0.001,1104,1
0.676,1e-05,609,595,100,100,0.001,1204,1
0.692,1e-05,662,642,100,100,0.001,1304,1
0.698,1e-05,708,696,100,100,0.001,1404,1
0.72,1e-05,753,751,100,100,0.001,1504,1
0.754,1e-05,808,796,100,100,0.001,1604,1
0.78,1e-05,861,843,100,100,0.001,1704,1
0.796,1e-05,907,897,100,100,0.001,1804,1
0.822,1e-05,949,955,100,100,0.001,1904,1
0.862,1e-05,1000,1004,100,100,0.001,2004,1
0.482,1e-05,48,56,100,100,0.001,104,2
0.492,1e-05,92,112,100,100,0.001,204,2
0.49,1e-05,134,170,100,100,0.001,304,2
0.5,1e-05,183,221,100,100,0.001,404,2
0.51,1e-05,226,278,100,100,0.001,504,2
0.508,1e-05,287,317,100,100,0.001,604,2
0.52,1e-05,339,365,100,100,0.001,704,2
0.532,1e-05,386,418,100,100,0.001,804,2
0.536,1e-05,430,474,100,100,0.001,904,2
0.566,1e-05,482,522,100,100,0.001,1004,2
0.574,1e-05,538,566,100,100,0.001,1104,2
0.604,1e-05,589,615,100,100,0.001,1204,2
0.614,1e-05,638,666,100,100,0.001,1304,2
0.648,1e-05,695,709,100,100,0.001,1404,2
0.664,1e-05,749,755,100,100,0.001,1504,2
0.692,1e-05,797,807,100,100,0.001,1604,2
0.712,1e-05,843,861,100,100,0.001,1704,2
0.748,1e-05,898,906,100,100,0.001,1804,2
0.768,1e-05,948,956,100,100,0.001,1904,2
0.814,1e-05,996,1008,100,100,0.001,2004,2
0.536,1e-05,55,49,100,100,0.001,104,3
0.552,1e-05,105,99,100,100,0.001,204,3
0.562,1e-05,162,142,100,100,0.001,304,3
0.58,1e-05,216,188,100,100,0.001,404,3
0.578,1e-05,265,239,100,100,0.001,504,3
0.588,1e-05,315,289,100,100,0.001,604,3
0.598,1e-05,359,345,100,100,0.001,704,3
0.614,1e-05,412,392,100,100,0.001,804,3
0.622,1e-05,456,448,100,100,0.001,904,3
0.642,1e-05,507,497,100,100,0.001,1004,3
0.66,1e-05,563,541,100,100,0.001,1104,3
0.682,1e-05,610,594,100,100,0.001,1204,3
0.688,1e-05,655,649,100,100,0.001,1304,3
0.704,1e-05,709,695,100,100,0.001,1404,3
0.734,1e-05,746,758,100,100,0.001,1504,3
0.758,1e-05,796,808,100,100,0.001,1604,3
0.752,1e-05,845,859,100,100,0.001,1704,3
0.784,1e-05,896,908,100,100,0.001,1804,3
0.802,1e-05,949,955,100,100,0.001,1904,3
0.836,1e-05,1008,996,100,100,0.001,2004,3
0.528,1e-05,59,45,100,100,0.001,104,4
0.538,1e-05,109,95,100,100,0.001,204,4
0.538,1e-05,145,159,100,100,0.001,304,4
0.534,1e-05,207,197,100,100,0.001,404,4
0.536,1e-05,262,242,100,100,0.001,504,4
0.536,1e-05,325,279,100,100,0.001,604,4
0.546,1e-05,379,325,100,100,0.001,704,4
0.57,1e-05,430,374,100,100,0.001,804,4
0.584,1e-05,470,434,100,100,0.001,904,4
0.596,1e-05,511,493,100,100,0.001,1004,4
0.604,1e-05,553,551,100,100,0.001,1104,4
0.638,1e-05,599,605,100,100,0.001,1204,4
0.646,1e-05,650,654,100,100,0.001,1304,4
0.656,1e-05,702,702,100,100,0.001,1404,4
0.682,1e-05,755,749,100,100,0.001,1504,4
0.692,1e-05,815,789,100,100,0.001,1604,4
0.732,1e-05,860,844,100,100,0.001,1704,4
0.758,1e-05,902,902,100,100,0.001,1804,4
0.758,1e-05,946,958,100,100,0.001,1904,4
0.786,1e-05,996,1008,100,100,0.001,2004,4
0.456,1e-05,51,53,100,100,0.001,104,5
0.466,1e-05,92,112,100,100,0.001,204,5
0.468,1e-05,145,159,100,100,0.001,304,5
0.468,1e-05,191,213,100,100,0.001,404,5
0.482,1e-05,237,267,100,100,0.001,504,5
0.498,1e-05,289,315,100,100,0.001,604,5
0.5,1e-05,343,361,100,100,0.001,704,5
0.514,1e-05,386,418,100,100,0.001,804,5
0.546,1e-05,423,481,100,100,0.001,904,5
0.548,1e-05,473,531,100,100,0.001,1004,5
0.568,1e-05,514,590,100,100,0.001,1104,5
0.584,1e-05,571,633,100,100,0.001,1204,5
0.606,1e-05,628,676,100,100,0.001,1304,5
0.648,1e-05,679,725,100,100,0.001,1404,5
0.676,1e-05,737,767,100,100,0.001,1504,5
0.71,1e-05,794,810,100,100,0.001,1604,5
0.718,1e-05,848,856,100,100,0.001,1704,5
0.766,1e-05,895,909,100,100,0.001,1804,5
0.808,1e-05,943,961,100,100,0.001,1904,5
0.836,1e-05,992,1012,100,100,0.001,2004,5
0.496,1e-05,50,54,100,100,0.001,104,6
0.512,1e-05,102,102,100,100,0.001,204,6
0.534,1e-05,149,155,100,100,0.001,304,6
0.54,1e-05,199,205,100,100,0.001,404,6
0.546,1e-05,243,261,100,100,0.001,504,6
0.548,1e-05,293,311,100,100,0.001,604,6
0.562,1e-05,346,358,100,100,0.001,704,6
0.57,1e-05,393,411,100,100,0.001,804,6
0.57,1e-05,443,461,100,100,0.001,904,6
0.576,1e-05,498,506,100,100,0.001,1004,6
0.602,1e-05,557,547,100,100,0.001,1104,6
0.622,1e-05,611,593,100,100,0.001,1204,6
0.646,1e-05,657,647,100,100,0.001,1304,6
0.664,1e-05,707,697,100,100,0.001,1404,6
0.696,1e-05,761,743,100,100,0.001,1504,6
0.726,1e-05,819,785,100,100,0.001,1604,6
0.748,1e-05,867,837,100,100,0.001,1704,6
0.77,1e-05,922,882,100,100,0.001,1804,6
0.784,1e-05,965,939,100,100,0.001,1904,6
0.83,1e-05,1006,998,100,100,0.001,2004,6
0.462,1e-05,42,62,100,100,0.001,104,7
0.484,1e-05,97,107,100,100,0.001,204,7
0.494,1e-05,146,158,100,100,0.001,304,7
0.502,1e-05,197,207,100,100,0.001,404,7
0.51,1e-05,238,266,100,100,0.001,504,7
0.526,1e-05,286,318,100,100,0.001,604,7
0.538,1e-05,339,365,100,100,0.001,704,7
0.552,1e-05,390,414,100,100,0.001,804,7
0.568,1e-05,449,455,100,100,0.001,904,7
0.584,1e-05,498,506,100,100,0.001,1004,7
0.596,1e-05,551,553,100,100,0.001,1104,7
0.622,1e-05,600,604,100,100,0.001,1204,7
0.648,1e-05,646,658,100,100,0.001,1304,7
0.674,1e-05,701,703,100,100,0.001,1404,7
0.706,1e-05,744,760,100,100,0.001,1504,7
0.732,1e-05,788,816,100,100,0.001,1604,7
0.758,1e-05,846,858,100,100,0.001,1704,7
0.776,1e-05,890,914,100,100,0.001,1804,7
0.802,1e-05,943,961,100,100,0.001,1904,7
0.822,1e-05,992,1012,100,100,0.001,2004,7
0.516,1e-05,51,53,100,100,0.001,104,8
0.528,1e-05,107,97,100,100,0.001,204,8
0.556,1e-05,152,152,100,100,0.001,304,8
0.566,1e-05,200,204,100,100,0.001,404,8
0.572,1e-05,250,254,100,100,0.001,504,8
0.578,1e-05,299,305,100,100,0.001,604,8
0.596,1e-05,345,359,100,100,0.001,704,8
0.602,1e-05,394,410,100,100,0.001,804,8
0.612,1e-05,455,449,100,100,0.001,904,8
0.624,1e-05,509,495,100,100,0.001,1004,8
0.64,1e-05,562,542,100,100,0.001,1104,8
0.654,1e-05,614,590,100,100,0.001,1204,8
0.676,1e-05,664,640,100,100,0.001,1304,8
0.692,1e-05,709,695,100,100,0.001,1404,8
0.714,1e-05,761,743,100,100,0.001,1504,8
0.734,1e-05,809,795,100,100,0.001,1604,8
0.764,1e-05,853,851,100,100,0.001,1704,8
0.798,1e-05,900,904,100,100,0.001,1804,8
0.816,1e-05,945,959,100,100,0.001,1904,8
0.836,1e-05,997,1007,100,100,0.001,2004,8
0.462,1e-05,53,51,100,100,0.001,104,9
0.474,1e-05,108,96,100,100,0.001,204,9
0.48,1e-05,159,145,100,100,0.001,304,9
0.47,1e-05,210,194,100,100,0.001,404,9
0.474,1e-05,260,244,100,100,0.001,504,9
0.484,1e-05,313,291,100,100,0.001,604,9
0.488,1e-05,374,330,100,100,0.001,704,9
0.484,1e-05,424,380,100,100,0.001,804,9
0.486,1e-05,474,430,100,100,0.001,904,9
0.492,1e-05,522,482,100,100,0.001,1004,9
0.512,1e-05,564,540,100,100,0.001,1104,9
0.54,1e-05,614,590,100,100,0.001,1204,9
0.556,1e-05,668,636,100,100,0.001,1304,9
0.58,1e-05,719,685,100,100,0.001,1404,9
0.612,1e-05,771,733,100,100,0.001,1504,9
0.636,1e-05,821,783,100,100,0.001,1604,9
0.656,1e-05,867,837,100,100,0.001,1704,9
0.696,1e-05,916,888,100,100,0.001,1804,9
0.718,1e-05,954,950,100,100,0.001,1904,9
0.764,1e-05,1008,996,100,100,0.001,2004,9
0.498,1e-05,52,52,100,100,0.001,104,10
0.51,1e-05,106,98,100,100,0.001,204,10
0.51,1e-05,159,145,100,100,0.001,304,10
0.516,1e-05,207,197,100,100,0.001,404,10
0.526,1e-05,252,252,100,100,0.001,504,10
0.542,1e-05,301,303,100,100,0.001,604,10
0.566,1e-05,352,352,100,100,0.001,704,10
0.59,1e-05,399,405,100,100,0.001,804,10
0.596,1e-05,454,450,100,100,0.001,904,10
0.612,1e-05,495,509,100,100,0.001,1004,10
0.622,1e-05,541,563,100,100,0.001,1104,10
0.642,1e-05,599,605,100,100,0.001,1204,10
0.648,1e-05,648,656,100,100,0.001,1304,10
0.66,1e-05,701,703,100,100,0.001,1404,10
0.66,1e-05,747,757,100,100,0.001,1504,10
0.678,1e-05,797,807,100,100,0.001,1604,10
0.71,1e-05,840,864,100,100,0.001,1704,10
0.746,1e-05,892,912,100,100,0.001,1804,10
0.766,1e-05,945,959,100,100,0.001,1904,10
0.796,1e-05,1001,1003,100,100,0.001,2004,10
0.486,1e-05,52,52,100,100,0.001,104,11
0.498,1e-05,103,101,100,100,0.001,204,11
0.502,1e-05,154,150,100,100,0.001,304,11
0.504,1e-05,197,207,100,100,0.001,404,11
0.516,1e-05,250,254,100,100,0.001,504,11
0.528,1e-05,301,303,100,100,0.001,604,11
0.544,1e-05,357,347,100,100,0.001,704,11
0.562,1e-05,397,407,100,100,0.001,804,11
0.564,1e-05,444,460,100,100,0.001,904,11
0.57,1e-05,488,516,100,100,0.001,1004,11
0.58,1e-05,539,565,100,100,0.001,1104,11
0.614,1e-05,581,623,100,100,0.001,1204,11
0.638,1e-05,645,659,100,100,0.001,1304,11
0.662,1e-05,699,705,100,100,0.001,1404,11
0.682,1e-05,756,748,100,100,0.001,1504,11
0.694,1e-05,802,802,100,100,0.001,1604,11
0.708,1e-05,850,854,100,100,0.001,1704,11
0.75,1e-05,907,897,100,100,0.001,1804,11
0.766,1e-05,955,949,100,100,0.001,1904,11
0.792,1e-05,1007,997,100,100,0.001,2004,11
0.512,1e-05,52,52,100,100,0.001,104,12
0.516,1e-05,112,92,100,100,0.001,204,12
0.518,1e-05,157,147,100,100,0.001,304,12
0.518,1e-05,208,196,100,100,0.001,404,12
0.504,1e-05,263,241,100,100,0.001,504,12
0.52,1e-05,309,295,100,100,0.001,604,12
0.532,1e-05,350,354,100,100,0.001,704,12
0.552,1e-05,399,405,100,100,0.001,804,12
0.58,1e-05,449,455,100,100,0.001,904,12
0.588,1e-05,500,504,100,100,0.001,1004,12
0.604,1e-05,549,555,100,100,0.001,1104,12
0.63,1e-05,585,619,100,100,0.001,1204,12
0.658,1e-05,636,668,100,100,0.001,1304,12
0.682,1e-05,691,713,100,100,0.001,1404,12
0.706,1e-05,744,760,100,100,0.001,1504,12
0.722,1e-05,789,815,100,100,0.001,1604,12
0.728,1e-05,852,852,100,100,0.001,1704,12
0.744,1e-05,899,905,100,100,0.001,1804,12
0.752,1e-05,942,962,100,100,0.001,1904,12
0.766,1e-05,994,1010,100,100,0.001,2004,12
0.494,1e-05,52,52,100,100,0.001,104,13
0.498,1e-05,100,104,100,100,0.001,204,13
0.488,1e-05,145,159,100,100,0.001,304,13
0.492,1e-05,197,207,100,100,0.001,404,13
0.502,1e-05,247,257,100,100,0.001,504,13
0.522,1e-05,300,304,100,100,0.001,604,13
0.532,1e-05,347,357,100,100,0.001,704,13
0.548,1e-05,396,408,100,100,0.001,804,13
0.554,1e-05,453,451,100,100,0.001,904,13
0.578,1e-05,494,510,100,100,0.001,1004,13
0.604,1e-05,550,554,100,100,0.001,1104,13
0.612,1e-05,599,605,100,100,0.001,1204,13
0.634,1e-05,650,654,100,100,0.001,1304,13
0.638,1e-05,699,705,100,100,0.001,1404,13
0.666,1e-05,750,754,100,100,0.001,1504,13
0.69,1e-05,801,803,100,100,0.001,1604,13
0.706,1e-05,843,861,100,100,0.001,1704,13
0.742,1e-05,895,909,100,100,0.001,1804,13
0.764,1e-05,946,958,100,100,0.001,1904,13
0.786,1e-05,996,1008,100,100,0.001,2004,13
0.488,1e-05,59,45,100,100,0.001,104,14
0.512,1e-05,100,104,100,100,0.001,204,14
0.52,1e-05,151,153,100,100,0.001,304,14
0.532,1e-05,202,202,100,100,0.001,404,14
0.532,1e-05,257,247,100,100,0.001,504,14
0.538,1e-05,312,292,100,100,0.001,604,14
0.542,1e-05,360,344,100,100,0.001,704,14
0.546,1e-05,395,409,100,100,0.001,804,14
0.544,1e-05,447,457,100,100,0.001,904,14
0.57,1e-05,501,503,100,100,0.001,1004,14
0.582,1e-05,548,556,100,100,0.001,1104,14
0.594,1e-05,592,612,100,100,0.001,1204,14
0.618,1e-05,644,660,100,100,0.001,1304,14
0.64,1e-05,689,715,100,100,0.001,1404,14
0.648,1e-05,739,765,100,100,0.001,1504,14
0.682,1e-05,785,819,100,100,0.001,1604,14
0.692,1e-05,836,868,100,100,0.001,1704,14
0.72,1e-05,892,912,100,100,0.001,1804,14
0.752,1e-05,937,967,100,100,0.001,1904,14
0.788,1e-05,990,1014,100,100,0.001,2004,14
0.522,1e-05,54,50,100,100,0.001,104,15
0.534,1e-05,99,105,100,100,0.001,204,15
0.54,1e-05,162,142,100,100,0.001,304,15
0.54,1e-05,205,199,100,100,0.001,404,15
0.532,1e-05,248,256,100,100,0.001,504,15
0.55,1e-05,300,304,100,100,0.001,604,15
0.556,1e-05,346,358,100,100,0.001,704,15
0.568,1e-05,394,410,100,100,0.001,804,15
0.578,1e-05,451,453,100,100,0.001,904,15
0.59,1e-05,505,499,100,100,0.001,1004,15
0.608,1e-05,556,548,100,100,0.001,1104,15
0.62,1e-05,609,595,100,100,0.001,1204,15
0.638,1e-05,668,636,100,100,0.001,1304,15
0.65,1e-05,711,693,100,100,0.001,1404,15
0.678,1e-05,762,742,100,100,0.001,1504,15
0.692,1e-05,805,799,100,100,0.001,1604,15
0.708,1e-05,860,844,100,100,0.001,1704,15
0.722,1e-05,910,894,100,100,0.001,1804,15
0.746,1e-05,961,943,100,100,0.001,1904,15
0.776,1e-05,1011,993,100,100,0.001,2004,15
0.5,1e-05,48,56,100,100,0.001,104,16
0.512,1e-05,98,106,100,100,0.001,204,16
0.524,1e-05,155,149,100,100,0.001,304,16
0.528,1e-05,204,200,100,100,0.001,404,16
0.54,1e-05,252,252,100,100,0.001,504,16
0.548,1e-05,294,310,100,100,0.001,604,16
0.57,1e-05,335,369,100,100,0.001,704,16
0.588,1e-05,394,410,100,100,0.001,804,16
0.604,1e-05,440,464,100,100,0.001,904,16
0.618,1e-05,493,511,100,100,0.001,1004,16
0.642,1e-05,539,565,100,100,0.001,1104,16
0.66,1e-05,596,608,100,100,0.001,1204,16
0.684,1e-05,650,654,100,100,0.001,1304,16
0.708,1e-05,699,705,100,100,0.001,1404,16
0.72,1e-05,750,754,100,100,0.001,1504,16
0.734,1e-05,797,807,100,100,0.001,1604,16
0.748,1e-05,851,853,100,100,0.001,1704,16
0.76,1e-05,901,903,100,100,0.001,1804,16
0.788,1e-05,949,955,100,100,0.001,1904,16
0.818,1e-05,1004,1000,100,100,0.001,2004,16
0.488,1e-05,54,50,100,100,0.001,104,17
0.506,1e-05,98,106,100,100,0.001,204,17
0.504,1e-05,149,155,100,100,0.001,304,17
0.52,1e-05,198,206,100,100,0.001,404,17
0.518,1e-05,244,260,100,100,0.001,504,17
0.532,1e-05,292,312,100,100,0.001,604,17
0.536,1e-05,350,354,100,100,0.001,704,17
0.548,1e-05,392,412,100,100,0.001,804,17
0.558,1e-05,444,460,100,100,0.001,904,17
0.568,1e-05,498,506,100,100,0.001,1004,17
0.582,1e-05,546,558,100,100,0.001,1104,17
0.612,1e-05,599,605,100,100,0.001,1204,17
0.63,1e-05,647,657,100,100,0.001,1304,17
0.666,1e-05,693,711,100,100,0.001,1404,17
0.68,1e-05,740,764,100,100,0.001,1504,17
0.69,1e-05,794,810,100,100,0.001,1604,17
0.72,1e-05,838,866,100,100,0.001,1704,17
0.734,1e-05,890,914,100,100,0.001,1804,17
0.748,1e-05,945,959,100,100,0.001,1904,17
0.784,1e-05,992,1012,100,100,0.001,2004,17
0.46,1e-05,55,49,100,100,0.001,104,18
0.472,1e-05,100,104,100,100,0.001,204,18
0.474,1e-05,154,150,100,100,0.001,304,18
0.484,1e-05,206,198,100,100,0.001,404,18
0.484,1e-05,253,251,100,100,0.001,504,18
0.492,1e-05,301,303,100,100,0.001,604,18
0.504,1e-05,355,349,100,100,0.001,704,18
0.5,1e-05,411,393,100,100,0.001,804,18
0.52,1e-05,459,445,100,100,0.001,904,18
0.56,1e-05,512,492,100,100,0.001,1004,18
0.592,1e-05,560,544,100,100,0.001,1104,18
0.612,1e-05,610,594,100,100,0.001,1204,18
0.628,1e-05,658,646,100,100,0.001,1304,18
0.646,1e-05,714,690,100,100,0.001,1404,18
0.676,1e-05,757,747,100,100,0.001,1504,18
0.694,1e-05,804,800,100,100,0.001,1604,18
0.726,1e-05,861,843,100,100,0.001,1704,18
0.748,1e-05,913,891,100,100,0.001,1804,18
0.774,1e-05,966,938,100,100,0.001,1904,18
0.802,1e-05,1014,990,100,100,0.001,2004,18
0.526,1e-05,60,44,100,100,0.001,104,19
0.534,1e-05,109,95,100,100,0.001,204,19
0.534,1e-05,160,144,100,100,0.001,304,19
0.542,1e-05,207,197,100,100,0.001,404,19
0.556,1e-05,252,252,100,100,0.001,504,19
0.558,1e-05,306,298,100,100,0.001,604,19
0.558,1e-05,348,356,100,100,0.001,704,19
0.568,1e-05,390,414,100,100,0.001,804,19
0.594,1e-05,442,462,100,100,0.001,904,19
0.6,1e-05,487,517,100,100,0.001,1004,19
0.62,1e-05,538,566,100,100,0.001,1104,19
0.622,1e-05,591,613,100,100,0.001,1204,19
0.63,1e-05,641,663,100,100,0.001,1304,19
0.66,1e-05,695,709,100,100,0.001,1404,19
0.674,1e-05,740,764,100,100,0.001,1504,19
0.698,1e-05,786,818,100,100,0.001,1604,19
0.736,1e-05,835,869,100,100,0.001,1704,19
0.76,1e-05,890,914,100,100,0.001,1804,19
0.77,1e-05,943,961,100,100,0.001,1904,19
0.792,1e-05,990,1014,100,100,0.001,2004,19
0.512,1e-05,53,51,100,100,0.001,104,20
0.53,1e-05,98,106,100,100,0.001,204,20
0.54,1e-05,156,148,100,100,0.001,304,20
0.548,1e-05,212,192,100,100,0.001,404,20
0.554,1e-05,268,236,100,100,0.001,504,20
0.568,1e-05,318,286,100,100,0.001,604,20
0.578,1e-05,374,330,100,100,0.001,704,20
0.588,1e-05,420,384,100,100,0.001,804,20
0.602,1e-05,473,431,100,100,0.001,904,20
0.622,1e-05,522,482,100,100,0.001,1004,20
0.626,1e-05,571,533,100,100,0.001,1104,20
0.65,1e-05,620,584,100,100,0.001,1204,20
0.664,1e-05,662,642,100,100,0.001,1304,20
0.674,1e-05,715,689,100,100,0.001,1404,20
0.694,1e-05,759,745,100,100,0.001,1504,20
0.706,1e-05,812,792,100,100,0.001,1604,20
0.716,1e-05,853,851,100,100,0.001,1704,20
0.75,1e-05,906,898,100,100,0.001,1804,20
0.778,1e-05,959,945,100,100,0.001,1904,20
0.81,1e-05,1008,996,100,100,0.001,2004,20
0.502,1e-05,52,52,100,100,0.01,104,1
0.526,1e-05,98,106,100,100,0.01,204,1
0.548,1e-05,149,155,100,100,0.01,304,1
0.576,1e-05,198,206,100,100,0.01,404,1
0.572,1e-05,250,254,100,100,0.01,504,1
0.608,1e-05,302,302,100,100,0.01,604,1
0.634,1e-05,353,351,100,100,0.01,704,1
0.69,1e-05,393,411,100,100,0.01,804,1
0.72,1e-05,444,460,100,100,0.01,904,1
0.812,1e-05,496,508,100,100,0.01,1004,1
0.858,1e-05,542,562,100,100,0.01,1104,1
0.894,1e-05,584,620,100,100,0.01,1204,1
0.89,1e-05,634,670,100,100,0.01,1304,1
0.916,1e-05,693,711,100,100,0.01,1404,1
0.93,1e-05,741,763,100,100,0.01,1504,1
0.938,1e-05,789,815,100,100,0.01,1604,1
0.946,1e-05,841,863,100,100,0.01,1704,1
0.954,1e-05,887,917,100,100,0.01,1804,1
0.954,1e-05,931,973,100,100,0.01,1904,1
0.954,1e-05,981,1023,100,100,0.01,2004,1
0.518,1e-05,40,64,100,100,0.01,104,2
0.548,1e-05,91,113,100,100,0.01,204,2
0.548,1e-05,137,167,100,100,0.01,304,2
0.63,1e-05,195,209,100,100,0.01,404,2
0.658,1e-05,247,257,100,100,0.01,504,2
0.704,1e-05,304,300,100,100,0.01,604,2
0.732,1e-05,355,349,100,100,0.01,704,2
0.788,1e-05,402,402,100,100,0.01,804,2
0.832,1e-05,453,451,100,100,0.01,904,2
0.898,1e-05,507,497,100,100,0.01,1004,2
0.934,1e-05,560,544,100,100,0.01,1104,2
0.954,1e-05,608,596,100,100,0.01,1204,2
0.96,1e-05,661,643,100,100,0.01,1304,2
0.966,1e-05,705,699,100,100,0.01,1404,2
0.968,1e-05,755,749,100,100,0.01,1504,2
0.974,1e-05,800,804,100,100,0.01,1604,2
0.97,1e-05,841,863,100,100,0.01,1704,2
0.97,1e-05,900,904,100,100,0.01,1804,2
0.976,1e-05,952,952,100,100,0.01,1904,2
0.974,1e-05,1001,1003,100,100,0.01,2004,2
0.552,1e-05,50,54,100,100,0.01,104,3
0.586,1e-05,96,108,100,100,0.01,204,3
0.602,1e-05,143,161,100,100,0.01,304,3
0.59,1e-05,200,204,100,100,0.01,404,3
0.594,1e-05,255,249,100,100,0.01,504,3
0.64,1e-05,305,299,100,100,0.01,604,3
0.692,1e-05,350,354,100,100,0.01,704,3
0.768,1e-05,399,405,100,100,0.01,804,3
0.804,1e-05,456,448,100,100,0.01,904,3
0.868,1e-05,510,494,100,100,0.01,1004,3
0.912,1e-05,562,542,100,100,0.01,1104,3
0.92,1e-05,612,592,100,100,0.01,1204,3
0.922,1e-05,665,639,100,100,0.01,1304,3
0.934,1e-05,716,688,100,100,0.01,1404,3
0.934,1e-05,768,736,100,100,0.01,1504,3
0.942,1e-05,808,796,100,100,0.01,1604,3
0.946,1e-05,866,838,100,100,0.01,1704,3
0.954,1e-05,909,895,100,100,0.01,1804,3
0.96,1e-05,961,943,100,100,0.01,1904,3
0.966,1e-05,1018,986,100,100,0.01,2004,3
0.572,1e-05,59,45,100,100,0.01,104,4
0.604,1e-05,107,97,100,100,0.01,204,4
0.596,1e-05,159,145,100,100,0.01,304,4
0.6,1e-05,212,192,100,100,0.01,404,4
0.604,1e-05,260,244,100,100,0.01,504,4
0.628,1e-05,311,293,100,100,0.01,604,4
0.666,1e-05,363,341,100,100,0.01,704,4
0.716,1e-05,414,390,100,100,0.01,804,4
0.768,1e-05,452,452,100,100,0.01,904,4
0.808,1e-05,506,498,100,100,0.01,1004,4
0.87,1e-05,553,551,100,100,0.01,1104,4
0.914,1e-05,610,594,100,100,0.01,1204,4
0.922,1e-05,653,651,100,100,0.01,1304,4
0.94,1e-05,702,702,100,100,0.01,1404,4
0.952,1e-05,755,749,100,100,0.01,1504,4
0.966,1e-05,806,798,100,100,0.01,1604,4
0.958,1e-05,853,851,100,100,0.01,1704,4
0.962,1e-05,899,905,100,100,0.01,1804,4
0.97,1e-05,949,955,100,100,0.01,1904,4
0.968,1e-05,998,1006,100,100,0.01,2004,4
0.576,1e-05,47,57,100,100,0.01,104,5
0.604,1e-05,100,104,100,100,0.01,204,5
0.616,1e-05,161,143,100,100,0.01,304,5
0.628,1e-05,205,199,100,100,0.01,404,5
0.64,1e-05,249,255,100,100,0.01,504,5
0.706,1e-05,304,300,100,100,0.01,604,5
0.698,1e-05,354,350,100,100,0.01,704,5
0.754,1e-05,407,397,100,100,0.01,804,5
0.794,1e-05,464,440,100,100,0.01,904,5
0.846,1e-05,509,495,100,100,0.01,1004,5
0.876,1e-05,562,542,100,100,0.01,1104,5
0.912,1e-05,608,596,100,100,0.01,1204,5
0.932,1e-05,656,648,100,100,0.01,1304,5
0.938,1e-05,702,702,100,100,0.01,1404,5
0.95,1e-05,746,758,100,100,0.01,1504,5
0.95,1e-05,801,803,100,100,0.01,1604,5
0.954,1e-05,848,856,100,100,0.01,1704,5
0.958,1e-05,903,901,100,100,0.01,1804,5
0.964,1e-05,962,942,100,100,0.01,1904,5
0.962,1e-05,1016,988,100,100,0.01,2004,5
0.57,1e-05,56,48,100,100,0.01,104,6
0.62,1e-05,108,96,100,100,0.01,204,6
0.582,1e-05,155,149,100,100,0.01,304,6
0.614,1e-05,205,199,100,100,0.01,404,6
0.636,1e-05,252,252,100,100,0.01,504,6
0.676,1e-05,302,302,100,100,0.01,604,6
0.7,1e-05,352,352,100,100,0.01,704,6
0.748,1e-05,396,408,100,100,0.01,804,6
0.762,1e-05,454,450,100,100,0.01,904,6
0.822,1e-05,499,505,100,100,0.01,1004,6
0.836,1e-05,555,549,100,100,0.01,1104,6
0.896,1e-05,605,599,100,100,0.01,1204,6
0.904,1e-05,658,646,100,100,0.01,1304,6
0.924,1e-05,702,702,100,100,0.01,1404,6
0.948,1e-05,752,752,100,100,0.01,1504,6
0.954,1e-05,804,800,100,100,0.01,1604,6
0.958,1e-05,848,856,100,100,0.01,1704,6
0.966,1e-05,897,907,100,100,0.01,1804,6
0.966,1e-05,946,958,100,100,0.01,1904,6
0.97,1e-05,991,1013,100,100,0.01,2004,6
0.528,1e-05,64,40,100,100,0.01,104,7
0.514,1e-05,114,90,100,100,0.01,204,7
0.522,1e-05,166,138,100,100,0.01,304,7
0.564,1e-05,210,194,100,100,0.01,404,7
0.586,1e-05,268,236,100,100,0.01,504,7
0.616,1e-05,316,288,100,100,0.01,604,7
0.648,1e-05,365,339,100,100,0.01,704,7
0.71,1e-05,417,387,100,100,0.01,804,7
0.748,1e-05,468,436,100,100,0.01,904,7
0.822,1e-05,505,499,100,100,0.01,1004,7
0.836,1e-05,550,554,100,100,0.01,1104,7
0.882,1e-05,598,606,100,100,0.01,1204,7
0.878,1e-05,643,661,100,100,0.01,1304,7
0.9,1e-05,682,722,100,100,0.01,1404,7
0.924,1e-05,733,771,100,100,0.01,1504,7
0.938,1e-05,791,813,100,100,0.01,1604,7
0.942,1e-05,847,857,100,100,0.01,1704,7
0.952,1e-05,894,910,100,100,0.01,1804,7
0.956,1e-05,947,957,100,100,0.01,1904,7
0.964,1e-05,1003,1001,100,100,0.01,2004,7
0.492,1e-05,50,54,100,100,0.01,104,8
0.5,1e-05,96,108,100,100,0.01,204,8
0.506,1e-05,152,152,100,100,0.01,304,8
0.566,1e-05,204,200,100,100,0.01,404,8
0.636,1e-05,250,254,100,100,0.01,504,8
0.678,1e-05,305,299,100,100,0.01,604,8
0.714,1e-05,355,349,100,100,0.01,704,8
0.768,1e-05,411,393,100,100,0.01,804,8
0.816,1e-05,453,451,100,100,0.01,904,8
0.876,1e-05,508,496,100,100,0.01,1004,8
0.888,1e-05,550,554,100,100,0.01,1104,8
0.926,1e-05,598,606,100,100,0.01,1204,8
0.932,1e-05,652,652,100,100,0.01,1304,8
0.936,1e-05,700,704,100,100,0.01,1404,8
0.952,1e-05,753,751,100,100,0.01,1504,8
0.952,1e-05,798,806,100,100,0.01,1604,8
0.954,1e-05,851,853,100,100,0.01,1704,8
0.958,1e-05,898,906,100,100,0.01,1804,8
0.956,1e-05,948,956,100,100,0.01,1904,8
0.958,1e-05,1012,992,100,100,0.01,2004,8
0.536,1e-05,57,47,100,100,0.01,104,9
0.516,1e-05,104,100,100,100,0.01,204,9
0.532,1e-05,145,159,100,100,0.01,304,9
0.582,1e-05,191,213,100,100,0.01,404,9
0.608,1e-05,239,265,100,100,0.01,504,9
0.624,1e-05,294,310,100,100,0.01,604,9
0.638,1e-05,341,363,100,100,0.01,704,9
0.684,1e-05,390,414,100,100,0.01,804,9
0.728,1e-05,445,459,100,100,0.01,904,9
0.782,1e-05,495,509,100,100,0.01,1004,9
0.834,1e-05,546,558,100,100,0.01,1104,9
0.874,1e-05,597,607,100,100,0.01,1204,9
0.908,1e-05,640,664,100,100,0.01,1304,9
0.922,1e-05,689,715,100,100,0.01,1404,9
0.936,1e-05,735,769,100,100,0.01,1504,9
0.932,1e-05,777,827,100,100,0.01,1604,9
0.936,1e-05,833,871,100,100,0.01,1704,9
0.938,1e-05,892,912,100,100,0.01,1804,9
0.926,1e-05,944,960,100,100,0.01,1904,9
0.938,1e-05,994,1010,100,100,0.01,2004,9
0.518,1e-05,53,51,100,100,0.01,104,10
0.56,1e-05,104,100,100,100,0.01,204,10
0.574,1e-05,151,153,100,100,0.01,304,10
0.586,1e-05,206,198,100,100,0.01,404,10
0.638,1e-05,258,246,100,100,0.01,504,10
0.678,1e-05,310,294,100,100,0.01,604,10
0.684,1e-05,366,338,100,100,0.01,704,10
0.73,1e-05,413,391,100,100,0.01,804,10
0.748,1e-05,468,436,100,100,0.01,904,10
0.804,1e-05,523,481,100,100,0.01,1004,10
0.836,1e-05,565,539,100,100,0.01,1104,10
0.874,1e-05,618,586,100,100,0.01,1204,10
0.916,1e-05,666,638,100,100,0.01,1304,10
0.946,1e-05,711,693,100,100,0.01,1404,10
0.956,1e-05,758,746,100,100,0.01,1504,10
0.964,1e-05,802,802,100,100,0.01,1604,10
0.964,1e-05,852,852,100,100,0.01,1704,10
0.964,1e-05,904,900,100,100,0.01,1804,10
0.966,1e-05,961,943,100,100,0.01,1904,10
0.97,1e-05,1015,989,100,100,0.01,2004,10
0.534,1e-05,47,57,100,100,0.01,104,11
0.548,1e-05,94,110,100,100,0.01,204,11
0.602,1e-05,139,165,100,100,0.01,304,11
0.662,1e-05,195,209,100,100,0.01,404,11
0.686,1e-05,248,256,100,100,0.01,504,11
0.704,1e-05,295,309,100,100,0.01,604,11
0.742,1e-05,347,357,100,100,0.01,704,11
0.78,1e-05,404,400,100,100,0.01,804,11
0.838,1e-05,452,452,100,100,0.01,904,11
0.862,1e-05,501,503,100,100,0.01,1004,11
0.884,1e-05,557,547,100,100,0.01,1104,11
0.916,1e-05,612,592,100,100,0.01,1204,11
0.908,1e-05,664,640,100,100,0.01,1304,11
0.928,1e-05,704,700,100,100,0.01,1404,11
0.938,1e-05,751,753,100,100,0.01,1504,11
0.934,1e-05,799,805,100,100,0.01,1604,11
0.944,1e-05,843,861,100,100,0.01,1704,11
0.942,1e-05,891,913,100,100,0.01,1804,11
0.952,1e-05,946,958,100,100,0.01,1904,11
0.948,1e-05,991,1013,100,100,0.01,2004,11
0.538,1e-05,48,56,100,100,0.01,104,12
0.58,1e-05,86,118,100,100,0.01,204,12
0.614,1e-05,142,162,100,100,0.01,304,12
0.634,1e-05,192,212,100,100,0.01,404,12
0.652,1e-05,243,261,100,100,0.01,504,12
0.686,1e-05,303,301,100,100,0.01,604,12
0.712,1e-05,358,346,100,100,0.01,704,12
0.74,1e-05,403,401,100,100,0.01,804,12
0.778,1e-05,449,455,100,100,0.01,904,12
0.82,1e-05,502,502,100,100,0.01,1004,12
0.848,1e-05,554,550,100,100,0.01,1104,12
0.888,1e-05,611,593,100,100,0.01,1204,12
0.906,1e-05,653,651,100,100,0.01,1304,12
0.922,1e-05,706,698,100,100,0.01,1404,12
0.928,1e-05,756,748,100,100,0.01,1504,12
0.936,1e-05,810,794,100,100,0.01,1604,12
0.932,1e-05,854,850,100,100,0.01,1704,12
0.94,1e-05,916,888,100,100,0.01,1804,12
0.942,1e-05,964,940,100,100,0.01,1904,12
0.944,1e-05,1010,994,100,100,0.01,2004,12
0.52,1e-05,61,43,100,100,0.01,104,13
0.518,1e-05,110,94,100,100,0.01,204,13
0.524,1e-05,159,145,100,100,0.01,304,13
0.526,1e-05,209,195,100,100,0.01,404,13
0.566,1e-05,266,238,100,100,0.01,504,13
0.604,1e-05,311,293,100,100,0.01,604,13
0.644,1e-05,363,341,100,100,0.01,704,13
0.672,1e-05,413,391,100,100,0.01,804,13
0.73,1e-05,468,436,100,100,0.01,904,13
0.796,1e-05,523,481,100,100,0.01,1004,13
0.85,1e-05,570,534,100,100,0.01,1104,13
0.876,1e-05,617,587,100,100,0.01,1204,13
0.902,1e-05,673,631,100,100,0.01,1304,13
0.924,1e-05,721,683,100,100,0.01,1404,13
0.926,1e-05,763,741,100,100,0.01,1504,13
0.932,1e-05,819,785,100,100,0.01,1604,13
0.938,1e-05,864,840,100,100,0.01,1704,13
0.938,1e-05,912,892,100,100,0.01,1804,13
0.944,1e-05,962,942,100,100,0.01,1904,13
0.952,1e-05,1009,995,100,100,0.01,2004,13
0.508,1e-05,52,52,100,100,0.01,104,14
0.544,1e-05,99,105,100,100,0.01,204,14
0.532,1e-05,153,151,100,100,0.01,304,14
0.554,1e-05,207,197,100,100,0.01,404,14
0.584,1e-05,255,249,100,100,0.01,504,14
0.622,1e-05,299,305,100,100,0.01,604,14
0.64,1e-05,345,359,100,100,0.01,704,14
0.71,1e-05,400,404,100,100,0.01,804,14
0.778,1e-05,457,447,100,100,0.01,904,14
0.876,1e-05,506,498,100,100,0.01,1004,14
0.916,1e-05,550,554,100,100,0.01,1104,14
0.938,1e-05,613,591,100,100,0.01,1204,14
0.95,1e-05,661,643,100,100,0.01,1304,14
0.958,1e-05,713,691,100,100,0.01,1404,14
0.958,1e-05,756,748,100,100,0.01,1504,14
0.954,1e-05,798,806,100,100,0.01,1604,14
0.96,1e-05,836,868,100,100,0.01,1704,14
0.954,1e-05,880,924,100,100,0.01,1804,14
0.964,1e-05,932,972,100,100,0.01,1904,14
0.964,1e-05,992,1012,100,100,0.01,2004,14
0.548,1e-05,52,52,100,100,0.01,104,15
0.57,1e-05,100,104,100,100,0.01,204,15
0.592,1e-05,146,158,100,100,0.01,304,15
0.628,1e-05,199,205,100,100,0.01,404,15
0.654,1e-05,244,260,100,100,0.01,504,15
0.69,1e-05,301,303,100,100,0.01,604,15
0.736,1e-05,347,357,100,100,0.01,704,15
0.766,1e-05,395,409,100,100,0.01,804,15
0.822,1e-05,444,460,100,100,0.01,904,15
0.858,1e-05,498,506,100,100,0.01,1004,15
0.874,1e-05,553,551,100,100,0.01,1104,15
0.918,1e-05,606,598,100,100,0.01,1204,15
0.93,1e-05,650,654,100,100,0.01,1304,15
0.938,1e-05,690,714,100,100,0.01,1404,15
0.942,1e-05,745,759,100,100,0.01,1504,15
0.938,1e-05,791,813,100,100,0.01,1604,15
0.944,1e-05,839,865,100,100,0.01,1704,15
0.952,1e-05,889,915,100,100,0.01,1804,15
0.946,1e-05,941,963,100,100,0.01,1904,15
0.944,1e-05,989,1015,100,100,0.01,2004,15
0.492,1e-05,50,54,100,100,0.01,104,16
0.562,1e-05,102,102,100,100,0.01,204,16
0.554,1e-05,148,156,100,100,0.01,304,16
0.582,1e-05,197,207,100,100,0.01,404,16
0.608,1e-05,253,251,100,100,0.01,504,16
0.632,1e-05,308,296,100,100,0.01,604,16
0.658,1e-05,356,348,100,100,0.01,704,16
0.732,1e-05,411,393,100,100,0.01,804,16
0.776,1e-05,463,441,100,100,0.01,904,16
0.828,1e-05,507,497,100,100,0.01,1004,16
0.868,1e-05,556,548,100,100,0.01,1104,16
0.912,1e-05,603,601,100,100,0.01,1204,16
0.924,1e-05,645,659,100,100,0.01,1304,16
0.93,1e-05,693,711,100,100,0.01,1404,16
0.938,1e-05,743,761,100,100,0.01,1504,16
0.95,1e-05,794,810,100,100,0.01,1604,16
0.952,1e-05,847,857,100,100,0.01,1704,16
0.956,1e-05,901,903,100,100,0.01,1804,16
0.956,1e-05,949,955,100,100,0.01,1904,16
0.96,1e-05,997,1007,100,100,0.01,2004,16
0.524,1e-05,58,46,100,100,0.01,104,17
0.558,1e-05,114,90,100,100,0.01,204,17
0.542,1e-05,164,140,100,100,0.01,304,17
0.554,1e-05,219,185,100,100,0.01,404,17
0.596,1e-05,269,235,100,100,0.01,504,17
0.65,1e-05,317,287,100,100,0.01,604,17
0.676,1e-05,365,339,100,100,0.01,704,17
0.736,1e-05,413,391,100,100,0.01,804,17
0.792,1e-05,457,447,100,100,0.01,904,17
0.842,1e-05,506,498,100,100,0.01,1004,17
0.888,1e-05,553,551,100,100,0.01,1104,17
0.916,1e-05,605,599,100,100,0.01,1204,17
0.928,1e-05,657,647,100,100,0.01,1304,17
0.936,1e-05,709,695,100,100,0.01,1404,17
0.948,1e-05,760,744,100,100,0.01,1504,17
0.956,1e-05,810,794,100,100,0.01,1604,17
0.958,1e-05,860,844,100,100,0.01,1704,17
0.966,1e-05,910,894,100,100,0.01,1804,17
0.966,1e-05,950,954,100,100,0.01,1904,17
0.974,1e-05,1000,1004,100,100,0.01,2004,17
0.554,1e-05,52,52,100,100,0.01,104,18
0.61,1e-05,102,102,100,100,0.01,204,18
0.606,1e-05,150,154,100,100,0.01,304,18
0.622,1e-05,199,205,100,100,0.01,404,18
0.614,1e-05,251,253,100,100,0.01,504,18
0.648,1e-05,294,310,100,100,0.01,604,18
0.688,1e-05,344,360,100,100,0.01,704,18
0.758,1e-05,388,416,100,100,0.01,804,18
0.814,1e-05,441,463,100,100,0.01,904,18
0.87,1e-05,489,515,100,100,0.01,1004,18
0.886,1e-05,528,576,100,100,0.01,1104,18
0.882,1e-05,577,627,100,100,0.01,1204,18
0.904,1e-05,629,675,100,100,0.01,1304,18
0.932,1e-05,685,719,100,100,0.01,1404,18
0.93,1e-05,736,768,100,100,0.01,1504,18
0.942,1e-05,792,812,100,100,0.01,1604,18
0.948,1e-05,838,866,100,100,0.01,1704,18
0.954,1e-05,892,912,100,100,0.01,1804,18
0.958,1e-05,944,960,100,100,0.01,1904,18
0.958,1e-05,996,1008,100,100,0.01,2004,18
0.504,1e-05,49,55,100,100,0.01,104,19
0.526,1e-05,97,107,100,100,0.01,204,19
0.562,1e-05,159,145,100,100,0.01,304,19
0.594,1e-05,208,196,100,100,0.01,404,19
0.614,1e-05,261,243,100,100,0.01,504,19
0.664,1e-05,307,297,100,100,0.01,604,19
0.682,1e-05,359,345,100,100,0.01,704,19
0.74,1e-05,408,396,100,100,0.01,804,19
0.804,1e-05,453,451,100,100,0.01,904,19
0.844,1e-05,507,497,100,100,0.01,1004,19
0.852,1e-05,556,548,100,100,0.01,1104,19
0.874,1e-05,603,601,100,100,0.01,1204,19
0.912,1e-05,655,649,100,100,0.01,1304,19
0.936,1e-05,705,699,100,100,0.01,1404,19
0.94,1e-05,757,747,100,100,0.01,1504,19
0.948,1e-05,804,800,100,100,0.01,1604,19
0.948,1e-05,860,844,100,100,0.01,1704,19
0.958,1e-05,914,890,100,100,0.01,1804,19
0.962,1e-05,962,942,100,100,0.01,1904,19
0.956,1e-05,1003,1001,100,100,0.01,2004,19
0.564,1e-05,47,57,100,100,0.01,104,20
0.558,1e-05,93,111,100,100,0.01,204,20
0.574,1e-05,142,162,100,100,0.01,304,20
0.632,1e-05,185,219,100,100,0.01,404,20
0.648,1e-05,236,268,100,100,0.01,504,20
0.704,1e-05,284,320,100,100,0.01,604,20
0.742,1e-05,331,373,100,100,0.01,704,20
0.794,1e-05,395,409,100,100,0.01,804,20
0.84,1e-05,448,456,100,100,0.01,904,20
0.864,1e-05,497,507,100,100,0.01,1004,20
0.876,1e-05,549,555,100,100,0.01,1104,20
0.898,1e-05,599,605,100,100,0.01,1204,20
0.912,1e-05,646,658,100,100,0.01,1304,20
0.91,1e-05,690,714,100,100,0.01,1404,20
0.93,1e-05,736,768,100,100,0.01,1504,20
0.93,1e-05,785,819,100,100,0.01,1604,20
0.934,1e-05,843,861,100,100,0.01,1704,20
0.942,1e-05,900,904,100,100,0.01,1804,20
0.938,1e-05,954,950,100,100,0.01,1904,20
0.94,1e-05,1005,999,100,100,0.01,2004,20
0.528,0.0001,49,55,100,100,0.0001,104,1
0.526,0.0001,104,100,100,100,0.0001,204,1
0.522,0.0001,152,152,100,100,0.0001,304,1
0.522,0.0001,197,207,100,100,0.0001,404,1
0.522,0.0001,254,250,100,100,0.0001,504,1
0.524,0.0001,298,306,100,100,0.0001,604,1
0.526,0.0001,350,354,100,100,0.0001,704,1
0.53,0.0001,415,389,100,100,0.0001,804,1
0.532,0.0001,469,435,100,100,0.0001,904,1
0.534,0.0001,521,483,100,100,0.0001,1004,1
0.53,0.0001,572,532,100,100,0.0001,1104,1
0.528,0.0001,625,579,100,100,0.0001,1204,1
0.532,0.0001,671,633,100,100,0.0001,1304,1
0.536,0.0001,718,686,100,100,0.0001,1404,1
0.53,0.0001,770,734,100,100,0.0001,1504,1
0.54,0.0001,817,787,100,100,0.0001,1604,1
0.544,0.0001,866,838,100,100,0.0001,1704,1
0.548,0.0001,912,892,100,100,0.0001,1804,1
0.55,0.0001,964,940,100,100,0.0001,1904,1
0.558,0.0001,1012,992,100,100,0.0001,2004,1
0.482,0.0001,47,57,100,100,0.0001,104,2
0.482,0.0001,92,112,100,100,0.0001,204,2
0.482,0.0001,141,163,100,100,0.0001,304,2
0.486,0.0001,198,206,100,100,0.0001,404,2
0.486,0.0001,248,256,100,100,0.0001,504,2
0.484,0.0001,294,310,100,100,0.0001,604,2
0.486,0.0001,348,356,100,100,0.0001,704,2
0.486,0.0001,397,407,100,100,0.0001,804,2
0.482,0.0001,446,458,100,100,0.0001,904,2
0.482,0.0001,500,504,100,100,0.0001,1004,2
0.48,0.0001,554,550,100,100,0.0001,1104,2
0.478,0.0001,600,604,100,100,0.0001,1204,2
0.482,0.0001,637,667,100,100,0.0001,1304,2
0.482,0.0001,685,719,100,100,0.0001,1404,2
0.488,0.0001,735,769,100,100,0.0001,1504,2
0.5,0.0001,785,819,100,100,0.0001,1604,2
0.502,0.0001,844,860,100,100,0.0001,1704,2
0.508,0.0001,905,899,100,100,0.0001,1804,2
0.508,0.0001,952,952,100,100,0.0001,1904,2
0.51,0.0001,995,1009,100,100,0.0001,2004,2
0.454,0.0001,51,53,100,100,0.0001,104,3
0.456,0.0001,101,103,100,100,0.0001,204,3
0.456,0.0001,152,152,100,100,0.0001,304,3
0.458,0.0001,199,205,100,100,0.0001,404,3
0.46,0.0001,240,264,100,100,0.0001,504,3
0.462,0.0001,278,326,100,100,0.0001,604,3
0.46,0.0001,322,382,100,100,0.0001,704,3
0.46,0.0001,369,435,100,100,0.0001,804,3
0.46,0.0001,410,494,100,100,0.0001,904,3
0.46,0.0001,459,545,100,100,0.0001,1004,3
0.46,0.0001,509,595,100,100,0.0001,1104,3
0.464,0.0001,561,643,100,100,0.0001,1204,3
0.464,0.0001,617,687,100,100,0.0001,1304,3
0.47,0.0001,666,738,100,100,0.0001,1404,3
0.47,0.0001,712,792,100,100,0.0001,1504,3
0.474,0.0001,765,839,100,100,0.0001,1604,3
0.478,0.0001,819,885,100,100,0.0001,1704,3
0.48,0.0001,874,930,100,100,0.0001,1804,3
0.48,0.0001,926,978,100,100,0.0001,1904,3
0.48,0.0001,980,1024,100,100,0.0001,2004,3
0.446,0.0001,55,49,100,100,0.0001,104,4
0.448,0.0001,104,100,100,100,0.0001,204,4
0.448,0.0001,157,147,100,100,0.0001,304,4
0.45,0.0001,207,197,100,100,0.0001,404,4
0.446,0.0001,254,250,100,100,0.0001,504,4
0.452,0.0001,302,302,100,100,0.0001,604,4
0.454,0.0001,351,353,100,100,0.0001,704,4
0.452,0.0001,401,403,100,100,0.0001,804,4
0.45,0.0001,456,448,100,100,0.0001,904,4
0.452,0.0001,508,496,100,100,0.0001,1004,4
0.45,0.0001,554,550,100,100,0.0001,1104,4
0.448,0.0001,607,597,100,100,0.0001,1204,4
0.452,0.0001,664,640,100,100,0.0001,1304,4
0.454,0.0001,707,697,100,100,0.0001,1404,4
0.456,0.0001,754,750,100,100,0.0001,1504,4
0.462,0.0001,803,801,100,100,0.0001,1604,4
0.476,0.0001,857,847,100,100,0.0001,1704,4
0.484,0.0001,910,894,100,100,0.0001,1804,4
0.484,0.0001,961,943,100,100,0.0001,1904,4
0.496,0.0001,1002,1002,100,100,0.0001,2004,4
0.462,0.0001,49,55,100,100,0.0001,104,5
0.462,0.0001,97,107,100,100,0.0001,204,5
0.462,0.0001,144,160,100,100,0.0001,304,5
0.462,0.0001,200,204,100,100,0.0001,404,5
0.462,0.0001,249,255,100,100,0.0001,504,5
0.464,0.0001,294,310,100,100,0.0001,604,5
0.466,0.0001,350,354,100,100,0.0001,704,5
0.468,0.0001,405,399,100,100,0.0001,804,5
0.47,0.0001,449,455,100,100,0.0001,904,5
0.47,0.0001,496,508,100,100,0.0001,1004,5
0.468,0.0001,538,566,100,100,0.0001,1104,5
0.47,0.0001,598,606,100,100,0.0001,1204,5
0.47,0.0001,657,647,100,100,0.0001,1304,5
0.466,0.0001,695,709,100,100,0.0001,1404,5
0.47,0.0001,749,755,100,100,0.0001,1504,5
0.476,0.0001,805,799,100,100,0.0001,1604,5
0.478,0.0001,860,844,100,100,0.0001,1704,5
0.474,0.0001,903,901,100,100,0.0001,1804,5
0.472,0.0001,951,953,100,100,0.0001,1904,5
0.476,0.0001,1011,993,100,100,0.0001,2004,5
0.508,0.0001,49,55,100,100,0.0001,104,6
0.508,0.0001,101,103,100,100,0.0001,204,6
0.508,0.0001,154,150,100,100,0.0001,304,6
0.512,0.0001,203,201,100,100,0.0001,404,6
0.516,0.0001,250,254,100,100,0.0001,504,6
0.514,0.0001,298,306,100,100,0.0001,604,6
0.518,0.0001,350,354,100,100,0.0001,704,6
0.524,0.0001,405,399,100,100,0.0001,804,6
0.528,0.0001,463,441,100,100,0.0001,904,6
0.53,0.0001,507,497,100,100,0.0001,1004,6
0.532,0.0001,560,544,100,100,0.0001,1104,6
0.53,0.0001,612,592,100,100,0.0001,1204,6
0.526,0.0001,657,647,100,100,0.0001,1304,6
0.526,0.0001,709,695,100,100,0.0001,1404,6
0.522,0.0001,762,742,100,100,0.0001,1504,6
0.522,0.0001,812,792,100,100,0.0001,1604,6
0.524,0.0001,857,847,100,100,0.0001,1704,6
0.53,0.0001,906,898,100,100,0.0001,1804,6
0.532,0.0001,958,946,100,100,0.0001,1904,6
0.546,0.0001,1015,989,100,100,0.0001,2004,6
0.51,0.0001,62,42,100,100,0.0001,104,7
0.508,0.0001,109,95,100,100,0.0001,204,7
0.508,0.0001,150,154,100,100,0.0001,304,7
0.506,0.0001,199,205,100,100,0.0001,404,7
0.506,0.0001,249,255,100,100,0.0001,504,7
0.508,0.0001,299,305,100,100,0.0001,604,7
0.508,0.0001,340,364,100,100,0.0001,704,7
0.508,0.0001,386,418,100,100,0.0001,804,7
0.51,0.0001,439,465,100,100,0.0001,904,7
0.51,0.0001,490,514,100,100,0.0001,1004,7
0.51,0.0001,537,567,100,100,0.0001,1104,7
0.51,0.0001,581,623,100,100,0.0001,1204,7
0.51,0.0001,632,672,100,100,0.0001,1304,7
0.51,0.0001,686,718,100,100,0.0001,1404,7
0.51,0.0001,734,770,100,100,0.0001,1504,7
0.508,0.0001,787,817,100,100,0.0001,1604,7
0.51,0.0001,843,861,100,100,0.0001,1704,7
0.51,0.0001,895,909,100,100,0.0001,1804,7
0.508,0.0001,945,959,100,100,0.0001,1904,7
0.502,0.0001,994,1010,100,100,0.0001,2004,7
0.46,0.0001,56,48,100,100,0.0001,104,8
0.462,0.0001,112,92,100,100,0.0001,204,8
0.46,0.0001,159,145,100,100,0.0001,304,8
0.464,0.0001,209,195,100,100,0.0001,404,8
0.468,0.0001,261,243,100,100,0.0001,504,8
0.466,0.0001,312,292,100,100,0.0001,604,8
0.466,0.0001,358,346,100,100,0.0001,704,8
0.466,0.0001,415,389,100,100,0.0001,804,8
0.462,0.0001,465,439,100,100,0.0001,904,8
0.462,0.0001,516,488,100,100,0.0001,1004,8
0.466,0.0001,564,540,100,100,0.0001,1104,8
0.466,0.0001,618,586,100,100,0.0001,1204,8
0.466,0.0001,662,642,100,100,0.0001,1304,8
0.47,0.0001,712,692,100,100,0.0001,1404,8
0.474,0.0001,757,747,100,100,0.0001,1504,8
0.478,0.0001,817,787,100,100,0.0001,1604,8
0.484,0.0001,871,833,100,100,0.0001,1704,8
0.488,0.0001,921,883,100,100,0.0001,1804,8
0.484,0.0001,966,938,100,100,0.0001,1904,8
0.492,0.0001,1014,990,100,100,0.0001,2004,8
0.49,0.0001,45,59,100,100,0.0001,104,9
0.492,0.0001,98,106,100,100,0.0001,204,9
0.496,0.0001,150,154,100,100,0.0001,304,9
0.498,0.0001,203,201,100,100,0.0001,404,9
0.496,0.0001,258,246,100,100,0.0001,504,9
0.502,0.0001,302,302,100,100,0.0001,604,9
0.504,0.0001,351,353,100,100,0.0001,704,9
0.502,0.0001,402,402,100,100,0.0001,804,9
0.502,0.0001,458,446,100,100,0.0001,904,9
0.502,0.0001,506,498,100,100,0.0001,1004,9
0.502,0.0001,547,557,100,100,0.0001,1104,9
0.504,0.0001,597,607,100,100,0.0001,1204,9
0.512,0.0001,650,654,100,100,0.0001,1304,9
0.512,0.0001,702,702,100,100,0.0001,1404,9
0.522,0.0001,754,750,100,100,0.0001,1504,9
0.522,0.0001,809,795,100,100,0.0001,1604,9
0.524,0.0001,863,841,100,100,0.0001,1704,9
0.526,0.0001,911,893,100,100,0.0001,1804,9
0.53,0.0001,964,940,100,100,0.0001,1904,9
0.53,0.0001,1016,988,100,100,0.0001,2004,9
0.496,0.0001,54,50,100,100,0.0001,104,10
0.496,0.0001,101,103,100,100,0.0001,204,10
0.494,0.0001,157,147,100,100,0.0001,304,10
0.496,0.0001,205,199,100,100,0.0001,404,10
0.496,0.0001,259,245,100,100,0.0001,504,10
0.494,0.0001,324,280,100,100,0.0001,604,10
0.492,0.0001,368,336,100,100,0.0001,704,10
0.498,0.0001,420,384,100,100,0.0001,804,10
0.502,0.0001,470,434,100,100,0.0001,904,10
0.508,0.0001,523,481,100,100,0.0001,1004,10
0.51,0.0001,572,532,100,100,0.0001,1104,10
0.508,0.0001,621,583,100,100,0.0001,1204,10
0.508,0.0001,667,637,100,100,0.0001,1304,10
0.504,0.0001,710,694,100,100,0.0001,1404,10
0.504,0.0001,757,747,100,100,0.0001,1504,10
0.502,0.0001,812,792,100,100,0.0001,1604,10
0.502,0.0001,861,843,100,100,0.0001,1704,10
0.504,0.0001,906,898,100,100,0.0001,1804,10
0.502,0.0001,962,942,100,100,0.0001,1904,10
0.502,0.0001,1007,997,100,100,0.0001,2004,10
0.526,0.0001,52,52,100,100,0.0001,104,11
0.53,0.0001,112,92,100,100,0.0001,204,11
0.526,0.0001,157,147,100,100,0.0001,304,11
0.528,0.0001,202,202,100,100,0.0001,404,11
0.526,0.0001,245,259,100,100,0.0001,504,11
0.528,0.0001,294,310,100,100,0.0001,604,11
0.532,0.0001,350,354,100,100,0.0001,704,11
0.528,0.0001,402,402,100,100,0.0001,804,11
0.528,0.0001,451,453,100,100,0.0001,904,11
0.532,0.0001,496,508,100,100,0.0001,1004,11
0.53,0.0001,551,553,100,100,0.0001,1104,11
0.53,0.0001,604,600,100,100,0.0001,1204,11
0.53,0.0001,648,656,100,100,0.0001,1304,11
0.53,0.0001,701,703,100,100,0.0001,1404,11
0.54,0.0001,748,756,100,100,0.0001,1504,11
0.54,0.0001,808,796,100,100,0.0001,1604,11
0.548,0.0001,860,844,100,100,0.0001,1704,11
0.564,0.0001,906,898,100,100,0.0001,1804,11
0.56,0.0001,954,950,100,100,0.0001,1904,11
0.566,0.0001,996,1008,100,100,0.0001,2004,11
0.482,0.0001,56,48,100,100,0.0001,104,12
0.484,0.0001,106,98,100,100,0.0001,204,12
0.482,0.0001,156,148,100,100,0.0001,304,12
0.482,0.0001,204,200,100,100,0.0001,404,12
0.48,0.0001,263,241,100,100,0.0001,504,12
0.482,0.0001,311,293,100,100,0.0001,604,12
0.486,0.0001,352,352,100,100,0.0001,704,12
0.49,0.0001,408,396,100,100,0.0001,804,12
0.494,0.0001,464,440,100,100,0.0001,904,12
0.494,0.0001,510,494,100,100,0.0001,1004,12
0.496,0.0001,566,538,100,100,0.0001,1104,12
0.494,0.0001,617,587,100,100,0.0001,1204,12
0.496,0.0001,664,640,100,100,0.0001,1304,12
0.5,0.0001,717,687,100,100,0.0001,1404,12
0.506,0.0001,764,740,100,100,0.0001,1504,12
0.508,0.0001,819,785,100,100,0.0001,1604,12
0.514,0.0001,869,835,100,100,0.0001,1704,12
0.512,0.0001,916,888,100,100,0.0001,1804,12
0.518,0.0001,961,943,100,100,0.0001,1904,12
0.522,0.0001,1007,997,100,100,0.0001,2004,12
0.514,0.0001,56,48,100,100,0.0001,104,13
0.512,0.0001,101,103,100,100,0.0001,204,13
0.51,0.0001,155,149,100,100,0.0001,304,13
0.508,0.0001,214,190,100,100,0.0001,404,13
0.508,0.0001,258,246,100,100,0.0001,504,13
0.51,0.0001,306,298,100,100,0.0001,604,13
0.51,0.0001,353,351,100,100,0.0001,704,13
0.516,0.0001,402,402,100,100,0.0001,804,13
0.51,0.0001,448,456,100,100,0.0001,904,13
0.514,0.0001,498,506,100,100,0.0001,1004,13
0.52,0.0001,546,558,100,100,0.0001,1104,13
0.526,0.0001,597,607,100,100,0.0001,1204,13
0.524,0.0001,652,652,100,100,0.0001,1304,13
0.528,0.0001,700,704,100,100,0.0001,1404,13
0.53,0.0001,748,756,100,100,0.0001,1504,13
0.54,0.0001,795,809,100,100,0.0001,1604,13
0.542,0.0001,846,858,100,100,0.0001,1704,13
0.546,0.0001,890,914,100,100,0.0001,1804,13
0.55,0.0001,941,963,100,100,0.0001,1904,13
0.554,0.0001,989,1015,100,100,0.0001,2004,13
0.486,0.0001,44,60,100,100,0.0001,104,14
0.492,0.0001,98,106,100,100,0.0001,204,14
0.494,0.0001,152,152,100,100,0.0001,304,14
0.502,0.0001,197,207,100,100,0.0001,404,14
0.5,0.0001,249,255,100,100,0.0001,504,14
0.502,0.0001,292,312,100,100,0.0001,604,14
0.502,0.0001,346,358,100,100,0.0001,704,14
0.504,0.0001,402,402,100,100,0.0001,804,14
0.504,0.0001,445,459,100,100,0.0001,904,14
0.504,0.0001,500,504,100,100,0.0001,1004,14
0.506,0.0001,546,558,100,100,0.0001,1104,14
0.508,0.0001,595,609,100,100,0.0001,1204,14
0.506,0.0001,641,663,100,100,0.0001,1304,14
0.508,0.0001,697,707,100,100,0.0001,1404,14
0.512,0.0001,746,758,100,100,0.0001,1504,14
0.51,0.0001,792,812,100,100,0.0001,1604,14
0.514,0.0001,847,857,100,100,0.0001,1704,14
0.516,0.0001,899,905,100,100,0.0001,1804,14
0.522,0.0001,956,948,100,100,0.0001,1904,14
0.522,0.0001,1007,997,100,100,0.0001,2004,14
0.504,0.0001,47,57,100,100,0.0001,104,15
0.504,0.0001,84,120,100,100,0.0001,204,15
0.504,0.0001,132,172,100,100,0.0001,304,15
0.506,0.0001,182,222,100,100,0.0001,404,15
0.504,0.0001,228,276,100,100,0.0001,504,15
0.506,0.0001,271,333,100,100,0.0001,604,15
0.506,0.0001,329,375,100,100,0.0001,704,15
0.502,0.0001,380,424,100,100,0.0001,804,15
0.502,0.0001,430,474,100,100,0.0001,904,15
0.504,0.0001,477,527,100,100,0.0001,1004,15
0.51,0.0001,523,581,100,100,0.0001,1104,15
0.506,0.0001,575,629,100,100,0.0001,1204,15
0.508,0.0001,625,679,100,100,0.0001,1304,15
0.512,0.0001,677,727,100,100,0.0001,1404,15
0.522,0.0001,730,774,100,100,0.0001,1504,15
0.524,0.0001,783,821,100,100,0.0001,1604,15
0.52,0.0001,834,870,100,100,0.0001,1704,15
0.53,0.0001,885,919,100,100,0.0001,1804,15
0.536,0.0001,935,969,100,100,0.0001,1904,15
0.538,0.0001,993,1011,100,100,0.0001,2004,15
0.514,0.0001,54,50,100,100,0.0001,104,16
0.514,0.0001,106,98,100,100,0.0001,204,16
0.51,0.0001,156,148,100,100,0.0001,304,16
0.506,0.0001,205,199,100,100,0.0001,404,16
0.512,0.0001,249,255,100,100,0.0001,504,16
0.514,0.0001,302,302,100,100,0.0001,604,16
0.518,0.0001,349,355,100,100,0.0001,704,16
0.52,0.0001,402,402,100,100,0.0001,804,16
0.526,0.0001,452,452,100,100,0.0001,904,16
0.53,0.0001,501,503,100,100,0.0001,1004,16
0.528,0.0001,552,552,100,100,0.0001,1104,16
0.528,0.0001,594,610,100,100,0.0001,1204,16
0.538,0.0001,644,660,100,100,0.0001,1304,16
0.546,0.0001,685,719,100,100,0.0001,1404,16
0.548,0.0001,738,766,100,100,0.0001,1504,16
0.548,0.0001,799,805,100,100,0.0001,1604,16
0.544,0.0001,840,864,100,100,0.0001,1704,16
0.556,0.0001,892,912,100,100,0.0001,1804,16
0.564,0.0001,947,957,100,100,0.0001,1904,16
0.566,0.0001,1004,1000,100,100,0.0001,2004,16
0.53,0.0001,46,58,100,100,0.0001,104,17
0.528,0.0001,88,116,100,100,0.0001,204,17
0.526,0.0001,147,157,100,100,0.0001,304,17
0.53,0.0001,198,206,100,100,0.0001,404,17
0.53,0.0001,248,256,100,100,0.0001,504,17
0.532,0.0001,291,313,100,100,0.0001,604,17
0.534,0.0001,340,364,100,100,0.0001,704,17
0.532,0.0001,389,415,100,100,0.0001,804,17
0.528,0.0001,440,464,100,100,0.0001,904,17
0.534,0.0001,487,517,100,100,0.0001,1004,17
0.53,0.0001,535,569,100,100,0.0001,1104,17
0.528,0.0001,583,621,100,100,0.0001,1204,17
0.53,0.0001,635,669,100,100,0.0001,1304,17
0.54,0.0001,689,715,100,100,0.0001,1404,17
0.544,0.0001,733,771,100,100,0.0001,1504,17
0.544,0.0001,785,819,100,100,0.0001,1604,17
0.554,0.0001,829,875,100,100,0.0001,1704,17
0.548,0.0001,886,918,100,100,0.0001,1804,17
0.554,0.0001,935,969,100,100,0.0001,1904,17
0.554,0.0001,986,1018,100,100,0.0001,2004,17
0.516,0.0001,58,46,100,100,0.0001,104,18
0.518,0.0001,109,95,100,100,0.0001,204,18
0.516,0.0001,152,152,100,100,0.0001,304,18
0.516,0.0001,199,205,100,100,0.0001,404,18
0.52,0.0001,248,256,100,100,0.0001,504,18
0.526,0.0001,287,317,100,100,0.0001,604,18
0.526,0.0001,334,370,100,100,0.0001,704,18
0.528,0.0001,385,419,100,100,0.0001,804,18
0.53,0.0001,436,468,100,100,0.0001,904,18
0.53,0.0001,490,514,100,100,0.0001,1004,18
0.536,0.0001,542,562,100,100,0.0001,1104,18
0.542,0.0001,587,617,100,100,0.0001,1204,18
0.542,0.0001,646,658,100,100,0.0001,1304,18
0.55,0.0001,692,712,100,100,0.0001,1404,18
0.554,0.0001,739,765,100,100,0.0001,1504,18
0.556,0.0001,794,810,100,100,0.0001,1604,18
0.552,0.0001,848,856,100,100,0.0001,1704,18
0.554,0.0001,896,908,100,100,0.0001,1804,18
0.556,0.0001,952,952,100,100,0.0001,1904,18
0.564,0.0001,1001,1003,100,100,0.0001,2004,18
0.54,0.0001,46,58,100,100,0.0001,104,19
0.54,0.0001,99,105,100,100,0.0001,204,19
0.538,0.0001,153,151,100,100,0.0001,304,19
0.538,0.0001,196,208,100,100,0.0001,404,19
0.536,0.0001,245,259,100,100,0.0001,504,19
0.54,0.0001,292,312,100,100,0.0001,604,19
0.542,0.0001,348,356,100,100,0.0001,704,19
0.548,0.0001,395,409,100,100,0.0001,804,19
0.55,0.0001,439,465,100,100,0.0001,904,19
0.55,0.0001,489,515,100,100,0.0001,1004,19
0.558,0.0001,540,564,100,100,0.0001,1104,19
0.558,0.0001,588,616,100,100,0.0001,1204,19
0.568,0.0001,637,667,100,100,0.0001,1304,19
0.566,0.0001,690,714,100,100,0.0001,1404,19
0.566,0.0001,732,772,100,100,0.0001,1504,19
0.568,0.0001,781,823,100,100,0.0001,1604,19
0.574,0.0001,836,868,100,100,0.0001,1704,19
0.576,0.0001,885,919,100,100,0.0001,1804,19
0.578,0.0001,931,973,100,100,0.0001,1904,19
0.584,0.0001,994,1010,100,100,0.0001,2004,19
0.474,0.0001,45,59,100,100,0.0001,104,20
0.48,0.0001,86,118,100,100,0.0001,204,20
0.48,0.0001,139,165,100,100,0.0001,304,20
0.484,0.0001,187,217,100,100,0.0001,404,20
0.48,0.0001,240,264,100,100,0.0001,504,20
0.48,0.0001,284,320,100,100,0.0001,604,20
0.482,0.0001,336,368,100,100,0.0001,704,20
0.484,0.0001,387,417,100,100,0.0001,804,20
0.486,0.0001,436,468,100,100,0.0001,904,20
0.482,0.0001,488,516,100,100,0.0001,1004,20
0.488,0.0001,538,566,100,100,0.0001,1104,20
0.492,0.0001,581,623,100,100,0.0001,1204,20
0.49,0.0001,633,671,100,100,0.0001,1304,20
0.496,0.0001,693,711,100,100,0.0001,1404,20
0.502,0.0001,736,768,100,100,0.0001,1504,20
0.502,0.0001,791,813,100,100,0.0001,1604,20
0.506,0.0001,848,856,100,100,0.0001,1704,20
0.518,0.0001,900,904,100,100,0.0001,1804,20
0.532,0.0001,947,957,100,100,0.0001,1904,20
0.532,0.0001,1001,1003,100,100,0.0001,2004,20
0.48,0.0001,52,52,100,100,0.001,104,1
0.484,0.0001,111,93,100,100,0.001,204,1
0.492,0.0001,155,149,100,100,0.001,304,1
0.49,0.0001,204,200,100,100,0.001,404,1
0.5,0.0001,253,251,100,100,0.001,504,1
0.498,0.0001,299,305,100,100,0.001,604,1
0.51,0.0001,338,366,100,100,0.001,704,1
0.524,0.0001,391,413,100,100,0.001,804,1
0.534,0.0001,437,467,100,100,0.001,904,1
0.542,0.0001,488,516,100,100,0.001,1004,1
0.556,0.0001,546,558,100,100,0.001,1104,1
0.578,0.0001,588,616,100,100,0.001,1204,1
0.594,0.0001,637,667,100,100,0.001,1304,1
0.606,0.0001,690,714,100,100,0.001,1404,1
0.622,0.0001,747,757,100,100,0.001,1504,1
0.644,0.0001,796,808,100,100,0.001,1604,1
0.684,0.0001,841,863,100,100,0.001,1704,1
0.716,0.0001,892,912,100,100,0.001,1804,1
0.736,0.0001,940,964,100,100,0.001,1904,1
0.78,0.0001,992,1012,100,100,0.001,2004,1
0.512,0.0001,52,52,100,100,0.001,104,2
0.524,0.0001,97,107,100,100,0.001,204,2
0.546,0.0001,146,158,100,100,0.001,304,2
0.55,0.0001,195,209,100,100,0.001,404,2
0.56,0.0001,250,254,100,100,0.001,504,2
0.578,0.0001,306,298,100,100,0.001,604,2
0.574,0.0001,356,348,100,100,0.001,704,2
0.588,0.0001,406,398,100,100,0.001,804,2
0.588,0.0001,460,444,100,100,0.001,904,2
0.606,0.0001,513,491,100,100,0.001,1004,2
0.62,0.0001,558,546,100,100,0.001,1104,2
0.638,0.0001,601,603,100,100,0.001,1204,2
0.658,0.0001,652,652,100,100,0.001,1304,2
0.674,0.0001,706,698,100,100,0.001,1404,2
0.692,0.0001,760,744,100,100,0.001,1504,2
0.722,0.0001,816,788,100,100,0.001,1604,2
0.742,0.0001,863,841,100,100,0.001,1704,2
0.77,0.0001,912,892,100,100,0.001,1804,2
0.796,0.0001,963,941,100,100,0.001,1904,2
0.82,0.0001,1004,1000,100,100,0.001,2004,2
0.488,0.0001,61,43,100,100,0.001,104,3
0.492,0.0001,102,102,100,100,0.001,204,3
0.506,0.0001,146,158,100,100,0.001,304,3
0.516,0.0001,191,213,100,100,0.001,404,3
0.52,0.0001,248,256,100,100,0.001,504,3
0.53,0.0001,297,307,100,100,0.001,604,3
0.564,0.0001,347,357,100,100,0.001,704,3
0.586,0.0001,403,401,100,100,0.001,804,3
0.602,0.0001,457,447,100,100,0.001,904,3
0.612,0.0001,507,497,100,100,0.001,1004,3
0.628,0.0001,560,544,100,100,0.001,1104,3
0.644,0.0001,602,602,100,100,0.001,1204,3
0.666,0.0001,652,652,100,100,0.001,1304,3
0.678,0.0001,701,703,100,100,0.001,1404,3
0.696,0.0001,750,754,100,100,0.001,1504,3
0.718,0.0001,800,804,100,100,0.001,1604,3
0.74,0.0001,849,855,100,100,0.001,1704,3
0.772,0.0001,906,898,100,100,0.001,1804,3
0.794,0.0001,945,959,100,100,0.001,1904,3
0.82,0.0001,1004,1000,100,100,0.001,2004,3
0.502,0.0001,46,58,100,100,0.001,104,4
0.512,0.0001,86,118,100,100,0.001,204,4
0.516,0.0001,134,170,100,100,0.001,304,4
0.52,0.0001,188,216,100,100,0.001,404,4
0.528,0.0001,234,270,100,100,0.001,504,4
0.536,0.0001,285,319,100,100,0.001,604,4
0.536,0.0001,331,373,100,100,0.001,704,4
0.55,0.0001,380,424,100,100,0.001,804,4
0.57,0.0001,424,480,100,100,0.001,904,4
0.58,0.0001,473,531,100,100,0.001,1004,4
0.6,0.0001,528,576,100,100,0.001,1104,4
0.632,0.0001,574,630,100,100,0.001,1204,4
0.628,0.0001,627,677,100,100,0.001,1304,4
0.646,0.0001,679,725,100,100,0.001,1404,4
0.664,0.0001,728,776,100,100,0.001,1504,4
0.698,0.0001,777,827,100,100,0.001,1604,4
0.718,0.0001,839,865,100,100,0.001,1704,4
0.742,0.0001,893,911,100,100,0.001,1804,4
0.774,0.0001,944,960,100,100,0.001,1904,4
0.798,0.0001,996,1008,100,100,0.001,2004,4
0.518,0.0001,64,40,100,100,0.001,104,5
0.526,0.0001,117,87,100,100,0.001,204,5
0.526,0.0001,172,132,100,100,0.001,304,5
0.548,0.0001,219,185,100,100,0.001,404,5
0.558,0.0001,261,243,100,100,0.001,504,5
0.56,0.0001,313,291,100,100,0.001,604,5
0.564,0.0001,362,342,100,100,0.001,704,5
0.574,0.0001,418,386,100,100,0.001,804,5
0.582,0.0001,466,438,100,100,0.001,904,5
0.614,0.0001,512,492,100,100,0.001,1004,5
0.636,0.0001,561,543,100,100,0.001,1104,5
0.668,0.0001,608,596,100,100,0.001,1204,5
0.69,0.0001,664,640,100,100,0.001,1304,5
0.694,0.0001,708,696,100,100,0.001,1404,5
0.708,0.0001,753,751,100,100,0.001,1504,5
0.722,0.0001,800,804,100,100,0.001,1604,5
0.752,0.0001,853,851,100,100,0.001,1704,5
0.772,0.0001,904,900,100,100,0.001,1804,5
0.81,0.0001,957,947,100,100,0.001,1904,5
0.836,0.0001,1010,994,100,100,0.001,2004,5
0.512,0.0001,46,58,100,100,0.001,104,6
0.51,0.0001,96,108,100,100,0.001,204,6
0.506,0.0001,149,155,100,100,0.001,304,6
0.508,0.0001,198,206,100,100,0.001,404,6
0.506,0.0001,254,250,100,100,0.001,504,6
0.522,0.0001,302,302,100,100,0.001,604,6
0.532,0.0001,351,353,100,100,0.001,704,6
0.538,0.0001,396,408,100,100,0.001,804,6
0.57,0.0001,446,458,100,100,0.001,904,6
0.582,0.0001,493,511,100,100,0.001,1004,6
0.608,0.0001,541,563,100,100,0.001,1104,6
0.624,0.0001,590,614,100,100,0.001,1204,6
0.65,0.0001,646,658,100,100,0.001,1304,6
0.67,0.0001,703,701,100,100,0.001,1404,6
0.684,0.0001,752,752,100,100,0.001,1504,6
0.72,0.0001,795,809,100,100,0.001,1604,6
0.73,0.0001,837,867,100,100,0.001,1704,6
0.77,0.0001,889,915,100,100,0.001,1804,6
0.764,0.0001,942,962,100,100,0.001,1904,6
0.81,0.0001,1000,1004,100,100,0.001,2004,6
0.482,0.0001,48,56,100,100,0.001,104,7
0.486,0.0001,88,116,100,100,0.001,204,7
0.508,0.0001,138,166,100,100,0.001,304,7
0.52,0.0001,189,215,100,100,0.001,404,7
0.53,0.0001,234,270,100,100,0.001,504,7
0.534,0.0001,289,315,100,100,0.001,604,7
0.534,0.0001,340,364,100,100,0.001,704,7
0.534,0.0001,389,415,100,100,0.001,804,7
0.542,0.0001,435,469,100,100,0.001,904,7
0.544,0.0001,486,518,100,100,0.001,1004,7
0.566,0.0001,533,571,100,100,0.001,1104,7
0.584,0.0001,586,618,100,100,0.001,1204,7
0.588,0.0001,638,666,100,100,0.001,1304,7
0.608,0.0001,692,712,100,100,0.001,1404,7
0.62,0.0001,740,764,100,100,0.001,1504,7
0.654,0.0001,789,815,100,100,0.001,1604,7
0.684,0.0001,837,867,100,100,0.001,1704,7
0.714,0.0001,886,918,100,100,0.001,1804,7
0.744,0.0001,939,965,100,100,0.001,1904,7
0.768,0.0001,992,1012,100,100,0.001,2004,7
0.5,0.0001,59,45,100,100,0.001,104,8
0.512,0.0001,104,100,100,100,0.001,204,8
0.524,0.0001,153,151,100,100,0.001,304,8
0.548,0.0001,203,201,100,100,0.001,404,8
0.532,0.0001,254,250,100,100,0.001,504,8
0.552,0.0001,307,297,100,100,0.001,604,8
0.57,0.0001,352,352,100,100,0.001,704,8
0.592,0.0001,405,399,100,100,0.001,804,8
0.604,0.0001,449,455,100,100,0.001,904,8
0.626,0.0001,495,509,100,100,0.001,1004,8
0.638,0.0001,547,557,100,100,0.001,1104,8
0.67,0.0001,597,607,100,100,0.001,1204,8
0.676,0.0001,648,656,100,100,0.001,1304,8
0.688,0.0001,696,708,100,100,0.001,1404,8
0.714,0.0001,740,764,100,100,0.001,1504,8
0.732,0.0001,795,809,100,100,0.001,1604,8
0.766,0.0001,846,858,100,100,0.001,1704,8
0.786,0.0001,894,910,100,100,0.001,1804,8
0.804,0.0001,945,959,100,100,0.001,1904,8
0.824,0.0001,997,1007,100,100,0.001,2004,8
0.452,0.0001,54,50,100,100,0.001,104,9
0.462,0.0001,101,103,100,100,0.001,204,9
0.496,0.0001,150,154,100,100,0.001,304,9
0.516,0.0001,200,204,100,100,0.001,404,9
0.538,0.0001,254,250,100,100,0.001,504,9
0.546,0.0001,304,300,100,100,0.001,604,9
0.556,0.0001,355,349,100,100,0.001,704,9
0.556,0.0001,400,404,100,100,0.001,804,9
0.56,0.0001,449,455,100,100,0.001,904,9
0.582,0.0001,497,507,100,100,0.001,1004,9
0.596,0.0001,534,570,100,100,0.001,1104,9
0.594,0.0001,584,620,100,100,0.001,1204,9
0.602,0.0001,643,661,100,100,0.001,1304,9
0.618,0.0001,693,711,100,100,0.001,1404,9
0.648,0.0001,741,763,100,100,0.001,1504,9
0.682,0.0001,792,812,100,100,0.001,1604,9
0.712,0.0001,846,858,100,100,0.001,1704,9
0.744,0.0001,902,902,100,100,0.001,1804,9
0.756,0.0001,951,953,100,100,0.001,1904,9
0.796,0.0001,1001,1003,100,100,0.001,2004,9
0.492,0.0001,48,56,100,100,0.001,104,10
0.486,0.0001,102,102,100,100,0.001,204,10
0.496,0.0001,145,159,100,100,0.001,304,10
0.51,0.0001,203,201,100,100,0.001,404,10
0.532,0.0001,245,259,100,100,0.001,504,10
0.534,0.0001,287,317,100,100,0.001,604,10
0.536,0.0001,331,373,100,100,0.001,704,10
0.568,0.0001,385,419,100,100,0.001,804,10
0.584,0.0001,434,470,100,100,0.001,904,10
0.608,0.0001,490,514,100,100,0.001,1004,10
0.622,0.0001,545,559,100,100,0.001,1104,10
0.64,0.0001,597,607,100,100,0.001,1204,10
0.672,0.0001,636,668,100,100,0.001,1304,10
0.688,0.0001,690,714,100,100,0.001,1404,10
0.704,0.0001,740,764,100,100,0.001,1504,10
0.712,0.0001,798,806,100,100,0.001,1604,10
0.744,0.0001,846,858,100,100,0.001,1704,10
0.774,0.0001,901,903,100,100,0.001,1804,10
0.804,0.0001,947,957,100,100,0.001,1904,10
0.836,0.0001,1006,998,100,100,0.001,2004,10
0.524,0.0001,52,52,100,100,0.001,104,11
0.538,0.0001,105,99,100,100,0.001,204,11
0.538,0.0001,151,153,100,100,0.001,304,11
0.544,0.0001,204,200,100,100,0.001,404,11
0.556,0.0001,262,242,100,100,0.001,504,11
0.564,0.0001,307,297,100,100,0.001,604,11
0.578,0.0001,356,348,100,100,0.001,704,11
0.596,0.0001,409,395,100,100,0.001,804,11
0.582,0.0001,464,440,100,100,0.001,904,11
0.596,0.0001,510,494,100,100,0.001,1004,11
0.618,0.0001,559,545,100,100,0.001,1104,11
0.636,0.0001,600,604,100,100,0.001,1204,11
0.63,0.0001,650,654,100,100,0.001,1304,11
0.656,0.0001,694,710,100,100,0.001,1404,11
0.674,0.0001,740,764,100,100,0.001,1504,11
0.718,0.0001,794,810,100,100,0.001,1604,11
0.746,0.0001,842,862,100,100,0.001,1704,11
0.762,0.0001,885,919,100,100,0.001,1804,11
0.776,0.0001,931,973,100,100,0.001,1904,11
0.81,0.0001,983,1021,100,100,0.001,2004,11
0.516,0.0001,49,55,100,100,0.001,104,12
0.53,0.0001,99,105,100,100,0.001,204,12
0.528,0.0001,154,150,100,100,0.001,304,12
0.546,0.0001,213,191,100,100,0.001,404,12
0.558,0.0001,265,239,100,100,0.001,504,12
0.564,0.0001,308,296,100,100,0.001,604,12
0.572,0.0001,365,339,100,100,0.001,704,12
0.574,0.0001,414,390,100,100,0.001,804,12
0.58,0.0001,461,443,100,100,0.001,904,12
0.606,0.0001,515,489,100,100,0.001,1004,12
0.616,0.0001,570,534,100,100,0.001,1104,12
0.634,0.0001,618,586,100,100,0.001,1204,12
0.662,0.0001,663,641,100,100,0.001,1304,12
0.674,0.0001,715,689,100,100,0.001,1404,12
0.708,0.0001,766,738,100,100,0.001,1504,12
0.712,0.0001,810,794,100,100,0.001,1604,12
0.748,0.0001,857,847,100,100,0.001,1704,12
0.772,0.0001,908,896,100,100,0.001,1804,12
0.78,0.0001,956,948,100,100,0.001,1904,12
0.822,0.0001,1006,998,100,100,0.001,2004,12
0.476,0.0001,50,54,100,100,0.001,104,13
0.49,0.0001,93,111,100,100,0.001,204,13
0.502,0.0001,144,160,100,100,0.001,304,13
0.506,0.0001,194,210,100,100,0.001,404,13
0.524,0.0001,242,262,100,100,0.001,504,13
0.536,0.0001,282,322,100,100,0.001,604,13
0.556,0.0001,334,370,100,100,0.001,704,13
0.558,0.0001,388,416,100,100,0.001,804,13
0.578,0.0001,435,469,100,100,0.001,904,13
0.596,0.0001,494,510,100,100,0.001,1004,13
0.608,0.0001,554,550,100,100,0.001,1104,13
0.634,0.0001,601,603,100,100,0.001,1204,13
0.66,0.0001,647,657,100,100,0.001,1304,13
0.69,0.0001,692,712,100,100,0.001,1404,13
0.704,0.0001,746,758,100,100,0.001,1504,13
0.728,0.0001,803,801,100,100,0.001,1604,13
0.746,0.0001,856,848,100,100,0.001,1704,13
0.772,0.0001,913,891,100,100,0.001,1804,13
0.8,0.0001,955,949,100,100,0.001,1904,13
0.816,0.0001,998,1006,100,100,0.001,2004,13
0.512,0.0001,51,53,100,100,0.001,104,14
0.51,0.0001,103,101,100,100,0.001,204,14
0.518,0.0001,161,143,100,100,0.001,304,14
0.534,0.0001,211,193,100,100,0.001,404,14
0.546,0.0001,262,242,100,100,0.001,504,14
0.57,0.0001,309,295,100,100,0.001,604,14
0.574,0.0001,364,340,100,100,0.001,704,14
0.592,0.0001,419,385,100,100,0.001,804,14
0.602,0.0001,466,438,100,100,0.001,904,14
0.614,0.0001,510,494,100,100,0.001,1004,14
0.618,0.0001,561,543,100,100,0.001,1104,14
0.646,0.0001,613,591,100,100,0.001,1204,14
0.676,0.0001,663,641,100,100,0.001,1304,14
0.688,0.0001,713,691,100,100,0.001,1404,14
0.702,0.0001,764,740,100,100,0.001,1504,14
0.726,0.0001,811,793,100,100,0.001,1604,14
0.758,0.0001,856,848,100,100,0.001,1704,14
0.772,0.0001,899,905,100,100,0.001,1804,14
0.804,0.0001,957,947,100,100,0.001,1904,14
0.834,0.0001,1000,1004,100,100,0.001,2004,14
0.552,0.0001,53,51,100,100,0.001,104,15
0.564,0.0001,100,104,100,100,0.001,204,15
0.574,0.0001,141,163,100,100,0.001,304,15
0.594,0.0001,197,207,100,100,0.001,404,15
0.602,0.0001,251,253,100,100,0.001,504,15
0.606,0.0001,307,297,100,100,0.001,604,15
0.622,0.0001,359,345,100,100,0.001,704,15
0.638,0.0001,417,387,100,100,0.001,804,15
0.662,0.0001,470,434,100,100,0.001,904,15
0.678,0.0001,515,489,100,100,0.001,1004,15
0.686,0.0001,563,541,100,100,0.001,1104,15
0.702,0.0001,619,585,100,100,0.001,1204,15
0.71,0.0001,672,632,100,100,0.001,1304,15
0.732,0.0001,714,690,100,100,0.001,1404,15
0.752,0.0001,762,742,100,100,0.001,1504,15
0.774,0.0001,799,805,100,100,0.001,1604,15
0.784,0.0001,850,854,100,100,0.001,1704,15
0.796,0.0001,902,902,100,100,0.001,1804,15
0.812,0.0001,951,953,100,100,0.001,1904,15
0.844,0.0001,1001,1003,100,100,0.001,2004,15
0.502,0.0001,50,54,100,100,0.001,104,16
0.508,0.0001,93,111,100,100,0.001,204,16
0.51,0.0001,137,167,100,100,0.001,304,16
0.536,0.0001,195,209,100,100,0.001,404,16
0.562,0.0001,247,257,100,100,0.001,504,16
0.58,0.0001,292,312,100,100,0.001,604,16
0.586,0.0001,343,361,100,100,0.001,704,16
0.59,0.0001,396,408,100,100,0.001,804,16
0.616,0.0001,446,458,100,100,0.001,904,16
0.62,0.0001,487,517,100,100,0.001,1004,16
0.642,0.0001,545,559,100,100,0.001,1104,16
0.66,0.0001,603,601,100,100,0.001,1204,16
0.686,0.0001,651,653,100,100,0.001,1304,16
0.696,0.0001,704,700,100,100,0.001,1404,16
0.712,0.0001,752,752,100,100,0.001,1504,16
0.746,0.0001,802,802,100,100,0.001,1604,16
0.782,0.0001,841,863,100,100,0.001,1704,16
0.82,0.0001,906,898,100,100,0.001,1804,16
0.832,0.0001,959,945,100,100,0.001,1904,16
0.856,0.0001,1002,1002,100,100,0.001,2004,16
0.488,0.0001,55,49,100,100,0.001,104,17
0.496,0.0001,107,97,100,100,0.001,204,17
0.496,0.0001,150,154,100,100,0.001,304,17
0.508,0.0001,199,205,100,100,0.001,404,17
0.508,0.0001,244,260,100,100,0.001,504,17
0.516,0.0001,289,315,100,100,0.001,604,17
0.518,0.0001,345,359,100,100,0.001,704,17
0.538,0.0001,394,410,100,100,0.001,804,17
0.566,0.0001,450,454,100,100,0.001,904,17
0.596,0.0001,487,517,100,100,0.001,1004,17
0.63,0.0001,535,569,100,100,0.001,1104,17
0.642,0.0001,584,620,100,100,0.001,1204,17
0.66,0.0001,632,672,100,100,0.001,1304,17
0.674,0.0001,682,722,100,100,0.001,1404,17
0.714,0.0001,732,772,100,100,0.001,1504,17
0.734,0.0001,783,821,100,100,0.001,1604,17
0.75,0.0001,837,867,100,100,0.001,1704,17
0.778,0.0001,898,906,100,100,0.001,1804,17
0.796,0.0001,954,950,100,100,0.001,1904,17
0.818,0.0001,998,1006,100,100,0.001,2004,17
0.506,0.0001,47,57,100,100,0.001,104,18
0.518,0.0001,98,106,100,100,0.001,204,18
0.52,0.0001,149,155,100,100,0.001,304,18
0.524,0.0001,199,205,100,100,0.001,404,18
0.534,0.0001,246,258,100,100,0.001,504,18
0.552,0.0001,300,304,100,100,0.001,604,18
0.558,0.0001,350,354,100,100,0.001,704,18
0.564,0.0001,398,406,100,100,0.001,804,18
0.578,0.0001,445,459,100,100,0.001,904,18
0.59,0.0001,495,509,100,100,0.001,1004,18
0.588,0.0001,547,557,100,100,0.001,1104,18
0.604,0.0001,592,612,100,100,0.001,1204,18
0.616,0.0001,641,663,100,100,0.001,1304,18
0.632,0.0001,697,707,100,100,0.001,1404,18
0.656,0.0001,746,758,100,100,0.001,1504,18
0.684,0.0001,794,810,100,100,0.001,1604,18
0.716,0.0001,844,860,100,100,0.001,1704,18
0.744,0.0001,888,916,100,100,0.001,1804,18
0.766,0.0001,938,966,100,100,0.001,1904,18
0.782,0.0001,990,1014,100,100,0.001,2004,18
0.532,0.0001,55,49,100,100,0.001,104,19
0.526,0.0001,103,101,100,100,0.001,204,19
0.518,0.0001,159,145,100,100,0.001,304,19
0.53,0.0001,213,191,100,100,0.001,404,19
0.526,0.0001,262,242,100,100,0.001,504,19
0.542,0.0001,311,293,100,100,0.001,604,19
0.57,0.0001,355,349,100,100,0.001,704,19
0.59,0.0001,405,399,100,100,0.001,804,19
0.6,0.0001,455,449,100,100,0.001,904,19
0.61,0.0001,501,503,100,100,0.001,1004,19
0.634,0.0001,541,563,100,100,0.001,1104,19
0.65,0.0001,594,610,100,100,0.001,1204,19
0.658,0.0001,647,657,100,100,0.001,1304,19
0.678,0.0001,703,701,100,100,0.001,1404,19
0.71,0.0001,762,742,100,100,0.001,1504,19
0.724,0.0001,812,792,100,100,0.001,1604,19
0.722,0.0001,861,843,100,100,0.001,1704,19
0.74,0.0001,906,898,100,100,0.001,1804,19
0.758,0.0001,955,949,100,100,0.001,1904,19
0.784,0.0001,1013,991,100,100,0.001,2004,19
0.482,0.0001,52,52,100,100,0.001,104,20
0.48,0.0001,98,106,100,100,0.001,204,20
0.498,0.0001,154,150,100,100,0.001,304,20
0.5,0.0001,203,201,100,100,0.001,404,20
0.508,0.0001,260,244,100,100,0.001,504,20
0.53,0.0001,298,306,100,100,0.001,604,20
0.544,0.0001,349,355,100,100,0.001,704,20
0.566,0.0001,405,399,100,100,0.001,804,20
0.568,0.0001,455,449,100,100,0.001,904,20
0.572,0.0001,505,499,100,100,0.001,1004,20
0.594,0.0001,558,546,100,100,0.001,1104,20
0.62,0.0001,600,604,100,100,0.001,1204,20
0.64,0.0001,658,646,100,100,0.001,1304,20
0.654,0.0001,707,697,100,100,0.001,1404,20
0.686,0.0001,751,753,100,100,0.001,1504,20
0.726,0.0001,802,802,100,100,0.001,1604,20
0.734,0.0001,851,853,100,100,0.001,1704,20
0.754,0.0001,899,905,100,100,0.001,1804,20
0.768,0.0001,951,953,100,100,0.001,1904,20
0.784,0.0001,1007,997,100,100,0.001,2004,20
0.522,0.0001,56,48,100,100,0.01,104,1
0.56,0.0001,108,96,100,100,0.01,204,1
0.594,0.0001,154,150,100,100,0.01,304,1
0.602,0.0001,201,203,100,100,0.01,404,1
0.606,0.0001,253,251,100,100,0.01,504,1
0.646,0.0001,298,306,100,100,0.01,604,1
0.696,0.0001,350,354,100,100,0.01,704,1
0.742,0.0001,401,403,100,100,0.01,804,1
0.788,0.0001,451,453,100,100,0.01,904,1
0.854,0.0001,498,506,100,100,0.01,1004,1
0.88,0.0001,548,556,100,100,0.01,1104,1
0.896,0.0001,601,603,100,100,0.01,1204,1
0.904,0.0001,649,655,100,100,0.01,1304,1
0.916,0.0001,701,703,100,100,0.01,1404,1
0.924,0.0001,751,753,100,100,0.01,1504,1
0.93,0.0001,803,801,100,100,0.01,1604,1
0.926,0.0001,855,849,100,100,0.01,1704,1
0.928,0.0001,898,906,100,100,0.01,1804,1
0.934,0.0001,952,952,100,100,0.01,1904,1
0.94,0.0001,1009,995,100,100,0.01,2004,1
0.55,0.0001,40,64,100,100,0.01,104,2
0.57,0.0001,83,121,100,100,0.01,204,2
0.55,0.0001,138,166,100,100,0.01,304,2
0.576,0.0001,186,218,100,100,0.01,404,2
0.614,0.0001,230,274,100,100,0.01,504,2
0.67,0.0001,285,319,100,100,0.01,604,2
0.718,0.0001,343,361,100,100,0.01,704,2
0.764,0.0001,396,408,100,100,0.01,804,2
0.808,0.0001,452,452,100,100,0.01,904,2
0.842,0.0001,502,502,100,100,0.01,1004,2
0.878,0.0001,551,553,100,100,0.01,1104,2
0.914,0.0001,601,603,100,100,0.01,1204,2
0.936,0.0001,651,653,100,100,0.01,1304,2
0.944,0.0001,706,698,100,100,0.01,1404,2
0.952,0.0001,755,749,100,100,0.01,1504,2
0.96,0.0001,801,803,100,100,0.01,1604,2
0.964,0.0001,844,860,100,100,0.01,1704,2
0.966,0.0001,899,905,100,100,0.01,1804,2
0.96,0.0001,958,946,100,100,0.01,1904,2
0.964,0.0001,1007,997,100,100,0.01,2004,2
0.508,0.0001,51,53,100,100,0.01,104,3
0.578,0.0001,101,103,100,100,0.01,204,3
0.568,0.0001,153,151,100,100,0.01,304,3
0.572,0.0001,202,202,100,100,0.01,404,3
0.602,0.0001,261,243,100,100,0.01,504,3
0.658,0.0001,317,287,100,100,0.01,604,3
0.696,0.0001,366,338,100,100,0.01,704,3
0.776,0.0001,420,384,100,100,0.01,804,3
0.842,0.0001,464,440,100,100,0.01,904,3
0.878,0.0001,514,490,100,100,0.01,1004,3
0.894,0.0001,562,542,100,100,0.01,1104,3
0.914,0.0001,613,591,100,100,0.01,1204,3
0.928,0.0001,670,634,100,100,0.01,1304,3
0.948,0.0001,725,679,100,100,0.01,1404,3
0.95,0.0001,778,726,100,100,0.01,1504,3
0.958,0.0001,824,780,100,100,0.01,1604,3
0.964,0.0001,871,833,100,100,0.01,1704,3
0.958,0.0001,912,892,100,100,0.01,1804,3
0.964,0.0001,957,947,100,100,0.01,1904,3
0.972,0.0001,1004,1000,100,100,0.01,2004,3
0.534,0.0001,48,56,100,100,0.01,104,4
0.586,0.0001,104,100,100,100,0.01,204,4
0.634,0.0001,158,146,100,100,0.01,304,4
0.666,0.0001,206,198,100,100,0.01,404,4
0.672,0.0001,254,250,100,100,0.01,504,4
0.686,0.0001,311,293,100,100,0.01,604,4
0.72,0.0001,370,334,100,100,0.01,704,4
0.778,0.0001,419,385,100,100,0.01,804,4
0.792,0.0001,471,433,100,100,0.01,904,4
0.83,0.0001,513,491,100,100,0.01,1004,4
0.814,0.0001,561,543,100,100,0.01,1104,4
0.884,0.0001,614,590,100,100,0.01,1204,4
0.89,0.0001,666,638,100,100,0.01,1304,4
0.904,0.0001,717,687,100,100,0.01,1404,4
0.918,0.0001,770,734,100,100,0.01,1504,4
0.938,0.0001,826,778,100,100,0.01,1604,4
0.946,0.0001,873,831,100,100,0.01,1704,4
0.944,0.0001,922,882,100,100,0.01,1804,4
0.946,0.0001,970,934,100,100,0.01,1904,4
0.952,0.0001,1013,991,100,100,0.01,2004,4
0.532,0.0001,62,42,100,100,0.01,104,5
0.562,0.0001,114,90,100,100,0.01,204,5
0.586,0.0001,172,132,100,100,0.01,304,5
0.616,0.0001,221,183,100,100,0.01,404,5
0.62,0.0001,269,235,100,100,0.01,504,5
0.662,0.0001,330,274,100,100,0.01,604,5
0.678,0.0001,386,318,100,100,0.01,704,5
0.74,0.0001,436,368,100,100,0.01,804,5
0.8,0.0001,492,412,100,100,0.01,904,5
0.854,0.0001,543,461,100,100,0.01,1004,5
0.88,0.0001,588,516,100,100,0.01,1104,5
0.906,0.0001,633,571,100,100,0.01,1204,5
0.916,0.0001,680,624,100,100,0.01,1304,5
0.938,0.0001,722,682,100,100,0.01,1404,5
0.944,0.0001,780,724,100,100,0.01,1504,5
0.95,0.0001,823,781,100,100,0.01,1604,5
0.96,0.0001,866,838,100,100,0.01,1704,5
0.962,0.0001,917,887,100,100,0.01,1804,5
0.962,0.0001,968,936,100,100,0.01,1904,5
0.964,0.0001,1007,997,100,100,0.01,2004,5
0.558,0.0001,53,51,100,100,0.01,104,6
0.584,0.0001,102,102,100,100,0.01,204,6
0.564,0.0001,143,161,100,100,0.01,304,6
0.582,0.0001,197,207,100,100,0.01,404,6
0.604,0.0001,245,259,100,100,0.01,504,6
0.678,0.0001,294,310,100,100,0.01,604,6
0.738,0.0001,340,364,100,100,0.01,704,6
0.794,0.0001,396,408,100,100,0.01,804,6
0.832,0.0001,441,463,100,100,0.01,904,6
0.896,0.0001,491,513,100,100,0.01,1004,6
0.914,0.0001,544,560,100,100,0.01,1104,6
0.93,0.0001,594,610,100,100,0.01,1204,6
0.94,0.0001,646,658,100,100,0.01,1304,6
0.95,0.0001,703,701,100,100,0.01,1404,6
0.952,0.0001,751,753,100,100,0.01,1504,6
0.962,0.0001,807,797,100,100,0.01,1604,6
0.962,0.0001,859,845,100,100,0.01,1704,6
0.96,0.0001,910,894,100,100,0.01,1804,6
0.96,0.0001,956,948,100,100,0.01,1904,6
0.958,0.0001,1015,989,100,100,0.01,2004,6
0.544,0.0001,54,50,100,100,0.01,104,7
0.546,0.0001,100,104,100,100,0.01,204,7
0.548,0.0001,154,150,100,100,0.01,304,7
0.564,0.0001,196,208,100,100,0.01,404,7
0.594,0.0001,245,259,100,100,0.01,504,7
0.648,0.0001,307,297,100,100,0.01,604,7
0.698,0.0001,356,348,100,100,0.01,704,7
0.73,0.0001,406,398,100,100,0.01,804,7
0.776,0.0001,459,445,100,100,0.01,904,7
0.804,0.0001,501,503,100,100,0.01,1004,7
0.846,0.0001,545,559,100,100,0.01,1104,7
0.878,0.0001,590,614,100,100,0.01,1204,7
0.89,0.0001,639,665,100,100,0.01,1304,7
0.91,0.0001,678,726,100,100,0.01,1404,7
0.932,0.0001,730,774,100,100,0.01,1504,7
0.934,0.0001,786,818,100,100,0.01,1604,7
0.938,0.0001,836,868,100,100,0.01,1704,7
0.942,0.0001,877,927,100,100,0.01,1804,7
0.938,0.0001,933,971,100,100,0.01,1904,7
0.94,0.0001,992,1012,100,100,0.01,2004,7
0.556,0.0001,47,57,100,100,0.01,104,8
0.58,0.0001,97,107,100,100,0.01,204,8
0.584,0.0001,147,157,100,100,0.01,304,8
0.636,0.0001,192,212,100,100,0.01,404,8
0.624,0.0001,241,263,100,100,0.01,504,8
0.678,0.0001,288,316,100,100,0.01,604,8
0.716,0.0001,339,365,100,100,0.01,704,8
0.764,0.0001,391,413,100,100,0.01,804,8
0.796,0.0001,440,464,100,100,0.01,904,8
0.85,0.0001,490,514,100,100,0.01,1004,8
0.888,0.0001,549,555,100,100,0.01,1104,8
0.932,0.0001,594,610,100,100,0.01,1204,8
0.938,0.0001,645,659,100,100,0.01,1304,8
0.95,0.0001,691,713,100,100,0.01,1404,8
0.962,0.0001,746,758,100,100,0.01,1504,8
0.964,0.0001,805,799,100,100,0.01,1604,8
0.968,0.0001,862,842,100,100,0.01,1704,8
0.966,0.0001,920,884,100,100,0.01,1804,8
0.974,0.0001,970,934,100,100,0.01,1904,8
0.966,0.0001,1019,985,100,100,0.01,2004,8
0.564,0.0001,52,52,100,100,0.01,104,9
0.57,0.0001,98,106,100,100,0.01,204,9
0.56,0.0001,158,146,100,100,0.01,304,9
0.59,0.0001,215,189,100,100,0.01,404,9
0.654,0.0001,261,243,100,100,0.01,504,9
0.66,0.0001,301,303,100,100,0.01,604,9
0.676,0.0001,361,343,100,100,0.01,704,9
0.746,0.0001,410,394,100,100,0.01,804,9
0.8,0.0001,459,445,100,100,0.01,904,9
0.846,0.0001,510,494,100,100,0.01,1004,9
0.836,0.0001,562,542,100,100,0.01,1104,9
0.898,0.0001,614,590,100,100,0.01,1204,9
0.924,0.0001,662,642,100,100,0.01,1304,9
0.948,0.0001,709,695,100,100,0.01,1404,9
0.936,0.0001,755,749,100,100,0.01,1504,9
0.952,0.0001,802,802,100,100,0.01,1604,9
0.948,0.0001,854,850,100,100,0.01,1704,9
0.966,0.0001,908,896,100,100,0.01,1804,9
0.964,0.0001,958,946,100,100,0.01,1904,9
0.968,0.0001,1005,999,100,100,0.01,2004,9
0.522,0.0001,51,53,100,100,0.01,104,10
0.532,0.0001,106,98,100,100,0.01,204,10
0.538,0.0001,155,149,100,100,0.01,304,10
0.566,0.0001,205,199,100,100,0.01,404,10
0.598,0.0001,259,245,100,100,0.01,504,10
0.634,0.0001,312,292,100,100,0.01,604,10
0.662,0.0001,359,345,100,100,0.01,704,10
0.754,0.0001,400,404,100,100,0.01,804,10
0.778,0.0001,459,445,100,100,0.01,904,10
0.864,0.0001,513,491,100,100,0.01,1004,10
0.904,0.0001,563,541,100,100,0.01,1104,10
0.936,0.0001,610,594,100,100,0.01,1204,10
0.938,0.0001,654,650,100,100,0.01,1304,10
0.948,0.0001,700,704,100,100,0.01,1404,10
0.934,0.0001,747,757,100,100,0.01,1504,10
0.95,0.0001,793,811,100,100,0.01,1604,10
0.95,0.0001,849,855,100,100,0.01,1704,10
0.946,0.0001,897,907,100,100,0.01,1804,10
0.956,0.0001,952,952,100,100,0.01,1904,10
0.958,0.0001,1001,1003,100,100,0.01,2004,10
0.572,0.0001,58,46,100,100,0.01,104,11
0.554,0.0001,104,100,100,100,0.01,204,11
0.556,0.0001,154,150,100,100,0.01,304,11
0.6,0.0001,196,208,100,100,0.01,404,11
0.592,0.0001,247,257,100,100,0.01,504,11
0.62,0.0001,293,311,100,100,0.01,604,11
0.66,0.0001,348,356,100,100,0.01,704,11
0.726,0.0001,392,412,100,100,0.01,804,11
0.76,0.0001,444,460,100,100,0.01,904,11
0.846,0.0001,485,519,100,100,0.01,1004,11
0.884,0.0001,533,571,100,100,0.01,1104,11
0.918,0.0001,581,623,100,100,0.01,1204,11
0.928,0.0001,634,670,100,100,0.01,1304,11
0.942,0.0001,686,718,100,100,0.01,1404,11
0.948,0.0001,745,759,100,100,0.01,1504,11
0.956,0.0001,795,809,100,100,0.01,1604,11
0.962,0.0001,842,862,100,100,0.01,1704,11
0.962,0.0001,884,920,100,100,0.01,1804,11
0.966,0.0001,937,967,100,100,0.01,1904,11
0.97,0.0001,985,1019,100,100,0.01,2004,11
0.538,0.0001,52,52,100,100,0.01,104,12
0.546,0.0001,97,107,100,100,0.01,204,12
0.546,0.0001,146,158,100,100,0.01,304,12
0.556,0.0001,206,198,100,100,0.01,404,12
0.608,0.0001,249,255,100,100,0.01,504,12
0.658,0.0001,305,299,100,100,0.01,604,12
0.676,0.0001,355,349,100,100,0.01,704,12
0.742,0.0001,398,406,100,100,0.01,804,12
0.758,0.0001,457,447,100,100,0.01,904,12
0.808,0.0001,505,499,100,100,0.01,1004,12
0.85,0.0001,557,547,100,100,0.01,1104,12
0.902,0.0001,605,599,100,100,0.01,1204,12
0.934,0.0001,650,654,100,100,0.01,1304,12
0.952,0.0001,706,698,100,100,0.01,1404,12
0.956,0.0001,753,751,100,100,0.01,1504,12
0.962,0.0001,806,798,100,100,0.01,1604,12
0.962,0.0001,859,845,100,100,0.01,1704,12
0.968,0.0001,911,893,100,100,0.01,1804,12
0.968,0.0001,953,951,100,100,0.01,1904,12
0.97,0.0001,1006,998,100,100,0.01,2004,12
0.536,0.0001,52,52,100,100,0.01,104,13
0.56,0.0001,93,111,100,100,0.01,204,13
0.578,0.0001,135,169,100,100,0.01,304,13
0.61,0.0001,188,216,100,100,0.01,404,13
0.64,0.0001,238,266,100,100,0.01,504,13
0.66,0.0001,289,315,100,100,0.01,604,13
0.688,0.0001,333,371,100,100,0.01,704,13
0.77,0.0001,383,421,100,100,0.01,804,13
0.806,0.0001,438,466,100,100,0.01,904,13
0.844,0.0001,488,516,100,100,0.01,1004,13
0.868,0.0001,544,560,100,100,0.01,1104,13
0.878,0.0001,599,605,100,100,0.01,1204,13
0.898,0.0001,648,656,100,100,0.01,1304,13
0.914,0.0001,702,702,100,100,0.01,1404,13
0.926,0.0001,752,752,100,100,0.01,1504,13
0.95,0.0001,799,805,100,100,0.01,1604,13
0.95,0.0001,843,861,100,100,0.01,1704,13
0.948,0.0001,890,914,100,100,0.01,1804,13
0.956,0.0001,954,950,100,100,0.01,1904,13
0.96,0.0001,1014,990,100,100,0.01,2004,13
0.558,0.0001,56,48,100,100,0.01,104,14
0.576,0.0001,108,96,100,100,0.01,204,14
0.57,0.0001,159,145,100,100,0.01,304,14
0.592,0.0001,216,188,100,100,0.01,404,14
0.638,0.0001,269,235,100,100,0.01,504,14
0.692,0.0001,321,283,100,100,0.01,604,14
0.714,0.0001,357,347,100,100,0.01,704,14
0.754,0.0001,406,398,100,100,0.01,804,14
0.796,0.0001,458,446,100,100,0.01,904,14
0.828,0.0001,508,496,100,100,0.01,1004,14
0.858,0.0001,556,548,100,100,0.01,1104,14
0.894,0.0001,606,598,100,100,0.01,1204,14
0.918,0.0001,655,649,100,100,0.01,1304,14
0.932,0.0001,700,704,100,100,0.01,1404,14
0.95,0.0001,752,752,100,100,0.01,1504,14
0.95,0.0001,797,807,100,100,0.01,1604,14
0.954,0.0001,848,856,100,100,0.01,1704,14
0.956,0.0001,899,905,100,100,0.01,1804,14
0.956,0.0001,947,957,100,100,0.01,1904,14
0.96,0.0001,1008,996,100,100,0.01,2004,14
0.528,0.0001,53,51,100,100,0.01,104,15
0.544,0.0001,111,93,100,100,0.01,204,15
0.56,0.0001,165,139,100,100,0.01,304,15
0.592,0.0001,219,185,100,100,0.01,404,15
0.602,0.0001,269,235,100,100,0.01,504,15
0.624,0.0001,319,285,100,100,0.01,604,15
0.656,0.0001,369,335,100,100,0.01,704,15
0.696,0.0001,418,386,100,100,0.01,804,15
0.734,0.0001,473,431,100,100,0.01,904,15
0.774,0.0001,528,476,100,100,0.01,1004,15
0.822,0.0001,580,524,100,100,0.01,1104,15
0.87,0.0001,630,574,100,100,0.01,1204,15
0.898,0.0001,687,617,100,100,0.01,1304,15
0.912,0.0001,732,672,100,100,0.01,1404,15
0.944,0.0001,786,718,100,100,0.01,1504,15
0.956,0.0001,833,771,100,100,0.01,1604,15
0.958,0.0001,885,819,100,100,0.01,1704,15
0.958,0.0001,933,871,100,100,0.01,1804,15
0.964,0.0001,982,922,100,100,0.01,1904,15
0.974,0.0001,1031,973,100,100,0.01,2004,15
0.51,0.0001,45,59,100,100,0.01,104,16
0.54,0.0001,92,112,100,100,0.01,204,16
0.568,0.0001,135,169,100,100,0.01,304,16
0.594,0.0001,193,211,100,100,0.01,404,16
0.608,0.0001,247,257,100,100,0.01,504,16
0.662,0.0001,293,311,100,100,0.01,604,16
0.704,0.0001,342,362,100,100,0.01,704,16
0.742,0.0001,394,410,100,100,0.01,804,16
0.772,0.0001,442,462,100,100,0.01,904,16
0.812,0.0001,496,508,100,100,0.01,1004,16
0.842,0.0001,546,558,100,100,0.01,1104,16
0.892,0.0001,608,596,100,100,0.01,1204,16
0.922,0.0001,663,641,100,100,0.01,1304,16
0.942,0.0001,717,687,100,100,0.01,1404,16
0.948,0.0001,765,739,100,100,0.01,1504,16
0.946,0.0001,816,788,100,100,0.01,1604,16
0.952,0.0001,859,845,100,100,0.01,1704,16
0.954,0.0001,909,895,100,100,0.01,1804,16
0.958,0.0001,954,950,100,100,0.01,1904,16
0.954,0.0001,1000,1004,100,100,0.01,2004,16
0.53,0.0001,50,54,100,100,0.01,104,17
0.566,0.0001,102,102,100,100,0.01,204,17
0.574,0.0001,147,157,100,100,0.01,304,17
0.61,0.0001,195,209,100,100,0.01,404,17
0.664,0.0001,239,265,100,100,0.01,504,17
0.69,0.0001,293,311,100,100,0.01,604,17
0.744,0.0001,343,361,100,100,0.01,704,17
0.784,0.0001,384,420,100,100,0.01,804,17
0.82,0.0001,436,468,100,100,0.01,904,17
0.866,0.0001,487,517,100,100,0.01,1004,17
0.882,0.0001,532,572,100,100,0.01,1104,17
0.91,0.0001,584,620,100,100,0.01,1204,17
0.922,0.0001,640,664,100,100,0.01,1304,17
0.94,0.0001,689,715,100,100,0.01,1404,17
0.936,0.0001,751,753,100,100,0.01,1504,17
0.942,0.0001,799,805,100,100,0.01,1604,17
0.942,0.0001,854,850,100,100,0.01,1704,17
0.95,0.0001,908,896,100,100,0.01,1804,17
0.952,0.0001,952,952,100,100,0.01,1904,17
0.954,0.0001,1002,1002,100,100,0.01,2004,17
0.536,0.0001,50,54,100,100,0.01,104,18
0.542,0.0001,103,101,100,100,0.01,204,18
0.562,0.0001,158,146,100,100,0.01,304,18
0.592,0.0001,207,197,100,100,0.01,404,18
0.632,0.0001,251,253,100,100,0.01,504,18
0.666,0.0001,305,299,100,100,0.01,604,18
0.692,0.0001,359,345,100,100,0.01,704,18
0.746,0.0001,412,392,100,100,0.01,804,18
0.802,0.0001,463,441,100,100,0.01,904,18
0.866,0.0001,509,495,100,100,0.01,1004,18
0.882,0.0001,552,552,100,100,0.01,1104,18
0.912,0.0001,602,602,100,100,0.01,1204,18
0.922,0.0001,647,657,100,100,0.01,1304,18
0.952,0.0001,690,714,100,100,0.01,1404,18
0.954,0.0001,733,771,100,100,0.01,1504,18
0.952,0.0001,779,825,100,100,0.01,1604,18
0.958,0.0001,832,872,100,100,0.01,1704,18
0.968,0.0001,886,918,100,100,0.01,1804,18
0.968,0.0001,939,965,100,100,0.01,1904,18
0.968,0.0001,989,1015,100,100,0.01,2004,18
0.56,0.0001,48,56,100,100,0.01,104,19
0.55,0.0001,98,106,100,100,0.01,204,19
0.552,0.0001,141,163,100,100,0.01,304,19
0.578,0.0001,197,207,100,100,0.01,404,19
0.608,0.0001,249,255,100,100,0.01,504,19
0.668,0.0001,299,305,100,100,0.01,604,19
0.702,0.0001,351,353,100,100,0.01,704,19
0.75,0.0001,400,404,100,100,0.01,804,19
0.772,0.0001,451,453,100,100,0.01,904,19
0.826,0.0001,508,496,100,100,0.01,1004,19
0.846,0.0001,553,551,100,100,0.01,1104,19
0.888,0.0001,603,601,100,100,0.01,1204,19
0.914,0.0001,638,666,100,100,0.01,1304,19
0.918,0.0001,689,715,100,100,0.01,1404,19
0.926,0.0001,740,764,100,100,0.01,1504,19
0.934,0.0001,787,817,100,100,0.01,1604,19
0.944,0.0001,847,857,100,100,0.01,1704,19
0.946,0.0001,896,908,100,100,0.01,1804,19
0.956,0.0001,952,952,100,100,0.01,1904,19
0.952,0.0001,1006,998,100,100,0.01,2004,19
0.552,0.0001,48,56,100,100,0.01,104,20
0.538,0.0001,94,110,100,100,0.01,204,20
0.57,0.0001,139,165,100,100,0.01,304,20
0.57,0.0001,195,209,100,100,0.01,404,20
0.618,0.0001,242,262,100,100,0.01,504,20
0.66,0.0001,294,310,100,100,0.01,604,20
0.672,0.0001,344,360,100,100,0.01,704,20
0.742,0.0001,394,410,100,100,0.01,804,20
0.788,0.0001,450,454,100,100,0.01,904,20
0.818,0.0001,505,499,100,100,0.01,1004,20
0.854,0.0001,541,563,100,100,0.01,1104,20
0.898,0.0001,588,616,100,100,0.01,1204,20
0.912,0.0001,646,658,100,100,0.01,1304,20
0.928,0.0001,684,720,100,100,0.01,1404,20
0.95,0.0001,728,776,100,100,0.01,1504,20
0.954,0.0001,780,824,100,100,0.01,1604,20
0.96,0.0001,829,875,100,100,0.01,1704,20
0.966,0.0001,890,914,100,100,0.01,1804,20
0.966,0.0001,940,964,100,100,0.01,1904,20
0.968,0.0001,993,1011,100,100,0.01,2004,20
0.508,0.001,50,54,100,100,0.0001,104,1
0.51,0.001,99,105,100,100,0.0001,204,1
0.506,0.001,145,159,100,100,0.0001,304,1
0.502,0.001,198,206,100,100,0.0001,404,1
0.506,0.001,258,246,100,100,0.0001,504,1
0.506,0.001,306,298,100,100,0.0001,604,1
0.506,0.001,359,345,100,100,0.0001,704,1
0.508,0.001,408,396,100,100,0.0001,804,1
0.508,0.001,453,451,100,100,0.0001,904,1
0.506,0.001,507,497,100,100,0.0001,1004,1
0.508,0.001,558,546,100,100,0.0001,1104,1
0.508,0.001,609,595,100,100,0.0001,1204,1
0.512,0.001,651,653,100,100,0.0001,1304,1
0.518,0.001,702,702,100,100,0.0001,1404,1
0.53,0.001,761,743,100,100,0.0001,1504,1
0.532,0.001,812,792,100,100,0.0001,1604,1
0.532,0.001,857,847,100,100,0.0001,1704,1
0.538,0.001,906,898,100,100,0.0001,1804,1
0.54,0.001,951,953,100,100,0.0001,1904,1
0.542,0.001,997,1007,100,100,0.0001,2004,1
0.504,0.001,53,51,100,100,0.0001,104,2
0.504,0.001,102,102,100,100,0.0001,204,2
0.51,0.001,147,157,100,100,0.0001,304,2
0.512,0.001,195,209,100,100,0.0001,404,2
0.518,0.001,248,256,100,100,0.0001,504,2
0.516,0.001,298,306,100,100,0.0001,604,2
0.518,0.001,342,362,100,100,0.0001,704,2
0.52,0.001,389,415,100,100,0.0001,804,2
0.522,0.001,438,466,100,100,0.0001,904,2
0.52,0.001,487,517,100,100,0.0001,1004,2
0.522,0.001,539,565,100,100,0.0001,1104,2
0.52,0.001,589,615,100,100,0.0001,1204,2
0.524,0.001,642,662,100,100,0.0001,1304,2
0.528,0.001,694,710,100,100,0.0001,1404,2
0.526,0.001,747,757,100,100,0.0001,1504,2
0.526,0.001,798,806,100,100,0.0001,1604,2
0.53,0.001,839,865,100,100,0.0001,1704,2
0.53,0.001,895,909,100,100,0.0001,1804,2
0.536,0.001,947,957,100,100,0.0001,1904,2
0.548,0.001,994,1010,100,100,0.0001,2004,2
0.508,0.001,50,54,100,100,0.0001,104,3
0.51,0.001,99,105,100,100,0.0001,204,3
0.51,0.001,150,154,100,100,0.0001,304,3
0.512,0.001,201,203,100,100,0.0001,404,3
0.512,0.001,252,252,100,100,0.0001,504,3
0.508,0.001,303,301,100,100,0.0001,604,3
0.51,0.001,356,348,100,100,0.0001,704,3
0.512,0.001,404,400,100,100,0.0001,804,3
0.512,0.001,454,450,100,100,0.0001,904,3
0.512,0.001,505,499,100,100,0.0001,1004,3
0.514,0.001,551,553,100,100,0.0001,1104,3
0.514,0.001,599,605,100,100,0.0001,1204,3
0.514,0.001,653,651,100,100,0.0001,1304,3
0.518,0.001,692,712,100,100,0.0001,1404,3
0.516,0.001,741,763,100,100,0.0001,1504,3
0.516,0.001,795,809,100,100,0.0001,1604,3
0.52,0.001,840,864,100,100,0.0001,1704,3
0.522,0.001,896,908,100,100,0.0001,1804,3
0.526,0.001,949,955,100,100,0.0001,1904,3
0.528,0.001,1008,996,100,100,0.0001,2004,3
0.474,0.001,51,53,100,100,0.0001,104,4
0.476,0.001,106,98,100,100,0.0001,204,4
0.478,0.001,154,150,100,100,0.0001,304,4
0.48,0.001,202,202,100,100,0.0001,404,4
0.474,0.001,252,252,100,100,0.0001,504,4
0.474,0.001,292,312,100,100,0.0001,604,4
0.478,0.001,343,361,100,100,0.0001,704,4
0.476,0.001,383,421,100,100,0.0001,804,4
0.474,0.001,423,481,100,100,0.0001,904,4
0.478,0.001,484,520,100,100,0.0001,1004,4
0.476,0.001,532,572,100,100,0.0001,1104,4
0.476,0.001,584,620,100,100,0.0001,1204,4
0.48,0.001,633,671,100,100,0.0001,1304,4
0.48,0.001,684,720,100,100,0.0001,1404,4
0.486,0.001,740,764,100,100,0.0001,1504,4
0.486,0.001,790,814,100,100,0.0001,1604,4
0.488,0.001,844,860,100,100,0.0001,1704,4
0.492,0.001,893,911,100,100,0.0001,1804,4
0.5,0.001,945,959,100,100,0.0001,1904,4
0.5,0.001,998,1006,100,100,0.0001,2004,4
0.488,0.001,48,56,100,100,0.0001,104,5
0.49,0.001,92,112,100,100,0.0001,204,5
0.49,0.001,144,160,100,100,0.0001,304,5
0.49,0.001,200,204,100,100,0.0001,404,5
0.49,0.001,250,254,100,100,0.0001,504,5
0.488,0.001,300,304,100,100,0.0001,604,5
0.488,0.001,353,351,100,100,0.0001,704,5
0.486,0.001,402,402,100,100,0.0001,804,5
0.488,0.001,449,455,100,100,0.0001,904,5
0.498,0.001,501,503,100,100,0.0001,1004,5
0.498,0.001,559,545,100,100,0.0001,1104,5
0.5,0.001,607,597,100,100,0.0001,1204,5
0.498,0.001,657,647,100,100,0.0001,1304,5
0.508,0.001,710,694,100,100,0.0001,1404,5
0.506,0.001,763,741,100,100,0.0001,1504,5
0.508,0.001,813,791,100,100,0.0001,1604,5
0.518,0.001,857,847,100,100,0.0001,1704,5
0.522,0.001,902,902,100,100,0.0001,1804,5
0.534,0.001,953,951,100,100,0.0001,1904,5
0.534,0.001,1008,996,100,100,0.0001,2004,5
0.532,0.001,46,58,100,100,0.0001,104,6
0.532,0.001,95,109,100,100,0.0001,204,6
0.532,0.001,145,159,100,100,0.0001,304,6
0.534,0.001,201,203,100,100,0.0001,404,6
0.536,0.001,252,252,100,100,0.0001,504,6
0.54,0.001,294,310,100,100,0.0001,604,6
0.536,0.001,350,354,100,100,0.0001,704,6
0.536,0.001,399,405,100,100,0.0001,804,6
0.534,0.001,449,455,100,100,0.0001,904,6
0.536,0.001,498,506,100,100,0.0001,1004,6
0.53,0.001,548,556,100,100,0.0001,1104,6
0.532,0.001,595,609,100,100,0.0001,1204,6
0.536,0.001,647,657,100,100,0.0001,1304,6
0.54,0.001,700,704,100,100,0.0001,1404,6
0.536,0.001,747,757,100,100,0.0001,1504,6
0.53,0.001,791,813,100,100,0.0001,1604,6
0.536,0.001,840,864,100,100,0.0001,1704,6
0.542,0.001,898,906,100,100,0.0001,1804,6
0.546,0.001,945,959,100,100,0.0001,1904,6
0.548,0.001,996,1008,100,100,0.0001,2004,6
0.488,0.001,61,43,100,100,0.0001,104,7
0.492,0.001,108,96,100,100,0.0001,204,7
0.498,0.001,171,133,100,100,0.0001,304,7
0.498,0.001,215,189,100,100,0.0001,404,7
0.496,0.001,260,244,100,100,0.0001,504,7
0.494,0.001,309,295,100,100,0.0001,604,7
0.496,0.001,361,343,100,100,0.0001,704,7
0.506,0.001,413,391,100,100,0.0001,804,7
0.506,0.001,463,441,100,100,0.0001,904,7
0.51,0.001,507,497,100,100,0.0001,1004,7
0.508,0.001,553,551,100,100,0.0001,1104,7
0.512,0.001,593,611,100,100,0.0001,1204,7
0.51,0.001,640,664,100,100,0.0001,1304,7
0.514,0.001,685,719,100,100,0.0001,1404,7
0.518,0.001,734,770,100,100,0.0001,1504,7
0.524,0.001,782,822,100,100,0.0001,1604,7
0.52,0.001,840,864,100,100,0.0001,1704,7
0.522,0.001,898,906,100,100,0.0001,1804,7
0.518,0.001,953,951,100,100,0.0001,1904,7
0.53,0.001,1010,994,100,100,0.0001,2004,7
0.522,0.001,45,59,100,100,0.0001,104,8
0.52,0.001,93,111,100,100,0.0001,204,8
0.516,0.001,135,169,100,100,0.0001,304,8
0.516,0.001,184,220,100,100,0.0001,404,8
0.522,0.001,227,277,100,100,0.0001,504,8
0.52,0.001,276,328,100,100,0.0001,604,8
0.518,0.001,336,368,100,100,0.0001,704,8
0.518,0.001,385,419,100,100,0.0001,804,8
0.52,0.001,435,469,100,100,0.0001,904,8
0.522,0.001,479,525,100,100,0.0001,1004,8
0.516,0.001,532,572,100,100,0.0001,1104,8
0.52,0.001,583,621,100,100,0.0001,1204,8
0.532,0.001,625,679,100,100,0.0001,1304,8
0.538,0.001,669,735,100,100,0.0001,1404,8
0.538,0.001,724,780,100,100,0.0001,1504,8
0.538,0.001,768,836,100,100,0.0001,1604,8
0.538,0.001,825,879,100,100,0.0001,1704,8
0.538,0.001,876,928,100,100,0.0001,1804,8
0.542,0.001,927,977,100,100,0.0001,1904,8
0.544,0.001,985,1019,100,100,0.0001,2004,8
0.498,0.001,52,52,100,100,0.0001,104,9
0.502,0.001,100,104,100,100,0.0001,204,9
0.498,0.001,145,159,100,100,0.0001,304,9
0.504,0.001,194,210,100,100,0.0001,404,9
0.508,0.001,245,259,100,100,0.0001,504,9
0.508,0.001,290,314,100,100,0.0001,604,9
0.508,0.001,344,360,100,100,0.0001,704,9
0.516,0.001,392,412,100,100,0.0001,804,9
0.518,0.001,431,473,100,100,0.0001,904,9
0.516,0.001,483,521,100,100,0.0001,1004,9
0.52,0.001,533,571,100,100,0.0001,1104,9
0.52,0.001,589,615,100,100,0.0001,1204,9
0.52,0.001,651,653,100,100,0.0001,1304,9
0.526,0.001,703,701,100,100,0.0001,1404,9
0.53,0.001,756,748,100,100,0.0001,1504,9
0.534,0.001,807,797,100,100,0.0001,1604,9
0.528,0.001,862,842,100,100,0.0001,1704,9
0.524,0.001,913,891,100,100,0.0001,1804,9
0.526,0.001,960,944,100,100,0.0001,1904,9
0.526,0.001,1008,996,100,100,0.0001,2004,9
0.516,0.001,51,53,100,100,0.0001,104,10
0.518,0.001,108,96,100,100,0.0001,204,10
0.522,0.001,161,143,100,100,0.0001,304,10
0.522,0.001,212,192,100,100,0.0001,404,10
0.524,0.001,256,248,100,100,0.0001,504,10
0.526,0.001,298,306,100,100,0.0001,604,10
0.53,0.001,352,352,100,100,0.0001,704,10
0.536,0.001,404,400,100,100,0.0001,804,10
0.534,0.001,442,462,100,100,0.0001,904,10
0.532,0.001,502,502,100,100,0.0001,1004,10
0.538,0.001,551,553,100,100,0.0001,1104,10
0.542,0.001,602,602,100,100,0.0001,1204,10
0.544,0.001,657,647,100,100,0.0001,1304,10
0.548,0.001,708,696,100,100,0.0001,1404,10
0.55,0.001,758,746,100,100,0.0001,1504,10
0.552,0.001,802,802,100,100,0.0001,1604,10
0.558,0.001,853,851,100,100,0.0001,1704,10
0.562,0.001,902,902,100,100,0.0001,1804,10
0.564,0.001,956,948,100,100,0.0001,1904,10
0.564,0.001,1007,997,100,100,0.0001,2004,10
0.53,0.001,60,44,100,100,0.0001,104,11
0.534,0.001,105,99,100,100,0.0001,204,11
0.536,0.001,147,157,100,100,0.0001,304,11
0.538,0.001,200,204,100,100,0.0001,404,11
0.532,0.001,252,252,100,100,0.0001,504,11
0.53,0.001,306,298,100,100,0.0001,604,11
0.534,0.001,359,345,100,100,0.0001,704,11
0.54,0.001,417,387,100,100,0.0001,804,11
0.54,0.001,473,431,100,100,0.0001,904,11
0.542,0.001,534,470,100,100,0.0001,1004,11
0.548,0.001,591,513,100,100,0.0001,1104,11
0.55,0.001,631,573,100,100,0.0001,1204,11
0.552,0.001,675,629,100,100,0.0001,1304,11
0.552,0.001,721,683,100,100,0.0001,1404,11
0.562,0.001,768,736,100,100,0.0001,1504,11
0.562,0.001,822,782,100,100,0.0001,1604,11
0.562,0.001,862,842,100,100,0.0001,1704,11
0.57,0.001,905,899,100,100,0.0001,1804,11
0.572,0.001,943,961,100,100,0.0001,1904,11
0.58,0.001,989,1015,100,100,0.0001,2004,11
0.48,0.001,59,45,100,100,0.0001,104,12
0.482,0.001,113,91,100,100,0.0001,204,12
0.484,0.001,166,138,100,100,0.0001,304,12
0.488,0.001,222,182,100,100,0.0001,404,12
0.488,0.001,268,236,100,100,0.0001,504,12
0.488,0.001,318,286,100,100,0.0001,604,12
0.488,0.001,366,338,100,100,0.0001,704,12
0.486,0.001,413,391,100,100,0.0001,804,12
0.49,0.001,468,436,100,100,0.0001,904,12
0.494,0.001,527,477,100,100,0.0001,1004,12
0.494,0.001,581,523,100,100,0.0001,1104,12
0.494,0.001,619,585,100,100,0.0001,1204,12
0.498,0.001,670,634,100,100,0.0001,1304,12
0.498,0.001,722,682,100,100,0.0001,1404,12
0.506,0.001,775,729,100,100,0.0001,1504,12
0.51,0.001,823,781,100,100,0.0001,1604,12
0.52,0.001,874,830,100,100,0.0001,1704,12
0.53,0.001,921,883,100,100,0.0001,1804,12
0.536,0.001,966,938,100,100,0.0001,1904,12
0.534,0.001,1017,987,100,100,0.0001,2004,12
0.478,0.001,60,44,100,100,0.0001,104,13
0.48,0.001,112,92,100,100,0.0001,204,13
0.484,0.001,164,140,100,100,0.0001,304,13
0.482,0.001,222,182,100,100,0.0001,404,13
0.482,0.001,267,237,100,100,0.0001,504,13
0.48,0.001,315,289,100,100,0.0001,604,13
0.484,0.001,362,342,100,100,0.0001,704,13
0.482,0.001,409,395,100,100,0.0001,804,13
0.486,0.001,459,445,100,100,0.0001,904,13
0.484,0.001,502,502,100,100,0.0001,1004,13
0.488,0.001,550,554,100,100,0.0001,1104,13
0.488,0.001,601,603,100,100,0.0001,1204,13
0.492,0.001,654,650,100,100,0.0001,1304,13
0.488,0.001,707,697,100,100,0.0001,1404,13
0.492,0.001,752,752,100,100,0.0001,1504,13
0.492,0.001,806,798,100,100,0.0001,1604,13
0.504,0.001,854,850,100,100,0.0001,1704,13
0.51,0.001,910,894,100,100,0.0001,1804,13
0.506,0.001,963,941,100,100,0.0001,1904,13
0.514,0.001,1010,994,100,100,0.0001,2004,13
0.486,0.001,59,45,100,100,0.0001,104,14
0.482,0.001,111,93,100,100,0.0001,204,14
0.482,0.001,159,145,100,100,0.0001,304,14
0.48,0.001,211,193,100,100,0.0001,404,14
0.48,0.001,258,246,100,100,0.0001,504,14
0.48,0.001,308,296,100,100,0.0001,604,14
0.484,0.001,358,346,100,100,0.0001,704,14
0.482,0.001,416,388,100,100,0.0001,804,14
0.484,0.001,464,440,100,100,0.0001,904,14
0.482,0.001,516,488,100,100,0.0001,1004,14
0.482,0.001,566,538,100,100,0.0001,1104,14
0.484,0.001,615,589,100,100,0.0001,1204,14
0.488,0.001,665,639,100,100,0.0001,1304,14
0.488,0.001,709,695,100,100,0.0001,1404,14
0.49,0.001,763,741,100,100,0.0001,1504,14
0.492,0.001,806,798,100,100,0.0001,1604,14
0.496,0.001,851,853,100,100,0.0001,1704,14
0.502,0.001,896,908,100,100,0.0001,1804,14
0.498,0.001,950,954,100,100,0.0001,1904,14
0.506,0.001,997,1007,100,100,0.0001,2004,14
0.52,0.001,55,49,100,100,0.0001,104,15
0.522,0.001,109,95,100,100,0.0001,204,15
0.526,0.001,154,150,100,100,0.0001,304,15
0.526,0.001,195,209,100,100,0.0001,404,15
0.524,0.001,238,266,100,100,0.0001,504,15
0.526,0.001,287,317,100,100,0.0001,604,15
0.526,0.001,341,363,100,100,0.0001,704,15
0.528,0.001,390,414,100,100,0.0001,804,15
0.53,0.001,443,461,100,100,0.0001,904,15
0.536,0.001,499,505,100,100,0.0001,1004,15
0.536,0.001,551,553,100,100,0.0001,1104,15
0.54,0.001,601,603,100,100,0.0001,1204,15
0.544,0.001,644,660,100,100,0.0001,1304,15
0.544,0.001,702,702,100,100,0.0001,1404,15
0.546,0.001,753,751,100,100,0.0001,1504,15
0.55,0.001,802,802,100,100,0.0001,1604,15
0.554,0.001,853,851,100,100,0.0001,1704,15
0.552,0.001,903,901,100,100,0.0001,1804,15
0.558,0.001,949,955,100,100,0.0001,1904,15
0.562,0.001,996,1008,100,100,0.0001,2004,15
0.532,0.001,55,49,100,100,0.0001,104,16
0.532,0.001,105,99,100,100,0.0001,204,16
0.534,0.001,156,148,100,100,0.0001,304,16
0.536,0.001,202,202,100,100,0.0001,404,16
0.532,0.001,241,263,100,100,0.0001,504,16
0.532,0.001,293,311,100,100,0.0001,604,16
0.536,0.001,345,359,100,100,0.0001,704,16
0.536,0.001,389,415,100,100,0.0001,804,16
0.536,0.001,436,468,100,100,0.0001,904,16
0.538,0.001,487,517,100,100,0.0001,1004,16
0.544,0.001,544,560,100,100,0.0001,1104,16
0.552,0.001,589,615,100,100,0.0001,1204,16
0.552,0.001,637,667,100,100,0.0001,1304,16
0.558,0.001,693,711,100,100,0.0001,1404,16
0.56,0.001,752,752,100,100,0.0001,1504,16
0.556,0.001,803,801,100,100,0.0001,1604,16
0.556,0.001,855,849,100,100,0.0001,1704,16
0.556,0.001,901,903,100,100,0.0001,1804,16
0.554,0.001,948,956,100,100,0.0001,1904,16
0.56,0.001,992,1012,100,100,0.0001,2004,16
0.5,0.001,49,55,100,100,0.0001,104,17
0.504,0.001,104,100,100,100,0.0001,204,17
0.508,0.001,151,153,100,100,0.0001,304,17
0.506,0.001,202,202,100,100,0.0001,404,17
0.504,0.001,242,262,100,100,0.0001,504,17
0.506,0.001,292,312,100,100,0.0001,604,17
0.504,0.001,338,366,100,100,0.0001,704,17
0.5,0.001,391,413,100,100,0.0001,804,17
0.502,0.001,434,470,100,100,0.0001,904,17
0.504,0.001,480,524,100,100,0.0001,1004,17
0.502,0.001,534,570,100,100,0.0001,1104,17
0.506,0.001,581,623,100,100,0.0001,1204,17
0.512,0.001,626,678,100,100,0.0001,1304,17
0.518,0.001,681,723,100,100,0.0001,1404,17
0.52,0.001,736,768,100,100,0.0001,1504,17
0.526,0.001,791,813,100,100,0.0001,1604,17
0.53,0.001,835,869,100,100,0.0001,1704,17
0.536,0.001,881,923,100,100,0.0001,1804,17
0.538,0.001,932,972,100,100,0.0001,1904,17
0.538,0.001,987,1017,100,100,0.0001,2004,17
0.536,0.001,48,56,100,100,0.0001,104,18
0.538,0.001,101,103,100,100,0.0001,204,18
0.536,0.001,146,158,100,100,0.0001,304,18
0.538,0.001,201,203,100,100,0.0001,404,18
0.538,0.001,261,243,100,100,0.0001,504,18
0.538,0.001,302,302,100,100,0.0001,604,18
0.538,0.001,360,344,100,100,0.0001,704,18
0.536,0.001,411,393,100,100,0.0001,804,18
0.536,0.001,463,441,100,100,0.0001,904,18
0.536,0.001,510,494,100,100,0.0001,1004,18
0.542,0.001,561,543,100,100,0.0001,1104,18
0.548,0.001,605,599,100,100,0.0001,1204,18
0.556,0.001,652,652,100,100,0.0001,1304,18
0.56,0.001,695,709,100,100,0.0001,1404,18
0.56,0.001,741,763,100,100,0.0001,1504,18
0.56,0.001,793,811,100,100,0.0001,1604,18
0.564,0.001,840,864,100,100,0.0001,1704,18
0.568,0.001,886,918,100,100,0.0001,1804,18
0.566,0.001,940,964,100,100,0.0001,1904,18
0.568,0.001,1000,1004,100,100,0.0001,2004,18
0.5,0.001,44,60,100,100,0.0001,104,19
0.504,0.001,97,107,100,100,0.0001,204,19
0.508,0.001,152,152,100,100,0.0001,304,19
0.51,0.001,208,196,100,100,0.0001,404,19
0.512,0.001,256,248,100,100,0.0001,504,19
0.512,0.001,294,310,100,100,0.0001,604,19
0.518,0.001,347,357,100,100,0.0001,704,19
0.522,0.001,399,405,100,100,0.0001,804,19
0.522,0.001,454,450,100,100,0.0001,904,19
0.526,0.001,500,504,100,100,0.0001,1004,19
0.524,0.001,553,551,100,100,0.0001,1104,19
0.532,0.001,612,592,100,100,0.0001,1204,19
0.54,0.001,658,646,100,100,0.0001,1304,19
0.55,0.001,710,694,100,100,0.0001,1404,19
0.556,0.001,758,746,100,100,0.0001,1504,19
0.558,0.001,807,797,100,100,0.0001,1604,19
0.562,0.001,861,843,100,100,0.0001,1704,19
0.566,0.001,908,896,100,100,0.0001,1804,19
0.568,0.001,958,946,100,100,0.0001,1904,19
0.576,0.001,1017,987,100,100,0.0001,2004,19
0.522,0.001,50,54,100,100,0.0001,104,20
0.524,0.001,99,105,100,100,0.0001,204,20
0.524,0.001,147,157,100,100,0.0001,304,20
0.524,0.001,201,203,100,100,0.0001,404,20
0.524,0.001,246,258,100,100,0.0001,504,20
0.52,0.001,299,305,100,100,0.0001,604,20
0.52,0.001,349,355,100,100,0.0001,704,20
0.52,0.001,400,404,100,100,0.0001,804,20
0.522,0.001,457,447,100,100,0.0001,904,20
0.524,0.001,511,493,100,100,0.0001,1004,20
0.524,0.001,560,544,100,100,0.0001,1104,20
0.526,0.001,608,596,100,100,0.0001,1204,20
0.532,0.001,656,648,100,100,0.0001,1304,20
0.536,0.001,695,709,100,100,0.0001,1404,20
0.534,0.001,751,753,100,100,0.0001,1504,20
0.53,0.001,798,806,100,100,0.0001,1604,20
0.542,0.001,850,854,100,100,0.0001,1704,20
0.544,0.001,897,907,100,100,0.0001,1804,20
0.548,0.001,941,963,100,100,0.0001,1904,20
0.55,0.001,999,1005,100,100,0.0001,2004,20
0.468,0.001,49,55,100,100,0.001,104,1
0.476,0.001,100,104,100,100,0.001,204,1
0.482,0.001,145,159,100,100,0.001,304,1
0.502,0.001,202,202,100,100,0.001,404,1
0.512,0.001,261,243,100,100,0.001,504,1
0.534,0.001,304,300,100,100,0.001,604,1
0.538,0.001,366,338,100,100,0.001,704,1
0.552,0.001,411,393,100,100,0.001,804,1
0.572,0.001,473,431,100,100,0.001,904,1
0.586,0.001,517,487,100,100,0.001,1004,1
0.592,0.001,564,540,100,100,0.001,1104,1
0.63,0.001,610,594,100,100,0.001,1204,1
0.644,0.001,651,653,100,100,0.001,1304,1
0.666,0.001,696,708,100,100,0.001,1404,1
0.684,0.001,745,759,100,100,0.001,1504,1
0.706,0.001,791,813,100,100,0.001,1604,1
0.722,0.001,842,862,100,100,0.001,1704,1
0.732,0.001,893,911,100,100,0.001,1804,1
0.744,0.001,946,958,100,100,0.001,1904,1
0.776,0.001,997,1007,100,100,0.001,2004,1
0.508,0.001,46,58,100,100,0.001,104,2
0.496,0.001,93,111,100,100,0.001,204,2
0.498,0.001,148,156,100,100,0.001,304,2
0.5,0.001,194,210,100,100,0.001,404,2
0.526,0.001,249,255,100,100,0.001,504,2
0.532,0.001,288,316,100,100,0.001,604,2
0.54,0.001,343,361,100,100,0.001,704,2
0.548,0.001,392,412,100,100,0.001,804,2
0.568,0.001,438,466,100,100,0.001,904,2
0.584,0.001,487,517,100,100,0.001,1004,2
0.6,0.001,536,568,100,100,0.001,1104,2
0.62,0.001,586,618,100,100,0.001,1204,2
0.632,0.001,645,659,100,100,0.001,1304,2
0.652,0.001,691,713,100,100,0.001,1404,2
0.674,0.001,737,767,100,100,0.001,1504,2
0.684,0.001,787,817,100,100,0.001,1604,2
0.71,0.001,841,863,100,100,0.001,1704,2
0.734,0.001,890,914,100,100,0.001,1804,2
0.758,0.001,945,959,100,100,0.001,1904,2
0.784,0.001,994,1010,100,100,0.001,2004,2
0.528,0.001,50,54,100,100,0.001,104,3
0.54,0.001,106,98,100,100,0.001,204,3
0.544,0.001,156,148,100,100,0.001,304,3
0.558,0.001,198,206,100,100,0.001,404,3
0.562,0.001,247,257,100,100,0.001,504,3
0.58,0.001,298,306,100,100,0.001,604,3
0.576,0.001,346,358,100,100,0.001,704,3
0.592,0.001,398,406,100,100,0.001,804,3
0.608,0.001,451,453,100,100,0.001,904,3
0.63,0.001,489,515,100,100,0.001,1004,3
0.638,0.001,542,562,100,100,0.001,1104,3
0.672,0.001,585,619,100,100,0.001,1204,3
0.704,0.001,629,675,100,100,0.001,1304,3
0.722,0.001,681,723,100,100,0.001,1404,3
0.746,0.001,729,775,100,100,0.001,1504,3
0.782,0.001,786,818,100,100,0.001,1604,3
0.798,0.001,840,864,100,100,0.001,1704,3
0.808,0.001,898,906,100,100,0.001,1804,3
0.834,0.001,948,956,100,100,0.001,1904,3
0.862,0.001,998,1006,100,100,0.001,2004,3
0.462,0.001,47,57,100,100,0.001,104,4
0.472,0.001,98,106,100,100,0.001,204,4
0.482,0.001,142,162,100,100,0.001,304,4
0.484,0.001,193,211,100,100,0.001,404,4
0.506,0.001,245,259,100,100,0.001,504,4
0.53,0.001,296,308,100,100,0.001,604,4
0.548,0.001,352,352,100,100,0.001,704,4
0.564,0.001,397,407,100,100,0.001,804,4
0.582,0.001,439,465,100,100,0.001,904,4
0.618,0.001,488,516,100,100,0.001,1004,4
0.634,0.001,545,559,100,100,0.001,1104,4
0.644,0.001,595,609,100,100,0.001,1204,4
0.66,0.001,647,657,100,100,0.001,1304,4
0.674,0.001,700,704,100,100,0.001,1404,4
0.702,0.001,751,753,100,100,0.001,1504,4
0.706,0.001,805,799,100,100,0.001,1604,4
0.728,0.001,854,850,100,100,0.001,1704,4
0.742,0.001,911,893,100,100,0.001,1804,4
0.752,0.001,968,936,100,100,0.001,1904,4
0.784,0.001,1017,987,100,100,0.001,2004,4
0.518,0.001,49,55,100,100,0.001,104,5
0.542,0.001,89,115,100,100,0.001,204,5
0.556,0.001,137,167,100,100,0.001,304,5
0.572,0.001,184,220,100,100,0.001,404,5
0.588,0.001,231,273,100,100,0.001,504,5
0.592,0.001,285,319,100,100,0.001,604,5
0.588,0.001,337,367,100,100,0.001,704,5
0.606,0.001,386,418,100,100,0.001,804,5
0.61,0.001,437,467,100,100,0.001,904,5
0.638,0.001,493,511,100,100,0.001,1004,5
0.636,0.001,542,562,100,100,0.001,1104,5
0.67,0.001,586,618,100,100,0.001,1204,5
0.688,0.001,640,664,100,100,0.001,1304,5
0.704,0.001,693,711,100,100,0.001,1404,5
0.74,0.001,732,772,100,100,0.001,1504,5
0.746,0.001,782,822,100,100,0.001,1604,5
0.752,0.001,837,867,100,100,0.001,1704,5
0.77,0.001,889,915,100,100,0.001,1804,5
0.79,0.001,934,970,100,100,0.001,1904,5
0.814,0.001,990,1014,100,100,0.001,2004,5
0.498,0.001,55,49,100,100,0.001,104,6
0.492,0.001,112,92,100,100,0.001,204,6
0.5,0.001,156,148,100,100,0.001,304,6
0.502,0.001,211,193,100,100,0.001,404,6
0.488,0.001,274,230,100,100,0.001,504,6
0.482,0.001,319,285,100,100,0.001,604,6
0.5,0.001,377,327,100,100,0.001,704,6
0.518,0.001,424,380,100,100,0.001,804,6
0.518,0.001,470,434,100,100,0.001,904,6
0.52,0.001,523,481,100,100,0.001,1004,6
0.54,0.001,574,530,100,100,0.001,1104,6
0.564,0.001,625,579,100,100,0.001,1204,6
0.586,0.001,670,634,100,100,0.001,1304,6
0.606,0.001,723,681,100,100,0.001,1404,6
0.618,0.001,767,737,100,100,0.001,1504,6
0.636,0.001,819,785,100,100,0.001,1604,6
0.672,0.001,863,841,100,100,0.001,1704,6
0.708,0.001,908,896,100,100,0.001,1804,6
0.732,0.001,961,943,100,100,0.001,1904,6
0.752,0.001,1009,995,100,100,0.001,2004,6
0.502,0.001,51,53,100,100,0.001,104,7
0.532,0.001,95,109,100,100,0.001,204,7
0.546,0.001,141,163,100,100,0.001,304,7
0.56,0.001,202,202,100,100,0.001,404,7
0.554,0.001,254,250,100,100,0.001,504,7
0.57,0.001,305,299,100,100,0.001,604,7
0.572,0.001,353,351,100,100,0.001,704,7
0.59,0.001,408,396,100,100,0.001,804,7
0.596,0.001,465,439,100,100,0.001,904,7
0.598,0.001,516,488,100,100,0.001,1004,7
0.616,0.001,568,536,100,100,0.001,1104,7
0.638,0.001,612,592,100,100,0.001,1204,7
0.654,0.001,665,639,100,100,0.001,1304,7
0.676,0.001,704,700,100,100,0.001,1404,7
0.7,0.001,752,752,100,100,0.001,1504,7
0.72,0.001,812,792,100,100,0.001,1604,7
0.726,0.001,858,846,100,100,0.001,1704,7
0.752,0.001,908,896,100,100,0.001,1804,7
0.762,0.001,949,955,100,100,0.001,1904,7
0.79,0.001,1001,1003,100,100,0.001,2004,7
0.476,0.001,54,50,100,100,0.001,104,8
0.472,0.001,102,102,100,100,0.001,204,8
0.468,0.001,150,154,100,100,0.001,304,8
0.466,0.001,195,209,100,100,0.001,404,8
0.476,0.001,242,262,100,100,0.001,504,8
0.492,0.001,293,311,100,100,0.001,604,8
0.484,0.001,343,361,100,100,0.001,704,8
0.498,0.001,400,404,100,100,0.001,804,8
0.514,0.001,450,454,100,100,0.001,904,8
0.556,0.001,504,500,100,100,0.001,1004,8
0.588,0.001,546,558,100,100,0.001,1104,8
0.59,0.001,592,612,100,100,0.001,1204,8
0.61,0.001,649,655,100,100,0.001,1304,8
0.626,0.001,703,701,100,100,0.001,1404,8
0.658,0.001,747,757,100,100,0.001,1504,8
0.676,0.001,788,816,100,100,0.001,1604,8
0.696,0.001,837,867,100,100,0.001,1704,8
0.722,0.001,886,918,100,100,0.001,1804,8
0.738,0.001,946,958,100,100,0.001,1904,8
0.774,0.001,997,1007,100,100,0.001,2004,8
0.494,0.001,45,59,100,100,0.001,104,9
0.504,0.001,100,104,100,100,0.001,204,9
0.496,0.001,156,148,100,100,0.001,304,9
0.496,0.001,203,201,100,100,0.001,404,9
0.496,0.001,255,249,100,100,0.001,504,9
0.508,0.001,303,301,100,100,0.001,604,9
0.52,0.001,362,342,100,100,0.001,704,9
0.53,0.001,414,390,100,100,0.001,804,9
0.548,0.001,463,441,100,100,0.001,904,9
0.564,0.001,509,495,100,100,0.001,1004,9
0.572,0.001,554,550,100,100,0.001,1104,9
0.584,0.001,606,598,100,100,0.001,1204,9
0.6,0.001,655,649,100,100,0.001,1304,9
0.634,0.001,703,701,100,100,0.001,1404,9
0.644,0.001,747,757,100,100,0.001,1504,9
0.676,0.001,791,813,100,100,0.001,1604,9
0.694,0.001,838,866,100,100,0.001,1704,9
0.718,0.001,896,908,100,100,0.001,1804,9
0.732,0.001,941,963,100,100,0.001,1904,9
0.77,0.001,994,1010,100,100,0.001,2004,9
0.51,0.001,59,45,100,100,0.001,104,10
0.518,0.001,103,101,100,100,0.001,204,10
0.536,0.001,158,146,100,100,0.001,304,10
0.542,0.001,204,200,100,100,0.001,404,10
0.55,0.001,250,254,100,100,0.001,504,10
0.556,0.001,299,305,100,100,0.001,604,10
0.578,0.001,348,356,100,100,0.001,704,10
0.57,0.001,396,408,100,100,0.001,804,10
0.576,0.001,451,453,100,100,0.001,904,10
0.602,0.001,507,497,100,100,0.001,1004,10
0.618,0.001,555,549,100,100,0.001,1104,10
0.628,0.001,601,603,100,100,0.001,1204,10
0.63,0.001,652,652,100,100,0.001,1304,10
0.64,0.001,703,701,100,100,0.001,1404,10
0.656,0.001,750,754,100,100,0.001,1504,10
0.686,0.001,796,808,100,100,0.001,1604,10
0.722,0.001,856,848,100,100,0.001,1704,10
0.74,0.001,909,895,100,100,0.001,1804,10
0.752,0.001,954,950,100,100,0.001,1904,10
0.776,0.001,1007,997,100,100,0.001,2004,10
0.486,0.001,54,50,100,100,0.001,104,11
0.488,0.001,104,100,100,100,0.001,204,11
0.502,0.001,159,145,100,100,0.001,304,11
0.522,0.001,217,187,100,100,0.001,404,11
0.52,0.001,281,223,100,100,0.001,504,11
0.534,0.001,326,278,100,100,0.001,604,11
0.546,0.001,371,333,100,100,0.001,704,11
0.568,0.001,419,385,100,100,0.001,804,11
0.582,0.001,469,435,100,100,0.001,904,11
0.596,0.001,520,484,100,100,0.001,1004,11
0.598,0.001,559,545,100,100,0.001,1104,11
0.624,0.001,599,605,100,100,0.001,1204,11
0.634,0.001,652,652,100,100,0.001,1304,11
0.638,0.001,700,704,100,100,0.001,1404,11
0.664,0.001,752,752,100,100,0.001,1504,11
0.682,0.001,800,804,100,100,0.001,1604,11
0.738,0.001,851,853,100,100,0.001,1704,11
0.738,0.001,897,907,100,100,0.001,1804,11
0.768,0.001,943,961,100,100,0.001,1904,11
0.796,0.001,985,1019,100,100,0.001,2004,11
0.534,0.001,58,46,100,100,0.001,104,12
0.534,0.001,111,93,100,100,0.001,204,12
0.534,0.001,167,137,100,100,0.001,304,12
0.526,0.001,222,182,100,100,0.001,404,12
0.53,0.001,259,245,100,100,0.001,504,12
0.534,0.001,298,306,100,100,0.001,604,12
0.548,0.001,348,356,100,100,0.001,704,12
0.568,0.001,399,405,100,100,0.001,804,12
0.58,0.001,451,453,100,100,0.001,904,12
0.604,0.001,507,497,100,100,0.001,1004,12
0.616,0.001,559,545,100,100,0.001,1104,12
0.632,0.001,603,601,100,100,0.001,1204,12
0.644,0.001,654,650,100,100,0.001,1304,12
0.652,0.001,692,712,100,100,0.001,1404,12
0.678,0.001,732,772,100,100,0.001,1504,12
0.696,0.001,785,819,100,100,0.001,1604,12
0.728,0.001,836,868,100,100,0.001,1704,12
0.754,0.001,889,915,100,100,0.001,1804,12
0.772,0.001,931,973,100,100,0.001,1904,12
0.802,0.001,987,1017,100,100,0.001,2004,12
0.49,0.001,55,49,100,100,0.001,104,13
0.508,0.001,108,96,100,100,0.001,204,13
0.526,0.001,164,140,100,100,0.001,304,13
0.514,0.001,211,193,100,100,0.001,404,13
0.518,0.001,257,247,100,100,0.001,504,13
0.514,0.001,313,291,100,100,0.001,604,13
0.532,0.001,365,339,100,100,0.001,704,13
0.538,0.001,424,380,100,100,0.001,804,13
0.558,0.001,485,419,100,100,0.001,904,13
0.564,0.001,527,477,100,100,0.001,1004,13
0.586,0.001,572,532,100,100,0.001,1104,13
0.606,0.001,619,585,100,100,0.001,1204,13
0.632,0.001,658,646,100,100,0.001,1304,13
0.658,0.001,709,695,100,100,0.001,1404,13
0.676,0.001,761,743,100,100,0.001,1504,13
0.702,0.001,813,791,100,100,0.001,1604,13
0.708,0.001,868,836,100,100,0.001,1704,13
0.738,0.001,915,889,100,100,0.001,1804,13
0.774,0.001,961,943,100,100,0.001,1904,13
0.808,0.001,1011,993,100,100,0.001,2004,13
0.516,0.001,50,54,100,100,0.001,104,14
0.516,0.001,103,101,100,100,0.001,204,14
0.518,0.001,143,161,100,100,0.001,304,14
0.542,0.001,191,213,100,100,0.001,404,14
0.55,0.001,247,257,100,100,0.001,504,14
0.576,0.001,294,310,100,100,0.001,604,14
0.594,0.001,345,359,100,100,0.001,704,14
0.6,0.001,398,406,100,100,0.001,804,14
0.616,0.001,446,458,100,100,0.001,904,14
0.626,0.001,505,499,100,100,0.001,1004,14
0.638,0.001,551,553,100,100,0.001,1104,14
0.648,0.001,600,604,100,100,0.001,1204,14
0.66,0.001,656,648,100,100,0.001,1304,14
0.676,0.001,707,697,100,100,0.001,1404,14
0.682,0.001,757,747,100,100,0.001,1504,14
0.714,0.001,810,794,100,100,0.001,1604,14
0.72,0.001,857,847,100,100,0.001,1704,14
0.75,0.001,907,897,100,100,0.001,1804,14
0.778,0.001,956,948,100,100,0.001,1904,14
0.806,0.001,1002,1002,100,100,0.001,2004,14
0.486,0.001,54,50,100,100,0.001,104,15
0.494,0.001,98,106,100,100,0.001,204,15
0.498,0.001,150,154,100,100,0.001,304,15
0.502,0.001,209,195,100,100,0.001,404,15
0.488,0.001,259,245,100,100,0.001,504,15
0.51,0.001,311,293,100,100,0.001,604,15
0.532,0.001,363,341,100,100,0.001,704,15
0.548,0.001,413,391,100,100,0.001,804,15
0.556,0.001,471,433,100,100,0.001,904,15
0.572,0.001,516,488,100,100,0.001,1004,15
0.598,0.001,569,535,100,100,0.001,1104,15
0.612,0.001,621,583,100,100,0.001,1204,15
0.62,0.001,666,638,100,100,0.001,1304,15
0.638,0.001,711,693,100,100,0.001,1404,15
0.644,0.001,759,745,100,100,0.001,1504,15
0.67,0.001,795,809,100,100,0.001,1604,15
0.686,0.001,851,853,100,100,0.001,1704,15
0.702,0.001,903,901,100,100,0.001,1804,15
0.736,0.001,962,942,100,100,0.001,1904,15
0.778,0.001,1008,996,100,100,0.001,2004,15
0.472,0.001,52,52,100,100,0.001,104,16
0.476,0.001,98,106,100,100,0.001,204,16
0.49,0.001,145,159,100,100,0.001,304,16
0.512,0.001,190,214,100,100,0.001,404,16
0.52,0.001,239,265,100,100,0.001,504,16
0.54,0.001,289,315,100,100,0.001,604,16
0.54,0.001,339,365,100,100,0.001,704,16
0.552,0.001,394,410,100,100,0.001,804,16
0.576,0.001,442,462,100,100,0.001,904,16
0.58,0.001,491,513,100,100,0.001,1004,16
0.596,0.001,545,559,100,100,0.001,1104,16
0.612,0.001,597,607,100,100,0.001,1204,16
0.642,0.001,648,656,100,100,0.001,1304,16
0.666,0.001,696,708,100,100,0.001,1404,16
0.67,0.001,744,760,100,100,0.001,1504,16
0.698,0.001,793,811,100,100,0.001,1604,16
0.726,0.001,838,866,100,100,0.001,1704,16
0.756,0.001,899,905,100,100,0.001,1804,16
0.78,0.001,951,953,100,100,0.001,1904,16
0.82,0.001,999,1005,100,100,0.001,2004,16
0.494,0.001,57,47,100,100,0.001,104,17
0.502,0.001,106,98,100,100,0.001,204,17
0.518,0.001,154,150,100,100,0.001,304,17
0.53,0.001,207,197,100,100,0.001,404,17
0.53,0.001,260,244,100,100,0.001,504,17
0.542,0.001,313,291,100,100,0.001,604,17
0.556,0.001,347,357,100,100,0.001,704,17
0.556,0.001,396,408,100,100,0.001,804,17
0.558,0.001,446,458,100,100,0.001,904,17
0.572,0.001,496,508,100,100,0.001,1004,17
0.582,0.001,551,553,100,100,0.001,1104,17
0.604,0.001,603,601,100,100,0.001,1204,17
0.612,0.001,650,654,100,100,0.001,1304,17
0.646,0.001,701,703,100,100,0.001,1404,17
0.674,0.001,752,752,100,100,0.001,1504,17
0.702,0.001,803,801,100,100,0.001,1604,17
0.724,0.001,851,853,100,100,0.001,1704,17
0.744,0.001,903,901,100,100,0.001,1804,17
0.78,0.001,956,948,100,100,0.001,1904,17
0.804,0.001,1005,999,100,100,0.001,2004,17
0.498,0.001,46,58,100,100,0.001,104,18
0.496,0.001,91,113,100,100,0.001,204,18
0.506,0.001,133,171,100,100,0.001,304,18
0.524,0.001,183,221,100,100,0.001,404,18
0.542,0.001,228,276,100,100,0.001,504,18
0.548,0.001,280,324,100,100,0.001,604,18
0.572,0.001,333,371,100,100,0.001,704,18
0.568,0.001,388,416,100,100,0.001,804,18
0.576,0.001,442,462,100,100,0.001,904,18
0.588,0.001,490,514,100,100,0.001,1004,18
0.614,0.001,539,565,100,100,0.001,1104,18
0.638,0.001,591,613,100,100,0.001,1204,18
0.65,0.001,649,655,100,100,0.001,1304,18
0.682,0.001,697,707,100,100,0.001,1404,18
0.696,0.001,749,755,100,100,0.001,1504,18
0.714,0.001,792,812,100,100,0.001,1604,18
0.738,0.001,848,856,100,100,0.001,1704,18
0.748,0.001,900,904,100,100,0.001,1804,18
0.784,0.001,950,954,100,100,0.001,1904,18
0.812,0.001,999,1005,100,100,0.001,2004,18
0.526,0.001,56,48,100,100,0.001,104,19
0.53,0.001,110,94,100,100,0.001,204,19
0.528,0.001,153,151,100,100,0.001,304,19
0.53,0.001,201,203,100,100,0.001,404,19
0.544,0.001,256,248,100,100,0.001,504,19
0.556,0.001,309,295,100,100,0.001,604,19
0.582,0.001,357,347,100,100,0.001,704,19
0.592,0.001,395,409,100,100,0.001,804,19
0.598,0.001,447,457,100,100,0.001,904,19
0.612,0.001,498,506,100,100,0.001,1004,19
0.622,0.001,549,555,100,100,0.001,1104,19
0.642,0.001,595,609,100,100,0.001,1204,19
0.676,0.001,645,659,100,100,0.001,1304,19
0.706,0.001,690,714,100,100,0.001,1404,19
0.716,0.001,734,770,100,100,0.001,1504,19
0.736,0.001,787,817,100,100,0.001,1604,19
0.748,0.001,843,861,100,100,0.001,1704,19
0.77,0.001,899,905,100,100,0.001,1804,19
0.794,0.001,950,954,100,100,0.001,1904,19
0.82,0.001,998,1006,100,100,0.001,2004,19
0.494,0.001,55,49,100,100,0.001,104,20
0.5,0.001,100,104,100,100,0.001,204,20
0.5,0.001,156,148,100,100,0.001,304,20
0.51,0.001,206,198,100,100,0.001,404,20
0.52,0.001,251,253,100,100,0.001,504,20
0.526,0.001,299,305,100,100,0.001,604,20
0.538,0.001,343,361,100,100,0.001,704,20
0.55,0.001,399,405,100,100,0.001,804,20
0.568,0.001,448,456,100,100,0.001,904,20
0.578,0.001,495,509,100,100,0.001,1004,20
0.582,0.001,539,565,100,100,0.001,1104,20
0.59,0.001,592,612,100,100,0.001,1204,20
0.604,0.001,633,671,100,100,0.001,1304,20
0.622,0.001,685,719,100,100,0.001,1404,20
0.638,0.001,731,773,100,100,0.001,1504,20
0.67,0.001,780,824,100,100,0.001,1604,20
0.71,0.001,829,875,100,100,0.001,1704,20
0.736,0.001,882,922,100,100,0.001,1804,20
0.772,0.001,930,974,100,100,0.001,1904,20
0.804,0.001,988,1016,100,100,0.001,2004,20
0.554,0.001,45,59,100,100,0.01,104,1
0.54,0.001,91,113,100,100,0.01,204,1
0.538,0.001,139,165,100,100,0.01,304,1
0.556,0.001,196,208,100,100,0.01,404,1
0.594,0.001,247,257,100,100,0.01,504,1
0.626,0.001,294,310,100,100,0.01,604,1
0.656,0.001,341,363,100,100,0.01,704,1
0.704,0.001,395,409,100,100,0.01,804,1
0.722,0.001,450,454,100,100,0.01,904,1
0.766,0.001,501,503,100,100,0.01,1004,1
0.812,0.001,549,555,100,100,0.01,1104,1
0.86,0.001,595,609,100,100,0.01,1204,1
0.864,0.001,640,664,100,100,0.01,1304,1
0.896,0.001,690,714,100,100,0.01,1404,1
0.884,0.001,746,758,100,100,0.01,1504,1
0.894,0.001,798,806,100,100,0.01,1604,1
0.914,0.001,851,853,100,100,0.01,1704,1
0.912,0.001,893,911,100,100,0.01,1804,1
0.922,0.001,945,959,100,100,0.01,1904,1
0.938,0.001,993,1011,100,100,0.01,2004,1
0.578,0.001,52,52,100,100,0.01,104,2
0.594,0.001,102,102,100,100,0.01,204,2
0.62,0.001,150,154,100,100,0.01,304,2
0.636,0.001,196,208,100,100,0.01,404,2
0.638,0.001,246,258,100,100,0.01,504,2
0.698,0.001,295,309,100,100,0.01,604,2
0.724,0.001,338,366,100,100,0.01,704,2
0.766,0.001,384,420,100,100,0.01,804,2
0.82,0.001,438,466,100,100,0.01,904,2
0.864,0.001,489,515,100,100,0.01,1004,2
0.9,0.001,536,568,100,100,0.01,1104,2
0.922,0.001,586,618,100,100,0.01,1204,2
0.948,0.001,644,660,100,100,0.01,1304,2
0.958,0.001,697,707,100,100,0.01,1404,2
0.95,0.001,751,753,100,100,0.01,1504,2
0.948,0.001,804,800,100,100,0.01,1604,2
0.954,0.001,857,847,100,100,0.01,1704,2
0.954,0.001,904,900,100,100,0.01,1804,2
0.96,0.001,955,949,100,100,0.01,1904,2
0.962,0.001,1004,1000,100,100,0.01,2004,2
0.546,0.001,45,59,100,100,0.01,104,3
0.554,0.001,97,107,100,100,0.01,204,3
0.54,0.001,142,162,100,100,0.01,304,3
0.586,0.001,192,212,100,100,0.01,404,3
0.634,0.001,252,252,100,100,0.01,504,3
0.686,0.001,291,313,100,100,0.01,604,3
0.702,0.001,344,360,100,100,0.01,704,3
0.74,0.001,398,406,100,100,0.01,804,3
0.796,0.001,444,460,100,100,0.01,904,3
0.838,0.001,491,513,100,100,0.01,1004,3
0.866,0.001,545,559,100,100,0.01,1104,3
0.896,0.001,602,602,100,100,0.01,1204,3
0.92,0.001,646,658,100,100,0.01,1304,3
0.926,0.001,692,712,100,100,0.01,1404,3
0.936,0.001,753,751,100,100,0.01,1504,3
0.936,0.001,799,805,100,100,0.01,1604,3
0.928,0.001,843,861,100,100,0.01,1704,3
0.938,0.001,887,917,100,100,0.01,1804,3
0.944,0.001,944,960,100,100,0.01,1904,3
0.952,0.001,1001,1003,100,100,0.01,2004,3
0.546,0.001,58,46,100,100,0.01,104,4
0.576,0.001,106,98,100,100,0.01,204,4
0.582,0.001,158,146,100,100,0.01,304,4
0.59,0.001,209,195,100,100,0.01,404,4
0.586,0.001,259,245,100,100,0.01,504,4
0.608,0.001,307,297,100,100,0.01,604,4
0.646,0.001,354,350,100,100,0.01,704,4
0.712,0.001,404,400,100,100,0.01,804,4
0.758,0.001,446,458,100,100,0.01,904,4
0.812,0.001,495,509,100,100,0.01,1004,4
0.866,0.001,550,554,100,100,0.01,1104,4
0.88,0.001,611,593,100,100,0.01,1204,4
0.896,0.001,655,649,100,100,0.01,1304,4
0.924,0.001,705,699,100,100,0.01,1404,4
0.93,0.001,755,749,100,100,0.01,1504,4
0.946,0.001,810,794,100,100,0.01,1604,4
0.954,0.001,865,839,100,100,0.01,1704,4
0.956,0.001,917,887,100,100,0.01,1804,4
0.964,0.001,964,940,100,100,0.01,1904,4
0.964,0.001,1022,982,100,100,0.01,2004,4
0.53,0.001,59,45,100,100,0.01,104,5
0.552,0.001,106,98,100,100,0.01,204,5
0.554,0.001,158,146,100,100,0.01,304,5
0.602,0.001,202,202,100,100,0.01,404,5
0.624,0.001,252,252,100,100,0.01,504,5
0.67,0.001,299,305,100,100,0.01,604,5
0.708,0.001,347,357,100,100,0.01,704,5
0.756,0.001,389,415,100,100,0.01,804,5
0.792,0.001,438,466,100,100,0.01,904,5
0.842,0.001,488,516,100,100,0.01,1004,5
0.872,0.001,537,567,100,100,0.01,1104,5
0.896,0.001,579,625,100,100,0.01,1204,5
0.906,0.001,637,667,100,100,0.01,1304,5
0.928,0.001,683,721,100,100,0.01,1404,5
0.932,0.001,737,767,100,100,0.01,1504,5
0.95,0.001,795,809,100,100,0.01,1604,5
0.952,0.001,853,851,100,100,0.01,1704,5
0.956,0.001,914,890,100,100,0.01,1804,5
0.966,0.001,967,937,100,100,0.01,1904,5
0.966,0.001,1013,991,100,100,0.01,2004,5
0.488,0.001,60,44,100,100,0.01,104,6
0.5,0.001,115,89,100,100,0.01,204,6
0.52,0.001,169,135,100,100,0.01,304,6
0.528,0.001,229,175,100,100,0.01,404,6
0.562,0.001,278,226,100,100,0.01,504,6
0.614,0.001,322,282,100,100,0.01,604,6
0.644,0.001,368,336,100,100,0.01,704,6
0.704,0.001,417,387,100,100,0.01,804,6
0.742,0.001,473,431,100,100,0.01,904,6
0.794,0.001,532,472,100,100,0.01,1004,6
0.866,0.001,579,525,100,100,0.01,1104,6
0.916,0.001,617,587,100,100,0.01,1204,6
0.93,0.001,674,630,100,100,0.01,1304,6
0.944,0.001,716,688,100,100,0.01,1404,6
0.952,0.001,771,733,100,100,0.01,1504,6
0.956,0.001,827,777,100,100,0.01,1604,6
0.964,0.001,873,831,100,100,0.01,1704,6
0.968,0.001,926,878,100,100,0.01,1804,6
0.968,0.001,970,934,100,100,0.01,1904,6
0.972,0.001,1011,993,100,100,0.01,2004,6
0.522,0.001,54,50,100,100,0.01,104,7
0.56,0.001,103,101,100,100,0.01,204,7
0.58,0.001,160,144,100,100,0.01,304,7
0.63,0.001,208,196,100,100,0.01,404,7
0.664,0.001,251,253,100,100,0.01,504,7
0.696,0.001,295,309,100,100,0.01,604,7
0.712,0.001,355,349,100,100,0.01,704,7
0.754,0.001,398,406,100,100,0.01,804,7
0.804,0.001,446,458,100,100,0.01,904,7
0.87,0.001,497,507,100,100,0.01,1004,7
0.886,0.001,544,560,100,100,0.01,1104,7
0.9,0.001,592,612,100,100,0.01,1204,7
0.884,0.001,635,669,100,100,0.01,1304,7
0.928,0.001,686,718,100,100,0.01,1404,7
0.952,0.001,736,768,100,100,0.01,1504,7
0.952,0.001,792,812,100,100,0.01,1604,7
0.956,0.001,847,857,100,100,0.01,1704,7
0.966,0.001,899,905,100,100,0.01,1804,7
0.96,0.001,949,955,100,100,0.01,1904,7
0.968,0.001,997,1007,100,100,0.01,2004,7
0.548,0.001,53,51,100,100,0.01,104,8
0.57,0.001,110,94,100,100,0.01,204,8
0.558,0.001,154,150,100,100,0.01,304,8
0.626,0.001,204,200,100,100,0.01,404,8
0.664,0.001,256,248,100,100,0.01,504,8
0.686,0.001,312,292,100,100,0.01,604,8
0.732,0.001,363,341,100,100,0.01,704,8
0.776,0.001,409,395,100,100,0.01,804,8
0.808,0.001,456,448,100,100,0.01,904,8
0.862,0.001,505,499,100,100,0.01,1004,8
0.87,0.001,554,550,100,100,0.01,1104,8
0.906,0.001,609,595,100,100,0.01,1204,8
0.916,0.001,650,654,100,100,0.01,1304,8
0.926,0.001,697,707,100,100,0.01,1404,8
0.928,0.001,746,758,100,100,0.01,1504,8
0.932,0.001,798,806,100,100,0.01,1604,8
0.938,0.001,855,849,100,100,0.01,1704,8
0.944,0.001,901,903,100,100,0.01,1804,8
0.936,0.001,948,956,100,100,0.01,1904,8
0.938,0.001,997,1007,100,100,0.01,2004,8
0.562,0.001,51,53,100,100,0.01,104,9
0.538,0.001,105,99,100,100,0.01,204,9
0.568,0.001,153,151,100,100,0.01,304,9
0.59,0.001,212,192,100,100,0.01,404,9
0.626,0.001,261,243,100,100,0.01,504,9
0.644,0.001,309,295,100,100,0.01,604,9
0.654,0.001,357,347,100,100,0.01,704,9
0.708,0.001,408,396,100,100,0.01,804,9
0.788,0.001,456,448,100,100,0.01,904,9
0.834,0.001,498,506,100,100,0.01,1004,9
0.868,0.001,544,560,100,100,0.01,1104,9
0.896,0.001,596,608,100,100,0.01,1204,9
0.906,0.001,649,655,100,100,0.01,1304,9
0.93,0.001,698,706,100,100,0.01,1404,9
0.936,0.001,748,756,100,100,0.01,1504,9
0.944,0.001,795,809,100,100,0.01,1604,9
0.94,0.001,848,856,100,100,0.01,1704,9
0.952,0.001,901,903,100,100,0.01,1804,9
0.95,0.001,943,961,100,100,0.01,1904,9
0.952,0.001,996,1008,100,100,0.01,2004,9
0.554,0.001,55,49,100,100,0.01,104,10
0.52,0.001,105,99,100,100,0.01,204,10
0.53,0.001,151,153,100,100,0.01,304,10
0.56,0.001,194,210,100,100,0.01,404,10
0.592,0.001,239,265,100,100,0.01,504,10
0.62,0.001,290,314,100,100,0.01,604,10
0.636,0.001,331,373,100,100,0.01,704,10
0.718,0.001,378,426,100,100,0.01,804,10
0.762,0.001,423,481,100,100,0.01,904,10
0.822,0.001,481,523,100,100,0.01,1004,10
0.862,0.001,532,572,100,100,0.01,1104,10
0.89,0.001,584,620,100,100,0.01,1204,10
0.9,0.001,641,663,100,100,0.01,1304,10
0.92,0.001,697,707,100,100,0.01,1404,10
0.93,0.001,751,753,100,100,0.01,1504,10
0.934,0.001,800,804,100,100,0.01,1604,10
0.942,0.001,851,853,100,100,0.01,1704,10
0.942,0.001,904,900,100,100,0.01,1804,10
0.942,0.001,949,955,100,100,0.01,1904,10
0.954,0.001,998,1006,100,100,0.01,2004,10
0.508,0.001,53,51,100,100,0.01,104,11
0.594,0.001,103,101,100,100,0.01,204,11
0.592,0.001,166,138,100,100,0.01,304,11
0.622,0.001,223,181,100,100,0.01,404,11
0.624,0.001,268,236,100,100,0.01,504,11
0.656,0.001,319,285,100,100,0.01,604,11
0.694,0.001,363,341,100,100,0.01,704,11
0.754,0.001,414,390,100,100,0.01,804,11
0.788,0.001,466,438,100,100,0.01,904,11
0.834,0.001,512,492,100,100,0.01,1004,11
0.864,0.001,562,542,100,100,0.01,1104,11
0.88,0.001,609,595,100,100,0.01,1204,11
0.916,0.001,646,658,100,100,0.01,1304,11
0.94,0.001,692,712,100,100,0.01,1404,11
0.954,0.001,742,762,100,100,0.01,1504,11
0.966,0.001,802,802,100,100,0.01,1604,11
0.966,0.001,851,853,100,100,0.01,1704,11
0.966,0.001,905,899,100,100,0.01,1804,11
0.972,0.001,953,951,100,100,0.01,1904,11
0.972,0.001,1011,993,100,100,0.01,2004,11
0.52,0.001,56,48,100,100,0.01,104,12
0.55,0.001,104,100,100,100,0.01,204,12
0.56,0.001,153,151,100,100,0.01,304,12
0.606,0.001,201,203,100,100,0.01,404,12
0.638,0.001,249,255,100,100,0.01,504,12
0.684,0.001,295,309,100,100,0.01,604,12
0.69,0.001,338,366,100,100,0.01,704,12
0.742,0.001,389,415,100,100,0.01,804,12
0.786,0.001,442,462,100,100,0.01,904,12
0.84,0.001,497,507,100,100,0.01,1004,12
0.856,0.001,555,549,100,100,0.01,1104,12
0.884,0.001,598,606,100,100,0.01,1204,12
0.92,0.001,653,651,100,100,0.01,1304,12
0.942,0.001,700,704,100,100,0.01,1404,12
0.938,0.001,750,754,100,100,0.01,1504,12
0.942,0.001,803,801,100,100,0.01,1604,12
0.948,0.001,853,851,100,100,0.01,1704,12
0.956,0.001,896,908,100,100,0.01,1804,12
0.962,0.001,949,955,100,100,0.01,1904,12
0.966,0.001,999,1005,100,100,0.01,2004,12
0.55,0.001,53,51,100,100,0.01,104,13
0.57,0.001,107,97,100,100,0.01,204,13
0.608,0.001,154,150,100,100,0.01,304,13
0.62,0.001,203,201,100,100,0.01,404,13
0.65,0.001,246,258,100,100,0.01,504,13
0.666,0.001,292,312,100,100,0.01,604,13
0.712,0.001,352,352,100,100,0.01,704,13
0.75,0.001,407,397,100,100,0.01,804,13
0.784,0.001,458,446,100,100,0.01,904,13
0.832,0.001,514,490,100,100,0.01,1004,13
0.844,0.001,573,531,100,100,0.01,1104,13
0.882,0.001,627,577,100,100,0.01,1204,13
0.924,0.001,679,625,100,100,0.01,1304,13
0.94,0.001,724,680,100,100,0.01,1404,13
0.94,0.001,777,727,100,100,0.01,1504,13
0.944,0.001,831,773,100,100,0.01,1604,13
0.95,0.001,887,817,100,100,0.01,1704,13
0.952,0.001,930,874,100,100,0.01,1804,13
0.962,0.001,972,932,100,100,0.01,1904,13
0.964,0.001,1015,989,100,100,0.01,2004,13
0.534,0.001,59,45,100,100,0.01,104,14
0.57,0.001,111,93,100,100,0.01,204,14
0.594,0.001,166,138,100,100,0.01,304,14
0.618,0.001,213,191,100,100,0.01,404,14
0.644,0.001,265,239,100,100,0.01,504,14
0.648,0.001,321,283,100,100,0.01,604,14
0.696,0.001,373,331,100,100,0.01,704,14
0.738,0.001,428,376,100,100,0.01,804,14
0.79,0.001,469,435,100,100,0.01,904,14
0.854,0.001,519,485,100,100,0.01,1004,14
0.884,0.001,566,538,100,100,0.01,1104,14
0.912,0.001,617,587,100,100,0.01,1204,14
0.91,0.001,668,636,100,100,0.01,1304,14
0.938,0.001,718,686,100,100,0.01,1404,14
0.934,0.001,766,738,100,100,0.01,1504,14
0.94,0.001,812,792,100,100,0.01,1604,14
0.96,0.001,863,841,100,100,0.01,1704,14
0.96,0.001,908,896,100,100,0.01,1804,14
0.962,0.001,944,960,100,100,0.01,1904,14
0.97,0.001,996,1008,100,100,0.01,2004,14
0.53,0.001,50,54,100,100,0.01,104,15
0.56,0.001,101,103,100,100,0.01,204,15
0.552,0.001,150,154,100,100,0.01,304,15
0.566,0.001,206,198,100,100,0.01,404,15
0.594,0.001,250,254,100,100,0.01,504,15
0.628,0.001,304,300,100,100,0.01,604,15
0.666,0.001,356,348,100,100,0.01,704,15
0.72,0.001,400,404,100,100,0.01,804,15
0.742,0.001,462,442,100,100,0.01,904,15
0.818,0.001,497,507,100,100,0.01,1004,15
0.858,0.001,539,565,100,100,0.01,1104,15
0.9,0.001,592,612,100,100,0.01,1204,15
0.914,0.001,634,670,100,100,0.01,1304,15
0.934,0.001,691,713,100,100,0.01,1404,15
0.934,0.001,741,763,100,100,0.01,1504,15
0.938,0.001,791,813,100,100,0.01,1604,15
0.942,0.001,842,862,100,100,0.01,1704,15
0.946,0.001,898,906,100,100,0.01,1804,15
0.952,0.001,950,954,100,100,0.01,1904,15
0.944,0.001,1000,1004,100,100,0.01,2004,15
0.53,0.001,58,46,100,100,0.01,104,16
0.574,0.001,112,92,100,100,0.01,204,16
0.598,0.001,165,139,100,100,0.01,304,16
0.618,0.001,213,191,100,100,0.01,404,16
0.636,0.001,262,242,100,100,0.01,504,16
0.666,0.001,311,293,100,100,0.01,604,16
0.68,0.001,363,341,100,100,0.01,704,16
0.728,0.001,414,390,100,100,0.01,804,16
0.766,0.001,465,439,100,100,0.01,904,16
0.812,0.001,520,484,100,100,0.01,1004,16
0.826,0.001,573,531,100,100,0.01,1104,16
0.9,0.001,625,579,100,100,0.01,1204,16
0.912,0.001,669,635,100,100,0.01,1304,16
0.946,0.001,714,690,100,100,0.01,1404,16
0.954,0.001,763,741,100,100,0.01,1504,16
0.958,0.001,810,794,100,100,0.01,1604,16
0.96,0.001,851,853,100,100,0.01,1704,16
0.964,0.001,903,901,100,100,0.01,1804,16
0.962,0.001,954,950,100,100,0.01,1904,16
0.964,0.001,1004,1000,100,100,0.01,2004,16
0.484,0.001,43,61,100,100,0.01,104,17
0.498,0.001,88,116,100,100,0.01,204,17
0.506,0.001,128,176,100,100,0.01,304,17
0.556,0.001,184,220,100,100,0.01,404,17
0.602,0.001,236,268,100,100,0.01,504,17
0.638,0.001,288,316,100,100,0.01,604,17
0.68,0.001,348,356,100,100,0.01,704,17
0.73,0.001,402,402,100,100,0.01,804,17
0.79,0.001,439,465,100,100,0.01,904,17
0.854,0.001,488,516,100,100,0.01,1004,17
0.884,0.001,536,568,100,100,0.01,1104,17
0.92,0.001,588,616,100,100,0.01,1204,17
0.932,0.001,645,659,100,100,0.01,1304,17
0.942,0.001,696,708,100,100,0.01,1404,17
0.956,0.001,751,753,100,100,0.01,1504,17
0.96,0.001,797,807,100,100,0.01,1604,17
0.958,0.001,847,857,100,100,0.01,1704,17
0.958,0.001,896,908,100,100,0.01,1804,17
0.958,0.001,951,953,100,100,0.01,1904,17
0.96,0.001,1006,998,100,100,0.01,2004,17
0.514,0.001,49,55,100,100,0.01,104,18
0.536,0.001,95,109,100,100,0.01,204,18
0.584,0.001,140,164,100,100,0.01,304,18
0.64,0.001,194,210,100,100,0.01,404,18
0.664,0.001,250,254,100,100,0.01,504,18
0.688,0.001,306,298,100,100,0.01,604,18
0.706,0.001,353,351,100,100,0.01,704,18
0.76,0.001,405,399,100,100,0.01,804,18
0.806,0.001,451,453,100,100,0.01,904,18
0.856,0.001,508,496,100,100,0.01,1004,18
0.886,0.001,564,540,100,100,0.01,1104,18
0.932,0.001,616,588,100,100,0.01,1204,18
0.94,0.001,663,641,100,100,0.01,1304,18
0.94,0.001,715,689,100,100,0.01,1404,18
0.948,0.001,770,734,100,100,0.01,1504,18
0.954,0.001,818,786,100,100,0.01,1604,18
0.952,0.001,870,834,100,100,0.01,1704,18
0.956,0.001,924,880,100,100,0.01,1804,18
0.958,0.001,974,930,100,100,0.01,1904,18
0.964,0.001,1016,988,100,100,0.01,2004,18
0.51,0.001,51,53,100,100,0.01,104,19
0.484,0.001,95,109,100,100,0.01,204,19
0.54,0.001,146,158,100,100,0.01,304,19
0.602,0.001,190,214,100,100,0.01,404,19
0.646,0.001,232,272,100,100,0.01,504,19
0.65,0.001,291,313,100,100,0.01,604,19
0.7,0.001,340,364,100,100,0.01,704,19
0.736,0.001,391,413,100,100,0.01,804,19
0.754,0.001,434,470,100,100,0.01,904,19
0.82,0.001,484,520,100,100,0.01,1004,19
0.836,0.001,542,562,100,100,0.01,1104,19
0.89,0.001,587,617,100,100,0.01,1204,19
0.904,0.001,639,665,100,100,0.01,1304,19
0.924,0.001,685,719,100,100,0.01,1404,19
0.93,0.001,737,767,100,100,0.01,1504,19
0.934,0.001,787,817,100,100,0.01,1604,19
0.944,0.001,839,865,100,100,0.01,1704,19
0.946,0.001,892,912,100,100,0.01,1804,19
0.954,0.001,944,960,100,100,0.01,1904,19
0.958,0.001,999,1005,100,100,0.01,2004,19
0.476,0.001,54,50,100,100,0.01,104,20
0.518,0.001,97,107,100,100,0.01,204,20
0.518,0.001,156,148,100,100,0.01,304,20
0.552,0.001,204,200,100,100,0.01,404,20
0.592,0.001,252,252,100,100,0.01,504,20
0.626,0.001,309,295,100,100,0.01,604,20
0.652,0.001,360,344,100,100,0.01,704,20
0.724,0.001,408,396,100,100,0.01,804,20
0.782,0.001,460,444,100,100,0.01,904,20
0.858,0.001,513,491,100,100,0.01,1004,20
0.874,0.001,563,541,100,100,0.01,1104,20
0.904,0.001,614,590,100,100,0.01,1204,20
0.928,0.001,663,641,100,100,0.01,1304,20
0.94,0.001,714,690,100,100,0.01,1404,20
0.954,0.001,760,744,100,100,0.01,1504,20
0.952,0.001,797,807,100,100,0.01,1604,20
0.95,0.001,847,857,100,100,0.01,1704,20
0.956,0.001,901,903,100,100,0.01,1804,20
0.958,0.001,942,962,100,100,0.01,1904,20
0.96,0.001,991,1013,100,100,0.01,2004,20
