trial,train_size,embed_dim,hidden_dim,alpha,learning_rate,accuracy,batch_pos,batch_neg
1,104,10,100,1e-05,0.01,0.522,59,45
1,204,10,100,1e-05,0.01,0.462,100,104
1,304,10,100,1e-05,0.01,0.478,148,156
1,404,10,100,1e-05,0.01,0.49,189,215
1,504,10,100,1e-05,0.01,0.464,240,264
1,604,10,100,1e-05,0.01,0.474,296,308
1,704,10,100,1e-05,0.01,0.498,340,364
1,804,10,100,1e-05,0.01,0.522,391,413
1,904,10,100,1e-05,0.01,0.498,440,464
1,1004,10,100,1e-05,0.01,0.494,489,515
1,1104,10,100,1e-05,0.01,0.48,538,566
1,1204,10,100,1e-05,0.01,0.496,589,615
1,1304,10,100,1e-05,0.01,0.48,649,655
1,1404,10,100,1e-05,0.01,0.524,702,702
1,1504,10,100,1e-05,0.01,0.482,754,750
1,1604,10,100,1e-05,0.01,0.55,805,799
1,1704,10,100,1e-05,0.01,0.56,859,845
1,1804,10,100,1e-05,0.01,0.556,911,893
1,1904,10,100,1e-05,0.01,0.606,963,941
1,2004,10,100,1e-05,0.01,0.596,1010,994
1,2104,10,100,1e-05,0.01,0.64,1060,1044
1,2204,10,100,1e-05,0.01,0.652,1115,1089
1,2304,10,100,1e-05,0.01,0.686,1159,1145
1,2404,10,100,1e-05,0.01,0.678,1216,1188
1,2504,10,100,1e-05,0.01,0.674,1269,1235
1,2604,10,100,1e-05,0.01,0.686,1317,1287
1,2704,10,100,1e-05,0.01,0.672,1358,1346
1,2804,10,100,1e-05,0.01,0.644,1406,1398
1,2904,10,100,1e-05,0.01,0.694,1453,1451
1,3004,10,100,1e-05,0.01,0.668,1498,1506
1,3104,10,100,1e-05,0.01,0.686,1556,1548
1,3204,10,100,1e-05,0.01,0.72,1606,1598
1,3304,10,100,1e-05,0.01,0.692,1652,1652
1,3404,10,100,1e-05,0.01,0.696,1697,1707
1,3504,10,100,1e-05,0.01,0.724,1745,1759
1,3604,10,100,1e-05,0.01,0.706,1797,1807
1,3704,10,100,1e-05,0.01,0.696,1845,1859
1,3804,10,100,1e-05,0.01,0.702,1886,1918
1,3904,10,100,1e-05,0.01,0.69,1936,1968
1,4004,10,100,1e-05,0.01,0.742,1989,2015
1,4104,10,100,1e-05,0.01,0.71,2043,2061
1,4204,10,100,1e-05,0.01,0.722,2101,2103
1,4304,10,100,1e-05,0.01,0.74,2145,2159
1,4404,10,100,1e-05,0.01,0.734,2199,2205
1,4504,10,100,1e-05,0.01,0.742,2242,2262
1,4604,10,100,1e-05,0.01,0.7,2295,2309
1,4704,10,100,1e-05,0.01,0.736,2355,2349
1,4804,10,100,1e-05,0.01,0.722,2407,2397
1,4904,10,100,1e-05,0.01,0.712,2453,2451
1,5004,10,100,1e-05,0.01,0.73,2496,2508
1,5104,10,100,1e-05,0.01,0.728,2532,2572
1,5204,10,100,1e-05,0.01,0.734,2585,2619
1,5304,10,100,1e-05,0.01,0.726,2637,2667
1,5404,10,100,1e-05,0.01,0.728,2691,2713
1,5504,10,100,1e-05,0.01,0.718,2736,2768
1,5604,10,100,1e-05,0.01,0.758,2789,2815
1,5704,10,100,1e-05,0.01,0.728,2838,2866
1,5804,10,100,1e-05,0.01,0.758,2885,2919
1,5904,10,100,1e-05,0.01,0.764,2933,2971
1,6004,10,100,1e-05,0.01,0.74,2990,3014
1,6104,10,100,1e-05,0.01,0.74,3043,3061
1,6204,10,100,1e-05,0.01,0.782,3096,3108
1,6304,10,100,1e-05,0.01,0.746,3145,3159
1,6404,10,100,1e-05,0.01,0.722,3195,3209
1,6504,10,100,1e-05,0.01,0.746,3256,3248
1,6604,10,100,1e-05,0.01,0.74,3313,3291
1,6704,10,100,1e-05,0.01,0.708,3361,3343
1,6804,10,100,1e-05,0.01,0.77,3406,3398
1,6904,10,100,1e-05,0.01,0.778,3456,3448
1,7004,10,100,1e-05,0.01,0.772,3505,3499
1,7104,10,100,1e-05,0.01,0.752,3551,3553
1,7204,10,100,1e-05,0.01,0.734,3596,3608
1,7304,10,100,1e-05,0.01,0.71,3639,3665
1,7404,10,100,1e-05,0.01,0.756,3693,3711
1,7504,10,100,1e-05,0.01,0.768,3751,3753
1,7604,10,100,1e-05,0.01,0.792,3805,3799
1,7704,10,100,1e-05,0.01,0.79,3856,3848
1,7804,10,100,1e-05,0.01,0.796,3908,3896
1,7904,10,100,1e-05,0.01,0.798,3954,3950
1,8004,10,100,1e-05,0.01,0.794,4006,3998
1,8104,10,100,1e-05,0.01,0.786,4057,4047
1,8204,10,100,1e-05,0.01,0.812,4109,4095
1,8304,10,100,1e-05,0.01,0.794,4155,4149
1,8404,10,100,1e-05,0.01,0.766,4196,4208
1,8504,10,100,1e-05,0.01,0.77,4238,4266
1,8604,10,100,1e-05,0.01,0.786,4290,4314
1,8704,10,100,1e-05,0.01,0.764,4346,4358
1,8804,10,100,1e-05,0.01,0.812,4391,4413
1,8904,10,100,1e-05,0.01,0.81,4447,4457
1,9004,10,100,1e-05,0.01,0.764,4494,4510
1,9104,10,100,1e-05,0.01,0.782,4544,4560
1,9204,10,100,1e-05,0.01,0.81,4591,4613
1,9304,10,100,1e-05,0.01,0.82,4647,4657
1,9404,10,100,1e-05,0.01,0.784,4706,4698
1,9504,10,100,1e-05,0.01,0.77,4743,4761
1,9604,10,100,1e-05,0.01,0.79,4794,4810
1,9704,10,100,1e-05,0.01,0.762,4845,4859
1,9804,10,100,1e-05,0.01,0.77,4894,4910
1,9904,10,100,1e-05,0.01,0.792,4946,4958
1,10004,10,100,1e-05,0.01,0.794,4999,5005
1,10104,10,100,1e-05,0.01,0.764,5049,5055
1,10204,10,100,1e-05,0.01,0.788,5095,5109
1,10304,10,100,1e-05,0.01,0.788,5141,5163
1,10404,10,100,1e-05,0.01,0.814,5193,5211
1,10504,10,100,1e-05,0.01,0.816,5244,5260
1,10604,10,100,1e-05,0.01,0.812,5291,5313
1,10704,10,100,1e-05,0.01,0.832,5343,5361
1,10804,10,100,1e-05,0.01,0.834,5386,5418
1,10904,10,100,1e-05,0.01,0.828,5446,5458
1,11004,10,100,1e-05,0.01,0.832,5496,5508
1,11104,10,100,1e-05,0.01,0.858,5544,5560
1,11204,10,100,1e-05,0.01,0.862,5596,5608
1,11304,10,100,1e-05,0.01,0.844,5643,5661
1,11404,10,100,1e-05,0.01,0.808,5702,5702
1,11504,10,100,1e-05,0.01,0.81,5757,5747
1,11604,10,100,1e-05,0.01,0.804,5812,5792
1,11704,10,100,1e-05,0.01,0.842,5870,5834
1,11804,10,100,1e-05,0.01,0.838,5910,5894
1,11904,10,100,1e-05,0.01,0.846,5963,5941
1,12004,10,100,1e-05,0.01,0.842,6024,5980
1,12104,10,100,1e-05,0.01,0.862,6072,6032
1,12204,10,100,1e-05,0.01,0.848,6114,6090
1,12304,10,100,1e-05,0.01,0.84,6158,6146
1,12404,10,100,1e-05,0.01,0.856,6207,6197
1,12504,10,100,1e-05,0.01,0.838,6264,6240
1,12604,10,100,1e-05,0.01,0.814,6315,6289
1,12704,10,100,1e-05,0.01,0.858,6365,6339
1,12804,10,100,1e-05,0.01,0.818,6412,6392
1,12904,10,100,1e-05,0.01,0.832,6470,6434
1,13004,10,100,1e-05,0.01,0.834,6510,6494
1,13104,10,100,1e-05,0.01,0.848,6560,6544
1,13204,10,100,1e-05,0.01,0.86,6613,6591
1,13304,10,100,1e-05,0.01,0.844,6663,6641
1,13404,10,100,1e-05,0.01,0.844,6706,6698
1,13504,10,100,1e-05,0.01,0.848,6752,6752
1,13604,10,100,1e-05,0.01,0.864,6804,6800
1,13704,10,100,1e-05,0.01,0.868,6860,6844
1,13804,10,100,1e-05,0.01,0.842,6910,6894
1,13904,10,100,1e-05,0.01,0.868,6963,6941
1,14004,10,100,1e-05,0.01,0.868,7011,6993
1,14104,10,100,1e-05,0.01,0.866,7050,7054
1,14204,10,100,1e-05,0.01,0.874,7098,7106
1,14304,10,100,1e-05,0.01,0.852,7148,7156
1,14404,10,100,1e-05,0.01,0.882,7201,7203
1,14504,10,100,1e-05,0.01,0.904,7244,7260
1,14604,10,100,1e-05,0.01,0.878,7288,7316
1,14704,10,100,1e-05,0.01,0.884,7332,7372
1,14804,10,100,1e-05,0.01,0.886,7378,7426
1,14904,10,100,1e-05,0.01,0.87,7436,7468
1,15004,10,100,1e-05,0.01,0.858,7491,7513
2,104,10,100,1e-05,0.01,0.506,55,49
2,204,10,100,1e-05,0.01,0.476,105,99
2,304,10,100,1e-05,0.01,0.478,157,147
2,404,10,100,1e-05,0.01,0.468,209,195
2,504,10,100,1e-05,0.01,0.512,260,244
2,604,10,100,1e-05,0.01,0.494,309,295
2,704,10,100,1e-05,0.01,0.466,351,353
2,804,10,100,1e-05,0.01,0.45,398,406
2,904,10,100,1e-05,0.01,0.466,452,452
2,1004,10,100,1e-05,0.01,0.482,497,507
2,1104,10,100,1e-05,0.01,0.474,548,556
2,1204,10,100,1e-05,0.01,0.512,594,610
2,1304,10,100,1e-05,0.01,0.492,647,657
2,1404,10,100,1e-05,0.01,0.492,692,712
2,1504,10,100,1e-05,0.01,0.486,731,773
2,1604,10,100,1e-05,0.01,0.484,784,820
2,1704,10,100,1e-05,0.01,0.504,831,873
2,1804,10,100,1e-05,0.01,0.532,878,926
2,1904,10,100,1e-05,0.01,0.516,931,973
2,2004,10,100,1e-05,0.01,0.51,976,1028
2,2104,10,100,1e-05,0.01,0.516,1030,1074
2,2204,10,100,1e-05,0.01,0.496,1081,1123
2,2304,10,100,1e-05,0.01,0.514,1133,1171
2,2404,10,100,1e-05,0.01,0.54,1190,1214
2,2504,10,100,1e-05,0.01,0.508,1233,1271
2,2604,10,100,1e-05,0.01,0.548,1277,1327
2,2704,10,100,1e-05,0.01,0.536,1317,1387
2,2804,10,100,1e-05,0.01,0.56,1362,1442
2,2904,10,100,1e-05,0.01,0.562,1399,1505
2,3004,10,100,1e-05,0.01,0.586,1442,1562
2,3104,10,100,1e-05,0.01,0.568,1496,1608
2,3204,10,100,1e-05,0.01,0.584,1551,1653
2,3304,10,100,1e-05,0.01,0.604,1601,1703
2,3404,10,100,1e-05,0.01,0.6,1651,1753
2,3504,10,100,1e-05,0.01,0.638,1697,1807
2,3604,10,100,1e-05,0.01,0.616,1761,1843
2,3704,10,100,1e-05,0.01,0.634,1808,1896
2,3804,10,100,1e-05,0.01,0.632,1860,1944
2,3904,10,100,1e-05,0.01,0.606,1907,1997
2,4004,10,100,1e-05,0.01,0.626,1956,2048
2,4104,10,100,1e-05,0.01,0.626,2008,2096
2,4204,10,100,1e-05,0.01,0.656,2054,2150
2,4304,10,100,1e-05,0.01,0.652,2105,2199
2,4404,10,100,1e-05,0.01,0.666,2153,2251
2,4504,10,100,1e-05,0.01,0.636,2202,2302
2,4604,10,100,1e-05,0.01,0.686,2235,2369
2,4704,10,100,1e-05,0.01,0.68,2282,2422
2,4804,10,100,1e-05,0.01,0.682,2318,2486
2,4904,10,100,1e-05,0.01,0.688,2368,2536
2,5004,10,100,1e-05,0.01,0.698,2426,2578
2,5104,10,100,1e-05,0.01,0.688,2476,2628
2,5204,10,100,1e-05,0.01,0.668,2530,2674
2,5304,10,100,1e-05,0.01,0.688,2574,2730
2,5404,10,100,1e-05,0.01,0.714,2618,2786
2,5504,10,100,1e-05,0.01,0.686,2655,2849
2,5604,10,100,1e-05,0.01,0.688,2710,2894
2,5704,10,100,1e-05,0.01,0.704,2761,2943
2,5804,10,100,1e-05,0.01,0.682,2815,2989
2,5904,10,100,1e-05,0.01,0.698,2861,3043
2,6004,10,100,1e-05,0.01,0.692,2906,3098
2,6104,10,100,1e-05,0.01,0.696,2961,3143
2,6204,10,100,1e-05,0.01,0.706,3017,3187
2,6304,10,100,1e-05,0.01,0.694,3070,3234
2,6404,10,100,1e-05,0.01,0.722,3124,3280
2,6504,10,100,1e-05,0.01,0.722,3174,3330
2,6604,10,100,1e-05,0.01,0.736,3225,3379
2,6704,10,100,1e-05,0.01,0.748,3279,3425
2,6804,10,100,1e-05,0.01,0.734,3331,3473
2,6904,10,100,1e-05,0.01,0.724,3381,3523
2,7004,10,100,1e-05,0.01,0.738,3433,3571
2,7104,10,100,1e-05,0.01,0.74,3481,3623
2,7204,10,100,1e-05,0.01,0.728,3522,3682
2,7304,10,100,1e-05,0.01,0.668,3578,3726
2,7404,10,100,1e-05,0.01,0.698,3632,3772
2,7504,10,100,1e-05,0.01,0.7,3685,3819
2,7604,10,100,1e-05,0.01,0.674,3735,3869
2,7704,10,100,1e-05,0.01,0.716,3792,3912
2,7804,10,100,1e-05,0.01,0.738,3840,3964
2,7904,10,100,1e-05,0.01,0.758,3897,4007
2,8004,10,100,1e-05,0.01,0.728,3939,4065
2,8104,10,100,1e-05,0.01,0.722,3987,4117
2,8204,10,100,1e-05,0.01,0.764,4046,4158
2,8304,10,100,1e-05,0.01,0.734,4099,4205
2,8404,10,100,1e-05,0.01,0.764,4158,4246
2,8504,10,100,1e-05,0.01,0.774,4210,4294
2,8604,10,100,1e-05,0.01,0.758,4260,4344
2,8704,10,100,1e-05,0.01,0.77,4313,4391
2,8804,10,100,1e-05,0.01,0.798,4372,4432
2,8904,10,100,1e-05,0.01,0.774,4419,4485
2,9004,10,100,1e-05,0.01,0.778,4468,4536
2,9104,10,100,1e-05,0.01,0.752,4514,4590
2,9204,10,100,1e-05,0.01,0.784,4562,4642
2,9304,10,100,1e-05,0.01,0.81,4619,4685
2,9404,10,100,1e-05,0.01,0.764,4675,4729
2,9504,10,100,1e-05,0.01,0.782,4725,4779
2,9604,10,100,1e-05,0.01,0.824,4781,4823
2,9704,10,100,1e-05,0.01,0.816,4837,4867
2,9804,10,100,1e-05,0.01,0.804,4893,4911
2,9904,10,100,1e-05,0.01,0.804,4946,4958
2,10004,10,100,1e-05,0.01,0.8,4994,5010
2,10104,10,100,1e-05,0.01,0.812,5041,5063
2,10204,10,100,1e-05,0.01,0.78,5091,5113
2,10304,10,100,1e-05,0.01,0.806,5128,5176
2,10404,10,100,1e-05,0.01,0.826,5182,5222
2,10504,10,100,1e-05,0.01,0.834,5237,5267
2,10604,10,100,1e-05,0.01,0.83,5283,5321
2,10704,10,100,1e-05,0.01,0.808,5335,5369
2,10804,10,100,1e-05,0.01,0.83,5387,5417
2,10904,10,100,1e-05,0.01,0.828,5438,5466
2,11004,10,100,1e-05,0.01,0.81,5474,5530
2,11104,10,100,1e-05,0.01,0.832,5526,5578
2,11204,10,100,1e-05,0.01,0.84,5572,5632
2,11304,10,100,1e-05,0.01,0.84,5628,5676
2,11404,10,100,1e-05,0.01,0.832,5677,5727
2,11504,10,100,1e-05,0.01,0.852,5736,5768
2,11604,10,100,1e-05,0.01,0.836,5794,5810
2,11704,10,100,1e-05,0.01,0.85,5842,5862
2,11804,10,100,1e-05,0.01,0.836,5892,5912
2,11904,10,100,1e-05,0.01,0.806,5941,5963
2,12004,10,100,1e-05,0.01,0.804,5999,6005
2,12104,10,100,1e-05,0.01,0.842,6048,6056
2,12204,10,100,1e-05,0.01,0.812,6095,6109
2,12304,10,100,1e-05,0.01,0.834,6138,6166
2,12404,10,100,1e-05,0.01,0.814,6180,6224
2,12504,10,100,1e-05,0.01,0.808,6232,6272
2,12604,10,100,1e-05,0.01,0.856,6284,6320
2,12704,10,100,1e-05,0.01,0.862,6333,6371
2,12804,10,100,1e-05,0.01,0.858,6380,6424
2,12904,10,100,1e-05,0.01,0.86,6426,6478
2,13004,10,100,1e-05,0.01,0.832,6465,6539
2,13104,10,100,1e-05,0.01,0.846,6514,6590
2,13204,10,100,1e-05,0.01,0.854,6567,6637
2,13304,10,100,1e-05,0.01,0.856,6614,6690
2,13404,10,100,1e-05,0.01,0.866,6660,6744
2,13504,10,100,1e-05,0.01,0.858,6715,6789
2,13604,10,100,1e-05,0.01,0.832,6771,6833
2,13704,10,100,1e-05,0.01,0.844,6823,6881
2,13804,10,100,1e-05,0.01,0.87,6868,6936
2,13904,10,100,1e-05,0.01,0.854,6913,6991
2,14004,10,100,1e-05,0.01,0.872,6968,7036
2,14104,10,100,1e-05,0.01,0.854,7014,7090
2,14204,10,100,1e-05,0.01,0.872,7072,7132
2,14304,10,100,1e-05,0.01,0.868,7118,7186
2,14404,10,100,1e-05,0.01,0.866,7167,7237
2,14504,10,100,1e-05,0.01,0.864,7227,7277
2,14604,10,100,1e-05,0.01,0.876,7273,7331
2,14704,10,100,1e-05,0.01,0.882,7329,7375
2,14804,10,100,1e-05,0.01,0.886,7386,7418
2,14904,10,100,1e-05,0.01,0.862,7438,7466
2,15004,10,100,1e-05,0.01,0.882,7490,7514
3,104,10,100,1e-05,0.01,0.556,45,59
3,204,10,100,1e-05,0.01,0.45,100,104
3,304,10,100,1e-05,0.01,0.474,153,151
3,404,10,100,1e-05,0.01,0.534,203,201
3,504,10,100,1e-05,0.01,0.492,261,243
3,604,10,100,1e-05,0.01,0.482,299,305
3,704,10,100,1e-05,0.01,0.504,356,348
3,804,10,100,1e-05,0.01,0.5,401,403
3,904,10,100,1e-05,0.01,0.458,450,454
3,1004,10,100,1e-05,0.01,0.48,493,511
3,1104,10,100,1e-05,0.01,0.476,549,555
3,1204,10,100,1e-05,0.01,0.498,603,601
3,1304,10,100,1e-05,0.01,0.512,653,651
3,1404,10,100,1e-05,0.01,0.51,706,698
3,1504,10,100,1e-05,0.01,0.482,757,747
3,1604,10,100,1e-05,0.01,0.51,805,799
3,1704,10,100,1e-05,0.01,0.494,855,849
3,1804,10,100,1e-05,0.01,0.52,899,905
3,1904,10,100,1e-05,0.01,0.522,950,954
3,2004,10,100,1e-05,0.01,0.542,997,1007
3,2104,10,100,1e-05,0.01,0.528,1043,1061
3,2204,10,100,1e-05,0.01,0.518,1096,1108
3,2304,10,100,1e-05,0.01,0.508,1152,1152
3,2404,10,100,1e-05,0.01,0.524,1208,1196
3,2504,10,100,1e-05,0.01,0.542,1253,1251
3,2604,10,100,1e-05,0.01,0.608,1301,1303
3,2704,10,100,1e-05,0.01,0.604,1354,1350
3,2804,10,100,1e-05,0.01,0.588,1405,1399
3,2904,10,100,1e-05,0.01,0.656,1465,1439
3,3004,10,100,1e-05,0.01,0.618,1515,1489
3,3104,10,100,1e-05,0.01,0.604,1565,1539
3,3204,10,100,1e-05,0.01,0.618,1613,1591
3,3304,10,100,1e-05,0.01,0.612,1657,1647
3,3404,10,100,1e-05,0.01,0.596,1706,1698
3,3504,10,100,1e-05,0.01,0.622,1757,1747
3,3604,10,100,1e-05,0.01,0.602,1809,1795
3,3704,10,100,1e-05,0.01,0.638,1858,1846
3,3804,10,100,1e-05,0.01,0.648,1905,1899
3,3904,10,100,1e-05,0.01,0.638,1944,1960
3,4004,10,100,1e-05,0.01,0.652,1992,2012
3,4104,10,100,1e-05,0.01,0.632,2053,2051
3,4204,10,100,1e-05,0.01,0.66,2099,2105
3,4304,10,100,1e-05,0.01,0.616,2142,2162
3,4404,10,100,1e-05,0.01,0.61,2185,2219
3,4504,10,100,1e-05,0.01,0.658,2232,2272
3,4604,10,100,1e-05,0.01,0.654,2282,2322
3,4704,10,100,1e-05,0.01,0.65,2320,2384
3,4804,10,100,1e-05,0.01,0.664,2370,2434
3,4904,10,100,1e-05,0.01,0.684,2425,2479
3,5004,10,100,1e-05,0.01,0.662,2475,2529
3,5104,10,100,1e-05,0.01,0.672,2521,2583
3,5204,10,100,1e-05,0.01,0.666,2572,2632
3,5304,10,100,1e-05,0.01,0.668,2621,2683
3,5404,10,100,1e-05,0.01,0.596,2682,2722
3,5504,10,100,1e-05,0.01,0.644,2735,2769
3,5604,10,100,1e-05,0.01,0.632,2786,2818
3,5704,10,100,1e-05,0.01,0.668,2839,2865
3,5804,10,100,1e-05,0.01,0.702,2887,2917
3,5904,10,100,1e-05,0.01,0.702,2940,2964
3,6004,10,100,1e-05,0.01,0.7,2995,3009
3,6104,10,100,1e-05,0.01,0.712,3050,3054
3,6204,10,100,1e-05,0.01,0.658,3095,3109
3,6304,10,100,1e-05,0.01,0.714,3149,3155
3,6404,10,100,1e-05,0.01,0.722,3207,3197
3,6504,10,100,1e-05,0.01,0.736,3265,3239
3,6604,10,100,1e-05,0.01,0.726,3318,3286
3,6704,10,100,1e-05,0.01,0.688,3370,3334
3,6804,10,100,1e-05,0.01,0.728,3417,3387
3,6904,10,100,1e-05,0.01,0.732,3470,3434
3,7004,10,100,1e-05,0.01,0.706,3516,3488
3,7104,10,100,1e-05,0.01,0.718,3563,3541
3,7204,10,100,1e-05,0.01,0.71,3608,3596
3,7304,10,100,1e-05,0.01,0.752,3657,3647
3,7404,10,100,1e-05,0.01,0.754,3711,3693
3,7504,10,100,1e-05,0.01,0.754,3765,3739
3,7604,10,100,1e-05,0.01,0.782,3818,3786
3,7704,10,100,1e-05,0.01,0.758,3872,3832
3,7804,10,100,1e-05,0.01,0.766,3927,3877
3,7904,10,100,1e-05,0.01,0.742,3979,3925
3,8004,10,100,1e-05,0.01,0.73,4034,3970
3,8104,10,100,1e-05,0.01,0.744,4079,4025
3,8204,10,100,1e-05,0.01,0.762,4132,4072
3,8304,10,100,1e-05,0.01,0.768,4178,4126
3,8404,10,100,1e-05,0.01,0.782,4227,4177
3,8504,10,100,1e-05,0.01,0.782,4275,4229
3,8604,10,100,1e-05,0.01,0.802,4330,4274
3,8704,10,100,1e-05,0.01,0.784,4374,4330
3,8804,10,100,1e-05,0.01,0.772,4424,4380
3,8904,10,100,1e-05,0.01,0.804,4481,4423
3,9004,10,100,1e-05,0.01,0.78,4533,4471
3,9104,10,100,1e-05,0.01,0.818,4591,4513
3,9204,10,100,1e-05,0.01,0.802,4643,4561
3,9304,10,100,1e-05,0.01,0.79,4694,4610
3,9404,10,100,1e-05,0.01,0.792,4745,4659
3,9504,10,100,1e-05,0.01,0.816,4804,4700
3,9604,10,100,1e-05,0.01,0.798,4847,4757
3,9704,10,100,1e-05,0.01,0.824,4889,4815
3,9804,10,100,1e-05,0.01,0.782,4937,4867
3,9904,10,100,1e-05,0.01,0.754,4986,4918
3,10004,10,100,1e-05,0.01,0.764,5040,4964
3,10104,10,100,1e-05,0.01,0.788,5084,5020
3,10204,10,100,1e-05,0.01,0.816,5131,5073
3,10304,10,100,1e-05,0.01,0.804,5178,5126
3,10404,10,100,1e-05,0.01,0.812,5220,5184
3,10504,10,100,1e-05,0.01,0.792,5271,5233
3,10604,10,100,1e-05,0.01,0.812,5320,5284
3,10704,10,100,1e-05,0.01,0.836,5363,5341
3,10804,10,100,1e-05,0.01,0.806,5418,5386
3,10904,10,100,1e-05,0.01,0.808,5464,5440
3,11004,10,100,1e-05,0.01,0.83,5510,5494
3,11104,10,100,1e-05,0.01,0.822,5565,5539
3,11204,10,100,1e-05,0.01,0.798,5612,5592
3,11304,10,100,1e-05,0.01,0.84,5666,5638
3,11404,10,100,1e-05,0.01,0.826,5721,5683
3,11504,10,100,1e-05,0.01,0.844,5770,5734
3,11604,10,100,1e-05,0.01,0.834,5824,5780
3,11704,10,100,1e-05,0.01,0.85,5869,5835
3,11804,10,100,1e-05,0.01,0.824,5918,5886
3,11904,10,100,1e-05,0.01,0.846,5969,5935
3,12004,10,100,1e-05,0.01,0.804,6023,5981
3,12104,10,100,1e-05,0.01,0.858,6075,6029
3,12204,10,100,1e-05,0.01,0.844,6124,6080
3,12304,10,100,1e-05,0.01,0.88,6179,6125
3,12404,10,100,1e-05,0.01,0.838,6234,6170
3,12504,10,100,1e-05,0.01,0.854,6286,6218
3,12604,10,100,1e-05,0.01,0.84,6340,6264
3,12704,10,100,1e-05,0.01,0.842,6391,6313
3,12804,10,100,1e-05,0.01,0.858,6428,6376
3,12904,10,100,1e-05,0.01,0.846,6483,6421
3,13004,10,100,1e-05,0.01,0.854,6525,6479
3,13104,10,100,1e-05,0.01,0.866,6579,6525
3,13204,10,100,1e-05,0.01,0.87,6628,6576
3,13304,10,100,1e-05,0.01,0.848,6678,6626
3,13404,10,100,1e-05,0.01,0.878,6720,6684
3,13504,10,100,1e-05,0.01,0.87,6772,6732
3,13604,10,100,1e-05,0.01,0.844,6829,6775
3,13704,10,100,1e-05,0.01,0.848,6875,6829
3,13804,10,100,1e-05,0.01,0.862,6921,6883
3,13904,10,100,1e-05,0.01,0.866,6973,6931
3,14004,10,100,1e-05,0.01,0.874,7025,6979
3,14104,10,100,1e-05,0.01,0.848,7070,7034
3,14204,10,100,1e-05,0.01,0.87,7117,7087
3,14304,10,100,1e-05,0.01,0.85,7167,7137
3,14404,10,100,1e-05,0.01,0.876,7223,7181
3,14504,10,100,1e-05,0.01,0.878,7273,7231
3,14604,10,100,1e-05,0.01,0.87,7333,7271
3,14704,10,100,1e-05,0.01,0.842,7385,7319
3,14804,10,100,1e-05,0.01,0.856,7428,7376
3,14904,10,100,1e-05,0.01,0.86,7479,7425
3,15004,10,100,1e-05,0.01,0.842,7528,7476
4,104,10,100,1e-05,0.01,0.472,45,59
4,204,10,100,1e-05,0.01,0.522,91,113
4,304,10,100,1e-05,0.01,0.496,147,157
4,404,10,100,1e-05,0.01,0.492,200,204
4,504,10,100,1e-05,0.01,0.514,257,247
4,604,10,100,1e-05,0.01,0.492,294,310
4,704,10,100,1e-05,0.01,0.486,348,356
4,804,10,100,1e-05,0.01,0.46,399,405
4,904,10,100,1e-05,0.01,0.488,451,453
4,1004,10,100,1e-05,0.01,0.512,489,515
4,1104,10,100,1e-05,0.01,0.48,542,562
4,1204,10,100,1e-05,0.01,0.496,593,611
4,1304,10,100,1e-05,0.01,0.462,647,657
4,1404,10,100,1e-05,0.01,0.47,701,703
4,1504,10,100,1e-05,0.01,0.506,757,747
4,1604,10,100,1e-05,0.01,0.484,799,805
4,1704,10,100,1e-05,0.01,0.502,854,850
4,1804,10,100,1e-05,0.01,0.498,911,893
4,1904,10,100,1e-05,0.01,0.5,956,948
4,2004,10,100,1e-05,0.01,0.538,1010,994
4,2104,10,100,1e-05,0.01,0.574,1051,1053
4,2204,10,100,1e-05,0.01,0.55,1100,1104
4,2304,10,100,1e-05,0.01,0.548,1156,1148
4,2404,10,100,1e-05,0.01,0.594,1210,1194
4,2504,10,100,1e-05,0.01,0.632,1262,1242
4,2604,10,100,1e-05,0.01,0.652,1311,1293
4,2704,10,100,1e-05,0.01,0.656,1361,1343
4,2804,10,100,1e-05,0.01,0.68,1406,1398
4,2904,10,100,1e-05,0.01,0.718,1457,1447
4,3004,10,100,1e-05,0.01,0.764,1522,1482
4,3104,10,100,1e-05,0.01,0.764,1581,1523
4,3204,10,100,1e-05,0.01,0.83,1631,1573
4,3304,10,100,1e-05,0.01,0.848,1678,1626
4,3404,10,100,1e-05,0.01,0.846,1723,1681
4,3504,10,100,1e-05,0.01,0.834,1771,1733
4,3604,10,100,1e-05,0.01,0.868,1828,1776
4,3704,10,100,1e-05,0.01,0.88,1872,1832
4,3804,10,100,1e-05,0.01,0.9,1927,1877
4,3904,10,100,1e-05,0.01,0.914,1981,1923
4,4004,10,100,1e-05,0.01,0.926,2026,1978
4,4104,10,100,1e-05,0.01,0.928,2079,2025
4,4204,10,100,1e-05,0.01,0.908,2120,2084
4,4304,10,100,1e-05,0.01,0.928,2174,2130
4,4404,10,100,1e-05,0.01,0.944,2223,2181
4,4504,10,100,1e-05,0.01,0.936,2271,2233
4,4604,10,100,1e-05,0.01,0.952,2314,2290
4,4704,10,100,1e-05,0.01,0.94,2360,2344
4,4804,10,100,1e-05,0.01,0.948,2413,2391
4,4904,10,100,1e-05,0.01,0.948,2460,2444
4,5004,10,100,1e-05,0.01,0.938,2506,2498
4,5104,10,100,1e-05,0.01,0.95,2556,2548
4,5204,10,100,1e-05,0.01,0.94,2607,2597
4,5304,10,100,1e-05,0.01,0.926,2661,2643
4,5404,10,100,1e-05,0.01,0.924,2710,2694
4,5504,10,100,1e-05,0.01,0.9,2759,2745
4,5604,10,100,1e-05,0.01,0.924,2807,2797
4,5704,10,100,1e-05,0.01,0.966,2860,2844
4,5804,10,100,1e-05,0.01,0.972,2908,2896
4,5904,10,100,1e-05,0.01,0.976,2959,2945
4,6004,10,100,1e-05,0.01,0.974,3010,2994
4,6104,10,100,1e-05,0.01,0.968,3064,3040
4,6204,10,100,1e-05,0.01,0.976,3115,3089
4,6304,10,100,1e-05,0.01,0.984,3158,3146
4,6404,10,100,1e-05,0.01,0.976,3213,3191
4,6504,10,100,1e-05,0.01,0.98,3259,3245
4,6604,10,100,1e-05,0.01,0.978,3306,3298
4,6704,10,100,1e-05,0.01,0.98,3350,3354
4,6804,10,100,1e-05,0.01,0.966,3395,3409
4,6904,10,100,1e-05,0.01,0.978,3440,3464
4,7004,10,100,1e-05,0.01,0.978,3499,3505
4,7104,10,100,1e-05,0.01,0.97,3546,3558
4,7204,10,100,1e-05,0.01,0.978,3588,3616
4,7304,10,100,1e-05,0.01,0.968,3639,3665
4,7404,10,100,1e-05,0.01,0.988,3695,3709
4,7504,10,100,1e-05,0.01,0.984,3734,3770
4,7604,10,100,1e-05,0.01,0.978,3785,3819
4,7704,10,100,1e-05,0.01,0.978,3841,3863
4,7804,10,100,1e-05,0.01,0.982,3888,3916
4,7904,10,100,1e-05,0.01,0.976,3942,3962
4,8004,10,100,1e-05,0.01,0.974,3994,4010
4,8104,10,100,1e-05,0.01,0.978,4044,4060
4,8204,10,100,1e-05,0.01,0.98,4093,4111
4,8304,10,100,1e-05,0.01,0.98,4141,4163
4,8404,10,100,1e-05,0.01,0.98,4189,4215
4,8504,10,100,1e-05,0.01,0.98,4240,4264
4,8604,10,100,1e-05,0.01,0.974,4297,4307
4,8704,10,100,1e-05,0.01,0.982,4349,4355
4,8804,10,100,1e-05,0.01,0.982,4398,4406
4,8904,10,100,1e-05,0.01,0.984,4447,4457
4,9004,10,100,1e-05,0.01,0.98,4504,4500
4,9104,10,100,1e-05,0.01,0.986,4554,4550
4,9204,10,100,1e-05,0.01,0.98,4606,4598
4,9304,10,100,1e-05,0.01,0.98,4655,4649
4,9404,10,100,1e-05,0.01,0.976,4716,4688
4,9504,10,100,1e-05,0.01,0.972,4765,4739
4,9604,10,100,1e-05,0.01,0.99,4808,4796
4,9704,10,100,1e-05,0.01,0.986,4863,4841
4,9804,10,100,1e-05,0.01,0.984,4912,4892
4,9904,10,100,1e-05,0.01,0.98,4960,4944
4,10004,10,100,1e-05,0.01,0.98,5010,4994
4,10104,10,100,1e-05,0.01,0.984,5067,5037
4,10204,10,100,1e-05,0.01,0.984,5110,5094
4,10304,10,100,1e-05,0.01,0.992,5170,5134
4,10404,10,100,1e-05,0.01,0.988,5215,5189
4,10504,10,100,1e-05,0.01,0.988,5267,5237
4,10604,10,100,1e-05,0.01,0.988,5322,5282
4,10704,10,100,1e-05,0.01,0.992,5367,5337
4,10804,10,100,1e-05,0.01,0.99,5415,5389
4,10904,10,100,1e-05,0.01,0.984,5461,5443
4,11004,10,100,1e-05,0.01,0.982,5512,5492
4,11104,10,100,1e-05,0.01,0.992,5556,5548
4,11204,10,100,1e-05,0.01,0.992,5607,5597
4,11304,10,100,1e-05,0.01,0.99,5662,5642
4,11404,10,100,1e-05,0.01,0.99,5711,5693
4,11504,10,100,1e-05,0.01,0.988,5767,5737
4,11604,10,100,1e-05,0.01,0.99,5818,5786
4,11704,10,100,1e-05,0.01,0.988,5873,5831
4,11804,10,100,1e-05,0.01,0.988,5924,5880
4,11904,10,100,1e-05,0.01,0.98,5971,5933
4,12004,10,100,1e-05,0.01,0.988,6026,5978
4,12104,10,100,1e-05,0.01,0.988,6074,6030
4,12204,10,100,1e-05,0.01,0.992,6119,6085
4,12304,10,100,1e-05,0.01,0.99,6162,6142
4,12404,10,100,1e-05,0.01,0.992,6212,6192
4,12504,10,100,1e-05,0.01,0.994,6266,6238
4,12604,10,100,1e-05,0.01,0.988,6322,6282
4,12704,10,100,1e-05,0.01,0.988,6374,6330
4,12804,10,100,1e-05,0.01,0.994,6420,6384
4,12904,10,100,1e-05,0.01,0.982,6472,6432
4,13004,10,100,1e-05,0.01,0.99,6522,6482
4,13104,10,100,1e-05,0.01,0.992,6575,6529
4,13204,10,100,1e-05,0.01,0.986,6631,6573
4,13304,10,100,1e-05,0.01,0.994,6683,6621
4,13404,10,100,1e-05,0.01,0.992,6735,6669
4,13504,10,100,1e-05,0.01,0.994,6785,6719
4,13604,10,100,1e-05,0.01,0.994,6834,6770
4,13704,10,100,1e-05,0.01,0.992,6877,6827
4,13804,10,100,1e-05,0.01,0.992,6918,6886
4,13904,10,100,1e-05,0.01,0.994,6968,6936
4,14004,10,100,1e-05,0.01,0.996,7011,6993
4,14104,10,100,1e-05,0.01,0.996,7062,7042
4,14204,10,100,1e-05,0.01,0.998,7114,7090
4,14304,10,100,1e-05,0.01,0.998,7173,7131
4,14404,10,100,1e-05,0.01,0.998,7219,7185
4,14504,10,100,1e-05,0.01,0.994,7265,7239
4,14604,10,100,1e-05,0.01,0.992,7312,7292
4,14704,10,100,1e-05,0.01,0.98,7363,7341
4,14804,10,100,1e-05,0.01,0.994,7409,7395
4,14904,10,100,1e-05,0.01,0.994,7467,7437
4,15004,10,100,1e-05,0.01,0.994,7516,7488
5,104,10,100,1e-05,0.01,0.484,54,50
5,204,10,100,1e-05,0.01,0.506,114,90
5,304,10,100,1e-05,0.01,0.524,158,146
5,404,10,100,1e-05,0.01,0.53,209,195
5,504,10,100,1e-05,0.01,0.544,260,244
5,604,10,100,1e-05,0.01,0.498,308,296
5,704,10,100,1e-05,0.01,0.532,343,361
5,804,10,100,1e-05,0.01,0.522,396,408
5,904,10,100,1e-05,0.01,0.528,440,464
5,1004,10,100,1e-05,0.01,0.534,483,521
5,1104,10,100,1e-05,0.01,0.536,529,575
5,1204,10,100,1e-05,0.01,0.546,576,628
5,1304,10,100,1e-05,0.01,0.534,626,678
5,1404,10,100,1e-05,0.01,0.514,683,721
5,1504,10,100,1e-05,0.01,0.53,739,765
5,1604,10,100,1e-05,0.01,0.522,794,810
5,1704,10,100,1e-05,0.01,0.516,846,858
5,1804,10,100,1e-05,0.01,0.502,897,907
5,1904,10,100,1e-05,0.01,0.524,955,949
5,2004,10,100,1e-05,0.01,0.528,1007,997
5,2104,10,100,1e-05,0.01,0.536,1042,1062
5,2204,10,100,1e-05,0.01,0.518,1095,1109
5,2304,10,100,1e-05,0.01,0.51,1146,1158
5,2404,10,100,1e-05,0.01,0.52,1197,1207
5,2504,10,100,1e-05,0.01,0.552,1246,1258
5,2604,10,100,1e-05,0.01,0.526,1299,1305
5,2704,10,100,1e-05,0.01,0.548,1347,1357
5,2804,10,100,1e-05,0.01,0.568,1389,1415
5,2904,10,100,1e-05,0.01,0.548,1443,1461
5,3004,10,100,1e-05,0.01,0.57,1492,1512
5,3104,10,100,1e-05,0.01,0.576,1541,1563
5,3204,10,100,1e-05,0.01,0.584,1593,1611
5,3304,10,100,1e-05,0.01,0.626,1638,1666
5,3404,10,100,1e-05,0.01,0.586,1690,1714
5,3504,10,100,1e-05,0.01,0.592,1735,1769
5,3604,10,100,1e-05,0.01,0.582,1790,1814
5,3704,10,100,1e-05,0.01,0.582,1844,1860
5,3804,10,100,1e-05,0.01,0.562,1892,1912
5,3904,10,100,1e-05,0.01,0.566,1952,1952
5,4004,10,100,1e-05,0.01,0.586,2000,2004
5,4104,10,100,1e-05,0.01,0.584,2042,2062
5,4204,10,100,1e-05,0.01,0.596,2088,2116
5,4304,10,100,1e-05,0.01,0.582,2146,2158
5,4404,10,100,1e-05,0.01,0.584,2193,2211
5,4504,10,100,1e-05,0.01,0.598,2245,2259
5,4604,10,100,1e-05,0.01,0.566,2305,2299
5,4704,10,100,1e-05,0.01,0.592,2357,2347
5,4804,10,100,1e-05,0.01,0.606,2407,2397
5,4904,10,100,1e-05,0.01,0.588,2457,2447
5,5004,10,100,1e-05,0.01,0.6,2506,2498
5,5104,10,100,1e-05,0.01,0.606,2550,2554
5,5204,10,100,1e-05,0.01,0.57,2596,2608
5,5304,10,100,1e-05,0.01,0.614,2644,2660
5,5404,10,100,1e-05,0.01,0.614,2692,2712
5,5504,10,100,1e-05,0.01,0.612,2743,2761
5,5604,10,100,1e-05,0.01,0.604,2786,2818
5,5704,10,100,1e-05,0.01,0.596,2828,2876
5,5804,10,100,1e-05,0.01,0.626,2882,2922
5,5904,10,100,1e-05,0.01,0.64,2930,2974
5,6004,10,100,1e-05,0.01,0.618,2972,3032
5,6104,10,100,1e-05,0.01,0.64,3026,3078
5,6204,10,100,1e-05,0.01,0.606,3079,3125
5,6304,10,100,1e-05,0.01,0.618,3131,3173
5,6404,10,100,1e-05,0.01,0.654,3178,3226
5,6504,10,100,1e-05,0.01,0.626,3226,3278
5,6604,10,100,1e-05,0.01,0.678,3280,3324
5,6704,10,100,1e-05,0.01,0.65,3327,3377
5,6804,10,100,1e-05,0.01,0.646,3377,3427
5,6904,10,100,1e-05,0.01,0.624,3422,3482
5,7004,10,100,1e-05,0.01,0.666,3469,3535
5,7104,10,100,1e-05,0.01,0.62,3523,3581
5,7204,10,100,1e-05,0.01,0.674,3575,3629
5,7304,10,100,1e-05,0.01,0.626,3626,3678
5,7404,10,100,1e-05,0.01,0.652,3671,3733
5,7504,10,100,1e-05,0.01,0.646,3729,3775
5,7604,10,100,1e-05,0.01,0.66,3778,3826
5,7704,10,100,1e-05,0.01,0.666,3827,3877
5,7804,10,100,1e-05,0.01,0.66,3887,3917
5,7904,10,100,1e-05,0.01,0.65,3936,3968
5,8004,10,100,1e-05,0.01,0.668,3996,4008
5,8104,10,100,1e-05,0.01,0.656,4042,4062
5,8204,10,100,1e-05,0.01,0.65,4101,4103
5,8304,10,100,1e-05,0.01,0.658,4151,4153
5,8404,10,100,1e-05,0.01,0.664,4202,4202
5,8504,10,100,1e-05,0.01,0.676,4250,4254
5,8604,10,100,1e-05,0.01,0.66,4304,4300
5,8704,10,100,1e-05,0.01,0.684,4355,4349
5,8804,10,100,1e-05,0.01,0.7,4401,4403
5,8904,10,100,1e-05,0.01,0.656,4452,4452
5,9004,10,100,1e-05,0.01,0.678,4506,4498
5,9104,10,100,1e-05,0.01,0.656,4559,4545
5,9204,10,100,1e-05,0.01,0.668,4608,4596
5,9304,10,100,1e-05,0.01,0.676,4660,4644
5,9404,10,100,1e-05,0.01,0.696,4704,4700
5,9504,10,100,1e-05,0.01,0.662,4755,4749
5,9604,10,100,1e-05,0.01,0.7,4802,4802
5,9704,10,100,1e-05,0.01,0.674,4850,4854
5,9804,10,100,1e-05,0.01,0.692,4900,4904
5,9904,10,100,1e-05,0.01,0.692,4949,4955
5,10004,10,100,1e-05,0.01,0.684,5004,5000
5,10104,10,100,1e-05,0.01,0.684,5056,5048
5,10204,10,100,1e-05,0.01,0.708,5106,5098
5,10304,10,100,1e-05,0.01,0.702,5159,5145
5,10404,10,100,1e-05,0.01,0.714,5209,5195
5,10504,10,100,1e-05,0.01,0.684,5249,5255
5,10604,10,100,1e-05,0.01,0.712,5298,5306
5,10704,10,100,1e-05,0.01,0.704,5350,5354
5,10804,10,100,1e-05,0.01,0.694,5397,5407
5,10904,10,100,1e-05,0.01,0.712,5444,5460
5,11004,10,100,1e-05,0.01,0.696,5492,5512
5,11104,10,100,1e-05,0.01,0.698,5543,5561
5,11204,10,100,1e-05,0.01,0.682,5600,5604
5,11304,10,100,1e-05,0.01,0.704,5648,5656
5,11404,10,100,1e-05,0.01,0.694,5706,5698
5,11504,10,100,1e-05,0.01,0.708,5749,5755
5,11604,10,100,1e-05,0.01,0.714,5810,5794
5,11704,10,100,1e-05,0.01,0.712,5854,5850
5,11804,10,100,1e-05,0.01,0.704,5905,5899
5,11904,10,100,1e-05,0.01,0.706,5952,5952
5,12004,10,100,1e-05,0.01,0.69,6005,5999
5,12104,10,100,1e-05,0.01,0.712,6055,6049
5,12204,10,100,1e-05,0.01,0.712,6099,6105
5,12304,10,100,1e-05,0.01,0.696,6140,6164
5,12404,10,100,1e-05,0.01,0.706,6180,6224
5,12504,10,100,1e-05,0.01,0.724,6226,6278
5,12604,10,100,1e-05,0.01,0.714,6278,6326
5,12704,10,100,1e-05,0.01,0.708,6330,6374
5,12804,10,100,1e-05,0.01,0.738,6370,6434
5,12904,10,100,1e-05,0.01,0.728,6414,6490
5,13004,10,100,1e-05,0.01,0.718,6469,6535
5,13104,10,100,1e-05,0.01,0.712,6520,6584
5,13204,10,100,1e-05,0.01,0.714,6571,6633
5,13304,10,100,1e-05,0.01,0.718,6619,6685
5,13404,10,100,1e-05,0.01,0.74,6676,6728
5,13504,10,100,1e-05,0.01,0.72,6721,6783
5,13604,10,100,1e-05,0.01,0.718,6778,6826
5,13704,10,100,1e-05,0.01,0.726,6836,6868
5,13804,10,100,1e-05,0.01,0.722,6893,6911
5,13904,10,100,1e-05,0.01,0.74,6947,6957
5,14004,10,100,1e-05,0.01,0.704,7005,6999
5,14104,10,100,1e-05,0.01,0.754,7063,7041
5,14204,10,100,1e-05,0.01,0.724,7107,7097
5,14304,10,100,1e-05,0.01,0.72,7156,7148
5,14404,10,100,1e-05,0.01,0.732,7207,7197
5,14504,10,100,1e-05,0.01,0.738,7252,7252
5,14604,10,100,1e-05,0.01,0.732,7297,7307
5,14704,10,100,1e-05,0.01,0.746,7350,7354
5,14804,10,100,1e-05,0.01,0.754,7393,7411
5,14904,10,100,1e-05,0.01,0.742,7442,7462
5,15004,10,100,1e-05,0.01,0.73,7494,7510
6,104,10,100,1e-05,0.01,0.504,53,51
6,204,10,100,1e-05,0.01,0.466,97,107
6,304,10,100,1e-05,0.01,0.476,150,154
6,404,10,100,1e-05,0.01,0.486,200,204
6,504,10,100,1e-05,0.01,0.476,251,253
6,604,10,100,1e-05,0.01,0.47,300,304
6,704,10,100,1e-05,0.01,0.49,354,350
6,804,10,100,1e-05,0.01,0.508,404,400
6,904,10,100,1e-05,0.01,0.514,449,455
6,1004,10,100,1e-05,0.01,0.54,504,500
6,1104,10,100,1e-05,0.01,0.49,548,556
6,1204,10,100,1e-05,0.01,0.504,593,611
6,1304,10,100,1e-05,0.01,0.506,642,662
6,1404,10,100,1e-05,0.01,0.502,689,715
6,1504,10,100,1e-05,0.01,0.538,748,756
6,1604,10,100,1e-05,0.01,0.534,795,809
6,1704,10,100,1e-05,0.01,0.522,846,858
6,1804,10,100,1e-05,0.01,0.516,895,909
6,1904,10,100,1e-05,0.01,0.512,955,949
6,2004,10,100,1e-05,0.01,0.542,1013,991
6,2104,10,100,1e-05,0.01,0.55,1064,1040
6,2204,10,100,1e-05,0.01,0.624,1113,1091
6,2304,10,100,1e-05,0.01,0.61,1171,1133
6,2404,10,100,1e-05,0.01,0.598,1216,1188
6,2504,10,100,1e-05,0.01,0.624,1260,1244
6,2604,10,100,1e-05,0.01,0.584,1310,1294
6,2704,10,100,1e-05,0.01,0.65,1353,1351
6,2804,10,100,1e-05,0.01,0.648,1412,1392
6,2904,10,100,1e-05,0.01,0.676,1467,1437
6,3004,10,100,1e-05,0.01,0.674,1521,1483
6,3104,10,100,1e-05,0.01,0.66,1573,1531
6,3204,10,100,1e-05,0.01,0.698,1627,1577
6,3304,10,100,1e-05,0.01,0.7,1678,1626
6,3404,10,100,1e-05,0.01,0.674,1735,1669
6,3504,10,100,1e-05,0.01,0.668,1786,1718
6,3604,10,100,1e-05,0.01,0.726,1833,1771
6,3704,10,100,1e-05,0.01,0.708,1881,1823
6,3804,10,100,1e-05,0.01,0.704,1933,1871
6,3904,10,100,1e-05,0.01,0.726,1984,1920
6,4004,10,100,1e-05,0.01,0.716,2038,1966
6,4104,10,100,1e-05,0.01,0.722,2088,2016
6,4204,10,100,1e-05,0.01,0.692,2133,2071
6,4304,10,100,1e-05,0.01,0.704,2187,2117
6,4404,10,100,1e-05,0.01,0.74,2238,2166
6,4504,10,100,1e-05,0.01,0.742,2282,2222
6,4604,10,100,1e-05,0.01,0.726,2333,2271
6,4704,10,100,1e-05,0.01,0.756,2374,2330
6,4804,10,100,1e-05,0.01,0.772,2419,2385
6,4904,10,100,1e-05,0.01,0.766,2465,2439
6,5004,10,100,1e-05,0.01,0.78,2509,2495
6,5104,10,100,1e-05,0.01,0.724,2562,2542
6,5204,10,100,1e-05,0.01,0.762,2615,2589
6,5304,10,100,1e-05,0.01,0.756,2671,2633
6,5404,10,100,1e-05,0.01,0.77,2720,2684
6,5504,10,100,1e-05,0.01,0.772,2768,2736
6,5604,10,100,1e-05,0.01,0.738,2816,2788
6,5704,10,100,1e-05,0.01,0.76,2865,2839
6,5804,10,100,1e-05,0.01,0.788,2905,2899
6,5904,10,100,1e-05,0.01,0.8,2954,2950
6,6004,10,100,1e-05,0.01,0.802,3012,2992
6,6104,10,100,1e-05,0.01,0.786,3060,3044
6,6204,10,100,1e-05,0.01,0.812,3109,3095
6,6304,10,100,1e-05,0.01,0.81,3159,3145
6,6404,10,100,1e-05,0.01,0.792,3216,3188
6,6504,10,100,1e-05,0.01,0.79,3267,3237
6,6604,10,100,1e-05,0.01,0.798,3319,3285
6,6704,10,100,1e-05,0.01,0.766,3369,3335
6,6804,10,100,1e-05,0.01,0.802,3417,3387
6,6904,10,100,1e-05,0.01,0.808,3471,3433
6,7004,10,100,1e-05,0.01,0.802,3526,3478
6,7104,10,100,1e-05,0.01,0.8,3572,3532
6,7204,10,100,1e-05,0.01,0.798,3628,3576
6,7304,10,100,1e-05,0.01,0.806,3674,3630
6,7404,10,100,1e-05,0.01,0.77,3730,3674
6,7504,10,100,1e-05,0.01,0.808,3779,3725
6,7604,10,100,1e-05,0.01,0.82,3835,3769
6,7704,10,100,1e-05,0.01,0.816,3885,3819
6,7804,10,100,1e-05,0.01,0.806,3938,3866
6,7904,10,100,1e-05,0.01,0.808,3984,3920
6,8004,10,100,1e-05,0.01,0.844,4036,3968
6,8104,10,100,1e-05,0.01,0.812,4086,4018
6,8204,10,100,1e-05,0.01,0.834,4138,4066
6,8304,10,100,1e-05,0.01,0.806,4188,4116
6,8404,10,100,1e-05,0.01,0.806,4237,4167
6,8504,10,100,1e-05,0.01,0.834,4285,4219
6,8604,10,100,1e-05,0.01,0.826,4336,4268
6,8704,10,100,1e-05,0.01,0.84,4382,4322
6,8804,10,100,1e-05,0.01,0.846,4433,4371
6,8904,10,100,1e-05,0.01,0.836,4489,4415
6,9004,10,100,1e-05,0.01,0.836,4539,4465
6,9104,10,100,1e-05,0.01,0.808,4586,4518
6,9204,10,100,1e-05,0.01,0.848,4630,4574
6,9304,10,100,1e-05,0.01,0.814,4687,4617
6,9404,10,100,1e-05,0.01,0.868,4737,4667
6,9504,10,100,1e-05,0.01,0.838,4800,4704
6,9604,10,100,1e-05,0.01,0.798,4847,4757
6,9704,10,100,1e-05,0.01,0.832,4892,4812
6,9804,10,100,1e-05,0.01,0.852,4940,4864
6,9904,10,100,1e-05,0.01,0.858,4990,4914
6,10004,10,100,1e-05,0.01,0.832,5041,4963
6,10104,10,100,1e-05,0.01,0.836,5088,5016
6,10204,10,100,1e-05,0.01,0.856,5132,5072
6,10304,10,100,1e-05,0.01,0.856,5177,5127
6,10404,10,100,1e-05,0.01,0.84,5218,5186
6,10504,10,100,1e-05,0.01,0.856,5269,5235
6,10604,10,100,1e-05,0.01,0.868,5317,5287
6,10704,10,100,1e-05,0.01,0.872,5362,5342
6,10804,10,100,1e-05,0.01,0.872,5412,5392
6,10904,10,100,1e-05,0.01,0.878,5459,5445
6,11004,10,100,1e-05,0.01,0.884,5504,5500
6,11104,10,100,1e-05,0.01,0.86,5552,5552
6,11204,10,100,1e-05,0.01,0.868,5608,5596
6,11304,10,100,1e-05,0.01,0.87,5651,5653
6,11404,10,100,1e-05,0.01,0.85,5702,5702
6,11504,10,100,1e-05,0.01,0.866,5751,5753
6,11604,10,100,1e-05,0.01,0.878,5798,5806
6,11704,10,100,1e-05,0.01,0.89,5846,5858
6,11804,10,100,1e-05,0.01,0.862,5899,5905
6,11904,10,100,1e-05,0.01,0.878,5952,5952
6,12004,10,100,1e-05,0.01,0.902,5997,6007
6,12104,10,100,1e-05,0.01,0.87,6048,6056
6,12204,10,100,1e-05,0.01,0.834,6102,6102
6,12304,10,100,1e-05,0.01,0.788,6142,6162
6,12404,10,100,1e-05,0.01,0.806,6196,6208
6,12504,10,100,1e-05,0.01,0.836,6246,6258
6,12604,10,100,1e-05,0.01,0.804,6298,6306
6,12704,10,100,1e-05,0.01,0.794,6342,6362
6,12804,10,100,1e-05,0.01,0.836,6395,6409
6,12904,10,100,1e-05,0.01,0.838,6447,6457
6,13004,10,100,1e-05,0.01,0.858,6499,6505
6,13104,10,100,1e-05,0.01,0.866,6540,6564
6,13204,10,100,1e-05,0.01,0.85,6595,6609
6,13304,10,100,1e-05,0.01,0.852,6645,6659
6,13404,10,100,1e-05,0.01,0.852,6693,6711
6,13504,10,100,1e-05,0.01,0.868,6742,6762
6,13604,10,100,1e-05,0.01,0.866,6791,6813
6,13704,10,100,1e-05,0.01,0.848,6837,6867
6,13804,10,100,1e-05,0.01,0.886,6891,6913
6,13904,10,100,1e-05,0.01,0.886,6939,6965
6,14004,10,100,1e-05,0.01,0.842,6992,7012
6,14104,10,100,1e-05,0.01,0.872,7044,7060
6,14204,10,100,1e-05,0.01,0.882,7090,7114
6,14304,10,100,1e-05,0.01,0.892,7141,7163
6,14404,10,100,1e-05,0.01,0.906,7188,7216
6,14504,10,100,1e-05,0.01,0.91,7238,7266
6,14604,10,100,1e-05,0.01,0.87,7291,7313
6,14704,10,100,1e-05,0.01,0.882,7344,7360
6,14804,10,100,1e-05,0.01,0.896,7396,7408
6,14904,10,100,1e-05,0.01,0.9,7448,7456
6,15004,10,100,1e-05,0.01,0.902,7500,7504
7,104,10,100,1e-05,0.01,0.526,56,48
7,204,10,100,1e-05,0.01,0.464,114,90
7,304,10,100,1e-05,0.01,0.494,164,140
7,404,10,100,1e-05,0.01,0.534,198,206
7,504,10,100,1e-05,0.01,0.528,236,268
7,604,10,100,1e-05,0.01,0.496,278,326
7,704,10,100,1e-05,0.01,0.468,329,375
7,804,10,100,1e-05,0.01,0.526,372,432
7,904,10,100,1e-05,0.01,0.532,418,486
7,1004,10,100,1e-05,0.01,0.51,468,536
7,1104,10,100,1e-05,0.01,0.498,517,587
7,1204,10,100,1e-05,0.01,0.518,570,634
7,1304,10,100,1e-05,0.01,0.544,628,676
7,1404,10,100,1e-05,0.01,0.538,682,722
7,1504,10,100,1e-05,0.01,0.522,733,771
7,1604,10,100,1e-05,0.01,0.512,782,822
7,1704,10,100,1e-05,0.01,0.52,832,872
7,1804,10,100,1e-05,0.01,0.498,885,919
7,1904,10,100,1e-05,0.01,0.504,943,961
7,2004,10,100,1e-05,0.01,0.54,989,1015
7,2104,10,100,1e-05,0.01,0.496,1035,1069
7,2204,10,100,1e-05,0.01,0.512,1081,1123
7,2304,10,100,1e-05,0.01,0.544,1132,1172
7,2404,10,100,1e-05,0.01,0.548,1185,1219
7,2504,10,100,1e-05,0.01,0.592,1231,1273
7,2604,10,100,1e-05,0.01,0.586,1290,1314
7,2704,10,100,1e-05,0.01,0.576,1329,1375
7,2804,10,100,1e-05,0.01,0.656,1377,1427
7,2904,10,100,1e-05,0.01,0.668,1418,1486
7,3004,10,100,1e-05,0.01,0.656,1469,1535
7,3104,10,100,1e-05,0.01,0.674,1514,1590
7,3204,10,100,1e-05,0.01,0.69,1560,1644
7,3304,10,100,1e-05,0.01,0.722,1614,1690
7,3404,10,100,1e-05,0.01,0.71,1664,1740
7,3504,10,100,1e-05,0.01,0.748,1715,1789
7,3604,10,100,1e-05,0.01,0.74,1767,1837
7,3704,10,100,1e-05,0.01,0.712,1817,1887
7,3804,10,100,1e-05,0.01,0.754,1868,1936
7,3904,10,100,1e-05,0.01,0.762,1919,1985
7,4004,10,100,1e-05,0.01,0.776,1958,2046
7,4104,10,100,1e-05,0.01,0.784,2019,2085
7,4204,10,100,1e-05,0.01,0.788,2068,2136
7,4304,10,100,1e-05,0.01,0.814,2112,2192
7,4404,10,100,1e-05,0.01,0.8,2160,2244
7,4504,10,100,1e-05,0.01,0.738,2220,2284
7,4604,10,100,1e-05,0.01,0.812,2272,2332
7,4704,10,100,1e-05,0.01,0.802,2319,2385
7,4804,10,100,1e-05,0.01,0.812,2373,2431
7,4904,10,100,1e-05,0.01,0.852,2417,2487
7,5004,10,100,1e-05,0.01,0.846,2467,2537
7,5104,10,100,1e-05,0.01,0.828,2508,2596
7,5204,10,100,1e-05,0.01,0.874,2558,2646
7,5304,10,100,1e-05,0.01,0.824,2611,2693
7,5404,10,100,1e-05,0.01,0.86,2658,2746
7,5504,10,100,1e-05,0.01,0.848,2707,2797
7,5604,10,100,1e-05,0.01,0.84,2759,2845
7,5704,10,100,1e-05,0.01,0.858,2804,2900
7,5804,10,100,1e-05,0.01,0.864,2852,2952
7,5904,10,100,1e-05,0.01,0.882,2903,3001
7,6004,10,100,1e-05,0.01,0.86,2951,3053
7,6104,10,100,1e-05,0.01,0.862,3004,3100
7,6204,10,100,1e-05,0.01,0.87,3049,3155
7,6304,10,100,1e-05,0.01,0.85,3096,3208
7,6404,10,100,1e-05,0.01,0.842,3147,3257
7,6504,10,100,1e-05,0.01,0.886,3193,3311
7,6604,10,100,1e-05,0.01,0.872,3241,3363
7,6704,10,100,1e-05,0.01,0.87,3295,3409
7,6804,10,100,1e-05,0.01,0.86,3343,3461
7,6904,10,100,1e-05,0.01,0.88,3391,3513
7,7004,10,100,1e-05,0.01,0.866,3443,3561
7,7104,10,100,1e-05,0.01,0.818,3490,3614
7,7204,10,100,1e-05,0.01,0.878,3537,3667
7,7304,10,100,1e-05,0.01,0.882,3588,3716
7,7404,10,100,1e-05,0.01,0.858,3637,3767
7,7504,10,100,1e-05,0.01,0.864,3695,3809
7,7604,10,100,1e-05,0.01,0.882,3743,3861
7,7704,10,100,1e-05,0.01,0.864,3792,3912
7,7804,10,100,1e-05,0.01,0.878,3836,3968
7,7904,10,100,1e-05,0.01,0.864,3884,4020
7,8004,10,100,1e-05,0.01,0.866,3930,4074
7,8104,10,100,1e-05,0.01,0.874,3968,4136
7,8204,10,100,1e-05,0.01,0.824,4020,4184
7,8304,10,100,1e-05,0.01,0.858,4080,4224
7,8404,10,100,1e-05,0.01,0.864,4134,4270
7,8504,10,100,1e-05,0.01,0.876,4178,4326
7,8604,10,100,1e-05,0.01,0.916,4226,4378
7,8704,10,100,1e-05,0.01,0.882,4278,4426
7,8804,10,100,1e-05,0.01,0.876,4334,4470
7,8904,10,100,1e-05,0.01,0.894,4385,4519
7,9004,10,100,1e-05,0.01,0.892,4440,4564
7,9104,10,100,1e-05,0.01,0.906,4491,4613
7,9204,10,100,1e-05,0.01,0.888,4539,4665
7,9304,10,100,1e-05,0.01,0.898,4593,4711
7,9404,10,100,1e-05,0.01,0.866,4646,4758
7,9504,10,100,1e-05,0.01,0.884,4700,4804
7,9604,10,100,1e-05,0.01,0.892,4758,4846
7,9704,10,100,1e-05,0.01,0.92,4814,4890
7,9804,10,100,1e-05,0.01,0.88,4852,4952
7,9904,10,100,1e-05,0.01,0.874,4902,5002
7,10004,10,100,1e-05,0.01,0.89,4953,5051
7,10104,10,100,1e-05,0.01,0.9,5005,5099
7,10204,10,100,1e-05,0.01,0.91,5055,5149
7,10304,10,100,1e-05,0.01,0.914,5107,5197
7,10404,10,100,1e-05,0.01,0.914,5164,5240
7,10504,10,100,1e-05,0.01,0.916,5213,5291
7,10604,10,100,1e-05,0.01,0.904,5265,5339
7,10704,10,100,1e-05,0.01,0.916,5315,5389
7,10804,10,100,1e-05,0.01,0.912,5368,5436
7,10904,10,100,1e-05,0.01,0.926,5418,5486
7,11004,10,100,1e-05,0.01,0.914,5467,5537
7,11104,10,100,1e-05,0.01,0.932,5525,5579
7,11204,10,100,1e-05,0.01,0.92,5575,5629
7,11304,10,100,1e-05,0.01,0.904,5622,5682
7,11404,10,100,1e-05,0.01,0.902,5667,5737
7,11504,10,100,1e-05,0.01,0.92,5717,5787
7,11604,10,100,1e-05,0.01,0.914,5765,5839
7,11704,10,100,1e-05,0.01,0.922,5825,5879
7,11804,10,100,1e-05,0.01,0.92,5884,5920
7,11904,10,100,1e-05,0.01,0.92,5931,5973
7,12004,10,100,1e-05,0.01,0.932,5984,6020
7,12104,10,100,1e-05,0.01,0.91,6036,6068
7,12204,10,100,1e-05,0.01,0.934,6092,6112
7,12304,10,100,1e-05,0.01,0.926,6145,6159
7,12404,10,100,1e-05,0.01,0.932,6195,6209
7,12504,10,100,1e-05,0.01,0.926,6248,6256
7,12604,10,100,1e-05,0.01,0.936,6296,6308
7,12704,10,100,1e-05,0.01,0.934,6340,6364
7,12804,10,100,1e-05,0.01,0.93,6396,6408
7,12904,10,100,1e-05,0.01,0.93,6449,6455
7,13004,10,100,1e-05,0.01,0.936,6488,6516
7,13104,10,100,1e-05,0.01,0.922,6539,6565
7,13204,10,100,1e-05,0.01,0.936,6588,6616
7,13304,10,100,1e-05,0.01,0.928,6634,6670
7,13404,10,100,1e-05,0.01,0.916,6694,6710
7,13504,10,100,1e-05,0.01,0.92,6746,6758
7,13604,10,100,1e-05,0.01,0.934,6797,6807
7,13704,10,100,1e-05,0.01,0.944,6850,6854
7,13804,10,100,1e-05,0.01,0.934,6901,6903
7,13904,10,100,1e-05,0.01,0.912,6961,6943
7,14004,10,100,1e-05,0.01,0.93,7009,6995
7,14104,10,100,1e-05,0.01,0.934,7059,7045
7,14204,10,100,1e-05,0.01,0.928,7109,7095
7,14304,10,100,1e-05,0.01,0.932,7154,7150
7,14404,10,100,1e-05,0.01,0.944,7198,7206
7,14504,10,100,1e-05,0.01,0.934,7256,7248
7,14604,10,100,1e-05,0.01,0.954,7310,7294
7,14704,10,100,1e-05,0.01,0.952,7355,7349
7,14804,10,100,1e-05,0.01,0.928,7414,7390
7,14904,10,100,1e-05,0.01,0.928,7466,7438
7,15004,10,100,1e-05,0.01,0.946,7515,7489
8,104,10,100,1e-05,0.01,0.512,48,56
8,204,10,100,1e-05,0.01,0.484,92,112
8,304,10,100,1e-05,0.01,0.516,140,164
8,404,10,100,1e-05,0.01,0.53,184,220
8,504,10,100,1e-05,0.01,0.5,228,276
8,604,10,100,1e-05,0.01,0.504,272,332
8,704,10,100,1e-05,0.01,0.524,317,387
8,804,10,100,1e-05,0.01,0.518,366,438
8,904,10,100,1e-05,0.01,0.522,415,489
8,1004,10,100,1e-05,0.01,0.524,463,541
8,1104,10,100,1e-05,0.01,0.512,512,592
8,1204,10,100,1e-05,0.01,0.504,560,644
8,1304,10,100,1e-05,0.01,0.516,619,685
8,1404,10,100,1e-05,0.01,0.536,673,731
8,1504,10,100,1e-05,0.01,0.506,723,781
8,1604,10,100,1e-05,0.01,0.546,782,822
8,1704,10,100,1e-05,0.01,0.526,832,872
8,1804,10,100,1e-05,0.01,0.484,894,910
8,1904,10,100,1e-05,0.01,0.502,948,956
8,2004,10,100,1e-05,0.01,0.55,1001,1003
8,2104,10,100,1e-05,0.01,0.544,1053,1051
8,2204,10,100,1e-05,0.01,0.54,1101,1103
8,2304,10,100,1e-05,0.01,0.57,1153,1151
8,2404,10,100,1e-05,0.01,0.548,1198,1206
8,2504,10,100,1e-05,0.01,0.562,1247,1257
8,2604,10,100,1e-05,0.01,0.59,1293,1311
8,2704,10,100,1e-05,0.01,0.612,1347,1357
8,2804,10,100,1e-05,0.01,0.612,1393,1411
8,2904,10,100,1e-05,0.01,0.612,1441,1463
8,3004,10,100,1e-05,0.01,0.572,1495,1509
8,3104,10,100,1e-05,0.01,0.626,1548,1556
8,3204,10,100,1e-05,0.01,0.654,1585,1619
8,3304,10,100,1e-05,0.01,0.636,1636,1668
8,3404,10,100,1e-05,0.01,0.598,1670,1734
8,3504,10,100,1e-05,0.01,0.65,1718,1786
8,3604,10,100,1e-05,0.01,0.65,1758,1846
8,3704,10,100,1e-05,0.01,0.626,1807,1897
8,3804,10,100,1e-05,0.01,0.638,1855,1949
8,3904,10,100,1e-05,0.01,0.642,1900,2004
8,4004,10,100,1e-05,0.01,0.64,1953,2051
8,4104,10,100,1e-05,0.01,0.628,2001,2103
8,4204,10,100,1e-05,0.01,0.666,2059,2145
8,4304,10,100,1e-05,0.01,0.662,2112,2192
8,4404,10,100,1e-05,0.01,0.656,2166,2238
8,4504,10,100,1e-05,0.01,0.692,2218,2286
8,4604,10,100,1e-05,0.01,0.642,2264,2340
8,4704,10,100,1e-05,0.01,0.666,2322,2382
8,4804,10,100,1e-05,0.01,0.674,2365,2439
8,4904,10,100,1e-05,0.01,0.698,2417,2487
8,5004,10,100,1e-05,0.01,0.706,2477,2527
8,5104,10,100,1e-05,0.01,0.724,2537,2567
8,5204,10,100,1e-05,0.01,0.722,2589,2615
8,5304,10,100,1e-05,0.01,0.714,2637,2667
8,5404,10,100,1e-05,0.01,0.712,2689,2715
8,5504,10,100,1e-05,0.01,0.734,2753,2751
8,5604,10,100,1e-05,0.01,0.71,2804,2800
8,5704,10,100,1e-05,0.01,0.732,2864,2840
8,5804,10,100,1e-05,0.01,0.692,2909,2895
8,5904,10,100,1e-05,0.01,0.694,2960,2944
8,6004,10,100,1e-05,0.01,0.718,3010,2994
8,6104,10,100,1e-05,0.01,0.726,3065,3039
8,6204,10,100,1e-05,0.01,0.736,3117,3087
8,6304,10,100,1e-05,0.01,0.74,3166,3138
8,6404,10,100,1e-05,0.01,0.732,3213,3191
8,6504,10,100,1e-05,0.01,0.716,3259,3245
8,6604,10,100,1e-05,0.01,0.736,3311,3293
8,6704,10,100,1e-05,0.01,0.752,3359,3345
8,6804,10,100,1e-05,0.01,0.762,3411,3393
8,6904,10,100,1e-05,0.01,0.766,3449,3455
8,7004,10,100,1e-05,0.01,0.742,3493,3511
8,7104,10,100,1e-05,0.01,0.776,3543,3561
8,7204,10,100,1e-05,0.01,0.74,3585,3619
8,7304,10,100,1e-05,0.01,0.76,3633,3671
8,7404,10,100,1e-05,0.01,0.784,3679,3725
8,7504,10,100,1e-05,0.01,0.81,3733,3771
8,7604,10,100,1e-05,0.01,0.778,3783,3821
8,7704,10,100,1e-05,0.01,0.79,3832,3872
8,7804,10,100,1e-05,0.01,0.802,3888,3916
8,7904,10,100,1e-05,0.01,0.786,3939,3965
8,8004,10,100,1e-05,0.01,0.794,3992,4012
8,8104,10,100,1e-05,0.01,0.794,4037,4067
8,8204,10,100,1e-05,0.01,0.814,4091,4113
8,8304,10,100,1e-05,0.01,0.75,4141,4163
8,8404,10,100,1e-05,0.01,0.774,4195,4209
8,8504,10,100,1e-05,0.01,0.794,4238,4266
8,8604,10,100,1e-05,0.01,0.766,4281,4323
8,8704,10,100,1e-05,0.01,0.778,4329,4375
8,8804,10,100,1e-05,0.01,0.79,4374,4430
8,8904,10,100,1e-05,0.01,0.76,4424,4480
8,9004,10,100,1e-05,0.01,0.778,4467,4537
8,9104,10,100,1e-05,0.01,0.82,4525,4579
8,9204,10,100,1e-05,0.01,0.794,4572,4632
8,9304,10,100,1e-05,0.01,0.804,4630,4674
8,9404,10,100,1e-05,0.01,0.784,4681,4723
8,9504,10,100,1e-05,0.01,0.806,4741,4763
8,9604,10,100,1e-05,0.01,0.808,4792,4812
8,9704,10,100,1e-05,0.01,0.802,4851,4853
8,9804,10,100,1e-05,0.01,0.824,4911,4893
8,9904,10,100,1e-05,0.01,0.782,4958,4946
8,10004,10,100,1e-05,0.01,0.796,5015,4989
8,10104,10,100,1e-05,0.01,0.782,5054,5050
8,10204,10,100,1e-05,0.01,0.784,5107,5097
8,10304,10,100,1e-05,0.01,0.802,5159,5145
8,10404,10,100,1e-05,0.01,0.782,5223,5181
8,10504,10,100,1e-05,0.01,0.818,5280,5224
8,10604,10,100,1e-05,0.01,0.822,5326,5278
8,10704,10,100,1e-05,0.01,0.812,5372,5332
8,10804,10,100,1e-05,0.01,0.826,5426,5378
8,10904,10,100,1e-05,0.01,0.832,5480,5424
8,11004,10,100,1e-05,0.01,0.84,5534,5470
8,11104,10,100,1e-05,0.01,0.836,5586,5518
8,11204,10,100,1e-05,0.01,0.854,5627,5577
8,11304,10,100,1e-05,0.01,0.846,5682,5622
8,11404,10,100,1e-05,0.01,0.86,5738,5666
8,11504,10,100,1e-05,0.01,0.854,5788,5716
8,11604,10,100,1e-05,0.01,0.848,5833,5771
8,11704,10,100,1e-05,0.01,0.856,5889,5815
8,11804,10,100,1e-05,0.01,0.866,5943,5861
8,11904,10,100,1e-05,0.01,0.852,5988,5916
8,12004,10,100,1e-05,0.01,0.868,6039,5965
8,12104,10,100,1e-05,0.01,0.856,6085,6019
8,12204,10,100,1e-05,0.01,0.872,6134,6070
8,12304,10,100,1e-05,0.01,0.884,6183,6121
8,12404,10,100,1e-05,0.01,0.87,6229,6175
8,12504,10,100,1e-05,0.01,0.868,6269,6235
8,12604,10,100,1e-05,0.01,0.872,6324,6280
8,12704,10,100,1e-05,0.01,0.868,6365,6339
8,12804,10,100,1e-05,0.01,0.872,6410,6394
8,12904,10,100,1e-05,0.01,0.89,6464,6440
8,13004,10,100,1e-05,0.01,0.876,6512,6492
8,13104,10,100,1e-05,0.01,0.892,6558,6546
8,13204,10,100,1e-05,0.01,0.892,6605,6599
8,13304,10,100,1e-05,0.01,0.894,6655,6649
8,13404,10,100,1e-05,0.01,0.88,6704,6700
8,13504,10,100,1e-05,0.01,0.882,6753,6751
8,13604,10,100,1e-05,0.01,0.884,6810,6794
8,13704,10,100,1e-05,0.01,0.874,6865,6839
8,13804,10,100,1e-05,0.01,0.896,6914,6890
8,13904,10,100,1e-05,0.01,0.884,6964,6940
8,14004,10,100,1e-05,0.01,0.898,7008,6996
8,14104,10,100,1e-05,0.01,0.918,7058,7046
8,14204,10,100,1e-05,0.01,0.9,7104,7100
8,14304,10,100,1e-05,0.01,0.892,7151,7153
8,14404,10,100,1e-05,0.01,0.854,7195,7209
8,14504,10,100,1e-05,0.01,0.878,7250,7254
8,14604,10,100,1e-05,0.01,0.88,7306,7298
8,14704,10,100,1e-05,0.01,0.9,7355,7349
8,14804,10,100,1e-05,0.01,0.922,7402,7402
8,14904,10,100,1e-05,0.01,0.922,7447,7457
8,15004,10,100,1e-05,0.01,0.908,7503,7501
9,104,10,100,1e-05,0.01,0.51,55,49
9,204,10,100,1e-05,0.01,0.474,107,97
9,304,10,100,1e-05,0.01,0.474,156,148
9,404,10,100,1e-05,0.01,0.466,211,193
9,504,10,100,1e-05,0.01,0.526,257,247
9,604,10,100,1e-05,0.01,0.532,297,307
9,704,10,100,1e-05,0.01,0.508,346,358
9,804,10,100,1e-05,0.01,0.5,397,407
9,904,10,100,1e-05,0.01,0.49,450,454
9,1004,10,100,1e-05,0.01,0.47,496,508
9,1104,10,100,1e-05,0.01,0.484,554,550
9,1204,10,100,1e-05,0.01,0.518,610,594
9,1304,10,100,1e-05,0.01,0.492,661,643
9,1404,10,100,1e-05,0.01,0.512,719,685
9,1504,10,100,1e-05,0.01,0.526,765,739
9,1604,10,100,1e-05,0.01,0.55,811,793
9,1704,10,100,1e-05,0.01,0.524,863,841
9,1804,10,100,1e-05,0.01,0.59,924,880
9,1904,10,100,1e-05,0.01,0.586,975,929
9,2004,10,100,1e-05,0.01,0.61,1023,981
9,2104,10,100,1e-05,0.01,0.67,1068,1036
9,2204,10,100,1e-05,0.01,0.694,1113,1091
9,2304,10,100,1e-05,0.01,0.716,1166,1138
9,2404,10,100,1e-05,0.01,0.692,1221,1183
9,2504,10,100,1e-05,0.01,0.716,1270,1234
9,2604,10,100,1e-05,0.01,0.7,1315,1289
9,2704,10,100,1e-05,0.01,0.722,1361,1343
9,2804,10,100,1e-05,0.01,0.708,1403,1401
9,2904,10,100,1e-05,0.01,0.726,1453,1451
9,3004,10,100,1e-05,0.01,0.73,1503,1501
9,3104,10,100,1e-05,0.01,0.75,1550,1554
9,3204,10,100,1e-05,0.01,0.734,1595,1609
9,3304,10,100,1e-05,0.01,0.694,1641,1663
9,3404,10,100,1e-05,0.01,0.724,1691,1713
9,3504,10,100,1e-05,0.01,0.752,1739,1765
9,3604,10,100,1e-05,0.01,0.746,1786,1818
9,3704,10,100,1e-05,0.01,0.734,1840,1864
9,3804,10,100,1e-05,0.01,0.742,1894,1910
9,3904,10,100,1e-05,0.01,0.778,1943,1961
9,4004,10,100,1e-05,0.01,0.742,2000,2004
9,4104,10,100,1e-05,0.01,0.78,2052,2052
9,4204,10,100,1e-05,0.01,0.762,2106,2098
9,4304,10,100,1e-05,0.01,0.774,2153,2151
9,4404,10,100,1e-05,0.01,0.776,2205,2199
9,4504,10,100,1e-05,0.01,0.798,2248,2256
9,4604,10,100,1e-05,0.01,0.78,2302,2302
9,4704,10,100,1e-05,0.01,0.762,2351,2353
9,4804,10,100,1e-05,0.01,0.772,2406,2398
9,4904,10,100,1e-05,0.01,0.802,2455,2449
9,5004,10,100,1e-05,0.01,0.782,2506,2498
9,5104,10,100,1e-05,0.01,0.784,2565,2539
9,5204,10,100,1e-05,0.01,0.808,2607,2597
9,5304,10,100,1e-05,0.01,0.782,2662,2642
9,5404,10,100,1e-05,0.01,0.764,2713,2691
9,5504,10,100,1e-05,0.01,0.808,2760,2744
9,5604,10,100,1e-05,0.01,0.782,2822,2782
9,5704,10,100,1e-05,0.01,0.81,2879,2825
9,5804,10,100,1e-05,0.01,0.774,2920,2884
9,5904,10,100,1e-05,0.01,0.816,2967,2937
9,6004,10,100,1e-05,0.01,0.808,3016,2988
9,6104,10,100,1e-05,0.01,0.814,3070,3034
9,6204,10,100,1e-05,0.01,0.796,3122,3082
9,6304,10,100,1e-05,0.01,0.794,3171,3133
9,6404,10,100,1e-05,0.01,0.774,3221,3183
9,6504,10,100,1e-05,0.01,0.806,3274,3230
9,6604,10,100,1e-05,0.01,0.806,3323,3281
9,6704,10,100,1e-05,0.01,0.82,3374,3330
9,6804,10,100,1e-05,0.01,0.804,3427,3377
9,6904,10,100,1e-05,0.01,0.808,3470,3434
9,7004,10,100,1e-05,0.01,0.774,3524,3480
9,7104,10,100,1e-05,0.01,0.778,3569,3535
9,7204,10,100,1e-05,0.01,0.796,3619,3585
9,7304,10,100,1e-05,0.01,0.794,3663,3641
9,7404,10,100,1e-05,0.01,0.804,3711,3693
9,7504,10,100,1e-05,0.01,0.802,3759,3745
9,7604,10,100,1e-05,0.01,0.834,3809,3795
9,7704,10,100,1e-05,0.01,0.82,3861,3843
9,7804,10,100,1e-05,0.01,0.82,3922,3882
9,7904,10,100,1e-05,0.01,0.798,3979,3925
9,8004,10,100,1e-05,0.01,0.804,4032,3972
9,8104,10,100,1e-05,0.01,0.818,4074,4030
9,8204,10,100,1e-05,0.01,0.824,4134,4070
9,8304,10,100,1e-05,0.01,0.816,4182,4122
9,8404,10,100,1e-05,0.01,0.834,4240,4164
9,8504,10,100,1e-05,0.01,0.826,4289,4215
9,8604,10,100,1e-05,0.01,0.822,4339,4265
9,8704,10,100,1e-05,0.01,0.816,4390,4314
9,8804,10,100,1e-05,0.01,0.854,4427,4377
9,8904,10,100,1e-05,0.01,0.818,4471,4433
9,9004,10,100,1e-05,0.01,0.816,4524,4480
9,9104,10,100,1e-05,0.01,0.842,4575,4529
9,9204,10,100,1e-05,0.01,0.838,4636,4568
9,9304,10,100,1e-05,0.01,0.84,4693,4611
9,9404,10,100,1e-05,0.01,0.856,4741,4663
9,9504,10,100,1e-05,0.01,0.844,4786,4718
9,9604,10,100,1e-05,0.01,0.842,4840,4764
9,9704,10,100,1e-05,0.01,0.87,4895,4809
9,9804,10,100,1e-05,0.01,0.864,4940,4864
9,9904,10,100,1e-05,0.01,0.874,4982,4922
9,10004,10,100,1e-05,0.01,0.86,5033,4971
9,10104,10,100,1e-05,0.01,0.856,5086,5018
9,10204,10,100,1e-05,0.01,0.854,5139,5065
9,10304,10,100,1e-05,0.01,0.842,5198,5106
9,10404,10,100,1e-05,0.01,0.872,5244,5160
9,10504,10,100,1e-05,0.01,0.882,5298,5206
9,10604,10,100,1e-05,0.01,0.862,5353,5251
9,10704,10,100,1e-05,0.01,0.862,5406,5298
9,10804,10,100,1e-05,0.01,0.87,5460,5344
9,10904,10,100,1e-05,0.01,0.858,5513,5391
9,11004,10,100,1e-05,0.01,0.862,5567,5437
9,11104,10,100,1e-05,0.01,0.874,5608,5496
9,11204,10,100,1e-05,0.01,0.83,5643,5561
9,11304,10,100,1e-05,0.01,0.85,5696,5608
9,11404,10,100,1e-05,0.01,0.832,5743,5661
9,11504,10,100,1e-05,0.01,0.862,5785,5719
9,11604,10,100,1e-05,0.01,0.842,5833,5771
9,11704,10,100,1e-05,0.01,0.87,5880,5824
9,11804,10,100,1e-05,0.01,0.886,5924,5880
9,11904,10,100,1e-05,0.01,0.892,5977,5927
9,12004,10,100,1e-05,0.01,0.848,6028,5976
9,12104,10,100,1e-05,0.01,0.866,6081,6023
9,12204,10,100,1e-05,0.01,0.87,6130,6074
9,12304,10,100,1e-05,0.01,0.878,6177,6127
9,12404,10,100,1e-05,0.01,0.884,6222,6182
9,12504,10,100,1e-05,0.01,0.906,6267,6237
9,12604,10,100,1e-05,0.01,0.866,6321,6283
9,12704,10,100,1e-05,0.01,0.876,6381,6323
9,12804,10,100,1e-05,0.01,0.896,6428,6376
9,12904,10,100,1e-05,0.01,0.89,6478,6426
9,13004,10,100,1e-05,0.01,0.874,6514,6490
9,13104,10,100,1e-05,0.01,0.894,6554,6550
9,13204,10,100,1e-05,0.01,0.882,6612,6592
9,13304,10,100,1e-05,0.01,0.91,6658,6646
9,13404,10,100,1e-05,0.01,0.858,6701,6703
9,13504,10,100,1e-05,0.01,0.886,6755,6749
9,13604,10,100,1e-05,0.01,0.862,6807,6797
9,13704,10,100,1e-05,0.01,0.872,6861,6843
9,13804,10,100,1e-05,0.01,0.9,6911,6893
9,13904,10,100,1e-05,0.01,0.888,6966,6938
9,14004,10,100,1e-05,0.01,0.878,7017,6987
9,14104,10,100,1e-05,0.01,0.894,7066,7038
9,14204,10,100,1e-05,0.01,0.874,7113,7091
9,14304,10,100,1e-05,0.01,0.892,7160,7144
9,14404,10,100,1e-05,0.01,0.888,7206,7198
9,14504,10,100,1e-05,0.01,0.88,7254,7250
9,14604,10,100,1e-05,0.01,0.894,7302,7302
9,14704,10,100,1e-05,0.01,0.88,7354,7350
9,14804,10,100,1e-05,0.01,0.894,7405,7399
9,14904,10,100,1e-05,0.01,0.914,7451,7453
9,15004,10,100,1e-05,0.01,0.904,7507,7497
10,104,10,100,1e-05,0.01,0.508,39,65
10,204,10,100,1e-05,0.01,0.488,93,111
10,304,10,100,1e-05,0.01,0.492,148,156
10,404,10,100,1e-05,0.01,0.516,197,207
10,504,10,100,1e-05,0.01,0.508,253,251
10,604,10,100,1e-05,0.01,0.528,303,301
10,704,10,100,1e-05,0.01,0.492,360,344
10,804,10,100,1e-05,0.01,0.508,411,393
10,904,10,100,1e-05,0.01,0.514,453,451
10,1004,10,100,1e-05,0.01,0.536,508,496
10,1104,10,100,1e-05,0.01,0.512,554,550
10,1204,10,100,1e-05,0.01,0.528,602,602
10,1304,10,100,1e-05,0.01,0.506,650,654
10,1404,10,100,1e-05,0.01,0.524,705,699
10,1504,10,100,1e-05,0.01,0.52,758,746
10,1604,10,100,1e-05,0.01,0.518,816,788
10,1704,10,100,1e-05,0.01,0.51,872,832
10,1804,10,100,1e-05,0.01,0.488,915,889
10,1904,10,100,1e-05,0.01,0.508,975,929
10,2004,10,100,1e-05,0.01,0.514,1022,982
10,2104,10,100,1e-05,0.01,0.51,1070,1034
10,2204,10,100,1e-05,0.01,0.51,1117,1087
10,2304,10,100,1e-05,0.01,0.496,1169,1135
10,2404,10,100,1e-05,0.01,0.516,1209,1195
10,2504,10,100,1e-05,0.01,0.522,1268,1236
10,2604,10,100,1e-05,0.01,0.52,1322,1282
10,2704,10,100,1e-05,0.01,0.542,1380,1324
10,2804,10,100,1e-05,0.01,0.566,1425,1379
10,2904,10,100,1e-05,0.01,0.576,1480,1424
10,3004,10,100,1e-05,0.01,0.614,1531,1473
10,3104,10,100,1e-05,0.01,0.632,1578,1526
10,3204,10,100,1e-05,0.01,0.672,1636,1568
10,3304,10,100,1e-05,0.01,0.698,1676,1628
10,3404,10,100,1e-05,0.01,0.734,1729,1675
10,3504,10,100,1e-05,0.01,0.714,1776,1728
10,3604,10,100,1e-05,0.01,0.736,1822,1782
10,3704,10,100,1e-05,0.01,0.748,1874,1830
10,3804,10,100,1e-05,0.01,0.766,1927,1877
10,3904,10,100,1e-05,0.01,0.77,1977,1927
10,4004,10,100,1e-05,0.01,0.786,2034,1970
10,4104,10,100,1e-05,0.01,0.76,2089,2015
10,4204,10,100,1e-05,0.01,0.812,2141,2063
10,4304,10,100,1e-05,0.01,0.804,2188,2116
10,4404,10,100,1e-05,0.01,0.796,2245,2159
10,4504,10,100,1e-05,0.01,0.838,2300,2204
10,4604,10,100,1e-05,0.01,0.832,2341,2263
10,4704,10,100,1e-05,0.01,0.862,2400,2304
10,4804,10,100,1e-05,0.01,0.876,2448,2356
10,4904,10,100,1e-05,0.01,0.884,2503,2401
10,5004,10,100,1e-05,0.01,0.882,2558,2446
10,5104,10,100,1e-05,0.01,0.892,2601,2503
10,5204,10,100,1e-05,0.01,0.914,2648,2556
10,5304,10,100,1e-05,0.01,0.91,2695,2609
10,5404,10,100,1e-05,0.01,0.896,2735,2669
10,5504,10,100,1e-05,0.01,0.9,2787,2717
10,5604,10,100,1e-05,0.01,0.918,2836,2768
10,5704,10,100,1e-05,0.01,0.932,2887,2817
10,5804,10,100,1e-05,0.01,0.916,2934,2870
10,5904,10,100,1e-05,0.01,0.912,2986,2918
10,6004,10,100,1e-05,0.01,0.924,3038,2966
10,6104,10,100,1e-05,0.01,0.94,3077,3027
10,6204,10,100,1e-05,0.01,0.952,3127,3077
10,6304,10,100,1e-05,0.01,0.95,3170,3134
10,6404,10,100,1e-05,0.01,0.962,3224,3180
10,6504,10,100,1e-05,0.01,0.962,3271,3233
10,6604,10,100,1e-05,0.01,0.96,3323,3281
10,6704,10,100,1e-05,0.01,0.962,3373,3331
10,6804,10,100,1e-05,0.01,0.962,3423,3381
10,6904,10,100,1e-05,0.01,0.962,3474,3430
10,7004,10,100,1e-05,0.01,0.964,3520,3484
10,7104,10,100,1e-05,0.01,0.954,3571,3533
10,7204,10,100,1e-05,0.01,0.96,3620,3584
10,7304,10,100,1e-05,0.01,0.96,3671,3633
10,7404,10,100,1e-05,0.01,0.966,3715,3689
10,7504,10,100,1e-05,0.01,0.958,3765,3739
10,7604,10,100,1e-05,0.01,0.968,3808,3796
10,7704,10,100,1e-05,0.01,0.972,3865,3839
10,7804,10,100,1e-05,0.01,0.978,3908,3896
10,7904,10,100,1e-05,0.01,0.982,3945,3959
10,8004,10,100,1e-05,0.01,0.972,3993,4011
10,8104,10,100,1e-05,0.01,0.976,4045,4059
10,8204,10,100,1e-05,0.01,0.974,4087,4117
10,8304,10,100,1e-05,0.01,0.978,4127,4177
10,8404,10,100,1e-05,0.01,0.982,4178,4226
10,8504,10,100,1e-05,0.01,0.98,4231,4273
10,8604,10,100,1e-05,0.01,0.98,4277,4327
10,8704,10,100,1e-05,0.01,0.984,4337,4367
10,8804,10,100,1e-05,0.01,0.978,4389,4415
10,8904,10,100,1e-05,0.01,0.98,4432,4472
10,9004,10,100,1e-05,0.01,0.974,4489,4515
10,9104,10,100,1e-05,0.01,0.978,4543,4561
10,9204,10,100,1e-05,0.01,0.98,4594,4610
10,9304,10,100,1e-05,0.01,0.984,4651,4653
10,9404,10,100,1e-05,0.01,0.984,4703,4701
10,9504,10,100,1e-05,0.01,0.98,4739,4765
10,9604,10,100,1e-05,0.01,0.966,4787,4817
10,9704,10,100,1e-05,0.01,0.966,4843,4861
10,9804,10,100,1e-05,0.01,0.98,4892,4912
10,9904,10,100,1e-05,0.01,0.984,4947,4957
10,10004,10,100,1e-05,0.01,0.984,4994,5010
10,10104,10,100,1e-05,0.01,0.98,5038,5066
10,10204,10,100,1e-05,0.01,0.974,5091,5113
10,10304,10,100,1e-05,0.01,0.982,5137,5167
10,10404,10,100,1e-05,0.01,0.972,5185,5219
10,10504,10,100,1e-05,0.01,0.986,5234,5270
10,10604,10,100,1e-05,0.01,0.984,5278,5326
10,10704,10,100,1e-05,0.01,0.984,5332,5372
10,10804,10,100,1e-05,0.01,0.982,5384,5420
10,10904,10,100,1e-05,0.01,0.98,5443,5461
10,11004,10,100,1e-05,0.01,0.982,5495,5509
10,11104,10,100,1e-05,0.01,0.982,5547,5557
10,11204,10,100,1e-05,0.01,0.978,5599,5605
10,11304,10,100,1e-05,0.01,0.98,5646,5658
10,11404,10,100,1e-05,0.01,0.984,5693,5711
10,11504,10,100,1e-05,0.01,0.986,5747,5757
10,11604,10,100,1e-05,0.01,0.988,5790,5814
10,11704,10,100,1e-05,0.01,0.988,5839,5865
10,11804,10,100,1e-05,0.01,0.986,5892,5912
10,11904,10,100,1e-05,0.01,0.992,5939,5965
10,12004,10,100,1e-05,0.01,0.984,5983,6021
10,12104,10,100,1e-05,0.01,0.986,6036,6068
10,12204,10,100,1e-05,0.01,0.986,6089,6115
10,12304,10,100,1e-05,0.01,0.988,6131,6173
10,12404,10,100,1e-05,0.01,0.982,6183,6221
10,12504,10,100,1e-05,0.01,0.988,6230,6274
10,12604,10,100,1e-05,0.01,0.99,6284,6320
10,12704,10,100,1e-05,0.01,0.986,6337,6367
10,12804,10,100,1e-05,0.01,0.988,6388,6416
10,12904,10,100,1e-05,0.01,0.988,6437,6467
10,13004,10,100,1e-05,0.01,0.988,6488,6516
10,13104,10,100,1e-05,0.01,0.988,6533,6571
10,13204,10,100,1e-05,0.01,0.986,6580,6624
10,13304,10,100,1e-05,0.01,0.988,6620,6684
10,13404,10,100,1e-05,0.01,0.994,6661,6743
10,13504,10,100,1e-05,0.01,0.99,6722,6782
10,13604,10,100,1e-05,0.01,0.988,6768,6836
10,13704,10,100,1e-05,0.01,0.99,6822,6882
10,13804,10,100,1e-05,0.01,0.992,6873,6931
10,13904,10,100,1e-05,0.01,0.992,6919,6985
10,14004,10,100,1e-05,0.01,0.994,6979,7025
10,14104,10,100,1e-05,0.01,0.992,7029,7075
10,14204,10,100,1e-05,0.01,0.992,7088,7116
10,14304,10,100,1e-05,0.01,0.992,7134,7170
10,14404,10,100,1e-05,0.01,0.992,7186,7218
10,14504,10,100,1e-05,0.01,0.992,7243,7261
10,14604,10,100,1e-05,0.01,0.992,7291,7313
10,14704,10,100,1e-05,0.01,0.994,7342,7362
10,14804,10,100,1e-05,0.01,0.99,7399,7405
10,14904,10,100,1e-05,0.01,0.992,7448,7456
10,15004,10,100,1e-05,0.01,0.986,7498,7506
11,104,10,100,1e-05,0.01,0.486,53,51
11,204,10,100,1e-05,0.01,0.49,104,100
11,304,10,100,1e-05,0.01,0.5,161,143
11,404,10,100,1e-05,0.01,0.512,213,191
11,504,10,100,1e-05,0.01,0.51,265,239
11,604,10,100,1e-05,0.01,0.49,310,294
11,704,10,100,1e-05,0.01,0.48,364,340
11,804,10,100,1e-05,0.01,0.468,414,390
11,904,10,100,1e-05,0.01,0.492,468,436
11,1004,10,100,1e-05,0.01,0.496,523,481
11,1104,10,100,1e-05,0.01,0.492,572,532
11,1204,10,100,1e-05,0.01,0.468,623,581
11,1304,10,100,1e-05,0.01,0.496,677,627
11,1404,10,100,1e-05,0.01,0.49,725,679
11,1504,10,100,1e-05,0.01,0.49,787,717
11,1604,10,100,1e-05,0.01,0.492,839,765
11,1704,10,100,1e-05,0.01,0.472,891,813
11,1804,10,100,1e-05,0.01,0.518,949,855
11,1904,10,100,1e-05,0.01,0.518,994,910
11,2004,10,100,1e-05,0.01,0.56,1033,971
11,2104,10,100,1e-05,0.01,0.536,1088,1016
11,2204,10,100,1e-05,0.01,0.52,1140,1064
11,2304,10,100,1e-05,0.01,0.516,1193,1111
11,2404,10,100,1e-05,0.01,0.522,1241,1163
11,2504,10,100,1e-05,0.01,0.536,1293,1211
11,2604,10,100,1e-05,0.01,0.56,1339,1265
11,2704,10,100,1e-05,0.01,0.542,1395,1309
11,2804,10,100,1e-05,0.01,0.56,1445,1359
11,2904,10,100,1e-05,0.01,0.59,1503,1401
11,3004,10,100,1e-05,0.01,0.562,1555,1449
11,3104,10,100,1e-05,0.01,0.622,1605,1499
11,3204,10,100,1e-05,0.01,0.604,1656,1548
11,3304,10,100,1e-05,0.01,0.612,1706,1598
11,3404,10,100,1e-05,0.01,0.606,1752,1652
11,3504,10,100,1e-05,0.01,0.62,1796,1708
11,3604,10,100,1e-05,0.01,0.654,1856,1748
11,3704,10,100,1e-05,0.01,0.638,1903,1801
11,3804,10,100,1e-05,0.01,0.652,1951,1853
11,3904,10,100,1e-05,0.01,0.648,1999,1905
11,4004,10,100,1e-05,0.01,0.63,2051,1953
11,4104,10,100,1e-05,0.01,0.63,2098,2006
11,4204,10,100,1e-05,0.01,0.63,2153,2051
11,4304,10,100,1e-05,0.01,0.66,2208,2096
11,4404,10,100,1e-05,0.01,0.64,2265,2139
11,4504,10,100,1e-05,0.01,0.65,2318,2186
11,4604,10,100,1e-05,0.01,0.662,2361,2243
11,4704,10,100,1e-05,0.01,0.664,2416,2288
11,4804,10,100,1e-05,0.01,0.674,2467,2337
11,4904,10,100,1e-05,0.01,0.684,2528,2376
11,5004,10,100,1e-05,0.01,0.694,2587,2417
11,5104,10,100,1e-05,0.01,0.69,2639,2465
11,5204,10,100,1e-05,0.01,0.708,2695,2509
11,5304,10,100,1e-05,0.01,0.718,2742,2562
11,5404,10,100,1e-05,0.01,0.698,2794,2610
11,5504,10,100,1e-05,0.01,0.692,2851,2653
11,5604,10,100,1e-05,0.01,0.716,2902,2702
11,5704,10,100,1e-05,0.01,0.736,2950,2754
11,5804,10,100,1e-05,0.01,0.708,2996,2808
11,5904,10,100,1e-05,0.01,0.736,3047,2857
11,6004,10,100,1e-05,0.01,0.708,3099,2905
11,6104,10,100,1e-05,0.01,0.696,3150,2954
11,6204,10,100,1e-05,0.01,0.73,3199,3005
11,6304,10,100,1e-05,0.01,0.692,3253,3051
11,6404,10,100,1e-05,0.01,0.722,3305,3099
11,6504,10,100,1e-05,0.01,0.712,3354,3150
11,6604,10,100,1e-05,0.01,0.68,3415,3189
11,6704,10,100,1e-05,0.01,0.72,3462,3242
11,6804,10,100,1e-05,0.01,0.756,3499,3305
11,6904,10,100,1e-05,0.01,0.744,3551,3353
11,7004,10,100,1e-05,0.01,0.736,3596,3408
11,7104,10,100,1e-05,0.01,0.744,3644,3460
11,7204,10,100,1e-05,0.01,0.774,3696,3508
11,7304,10,100,1e-05,0.01,0.758,3748,3556
11,7404,10,100,1e-05,0.01,0.754,3796,3608
11,7504,10,100,1e-05,0.01,0.742,3843,3661
11,7604,10,100,1e-05,0.01,0.78,3889,3715
11,7704,10,100,1e-05,0.01,0.754,3939,3765
11,7804,10,100,1e-05,0.01,0.742,3996,3808
11,7904,10,100,1e-05,0.01,0.756,4045,3859
11,8004,10,100,1e-05,0.01,0.772,4093,3911
11,8104,10,100,1e-05,0.01,0.744,4152,3952
11,8204,10,100,1e-05,0.01,0.722,4205,3999
11,8304,10,100,1e-05,0.01,0.756,4254,4050
11,8404,10,100,1e-05,0.01,0.806,4301,4103
11,8504,10,100,1e-05,0.01,0.786,4352,4152
11,8604,10,100,1e-05,0.01,0.76,4411,4193
11,8704,10,100,1e-05,0.01,0.784,4455,4249
11,8804,10,100,1e-05,0.01,0.778,4498,4306
11,8904,10,100,1e-05,0.01,0.788,4541,4363
11,9004,10,100,1e-05,0.01,0.786,4589,4415
11,9104,10,100,1e-05,0.01,0.782,4636,4468
11,9204,10,100,1e-05,0.01,0.814,4691,4513
11,9304,10,100,1e-05,0.01,0.79,4748,4556
11,9404,10,100,1e-05,0.01,0.804,4794,4610
11,9504,10,100,1e-05,0.01,0.802,4839,4665
11,9604,10,100,1e-05,0.01,0.82,4884,4720
11,9704,10,100,1e-05,0.01,0.828,4939,4765
11,9804,10,100,1e-05,0.01,0.808,4988,4816
11,9904,10,100,1e-05,0.01,0.842,5031,4873
11,10004,10,100,1e-05,0.01,0.84,5084,4920
11,10104,10,100,1e-05,0.01,0.81,5125,4979
11,10204,10,100,1e-05,0.01,0.82,5173,5031
11,10304,10,100,1e-05,0.01,0.808,5224,5080
11,10404,10,100,1e-05,0.01,0.846,5272,5132
11,10504,10,100,1e-05,0.01,0.826,5316,5188
11,10604,10,100,1e-05,0.01,0.852,5370,5234
11,10704,10,100,1e-05,0.01,0.84,5422,5282
11,10804,10,100,1e-05,0.01,0.856,5472,5332
11,10904,10,100,1e-05,0.01,0.834,5522,5382
11,11004,10,100,1e-05,0.01,0.834,5579,5425
11,11104,10,100,1e-05,0.01,0.834,5631,5473
11,11204,10,100,1e-05,0.01,0.854,5682,5522
11,11304,10,100,1e-05,0.01,0.866,5721,5583
11,11404,10,100,1e-05,0.01,0.884,5766,5638
11,11504,10,100,1e-05,0.01,0.864,5815,5689
11,11604,10,100,1e-05,0.01,0.854,5855,5749
11,11704,10,100,1e-05,0.01,0.848,5906,5798
11,11804,10,100,1e-05,0.01,0.852,5956,5848
11,11904,10,100,1e-05,0.01,0.886,6008,5896
11,12004,10,100,1e-05,0.01,0.866,6051,5953
11,12104,10,100,1e-05,0.01,0.852,6100,6004
11,12204,10,100,1e-05,0.01,0.878,6146,6058
11,12304,10,100,1e-05,0.01,0.87,6193,6111
11,12404,10,100,1e-05,0.01,0.884,6239,6165
11,12504,10,100,1e-05,0.01,0.884,6289,6215
11,12604,10,100,1e-05,0.01,0.898,6339,6265
11,12704,10,100,1e-05,0.01,0.902,6389,6315
11,12804,10,100,1e-05,0.01,0.88,6434,6370
11,12904,10,100,1e-05,0.01,0.9,6480,6424
11,13004,10,100,1e-05,0.01,0.884,6532,6472
11,13104,10,100,1e-05,0.01,0.91,6582,6522
11,13204,10,100,1e-05,0.01,0.894,6631,6573
11,13304,10,100,1e-05,0.01,0.926,6676,6628
11,13404,10,100,1e-05,0.01,0.918,6729,6675
11,13504,10,100,1e-05,0.01,0.916,6778,6726
11,13604,10,100,1e-05,0.01,0.916,6827,6777
11,13704,10,100,1e-05,0.01,0.926,6874,6830
11,13804,10,100,1e-05,0.01,0.908,6917,6887
11,13904,10,100,1e-05,0.01,0.92,6962,6942
11,14004,10,100,1e-05,0.01,0.928,7018,6986
11,14104,10,100,1e-05,0.01,0.934,7065,7039
11,14204,10,100,1e-05,0.01,0.928,7107,7097
11,14304,10,100,1e-05,0.01,0.93,7159,7145
11,14404,10,100,1e-05,0.01,0.936,7216,7188
11,14504,10,100,1e-05,0.01,0.936,7269,7235
11,14604,10,100,1e-05,0.01,0.936,7311,7293
11,14704,10,100,1e-05,0.01,0.938,7356,7348
11,14804,10,100,1e-05,0.01,0.932,7403,7401
11,14904,10,100,1e-05,0.01,0.938,7453,7451
11,15004,10,100,1e-05,0.01,0.956,7509,7495
12,104,10,100,1e-05,0.01,0.522,55,49
12,204,10,100,1e-05,0.01,0.52,102,102
12,304,10,100,1e-05,0.01,0.492,153,151
12,404,10,100,1e-05,0.01,0.534,206,198
12,504,10,100,1e-05,0.01,0.554,258,246
12,604,10,100,1e-05,0.01,0.508,316,288
12,704,10,100,1e-05,0.01,0.508,363,341
12,804,10,100,1e-05,0.01,0.518,420,384
12,904,10,100,1e-05,0.01,0.498,477,427
12,1004,10,100,1e-05,0.01,0.526,530,474
12,1104,10,100,1e-05,0.01,0.488,579,525
12,1204,10,100,1e-05,0.01,0.522,626,578
12,1304,10,100,1e-05,0.01,0.566,669,635
12,1404,10,100,1e-05,0.01,0.586,724,680
12,1504,10,100,1e-05,0.01,0.548,775,729
12,1604,10,100,1e-05,0.01,0.558,820,784
12,1704,10,100,1e-05,0.01,0.578,873,831
12,1804,10,100,1e-05,0.01,0.57,918,886
12,1904,10,100,1e-05,0.01,0.552,971,933
12,2004,10,100,1e-05,0.01,0.578,1019,985
12,2104,10,100,1e-05,0.01,0.602,1063,1041
12,2204,10,100,1e-05,0.01,0.624,1114,1090
12,2304,10,100,1e-05,0.01,0.634,1172,1132
12,2404,10,100,1e-05,0.01,0.694,1218,1186
12,2504,10,100,1e-05,0.01,0.676,1265,1239
12,2604,10,100,1e-05,0.01,0.702,1314,1290
12,2704,10,100,1e-05,0.01,0.726,1363,1341
12,2804,10,100,1e-05,0.01,0.76,1409,1395
12,2904,10,100,1e-05,0.01,0.746,1458,1446
12,3004,10,100,1e-05,0.01,0.756,1503,1501
12,3104,10,100,1e-05,0.01,0.764,1548,1556
12,3204,10,100,1e-05,0.01,0.764,1602,1602
12,3304,10,100,1e-05,0.01,0.796,1649,1655
12,3404,10,100,1e-05,0.01,0.792,1697,1707
12,3504,10,100,1e-05,0.01,0.786,1744,1760
12,3604,10,100,1e-05,0.01,0.848,1792,1812
12,3704,10,100,1e-05,0.01,0.858,1836,1868
12,3804,10,100,1e-05,0.01,0.822,1889,1915
12,3904,10,100,1e-05,0.01,0.83,1936,1968
12,4004,10,100,1e-05,0.01,0.85,1982,2022
12,4104,10,100,1e-05,0.01,0.862,2027,2077
12,4204,10,100,1e-05,0.01,0.882,2074,2130
12,4304,10,100,1e-05,0.01,0.872,2118,2186
12,4404,10,100,1e-05,0.01,0.888,2175,2229
12,4504,10,100,1e-05,0.01,0.892,2224,2280
12,4604,10,100,1e-05,0.01,0.882,2279,2325
12,4704,10,100,1e-05,0.01,0.87,2330,2374
12,4804,10,100,1e-05,0.01,0.89,2376,2428
12,4904,10,100,1e-05,0.01,0.87,2425,2479
12,5004,10,100,1e-05,0.01,0.902,2474,2530
12,5104,10,100,1e-05,0.01,0.922,2525,2579
12,5204,10,100,1e-05,0.01,0.914,2576,2628
12,5304,10,100,1e-05,0.01,0.914,2618,2686
12,5404,10,100,1e-05,0.01,0.922,2669,2735
12,5504,10,100,1e-05,0.01,0.916,2720,2784
12,5604,10,100,1e-05,0.01,0.908,2766,2838
12,5704,10,100,1e-05,0.01,0.924,2821,2883
12,5804,10,100,1e-05,0.01,0.92,2864,2940
12,5904,10,100,1e-05,0.01,0.916,2917,2987
12,6004,10,100,1e-05,0.01,0.91,2963,3041
12,6104,10,100,1e-05,0.01,0.918,3017,3087
12,6204,10,100,1e-05,0.01,0.93,3074,3130
12,6304,10,100,1e-05,0.01,0.916,3133,3171
12,6404,10,100,1e-05,0.01,0.91,3182,3222
12,6504,10,100,1e-05,0.01,0.926,3236,3268
12,6604,10,100,1e-05,0.01,0.936,3297,3307
12,6704,10,100,1e-05,0.01,0.93,3346,3358
12,6804,10,100,1e-05,0.01,0.93,3391,3413
12,6904,10,100,1e-05,0.01,0.938,3439,3465
12,7004,10,100,1e-05,0.01,0.942,3485,3519
12,7104,10,100,1e-05,0.01,0.944,3537,3567
12,7204,10,100,1e-05,0.01,0.92,3593,3611
12,7304,10,100,1e-05,0.01,0.936,3647,3657
12,7404,10,100,1e-05,0.01,0.938,3694,3710
12,7504,10,100,1e-05,0.01,0.938,3751,3753
12,7604,10,100,1e-05,0.01,0.94,3804,3800
12,7704,10,100,1e-05,0.01,0.932,3849,3855
12,7804,10,100,1e-05,0.01,0.946,3901,3903
12,7904,10,100,1e-05,0.01,0.95,3955,3949
12,8004,10,100,1e-05,0.01,0.954,4003,4001
12,8104,10,100,1e-05,0.01,0.934,4063,4041
12,8204,10,100,1e-05,0.01,0.95,4120,4084
12,8304,10,100,1e-05,0.01,0.938,4163,4141
12,8404,10,100,1e-05,0.01,0.952,4212,4192
12,8504,10,100,1e-05,0.01,0.956,4256,4248
12,8604,10,100,1e-05,0.01,0.932,4309,4295
12,8704,10,100,1e-05,0.01,0.966,4364,4340
12,8804,10,100,1e-05,0.01,0.948,4413,4391
12,8904,10,100,1e-05,0.01,0.952,4462,4442
12,9004,10,100,1e-05,0.01,0.952,4511,4493
12,9104,10,100,1e-05,0.01,0.97,4558,4546
12,9204,10,100,1e-05,0.01,0.966,4606,4598
12,9304,10,100,1e-05,0.01,0.97,4655,4649
12,9404,10,100,1e-05,0.01,0.966,4711,4693
12,9504,10,100,1e-05,0.01,0.944,4764,4740
12,9604,10,100,1e-05,0.01,0.952,4820,4784
12,9704,10,100,1e-05,0.01,0.96,4866,4838
12,9804,10,100,1e-05,0.01,0.968,4909,4895
12,9904,10,100,1e-05,0.01,0.958,4963,4941
12,10004,10,100,1e-05,0.01,0.968,5007,4997
12,10104,10,100,1e-05,0.01,0.968,5062,5042
12,10204,10,100,1e-05,0.01,0.96,5104,5100
12,10304,10,100,1e-05,0.01,0.96,5160,5144
12,10404,10,100,1e-05,0.01,0.958,5211,5193
12,10504,10,100,1e-05,0.01,0.952,5253,5251
12,10604,10,100,1e-05,0.01,0.966,5304,5300
12,10704,10,100,1e-05,0.01,0.962,5357,5347
12,10804,10,100,1e-05,0.01,0.968,5409,5395
12,10904,10,100,1e-05,0.01,0.966,5455,5449
12,11004,10,100,1e-05,0.01,0.968,5509,5495
12,11104,10,100,1e-05,0.01,0.972,5552,5552
12,11204,10,100,1e-05,0.01,0.978,5603,5601
12,11304,10,100,1e-05,0.01,0.964,5653,5651
12,11404,10,100,1e-05,0.01,0.95,5694,5710
12,11504,10,100,1e-05,0.01,0.968,5750,5754
12,11604,10,100,1e-05,0.01,0.968,5795,5809
12,11704,10,100,1e-05,0.01,0.974,5843,5861
12,11804,10,100,1e-05,0.01,0.97,5896,5908
12,11904,10,100,1e-05,0.01,0.962,5940,5964
12,12004,10,100,1e-05,0.01,0.962,5979,6025
12,12104,10,100,1e-05,0.01,0.976,6029,6075
12,12204,10,100,1e-05,0.01,0.968,6071,6133
12,12304,10,100,1e-05,0.01,0.982,6115,6189
12,12404,10,100,1e-05,0.01,0.98,6169,6235
12,12504,10,100,1e-05,0.01,0.976,6214,6290
12,12604,10,100,1e-05,0.01,0.968,6260,6344
12,12704,10,100,1e-05,0.01,0.958,6306,6398
12,12804,10,100,1e-05,0.01,0.96,6357,6447
12,12904,10,100,1e-05,0.01,0.974,6407,6497
12,13004,10,100,1e-05,0.01,0.966,6459,6545
12,13104,10,100,1e-05,0.01,0.976,6508,6596
12,13204,10,100,1e-05,0.01,0.984,6557,6647
12,13304,10,100,1e-05,0.01,0.978,6610,6694
12,13404,10,100,1e-05,0.01,0.962,6670,6734
12,13504,10,100,1e-05,0.01,0.97,6716,6788
12,13604,10,100,1e-05,0.01,0.98,6769,6835
12,13704,10,100,1e-05,0.01,0.976,6825,6879
12,13804,10,100,1e-05,0.01,0.98,6875,6929
12,13904,10,100,1e-05,0.01,0.978,6923,6981
12,14004,10,100,1e-05,0.01,0.978,6968,7036
12,14104,10,100,1e-05,0.01,0.98,7015,7089
12,14204,10,100,1e-05,0.01,0.988,7067,7137
12,14304,10,100,1e-05,0.01,0.984,7130,7174
12,14404,10,100,1e-05,0.01,0.984,7176,7228
12,14504,10,100,1e-05,0.01,0.984,7224,7280
12,14604,10,100,1e-05,0.01,0.966,7277,7327
12,14704,10,100,1e-05,0.01,0.99,7328,7376
12,14804,10,100,1e-05,0.01,0.982,7385,7419
12,14904,10,100,1e-05,0.01,0.98,7437,7467
12,15004,10,100,1e-05,0.01,0.986,7491,7513
13,104,10,100,1e-05,0.01,0.482,51,53
13,204,10,100,1e-05,0.01,0.512,105,99
13,304,10,100,1e-05,0.01,0.51,162,142
13,404,10,100,1e-05,0.01,0.498,206,198
13,504,10,100,1e-05,0.01,0.482,264,240
13,604,10,100,1e-05,0.01,0.5,314,290
13,704,10,100,1e-05,0.01,0.506,364,340
13,804,10,100,1e-05,0.01,0.486,408,396
13,904,10,100,1e-05,0.01,0.488,460,444
13,1004,10,100,1e-05,0.01,0.524,513,491
13,1104,10,100,1e-05,0.01,0.51,568,536
13,1204,10,100,1e-05,0.01,0.512,622,582
13,1304,10,100,1e-05,0.01,0.516,668,636
13,1404,10,100,1e-05,0.01,0.522,708,696
13,1504,10,100,1e-05,0.01,0.53,760,744
13,1604,10,100,1e-05,0.01,0.512,813,791
13,1704,10,100,1e-05,0.01,0.512,860,844
13,1804,10,100,1e-05,0.01,0.504,908,896
13,1904,10,100,1e-05,0.01,0.57,959,945
13,2004,10,100,1e-05,0.01,0.542,1013,991
13,2104,10,100,1e-05,0.01,0.558,1064,1040
13,2204,10,100,1e-05,0.01,0.586,1124,1080
13,2304,10,100,1e-05,0.01,0.626,1173,1131
13,2404,10,100,1e-05,0.01,0.604,1219,1185
13,2504,10,100,1e-05,0.01,0.65,1274,1230
13,2604,10,100,1e-05,0.01,0.614,1316,1288
13,2704,10,100,1e-05,0.01,0.61,1366,1338
13,2804,10,100,1e-05,0.01,0.616,1413,1391
13,2904,10,100,1e-05,0.01,0.614,1460,1444
13,3004,10,100,1e-05,0.01,0.676,1516,1488
13,3104,10,100,1e-05,0.01,0.706,1560,1544
13,3204,10,100,1e-05,0.01,0.718,1615,1589
13,3304,10,100,1e-05,0.01,0.716,1670,1634
13,3404,10,100,1e-05,0.01,0.682,1723,1681
13,3504,10,100,1e-05,0.01,0.644,1783,1721
13,3604,10,100,1e-05,0.01,0.686,1838,1766
13,3704,10,100,1e-05,0.01,0.716,1882,1822
13,3804,10,100,1e-05,0.01,0.71,1935,1869
13,3904,10,100,1e-05,0.01,0.724,1985,1919
13,4004,10,100,1e-05,0.01,0.724,2033,1971
13,4104,10,100,1e-05,0.01,0.716,2085,2019
13,4204,10,100,1e-05,0.01,0.742,2142,2062
13,4304,10,100,1e-05,0.01,0.73,2189,2115
13,4404,10,100,1e-05,0.01,0.756,2238,2166
13,4504,10,100,1e-05,0.01,0.756,2286,2218
13,4604,10,100,1e-05,0.01,0.75,2332,2272
13,4704,10,100,1e-05,0.01,0.774,2388,2316
13,4804,10,100,1e-05,0.01,0.772,2436,2368
13,4904,10,100,1e-05,0.01,0.758,2482,2422
13,5004,10,100,1e-05,0.01,0.752,2524,2480
13,5104,10,100,1e-05,0.01,0.78,2574,2530
13,5204,10,100,1e-05,0.01,0.758,2626,2578
13,5304,10,100,1e-05,0.01,0.78,2676,2628
13,5404,10,100,1e-05,0.01,0.77,2725,2679
13,5504,10,100,1e-05,0.01,0.77,2775,2729
13,5604,10,100,1e-05,0.01,0.758,2822,2782
13,5704,10,100,1e-05,0.01,0.778,2867,2837
13,5804,10,100,1e-05,0.01,0.774,2918,2886
13,5904,10,100,1e-05,0.01,0.798,2970,2934
13,6004,10,100,1e-05,0.01,0.798,3017,2987
13,6104,10,100,1e-05,0.01,0.798,3070,3034
13,6204,10,100,1e-05,0.01,0.8,3116,3088
13,6304,10,100,1e-05,0.01,0.776,3169,3135
13,6404,10,100,1e-05,0.01,0.798,3218,3186
13,6504,10,100,1e-05,0.01,0.784,3264,3240
13,6604,10,100,1e-05,0.01,0.802,3309,3295
13,6704,10,100,1e-05,0.01,0.806,3354,3350
13,6804,10,100,1e-05,0.01,0.83,3403,3401
13,6904,10,100,1e-05,0.01,0.818,3456,3448
13,7004,10,100,1e-05,0.01,0.806,3508,3496
13,7104,10,100,1e-05,0.01,0.814,3553,3551
13,7204,10,100,1e-05,0.01,0.828,3607,3597
13,7304,10,100,1e-05,0.01,0.798,3662,3642
13,7404,10,100,1e-05,0.01,0.828,3717,3687
13,7504,10,100,1e-05,0.01,0.784,3766,3738
13,7604,10,100,1e-05,0.01,0.816,3818,3786
13,7704,10,100,1e-05,0.01,0.824,3867,3837
13,7804,10,100,1e-05,0.01,0.796,3922,3882
13,7904,10,100,1e-05,0.01,0.834,3978,3926
13,8004,10,100,1e-05,0.01,0.83,4027,3977
13,8104,10,100,1e-05,0.01,0.83,4070,4034
13,8204,10,100,1e-05,0.01,0.822,4123,4081
13,8304,10,100,1e-05,0.01,0.844,4177,4127
13,8404,10,100,1e-05,0.01,0.844,4236,4168
13,8504,10,100,1e-05,0.01,0.85,4293,4211
13,8604,10,100,1e-05,0.01,0.846,4336,4268
13,8704,10,100,1e-05,0.01,0.844,4382,4322
13,8804,10,100,1e-05,0.01,0.826,4425,4379
13,8904,10,100,1e-05,0.01,0.816,4468,4436
13,9004,10,100,1e-05,0.01,0.828,4519,4485
13,9104,10,100,1e-05,0.01,0.844,4564,4540
13,9204,10,100,1e-05,0.01,0.834,4615,4589
13,9304,10,100,1e-05,0.01,0.848,4666,4638
13,9404,10,100,1e-05,0.01,0.838,4713,4691
13,9504,10,100,1e-05,0.01,0.832,4757,4747
13,9604,10,100,1e-05,0.01,0.858,4802,4802
13,9704,10,100,1e-05,0.01,0.846,4857,4847
13,9804,10,100,1e-05,0.01,0.868,4913,4891
13,9904,10,100,1e-05,0.01,0.848,4962,4942
13,10004,10,100,1e-05,0.01,0.836,5015,4989
13,10104,10,100,1e-05,0.01,0.83,5062,5042
13,10204,10,100,1e-05,0.01,0.84,5107,5097
13,10304,10,100,1e-05,0.01,0.842,5156,5148
13,10404,10,100,1e-05,0.01,0.862,5201,5203
13,10504,10,100,1e-05,0.01,0.848,5242,5262
13,10604,10,100,1e-05,0.01,0.868,5293,5311
13,10704,10,100,1e-05,0.01,0.85,5347,5357
13,10804,10,100,1e-05,0.01,0.834,5387,5417
13,10904,10,100,1e-05,0.01,0.854,5431,5473
13,11004,10,100,1e-05,0.01,0.862,5476,5528
13,11104,10,100,1e-05,0.01,0.872,5519,5585
13,11204,10,100,1e-05,0.01,0.858,5569,5635
13,11304,10,100,1e-05,0.01,0.858,5621,5683
13,11404,10,100,1e-05,0.01,0.876,5668,5736
13,11504,10,100,1e-05,0.01,0.864,5714,5790
13,11604,10,100,1e-05,0.01,0.862,5770,5834
13,11704,10,100,1e-05,0.01,0.858,5819,5885
13,11804,10,100,1e-05,0.01,0.878,5872,5932
13,11904,10,100,1e-05,0.01,0.89,5926,5978
13,12004,10,100,1e-05,0.01,0.882,5970,6034
13,12104,10,100,1e-05,0.01,0.878,6025,6079
13,12204,10,100,1e-05,0.01,0.88,6074,6130
13,12304,10,100,1e-05,0.01,0.862,6119,6185
13,12404,10,100,1e-05,0.01,0.886,6163,6241
13,12504,10,100,1e-05,0.01,0.892,6217,6287
13,12604,10,100,1e-05,0.01,0.898,6260,6344
13,12704,10,100,1e-05,0.01,0.9,6318,6386
13,12804,10,100,1e-05,0.01,0.89,6358,6446
13,12904,10,100,1e-05,0.01,0.9,6410,6494
13,13004,10,100,1e-05,0.01,0.9,6467,6537
13,13104,10,100,1e-05,0.01,0.884,6519,6585
13,13204,10,100,1e-05,0.01,0.902,6563,6641
13,13304,10,100,1e-05,0.01,0.88,6615,6689
13,13404,10,100,1e-05,0.01,0.888,6667,6737
13,13504,10,100,1e-05,0.01,0.896,6718,6786
13,13604,10,100,1e-05,0.01,0.9,6769,6835
13,13704,10,100,1e-05,0.01,0.91,6822,6882
13,13804,10,100,1e-05,0.01,0.844,6872,6932
13,13904,10,100,1e-05,0.01,0.882,6925,6979
13,14004,10,100,1e-05,0.01,0.906,6985,7019
13,14104,10,100,1e-05,0.01,0.918,7037,7067
13,14204,10,100,1e-05,0.01,0.914,7086,7118
13,14304,10,100,1e-05,0.01,0.906,7137,7167
13,14404,10,100,1e-05,0.01,0.912,7185,7219
13,14504,10,100,1e-05,0.01,0.91,7240,7264
13,14604,10,100,1e-05,0.01,0.912,7293,7311
13,14704,10,100,1e-05,0.01,0.91,7340,7364
13,14804,10,100,1e-05,0.01,0.904,7391,7413
13,14904,10,100,1e-05,0.01,0.888,7445,7459
13,15004,10,100,1e-05,0.01,0.926,7493,7511
14,104,10,100,1e-05,0.01,0.52,43,61
14,204,10,100,1e-05,0.01,0.504,97,107
14,304,10,100,1e-05,0.01,0.466,142,162
14,404,10,100,1e-05,0.01,0.514,185,219
14,504,10,100,1e-05,0.01,0.524,242,262
14,604,10,100,1e-05,0.01,0.52,294,310
14,704,10,100,1e-05,0.01,0.518,335,369
14,804,10,100,1e-05,0.01,0.498,381,423
14,904,10,100,1e-05,0.01,0.526,434,470
14,1004,10,100,1e-05,0.01,0.518,477,527
14,1104,10,100,1e-05,0.01,0.508,523,581
14,1204,10,100,1e-05,0.01,0.506,566,638
14,1304,10,100,1e-05,0.01,0.494,616,688
14,1404,10,100,1e-05,0.01,0.502,667,737
14,1504,10,100,1e-05,0.01,0.492,726,778
14,1604,10,100,1e-05,0.01,0.514,776,828
14,1704,10,100,1e-05,0.01,0.524,823,881
14,1804,10,100,1e-05,0.01,0.482,880,924
14,1904,10,100,1e-05,0.01,0.542,923,981
14,2004,10,100,1e-05,0.01,0.55,982,1022
14,2104,10,100,1e-05,0.01,0.528,1034,1070
14,2204,10,100,1e-05,0.01,0.52,1088,1116
14,2304,10,100,1e-05,0.01,0.548,1136,1168
14,2404,10,100,1e-05,0.01,0.558,1191,1213
14,2504,10,100,1e-05,0.01,0.592,1240,1264
14,2604,10,100,1e-05,0.01,0.582,1298,1306
14,2704,10,100,1e-05,0.01,0.596,1354,1350
14,2804,10,100,1e-05,0.01,0.612,1410,1394
14,2904,10,100,1e-05,0.01,0.656,1454,1450
14,3004,10,100,1e-05,0.01,0.67,1498,1506
14,3104,10,100,1e-05,0.01,0.622,1557,1547
14,3204,10,100,1e-05,0.01,0.672,1606,1598
14,3304,10,100,1e-05,0.01,0.688,1646,1658
14,3404,10,100,1e-05,0.01,0.69,1690,1714
14,3504,10,100,1e-05,0.01,0.728,1733,1771
14,3604,10,100,1e-05,0.01,0.736,1777,1827
14,3704,10,100,1e-05,0.01,0.738,1821,1883
14,3804,10,100,1e-05,0.01,0.75,1877,1927
14,3904,10,100,1e-05,0.01,0.77,1936,1968
14,4004,10,100,1e-05,0.01,0.766,1995,2009
14,4104,10,100,1e-05,0.01,0.762,2049,2055
14,4204,10,100,1e-05,0.01,0.79,2105,2099
14,4304,10,100,1e-05,0.01,0.798,2146,2158
14,4404,10,100,1e-05,0.01,0.782,2193,2211
14,4504,10,100,1e-05,0.01,0.776,2240,2264
14,4604,10,100,1e-05,0.01,0.798,2286,2318
14,4704,10,100,1e-05,0.01,0.806,2334,2370
14,4804,10,100,1e-05,0.01,0.8,2385,2419
14,4904,10,100,1e-05,0.01,0.822,2440,2464
14,5004,10,100,1e-05,0.01,0.836,2498,2506
14,5104,10,100,1e-05,0.01,0.836,2541,2563
14,5204,10,100,1e-05,0.01,0.81,2581,2623
14,5304,10,100,1e-05,0.01,0.81,2639,2665
14,5404,10,100,1e-05,0.01,0.838,2687,2717
14,5504,10,100,1e-05,0.01,0.824,2735,2769
14,5604,10,100,1e-05,0.01,0.85,2788,2816
14,5704,10,100,1e-05,0.01,0.848,2838,2866
14,5804,10,100,1e-05,0.01,0.84,2892,2912
14,5904,10,100,1e-05,0.01,0.822,2942,2962
14,6004,10,100,1e-05,0.01,0.832,2990,3014
14,6104,10,100,1e-05,0.01,0.844,3036,3068
14,6204,10,100,1e-05,0.01,0.874,3095,3109
14,6304,10,100,1e-05,0.01,0.85,3141,3163
14,6404,10,100,1e-05,0.01,0.862,3184,3220
14,6504,10,100,1e-05,0.01,0.862,3229,3275
14,6604,10,100,1e-05,0.01,0.868,3278,3326
14,6704,10,100,1e-05,0.01,0.866,3332,3372
14,6804,10,100,1e-05,0.01,0.872,3371,3433
14,6904,10,100,1e-05,0.01,0.866,3417,3487
14,7004,10,100,1e-05,0.01,0.868,3468,3536
14,7104,10,100,1e-05,0.01,0.864,3515,3589
14,7204,10,100,1e-05,0.01,0.858,3561,3643
14,7304,10,100,1e-05,0.01,0.868,3611,3693
14,7404,10,100,1e-05,0.01,0.878,3665,3739
14,7504,10,100,1e-05,0.01,0.868,3707,3797
14,7604,10,100,1e-05,0.01,0.864,3753,3851
14,7704,10,100,1e-05,0.01,0.842,3794,3910
14,7804,10,100,1e-05,0.01,0.872,3841,3963
14,7904,10,100,1e-05,0.01,0.866,3897,4007
14,8004,10,100,1e-05,0.01,0.868,3948,4056
14,8104,10,100,1e-05,0.01,0.88,3999,4105
14,8204,10,100,1e-05,0.01,0.87,4048,4156
14,8304,10,100,1e-05,0.01,0.852,4092,4212
14,8404,10,100,1e-05,0.01,0.852,4144,4260
14,8504,10,100,1e-05,0.01,0.868,4186,4318
14,8604,10,100,1e-05,0.01,0.88,4234,4370
14,8704,10,100,1e-05,0.01,0.89,4282,4422
14,8804,10,100,1e-05,0.01,0.872,4329,4475
14,8904,10,100,1e-05,0.01,0.862,4378,4526
14,9004,10,100,1e-05,0.01,0.878,4423,4581
14,9104,10,100,1e-05,0.01,0.894,4476,4628
14,9204,10,100,1e-05,0.01,0.876,4534,4670
14,9304,10,100,1e-05,0.01,0.9,4592,4712
14,9404,10,100,1e-05,0.01,0.902,4649,4755
14,9504,10,100,1e-05,0.01,0.898,4692,4812
14,9604,10,100,1e-05,0.01,0.898,4733,4871
14,9704,10,100,1e-05,0.01,0.888,4780,4924
14,9804,10,100,1e-05,0.01,0.894,4842,4962
14,9904,10,100,1e-05,0.01,0.912,4896,5008
14,10004,10,100,1e-05,0.01,0.884,4947,5057
14,10104,10,100,1e-05,0.01,0.898,5008,5096
14,10204,10,100,1e-05,0.01,0.896,5060,5144
14,10304,10,100,1e-05,0.01,0.904,5119,5185
14,10404,10,100,1e-05,0.01,0.902,5169,5235
14,10504,10,100,1e-05,0.01,0.894,5215,5289
14,10604,10,100,1e-05,0.01,0.9,5258,5346
14,10704,10,100,1e-05,0.01,0.888,5318,5386
14,10804,10,100,1e-05,0.01,0.892,5371,5433
14,10904,10,100,1e-05,0.01,0.908,5422,5482
14,11004,10,100,1e-05,0.01,0.872,5471,5533
14,11104,10,100,1e-05,0.01,0.894,5528,5576
14,11204,10,100,1e-05,0.01,0.88,5579,5625
14,11304,10,100,1e-05,0.01,0.906,5635,5669
14,11404,10,100,1e-05,0.01,0.9,5684,5720
14,11504,10,100,1e-05,0.01,0.906,5736,5768
14,11604,10,100,1e-05,0.01,0.904,5778,5826
14,11704,10,100,1e-05,0.01,0.918,5838,5866
14,11804,10,100,1e-05,0.01,0.902,5887,5917
14,11904,10,100,1e-05,0.01,0.882,5942,5962
14,12004,10,100,1e-05,0.01,0.906,5994,6010
14,12104,10,100,1e-05,0.01,0.914,6050,6054
14,12204,10,100,1e-05,0.01,0.898,6097,6107
14,12304,10,100,1e-05,0.01,0.914,6148,6156
14,12404,10,100,1e-05,0.01,0.894,6189,6215
14,12504,10,100,1e-05,0.01,0.928,6252,6252
14,12604,10,100,1e-05,0.01,0.894,6309,6295
14,12704,10,100,1e-05,0.01,0.908,6350,6354
14,12804,10,100,1e-05,0.01,0.914,6395,6409
14,12904,10,100,1e-05,0.01,0.912,6454,6450
14,13004,10,100,1e-05,0.01,0.924,6510,6494
14,13104,10,100,1e-05,0.01,0.934,6556,6548
14,13204,10,100,1e-05,0.01,0.918,6609,6595
14,13304,10,100,1e-05,0.01,0.922,6659,6645
14,13404,10,100,1e-05,0.01,0.93,6716,6688
14,13504,10,100,1e-05,0.01,0.916,6768,6736
14,13604,10,100,1e-05,0.01,0.9,6831,6773
14,13704,10,100,1e-05,0.01,0.908,6871,6833
14,13804,10,100,1e-05,0.01,0.926,6922,6882
14,13904,10,100,1e-05,0.01,0.922,6974,6930
14,14004,10,100,1e-05,0.01,0.914,7021,6983
14,14104,10,100,1e-05,0.01,0.92,7071,7033
14,14204,10,100,1e-05,0.01,0.902,7129,7075
14,14304,10,100,1e-05,0.01,0.922,7176,7128
14,14404,10,100,1e-05,0.01,0.938,7223,7181
14,14504,10,100,1e-05,0.01,0.92,7266,7238
14,14604,10,100,1e-05,0.01,0.932,7313,7291
14,14704,10,100,1e-05,0.01,0.926,7358,7346
14,14804,10,100,1e-05,0.01,0.92,7415,7389
14,14904,10,100,1e-05,0.01,0.926,7466,7438
14,15004,10,100,1e-05,0.01,0.92,7512,7492
15,104,10,100,1e-05,0.01,0.488,49,55
15,204,10,100,1e-05,0.01,0.54,100,104
15,304,10,100,1e-05,0.01,0.478,147,157
15,404,10,100,1e-05,0.01,0.466,185,219
15,504,10,100,1e-05,0.01,0.51,245,259
15,604,10,100,1e-05,0.01,0.518,300,304
15,704,10,100,1e-05,0.01,0.506,350,354
15,804,10,100,1e-05,0.01,0.498,400,404
15,904,10,100,1e-05,0.01,0.492,455,449
15,1004,10,100,1e-05,0.01,0.488,504,500
15,1104,10,100,1e-05,0.01,0.512,549,555
15,1204,10,100,1e-05,0.01,0.49,599,605
15,1304,10,100,1e-05,0.01,0.536,652,652
15,1404,10,100,1e-05,0.01,0.488,703,701
15,1504,10,100,1e-05,0.01,0.538,760,744
15,1604,10,100,1e-05,0.01,0.492,807,797
15,1704,10,100,1e-05,0.01,0.544,858,846
15,1804,10,100,1e-05,0.01,0.528,912,892
15,1904,10,100,1e-05,0.01,0.53,971,933
15,2004,10,100,1e-05,0.01,0.552,1025,979
15,2104,10,100,1e-05,0.01,0.524,1076,1028
15,2204,10,100,1e-05,0.01,0.52,1121,1083
15,2304,10,100,1e-05,0.01,0.532,1175,1129
15,2404,10,100,1e-05,0.01,0.586,1225,1179
15,2504,10,100,1e-05,0.01,0.584,1268,1236
15,2604,10,100,1e-05,0.01,0.598,1328,1276
15,2704,10,100,1e-05,0.01,0.6,1375,1329
15,2804,10,100,1e-05,0.01,0.65,1427,1377
15,2904,10,100,1e-05,0.01,0.618,1481,1423
15,3004,10,100,1e-05,0.01,0.6,1529,1475
15,3104,10,100,1e-05,0.01,0.616,1588,1516
15,3204,10,100,1e-05,0.01,0.628,1644,1560
15,3304,10,100,1e-05,0.01,0.646,1691,1613
15,3404,10,100,1e-05,0.01,0.648,1737,1667
15,3504,10,100,1e-05,0.01,0.654,1784,1720
15,3604,10,100,1e-05,0.01,0.622,1830,1774
15,3704,10,100,1e-05,0.01,0.672,1878,1826
15,3804,10,100,1e-05,0.01,0.682,1928,1876
15,3904,10,100,1e-05,0.01,0.718,1981,1923
15,4004,10,100,1e-05,0.01,0.69,2021,1983
15,4104,10,100,1e-05,0.01,0.672,2071,2033
15,4204,10,100,1e-05,0.01,0.698,2117,2087
15,4304,10,100,1e-05,0.01,0.674,2166,2138
15,4404,10,100,1e-05,0.01,0.706,2212,2192
15,4504,10,100,1e-05,0.01,0.718,2263,2241
15,4604,10,100,1e-05,0.01,0.736,2320,2284
15,4704,10,100,1e-05,0.01,0.718,2371,2333
15,4804,10,100,1e-05,0.01,0.724,2416,2388
15,4904,10,100,1e-05,0.01,0.734,2463,2441
15,5004,10,100,1e-05,0.01,0.748,2511,2493
15,5104,10,100,1e-05,0.01,0.75,2560,2544
15,5204,10,100,1e-05,0.01,0.742,2617,2587
15,5304,10,100,1e-05,0.01,0.768,2670,2634
15,5404,10,100,1e-05,0.01,0.756,2722,2682
15,5504,10,100,1e-05,0.01,0.772,2762,2742
15,5604,10,100,1e-05,0.01,0.79,2810,2794
15,5704,10,100,1e-05,0.01,0.734,2860,2844
15,5804,10,100,1e-05,0.01,0.768,2913,2891
15,5904,10,100,1e-05,0.01,0.784,2961,2943
15,6004,10,100,1e-05,0.01,0.75,3014,2990
15,6104,10,100,1e-05,0.01,0.788,3061,3043
15,6204,10,100,1e-05,0.01,0.758,3117,3087
15,6304,10,100,1e-05,0.01,0.804,3168,3136
15,6404,10,100,1e-05,0.01,0.746,3225,3179
15,6504,10,100,1e-05,0.01,0.804,3272,3232
15,6604,10,100,1e-05,0.01,0.784,3323,3281
15,6704,10,100,1e-05,0.01,0.798,3368,3336
15,6804,10,100,1e-05,0.01,0.794,3415,3389
15,6904,10,100,1e-05,0.01,0.798,3464,3440
15,7004,10,100,1e-05,0.01,0.766,3512,3492
15,7104,10,100,1e-05,0.01,0.832,3559,3545
15,7204,10,100,1e-05,0.01,0.792,3604,3600
15,7304,10,100,1e-05,0.01,0.828,3652,3652
15,7404,10,100,1e-05,0.01,0.832,3707,3697
15,7504,10,100,1e-05,0.01,0.822,3755,3749
15,7604,10,100,1e-05,0.01,0.81,3803,3801
15,7704,10,100,1e-05,0.01,0.808,3854,3850
15,7804,10,100,1e-05,0.01,0.806,3903,3901
15,7904,10,100,1e-05,0.01,0.842,3952,3952
15,8004,10,100,1e-05,0.01,0.824,4003,4001
15,8104,10,100,1e-05,0.01,0.844,4051,4053
15,8204,10,100,1e-05,0.01,0.824,4106,4098
15,8304,10,100,1e-05,0.01,0.844,4153,4151
15,8404,10,100,1e-05,0.01,0.834,4207,4197
15,8504,10,100,1e-05,0.01,0.862,4257,4247
15,8604,10,100,1e-05,0.01,0.85,4309,4295
15,8704,10,100,1e-05,0.01,0.816,4354,4350
15,8804,10,100,1e-05,0.01,0.844,4395,4409
15,8904,10,100,1e-05,0.01,0.806,4447,4457
15,9004,10,100,1e-05,0.01,0.83,4501,4503
15,9104,10,100,1e-05,0.01,0.836,4558,4546
15,9204,10,100,1e-05,0.01,0.822,4607,4597
15,9304,10,100,1e-05,0.01,0.838,4652,4652
15,9404,10,100,1e-05,0.01,0.832,4698,4706
15,9504,10,100,1e-05,0.01,0.822,4744,4760
15,9604,10,100,1e-05,0.01,0.848,4800,4804
15,9704,10,100,1e-05,0.01,0.864,4852,4852
15,9804,10,100,1e-05,0.01,0.848,4896,4908
15,9904,10,100,1e-05,0.01,0.838,4941,4963
15,10004,10,100,1e-05,0.01,0.84,4994,5010
15,10104,10,100,1e-05,0.01,0.836,5045,5059
15,10204,10,100,1e-05,0.01,0.862,5098,5106
15,10304,10,100,1e-05,0.01,0.87,5149,5155
15,10404,10,100,1e-05,0.01,0.848,5202,5202
15,10504,10,100,1e-05,0.01,0.852,5257,5247
15,10604,10,100,1e-05,0.01,0.862,5318,5286
15,10704,10,100,1e-05,0.01,0.862,5363,5341
15,10804,10,100,1e-05,0.01,0.796,5406,5398
15,10904,10,100,1e-05,0.01,0.846,5459,5445
15,11004,10,100,1e-05,0.01,0.824,5513,5491
15,11104,10,100,1e-05,0.01,0.86,5558,5546
15,11204,10,100,1e-05,0.01,0.856,5614,5590
15,11304,10,100,1e-05,0.01,0.85,5657,5647
15,11404,10,100,1e-05,0.01,0.87,5706,5698
15,11504,10,100,1e-05,0.01,0.876,5763,5741
15,11604,10,100,1e-05,0.01,0.884,5811,5793
15,11704,10,100,1e-05,0.01,0.86,5864,5840
15,11804,10,100,1e-05,0.01,0.87,5921,5883
15,11904,10,100,1e-05,0.01,0.844,5972,5932
15,12004,10,100,1e-05,0.01,0.864,6022,5982
15,12104,10,100,1e-05,0.01,0.86,6078,6026
15,12204,10,100,1e-05,0.01,0.868,6124,6080
15,12304,10,100,1e-05,0.01,0.874,6167,6137
15,12404,10,100,1e-05,0.01,0.868,6215,6189
15,12504,10,100,1e-05,0.01,0.888,6258,6246
15,12604,10,100,1e-05,0.01,0.894,6315,6289
15,12704,10,100,1e-05,0.01,0.88,6361,6343
15,12804,10,100,1e-05,0.01,0.878,6400,6404
15,12904,10,100,1e-05,0.01,0.884,6452,6452
15,13004,10,100,1e-05,0.01,0.876,6499,6505
15,13104,10,100,1e-05,0.01,0.866,6554,6550
15,13204,10,100,1e-05,0.01,0.898,6612,6592
15,13304,10,100,1e-05,0.01,0.894,6668,6636
15,13404,10,100,1e-05,0.01,0.91,6724,6680
15,13504,10,100,1e-05,0.01,0.882,6770,6734
15,13604,10,100,1e-05,0.01,0.894,6821,6783
15,13704,10,100,1e-05,0.01,0.876,6859,6845
15,13804,10,100,1e-05,0.01,0.908,6905,6899
15,13904,10,100,1e-05,0.01,0.886,6949,6955
15,14004,10,100,1e-05,0.01,0.902,7002,7002
15,14104,10,100,1e-05,0.01,0.906,7051,7053
15,14204,10,100,1e-05,0.01,0.884,7107,7097
15,14304,10,100,1e-05,0.01,0.892,7159,7145
15,14404,10,100,1e-05,0.01,0.912,7210,7194
15,14504,10,100,1e-05,0.01,0.898,7261,7243
15,14604,10,100,1e-05,0.01,0.886,7312,7292
15,14704,10,100,1e-05,0.01,0.884,7362,7342
15,14804,10,100,1e-05,0.01,0.906,7405,7399
15,14904,10,100,1e-05,0.01,0.904,7461,7443
15,15004,10,100,1e-05,0.01,0.916,7520,7484
16,104,10,100,1e-05,0.01,0.48,58,46
16,204,10,100,1e-05,0.01,0.452,118,86
16,304,10,100,1e-05,0.01,0.456,173,131
16,404,10,100,1e-05,0.01,0.492,210,194
16,504,10,100,1e-05,0.01,0.532,256,248
16,604,10,100,1e-05,0.01,0.54,305,299
16,704,10,100,1e-05,0.01,0.534,348,356
16,804,10,100,1e-05,0.01,0.556,401,403
16,904,10,100,1e-05,0.01,0.53,447,457
16,1004,10,100,1e-05,0.01,0.536,489,515
16,1104,10,100,1e-05,0.01,0.536,553,551
16,1204,10,100,1e-05,0.01,0.538,596,608
16,1304,10,100,1e-05,0.01,0.53,652,652
16,1404,10,100,1e-05,0.01,0.544,696,708
16,1504,10,100,1e-05,0.01,0.544,748,756
16,1604,10,100,1e-05,0.01,0.528,799,805
16,1704,10,100,1e-05,0.01,0.554,847,857
16,1804,10,100,1e-05,0.01,0.5,892,912
16,1904,10,100,1e-05,0.01,0.536,941,963
16,2004,10,100,1e-05,0.01,0.534,992,1012
16,2104,10,100,1e-05,0.01,0.536,1047,1057
16,2204,10,100,1e-05,0.01,0.57,1095,1109
16,2304,10,100,1e-05,0.01,0.578,1149,1155
16,2404,10,100,1e-05,0.01,0.59,1197,1207
16,2504,10,100,1e-05,0.01,0.582,1237,1267
16,2604,10,100,1e-05,0.01,0.634,1280,1324
16,2704,10,100,1e-05,0.01,0.6,1325,1379
16,2804,10,100,1e-05,0.01,0.624,1367,1437
16,2904,10,100,1e-05,0.01,0.632,1417,1487
16,3004,10,100,1e-05,0.01,0.648,1474,1530
16,3104,10,100,1e-05,0.01,0.598,1518,1586
16,3204,10,100,1e-05,0.01,0.63,1564,1640
16,3304,10,100,1e-05,0.01,0.63,1617,1687
16,3404,10,100,1e-05,0.01,0.646,1668,1736
16,3504,10,100,1e-05,0.01,0.626,1708,1796
16,3604,10,100,1e-05,0.01,0.646,1767,1837
16,3704,10,100,1e-05,0.01,0.642,1819,1885
16,3804,10,100,1e-05,0.01,0.66,1870,1934
16,3904,10,100,1e-05,0.01,0.644,1923,1981
16,4004,10,100,1e-05,0.01,0.666,1972,2032
16,4104,10,100,1e-05,0.01,0.646,2028,2076
16,4204,10,100,1e-05,0.01,0.656,2070,2134
16,4304,10,100,1e-05,0.01,0.692,2121,2183
16,4404,10,100,1e-05,0.01,0.68,2176,2228
16,4504,10,100,1e-05,0.01,0.65,2227,2277
16,4604,10,100,1e-05,0.01,0.69,2283,2321
16,4704,10,100,1e-05,0.01,0.676,2329,2375
16,4804,10,100,1e-05,0.01,0.678,2387,2417
16,4904,10,100,1e-05,0.01,0.698,2434,2470
16,5004,10,100,1e-05,0.01,0.69,2482,2522
16,5104,10,100,1e-05,0.01,0.694,2539,2565
16,5204,10,100,1e-05,0.01,0.672,2587,2617
16,5304,10,100,1e-05,0.01,0.716,2644,2660
16,5404,10,100,1e-05,0.01,0.724,2707,2697
16,5504,10,100,1e-05,0.01,0.72,2761,2743
16,5604,10,100,1e-05,0.01,0.708,2809,2795
16,5704,10,100,1e-05,0.01,0.708,2857,2847
16,5804,10,100,1e-05,0.01,0.718,2903,2901
16,5904,10,100,1e-05,0.01,0.714,2955,2949
16,6004,10,100,1e-05,0.01,0.732,3004,3000
16,6104,10,100,1e-05,0.01,0.744,3060,3044
16,6204,10,100,1e-05,0.01,0.738,3120,3084
16,6304,10,100,1e-05,0.01,0.726,3169,3135
16,6404,10,100,1e-05,0.01,0.754,3213,3191
16,6504,10,100,1e-05,0.01,0.718,3260,3244
16,6604,10,100,1e-05,0.01,0.75,3317,3287
16,6704,10,100,1e-05,0.01,0.764,3361,3343
16,6804,10,100,1e-05,0.01,0.76,3415,3389
16,6904,10,100,1e-05,0.01,0.75,3465,3439
16,7004,10,100,1e-05,0.01,0.73,3517,3487
16,7104,10,100,1e-05,0.01,0.75,3564,3540
16,7204,10,100,1e-05,0.01,0.742,3618,3586
16,7304,10,100,1e-05,0.01,0.754,3668,3636
16,7404,10,100,1e-05,0.01,0.768,3718,3686
16,7504,10,100,1e-05,0.01,0.75,3769,3735
16,7604,10,100,1e-05,0.01,0.764,3827,3777
16,7704,10,100,1e-05,0.01,0.782,3880,3824
16,7804,10,100,1e-05,0.01,0.742,3927,3877
16,7904,10,100,1e-05,0.01,0.75,3971,3933
16,8004,10,100,1e-05,0.01,0.784,4024,3980
16,8104,10,100,1e-05,0.01,0.792,4084,4020
16,8204,10,100,1e-05,0.01,0.782,4123,4081
16,8304,10,100,1e-05,0.01,0.788,4174,4130
16,8404,10,100,1e-05,0.01,0.794,4229,4175
16,8504,10,100,1e-05,0.01,0.798,4273,4231
16,8604,10,100,1e-05,0.01,0.794,4321,4283
16,8704,10,100,1e-05,0.01,0.784,4368,4336
16,8804,10,100,1e-05,0.01,0.778,4411,4393
16,8904,10,100,1e-05,0.01,0.812,4464,4440
16,9004,10,100,1e-05,0.01,0.772,4511,4493
16,9104,10,100,1e-05,0.01,0.8,4555,4549
16,9204,10,100,1e-05,0.01,0.81,4604,4600
16,9304,10,100,1e-05,0.01,0.812,4663,4641
16,9404,10,100,1e-05,0.01,0.806,4717,4687
16,9504,10,100,1e-05,0.01,0.842,4768,4736
16,9604,10,100,1e-05,0.01,0.828,4820,4784
16,9704,10,100,1e-05,0.01,0.832,4877,4827
16,9804,10,100,1e-05,0.01,0.838,4926,4878
16,9904,10,100,1e-05,0.01,0.834,4974,4930
16,10004,10,100,1e-05,0.01,0.834,5023,4981
16,10104,10,100,1e-05,0.01,0.844,5078,5026
16,10204,10,100,1e-05,0.01,0.828,5125,5079
16,10304,10,100,1e-05,0.01,0.846,5177,5127
16,10404,10,100,1e-05,0.01,0.846,5229,5175
16,10504,10,100,1e-05,0.01,0.834,5286,5218
16,10604,10,100,1e-05,0.01,0.836,5340,5264
16,10704,10,100,1e-05,0.01,0.826,5390,5314
16,10804,10,100,1e-05,0.01,0.834,5445,5359
16,10904,10,100,1e-05,0.01,0.842,5494,5410
16,11004,10,100,1e-05,0.01,0.84,5530,5474
16,11104,10,100,1e-05,0.01,0.788,5584,5520
16,11204,10,100,1e-05,0.01,0.792,5642,5562
16,11304,10,100,1e-05,0.01,0.832,5695,5609
16,11404,10,100,1e-05,0.01,0.83,5744,5660
16,11504,10,100,1e-05,0.01,0.822,5790,5714
16,11604,10,100,1e-05,0.01,0.854,5850,5754
16,11704,10,100,1e-05,0.01,0.834,5903,5801
16,11804,10,100,1e-05,0.01,0.846,5946,5858
16,11904,10,100,1e-05,0.01,0.832,5994,5910
16,12004,10,100,1e-05,0.01,0.846,6042,5962
16,12104,10,100,1e-05,0.01,0.83,6085,6019
16,12204,10,100,1e-05,0.01,0.858,6130,6074
16,12304,10,100,1e-05,0.01,0.876,6183,6121
16,12404,10,100,1e-05,0.01,0.866,6232,6172
16,12504,10,100,1e-05,0.01,0.868,6273,6231
16,12604,10,100,1e-05,0.01,0.854,6331,6273
16,12704,10,100,1e-05,0.01,0.856,6380,6324
16,12804,10,100,1e-05,0.01,0.86,6423,6381
16,12904,10,100,1e-05,0.01,0.866,6470,6434
16,13004,10,100,1e-05,0.01,0.856,6522,6482
16,13104,10,100,1e-05,0.01,0.874,6570,6534
16,13204,10,100,1e-05,0.01,0.878,6619,6585
16,13304,10,100,1e-05,0.01,0.878,6665,6639
16,13404,10,100,1e-05,0.01,0.874,6712,6692
16,13504,10,100,1e-05,0.01,0.87,6766,6738
16,13604,10,100,1e-05,0.01,0.88,6814,6790
16,13704,10,100,1e-05,0.01,0.886,6868,6836
16,13804,10,100,1e-05,0.01,0.882,6912,6892
16,13904,10,100,1e-05,0.01,0.884,6959,6945
16,14004,10,100,1e-05,0.01,0.868,7013,6991
16,14104,10,100,1e-05,0.01,0.888,7072,7032
16,14204,10,100,1e-05,0.01,0.896,7118,7086
16,14304,10,100,1e-05,0.01,0.892,7167,7137
16,14404,10,100,1e-05,0.01,0.902,7216,7188
16,14504,10,100,1e-05,0.01,0.88,7272,7232
16,14604,10,100,1e-05,0.01,0.896,7326,7278
16,14704,10,100,1e-05,0.01,0.894,7375,7329
16,14804,10,100,1e-05,0.01,0.908,7423,7381
16,14904,10,100,1e-05,0.01,0.908,7459,7445
16,15004,10,100,1e-05,0.01,0.898,7511,7493
17,104,10,100,1e-05,0.01,0.482,55,49
17,204,10,100,1e-05,0.01,0.48,109,95
17,304,10,100,1e-05,0.01,0.512,158,146
17,404,10,100,1e-05,0.01,0.534,200,204
17,504,10,100,1e-05,0.01,0.524,250,254
17,604,10,100,1e-05,0.01,0.532,310,294
17,704,10,100,1e-05,0.01,0.542,367,337
17,804,10,100,1e-05,0.01,0.546,420,384
17,904,10,100,1e-05,0.01,0.52,476,428
17,1004,10,100,1e-05,0.01,0.536,524,480
17,1104,10,100,1e-05,0.01,0.53,573,531
17,1204,10,100,1e-05,0.01,0.56,626,578
17,1304,10,100,1e-05,0.01,0.518,677,627
17,1404,10,100,1e-05,0.01,0.558,722,682
17,1504,10,100,1e-05,0.01,0.526,772,732
17,1604,10,100,1e-05,0.01,0.574,814,790
17,1704,10,100,1e-05,0.01,0.556,864,840
17,1804,10,100,1e-05,0.01,0.572,908,896
17,1904,10,100,1e-05,0.01,0.584,954,950
17,2004,10,100,1e-05,0.01,0.602,1005,999
17,2104,10,100,1e-05,0.01,0.582,1055,1049
17,2204,10,100,1e-05,0.01,0.582,1109,1095
17,2304,10,100,1e-05,0.01,0.612,1158,1146
17,2404,10,100,1e-05,0.01,0.618,1207,1197
17,2504,10,100,1e-05,0.01,0.64,1264,1240
17,2604,10,100,1e-05,0.01,0.596,1306,1298
17,2704,10,100,1e-05,0.01,0.648,1348,1356
17,2804,10,100,1e-05,0.01,0.636,1398,1406
17,2904,10,100,1e-05,0.01,0.642,1449,1455
17,3004,10,100,1e-05,0.01,0.654,1500,1504
17,3104,10,100,1e-05,0.01,0.638,1553,1551
17,3204,10,100,1e-05,0.01,0.632,1601,1603
17,3304,10,100,1e-05,0.01,0.642,1649,1655
17,3404,10,100,1e-05,0.01,0.676,1700,1704
17,3504,10,100,1e-05,0.01,0.658,1750,1754
17,3604,10,100,1e-05,0.01,0.696,1797,1807
17,3704,10,100,1e-05,0.01,0.686,1851,1853
17,3804,10,100,1e-05,0.01,0.694,1902,1902
17,3904,10,100,1e-05,0.01,0.696,1948,1956
17,4004,10,100,1e-05,0.01,0.698,2005,1999
17,4104,10,100,1e-05,0.01,0.712,2061,2043
17,4204,10,100,1e-05,0.01,0.704,2112,2092
17,4304,10,100,1e-05,0.01,0.71,2156,2148
17,4404,10,100,1e-05,0.01,0.694,2191,2213
17,4504,10,100,1e-05,0.01,0.7,2247,2257
17,4604,10,100,1e-05,0.01,0.712,2296,2308
17,4704,10,100,1e-05,0.01,0.708,2347,2357
17,4804,10,100,1e-05,0.01,0.712,2399,2405
17,4904,10,100,1e-05,0.01,0.742,2442,2462
17,5004,10,100,1e-05,0.01,0.736,2484,2520
17,5104,10,100,1e-05,0.01,0.726,2541,2563
17,5204,10,100,1e-05,0.01,0.72,2588,2616
17,5304,10,100,1e-05,0.01,0.706,2636,2668
17,5404,10,100,1e-05,0.01,0.712,2687,2717
17,5504,10,100,1e-05,0.01,0.748,2731,2773
17,5604,10,100,1e-05,0.01,0.72,2770,2834
17,5704,10,100,1e-05,0.01,0.768,2828,2876
17,5804,10,100,1e-05,0.01,0.746,2887,2917
17,5904,10,100,1e-05,0.01,0.756,2933,2971
17,6004,10,100,1e-05,0.01,0.756,2986,3018
17,6104,10,100,1e-05,0.01,0.776,3047,3057
17,6204,10,100,1e-05,0.01,0.782,3096,3108
17,6304,10,100,1e-05,0.01,0.772,3142,3162
17,6404,10,100,1e-05,0.01,0.744,3207,3197
17,6504,10,100,1e-05,0.01,0.738,3249,3255
17,6604,10,100,1e-05,0.01,0.748,3306,3298
17,6704,10,100,1e-05,0.01,0.77,3345,3359
17,6804,10,100,1e-05,0.01,0.782,3393,3411
17,6904,10,100,1e-05,0.01,0.77,3450,3454
17,7004,10,100,1e-05,0.01,0.772,3503,3501
17,7104,10,100,1e-05,0.01,0.77,3553,3551
17,7204,10,100,1e-05,0.01,0.778,3606,3598
17,7304,10,100,1e-05,0.01,0.782,3652,3652
17,7404,10,100,1e-05,0.01,0.75,3707,3697
17,7504,10,100,1e-05,0.01,0.794,3750,3754
17,7604,10,100,1e-05,0.01,0.782,3802,3802
17,7704,10,100,1e-05,0.01,0.808,3857,3847
17,7804,10,100,1e-05,0.01,0.798,3914,3890
17,7904,10,100,1e-05,0.01,0.796,3958,3946
17,8004,10,100,1e-05,0.01,0.796,4010,3994
17,8104,10,100,1e-05,0.01,0.794,4068,4036
17,8204,10,100,1e-05,0.01,0.784,4118,4086
17,8304,10,100,1e-05,0.01,0.776,4173,4131
17,8404,10,100,1e-05,0.01,0.788,4221,4183
17,8504,10,100,1e-05,0.01,0.804,4264,4240
17,8604,10,100,1e-05,0.01,0.818,4307,4297
17,8704,10,100,1e-05,0.01,0.794,4357,4347
17,8804,10,100,1e-05,0.01,0.828,4410,4394
17,8904,10,100,1e-05,0.01,0.812,4468,4436
17,9004,10,100,1e-05,0.01,0.79,4522,4482
17,9104,10,100,1e-05,0.01,0.816,4570,4534
17,9204,10,100,1e-05,0.01,0.818,4624,4580
17,9304,10,100,1e-05,0.01,0.812,4677,4627
17,9404,10,100,1e-05,0.01,0.794,4723,4681
17,9504,10,100,1e-05,0.01,0.826,4772,4732
17,9604,10,100,1e-05,0.01,0.812,4819,4785
17,9704,10,100,1e-05,0.01,0.824,4873,4831
17,9804,10,100,1e-05,0.01,0.818,4928,4876
17,9904,10,100,1e-05,0.01,0.81,4982,4922
17,10004,10,100,1e-05,0.01,0.806,5027,4977
17,10104,10,100,1e-05,0.01,0.822,5084,5020
17,10204,10,100,1e-05,0.01,0.798,5137,5067
17,10304,10,100,1e-05,0.01,0.818,5180,5124
17,10404,10,100,1e-05,0.01,0.814,5226,5178
17,10504,10,100,1e-05,0.01,0.822,5271,5233
17,10604,10,100,1e-05,0.01,0.818,5323,5281
17,10704,10,100,1e-05,0.01,0.83,5372,5332
17,10804,10,100,1e-05,0.01,0.836,5420,5384
17,10904,10,100,1e-05,0.01,0.824,5471,5433
17,11004,10,100,1e-05,0.01,0.84,5525,5479
17,11104,10,100,1e-05,0.01,0.76,5565,5539
17,11204,10,100,1e-05,0.01,0.784,5620,5584
17,11304,10,100,1e-05,0.01,0.812,5671,5633
17,11404,10,100,1e-05,0.01,0.804,5721,5683
17,11504,10,100,1e-05,0.01,0.82,5775,5729
17,11604,10,100,1e-05,0.01,0.828,5821,5783
17,11704,10,100,1e-05,0.01,0.83,5870,5834
17,11804,10,100,1e-05,0.01,0.84,5928,5876
17,11904,10,100,1e-05,0.01,0.868,5980,5924
17,12004,10,100,1e-05,0.01,0.844,6030,5974
17,12104,10,100,1e-05,0.01,0.828,6074,6030
17,12204,10,100,1e-05,0.01,0.832,6128,6076
17,12304,10,100,1e-05,0.01,0.84,6178,6126
17,12404,10,100,1e-05,0.01,0.832,6227,6177
17,12504,10,100,1e-05,0.01,0.842,6279,6225
17,12604,10,100,1e-05,0.01,0.826,6323,6281
17,12704,10,100,1e-05,0.01,0.854,6380,6324
17,12804,10,100,1e-05,0.01,0.864,6436,6368
17,12904,10,100,1e-05,0.01,0.87,6481,6423
17,13004,10,100,1e-05,0.01,0.856,6534,6470
17,13104,10,100,1e-05,0.01,0.872,6584,6520
17,13204,10,100,1e-05,0.01,0.858,6644,6560
17,13304,10,100,1e-05,0.01,0.87,6689,6615
17,13404,10,100,1e-05,0.01,0.864,6744,6660
17,13504,10,100,1e-05,0.01,0.888,6792,6712
17,13604,10,100,1e-05,0.01,0.846,6838,6766
17,13704,10,100,1e-05,0.01,0.87,6887,6817
17,13804,10,100,1e-05,0.01,0.89,6947,6857
17,13904,10,100,1e-05,0.01,0.872,6990,6914
17,14004,10,100,1e-05,0.01,0.834,7037,6967
17,14104,10,100,1e-05,0.01,0.864,7087,7017
17,14204,10,100,1e-05,0.01,0.874,7134,7070
17,14304,10,100,1e-05,0.01,0.86,7176,7128
17,14404,10,100,1e-05,0.01,0.884,7226,7178
17,14504,10,100,1e-05,0.01,0.872,7267,7237
17,14604,10,100,1e-05,0.01,0.862,7308,7296
17,14704,10,100,1e-05,0.01,0.874,7357,7347
17,14804,10,100,1e-05,0.01,0.898,7405,7399
17,14904,10,100,1e-05,0.01,0.896,7457,7447
17,15004,10,100,1e-05,0.01,0.89,7500,7504
18,104,10,100,1e-05,0.01,0.518,43,61
18,204,10,100,1e-05,0.01,0.494,88,116
18,304,10,100,1e-05,0.01,0.498,132,172
18,404,10,100,1e-05,0.01,0.476,172,232
18,504,10,100,1e-05,0.01,0.488,224,280
18,604,10,100,1e-05,0.01,0.5,278,326
18,704,10,100,1e-05,0.01,0.516,333,371
18,804,10,100,1e-05,0.01,0.492,382,422
18,904,10,100,1e-05,0.01,0.542,432,472
18,1004,10,100,1e-05,0.01,0.5,482,522
18,1104,10,100,1e-05,0.01,0.534,530,574
18,1204,10,100,1e-05,0.01,0.502,576,628
18,1304,10,100,1e-05,0.01,0.534,624,680
18,1404,10,100,1e-05,0.01,0.506,674,730
18,1504,10,100,1e-05,0.01,0.548,720,784
18,1604,10,100,1e-05,0.01,0.582,774,830
18,1704,10,100,1e-05,0.01,0.55,823,881
18,1804,10,100,1e-05,0.01,0.59,871,933
18,1904,10,100,1e-05,0.01,0.592,928,976
18,2004,10,100,1e-05,0.01,0.588,977,1027
18,2104,10,100,1e-05,0.01,0.566,1026,1078
18,2204,10,100,1e-05,0.01,0.586,1072,1132
18,2304,10,100,1e-05,0.01,0.606,1116,1188
18,2404,10,100,1e-05,0.01,0.648,1163,1241
18,2504,10,100,1e-05,0.01,0.64,1216,1288
18,2604,10,100,1e-05,0.01,0.622,1278,1326
18,2704,10,100,1e-05,0.01,0.652,1322,1382
18,2804,10,100,1e-05,0.01,0.648,1376,1428
18,2904,10,100,1e-05,0.01,0.7,1434,1470
18,3004,10,100,1e-05,0.01,0.63,1473,1531
18,3104,10,100,1e-05,0.01,0.674,1512,1592
18,3204,10,100,1e-05,0.01,0.676,1567,1637
18,3304,10,100,1e-05,0.01,0.678,1611,1693
18,3404,10,100,1e-05,0.01,0.66,1656,1748
18,3504,10,100,1e-05,0.01,0.67,1710,1794
18,3604,10,100,1e-05,0.01,0.702,1748,1856
18,3704,10,100,1e-05,0.01,0.694,1803,1901
18,3804,10,100,1e-05,0.01,0.672,1856,1948
18,3904,10,100,1e-05,0.01,0.668,1910,1994
18,4004,10,100,1e-05,0.01,0.708,1968,2036
18,4104,10,100,1e-05,0.01,0.698,2020,2084
18,4204,10,100,1e-05,0.01,0.648,2069,2135
18,4304,10,100,1e-05,0.01,0.666,2112,2192
18,4404,10,100,1e-05,0.01,0.674,2163,2241
18,4504,10,100,1e-05,0.01,0.706,2206,2298
18,4604,10,100,1e-05,0.01,0.692,2250,2354
18,4704,10,100,1e-05,0.01,0.704,2300,2404
18,4804,10,100,1e-05,0.01,0.726,2356,2448
18,4904,10,100,1e-05,0.01,0.728,2404,2500
18,5004,10,100,1e-05,0.01,0.688,2452,2552
18,5104,10,100,1e-05,0.01,0.692,2500,2604
18,5204,10,100,1e-05,0.01,0.706,2549,2655
18,5304,10,100,1e-05,0.01,0.704,2598,2706
18,5404,10,100,1e-05,0.01,0.706,2650,2754
18,5504,10,100,1e-05,0.01,0.714,2702,2802
18,5604,10,100,1e-05,0.01,0.722,2754,2850
18,5704,10,100,1e-05,0.01,0.72,2804,2900
18,5804,10,100,1e-05,0.01,0.736,2847,2957
18,5904,10,100,1e-05,0.01,0.718,2901,3003
18,6004,10,100,1e-05,0.01,0.756,2949,3055
18,6104,10,100,1e-05,0.01,0.738,2992,3112
18,6204,10,100,1e-05,0.01,0.728,3039,3165
18,6304,10,100,1e-05,0.01,0.722,3095,3209
18,6404,10,100,1e-05,0.01,0.724,3149,3255
18,6504,10,100,1e-05,0.01,0.724,3204,3300
18,6604,10,100,1e-05,0.01,0.746,3262,3342
18,6704,10,100,1e-05,0.01,0.738,3307,3397
18,6804,10,100,1e-05,0.01,0.728,3365,3439
18,6904,10,100,1e-05,0.01,0.75,3430,3474
18,7004,10,100,1e-05,0.01,0.746,3478,3526
18,7104,10,100,1e-05,0.01,0.75,3527,3577
18,7204,10,100,1e-05,0.01,0.738,3577,3627
18,7304,10,100,1e-05,0.01,0.75,3631,3673
18,7404,10,100,1e-05,0.01,0.732,3677,3727
18,7504,10,100,1e-05,0.01,0.67,3730,3774
18,7604,10,100,1e-05,0.01,0.742,3778,3826
18,7704,10,100,1e-05,0.01,0.71,3835,3869
18,7804,10,100,1e-05,0.01,0.708,3884,3920
18,7904,10,100,1e-05,0.01,0.732,3929,3975
18,8004,10,100,1e-05,0.01,0.732,3980,4024
18,8104,10,100,1e-05,0.01,0.764,4029,4075
18,8204,10,100,1e-05,0.01,0.718,4076,4128
18,8304,10,100,1e-05,0.01,0.742,4129,4175
18,8404,10,100,1e-05,0.01,0.758,4174,4230
18,8504,10,100,1e-05,0.01,0.678,4222,4282
18,8604,10,100,1e-05,0.01,0.754,4272,4332
18,8704,10,100,1e-05,0.01,0.766,4328,4376
18,8804,10,100,1e-05,0.01,0.748,4380,4424
18,8904,10,100,1e-05,0.01,0.798,4430,4474
18,9004,10,100,1e-05,0.01,0.788,4486,4518
18,9104,10,100,1e-05,0.01,0.792,4534,4570
18,9204,10,100,1e-05,0.01,0.792,4579,4625
18,9304,10,100,1e-05,0.01,0.778,4629,4675
18,9404,10,100,1e-05,0.01,0.77,4676,4728
18,9504,10,100,1e-05,0.01,0.794,4718,4786
18,9604,10,100,1e-05,0.01,0.778,4772,4832
18,9704,10,100,1e-05,0.01,0.78,4824,4880
18,9804,10,100,1e-05,0.01,0.756,4870,4934
18,9904,10,100,1e-05,0.01,0.772,4919,4985
18,10004,10,100,1e-05,0.01,0.792,4965,5039
18,10104,10,100,1e-05,0.01,0.784,5016,5088
18,10204,10,100,1e-05,0.01,0.782,5069,5135
18,10304,10,100,1e-05,0.01,0.79,5116,5188
18,10404,10,100,1e-05,0.01,0.766,5161,5243
18,10504,10,100,1e-05,0.01,0.746,5209,5295
18,10604,10,100,1e-05,0.01,0.772,5264,5340
18,10704,10,100,1e-05,0.01,0.816,5318,5386
18,10804,10,100,1e-05,0.01,0.776,5363,5441
18,10904,10,100,1e-05,0.01,0.816,5415,5489
18,11004,10,100,1e-05,0.01,0.83,5469,5535
18,11104,10,100,1e-05,0.01,0.834,5516,5588
18,11204,10,100,1e-05,0.01,0.796,5571,5633
18,11304,10,100,1e-05,0.01,0.828,5624,5680
18,11404,10,100,1e-05,0.01,0.834,5665,5739
18,11504,10,100,1e-05,0.01,0.82,5716,5788
18,11604,10,100,1e-05,0.01,0.808,5757,5847
18,11704,10,100,1e-05,0.01,0.828,5815,5889
18,11804,10,100,1e-05,0.01,0.764,5862,5942
18,11904,10,100,1e-05,0.01,0.778,5913,5991
18,12004,10,100,1e-05,0.01,0.758,5957,6047
18,12104,10,100,1e-05,0.01,0.806,6007,6097
18,12204,10,100,1e-05,0.01,0.822,6059,6145
18,12304,10,100,1e-05,0.01,0.842,6106,6198
18,12404,10,100,1e-05,0.01,0.828,6153,6251
18,12504,10,100,1e-05,0.01,0.836,6197,6307
18,12604,10,100,1e-05,0.01,0.86,6245,6359
18,12704,10,100,1e-05,0.01,0.868,6302,6402
18,12804,10,100,1e-05,0.01,0.852,6357,6447
18,12904,10,100,1e-05,0.01,0.86,6412,6492
18,13004,10,100,1e-05,0.01,0.826,6464,6540
18,13104,10,100,1e-05,0.01,0.842,6512,6592
18,13204,10,100,1e-05,0.01,0.82,6561,6643
18,13304,10,100,1e-05,0.01,0.838,6613,6691
18,13404,10,100,1e-05,0.01,0.876,6663,6741
18,13504,10,100,1e-05,0.01,0.862,6711,6793
18,13604,10,100,1e-05,0.01,0.858,6772,6832
18,13704,10,100,1e-05,0.01,0.856,6825,6879
18,13804,10,100,1e-05,0.01,0.864,6873,6931
18,13904,10,100,1e-05,0.01,0.884,6927,6977
18,14004,10,100,1e-05,0.01,0.844,6976,7028
18,14104,10,100,1e-05,0.01,0.866,7026,7078
18,14204,10,100,1e-05,0.01,0.854,7077,7127
18,14304,10,100,1e-05,0.01,0.88,7133,7171
18,14404,10,100,1e-05,0.01,0.846,7183,7221
18,14504,10,100,1e-05,0.01,0.85,7240,7264
18,14604,10,100,1e-05,0.01,0.832,7300,7304
18,14704,10,100,1e-05,0.01,0.856,7351,7353
18,14804,10,100,1e-05,0.01,0.872,7396,7408
18,14904,10,100,1e-05,0.01,0.846,7436,7468
18,15004,10,100,1e-05,0.01,0.876,7492,7512
19,104,10,100,1e-05,0.01,0.484,55,49
19,204,10,100,1e-05,0.01,0.514,113,91
19,304,10,100,1e-05,0.01,0.492,151,153
19,404,10,100,1e-05,0.01,0.49,204,200
19,504,10,100,1e-05,0.01,0.472,259,245
19,604,10,100,1e-05,0.01,0.502,318,286
19,704,10,100,1e-05,0.01,0.51,366,338
19,804,10,100,1e-05,0.01,0.448,412,392
19,904,10,100,1e-05,0.01,0.462,463,441
19,1004,10,100,1e-05,0.01,0.498,514,490
19,1104,10,100,1e-05,0.01,0.522,561,543
19,1204,10,100,1e-05,0.01,0.53,610,594
19,1304,10,100,1e-05,0.01,0.524,659,645
19,1404,10,100,1e-05,0.01,0.538,704,700
19,1504,10,100,1e-05,0.01,0.526,763,741
19,1604,10,100,1e-05,0.01,0.572,812,792
19,1704,10,100,1e-05,0.01,0.578,863,841
19,1804,10,100,1e-05,0.01,0.604,918,886
19,1904,10,100,1e-05,0.01,0.622,967,937
19,2004,10,100,1e-05,0.01,0.644,1016,988
19,2104,10,100,1e-05,0.01,0.666,1068,1036
19,2204,10,100,1e-05,0.01,0.642,1105,1099
19,2304,10,100,1e-05,0.01,0.664,1160,1144
19,2404,10,100,1e-05,0.01,0.678,1208,1196
19,2504,10,100,1e-05,0.01,0.654,1251,1253
19,2604,10,100,1e-05,0.01,0.662,1306,1298
19,2704,10,100,1e-05,0.01,0.684,1357,1347
19,2804,10,100,1e-05,0.01,0.706,1410,1394
19,2904,10,100,1e-05,0.01,0.694,1457,1447
19,3004,10,100,1e-05,0.01,0.7,1510,1494
19,3104,10,100,1e-05,0.01,0.718,1560,1544
19,3204,10,100,1e-05,0.01,0.706,1611,1593
19,3304,10,100,1e-05,0.01,0.696,1657,1647
19,3404,10,100,1e-05,0.01,0.712,1717,1687
19,3504,10,100,1e-05,0.01,0.734,1766,1738
19,3604,10,100,1e-05,0.01,0.724,1815,1789
19,3704,10,100,1e-05,0.01,0.72,1866,1838
19,3804,10,100,1e-05,0.01,0.69,1918,1886
19,3904,10,100,1e-05,0.01,0.694,1967,1937
19,4004,10,100,1e-05,0.01,0.762,2018,1986
19,4104,10,100,1e-05,0.01,0.734,2082,2022
19,4204,10,100,1e-05,0.01,0.734,2127,2077
19,4304,10,100,1e-05,0.01,0.762,2173,2131
19,4404,10,100,1e-05,0.01,0.766,2222,2182
19,4504,10,100,1e-05,0.01,0.74,2273,2231
19,4604,10,100,1e-05,0.01,0.742,2318,2286
19,4704,10,100,1e-05,0.01,0.756,2366,2338
19,4804,10,100,1e-05,0.01,0.76,2424,2380
19,4904,10,100,1e-05,0.01,0.784,2472,2432
19,5004,10,100,1e-05,0.01,0.756,2522,2482
19,5104,10,100,1e-05,0.01,0.76,2569,2535
19,5204,10,100,1e-05,0.01,0.76,2629,2575
19,5304,10,100,1e-05,0.01,0.78,2674,2630
19,5404,10,100,1e-05,0.01,0.78,2724,2680
19,5504,10,100,1e-05,0.01,0.784,2785,2719
19,5604,10,100,1e-05,0.01,0.766,2830,2774
19,5704,10,100,1e-05,0.01,0.78,2877,2827
19,5804,10,100,1e-05,0.01,0.752,2921,2883
19,5904,10,100,1e-05,0.01,0.782,2970,2934
19,6004,10,100,1e-05,0.01,0.776,3015,2989
19,6104,10,100,1e-05,0.01,0.804,3064,3040
19,6204,10,100,1e-05,0.01,0.786,3115,3089
19,6304,10,100,1e-05,0.01,0.786,3168,3136
19,6404,10,100,1e-05,0.01,0.754,3208,3196
19,6504,10,100,1e-05,0.01,0.804,3258,3246
19,6604,10,100,1e-05,0.01,0.802,3300,3304
19,6704,10,100,1e-05,0.01,0.796,3360,3344
19,6804,10,100,1e-05,0.01,0.768,3413,3391
19,6904,10,100,1e-05,0.01,0.792,3464,3440
19,7004,10,100,1e-05,0.01,0.796,3510,3494
19,7104,10,100,1e-05,0.01,0.794,3564,3540
19,7204,10,100,1e-05,0.01,0.794,3616,3588
19,7304,10,100,1e-05,0.01,0.782,3661,3643
19,7404,10,100,1e-05,0.01,0.808,3712,3692
19,7504,10,100,1e-05,0.01,0.798,3768,3736
19,7604,10,100,1e-05,0.01,0.806,3815,3789
19,7704,10,100,1e-05,0.01,0.818,3871,3833
19,7804,10,100,1e-05,0.01,0.824,3921,3883
19,7904,10,100,1e-05,0.01,0.83,3970,3934
19,8004,10,100,1e-05,0.01,0.826,4015,3989
19,8104,10,100,1e-05,0.01,0.814,4058,4046
19,8204,10,100,1e-05,0.01,0.808,4108,4096
19,8304,10,100,1e-05,0.01,0.828,4165,4139
19,8404,10,100,1e-05,0.01,0.84,4213,4191
19,8504,10,100,1e-05,0.01,0.816,4261,4243
19,8604,10,100,1e-05,0.01,0.844,4305,4299
19,8704,10,100,1e-05,0.01,0.842,4350,4354
19,8804,10,100,1e-05,0.01,0.816,4398,4406
19,8904,10,100,1e-05,0.01,0.816,4448,4456
19,9004,10,100,1e-05,0.01,0.826,4501,4503
19,9104,10,100,1e-05,0.01,0.834,4545,4559
19,9204,10,100,1e-05,0.01,0.828,4586,4618
19,9304,10,100,1e-05,0.01,0.842,4643,4661
19,9404,10,100,1e-05,0.01,0.836,4700,4704
19,9504,10,100,1e-05,0.01,0.83,4743,4761
19,9604,10,100,1e-05,0.01,0.816,4795,4809
19,9704,10,100,1e-05,0.01,0.84,4843,4861
19,9804,10,100,1e-05,0.01,0.824,4888,4916
19,9904,10,100,1e-05,0.01,0.846,4943,4961
19,10004,10,100,1e-05,0.01,0.848,4993,5011
19,10104,10,100,1e-05,0.01,0.866,5045,5059
19,10204,10,100,1e-05,0.01,0.852,5096,5108
19,10304,10,100,1e-05,0.01,0.86,5149,5155
19,10404,10,100,1e-05,0.01,0.866,5195,5209
19,10504,10,100,1e-05,0.01,0.838,5245,5259
19,10604,10,100,1e-05,0.01,0.852,5300,5304
19,10704,10,100,1e-05,0.01,0.868,5341,5363
19,10804,10,100,1e-05,0.01,0.862,5391,5413
19,10904,10,100,1e-05,0.01,0.842,5440,5464
19,11004,10,100,1e-05,0.01,0.856,5488,5516
19,11104,10,100,1e-05,0.01,0.866,5532,5572
19,11204,10,100,1e-05,0.01,0.848,5591,5613
19,11304,10,100,1e-05,0.01,0.858,5650,5654
19,11404,10,100,1e-05,0.01,0.848,5701,5703
19,11504,10,100,1e-05,0.01,0.872,5745,5759
19,11604,10,100,1e-05,0.01,0.876,5794,5810
19,11704,10,100,1e-05,0.01,0.874,5851,5853
19,11804,10,100,1e-05,0.01,0.884,5899,5905
19,11904,10,100,1e-05,0.01,0.862,5943,5961
19,12004,10,100,1e-05,0.01,0.872,5988,6016
19,12104,10,100,1e-05,0.01,0.798,6046,6058
19,12204,10,100,1e-05,0.01,0.856,6096,6108
19,12304,10,100,1e-05,0.01,0.858,6149,6155
19,12404,10,100,1e-05,0.01,0.86,6200,6204
19,12504,10,100,1e-05,0.01,0.88,6245,6259
19,12604,10,100,1e-05,0.01,0.844,6294,6310
19,12704,10,100,1e-05,0.01,0.868,6350,6354
19,12804,10,100,1e-05,0.01,0.886,6402,6402
19,12904,10,100,1e-05,0.01,0.892,6449,6455
19,13004,10,100,1e-05,0.01,0.904,6495,6509
19,13104,10,100,1e-05,0.01,0.86,6539,6565
19,13204,10,100,1e-05,0.01,0.892,6587,6617
19,13304,10,100,1e-05,0.01,0.88,6642,6662
19,13404,10,100,1e-05,0.01,0.888,6696,6708
19,13504,10,100,1e-05,0.01,0.884,6741,6763
19,13604,10,100,1e-05,0.01,0.886,6798,6806
19,13704,10,100,1e-05,0.01,0.874,6846,6858
19,13804,10,100,1e-05,0.01,0.898,6899,6905
19,13904,10,100,1e-05,0.01,0.904,6958,6946
19,14004,10,100,1e-05,0.01,0.896,7011,6993
19,14104,10,100,1e-05,0.01,0.912,7070,7034
19,14204,10,100,1e-05,0.01,0.884,7116,7088
19,14304,10,100,1e-05,0.01,0.904,7165,7139
19,14404,10,100,1e-05,0.01,0.922,7219,7185
19,14504,10,100,1e-05,0.01,0.874,7271,7233
19,14604,10,100,1e-05,0.01,0.932,7309,7295
19,14704,10,100,1e-05,0.01,0.906,7352,7352
19,14804,10,100,1e-05,0.01,0.89,7404,7400
19,14904,10,100,1e-05,0.01,0.894,7457,7447
19,15004,10,100,1e-05,0.01,0.896,7510,7494
20,104,10,100,1e-05,0.01,0.492,55,49
20,204,10,100,1e-05,0.01,0.444,106,98
20,304,10,100,1e-05,0.01,0.46,162,142
20,404,10,100,1e-05,0.01,0.486,216,188
20,504,10,100,1e-05,0.01,0.52,259,245
20,604,10,100,1e-05,0.01,0.538,301,303
20,704,10,100,1e-05,0.01,0.522,351,353
20,804,10,100,1e-05,0.01,0.538,402,402
20,904,10,100,1e-05,0.01,0.512,449,455
20,1004,10,100,1e-05,0.01,0.526,496,508
20,1104,10,100,1e-05,0.01,0.556,546,558
20,1204,10,100,1e-05,0.01,0.564,594,610
20,1304,10,100,1e-05,0.01,0.562,642,662
20,1404,10,100,1e-05,0.01,0.576,692,712
20,1504,10,100,1e-05,0.01,0.558,743,761
20,1604,10,100,1e-05,0.01,0.59,800,804
20,1704,10,100,1e-05,0.01,0.608,847,857
20,1804,10,100,1e-05,0.01,0.614,897,907
20,1904,10,100,1e-05,0.01,0.646,948,956
20,2004,10,100,1e-05,0.01,0.656,997,1007
20,2104,10,100,1e-05,0.01,0.664,1051,1053
20,2204,10,100,1e-05,0.01,0.652,1102,1102
20,2304,10,100,1e-05,0.01,0.702,1154,1150
20,2404,10,100,1e-05,0.01,0.684,1202,1202
20,2504,10,100,1e-05,0.01,0.7,1245,1259
20,2604,10,100,1e-05,0.01,0.686,1289,1315
20,2704,10,100,1e-05,0.01,0.718,1336,1368
20,2804,10,100,1e-05,0.01,0.712,1391,1413
20,2904,10,100,1e-05,0.01,0.722,1430,1474
20,3004,10,100,1e-05,0.01,0.726,1473,1531
20,3104,10,100,1e-05,0.01,0.724,1522,1582
20,3204,10,100,1e-05,0.01,0.748,1575,1629
20,3304,10,100,1e-05,0.01,0.712,1623,1681
20,3404,10,100,1e-05,0.01,0.748,1676,1728
20,3504,10,100,1e-05,0.01,0.71,1718,1786
20,3604,10,100,1e-05,0.01,0.75,1771,1833
20,3704,10,100,1e-05,0.01,0.754,1828,1876
20,3804,10,100,1e-05,0.01,0.79,1872,1932
20,3904,10,100,1e-05,0.01,0.814,1930,1974
20,4004,10,100,1e-05,0.01,0.82,1984,2020
20,4104,10,100,1e-05,0.01,0.838,2039,2065
20,4204,10,100,1e-05,0.01,0.814,2090,2114
20,4304,10,100,1e-05,0.01,0.796,2147,2157
20,4404,10,100,1e-05,0.01,0.8,2197,2207
20,4504,10,100,1e-05,0.01,0.796,2247,2257
20,4604,10,100,1e-05,0.01,0.828,2295,2309
20,4704,10,100,1e-05,0.01,0.854,2351,2353
20,4804,10,100,1e-05,0.01,0.77,2392,2412
20,4904,10,100,1e-05,0.01,0.818,2448,2456
20,5004,10,100,1e-05,0.01,0.794,2494,2510
20,5104,10,100,1e-05,0.01,0.848,2546,2558
20,5204,10,100,1e-05,0.01,0.836,2599,2605
20,5304,10,100,1e-05,0.01,0.848,2648,2656
20,5404,10,100,1e-05,0.01,0.856,2688,2716
20,5504,10,100,1e-05,0.01,0.836,2734,2770
20,5604,10,100,1e-05,0.01,0.86,2790,2814
20,5704,10,100,1e-05,0.01,0.838,2840,2864
20,5804,10,100,1e-05,0.01,0.818,2894,2910
20,5904,10,100,1e-05,0.01,0.862,2943,2961
20,6004,10,100,1e-05,0.01,0.87,2999,3005
20,6104,10,100,1e-05,0.01,0.854,3052,3052
20,6204,10,100,1e-05,0.01,0.85,3105,3099
20,6304,10,100,1e-05,0.01,0.848,3151,3153
20,6404,10,100,1e-05,0.01,0.85,3210,3194
20,6504,10,100,1e-05,0.01,0.848,3267,3237
20,6604,10,100,1e-05,0.01,0.822,3321,3283
20,6704,10,100,1e-05,0.01,0.842,3368,3336
20,6804,10,100,1e-05,0.01,0.826,3414,3390
20,6904,10,100,1e-05,0.01,0.834,3460,3444
20,7004,10,100,1e-05,0.01,0.854,3506,3498
20,7104,10,100,1e-05,0.01,0.858,3562,3542
20,7204,10,100,1e-05,0.01,0.852,3609,3595
20,7304,10,100,1e-05,0.01,0.864,3662,3642
20,7404,10,100,1e-05,0.01,0.856,3720,3684
20,7504,10,100,1e-05,0.01,0.84,3770,3734
20,7604,10,100,1e-05,0.01,0.888,3822,3782
20,7704,10,100,1e-05,0.01,0.878,3879,3825
20,7804,10,100,1e-05,0.01,0.876,3923,3881
20,7904,10,100,1e-05,0.01,0.872,3975,3929
20,8004,10,100,1e-05,0.01,0.9,4031,3973
20,8104,10,100,1e-05,0.01,0.886,4082,4022
20,8204,10,100,1e-05,0.01,0.864,4129,4075
20,8304,10,100,1e-05,0.01,0.878,4176,4128
20,8404,10,100,1e-05,0.01,0.882,4225,4179
20,8504,10,100,1e-05,0.01,0.878,4278,4226
20,8604,10,100,1e-05,0.01,0.884,4326,4278
20,8704,10,100,1e-05,0.01,0.884,4374,4330
20,8804,10,100,1e-05,0.01,0.882,4422,4382
20,8904,10,100,1e-05,0.01,0.888,4475,4429
20,9004,10,100,1e-05,0.01,0.882,4527,4477
20,9104,10,100,1e-05,0.01,0.868,4577,4527
20,9204,10,100,1e-05,0.01,0.884,4626,4578
20,9304,10,100,1e-05,0.01,0.886,4672,4632
20,9404,10,100,1e-05,0.01,0.906,4727,4677
20,9504,10,100,1e-05,0.01,0.904,4777,4727
20,9604,10,100,1e-05,0.01,0.91,4821,4783
20,9704,10,100,1e-05,0.01,0.884,4877,4827
20,9804,10,100,1e-05,0.01,0.876,4923,4881
20,9904,10,100,1e-05,0.01,0.916,4969,4935
20,10004,10,100,1e-05,0.01,0.912,5020,4984
20,10104,10,100,1e-05,0.01,0.914,5072,5032
20,10204,10,100,1e-05,0.01,0.892,5117,5087
20,10304,10,100,1e-05,0.01,0.9,5168,5136
20,10404,10,100,1e-05,0.01,0.922,5217,5187
20,10504,10,100,1e-05,0.01,0.908,5261,5243
20,10604,10,100,1e-05,0.01,0.924,5312,5292
20,10704,10,100,1e-05,0.01,0.92,5361,5343
20,10804,10,100,1e-05,0.01,0.914,5411,5393
20,10904,10,100,1e-05,0.01,0.924,5464,5440
20,11004,10,100,1e-05,0.01,0.924,5511,5493
20,11104,10,100,1e-05,0.01,0.912,5564,5540
20,11204,10,100,1e-05,0.01,0.926,5610,5594
20,11304,10,100,1e-05,0.01,0.924,5667,5637
20,11404,10,100,1e-05,0.01,0.936,5708,5696
20,11504,10,100,1e-05,0.01,0.916,5751,5753
20,11604,10,100,1e-05,0.01,0.932,5800,5804
20,11704,10,100,1e-05,0.01,0.92,5856,5848
20,11804,10,100,1e-05,0.01,0.908,5900,5904
20,11904,10,100,1e-05,0.01,0.93,5952,5952
20,12004,10,100,1e-05,0.01,0.936,5996,6008
20,12104,10,100,1e-05,0.01,0.938,6047,6057
20,12204,10,100,1e-05,0.01,0.942,6099,6105
20,12304,10,100,1e-05,0.01,0.952,6149,6155
20,12404,10,100,1e-05,0.01,0.942,6204,6200
20,12504,10,100,1e-05,0.01,0.94,6255,6249
20,12604,10,100,1e-05,0.01,0.934,6300,6304
20,12704,10,100,1e-05,0.01,0.932,6349,6355
20,12804,10,100,1e-05,0.01,0.948,6389,6415
20,12904,10,100,1e-05,0.01,0.956,6436,6468
20,13004,10,100,1e-05,0.01,0.938,6487,6517
20,13104,10,100,1e-05,0.01,0.932,6533,6571
20,13204,10,100,1e-05,0.01,0.946,6589,6615
20,13304,10,100,1e-05,0.01,0.948,6645,6659
20,13404,10,100,1e-05,0.01,0.96,6688,6716
20,13504,10,100,1e-05,0.01,0.946,6737,6767
20,13604,10,100,1e-05,0.01,0.96,6782,6822
20,13704,10,100,1e-05,0.01,0.956,6823,6881
20,13804,10,100,1e-05,0.01,0.954,6874,6930
20,13904,10,100,1e-05,0.01,0.94,6924,6980
20,14004,10,100,1e-05,0.01,0.954,6977,7027
20,14104,10,100,1e-05,0.01,0.964,7023,7081
20,14204,10,100,1e-05,0.01,0.958,7074,7130
20,14304,10,100,1e-05,0.01,0.96,7113,7191
20,14404,10,100,1e-05,0.01,0.952,7173,7231
20,14504,10,100,1e-05,0.01,0.956,7227,7277
20,14604,10,100,1e-05,0.01,0.962,7281,7323
20,14704,10,100,1e-05,0.01,0.966,7336,7368
20,14804,10,100,1e-05,0.01,0.956,7389,7415
20,14904,10,100,1e-05,0.01,0.95,7443,7461
20,15004,10,100,1e-05,0.01,0.966,7498,7506
1,104,10,100,0.0001,0.01,0.486,57,47
1,204,10,100,0.0001,0.01,0.492,101,103
1,304,10,100,0.0001,0.01,0.524,145,159
1,404,10,100,0.0001,0.01,0.52,205,199
1,504,10,100,0.0001,0.01,0.488,251,253
1,604,10,100,0.0001,0.01,0.5,298,306
1,704,10,100,0.0001,0.01,0.502,343,361
1,804,10,100,0.0001,0.01,0.502,386,418
1,904,10,100,0.0001,0.01,0.484,437,467
1,1004,10,100,0.0001,0.01,0.508,487,517
1,1104,10,100,0.0001,0.01,0.506,542,562
1,1204,10,100,0.0001,0.01,0.498,591,613
1,1304,10,100,0.0001,0.01,0.502,646,658
1,1404,10,100,0.0001,0.01,0.476,692,712
1,1504,10,100,0.0001,0.01,0.526,748,756
1,1604,10,100,0.0001,0.01,0.52,810,794
1,1704,10,100,0.0001,0.01,0.534,855,849
1,1804,10,100,0.0001,0.01,0.53,905,899
1,1904,10,100,0.0001,0.01,0.488,950,954
1,2004,10,100,0.0001,0.01,0.538,992,1012
1,2104,10,100,0.0001,0.01,0.514,1040,1064
1,2204,10,100,0.0001,0.01,0.526,1099,1105
1,2304,10,100,0.0001,0.01,0.52,1138,1166
1,2404,10,100,0.0001,0.01,0.536,1194,1210
1,2504,10,100,0.0001,0.01,0.514,1247,1257
1,2604,10,100,0.0001,0.01,0.518,1292,1312
1,2704,10,100,0.0001,0.01,0.52,1333,1371
1,2804,10,100,0.0001,0.01,0.522,1391,1413
1,2904,10,100,0.0001,0.01,0.564,1436,1468
1,3004,10,100,0.0001,0.01,0.592,1479,1525
1,3104,10,100,0.0001,0.01,0.586,1525,1579
1,3204,10,100,0.0001,0.01,0.596,1565,1639
1,3304,10,100,0.0001,0.01,0.63,1616,1688
1,3404,10,100,0.0001,0.01,0.616,1670,1734
1,3504,10,100,0.0001,0.01,0.64,1723,1781
1,3604,10,100,0.0001,0.01,0.64,1773,1831
1,3704,10,100,0.0001,0.01,0.648,1823,1881
1,3804,10,100,0.0001,0.01,0.664,1871,1933
1,3904,10,100,0.0001,0.01,0.64,1920,1984
1,4004,10,100,0.0001,0.01,0.662,1976,2028
1,4104,10,100,0.0001,0.01,0.672,2024,2080
1,4204,10,100,0.0001,0.01,0.658,2071,2133
1,4304,10,100,0.0001,0.01,0.672,2127,2177
1,4404,10,100,0.0001,0.01,0.696,2186,2218
1,4504,10,100,0.0001,0.01,0.682,2232,2272
1,4604,10,100,0.0001,0.01,0.688,2270,2334
1,4704,10,100,0.0001,0.01,0.67,2315,2389
1,4804,10,100,0.0001,0.01,0.686,2373,2431
1,4904,10,100,0.0001,0.01,0.704,2424,2480
1,5004,10,100,0.0001,0.01,0.704,2486,2518
1,5104,10,100,0.0001,0.01,0.704,2546,2558
1,5204,10,100,0.0001,0.01,0.718,2595,2609
1,5304,10,100,0.0001,0.01,0.712,2646,2658
1,5404,10,100,0.0001,0.01,0.704,2703,2701
1,5504,10,100,0.0001,0.01,0.726,2744,2760
1,5604,10,100,0.0001,0.01,0.742,2796,2808
1,5704,10,100,0.0001,0.01,0.744,2843,2861
1,5804,10,100,0.0001,0.01,0.75,2899,2905
1,5904,10,100,0.0001,0.01,0.75,2951,2953
1,6004,10,100,0.0001,0.01,0.764,2988,3016
1,6104,10,100,0.0001,0.01,0.796,3044,3060
1,6204,10,100,0.0001,0.01,0.75,3085,3119
1,6304,10,100,0.0001,0.01,0.78,3138,3166
1,6404,10,100,0.0001,0.01,0.784,3186,3218
1,6504,10,100,0.0001,0.01,0.792,3243,3261
1,6604,10,100,0.0001,0.01,0.766,3299,3305
1,6704,10,100,0.0001,0.01,0.784,3344,3360
1,6804,10,100,0.0001,0.01,0.79,3392,3412
1,6904,10,100,0.0001,0.01,0.77,3440,3464
1,7004,10,100,0.0001,0.01,0.792,3491,3513
1,7104,10,100,0.0001,0.01,0.782,3545,3559
1,7204,10,100,0.0001,0.01,0.774,3596,3608
1,7304,10,100,0.0001,0.01,0.786,3646,3658
1,7404,10,100,0.0001,0.01,0.788,3692,3712
1,7504,10,100,0.0001,0.01,0.798,3747,3757
1,7604,10,100,0.0001,0.01,0.808,3799,3805
1,7704,10,100,0.0001,0.01,0.792,3849,3855
1,7804,10,100,0.0001,0.01,0.806,3891,3913
1,7904,10,100,0.0001,0.01,0.78,3944,3960
1,8004,10,100,0.0001,0.01,0.794,3989,4015
1,8104,10,100,0.0001,0.01,0.794,4044,4060
1,8204,10,100,0.0001,0.01,0.796,4096,4108
1,8304,10,100,0.0001,0.01,0.792,4144,4160
1,8404,10,100,0.0001,0.01,0.77,4188,4216
1,8504,10,100,0.0001,0.01,0.798,4232,4272
1,8604,10,100,0.0001,0.01,0.782,4285,4319
1,8704,10,100,0.0001,0.01,0.776,4335,4369
1,8804,10,100,0.0001,0.01,0.776,4381,4423
1,8904,10,100,0.0001,0.01,0.822,4435,4469
1,9004,10,100,0.0001,0.01,0.802,4490,4514
1,9104,10,100,0.0001,0.01,0.802,4540,4564
1,9204,10,100,0.0001,0.01,0.796,4597,4607
1,9304,10,100,0.0001,0.01,0.76,4646,4658
1,9404,10,100,0.0001,0.01,0.774,4693,4711
1,9504,10,100,0.0001,0.01,0.794,4746,4758
1,9604,10,100,0.0001,0.01,0.8,4796,4808
1,9704,10,100,0.0001,0.01,0.81,4844,4860
1,9804,10,100,0.0001,0.01,0.784,4906,4898
1,9904,10,100,0.0001,0.01,0.782,4955,4949
1,10004,10,100,0.0001,0.01,0.798,5006,4998
1,10104,10,100,0.0001,0.01,0.776,5055,5049
1,10204,10,100,0.0001,0.01,0.804,5109,5095
1,10304,10,100,0.0001,0.01,0.816,5155,5149
1,10404,10,100,0.0001,0.01,0.802,5208,5196
1,10504,10,100,0.0001,0.01,0.822,5267,5237
1,10604,10,100,0.0001,0.01,0.816,5320,5284
1,10704,10,100,0.0001,0.01,0.798,5362,5342
1,10804,10,100,0.0001,0.01,0.826,5411,5393
1,10904,10,100,0.0001,0.01,0.842,5459,5445
1,11004,10,100,0.0001,0.01,0.842,5507,5497
1,11104,10,100,0.0001,0.01,0.822,5559,5545
1,11204,10,100,0.0001,0.01,0.81,5604,5600
1,11304,10,100,0.0001,0.01,0.82,5663,5641
1,11404,10,100,0.0001,0.01,0.834,5707,5697
1,11504,10,100,0.0001,0.01,0.848,5752,5752
1,11604,10,100,0.0001,0.01,0.836,5795,5809
1,11704,10,100,0.0001,0.01,0.862,5856,5848
1,11804,10,100,0.0001,0.01,0.828,5909,5895
1,11904,10,100,0.0001,0.01,0.828,5946,5958
1,12004,10,100,0.0001,0.01,0.844,5997,6007
1,12104,10,100,0.0001,0.01,0.838,6045,6059
1,12204,10,100,0.0001,0.01,0.856,6085,6119
1,12304,10,100,0.0001,0.01,0.834,6146,6158
1,12404,10,100,0.0001,0.01,0.838,6201,6203
1,12504,10,100,0.0001,0.01,0.832,6252,6252
1,12604,10,100,0.0001,0.01,0.836,6299,6305
1,12704,10,100,0.0001,0.01,0.842,6347,6357
1,12804,10,100,0.0001,0.01,0.832,6393,6411
1,12904,10,100,0.0001,0.01,0.866,6448,6456
1,13004,10,100,0.0001,0.01,0.89,6495,6509
1,13104,10,100,0.0001,0.01,0.872,6552,6552
1,13204,10,100,0.0001,0.01,0.896,6601,6603
1,13304,10,100,0.0001,0.01,0.848,6665,6639
1,13404,10,100,0.0001,0.01,0.87,6711,6693
1,13504,10,100,0.0001,0.01,0.864,6760,6744
1,13604,10,100,0.0001,0.01,0.876,6813,6791
1,13704,10,100,0.0001,0.01,0.862,6863,6841
1,13804,10,100,0.0001,0.01,0.864,6908,6896
1,13904,10,100,0.0001,0.01,0.882,6958,6946
1,14004,10,100,0.0001,0.01,0.882,6996,7008
1,14104,10,100,0.0001,0.01,0.868,7049,7055
1,14204,10,100,0.0001,0.01,0.872,7110,7094
1,14304,10,100,0.0001,0.01,0.878,7161,7143
1,14404,10,100,0.0001,0.01,0.862,7212,7192
1,14504,10,100,0.0001,0.01,0.892,7261,7243
1,14604,10,100,0.0001,0.01,0.884,7309,7295
1,14704,10,100,0.0001,0.01,0.882,7359,7345
1,14804,10,100,0.0001,0.01,0.892,7407,7397
1,14904,10,100,0.0001,0.01,0.886,7465,7439
1,15004,10,100,0.0001,0.01,0.904,7509,7495
2,104,10,100,0.0001,0.01,0.486,49,55
2,204,10,100,0.0001,0.01,0.488,97,107
2,304,10,100,0.0001,0.01,0.498,138,166
2,404,10,100,0.0001,0.01,0.476,186,218
2,504,10,100,0.0001,0.01,0.492,239,265
2,604,10,100,0.0001,0.01,0.5,288,316
2,704,10,100,0.0001,0.01,0.476,339,365
2,804,10,100,0.0001,0.01,0.482,383,421
2,904,10,100,0.0001,0.01,0.49,429,475
2,1004,10,100,0.0001,0.01,0.474,480,524
2,1104,10,100,0.0001,0.01,0.492,526,578
2,1204,10,100,0.0001,0.01,0.5,582,622
2,1304,10,100,0.0001,0.01,0.506,631,673
2,1404,10,100,0.0001,0.01,0.528,688,716
2,1504,10,100,0.0001,0.01,0.474,746,758
2,1604,10,100,0.0001,0.01,0.532,796,808
2,1704,10,100,0.0001,0.01,0.528,841,863
2,1804,10,100,0.0001,0.01,0.54,893,911
2,1904,10,100,0.0001,0.01,0.552,941,963
2,2004,10,100,0.0001,0.01,0.588,990,1014
2,2104,10,100,0.0001,0.01,0.584,1043,1061
2,2204,10,100,0.0001,0.01,0.614,1099,1105
2,2304,10,100,0.0001,0.01,0.632,1151,1153
2,2404,10,100,0.0001,0.01,0.698,1204,1200
2,2504,10,100,0.0001,0.01,0.67,1247,1257
2,2604,10,100,0.0001,0.01,0.722,1303,1301
2,2704,10,100,0.0001,0.01,0.768,1356,1348
2,2804,10,100,0.0001,0.01,0.782,1398,1406
2,2904,10,100,0.0001,0.01,0.782,1446,1458
2,3004,10,100,0.0001,0.01,0.816,1494,1510
2,3104,10,100,0.0001,0.01,0.822,1547,1557
2,3204,10,100,0.0001,0.01,0.836,1590,1614
2,3304,10,100,0.0001,0.01,0.828,1639,1665
2,3404,10,100,0.0001,0.01,0.832,1693,1711
2,3504,10,100,0.0001,0.01,0.814,1745,1759
2,3604,10,100,0.0001,0.01,0.844,1790,1814
2,3704,10,100,0.0001,0.01,0.884,1836,1868
2,3804,10,100,0.0001,0.01,0.89,1883,1921
2,3904,10,100,0.0001,0.01,0.878,1935,1969
2,4004,10,100,0.0001,0.01,0.896,1984,2020
2,4104,10,100,0.0001,0.01,0.918,2041,2063
2,4204,10,100,0.0001,0.01,0.91,2095,2109
2,4304,10,100,0.0001,0.01,0.902,2147,2157
2,4404,10,100,0.0001,0.01,0.908,2196,2208
2,4504,10,100,0.0001,0.01,0.912,2249,2255
2,4604,10,100,0.0001,0.01,0.918,2292,2312
2,4704,10,100,0.0001,0.01,0.906,2349,2355
2,4804,10,100,0.0001,0.01,0.888,2388,2416
2,4904,10,100,0.0001,0.01,0.92,2447,2457
2,5004,10,100,0.0001,0.01,0.91,2497,2507
2,5104,10,100,0.0001,0.01,0.914,2547,2557
2,5204,10,100,0.0001,0.01,0.938,2601,2603
2,5304,10,100,0.0001,0.01,0.948,2650,2654
2,5404,10,100,0.0001,0.01,0.912,2702,2702
2,5504,10,100,0.0001,0.01,0.946,2757,2747
2,5604,10,100,0.0001,0.01,0.95,2801,2803
2,5704,10,100,0.0001,0.01,0.954,2854,2850
2,5804,10,100,0.0001,0.01,0.952,2906,2898
2,5904,10,100,0.0001,0.01,0.962,2951,2953
2,6004,10,100,0.0001,0.01,0.948,3003,3001
2,6104,10,100,0.0001,0.01,0.912,3054,3050
2,6204,10,100,0.0001,0.01,0.956,3106,3098
2,6304,10,100,0.0001,0.01,0.96,3157,3147
2,6404,10,100,0.0001,0.01,0.96,3213,3191
2,6504,10,100,0.0001,0.01,0.972,3264,3240
2,6604,10,100,0.0001,0.01,0.97,3315,3289
2,6704,10,100,0.0001,0.01,0.974,3366,3338
2,6804,10,100,0.0001,0.01,0.97,3414,3390
2,6904,10,100,0.0001,0.01,0.97,3459,3445
2,7004,10,100,0.0001,0.01,0.972,3512,3492
2,7104,10,100,0.0001,0.01,0.97,3570,3534
2,7204,10,100,0.0001,0.01,0.974,3615,3589
2,7304,10,100,0.0001,0.01,0.962,3661,3643
2,7404,10,100,0.0001,0.01,0.95,3715,3689
2,7504,10,100,0.0001,0.01,0.974,3765,3739
2,7604,10,100,0.0001,0.01,0.968,3812,3792
2,7704,10,100,0.0001,0.01,0.956,3867,3837
2,7804,10,100,0.0001,0.01,0.962,3929,3875
2,7904,10,100,0.0001,0.01,0.978,3978,3926
2,8004,10,100,0.0001,0.01,0.972,4031,3973
2,8104,10,100,0.0001,0.01,0.952,4085,4019
2,8204,10,100,0.0001,0.01,0.958,4138,4066
2,8304,10,100,0.0001,0.01,0.976,4187,4117
2,8404,10,100,0.0001,0.01,0.97,4236,4168
2,8504,10,100,0.0001,0.01,0.974,4284,4220
2,8604,10,100,0.0001,0.01,0.976,4332,4272
2,8704,10,100,0.0001,0.01,0.978,4382,4322
2,8804,10,100,0.0001,0.01,0.968,4433,4371
2,8904,10,100,0.0001,0.01,0.976,4480,4424
2,9004,10,100,0.0001,0.01,0.972,4533,4471
2,9104,10,100,0.0001,0.01,0.974,4584,4520
2,9204,10,100,0.0001,0.01,0.976,4634,4570
2,9304,10,100,0.0001,0.01,0.978,4690,4614
2,9404,10,100,0.0001,0.01,0.98,4742,4662
2,9504,10,100,0.0001,0.01,0.978,4786,4718
2,9604,10,100,0.0001,0.01,0.982,4832,4772
2,9704,10,100,0.0001,0.01,0.982,4878,4826
2,9804,10,100,0.0001,0.01,0.982,4936,4868
2,9904,10,100,0.0001,0.01,0.984,4987,4917
2,10004,10,100,0.0001,0.01,0.958,5036,4968
2,10104,10,100,0.0001,0.01,0.97,5087,5017
2,10204,10,100,0.0001,0.01,0.968,5133,5071
2,10304,10,100,0.0001,0.01,0.974,5185,5119
2,10404,10,100,0.0001,0.01,0.978,5237,5167
2,10504,10,100,0.0001,0.01,0.984,5279,5225
2,10604,10,100,0.0001,0.01,0.982,5328,5276
2,10704,10,100,0.0001,0.01,0.984,5377,5327
2,10804,10,100,0.0001,0.01,0.988,5423,5381
2,10904,10,100,0.0001,0.01,0.988,5470,5434
2,11004,10,100,0.0001,0.01,0.988,5518,5486
2,11104,10,100,0.0001,0.01,0.984,5561,5543
2,11204,10,100,0.0001,0.01,0.982,5619,5585
2,11304,10,100,0.0001,0.01,0.986,5661,5643
2,11404,10,100,0.0001,0.01,0.982,5704,5700
2,11504,10,100,0.0001,0.01,0.988,5753,5751
2,11604,10,100,0.0001,0.01,0.982,5816,5788
2,11704,10,100,0.0001,0.01,0.984,5857,5847
2,11804,10,100,0.0001,0.01,0.962,5912,5892
2,11904,10,100,0.0001,0.01,0.984,5963,5941
2,12004,10,100,0.0001,0.01,0.986,6013,5991
2,12104,10,100,0.0001,0.01,0.986,6053,6051
2,12204,10,100,0.0001,0.01,0.986,6108,6096
2,12304,10,100,0.0001,0.01,0.988,6159,6145
2,12404,10,100,0.0001,0.01,0.986,6213,6191
2,12504,10,100,0.0001,0.01,0.988,6267,6237
2,12604,10,100,0.0001,0.01,0.988,6324,6280
2,12704,10,100,0.0001,0.01,0.992,6372,6332
2,12804,10,100,0.0001,0.01,0.982,6425,6379
2,12904,10,100,0.0001,0.01,0.978,6479,6425
2,13004,10,100,0.0001,0.01,0.974,6527,6477
2,13104,10,100,0.0001,0.01,0.986,6578,6526
2,13204,10,100,0.0001,0.01,0.992,6626,6578
2,13304,10,100,0.0001,0.01,0.992,6675,6629
2,13404,10,100,0.0001,0.01,0.992,6724,6680
2,13504,10,100,0.0001,0.01,0.992,6775,6729
2,13604,10,100,0.0001,0.01,0.992,6821,6783
2,13704,10,100,0.0001,0.01,0.992,6866,6838
2,13804,10,100,0.0001,0.01,0.99,6918,6886
2,13904,10,100,0.0001,0.01,0.99,6972,6932
2,14004,10,100,0.0001,0.01,0.99,7021,6983
2,14104,10,100,0.0001,0.01,0.992,7072,7032
2,14204,10,100,0.0001,0.01,0.992,7114,7090
2,14304,10,100,0.0001,0.01,0.988,7169,7135
2,14404,10,100,0.0001,0.01,0.99,7209,7195
2,14504,10,100,0.0001,0.01,0.976,7261,7243
2,14604,10,100,0.0001,0.01,0.984,7307,7297
2,14704,10,100,0.0001,0.01,0.986,7349,7355
2,14804,10,100,0.0001,0.01,0.99,7393,7411
2,14904,10,100,0.0001,0.01,0.986,7441,7463
2,15004,10,100,0.0001,0.01,0.986,7495,7509
3,104,10,100,0.0001,0.01,0.544,54,50
3,204,10,100,0.0001,0.01,0.498,100,104
3,304,10,100,0.0001,0.01,0.476,160,144
3,404,10,100,0.0001,0.01,0.522,214,190
3,504,10,100,0.0001,0.01,0.552,268,236
3,604,10,100,0.0001,0.01,0.54,320,284
3,704,10,100,0.0001,0.01,0.498,373,331
3,804,10,100,0.0001,0.01,0.51,418,386
3,904,10,100,0.0001,0.01,0.546,459,445
3,1004,10,100,0.0001,0.01,0.51,510,494
3,1104,10,100,0.0001,0.01,0.528,564,540
3,1204,10,100,0.0001,0.01,0.548,607,597
3,1304,10,100,0.0001,0.01,0.5,655,649
3,1404,10,100,0.0001,0.01,0.52,703,701
3,1504,10,100,0.0001,0.01,0.508,762,742
3,1604,10,100,0.0001,0.01,0.538,821,783
3,1704,10,100,0.0001,0.01,0.56,873,831
3,1804,10,100,0.0001,0.01,0.554,925,879
3,1904,10,100,0.0001,0.01,0.552,968,936
3,2004,10,100,0.0001,0.01,0.568,1023,981
3,2104,10,100,0.0001,0.01,0.57,1069,1035
3,2204,10,100,0.0001,0.01,0.608,1114,1090
3,2304,10,100,0.0001,0.01,0.632,1160,1144
3,2404,10,100,0.0001,0.01,0.654,1212,1192
3,2504,10,100,0.0001,0.01,0.66,1259,1245
3,2604,10,100,0.0001,0.01,0.722,1299,1305
3,2704,10,100,0.0001,0.01,0.752,1341,1363
3,2804,10,100,0.0001,0.01,0.814,1396,1408
3,2904,10,100,0.0001,0.01,0.84,1445,1459
3,3004,10,100,0.0001,0.01,0.866,1486,1518
3,3104,10,100,0.0001,0.01,0.864,1541,1563
3,3204,10,100,0.0001,0.01,0.886,1585,1619
3,3304,10,100,0.0001,0.01,0.898,1634,1670
3,3404,10,100,0.0001,0.01,0.91,1675,1729
3,3504,10,100,0.0001,0.01,0.91,1728,1776
3,3604,10,100,0.0001,0.01,0.9,1782,1822
3,3704,10,100,0.0001,0.01,0.876,1831,1873
3,3804,10,100,0.0001,0.01,0.916,1878,1926
3,3904,10,100,0.0001,0.01,0.918,1933,1971
3,4004,10,100,0.0001,0.01,0.918,1986,2018
3,4104,10,100,0.0001,0.01,0.916,2036,2068
3,4204,10,100,0.0001,0.01,0.938,2086,2118
3,4304,10,100,0.0001,0.01,0.946,2129,2175
3,4404,10,100,0.0001,0.01,0.94,2190,2214
3,4504,10,100,0.0001,0.01,0.918,2245,2259
3,4604,10,100,0.0001,0.01,0.938,2304,2300
3,4704,10,100,0.0001,0.01,0.94,2348,2356
3,4804,10,100,0.0001,0.01,0.956,2398,2406
3,4904,10,100,0.0001,0.01,0.952,2449,2455
3,5004,10,100,0.0001,0.01,0.906,2492,2512
3,5104,10,100,0.0001,0.01,0.904,2547,2557
3,5204,10,100,0.0001,0.01,0.952,2596,2608
3,5304,10,100,0.0001,0.01,0.932,2650,2654
3,5404,10,100,0.0001,0.01,0.946,2698,2706
3,5504,10,100,0.0001,0.01,0.958,2751,2753
3,5604,10,100,0.0001,0.01,0.952,2795,2809
3,5704,10,100,0.0001,0.01,0.95,2849,2855
3,5804,10,100,0.0001,0.01,0.962,2902,2902
3,5904,10,100,0.0001,0.01,0.954,2954,2950
3,6004,10,100,0.0001,0.01,0.942,3001,3003
3,6104,10,100,0.0001,0.01,0.964,3048,3056
3,6204,10,100,0.0001,0.01,0.944,3098,3106
3,6304,10,100,0.0001,0.01,0.956,3151,3153
3,6404,10,100,0.0001,0.01,0.954,3208,3196
3,6504,10,100,0.0001,0.01,0.956,3260,3244
3,6604,10,100,0.0001,0.01,0.954,3308,3296
3,6704,10,100,0.0001,0.01,0.958,3353,3351
3,6804,10,100,0.0001,0.01,0.94,3406,3398
3,6904,10,100,0.0001,0.01,0.96,3456,3448
3,7004,10,100,0.0001,0.01,0.966,3508,3496
3,7104,10,100,0.0001,0.01,0.958,3557,3547
3,7204,10,100,0.0001,0.01,0.948,3608,3596
3,7304,10,100,0.0001,0.01,0.948,3658,3646
3,7404,10,100,0.0001,0.01,0.962,3713,3691
3,7504,10,100,0.0001,0.01,0.964,3755,3749
3,7604,10,100,0.0001,0.01,0.968,3809,3795
3,7704,10,100,0.0001,0.01,0.972,3866,3838
3,7804,10,100,0.0001,0.01,0.96,3909,3895
3,7904,10,100,0.0001,0.01,0.966,3962,3942
3,8004,10,100,0.0001,0.01,0.97,4014,3990
3,8104,10,100,0.0001,0.01,0.954,4060,4044
3,8204,10,100,0.0001,0.01,0.968,4119,4085
3,8304,10,100,0.0001,0.01,0.964,4165,4139
3,8404,10,100,0.0001,0.01,0.98,4212,4192
3,8504,10,100,0.0001,0.01,0.978,4251,4253
3,8604,10,100,0.0001,0.01,0.97,4308,4296
3,8704,10,100,0.0001,0.01,0.974,4367,4337
3,8804,10,100,0.0001,0.01,0.984,4418,4386
3,8904,10,100,0.0001,0.01,0.968,4474,4430
3,9004,10,100,0.0001,0.01,0.964,4521,4483
3,9104,10,100,0.0001,0.01,0.972,4581,4523
3,9204,10,100,0.0001,0.01,0.96,4627,4577
3,9304,10,100,0.0001,0.01,0.974,4684,4620
3,9404,10,100,0.0001,0.01,0.964,4737,4667
3,9504,10,100,0.0001,0.01,0.968,4782,4722
3,9604,10,100,0.0001,0.01,0.964,4834,4770
3,9704,10,100,0.0001,0.01,0.974,4883,4821
3,9804,10,100,0.0001,0.01,0.974,4935,4869
3,9904,10,100,0.0001,0.01,0.972,4986,4918
3,10004,10,100,0.0001,0.01,0.974,5033,4971
3,10104,10,100,0.0001,0.01,0.978,5084,5020
3,10204,10,100,0.0001,0.01,0.972,5134,5070
3,10304,10,100,0.0001,0.01,0.976,5188,5116
3,10404,10,100,0.0001,0.01,0.97,5234,5170
3,10504,10,100,0.0001,0.01,0.98,5278,5226
3,10604,10,100,0.0001,0.01,0.986,5328,5276
3,10704,10,100,0.0001,0.01,0.98,5392,5312
3,10804,10,100,0.0001,0.01,0.982,5438,5366
3,10904,10,100,0.0001,0.01,0.986,5489,5415
3,11004,10,100,0.0001,0.01,0.984,5537,5467
3,11104,10,100,0.0001,0.01,0.982,5596,5508
3,11204,10,100,0.0001,0.01,0.97,5644,5560
3,11304,10,100,0.0001,0.01,0.972,5695,5609
3,11404,10,100,0.0001,0.01,0.98,5740,5664
3,11504,10,100,0.0001,0.01,0.982,5786,5718
3,11604,10,100,0.0001,0.01,0.986,5834,5770
3,11704,10,100,0.0001,0.01,0.976,5891,5813
3,11804,10,100,0.0001,0.01,0.984,5931,5873
3,11904,10,100,0.0001,0.01,0.984,5978,5926
3,12004,10,100,0.0001,0.01,0.982,6020,5984
3,12104,10,100,0.0001,0.01,0.988,6068,6036
3,12204,10,100,0.0001,0.01,0.986,6115,6089
3,12304,10,100,0.0001,0.01,0.984,6169,6135
3,12404,10,100,0.0001,0.01,0.982,6212,6192
3,12504,10,100,0.0001,0.01,0.98,6256,6248
3,12604,10,100,0.0001,0.01,0.986,6307,6297
3,12704,10,100,0.0001,0.01,0.988,6353,6351
3,12804,10,100,0.0001,0.01,0.962,6397,6407
3,12904,10,100,0.0001,0.01,0.968,6446,6458
3,13004,10,100,0.0001,0.01,0.97,6489,6515
3,13104,10,100,0.0001,0.01,0.986,6540,6564
3,13204,10,100,0.0001,0.01,0.986,6594,6610
3,13304,10,100,0.0001,0.01,0.992,6645,6659
3,13404,10,100,0.0001,0.01,0.99,6687,6717
3,13504,10,100,0.0001,0.01,0.99,6735,6769
3,13604,10,100,0.0001,0.01,0.992,6787,6817
3,13704,10,100,0.0001,0.01,0.992,6834,6870
3,13804,10,100,0.0001,0.01,0.988,6875,6929
3,13904,10,100,0.0001,0.01,0.99,6933,6971
3,14004,10,100,0.0001,0.01,0.988,6983,7021
3,14104,10,100,0.0001,0.01,0.988,7031,7073
3,14204,10,100,0.0001,0.01,0.992,7083,7121
3,14304,10,100,0.0001,0.01,0.992,7131,7173
3,14404,10,100,0.0001,0.01,0.986,7176,7228
3,14504,10,100,0.0001,0.01,0.988,7227,7277
3,14604,10,100,0.0001,0.01,0.986,7277,7327
3,14704,10,100,0.0001,0.01,0.988,7332,7372
3,14804,10,100,0.0001,0.01,0.992,7382,7422
3,14904,10,100,0.0001,0.01,0.996,7430,7474
3,15004,10,100,0.0001,0.01,0.988,7480,7524
4,104,10,100,0.0001,0.01,0.478,48,56
4,204,10,100,0.0001,0.01,0.49,96,108
4,304,10,100,0.0001,0.01,0.514,147,157
4,404,10,100,0.0001,0.01,0.504,194,210
4,504,10,100,0.0001,0.01,0.502,245,259
4,604,10,100,0.0001,0.01,0.502,287,317
4,704,10,100,0.0001,0.01,0.492,338,366
4,804,10,100,0.0001,0.01,0.516,402,402
4,904,10,100,0.0001,0.01,0.532,459,445
4,1004,10,100,0.0001,0.01,0.536,502,502
4,1104,10,100,0.0001,0.01,0.548,547,557
4,1204,10,100,0.0001,0.01,0.532,590,614
4,1304,10,100,0.0001,0.01,0.54,652,652
4,1404,10,100,0.0001,0.01,0.538,699,705
4,1504,10,100,0.0001,0.01,0.55,761,743
4,1604,10,100,0.0001,0.01,0.566,807,797
4,1704,10,100,0.0001,0.01,0.566,858,846
4,1804,10,100,0.0001,0.01,0.558,910,894
4,1904,10,100,0.0001,0.01,0.552,962,942
4,2004,10,100,0.0001,0.01,0.558,1015,989
4,2104,10,100,0.0001,0.01,0.544,1065,1039
4,2204,10,100,0.0001,0.01,0.56,1117,1087
4,2304,10,100,0.0001,0.01,0.548,1166,1138
4,2404,10,100,0.0001,0.01,0.556,1215,1189
4,2504,10,100,0.0001,0.01,0.584,1278,1226
4,2604,10,100,0.0001,0.01,0.612,1324,1280
4,2704,10,100,0.0001,0.01,0.588,1378,1326
4,2804,10,100,0.0001,0.01,0.564,1437,1367
4,2904,10,100,0.0001,0.01,0.598,1485,1419
4,3004,10,100,0.0001,0.01,0.636,1536,1468
4,3104,10,100,0.0001,0.01,0.618,1591,1513
4,3204,10,100,0.0001,0.01,0.644,1637,1567
4,3304,10,100,0.0001,0.01,0.66,1689,1615
4,3404,10,100,0.0001,0.01,0.644,1741,1663
4,3504,10,100,0.0001,0.01,0.676,1789,1715
4,3604,10,100,0.0001,0.01,0.68,1840,1764
4,3704,10,100,0.0001,0.01,0.658,1892,1812
4,3804,10,100,0.0001,0.01,0.672,1939,1865
4,3904,10,100,0.0001,0.01,0.672,1987,1917
4,4004,10,100,0.0001,0.01,0.674,2029,1975
4,4104,10,100,0.0001,0.01,0.704,2088,2016
4,4204,10,100,0.0001,0.01,0.7,2142,2062
4,4304,10,100,0.0001,0.01,0.672,2186,2118
4,4404,10,100,0.0001,0.01,0.688,2242,2162
4,4504,10,100,0.0001,0.01,0.704,2296,2208
4,4604,10,100,0.0001,0.01,0.702,2329,2275
4,4704,10,100,0.0001,0.01,0.694,2383,2321
4,4804,10,100,0.0001,0.01,0.672,2440,2364
4,4904,10,100,0.0001,0.01,0.72,2488,2416
4,5004,10,100,0.0001,0.01,0.696,2527,2477
4,5104,10,100,0.0001,0.01,0.76,2579,2525
4,5204,10,100,0.0001,0.01,0.728,2623,2581
4,5304,10,100,0.0001,0.01,0.744,2670,2634
4,5404,10,100,0.0001,0.01,0.754,2712,2692
4,5504,10,100,0.0001,0.01,0.75,2758,2746
4,5604,10,100,0.0001,0.01,0.742,2800,2804
4,5704,10,100,0.0001,0.01,0.74,2841,2863
4,5804,10,100,0.0001,0.01,0.772,2889,2915
4,5904,10,100,0.0001,0.01,0.744,2941,2963
4,6004,10,100,0.0001,0.01,0.772,2990,3014
4,6104,10,100,0.0001,0.01,0.762,3049,3055
4,6204,10,100,0.0001,0.01,0.776,3104,3100
4,6304,10,100,0.0001,0.01,0.768,3158,3146
4,6404,10,100,0.0001,0.01,0.766,3210,3194
4,6504,10,100,0.0001,0.01,0.776,3265,3239
4,6604,10,100,0.0001,0.01,0.782,3316,3288
4,6704,10,100,0.0001,0.01,0.784,3360,3344
4,6804,10,100,0.0001,0.01,0.786,3409,3395
4,6904,10,100,0.0001,0.01,0.788,3461,3443
4,7004,10,100,0.0001,0.01,0.806,3512,3492
4,7104,10,100,0.0001,0.01,0.79,3560,3544
4,7204,10,100,0.0001,0.01,0.772,3612,3592
4,7304,10,100,0.0001,0.01,0.798,3661,3643
4,7404,10,100,0.0001,0.01,0.794,3704,3700
4,7504,10,100,0.0001,0.01,0.804,3757,3747
4,7604,10,100,0.0001,0.01,0.81,3804,3800
4,7704,10,100,0.0001,0.01,0.814,3859,3845
4,7804,10,100,0.0001,0.01,0.814,3911,3893
4,7904,10,100,0.0001,0.01,0.832,3960,3944
4,8004,10,100,0.0001,0.01,0.818,4020,3984
4,8104,10,100,0.0001,0.01,0.834,4077,4027
4,8204,10,100,0.0001,0.01,0.82,4126,4078
4,8304,10,100,0.0001,0.01,0.826,4170,4134
4,8404,10,100,0.0001,0.01,0.858,4213,4191
4,8504,10,100,0.0001,0.01,0.852,4259,4245
4,8604,10,100,0.0001,0.01,0.85,4304,4300
4,8704,10,100,0.0001,0.01,0.86,4358,4346
4,8804,10,100,0.0001,0.01,0.822,4405,4399
4,8904,10,100,0.0001,0.01,0.862,4448,4456
4,9004,10,100,0.0001,0.01,0.864,4508,4496
4,9104,10,100,0.0001,0.01,0.844,4548,4556
4,9204,10,100,0.0001,0.01,0.856,4609,4595
4,9304,10,100,0.0001,0.01,0.854,4663,4641
4,9404,10,100,0.0001,0.01,0.86,4702,4702
4,9504,10,100,0.0001,0.01,0.89,4756,4748
4,9604,10,100,0.0001,0.01,0.868,4812,4792
4,9704,10,100,0.0001,0.01,0.884,4855,4849
4,9804,10,100,0.0001,0.01,0.846,4899,4905
4,9904,10,100,0.0001,0.01,0.894,4952,4952
4,10004,10,100,0.0001,0.01,0.89,5001,5003
4,10104,10,100,0.0001,0.01,0.88,5051,5053
4,10204,10,100,0.0001,0.01,0.884,5099,5105
4,10304,10,100,0.0001,0.01,0.89,5148,5156
4,10404,10,100,0.0001,0.01,0.886,5203,5201
4,10504,10,100,0.0001,0.01,0.874,5249,5255
4,10604,10,100,0.0001,0.01,0.89,5300,5304
4,10704,10,100,0.0001,0.01,0.838,5351,5353
4,10804,10,100,0.0001,0.01,0.89,5403,5401
4,10904,10,100,0.0001,0.01,0.906,5451,5453
4,11004,10,100,0.0001,0.01,0.92,5512,5492
4,11104,10,100,0.0001,0.01,0.934,5559,5545
4,11204,10,100,0.0001,0.01,0.92,5603,5601
4,11304,10,100,0.0001,0.01,0.912,5652,5652
4,11404,10,100,0.0001,0.01,0.926,5707,5697
4,11504,10,100,0.0001,0.01,0.92,5763,5741
4,11604,10,100,0.0001,0.01,0.918,5811,5793
4,11704,10,100,0.0001,0.01,0.926,5860,5844
4,11804,10,100,0.0001,0.01,0.932,5921,5883
4,11904,10,100,0.0001,0.01,0.938,5966,5938
4,12004,10,100,0.0001,0.01,0.944,6010,5994
4,12104,10,100,0.0001,0.01,0.904,6058,6046
4,12204,10,100,0.0001,0.01,0.9,6106,6098
4,12304,10,100,0.0001,0.01,0.93,6152,6152
4,12404,10,100,0.0001,0.01,0.95,6208,6196
4,12504,10,100,0.0001,0.01,0.95,6253,6251
4,12604,10,100,0.0001,0.01,0.932,6299,6305
4,12704,10,100,0.0001,0.01,0.948,6348,6356
4,12804,10,100,0.0001,0.01,0.94,6397,6407
4,12904,10,100,0.0001,0.01,0.934,6454,6450
4,13004,10,100,0.0001,0.01,0.954,6500,6504
4,13104,10,100,0.0001,0.01,0.954,6551,6553
4,13204,10,100,0.0001,0.01,0.956,6600,6604
4,13304,10,100,0.0001,0.01,0.96,6655,6649
4,13404,10,100,0.0001,0.01,0.954,6710,6694
4,13504,10,100,0.0001,0.01,0.95,6761,6743
4,13604,10,100,0.0001,0.01,0.958,6813,6791
4,13704,10,100,0.0001,0.01,0.966,6865,6839
4,13804,10,100,0.0001,0.01,0.972,6915,6889
4,13904,10,100,0.0001,0.01,0.974,6961,6943
4,14004,10,100,0.0001,0.01,0.964,7016,6988
4,14104,10,100,0.0001,0.01,0.974,7068,7036
4,14204,10,100,0.0001,0.01,0.976,7118,7086
4,14304,10,100,0.0001,0.01,0.962,7171,7133
4,14404,10,100,0.0001,0.01,0.948,7217,7187
4,14504,10,100,0.0001,0.01,0.958,7266,7238
4,14604,10,100,0.0001,0.01,0.956,7317,7287
4,14704,10,100,0.0001,0.01,0.962,7357,7347
4,14804,10,100,0.0001,0.01,0.974,7413,7391
4,14904,10,100,0.0001,0.01,0.966,7462,7442
4,15004,10,100,0.0001,0.01,0.972,7513,7491
5,104,10,100,0.0001,0.01,0.514,61,43
5,204,10,100,0.0001,0.01,0.51,112,92
5,304,10,100,0.0001,0.01,0.512,167,137
5,404,10,100,0.0001,0.01,0.506,221,183
5,504,10,100,0.0001,0.01,0.51,274,230
5,604,10,100,0.0001,0.01,0.49,319,285
5,704,10,100,0.0001,0.01,0.504,368,336
5,804,10,100,0.0001,0.01,0.518,413,391
5,904,10,100,0.0001,0.01,0.51,464,440
5,1004,10,100,0.0001,0.01,0.522,508,496
5,1104,10,100,0.0001,0.01,0.514,565,539
5,1204,10,100,0.0001,0.01,0.538,618,586
5,1304,10,100,0.0001,0.01,0.542,669,635
5,1404,10,100,0.0001,0.01,0.576,724,680
5,1504,10,100,0.0001,0.01,0.566,778,726
5,1604,10,100,0.0001,0.01,0.566,824,780
5,1704,10,100,0.0001,0.01,0.588,879,825
5,1804,10,100,0.0001,0.01,0.628,941,863
5,1904,10,100,0.0001,0.01,0.612,988,916
5,2004,10,100,0.0001,0.01,0.628,1032,972
5,2104,10,100,0.0001,0.01,0.686,1083,1021
5,2204,10,100,0.0001,0.01,0.658,1126,1078
5,2304,10,100,0.0001,0.01,0.726,1187,1117
5,2404,10,100,0.0001,0.01,0.75,1230,1174
5,2504,10,100,0.0001,0.01,0.774,1282,1222
5,2604,10,100,0.0001,0.01,0.712,1334,1270
5,2704,10,100,0.0001,0.01,0.748,1385,1319
5,2804,10,100,0.0001,0.01,0.766,1437,1367
5,2904,10,100,0.0001,0.01,0.73,1499,1405
5,3004,10,100,0.0001,0.01,0.764,1550,1454
5,3104,10,100,0.0001,0.01,0.788,1601,1503
5,3204,10,100,0.0001,0.01,0.752,1647,1557
5,3304,10,100,0.0001,0.01,0.78,1694,1610
5,3404,10,100,0.0001,0.01,0.774,1736,1668
5,3504,10,100,0.0001,0.01,0.804,1782,1722
5,3604,10,100,0.0001,0.01,0.758,1835,1769
5,3704,10,100,0.0001,0.01,0.796,1892,1812
5,3804,10,100,0.0001,0.01,0.788,1944,1860
5,3904,10,100,0.0001,0.01,0.818,1990,1914
5,4004,10,100,0.0001,0.01,0.756,2043,1961
5,4104,10,100,0.0001,0.01,0.79,2094,2010
5,4204,10,100,0.0001,0.01,0.788,2138,2066
5,4304,10,100,0.0001,0.01,0.826,2185,2119
5,4404,10,100,0.0001,0.01,0.78,2234,2170
5,4504,10,100,0.0001,0.01,0.788,2280,2224
5,4604,10,100,0.0001,0.01,0.706,2337,2267
5,4704,10,100,0.0001,0.01,0.764,2383,2321
5,4804,10,100,0.0001,0.01,0.8,2435,2369
5,4904,10,100,0.0001,0.01,0.794,2483,2421
5,5004,10,100,0.0001,0.01,0.808,2539,2465
5,5104,10,100,0.0001,0.01,0.8,2599,2505
5,5204,10,100,0.0001,0.01,0.8,2652,2552
5,5304,10,100,0.0001,0.01,0.78,2700,2604
5,5404,10,100,0.0001,0.01,0.808,2749,2655
5,5504,10,100,0.0001,0.01,0.83,2789,2715
5,5604,10,100,0.0001,0.01,0.764,2843,2761
5,5704,10,100,0.0001,0.01,0.79,2885,2819
5,5804,10,100,0.0001,0.01,0.828,2931,2873
5,5904,10,100,0.0001,0.01,0.822,2985,2919
5,6004,10,100,0.0001,0.01,0.838,3031,2973
5,6104,10,100,0.0001,0.01,0.846,3085,3019
5,6204,10,100,0.0001,0.01,0.852,3134,3070
5,6304,10,100,0.0001,0.01,0.812,3188,3116
5,6404,10,100,0.0001,0.01,0.834,3240,3164
5,6504,10,100,0.0001,0.01,0.836,3284,3220
5,6604,10,100,0.0001,0.01,0.86,3333,3271
5,6704,10,100,0.0001,0.01,0.838,3373,3331
5,6804,10,100,0.0001,0.01,0.834,3419,3385
5,6904,10,100,0.0001,0.01,0.852,3467,3437
5,7004,10,100,0.0001,0.01,0.862,3510,3494
5,7104,10,100,0.0001,0.01,0.852,3561,3543
5,7204,10,100,0.0001,0.01,0.86,3608,3596
5,7304,10,100,0.0001,0.01,0.884,3657,3647
5,7404,10,100,0.0001,0.01,0.85,3706,3698
5,7504,10,100,0.0001,0.01,0.884,3762,3742
5,7604,10,100,0.0001,0.01,0.82,3806,3798
5,7704,10,100,0.0001,0.01,0.812,3859,3845
5,7804,10,100,0.0001,0.01,0.824,3917,3887
5,7904,10,100,0.0001,0.01,0.87,3972,3932
5,8004,10,100,0.0001,0.01,0.844,4022,3982
5,8104,10,100,0.0001,0.01,0.86,4073,4031
5,8204,10,100,0.0001,0.01,0.874,4120,4084
5,8304,10,100,0.0001,0.01,0.874,4164,4140
5,8404,10,100,0.0001,0.01,0.868,4216,4188
5,8504,10,100,0.0001,0.01,0.906,4269,4235
5,8604,10,100,0.0001,0.01,0.894,4319,4285
5,8704,10,100,0.0001,0.01,0.91,4376,4328
5,8804,10,100,0.0001,0.01,0.85,4423,4381
5,8904,10,100,0.0001,0.01,0.84,4475,4429
5,9004,10,100,0.0001,0.01,0.868,4521,4483
5,9104,10,100,0.0001,0.01,0.874,4573,4531
5,9204,10,100,0.0001,0.01,0.892,4619,4585
5,9304,10,100,0.0001,0.01,0.896,4667,4637
5,9404,10,100,0.0001,0.01,0.886,4712,4692
5,9504,10,100,0.0001,0.01,0.892,4758,4746
5,9604,10,100,0.0001,0.01,0.894,4807,4797
5,9704,10,100,0.0001,0.01,0.874,4854,4850
5,9804,10,100,0.0001,0.01,0.854,4905,4899
5,9904,10,100,0.0001,0.01,0.892,4948,4956
5,10004,10,100,0.0001,0.01,0.894,4999,5005
5,10104,10,100,0.0001,0.01,0.896,5044,5060
5,10204,10,100,0.0001,0.01,0.892,5099,5105
5,10304,10,100,0.0001,0.01,0.9,5151,5153
5,10404,10,100,0.0001,0.01,0.844,5199,5205
5,10504,10,100,0.0001,0.01,0.916,5255,5249
5,10604,10,100,0.0001,0.01,0.91,5306,5298
5,10704,10,100,0.0001,0.01,0.928,5355,5349
5,10804,10,100,0.0001,0.01,0.918,5406,5398
5,10904,10,100,0.0001,0.01,0.932,5454,5450
5,11004,10,100,0.0001,0.01,0.926,5502,5502
5,11104,10,100,0.0001,0.01,0.918,5557,5547
5,11204,10,100,0.0001,0.01,0.928,5603,5601
5,11304,10,100,0.0001,0.01,0.89,5644,5660
5,11404,10,100,0.0001,0.01,0.896,5693,5711
5,11504,10,100,0.0001,0.01,0.934,5741,5763
5,11604,10,100,0.0001,0.01,0.908,5797,5807
5,11704,10,100,0.0001,0.01,0.932,5848,5856
5,11804,10,100,0.0001,0.01,0.922,5896,5908
5,11904,10,100,0.0001,0.01,0.936,5942,5962
5,12004,10,100,0.0001,0.01,0.924,5994,6010
5,12104,10,100,0.0001,0.01,0.914,6048,6056
5,12204,10,100,0.0001,0.01,0.93,6110,6094
5,12304,10,100,0.0001,0.01,0.906,6154,6150
5,12404,10,100,0.0001,0.01,0.828,6201,6203
5,12504,10,100,0.0001,0.01,0.816,6252,6252
5,12604,10,100,0.0001,0.01,0.854,6305,6299
5,12704,10,100,0.0001,0.01,0.912,6361,6343
5,12804,10,100,0.0001,0.01,0.936,6414,6390
5,12904,10,100,0.0001,0.01,0.928,6465,6439
5,13004,10,100,0.0001,0.01,0.938,6517,6487
5,13104,10,100,0.0001,0.01,0.93,6562,6542
5,13204,10,100,0.0001,0.01,0.944,6608,6596
5,13304,10,100,0.0001,0.01,0.948,6656,6648
5,13404,10,100,0.0001,0.01,0.94,6704,6700
5,13504,10,100,0.0001,0.01,0.948,6750,6754
5,13604,10,100,0.0001,0.01,0.952,6802,6802
5,13704,10,100,0.0001,0.01,0.942,6852,6852
5,13804,10,100,0.0001,0.01,0.95,6898,6906
5,13904,10,100,0.0001,0.01,0.906,6946,6958
5,14004,10,100,0.0001,0.01,0.95,6997,7007
5,14104,10,100,0.0001,0.01,0.938,7041,7063
5,14204,10,100,0.0001,0.01,0.952,7088,7116
5,14304,10,100,0.0001,0.01,0.948,7142,7162
5,14404,10,100,0.0001,0.01,0.968,7194,7210
5,14504,10,100,0.0001,0.01,0.962,7242,7262
5,14604,10,100,0.0001,0.01,0.968,7296,7308
5,14704,10,100,0.0001,0.01,0.962,7349,7355
5,14804,10,100,0.0001,0.01,0.964,7400,7404
5,14904,10,100,0.0001,0.01,0.96,7450,7454
5,15004,10,100,0.0001,0.01,0.914,7495,7509
6,104,10,100,0.0001,0.01,0.466,44,60
6,204,10,100,0.0001,0.01,0.514,96,108
6,304,10,100,0.0001,0.01,0.48,158,146
6,404,10,100,0.0001,0.01,0.476,223,181
6,504,10,100,0.0001,0.01,0.492,268,236
6,604,10,100,0.0001,0.01,0.496,319,285
6,704,10,100,0.0001,0.01,0.514,366,338
6,804,10,100,0.0001,0.01,0.494,417,387
6,904,10,100,0.0001,0.01,0.496,468,436
6,1004,10,100,0.0001,0.01,0.532,517,487
6,1104,10,100,0.0001,0.01,0.534,567,537
6,1204,10,100,0.0001,0.01,0.54,626,578
6,1304,10,100,0.0001,0.01,0.512,675,629
6,1404,10,100,0.0001,0.01,0.56,728,676
6,1504,10,100,0.0001,0.01,0.546,778,726
6,1604,10,100,0.0001,0.01,0.558,828,776
6,1704,10,100,0.0001,0.01,0.544,885,819
6,1804,10,100,0.0001,0.01,0.554,931,873
6,1904,10,100,0.0001,0.01,0.538,977,927
6,2004,10,100,0.0001,0.01,0.562,1022,982
6,2104,10,100,0.0001,0.01,0.55,1067,1037
6,2204,10,100,0.0001,0.01,0.566,1111,1093
6,2304,10,100,0.0001,0.01,0.568,1167,1137
6,2404,10,100,0.0001,0.01,0.55,1220,1184
6,2504,10,100,0.0001,0.01,0.57,1268,1236
6,2604,10,100,0.0001,0.01,0.56,1316,1288
6,2704,10,100,0.0001,0.01,0.574,1367,1337
6,2804,10,100,0.0001,0.01,0.584,1429,1375
6,2904,10,100,0.0001,0.01,0.562,1472,1432
6,3004,10,100,0.0001,0.01,0.552,1519,1485
6,3104,10,100,0.0001,0.01,0.586,1569,1535
6,3204,10,100,0.0001,0.01,0.58,1623,1581
6,3304,10,100,0.0001,0.01,0.596,1678,1626
6,3404,10,100,0.0001,0.01,0.62,1727,1677
6,3504,10,100,0.0001,0.01,0.62,1766,1738
6,3604,10,100,0.0001,0.01,0.602,1820,1784
6,3704,10,100,0.0001,0.01,0.6,1868,1836
6,3804,10,100,0.0001,0.01,0.652,1916,1888
6,3904,10,100,0.0001,0.01,0.646,1964,1940
6,4004,10,100,0.0001,0.01,0.644,2004,2000
6,4104,10,100,0.0001,0.01,0.668,2055,2049
6,4204,10,100,0.0001,0.01,0.668,2097,2107
6,4304,10,100,0.0001,0.01,0.654,2151,2153
6,4404,10,100,0.0001,0.01,0.678,2193,2211
6,4504,10,100,0.0001,0.01,0.654,2237,2267
6,4604,10,100,0.0001,0.01,0.658,2291,2313
6,4704,10,100,0.0001,0.01,0.698,2344,2360
6,4804,10,100,0.0001,0.01,0.698,2390,2414
6,4904,10,100,0.0001,0.01,0.72,2439,2465
6,5004,10,100,0.0001,0.01,0.71,2485,2519
6,5104,10,100,0.0001,0.01,0.714,2532,2572
6,5204,10,100,0.0001,0.01,0.67,2581,2623
6,5304,10,100,0.0001,0.01,0.718,2633,2671
6,5404,10,100,0.0001,0.01,0.72,2680,2724
6,5504,10,100,0.0001,0.01,0.738,2728,2776
6,5604,10,100,0.0001,0.01,0.744,2783,2821
6,5704,10,100,0.0001,0.01,0.754,2836,2868
6,5804,10,100,0.0001,0.01,0.744,2884,2920
6,5904,10,100,0.0001,0.01,0.734,2939,2965
6,6004,10,100,0.0001,0.01,0.748,2988,3016
6,6104,10,100,0.0001,0.01,0.728,3035,3069
6,6204,10,100,0.0001,0.01,0.768,3084,3120
6,6304,10,100,0.0001,0.01,0.744,3135,3169
6,6404,10,100,0.0001,0.01,0.768,3193,3211
6,6504,10,100,0.0001,0.01,0.772,3246,3258
6,6604,10,100,0.0001,0.01,0.74,3294,3310
6,6704,10,100,0.0001,0.01,0.746,3346,3358
6,6804,10,100,0.0001,0.01,0.742,3389,3415
6,6904,10,100,0.0001,0.01,0.692,3436,3468
6,7004,10,100,0.0001,0.01,0.726,3484,3520
6,7104,10,100,0.0001,0.01,0.76,3529,3575
6,7204,10,100,0.0001,0.01,0.752,3580,3624
6,7304,10,100,0.0001,0.01,0.772,3630,3674
6,7404,10,100,0.0001,0.01,0.742,3674,3730
6,7504,10,100,0.0001,0.01,0.772,3726,3778
6,7604,10,100,0.0001,0.01,0.768,3790,3814
6,7704,10,100,0.0001,0.01,0.74,3845,3859
6,7804,10,100,0.0001,0.01,0.772,3894,3910
6,7904,10,100,0.0001,0.01,0.724,3953,3951
6,8004,10,100,0.0001,0.01,0.768,3994,4010
6,8104,10,100,0.0001,0.01,0.75,4041,4063
6,8204,10,100,0.0001,0.01,0.778,4092,4112
6,8304,10,100,0.0001,0.01,0.782,4146,4158
6,8404,10,100,0.0001,0.01,0.778,4203,4201
6,8504,10,100,0.0001,0.01,0.802,4248,4256
6,8604,10,100,0.0001,0.01,0.802,4294,4310
6,8704,10,100,0.0001,0.01,0.802,4350,4354
6,8804,10,100,0.0001,0.01,0.79,4402,4402
6,8904,10,100,0.0001,0.01,0.776,4449,4455
6,9004,10,100,0.0001,0.01,0.804,4493,4511
6,9104,10,100,0.0001,0.01,0.784,4549,4555
6,9204,10,100,0.0001,0.01,0.804,4601,4603
6,9304,10,100,0.0001,0.01,0.788,4658,4646
6,9404,10,100,0.0001,0.01,0.812,4705,4699
6,9504,10,100,0.0001,0.01,0.8,4754,4750
6,9604,10,100,0.0001,0.01,0.792,4807,4797
6,9704,10,100,0.0001,0.01,0.812,4861,4843
6,9804,10,100,0.0001,0.01,0.806,4910,4894
6,9904,10,100,0.0001,0.01,0.808,4952,4952
6,10004,10,100,0.0001,0.01,0.824,4997,5007
6,10104,10,100,0.0001,0.01,0.824,5044,5060
6,10204,10,100,0.0001,0.01,0.788,5099,5105
6,10304,10,100,0.0001,0.01,0.814,5155,5149
6,10404,10,100,0.0001,0.01,0.788,5200,5204
6,10504,10,100,0.0001,0.01,0.8,5252,5252
6,10604,10,100,0.0001,0.01,0.82,5301,5303
6,10704,10,100,0.0001,0.01,0.8,5354,5350
6,10804,10,100,0.0001,0.01,0.818,5402,5402
6,10904,10,100,0.0001,0.01,0.812,5462,5442
6,11004,10,100,0.0001,0.01,0.816,5516,5488
6,11104,10,100,0.0001,0.01,0.82,5568,5536
6,11204,10,100,0.0001,0.01,0.83,5622,5582
6,11304,10,100,0.0001,0.01,0.81,5671,5633
6,11404,10,100,0.0001,0.01,0.834,5722,5682
6,11504,10,100,0.0001,0.01,0.822,5772,5732
6,11604,10,100,0.0001,0.01,0.828,5812,5792
6,11704,10,100,0.0001,0.01,0.824,5863,5841
6,11804,10,100,0.0001,0.01,0.81,5906,5898
6,11904,10,100,0.0001,0.01,0.828,5948,5956
6,12004,10,100,0.0001,0.01,0.832,6003,6001
6,12104,10,100,0.0001,0.01,0.832,6059,6045
6,12204,10,100,0.0001,0.01,0.828,6111,6093
6,12304,10,100,0.0001,0.01,0.846,6155,6149
6,12404,10,100,0.0001,0.01,0.866,6207,6197
6,12504,10,100,0.0001,0.01,0.818,6265,6239
6,12604,10,100,0.0001,0.01,0.84,6310,6294
6,12704,10,100,0.0001,0.01,0.83,6348,6356
6,12804,10,100,0.0001,0.01,0.834,6398,6406
6,12904,10,100,0.0001,0.01,0.832,6447,6457
6,13004,10,100,0.0001,0.01,0.84,6492,6512
6,13104,10,100,0.0001,0.01,0.842,6541,6563
6,13204,10,100,0.0001,0.01,0.848,6593,6611
6,13304,10,100,0.0001,0.01,0.858,6645,6659
6,13404,10,100,0.0001,0.01,0.856,6691,6713
6,13504,10,100,0.0001,0.01,0.862,6748,6756
6,13604,10,100,0.0001,0.01,0.842,6790,6814
6,13704,10,100,0.0001,0.01,0.868,6844,6860
6,13804,10,100,0.0001,0.01,0.854,6887,6917
6,13904,10,100,0.0001,0.01,0.852,6939,6965
6,14004,10,100,0.0001,0.01,0.866,6990,7014
6,14104,10,100,0.0001,0.01,0.868,7048,7056
6,14204,10,100,0.0001,0.01,0.86,7103,7101
6,14304,10,100,0.0001,0.01,0.872,7149,7155
6,14404,10,100,0.0001,0.01,0.862,7198,7206
6,14504,10,100,0.0001,0.01,0.876,7242,7262
6,14604,10,100,0.0001,0.01,0.86,7290,7314
6,14704,10,100,0.0001,0.01,0.856,7337,7367
6,14804,10,100,0.0001,0.01,0.856,7396,7408
6,14904,10,100,0.0001,0.01,0.88,7445,7459
6,15004,10,100,0.0001,0.01,0.88,7510,7494
7,104,10,100,0.0001,0.01,0.48,58,46
7,204,10,100,0.0001,0.01,0.524,108,96
7,304,10,100,0.0001,0.01,0.5,152,152
7,404,10,100,0.0001,0.01,0.484,201,203
7,504,10,100,0.0001,0.01,0.478,250,254
7,604,10,100,0.0001,0.01,0.48,293,311
7,704,10,100,0.0001,0.01,0.482,344,360
7,804,10,100,0.0001,0.01,0.482,393,411
7,904,10,100,0.0001,0.01,0.472,446,458
7,1004,10,100,0.0001,0.01,0.484,493,511
7,1104,10,100,0.0001,0.01,0.5,540,564
7,1204,10,100,0.0001,0.01,0.478,585,619
7,1304,10,100,0.0001,0.01,0.464,628,676
7,1404,10,100,0.0001,0.01,0.496,690,714
7,1504,10,100,0.0001,0.01,0.476,745,759
7,1604,10,100,0.0001,0.01,0.466,794,810
7,1704,10,100,0.0001,0.01,0.488,835,869
7,1804,10,100,0.0001,0.01,0.514,888,916
7,1904,10,100,0.0001,0.01,0.502,942,962
7,2004,10,100,0.0001,0.01,0.506,992,1012
7,2104,10,100,0.0001,0.01,0.498,1046,1058
7,2204,10,100,0.0001,0.01,0.48,1101,1103
7,2304,10,100,0.0001,0.01,0.522,1147,1157
7,2404,10,100,0.0001,0.01,0.528,1202,1202
7,2504,10,100,0.0001,0.01,0.522,1249,1255
7,2604,10,100,0.0001,0.01,0.518,1293,1311
7,2704,10,100,0.0001,0.01,0.51,1344,1360
7,2804,10,100,0.0001,0.01,0.546,1395,1409
7,2904,10,100,0.0001,0.01,0.562,1440,1464
7,3004,10,100,0.0001,0.01,0.55,1490,1514
7,3104,10,100,0.0001,0.01,0.592,1535,1569
7,3204,10,100,0.0001,0.01,0.606,1583,1621
7,3304,10,100,0.0001,0.01,0.576,1629,1675
7,3404,10,100,0.0001,0.01,0.602,1673,1731
7,3504,10,100,0.0001,0.01,0.61,1724,1780
7,3604,10,100,0.0001,0.01,0.636,1777,1827
7,3704,10,100,0.0001,0.01,0.658,1834,1870
7,3804,10,100,0.0001,0.01,0.682,1878,1926
7,3904,10,100,0.0001,0.01,0.624,1924,1980
7,4004,10,100,0.0001,0.01,0.65,1965,2039
7,4104,10,100,0.0001,0.01,0.672,2019,2085
7,4204,10,100,0.0001,0.01,0.706,2064,2140
7,4304,10,100,0.0001,0.01,0.706,2114,2190
7,4404,10,100,0.0001,0.01,0.702,2163,2241
7,4504,10,100,0.0001,0.01,0.682,2216,2288
7,4604,10,100,0.0001,0.01,0.664,2267,2337
7,4704,10,100,0.0001,0.01,0.648,2316,2388
7,4804,10,100,0.0001,0.01,0.708,2371,2433
7,4904,10,100,0.0001,0.01,0.682,2416,2488
7,5004,10,100,0.0001,0.01,0.686,2460,2544
7,5104,10,100,0.0001,0.01,0.718,2515,2589
7,5204,10,100,0.0001,0.01,0.714,2566,2638
7,5304,10,100,0.0001,0.01,0.702,2613,2691
7,5404,10,100,0.0001,0.01,0.712,2666,2738
7,5504,10,100,0.0001,0.01,0.742,2724,2780
7,5604,10,100,0.0001,0.01,0.726,2775,2829
7,5704,10,100,0.0001,0.01,0.728,2836,2868
7,5804,10,100,0.0001,0.01,0.754,2884,2920
7,5904,10,100,0.0001,0.01,0.732,2937,2967
7,6004,10,100,0.0001,0.01,0.734,2997,3007
7,6104,10,100,0.0001,0.01,0.75,3048,3056
7,6204,10,100,0.0001,0.01,0.73,3096,3108
7,6304,10,100,0.0001,0.01,0.728,3149,3155
7,6404,10,100,0.0001,0.01,0.752,3196,3208
7,6504,10,100,0.0001,0.01,0.762,3241,3263
7,6604,10,100,0.0001,0.01,0.784,3294,3310
7,6704,10,100,0.0001,0.01,0.78,3336,3368
7,6804,10,100,0.0001,0.01,0.778,3391,3413
7,6904,10,100,0.0001,0.01,0.788,3451,3453
7,7004,10,100,0.0001,0.01,0.784,3504,3500
7,7104,10,100,0.0001,0.01,0.774,3557,3547
7,7204,10,100,0.0001,0.01,0.782,3608,3596
7,7304,10,100,0.0001,0.01,0.77,3656,3648
7,7404,10,100,0.0001,0.01,0.802,3709,3695
7,7504,10,100,0.0001,0.01,0.778,3759,3745
7,7604,10,100,0.0001,0.01,0.798,3805,3799
7,7704,10,100,0.0001,0.01,0.768,3856,3848
7,7804,10,100,0.0001,0.01,0.792,3910,3894
7,7904,10,100,0.0001,0.01,0.766,3968,3936
7,8004,10,100,0.0001,0.01,0.77,4013,3991
7,8104,10,100,0.0001,0.01,0.788,4063,4041
7,8204,10,100,0.0001,0.01,0.784,4109,4095
7,8304,10,100,0.0001,0.01,0.726,4149,4155
7,8404,10,100,0.0001,0.01,0.788,4205,4199
7,8504,10,100,0.0001,0.01,0.816,4246,4258
7,8604,10,100,0.0001,0.01,0.814,4292,4312
7,8704,10,100,0.0001,0.01,0.814,4345,4359
7,8804,10,100,0.0001,0.01,0.8,4402,4402
7,8904,10,100,0.0001,0.01,0.81,4446,4458
7,9004,10,100,0.0001,0.01,0.834,4509,4495
7,9104,10,100,0.0001,0.01,0.834,4559,4545
7,9204,10,100,0.0001,0.01,0.812,4605,4599
7,9304,10,100,0.0001,0.01,0.82,4655,4649
7,9404,10,100,0.0001,0.01,0.836,4705,4699
7,9504,10,100,0.0001,0.01,0.85,4754,4750
7,9604,10,100,0.0001,0.01,0.846,4800,4804
7,9704,10,100,0.0001,0.01,0.802,4840,4864
7,9804,10,100,0.0001,0.01,0.862,4896,4908
7,9904,10,100,0.0001,0.01,0.886,4947,4957
7,10004,10,100,0.0001,0.01,0.888,4993,5011
7,10104,10,100,0.0001,0.01,0.882,5045,5059
7,10204,10,100,0.0001,0.01,0.884,5089,5115
7,10304,10,100,0.0001,0.01,0.886,5139,5165
7,10404,10,100,0.0001,0.01,0.892,5196,5208
7,10504,10,100,0.0001,0.01,0.896,5250,5254
7,10604,10,100,0.0001,0.01,0.9,5301,5303
7,10704,10,100,0.0001,0.01,0.91,5343,5361
7,10804,10,100,0.0001,0.01,0.908,5397,5407
7,10904,10,100,0.0001,0.01,0.906,5446,5458
7,11004,10,100,0.0001,0.01,0.9,5495,5509
7,11104,10,100,0.0001,0.01,0.872,5547,5557
7,11204,10,100,0.0001,0.01,0.904,5588,5616
7,11304,10,100,0.0001,0.01,0.908,5634,5670
7,11404,10,100,0.0001,0.01,0.912,5688,5716
7,11504,10,100,0.0001,0.01,0.916,5733,5771
7,11604,10,100,0.0001,0.01,0.926,5779,5825
7,11704,10,100,0.0001,0.01,0.916,5826,5878
7,11804,10,100,0.0001,0.01,0.914,5876,5928
7,11904,10,100,0.0001,0.01,0.922,5914,5990
7,12004,10,100,0.0001,0.01,0.906,5962,6042
7,12104,10,100,0.0001,0.01,0.936,6010,6094
7,12204,10,100,0.0001,0.01,0.922,6062,6142
7,12304,10,100,0.0001,0.01,0.912,6119,6185
7,12404,10,100,0.0001,0.01,0.932,6163,6241
7,12504,10,100,0.0001,0.01,0.922,6221,6283
7,12604,10,100,0.0001,0.01,0.93,6272,6332
7,12704,10,100,0.0001,0.01,0.94,6331,6373
7,12804,10,100,0.0001,0.01,0.92,6388,6416
7,12904,10,100,0.0001,0.01,0.938,6435,6469
7,13004,10,100,0.0001,0.01,0.936,6484,6520
7,13104,10,100,0.0001,0.01,0.928,6533,6571
7,13204,10,100,0.0001,0.01,0.934,6588,6616
7,13304,10,100,0.0001,0.01,0.908,6639,6665
7,13404,10,100,0.0001,0.01,0.936,6684,6720
7,13504,10,100,0.0001,0.01,0.934,6733,6771
7,13604,10,100,0.0001,0.01,0.942,6780,6824
7,13704,10,100,0.0001,0.01,0.942,6830,6874
7,13804,10,100,0.0001,0.01,0.94,6876,6928
7,13904,10,100,0.0001,0.01,0.95,6928,6976
7,14004,10,100,0.0001,0.01,0.95,6976,7028
7,14104,10,100,0.0001,0.01,0.954,7018,7086
7,14204,10,100,0.0001,0.01,0.956,7073,7131
7,14304,10,100,0.0001,0.01,0.954,7132,7172
7,14404,10,100,0.0001,0.01,0.932,7180,7224
7,14504,10,100,0.0001,0.01,0.942,7228,7276
7,14604,10,100,0.0001,0.01,0.95,7283,7321
7,14704,10,100,0.0001,0.01,0.956,7340,7364
7,14804,10,100,0.0001,0.01,0.958,7392,7412
7,14904,10,100,0.0001,0.01,0.942,7444,7460
7,15004,10,100,0.0001,0.01,0.942,7496,7508
8,104,10,100,0.0001,0.01,0.508,51,53
8,204,10,100,0.0001,0.01,0.5,106,98
8,304,10,100,0.0001,0.01,0.492,159,145
8,404,10,100,0.0001,0.01,0.488,204,200
8,504,10,100,0.0001,0.01,0.48,251,253
8,604,10,100,0.0001,0.01,0.514,302,302
8,704,10,100,0.0001,0.01,0.512,351,353
8,804,10,100,0.0001,0.01,0.49,402,402
8,904,10,100,0.0001,0.01,0.514,449,455
8,1004,10,100,0.0001,0.01,0.518,493,511
8,1104,10,100,0.0001,0.01,0.488,543,561
8,1204,10,100,0.0001,0.01,0.482,588,616
8,1304,10,100,0.0001,0.01,0.512,635,669
8,1404,10,100,0.0001,0.01,0.516,681,723
8,1504,10,100,0.0001,0.01,0.54,725,779
8,1604,10,100,0.0001,0.01,0.542,788,816
8,1704,10,100,0.0001,0.01,0.55,836,868
8,1804,10,100,0.0001,0.01,0.6,886,918
8,1904,10,100,0.0001,0.01,0.59,931,973
8,2004,10,100,0.0001,0.01,0.628,978,1026
8,2104,10,100,0.0001,0.01,0.648,1022,1082
8,2204,10,100,0.0001,0.01,0.692,1073,1131
8,2304,10,100,0.0001,0.01,0.712,1130,1174
8,2404,10,100,0.0001,0.01,0.706,1187,1217
8,2504,10,100,0.0001,0.01,0.678,1233,1271
8,2604,10,100,0.0001,0.01,0.678,1275,1329
8,2704,10,100,0.0001,0.01,0.686,1323,1381
8,2804,10,100,0.0001,0.01,0.682,1369,1435
8,2904,10,100,0.0001,0.01,0.696,1420,1484
8,3004,10,100,0.0001,0.01,0.73,1471,1533
8,3104,10,100,0.0001,0.01,0.714,1521,1583
8,3204,10,100,0.0001,0.01,0.726,1563,1641
8,3304,10,100,0.0001,0.01,0.732,1615,1689
8,3404,10,100,0.0001,0.01,0.708,1670,1734
8,3504,10,100,0.0001,0.01,0.73,1716,1788
8,3604,10,100,0.0001,0.01,0.708,1775,1829
8,3704,10,100,0.0001,0.01,0.754,1825,1879
8,3804,10,100,0.0001,0.01,0.714,1873,1931
8,3904,10,100,0.0001,0.01,0.744,1923,1981
8,4004,10,100,0.0001,0.01,0.698,1971,2033
8,4104,10,100,0.0001,0.01,0.76,2039,2065
8,4204,10,100,0.0001,0.01,0.716,2092,2112
8,4304,10,100,0.0001,0.01,0.7,2137,2167
8,4404,10,100,0.0001,0.01,0.758,2194,2210
8,4504,10,100,0.0001,0.01,0.75,2249,2255
8,4604,10,100,0.0001,0.01,0.74,2297,2307
8,4704,10,100,0.0001,0.01,0.752,2348,2356
8,4804,10,100,0.0001,0.01,0.778,2392,2412
8,4904,10,100,0.0001,0.01,0.76,2435,2469
8,5004,10,100,0.0001,0.01,0.776,2492,2512
8,5104,10,100,0.0001,0.01,0.78,2547,2557
8,5204,10,100,0.0001,0.01,0.786,2594,2610
8,5304,10,100,0.0001,0.01,0.772,2641,2663
8,5404,10,100,0.0001,0.01,0.78,2689,2715
8,5504,10,100,0.0001,0.01,0.782,2735,2769
8,5604,10,100,0.0001,0.01,0.77,2779,2825
8,5704,10,100,0.0001,0.01,0.786,2827,2877
8,5804,10,100,0.0001,0.01,0.746,2872,2932
8,5904,10,100,0.0001,0.01,0.798,2921,2983
8,6004,10,100,0.0001,0.01,0.788,2979,3025
8,6104,10,100,0.0001,0.01,0.794,3034,3070
8,6204,10,100,0.0001,0.01,0.792,3085,3119
8,6304,10,100,0.0001,0.01,0.828,3140,3164
8,6404,10,100,0.0001,0.01,0.774,3195,3209
8,6504,10,100,0.0001,0.01,0.794,3240,3264
8,6604,10,100,0.0001,0.01,0.802,3297,3307
8,6704,10,100,0.0001,0.01,0.784,3344,3360
8,6804,10,100,0.0001,0.01,0.788,3404,3400
8,6904,10,100,0.0001,0.01,0.828,3457,3447
8,7004,10,100,0.0001,0.01,0.82,3506,3498
8,7104,10,100,0.0001,0.01,0.83,3551,3553
8,7204,10,100,0.0001,0.01,0.822,3598,3606
8,7304,10,100,0.0001,0.01,0.802,3644,3660
8,7404,10,100,0.0001,0.01,0.81,3695,3709
8,7504,10,100,0.0001,0.01,0.772,3750,3754
8,7604,10,100,0.0001,0.01,0.812,3801,3803
8,7704,10,100,0.0001,0.01,0.824,3854,3850
8,7804,10,100,0.0001,0.01,0.812,3905,3899
8,7904,10,100,0.0001,0.01,0.832,3964,3940
8,8004,10,100,0.0001,0.01,0.804,4006,3998
8,8104,10,100,0.0001,0.01,0.838,4061,4043
8,8204,10,100,0.0001,0.01,0.828,4116,4088
8,8304,10,100,0.0001,0.01,0.818,4158,4146
8,8404,10,100,0.0001,0.01,0.812,4201,4203
8,8504,10,100,0.0001,0.01,0.808,4249,4255
8,8604,10,100,0.0001,0.01,0.836,4287,4317
8,8704,10,100,0.0001,0.01,0.812,4340,4364
8,8804,10,100,0.0001,0.01,0.83,4387,4417
8,8904,10,100,0.0001,0.01,0.814,4432,4472
8,9004,10,100,0.0001,0.01,0.868,4486,4518
8,9104,10,100,0.0001,0.01,0.82,4549,4555
8,9204,10,100,0.0001,0.01,0.826,4593,4611
8,9304,10,100,0.0001,0.01,0.828,4639,4665
8,9404,10,100,0.0001,0.01,0.806,4686,4718
8,9504,10,100,0.0001,0.01,0.822,4733,4771
8,9604,10,100,0.0001,0.01,0.848,4785,4819
8,9704,10,100,0.0001,0.01,0.844,4841,4863
8,9804,10,100,0.0001,0.01,0.798,4890,4914
8,9904,10,100,0.0001,0.01,0.8,4934,4970
8,10004,10,100,0.0001,0.01,0.842,4984,5020
8,10104,10,100,0.0001,0.01,0.862,5033,5071
8,10204,10,100,0.0001,0.01,0.85,5084,5120
8,10304,10,100,0.0001,0.01,0.854,5134,5170
8,10404,10,100,0.0001,0.01,0.846,5186,5218
8,10504,10,100,0.0001,0.01,0.852,5237,5267
8,10604,10,100,0.0001,0.01,0.85,5278,5326
8,10704,10,100,0.0001,0.01,0.854,5334,5370
8,10804,10,100,0.0001,0.01,0.87,5387,5417
8,10904,10,100,0.0001,0.01,0.872,5441,5463
8,11004,10,100,0.0001,0.01,0.784,5496,5508
8,11104,10,100,0.0001,0.01,0.858,5540,5564
8,11204,10,100,0.0001,0.01,0.874,5590,5614
8,11304,10,100,0.0001,0.01,0.868,5646,5658
8,11404,10,100,0.0001,0.01,0.86,5703,5701
8,11504,10,100,0.0001,0.01,0.87,5753,5751
8,11604,10,100,0.0001,0.01,0.86,5802,5802
8,11704,10,100,0.0001,0.01,0.89,5858,5846
8,11804,10,100,0.0001,0.01,0.85,5907,5897
8,11904,10,100,0.0001,0.01,0.856,5959,5945
8,12004,10,100,0.0001,0.01,0.87,6013,5991
8,12104,10,100,0.0001,0.01,0.876,6062,6042
8,12204,10,100,0.0001,0.01,0.87,6105,6099
8,12304,10,100,0.0001,0.01,0.85,6149,6155
8,12404,10,100,0.0001,0.01,0.872,6195,6209
8,12504,10,100,0.0001,0.01,0.876,6245,6259
8,12604,10,100,0.0001,0.01,0.88,6290,6314
8,12704,10,100,0.0001,0.01,0.872,6330,6374
8,12804,10,100,0.0001,0.01,0.872,6383,6421
8,12904,10,100,0.0001,0.01,0.892,6435,6469
8,13004,10,100,0.0001,0.01,0.854,6485,6519
8,13104,10,100,0.0001,0.01,0.886,6536,6568
8,13204,10,100,0.0001,0.01,0.884,6587,6617
8,13304,10,100,0.0001,0.01,0.872,6646,6658
8,13404,10,100,0.0001,0.01,0.896,6696,6708
8,13504,10,100,0.0001,0.01,0.912,6750,6754
8,13604,10,100,0.0001,0.01,0.886,6799,6805
8,13704,10,100,0.0001,0.01,0.906,6855,6849
8,13804,10,100,0.0001,0.01,0.874,6907,6897
8,13904,10,100,0.0001,0.01,0.892,6957,6947
8,14004,10,100,0.0001,0.01,0.854,7005,6999
8,14104,10,100,0.0001,0.01,0.872,7057,7047
8,14204,10,100,0.0001,0.01,0.89,7108,7096
8,14304,10,100,0.0001,0.01,0.882,7154,7150
8,14404,10,100,0.0001,0.01,0.904,7199,7205
8,14504,10,100,0.0001,0.01,0.88,7253,7251
8,14604,10,100,0.0001,0.01,0.87,7299,7305
8,14704,10,100,0.0001,0.01,0.878,7357,7347
8,14804,10,100,0.0001,0.01,0.89,7413,7391
8,14904,10,100,0.0001,0.01,0.884,7461,7443
8,15004,10,100,0.0001,0.01,0.884,7506,7498
9,104,10,100,0.0001,0.01,0.53,56,48
9,204,10,100,0.0001,0.01,0.468,98,106
9,304,10,100,0.0001,0.01,0.486,154,150
9,404,10,100,0.0001,0.01,0.492,204,200
9,504,10,100,0.0001,0.01,0.524,252,252
9,604,10,100,0.0001,0.01,0.53,299,305
9,704,10,100,0.0001,0.01,0.54,349,355
9,804,10,100,0.0001,0.01,0.522,392,412
9,904,10,100,0.0001,0.01,0.506,442,462
9,1004,10,100,0.0001,0.01,0.536,491,513
9,1104,10,100,0.0001,0.01,0.524,539,565
9,1204,10,100,0.0001,0.01,0.528,587,617
9,1304,10,100,0.0001,0.01,0.562,636,668
9,1404,10,100,0.0001,0.01,0.54,681,723
9,1504,10,100,0.0001,0.01,0.554,729,775
9,1604,10,100,0.0001,0.01,0.574,775,829
9,1704,10,100,0.0001,0.01,0.566,829,875
9,1804,10,100,0.0001,0.01,0.574,874,930
9,1904,10,100,0.0001,0.01,0.61,924,980
9,2004,10,100,0.0001,0.01,0.61,975,1029
9,2104,10,100,0.0001,0.01,0.654,1016,1088
9,2204,10,100,0.0001,0.01,0.644,1059,1145
9,2304,10,100,0.0001,0.01,0.672,1110,1194
9,2404,10,100,0.0001,0.01,0.692,1165,1239
9,2504,10,100,0.0001,0.01,0.744,1221,1283
9,2604,10,100,0.0001,0.01,0.782,1265,1339
9,2704,10,100,0.0001,0.01,0.796,1306,1398
9,2804,10,100,0.0001,0.01,0.836,1354,1450
9,2904,10,100,0.0001,0.01,0.864,1404,1500
9,3004,10,100,0.0001,0.01,0.896,1447,1557
9,3104,10,100,0.0001,0.01,0.896,1504,1600
9,3204,10,100,0.0001,0.01,0.904,1549,1655
9,3304,10,100,0.0001,0.01,0.906,1596,1708
9,3404,10,100,0.0001,0.01,0.902,1646,1758
9,3504,10,100,0.0001,0.01,0.91,1697,1807
9,3604,10,100,0.0001,0.01,0.92,1740,1864
9,3704,10,100,0.0001,0.01,0.912,1786,1918
9,3804,10,100,0.0001,0.01,0.918,1832,1972
9,3904,10,100,0.0001,0.01,0.942,1883,2021
9,4004,10,100,0.0001,0.01,0.914,1929,2075
9,4104,10,100,0.0001,0.01,0.892,1983,2121
9,4204,10,100,0.0001,0.01,0.912,2033,2171
9,4304,10,100,0.0001,0.01,0.928,2087,2217
9,4404,10,100,0.0001,0.01,0.936,2135,2269
9,4504,10,100,0.0001,0.01,0.95,2191,2313
9,4604,10,100,0.0001,0.01,0.944,2248,2356
9,4704,10,100,0.0001,0.01,0.952,2288,2416
9,4804,10,100,0.0001,0.01,0.958,2336,2468
9,4904,10,100,0.0001,0.01,0.958,2379,2525
9,5004,10,100,0.0001,0.01,0.944,2428,2576
9,5104,10,100,0.0001,0.01,0.95,2480,2624
9,5204,10,100,0.0001,0.01,0.948,2529,2675
9,5304,10,100,0.0001,0.01,0.934,2579,2725
9,5404,10,100,0.0001,0.01,0.96,2630,2774
9,5504,10,100,0.0001,0.01,0.966,2683,2821
9,5604,10,100,0.0001,0.01,0.95,2729,2875
9,5704,10,100,0.0001,0.01,0.948,2786,2918
9,5804,10,100,0.0001,0.01,0.962,2841,2963
9,5904,10,100,0.0001,0.01,0.966,2901,3003
9,6004,10,100,0.0001,0.01,0.962,2948,3056
9,6104,10,100,0.0001,0.01,0.954,3001,3103
9,6204,10,100,0.0001,0.01,0.952,3055,3149
9,6304,10,100,0.0001,0.01,0.944,3097,3207
9,6404,10,100,0.0001,0.01,0.97,3146,3258
9,6504,10,100,0.0001,0.01,0.968,3199,3305
9,6604,10,100,0.0001,0.01,0.964,3250,3354
9,6704,10,100,0.0001,0.01,0.97,3295,3409
9,6804,10,100,0.0001,0.01,0.976,3351,3453
9,6904,10,100,0.0001,0.01,0.972,3400,3504
9,7004,10,100,0.0001,0.01,0.964,3454,3550
9,7104,10,100,0.0001,0.01,0.974,3504,3600
9,7204,10,100,0.0001,0.01,0.974,3554,3650
9,7304,10,100,0.0001,0.01,0.972,3600,3704
9,7404,10,100,0.0001,0.01,0.974,3649,3755
9,7504,10,100,0.0001,0.01,0.97,3698,3806
9,7604,10,100,0.0001,0.01,0.96,3750,3854
9,7704,10,100,0.0001,0.01,0.97,3803,3901
9,7804,10,100,0.0001,0.01,0.974,3851,3953
9,7904,10,100,0.0001,0.01,0.986,3905,3999
9,8004,10,100,0.0001,0.01,0.982,3953,4051
9,8104,10,100,0.0001,0.01,0.972,4009,4095
9,8204,10,100,0.0001,0.01,0.966,4071,4133
9,8304,10,100,0.0001,0.01,0.982,4128,4176
9,8404,10,100,0.0001,0.01,0.974,4178,4226
9,8504,10,100,0.0001,0.01,0.974,4228,4276
9,8604,10,100,0.0001,0.01,0.974,4277,4327
9,8704,10,100,0.0001,0.01,0.978,4325,4379
9,8804,10,100,0.0001,0.01,0.96,4374,4430
9,8904,10,100,0.0001,0.01,0.98,4420,4484
9,9004,10,100,0.0001,0.01,0.926,4471,4533
9,9104,10,100,0.0001,0.01,0.92,4517,4587
9,9204,10,100,0.0001,0.01,0.928,4574,4630
9,9304,10,100,0.0001,0.01,0.96,4629,4675
9,9404,10,100,0.0001,0.01,0.966,4690,4714
9,9504,10,100,0.0001,0.01,0.984,4745,4759
9,9604,10,100,0.0001,0.01,0.976,4799,4805
9,9704,10,100,0.0001,0.01,0.98,4839,4865
9,9804,10,100,0.0001,0.01,0.97,4890,4914
9,9904,10,100,0.0001,0.01,0.974,4949,4955
9,10004,10,100,0.0001,0.01,0.972,5000,5004
9,10104,10,100,0.0001,0.01,0.982,5049,5055
9,10204,10,100,0.0001,0.01,0.982,5095,5109
9,10304,10,100,0.0001,0.01,0.98,5146,5158
9,10404,10,100,0.0001,0.01,0.986,5193,5211
9,10504,10,100,0.0001,0.01,0.964,5240,5264
9,10604,10,100,0.0001,0.01,0.982,5294,5310
9,10704,10,100,0.0001,0.01,0.982,5346,5358
9,10804,10,100,0.0001,0.01,0.978,5398,5406
9,10904,10,100,0.0001,0.01,0.978,5443,5461
9,11004,10,100,0.0001,0.01,0.984,5490,5514
9,11104,10,100,0.0001,0.01,0.982,5539,5565
9,11204,10,100,0.0001,0.01,0.974,5589,5615
9,11304,10,100,0.0001,0.01,0.984,5645,5659
9,11404,10,100,0.0001,0.01,0.986,5693,5711
9,11504,10,100,0.0001,0.01,0.98,5746,5758
9,11604,10,100,0.0001,0.01,0.988,5795,5809
9,11704,10,100,0.0001,0.01,0.986,5845,5859
9,11804,10,100,0.0001,0.01,0.99,5894,5910
9,11904,10,100,0.0001,0.01,0.984,5944,5960
9,12004,10,100,0.0001,0.01,0.984,5998,6006
9,12104,10,100,0.0001,0.01,0.988,6049,6055
9,12204,10,100,0.0001,0.01,0.982,6097,6107
9,12304,10,100,0.0001,0.01,0.978,6147,6157
9,12404,10,100,0.0001,0.01,0.98,6199,6205
9,12504,10,100,0.0001,0.01,0.984,6252,6252
9,12604,10,100,0.0001,0.01,0.986,6308,6296
9,12704,10,100,0.0001,0.01,0.988,6359,6345
9,12804,10,100,0.0001,0.01,0.972,6405,6399
9,12904,10,100,0.0001,0.01,0.984,6455,6449
9,13004,10,100,0.0001,0.01,0.988,6504,6500
9,13104,10,100,0.0001,0.01,0.99,6558,6546
9,13204,10,100,0.0001,0.01,0.988,6605,6599
9,13304,10,100,0.0001,0.01,0.974,6660,6644
9,13404,10,100,0.0001,0.01,0.99,6709,6695
9,13504,10,100,0.0001,0.01,0.99,6756,6748
9,13604,10,100,0.0001,0.01,0.99,6800,6804
9,13704,10,100,0.0001,0.01,0.992,6852,6852
9,13804,10,100,0.0001,0.01,0.994,6898,6906
9,13904,10,100,0.0001,0.01,0.99,6947,6957
9,14004,10,100,0.0001,0.01,0.992,7001,7003
9,14104,10,100,0.0001,0.01,0.99,7056,7048
9,14204,10,100,0.0001,0.01,0.99,7104,7100
9,14304,10,100,0.0001,0.01,0.99,7155,7149
9,14404,10,100,0.0001,0.01,0.99,7211,7193
9,14504,10,100,0.0001,0.01,0.99,7263,7241
9,14604,10,100,0.0001,0.01,0.984,7314,7290
9,14704,10,100,0.0001,0.01,0.988,7367,7337
9,14804,10,100,0.0001,0.01,0.994,7419,7385
9,14904,10,100,0.0001,0.01,0.99,7465,7439
9,15004,10,100,0.0001,0.01,0.994,7517,7487
10,104,10,100,0.0001,0.01,0.5,61,43
10,204,10,100,0.0001,0.01,0.524,108,96
10,304,10,100,0.0001,0.01,0.496,156,148
10,404,10,100,0.0001,0.01,0.514,209,195
10,504,10,100,0.0001,0.01,0.512,251,253
10,604,10,100,0.0001,0.01,0.498,304,300
10,704,10,100,0.0001,0.01,0.518,355,349
10,804,10,100,0.0001,0.01,0.494,404,400
10,904,10,100,0.0001,0.01,0.502,450,454
10,1004,10,100,0.0001,0.01,0.468,498,506
10,1104,10,100,0.0001,0.01,0.526,549,555
10,1204,10,100,0.0001,0.01,0.528,595,609
10,1304,10,100,0.0001,0.01,0.522,643,661
10,1404,10,100,0.0001,0.01,0.524,693,711
10,1504,10,100,0.0001,0.01,0.536,740,764
10,1604,10,100,0.0001,0.01,0.576,798,806
10,1704,10,100,0.0001,0.01,0.552,850,854
10,1804,10,100,0.0001,0.01,0.584,900,904
10,1904,10,100,0.0001,0.01,0.602,950,954
10,2004,10,100,0.0001,0.01,0.554,1001,1003
10,2104,10,100,0.0001,0.01,0.604,1051,1053
10,2204,10,100,0.0001,0.01,0.632,1102,1102
10,2304,10,100,0.0001,0.01,0.632,1150,1154
10,2404,10,100,0.0001,0.01,0.658,1202,1202
10,2504,10,100,0.0001,0.01,0.666,1257,1247
10,2604,10,100,0.0001,0.01,0.646,1314,1290
10,2704,10,100,0.0001,0.01,0.668,1367,1337
10,2804,10,100,0.0001,0.01,0.686,1415,1389
10,2904,10,100,0.0001,0.01,0.71,1469,1435
10,3004,10,100,0.0001,0.01,0.68,1522,1482
10,3104,10,100,0.0001,0.01,0.67,1567,1537
10,3204,10,100,0.0001,0.01,0.666,1612,1592
10,3304,10,100,0.0001,0.01,0.632,1656,1648
10,3404,10,100,0.0001,0.01,0.698,1709,1695
10,3504,10,100,0.0001,0.01,0.694,1749,1755
10,3604,10,100,0.0001,0.01,0.702,1793,1811
10,3704,10,100,0.0001,0.01,0.73,1846,1858
10,3804,10,100,0.0001,0.01,0.714,1896,1908
10,3904,10,100,0.0001,0.01,0.71,1948,1956
10,4004,10,100,0.0001,0.01,0.714,1992,2012
10,4104,10,100,0.0001,0.01,0.708,2034,2070
10,4204,10,100,0.0001,0.01,0.696,2085,2119
10,4304,10,100,0.0001,0.01,0.76,2128,2176
10,4404,10,100,0.0001,0.01,0.716,2180,2224
10,4504,10,100,0.0001,0.01,0.744,2226,2278
10,4604,10,100,0.0001,0.01,0.712,2270,2334
10,4704,10,100,0.0001,0.01,0.738,2317,2387
10,4804,10,100,0.0001,0.01,0.758,2372,2432
10,4904,10,100,0.0001,0.01,0.746,2410,2494
10,5004,10,100,0.0001,0.01,0.748,2456,2548
10,5104,10,100,0.0001,0.01,0.776,2509,2595
10,5204,10,100,0.0001,0.01,0.768,2561,2643
10,5304,10,100,0.0001,0.01,0.752,2617,2687
10,5404,10,100,0.0001,0.01,0.742,2664,2740
10,5504,10,100,0.0001,0.01,0.774,2705,2799
10,5604,10,100,0.0001,0.01,0.728,2755,2849
10,5704,10,100,0.0001,0.01,0.758,2800,2904
10,5804,10,100,0.0001,0.01,0.76,2853,2951
10,5904,10,100,0.0001,0.01,0.76,2900,3004
10,6004,10,100,0.0001,0.01,0.788,2951,3053
10,6104,10,100,0.0001,0.01,0.774,2995,3109
10,6204,10,100,0.0001,0.01,0.744,3038,3166
10,6304,10,100,0.0001,0.01,0.804,3097,3207
10,6404,10,100,0.0001,0.01,0.812,3147,3257
10,6504,10,100,0.0001,0.01,0.826,3187,3317
10,6604,10,100,0.0001,0.01,0.826,3240,3364
10,6704,10,100,0.0001,0.01,0.812,3292,3412
10,6804,10,100,0.0001,0.01,0.808,3342,3462
10,6904,10,100,0.0001,0.01,0.82,3402,3502
10,7004,10,100,0.0001,0.01,0.822,3447,3557
10,7104,10,100,0.0001,0.01,0.822,3495,3609
10,7204,10,100,0.0001,0.01,0.836,3544,3660
10,7304,10,100,0.0001,0.01,0.818,3597,3707
10,7404,10,100,0.0001,0.01,0.848,3640,3764
10,7504,10,100,0.0001,0.01,0.854,3690,3814
10,7604,10,100,0.0001,0.01,0.82,3743,3861
10,7704,10,100,0.0001,0.01,0.848,3795,3909
10,7804,10,100,0.0001,0.01,0.85,3847,3957
10,7904,10,100,0.0001,0.01,0.84,3895,4009
10,8004,10,100,0.0001,0.01,0.83,3940,4064
10,8104,10,100,0.0001,0.01,0.846,3990,4114
10,8204,10,100,0.0001,0.01,0.842,4037,4167
10,8304,10,100,0.0001,0.01,0.814,4090,4214
10,8404,10,100,0.0001,0.01,0.852,4146,4258
10,8504,10,100,0.0001,0.01,0.828,4197,4307
10,8604,10,100,0.0001,0.01,0.842,4241,4363
10,8704,10,100,0.0001,0.01,0.852,4294,4410
10,8804,10,100,0.0001,0.01,0.86,4339,4465
10,8904,10,100,0.0001,0.01,0.83,4387,4517
10,9004,10,100,0.0001,0.01,0.852,4436,4568
10,9104,10,100,0.0001,0.01,0.85,4479,4625
10,9204,10,100,0.0001,0.01,0.862,4528,4676
10,9304,10,100,0.0001,0.01,0.858,4578,4726
10,9404,10,100,0.0001,0.01,0.85,4627,4777
10,9504,10,100,0.0001,0.01,0.834,4667,4837
10,9604,10,100,0.0001,0.01,0.868,4717,4887
10,9704,10,100,0.0001,0.01,0.838,4776,4928
10,9804,10,100,0.0001,0.01,0.868,4821,4983
10,9904,10,100,0.0001,0.01,0.876,4878,5026
10,10004,10,100,0.0001,0.01,0.864,4926,5078
10,10104,10,100,0.0001,0.01,0.872,4978,5126
10,10204,10,100,0.0001,0.01,0.88,5022,5182
10,10304,10,100,0.0001,0.01,0.858,5083,5221
10,10404,10,100,0.0001,0.01,0.848,5140,5264
10,10504,10,100,0.0001,0.01,0.872,5192,5312
10,10604,10,100,0.0001,0.01,0.868,5244,5360
10,10704,10,100,0.0001,0.01,0.848,5300,5404
10,10804,10,100,0.0001,0.01,0.864,5358,5446
10,10904,10,100,0.0001,0.01,0.868,5409,5495
10,11004,10,100,0.0001,0.01,0.834,5455,5549
10,11104,10,100,0.0001,0.01,0.846,5508,5596
10,11204,10,100,0.0001,0.01,0.842,5562,5642
10,11304,10,100,0.0001,0.01,0.878,5616,5688
10,11404,10,100,0.0001,0.01,0.874,5662,5742
10,11504,10,100,0.0001,0.01,0.886,5709,5795
10,11604,10,100,0.0001,0.01,0.882,5754,5850
10,11704,10,100,0.0001,0.01,0.856,5804,5900
10,11804,10,100,0.0001,0.01,0.854,5861,5943
10,11904,10,100,0.0001,0.01,0.882,5905,5999
10,12004,10,100,0.0001,0.01,0.86,5963,6041
10,12104,10,100,0.0001,0.01,0.872,6016,6088
10,12204,10,100,0.0001,0.01,0.884,6074,6130
10,12304,10,100,0.0001,0.01,0.898,6129,6175
10,12404,10,100,0.0001,0.01,0.866,6180,6224
10,12504,10,100,0.0001,0.01,0.882,6233,6271
10,12604,10,100,0.0001,0.01,0.888,6280,6324
10,12704,10,100,0.0001,0.01,0.86,6340,6364
10,12804,10,100,0.0001,0.01,0.89,6389,6415
10,12904,10,100,0.0001,0.01,0.866,6440,6464
10,13004,10,100,0.0001,0.01,0.878,6485,6519
10,13104,10,100,0.0001,0.01,0.916,6543,6561
10,13204,10,100,0.0001,0.01,0.894,6593,6611
10,13304,10,100,0.0001,0.01,0.9,6649,6655
10,13404,10,100,0.0001,0.01,0.9,6702,6702
10,13504,10,100,0.0001,0.01,0.886,6749,6755
10,13604,10,100,0.0001,0.01,0.912,6800,6804
10,13704,10,100,0.0001,0.01,0.9,6848,6856
10,13804,10,100,0.0001,0.01,0.88,6901,6903
10,13904,10,100,0.0001,0.01,0.898,6948,6956
10,14004,10,100,0.0001,0.01,0.918,7007,6997
10,14104,10,100,0.0001,0.01,0.894,7060,7044
10,14204,10,100,0.0001,0.01,0.908,7109,7095
10,14304,10,100,0.0001,0.01,0.91,7162,7142
10,14404,10,100,0.0001,0.01,0.908,7206,7198
10,14504,10,100,0.0001,0.01,0.916,7254,7250
10,14604,10,100,0.0001,0.01,0.904,7306,7298
10,14704,10,100,0.0001,0.01,0.908,7356,7348
10,14804,10,100,0.0001,0.01,0.918,7407,7397
10,14904,10,100,0.0001,0.01,0.916,7449,7455
10,15004,10,100,0.0001,0.01,0.914,7502,7502
11,104,10,100,0.0001,0.01,0.508,48,56
11,204,10,100,0.0001,0.01,0.51,103,101
11,304,10,100,0.0001,0.01,0.526,153,151
11,404,10,100,0.0001,0.01,0.472,203,201
11,504,10,100,0.0001,0.01,0.486,254,250
11,604,10,100,0.0001,0.01,0.504,306,298
11,704,10,100,0.0001,0.01,0.5,356,348
11,804,10,100,0.0001,0.01,0.496,409,395
11,904,10,100,0.0001,0.01,0.502,460,444
11,1004,10,100,0.0001,0.01,0.518,511,493
11,1104,10,100,0.0001,0.01,0.486,563,541
11,1204,10,100,0.0001,0.01,0.526,598,606
11,1304,10,100,0.0001,0.01,0.516,646,658
11,1404,10,100,0.0001,0.01,0.524,692,712
11,1504,10,100,0.0001,0.01,0.512,744,760
11,1604,10,100,0.0001,0.01,0.53,796,808
11,1704,10,100,0.0001,0.01,0.526,857,847
11,1804,10,100,0.0001,0.01,0.544,906,898
11,1904,10,100,0.0001,0.01,0.538,959,945
11,2004,10,100,0.0001,0.01,0.514,1003,1001
11,2104,10,100,0.0001,0.01,0.546,1055,1049
11,2204,10,100,0.0001,0.01,0.516,1098,1106
11,2304,10,100,0.0001,0.01,0.532,1152,1152
11,2404,10,100,0.0001,0.01,0.512,1196,1208
11,2504,10,100,0.0001,0.01,0.474,1247,1257
11,2604,10,100,0.0001,0.01,0.498,1305,1299
11,2704,10,100,0.0001,0.01,0.51,1354,1350
11,2804,10,100,0.0001,0.01,0.482,1401,1403
11,2904,10,100,0.0001,0.01,0.534,1452,1452
11,3004,10,100,0.0001,0.01,0.506,1501,1503
11,3104,10,100,0.0001,0.01,0.504,1552,1552
11,3204,10,100,0.0001,0.01,0.502,1605,1599
11,3304,10,100,0.0001,0.01,0.51,1653,1651
11,3404,10,100,0.0001,0.01,0.524,1705,1699
11,3504,10,100,0.0001,0.01,0.496,1760,1744
11,3604,10,100,0.0001,0.01,0.5,1815,1789
11,3704,10,100,0.0001,0.01,0.518,1872,1832
11,3804,10,100,0.0001,0.01,0.51,1927,1877
11,3904,10,100,0.0001,0.01,0.51,1981,1923
11,4004,10,100,0.0001,0.01,0.5,2034,1970
11,4104,10,100,0.0001,0.01,0.5,2089,2015
11,4204,10,100,0.0001,0.01,0.534,2141,2063
11,4304,10,100,0.0001,0.01,0.52,2187,2117
11,4404,10,100,0.0001,0.01,0.504,2233,2171
11,4504,10,100,0.0001,0.01,0.498,2283,2221
11,4604,10,100,0.0001,0.01,0.534,2334,2270
11,4704,10,100,0.0001,0.01,0.508,2382,2322
11,4804,10,100,0.0001,0.01,0.518,2435,2369
11,4904,10,100,0.0001,0.01,0.53,2479,2425
11,5004,10,100,0.0001,0.01,0.526,2531,2473
11,5104,10,100,0.0001,0.01,0.536,2583,2521
11,5204,10,100,0.0001,0.01,0.536,2630,2574
11,5304,10,100,0.0001,0.01,0.518,2675,2629
11,5404,10,100,0.0001,0.01,0.548,2721,2683
11,5504,10,100,0.0001,0.01,0.566,2768,2736
11,5604,10,100,0.0001,0.01,0.534,2820,2784
11,5704,10,100,0.0001,0.01,0.538,2880,2824
11,5804,10,100,0.0001,0.01,0.564,2926,2878
11,5904,10,100,0.0001,0.01,0.52,2975,2929
11,6004,10,100,0.0001,0.01,0.528,3026,2978
11,6104,10,100,0.0001,0.01,0.536,3074,3030
11,6204,10,100,0.0001,0.01,0.552,3125,3079
11,6304,10,100,0.0001,0.01,0.554,3174,3130
11,6404,10,100,0.0001,0.01,0.562,3237,3167
11,6504,10,100,0.0001,0.01,0.582,3279,3225
11,6604,10,100,0.0001,0.01,0.548,3327,3277
11,6704,10,100,0.0001,0.01,0.572,3379,3325
11,6804,10,100,0.0001,0.01,0.564,3431,3373
11,6904,10,100,0.0001,0.01,0.544,3485,3419
11,7004,10,100,0.0001,0.01,0.55,3535,3469
11,7104,10,100,0.0001,0.01,0.576,3568,3536
11,7204,10,100,0.0001,0.01,0.56,3619,3585
11,7304,10,100,0.0001,0.01,0.582,3664,3640
11,7404,10,100,0.0001,0.01,0.586,3716,3688
11,7504,10,100,0.0001,0.01,0.556,3767,3737
11,7604,10,100,0.0001,0.01,0.594,3811,3793
11,7704,10,100,0.0001,0.01,0.562,3862,3842
11,7804,10,100,0.0001,0.01,0.574,3917,3887
11,7904,10,100,0.0001,0.01,0.56,3973,3931
11,8004,10,100,0.0001,0.01,0.578,4024,3980
11,8104,10,100,0.0001,0.01,0.594,4082,4022
11,8204,10,100,0.0001,0.01,0.574,4129,4075
11,8304,10,100,0.0001,0.01,0.58,4178,4126
11,8404,10,100,0.0001,0.01,0.604,4222,4182
11,8504,10,100,0.0001,0.01,0.596,4280,4224
11,8604,10,100,0.0001,0.01,0.588,4334,4270
11,8704,10,100,0.0001,0.01,0.584,4381,4323
11,8804,10,100,0.0001,0.01,0.588,4433,4371
11,8904,10,100,0.0001,0.01,0.594,4482,4422
11,9004,10,100,0.0001,0.01,0.614,4539,4465
11,9104,10,100,0.0001,0.01,0.618,4596,4508
11,9204,10,100,0.0001,0.01,0.594,4638,4566
11,9304,10,100,0.0001,0.01,0.616,4690,4614
11,9404,10,100,0.0001,0.01,0.6,4739,4665
11,9504,10,100,0.0001,0.01,0.604,4782,4722
11,9604,10,100,0.0001,0.01,0.662,4833,4771
11,9704,10,100,0.0001,0.01,0.602,4874,4830
11,9804,10,100,0.0001,0.01,0.624,4922,4882
11,9904,10,100,0.0001,0.01,0.588,4971,4933
11,10004,10,100,0.0001,0.01,0.616,5025,4979
11,10104,10,100,0.0001,0.01,0.628,5085,5019
11,10204,10,100,0.0001,0.01,0.62,5126,5078
11,10304,10,100,0.0001,0.01,0.64,5182,5122
11,10404,10,100,0.0001,0.01,0.614,5230,5174
11,10504,10,100,0.0001,0.01,0.646,5282,5222
11,10604,10,100,0.0001,0.01,0.642,5330,5274
11,10704,10,100,0.0001,0.01,0.62,5374,5330
11,10804,10,100,0.0001,0.01,0.642,5430,5374
11,10904,10,100,0.0001,0.01,0.64,5482,5422
11,11004,10,100,0.0001,0.01,0.634,5538,5466
11,11104,10,100,0.0001,0.01,0.63,5589,5515
11,11204,10,100,0.0001,0.01,0.648,5637,5567
11,11304,10,100,0.0001,0.01,0.63,5692,5612
11,11404,10,100,0.0001,0.01,0.644,5743,5661
11,11504,10,100,0.0001,0.01,0.636,5795,5709
11,11604,10,100,0.0001,0.01,0.65,5841,5763
11,11704,10,100,0.0001,0.01,0.636,5889,5815
11,11804,10,100,0.0001,0.01,0.662,5942,5862
11,11904,10,100,0.0001,0.01,0.652,6002,5902
11,12004,10,100,0.0001,0.01,0.648,6048,5956
11,12104,10,100,0.0001,0.01,0.644,6098,6006
11,12204,10,100,0.0001,0.01,0.666,6148,6056
11,12304,10,100,0.0001,0.01,0.658,6204,6100
11,12404,10,100,0.0001,0.01,0.626,6248,6156
11,12504,10,100,0.0001,0.01,0.656,6304,6200
11,12604,10,100,0.0001,0.01,0.646,6353,6251
11,12704,10,100,0.0001,0.01,0.678,6406,6298
11,12804,10,100,0.0001,0.01,0.658,6453,6351
11,12904,10,100,0.0001,0.01,0.656,6500,6404
11,13004,10,100,0.0001,0.01,0.638,6543,6461
11,13104,10,100,0.0001,0.01,0.648,6595,6509
11,13204,10,100,0.0001,0.01,0.658,6643,6561
11,13304,10,100,0.0001,0.01,0.634,6687,6617
11,13404,10,100,0.0001,0.01,0.648,6746,6658
11,13504,10,100,0.0001,0.01,0.63,6794,6710
11,13604,10,100,0.0001,0.01,0.634,6845,6759
11,13704,10,100,0.0001,0.01,0.644,6890,6814
11,13804,10,100,0.0001,0.01,0.64,6943,6861
11,13904,10,100,0.0001,0.01,0.64,6995,6909
11,14004,10,100,0.0001,0.01,0.654,7042,6962
11,14104,10,100,0.0001,0.01,0.628,7088,7016
11,14204,10,100,0.0001,0.01,0.65,7127,7077
11,14304,10,100,0.0001,0.01,0.642,7172,7132
11,14404,10,100,0.0001,0.01,0.648,7219,7185
11,14504,10,100,0.0001,0.01,0.642,7270,7234
11,14604,10,100,0.0001,0.01,0.66,7315,7289
11,14704,10,100,0.0001,0.01,0.674,7358,7346
11,14804,10,100,0.0001,0.01,0.662,7411,7393
11,14904,10,100,0.0001,0.01,0.684,7465,7439
11,15004,10,100,0.0001,0.01,0.688,7506,7498
12,104,10,100,0.0001,0.01,0.51,42,62
12,204,10,100,0.0001,0.01,0.49,89,115
12,304,10,100,0.0001,0.01,0.484,140,164
12,404,10,100,0.0001,0.01,0.504,192,212
12,504,10,100,0.0001,0.01,0.528,242,262
12,604,10,100,0.0001,0.01,0.518,291,313
12,704,10,100,0.0001,0.01,0.506,333,371
12,804,10,100,0.0001,0.01,0.484,379,425
12,904,10,100,0.0001,0.01,0.496,422,482
12,1004,10,100,0.0001,0.01,0.492,478,526
12,1104,10,100,0.0001,0.01,0.518,522,582
12,1204,10,100,0.0001,0.01,0.544,570,634
12,1304,10,100,0.0001,0.01,0.548,617,687
12,1404,10,100,0.0001,0.01,0.554,659,745
12,1504,10,100,0.0001,0.01,0.568,713,791
12,1604,10,100,0.0001,0.01,0.582,758,846
12,1704,10,100,0.0001,0.01,0.592,813,891
12,1804,10,100,0.0001,0.01,0.624,859,945
12,1904,10,100,0.0001,0.01,0.602,906,998
12,2004,10,100,0.0001,0.01,0.648,950,1054
12,2104,10,100,0.0001,0.01,0.65,997,1107
12,2204,10,100,0.0001,0.01,0.686,1045,1159
12,2304,10,100,0.0001,0.01,0.696,1083,1221
12,2404,10,100,0.0001,0.01,0.69,1141,1263
12,2504,10,100,0.0001,0.01,0.708,1186,1318
12,2604,10,100,0.0001,0.01,0.73,1234,1370
12,2704,10,100,0.0001,0.01,0.742,1279,1425
12,2804,10,100,0.0001,0.01,0.738,1332,1472
12,2904,10,100,0.0001,0.01,0.768,1389,1515
12,3004,10,100,0.0001,0.01,0.734,1437,1567
12,3104,10,100,0.0001,0.01,0.744,1491,1613
12,3204,10,100,0.0001,0.01,0.724,1547,1657
12,3304,10,100,0.0001,0.01,0.732,1590,1714
12,3404,10,100,0.0001,0.01,0.718,1628,1776
12,3504,10,100,0.0001,0.01,0.744,1678,1826
12,3604,10,100,0.0001,0.01,0.752,1723,1881
12,3704,10,100,0.0001,0.01,0.754,1777,1927
12,3804,10,100,0.0001,0.01,0.74,1824,1980
12,3904,10,100,0.0001,0.01,0.748,1875,2029
12,4004,10,100,0.0001,0.01,0.686,1931,2073
12,4104,10,100,0.0001,0.01,0.77,1975,2129
12,4204,10,100,0.0001,0.01,0.756,2035,2169
12,4304,10,100,0.0001,0.01,0.766,2087,2217
12,4404,10,100,0.0001,0.01,0.772,2138,2266
12,4504,10,100,0.0001,0.01,0.776,2192,2312
12,4604,10,100,0.0001,0.01,0.782,2240,2364
12,4704,10,100,0.0001,0.01,0.786,2280,2424
12,4804,10,100,0.0001,0.01,0.772,2325,2479
12,4904,10,100,0.0001,0.01,0.802,2381,2523
12,5004,10,100,0.0001,0.01,0.77,2429,2575
12,5104,10,100,0.0001,0.01,0.794,2478,2626
12,5204,10,100,0.0001,0.01,0.792,2533,2671
12,5304,10,100,0.0001,0.01,0.79,2581,2723
12,5404,10,100,0.0001,0.01,0.776,2635,2769
12,5504,10,100,0.0001,0.01,0.778,2686,2818
12,5604,10,100,0.0001,0.01,0.806,2731,2873
12,5704,10,100,0.0001,0.01,0.812,2784,2920
12,5804,10,100,0.0001,0.01,0.82,2831,2973
12,5904,10,100,0.0001,0.01,0.818,2869,3035
12,6004,10,100,0.0001,0.01,0.824,2922,3082
12,6104,10,100,0.0001,0.01,0.834,2970,3134
12,6204,10,100,0.0001,0.01,0.786,3013,3191
12,6304,10,100,0.0001,0.01,0.828,3071,3233
12,6404,10,100,0.0001,0.01,0.832,3117,3287
12,6504,10,100,0.0001,0.01,0.838,3167,3337
12,6604,10,100,0.0001,0.01,0.838,3214,3390
12,6704,10,100,0.0001,0.01,0.854,3263,3441
12,6804,10,100,0.0001,0.01,0.85,3313,3491
12,6904,10,100,0.0001,0.01,0.854,3370,3534
12,7004,10,100,0.0001,0.01,0.85,3419,3585
12,7104,10,100,0.0001,0.01,0.826,3472,3632
12,7204,10,100,0.0001,0.01,0.86,3531,3673
12,7304,10,100,0.0001,0.01,0.886,3587,3717
12,7404,10,100,0.0001,0.01,0.886,3639,3765
12,7504,10,100,0.0001,0.01,0.872,3696,3808
12,7604,10,100,0.0001,0.01,0.882,3746,3858
12,7704,10,100,0.0001,0.01,0.866,3790,3914
12,7804,10,100,0.0001,0.01,0.836,3838,3966
12,7904,10,100,0.0001,0.01,0.878,3888,4016
12,8004,10,100,0.0001,0.01,0.864,3933,4071
12,8104,10,100,0.0001,0.01,0.882,3977,4127
12,8204,10,100,0.0001,0.01,0.874,4033,4171
12,8304,10,100,0.0001,0.01,0.89,4093,4211
12,8404,10,100,0.0001,0.01,0.872,4141,4263
12,8504,10,100,0.0001,0.01,0.9,4192,4312
12,8604,10,100,0.0001,0.01,0.864,4251,4353
12,8704,10,100,0.0001,0.01,0.82,4300,4404
12,8804,10,100,0.0001,0.01,0.864,4348,4456
12,8904,10,100,0.0001,0.01,0.86,4394,4510
12,9004,10,100,0.0001,0.01,0.886,4444,4560
12,9104,10,100,0.0001,0.01,0.888,4497,4607
12,9204,10,100,0.0001,0.01,0.902,4539,4665
12,9304,10,100,0.0001,0.01,0.91,4599,4705
12,9404,10,100,0.0001,0.01,0.894,4648,4756
12,9504,10,100,0.0001,0.01,0.902,4701,4803
12,9604,10,100,0.0001,0.01,0.924,4753,4851
12,9704,10,100,0.0001,0.01,0.936,4808,4896
12,9804,10,100,0.0001,0.01,0.924,4863,4941
12,9904,10,100,0.0001,0.01,0.938,4911,4993
12,10004,10,100,0.0001,0.01,0.922,4958,5046
12,10104,10,100,0.0001,0.01,0.922,5010,5094
12,10204,10,100,0.0001,0.01,0.936,5068,5136
12,10304,10,100,0.0001,0.01,0.932,5115,5189
12,10404,10,100,0.0001,0.01,0.934,5163,5241
12,10504,10,100,0.0001,0.01,0.93,5212,5292
12,10604,10,100,0.0001,0.01,0.93,5261,5343
12,10704,10,100,0.0001,0.01,0.934,5307,5397
12,10804,10,100,0.0001,0.01,0.924,5356,5448
12,10904,10,100,0.0001,0.01,0.948,5414,5490
12,11004,10,100,0.0001,0.01,0.94,5474,5530
12,11104,10,100,0.0001,0.01,0.932,5520,5584
12,11204,10,100,0.0001,0.01,0.944,5559,5645
12,11304,10,100,0.0001,0.01,0.954,5615,5689
12,11404,10,100,0.0001,0.01,0.946,5673,5731
12,11504,10,100,0.0001,0.01,0.942,5725,5779
12,11604,10,100,0.0001,0.01,0.932,5773,5831
12,11704,10,100,0.0001,0.01,0.956,5822,5882
12,11804,10,100,0.0001,0.01,0.944,5873,5931
12,11904,10,100,0.0001,0.01,0.952,5917,5987
12,12004,10,100,0.0001,0.01,0.916,5974,6030
12,12104,10,100,0.0001,0.01,0.954,6022,6082
12,12204,10,100,0.0001,0.01,0.944,6070,6134
12,12304,10,100,0.0001,0.01,0.964,6121,6183
12,12404,10,100,0.0001,0.01,0.946,6169,6235
12,12504,10,100,0.0001,0.01,0.962,6221,6283
12,12604,10,100,0.0001,0.01,0.956,6270,6334
12,12704,10,100,0.0001,0.01,0.946,6320,6384
12,12804,10,100,0.0001,0.01,0.966,6377,6427
12,12904,10,100,0.0001,0.01,0.952,6428,6476
12,13004,10,100,0.0001,0.01,0.962,6482,6522
12,13104,10,100,0.0001,0.01,0.952,6537,6567
12,13204,10,100,0.0001,0.01,0.956,6590,6614
12,13304,10,100,0.0001,0.01,0.962,6644,6660
12,13404,10,100,0.0001,0.01,0.972,6693,6711
12,13504,10,100,0.0001,0.01,0.972,6744,6760
12,13604,10,100,0.0001,0.01,0.96,6794,6810
12,13704,10,100,0.0001,0.01,0.968,6837,6867
12,13804,10,100,0.0001,0.01,0.966,6887,6917
12,13904,10,100,0.0001,0.01,0.968,6935,6969
12,14004,10,100,0.0001,0.01,0.954,6995,7009
12,14104,10,100,0.0001,0.01,0.968,7047,7057
12,14204,10,100,0.0001,0.01,0.97,7098,7106
12,14304,10,100,0.0001,0.01,0.968,7149,7155
12,14404,10,100,0.0001,0.01,0.962,7206,7198
12,14504,10,100,0.0001,0.01,0.97,7261,7243
12,14604,10,100,0.0001,0.01,0.97,7308,7296
12,14704,10,100,0.0001,0.01,0.972,7356,7348
12,14804,10,100,0.0001,0.01,0.958,7403,7401
12,14904,10,100,0.0001,0.01,0.958,7455,7449
12,15004,10,100,0.0001,0.01,0.964,7507,7497
13,104,10,100,0.0001,0.01,0.512,47,57
13,204,10,100,0.0001,0.01,0.522,103,101
13,304,10,100,0.0001,0.01,0.504,157,147
13,404,10,100,0.0001,0.01,0.516,208,196
13,504,10,100,0.0001,0.01,0.502,260,244
13,604,10,100,0.0001,0.01,0.534,311,293
13,704,10,100,0.0001,0.01,0.544,355,349
13,804,10,100,0.0001,0.01,0.54,408,396
13,904,10,100,0.0001,0.01,0.538,452,452
13,1004,10,100,0.0001,0.01,0.544,510,494
13,1104,10,100,0.0001,0.01,0.542,563,541
13,1204,10,100,0.0001,0.01,0.556,615,589
13,1304,10,100,0.0001,0.01,0.558,659,645
13,1404,10,100,0.0001,0.01,0.578,702,702
13,1504,10,100,0.0001,0.01,0.558,747,757
13,1604,10,100,0.0001,0.01,0.586,802,802
13,1704,10,100,0.0001,0.01,0.608,850,854
13,1804,10,100,0.0001,0.01,0.618,899,905
13,1904,10,100,0.0001,0.01,0.642,952,952
13,2004,10,100,0.0001,0.01,0.662,1016,988
13,2104,10,100,0.0001,0.01,0.654,1068,1036
13,2204,10,100,0.0001,0.01,0.684,1112,1092
13,2304,10,100,0.0001,0.01,0.722,1164,1140
13,2404,10,100,0.0001,0.01,0.704,1219,1185
13,2504,10,100,0.0001,0.01,0.696,1266,1238
13,2604,10,100,0.0001,0.01,0.742,1313,1291
13,2704,10,100,0.0001,0.01,0.716,1365,1339
13,2804,10,100,0.0001,0.01,0.728,1417,1387
13,2904,10,100,0.0001,0.01,0.716,1473,1431
13,3004,10,100,0.0001,0.01,0.726,1529,1475
13,3104,10,100,0.0001,0.01,0.712,1584,1520
13,3204,10,100,0.0001,0.01,0.706,1641,1563
13,3304,10,100,0.0001,0.01,0.738,1695,1609
13,3404,10,100,0.0001,0.01,0.74,1751,1653
13,3504,10,100,0.0001,0.01,0.728,1805,1699
13,3604,10,100,0.0001,0.01,0.716,1856,1748
13,3704,10,100,0.0001,0.01,0.728,1912,1792
13,3804,10,100,0.0001,0.01,0.766,1967,1837
13,3904,10,100,0.0001,0.01,0.788,2014,1890
13,4004,10,100,0.0001,0.01,0.75,2068,1936
13,4104,10,100,0.0001,0.01,0.746,2111,1993
13,4204,10,100,0.0001,0.01,0.764,2150,2054
13,4304,10,100,0.0001,0.01,0.776,2205,2099
13,4404,10,100,0.0001,0.01,0.774,2256,2148
13,4504,10,100,0.0001,0.01,0.77,2298,2206
13,4604,10,100,0.0001,0.01,0.752,2338,2266
13,4704,10,100,0.0001,0.01,0.756,2389,2315
13,4804,10,100,0.0001,0.01,0.742,2442,2362
13,4904,10,100,0.0001,0.01,0.766,2489,2415
13,5004,10,100,0.0001,0.01,0.802,2534,2470
13,5104,10,100,0.0001,0.01,0.81,2582,2522
13,5204,10,100,0.0001,0.01,0.76,2629,2575
13,5304,10,100,0.0001,0.01,0.776,2679,2625
13,5404,10,100,0.0001,0.01,0.778,2722,2682
13,5504,10,100,0.0001,0.01,0.78,2774,2730
13,5604,10,100,0.0001,0.01,0.772,2827,2777
13,5704,10,100,0.0001,0.01,0.798,2876,2828
13,5804,10,100,0.0001,0.01,0.812,2925,2879
13,5904,10,100,0.0001,0.01,0.768,2976,2928
13,6004,10,100,0.0001,0.01,0.812,3033,2971
13,6104,10,100,0.0001,0.01,0.75,3082,3022
13,6204,10,100,0.0001,0.01,0.78,3133,3071
13,6304,10,100,0.0001,0.01,0.794,3182,3122
13,6404,10,100,0.0001,0.01,0.73,3233,3171
13,6504,10,100,0.0001,0.01,0.776,3287,3217
13,6604,10,100,0.0001,0.01,0.778,3344,3260
13,6704,10,100,0.0001,0.01,0.78,3402,3302
13,6804,10,100,0.0001,0.01,0.796,3454,3350
13,6904,10,100,0.0001,0.01,0.806,3503,3401
13,7004,10,100,0.0001,0.01,0.814,3555,3449
13,7104,10,100,0.0001,0.01,0.796,3598,3506
13,7204,10,100,0.0001,0.01,0.79,3644,3560
13,7304,10,100,0.0001,0.01,0.816,3691,3613
13,7404,10,100,0.0001,0.01,0.814,3743,3661
13,7504,10,100,0.0001,0.01,0.802,3793,3711
13,7604,10,100,0.0001,0.01,0.796,3840,3764
13,7704,10,100,0.0001,0.01,0.806,3892,3812
13,7804,10,100,0.0001,0.01,0.794,3948,3856
13,7904,10,100,0.0001,0.01,0.818,3994,3910
13,8004,10,100,0.0001,0.01,0.832,4038,3966
13,8104,10,100,0.0001,0.01,0.824,4094,4010
13,8204,10,100,0.0001,0.01,0.842,4138,4066
13,8304,10,100,0.0001,0.01,0.816,4187,4117
13,8404,10,100,0.0001,0.01,0.842,4240,4164
13,8504,10,100,0.0001,0.01,0.838,4291,4213
13,8604,10,100,0.0001,0.01,0.836,4337,4267
13,8704,10,100,0.0001,0.01,0.83,4393,4311
13,8804,10,100,0.0001,0.01,0.8,4447,4357
13,8904,10,100,0.0001,0.01,0.826,4492,4412
13,9004,10,100,0.0001,0.01,0.834,4534,4470
13,9104,10,100,0.0001,0.01,0.834,4585,4519
13,9204,10,100,0.0001,0.01,0.85,4627,4577
13,9304,10,100,0.0001,0.01,0.842,4684,4620
13,9404,10,100,0.0001,0.01,0.862,4726,4678
13,9504,10,100,0.0001,0.01,0.868,4782,4722
13,9604,10,100,0.0001,0.01,0.848,4823,4781
13,9704,10,100,0.0001,0.01,0.824,4873,4831
13,9804,10,100,0.0001,0.01,0.828,4925,4879
13,9904,10,100,0.0001,0.01,0.826,4975,4929
13,10004,10,100,0.0001,0.01,0.832,5031,4973
13,10104,10,100,0.0001,0.01,0.878,5083,5021
13,10204,10,100,0.0001,0.01,0.858,5125,5079
13,10304,10,100,0.0001,0.01,0.868,5186,5118
13,10404,10,100,0.0001,0.01,0.864,5238,5166
13,10504,10,100,0.0001,0.01,0.884,5287,5217
13,10604,10,100,0.0001,0.01,0.872,5335,5269
13,10704,10,100,0.0001,0.01,0.848,5384,5320
13,10804,10,100,0.0001,0.01,0.834,5438,5366
13,10904,10,100,0.0001,0.01,0.858,5491,5413
13,11004,10,100,0.0001,0.01,0.876,5533,5471
13,11104,10,100,0.0001,0.01,0.876,5569,5535
13,11204,10,100,0.0001,0.01,0.894,5622,5582
13,11304,10,100,0.0001,0.01,0.894,5676,5628
13,11404,10,100,0.0001,0.01,0.87,5726,5678
13,11504,10,100,0.0001,0.01,0.894,5767,5737
13,11604,10,100,0.0001,0.01,0.904,5818,5786
13,11704,10,100,0.0001,0.01,0.894,5864,5840
13,11804,10,100,0.0001,0.01,0.892,5919,5885
13,11904,10,100,0.0001,0.01,0.918,5979,5925
13,12004,10,100,0.0001,0.01,0.872,6029,5975
13,12104,10,100,0.0001,0.01,0.898,6069,6035
13,12204,10,100,0.0001,0.01,0.896,6117,6087
13,12304,10,100,0.0001,0.01,0.918,6170,6134
13,12404,10,100,0.0001,0.01,0.916,6218,6186
13,12504,10,100,0.0001,0.01,0.938,6265,6239
13,12604,10,100,0.0001,0.01,0.928,6313,6291
13,12704,10,100,0.0001,0.01,0.93,6366,6338
13,12804,10,100,0.0001,0.01,0.918,6417,6387
13,12904,10,100,0.0001,0.01,0.914,6472,6432
13,13004,10,100,0.0001,0.01,0.928,6525,6479
13,13104,10,100,0.0001,0.01,0.936,6573,6531
13,13204,10,100,0.0001,0.01,0.936,6623,6581
13,13304,10,100,0.0001,0.01,0.934,6664,6640
13,13404,10,100,0.0001,0.01,0.936,6715,6689
13,13504,10,100,0.0001,0.01,0.942,6755,6749
13,13604,10,100,0.0001,0.01,0.938,6806,6798
13,13704,10,100,0.0001,0.01,0.926,6856,6848
13,13804,10,100,0.0001,0.01,0.928,6903,6901
13,13904,10,100,0.0001,0.01,0.944,6952,6952
13,14004,10,100,0.0001,0.01,0.936,6995,7009
13,14104,10,100,0.0001,0.01,0.946,7038,7066
13,14204,10,100,0.0001,0.01,0.946,7084,7120
13,14304,10,100,0.0001,0.01,0.954,7133,7171
13,14404,10,100,0.0001,0.01,0.938,7192,7212
13,14504,10,100,0.0001,0.01,0.948,7239,7265
13,14604,10,100,0.0001,0.01,0.952,7293,7311
13,14704,10,100,0.0001,0.01,0.954,7341,7363
13,14804,10,100,0.0001,0.01,0.958,7393,7411
13,14904,10,100,0.0001,0.01,0.954,7447,7457
13,15004,10,100,0.0001,0.01,0.962,7492,7512
14,104,10,100,0.0001,0.01,0.498,46,58
14,204,10,100,0.0001,0.01,0.528,98,106
14,304,10,100,0.0001,0.01,0.54,150,154
14,404,10,100,0.0001,0.01,0.486,197,207
14,504,10,100,0.0001,0.01,0.494,249,255
14,604,10,100,0.0001,0.01,0.516,301,303
14,704,10,100,0.0001,0.01,0.51,350,354
14,804,10,100,0.0001,0.01,0.524,401,403
14,904,10,100,0.0001,0.01,0.508,443,461
14,1004,10,100,0.0001,0.01,0.512,488,516
14,1104,10,100,0.0001,0.01,0.496,545,559
14,1204,10,100,0.0001,0.01,0.52,600,604
14,1304,10,100,0.0001,0.01,0.538,656,648
14,1404,10,100,0.0001,0.01,0.554,704,700
14,1504,10,100,0.0001,0.01,0.524,754,750
14,1604,10,100,0.0001,0.01,0.522,802,802
14,1704,10,100,0.0001,0.01,0.536,856,848
14,1804,10,100,0.0001,0.01,0.532,899,905
14,1904,10,100,0.0001,0.01,0.548,952,952
14,2004,10,100,0.0001,0.01,0.582,994,1010
14,2104,10,100,0.0001,0.01,0.582,1041,1063
14,2204,10,100,0.0001,0.01,0.592,1090,1114
14,2304,10,100,0.0001,0.01,0.618,1133,1171
14,2404,10,100,0.0001,0.01,0.658,1188,1216
14,2504,10,100,0.0001,0.01,0.668,1235,1269
14,2604,10,100,0.0001,0.01,0.676,1289,1315
14,2704,10,100,0.0001,0.01,0.674,1333,1371
14,2804,10,100,0.0001,0.01,0.706,1386,1418
14,2904,10,100,0.0001,0.01,0.64,1432,1472
14,3004,10,100,0.0001,0.01,0.644,1484,1520
14,3104,10,100,0.0001,0.01,0.682,1537,1567
14,3204,10,100,0.0001,0.01,0.712,1585,1619
14,3304,10,100,0.0001,0.01,0.694,1635,1669
14,3404,10,100,0.0001,0.01,0.686,1689,1715
14,3504,10,100,0.0001,0.01,0.734,1745,1759
14,3604,10,100,0.0001,0.01,0.716,1802,1802
14,3704,10,100,0.0001,0.01,0.72,1854,1850
14,3804,10,100,0.0001,0.01,0.726,1908,1896
14,3904,10,100,0.0001,0.01,0.722,1958,1946
14,4004,10,100,0.0001,0.01,0.734,2002,2002
14,4104,10,100,0.0001,0.01,0.752,2058,2046
14,4204,10,100,0.0001,0.01,0.776,2107,2097
14,4304,10,100,0.0001,0.01,0.744,2150,2154
14,4404,10,100,0.0001,0.01,0.778,2197,2207
14,4504,10,100,0.0001,0.01,0.732,2251,2253
14,4604,10,100,0.0001,0.01,0.76,2295,2309
14,4704,10,100,0.0001,0.01,0.75,2354,2350
14,4804,10,100,0.0001,0.01,0.784,2405,2399
14,4904,10,100,0.0001,0.01,0.746,2453,2451
14,5004,10,100,0.0001,0.01,0.764,2498,2506
14,5104,10,100,0.0001,0.01,0.758,2551,2553
14,5204,10,100,0.0001,0.01,0.78,2607,2597
14,5304,10,100,0.0001,0.01,0.794,2649,2655
14,5404,10,100,0.0001,0.01,0.796,2699,2705
14,5504,10,100,0.0001,0.01,0.764,2756,2748
14,5604,10,100,0.0001,0.01,0.768,2804,2800
14,5704,10,100,0.0001,0.01,0.77,2848,2856
14,5804,10,100,0.0001,0.01,0.786,2897,2907
14,5904,10,100,0.0001,0.01,0.788,2964,2940
14,6004,10,100,0.0001,0.01,0.802,3014,2990
14,6104,10,100,0.0001,0.01,0.806,3067,3037
14,6204,10,100,0.0001,0.01,0.78,3121,3083
14,6304,10,100,0.0001,0.01,0.812,3183,3121
14,6404,10,100,0.0001,0.01,0.802,3238,3166
14,6504,10,100,0.0001,0.01,0.798,3284,3220
14,6604,10,100,0.0001,0.01,0.806,3328,3276
14,6704,10,100,0.0001,0.01,0.812,3378,3326
14,6804,10,100,0.0001,0.01,0.802,3419,3385
14,6904,10,100,0.0001,0.01,0.816,3470,3434
14,7004,10,100,0.0001,0.01,0.818,3519,3485
14,7104,10,100,0.0001,0.01,0.822,3570,3534
14,7204,10,100,0.0001,0.01,0.818,3615,3589
14,7304,10,100,0.0001,0.01,0.804,3666,3638
14,7404,10,100,0.0001,0.01,0.81,3723,3681
14,7504,10,100,0.0001,0.01,0.826,3770,3734
14,7604,10,100,0.0001,0.01,0.816,3823,3781
14,7704,10,100,0.0001,0.01,0.84,3875,3829
14,7804,10,100,0.0001,0.01,0.8,3925,3879
14,7904,10,100,0.0001,0.01,0.87,3980,3924
14,8004,10,100,0.0001,0.01,0.83,4029,3975
14,8104,10,100,0.0001,0.01,0.848,4075,4029
14,8204,10,100,0.0001,0.01,0.822,4120,4084
14,8304,10,100,0.0001,0.01,0.838,4172,4132
14,8404,10,100,0.0001,0.01,0.82,4227,4177
14,8504,10,100,0.0001,0.01,0.842,4267,4237
14,8604,10,100,0.0001,0.01,0.842,4320,4284
14,8704,10,100,0.0001,0.01,0.84,4375,4329
14,8804,10,100,0.0001,0.01,0.816,4430,4374
14,8904,10,100,0.0001,0.01,0.854,4476,4428
14,9004,10,100,0.0001,0.01,0.808,4525,4479
14,9104,10,100,0.0001,0.01,0.854,4582,4522
14,9204,10,100,0.0001,0.01,0.85,4626,4578
14,9304,10,100,0.0001,0.01,0.85,4684,4620
14,9404,10,100,0.0001,0.01,0.862,4738,4666
14,9504,10,100,0.0001,0.01,0.864,4780,4724
14,9604,10,100,0.0001,0.01,0.852,4828,4776
14,9704,10,100,0.0001,0.01,0.874,4871,4833
14,9804,10,100,0.0001,0.01,0.868,4918,4886
14,9904,10,100,0.0001,0.01,0.866,4958,4946
14,10004,10,100,0.0001,0.01,0.858,5015,4989
14,10104,10,100,0.0001,0.01,0.866,5066,5038
14,10204,10,100,0.0001,0.01,0.854,5117,5087
14,10304,10,100,0.0001,0.01,0.87,5169,5135
14,10404,10,100,0.0001,0.01,0.844,5222,5182
14,10504,10,100,0.0001,0.01,0.844,5276,5228
14,10604,10,100,0.0001,0.01,0.87,5324,5280
14,10704,10,100,0.0001,0.01,0.884,5382,5322
14,10804,10,100,0.0001,0.01,0.874,5422,5382
14,10904,10,100,0.0001,0.01,0.882,5477,5427
14,11004,10,100,0.0001,0.01,0.866,5521,5483
14,11104,10,100,0.0001,0.01,0.874,5569,5535
14,11204,10,100,0.0001,0.01,0.864,5614,5590
14,11304,10,100,0.0001,0.01,0.846,5664,5640
14,11404,10,100,0.0001,0.01,0.846,5708,5696
14,11504,10,100,0.0001,0.01,0.864,5751,5753
14,11604,10,100,0.0001,0.01,0.864,5804,5800
14,11704,10,100,0.0001,0.01,0.882,5851,5853
14,11804,10,100,0.0001,0.01,0.872,5909,5895
14,11904,10,100,0.0001,0.01,0.844,5953,5951
14,12004,10,100,0.0001,0.01,0.872,6012,5992
14,12104,10,100,0.0001,0.01,0.882,6068,6036
14,12204,10,100,0.0001,0.01,0.876,6123,6081
14,12304,10,100,0.0001,0.01,0.89,6172,6132
14,12404,10,100,0.0001,0.01,0.86,6217,6187
14,12504,10,100,0.0001,0.01,0.884,6263,6241
14,12604,10,100,0.0001,0.01,0.87,6317,6287
14,12704,10,100,0.0001,0.01,0.9,6374,6330
14,12804,10,100,0.0001,0.01,0.882,6422,6382
14,12904,10,100,0.0001,0.01,0.898,6468,6436
14,13004,10,100,0.0001,0.01,0.878,6511,6493
14,13104,10,100,0.0001,0.01,0.888,6561,6543
14,13204,10,100,0.0001,0.01,0.894,6607,6597
14,13304,10,100,0.0001,0.01,0.9,6652,6652
14,13404,10,100,0.0001,0.01,0.892,6704,6700
14,13504,10,100,0.0001,0.01,0.89,6750,6754
14,13604,10,100,0.0001,0.01,0.89,6803,6801
14,13704,10,100,0.0001,0.01,0.9,6858,6846
14,13804,10,100,0.0001,0.01,0.876,6908,6896
14,13904,10,100,0.0001,0.01,0.866,6962,6942
14,14004,10,100,0.0001,0.01,0.878,7010,6994
14,14104,10,100,0.0001,0.01,0.892,7061,7043
14,14204,10,100,0.0001,0.01,0.888,7110,7094
14,14304,10,100,0.0001,0.01,0.892,7159,7145
14,14404,10,100,0.0001,0.01,0.908,7213,7191
14,14504,10,100,0.0001,0.01,0.896,7265,7239
14,14604,10,100,0.0001,0.01,0.898,7308,7296
14,14704,10,100,0.0001,0.01,0.908,7367,7337
14,14804,10,100,0.0001,0.01,0.902,7420,7384
14,14904,10,100,0.0001,0.01,0.93,7466,7438
14,15004,10,100,0.0001,0.01,0.884,7516,7488
15,104,10,100,0.0001,0.01,0.496,49,55
15,204,10,100,0.0001,0.01,0.502,99,105
15,304,10,100,0.0001,0.01,0.464,151,153
15,404,10,100,0.0001,0.01,0.482,205,199
15,504,10,100,0.0001,0.01,0.508,253,251
15,604,10,100,0.0001,0.01,0.51,308,296
15,704,10,100,0.0001,0.01,0.524,362,342
15,804,10,100,0.0001,0.01,0.52,413,391
15,904,10,100,0.0001,0.01,0.488,463,441
15,1004,10,100,0.0001,0.01,0.484,509,495
15,1104,10,100,0.0001,0.01,0.508,558,546
15,1204,10,100,0.0001,0.01,0.512,607,597
15,1304,10,100,0.0001,0.01,0.49,654,650
15,1404,10,100,0.0001,0.01,0.508,710,694
15,1504,10,100,0.0001,0.01,0.496,756,748
15,1604,10,100,0.0001,0.01,0.532,809,795
15,1704,10,100,0.0001,0.01,0.536,875,829
15,1804,10,100,0.0001,0.01,0.524,926,878
15,1904,10,100,0.0001,0.01,0.57,977,927
15,2004,10,100,0.0001,0.01,0.574,1017,987
15,2104,10,100,0.0001,0.01,0.556,1063,1041
15,2204,10,100,0.0001,0.01,0.606,1109,1095
15,2304,10,100,0.0001,0.01,0.636,1158,1146
15,2404,10,100,0.0001,0.01,0.65,1210,1194
15,2504,10,100,0.0001,0.01,0.672,1264,1240
15,2604,10,100,0.0001,0.01,0.684,1319,1285
15,2704,10,100,0.0001,0.01,0.696,1375,1329
15,2804,10,100,0.0001,0.01,0.69,1429,1375
15,2904,10,100,0.0001,0.01,0.698,1468,1436
15,3004,10,100,0.0001,0.01,0.712,1524,1480
15,3104,10,100,0.0001,0.01,0.64,1578,1526
15,3204,10,100,0.0001,0.01,0.716,1630,1574
15,3304,10,100,0.0001,0.01,0.728,1680,1624
15,3404,10,100,0.0001,0.01,0.744,1729,1675
15,3504,10,100,0.0001,0.01,0.746,1784,1720
15,3604,10,100,0.0001,0.01,0.746,1829,1775
15,3704,10,100,0.0001,0.01,0.746,1885,1819
15,3804,10,100,0.0001,0.01,0.754,1938,1866
15,3904,10,100,0.0001,0.01,0.716,1984,1920
15,4004,10,100,0.0001,0.01,0.768,2036,1968
15,4104,10,100,0.0001,0.01,0.77,2088,2016
15,4204,10,100,0.0001,0.01,0.76,2144,2060
15,4304,10,100,0.0001,0.01,0.742,2198,2106
15,4404,10,100,0.0001,0.01,0.782,2254,2150
15,4504,10,100,0.0001,0.01,0.75,2296,2208
15,4604,10,100,0.0001,0.01,0.748,2338,2266
15,4704,10,100,0.0001,0.01,0.76,2388,2316
15,4804,10,100,0.0001,0.01,0.802,2441,2363
15,4904,10,100,0.0001,0.01,0.794,2493,2411
15,5004,10,100,0.0001,0.01,0.77,2537,2467
15,5104,10,100,0.0001,0.01,0.8,2589,2515
15,5204,10,100,0.0001,0.01,0.796,2636,2568
15,5304,10,100,0.0001,0.01,0.788,2696,2608
15,5404,10,100,0.0001,0.01,0.762,2742,2662
15,5504,10,100,0.0001,0.01,0.742,2785,2719
15,5604,10,100,0.0001,0.01,0.78,2823,2781
15,5704,10,100,0.0001,0.01,0.768,2867,2837
15,5804,10,100,0.0001,0.01,0.808,2919,2885
15,5904,10,100,0.0001,0.01,0.79,2970,2934
15,6004,10,100,0.0001,0.01,0.826,3022,2982
15,6104,10,100,0.0001,0.01,0.796,3067,3037
15,6204,10,100,0.0001,0.01,0.814,3124,3080
15,6304,10,100,0.0001,0.01,0.808,3181,3123
15,6404,10,100,0.0001,0.01,0.792,3236,3168
15,6504,10,100,0.0001,0.01,0.814,3290,3214
15,6604,10,100,0.0001,0.01,0.808,3333,3271
15,6704,10,100,0.0001,0.01,0.814,3380,3324
15,6804,10,100,0.0001,0.01,0.808,3435,3369
15,6904,10,100,0.0001,0.01,0.814,3492,3412
15,7004,10,100,0.0001,0.01,0.812,3543,3461
15,7104,10,100,0.0001,0.01,0.81,3592,3512
15,7204,10,100,0.0001,0.01,0.808,3647,3557
15,7304,10,100,0.0001,0.01,0.79,3696,3608
15,7404,10,100,0.0001,0.01,0.832,3747,3657
15,7504,10,100,0.0001,0.01,0.808,3792,3712
15,7604,10,100,0.0001,0.01,0.812,3841,3763
15,7704,10,100,0.0001,0.01,0.824,3891,3813
15,7804,10,100,0.0001,0.01,0.802,3938,3866
15,7904,10,100,0.0001,0.01,0.8,3993,3911
15,8004,10,100,0.0001,0.01,0.832,4049,3955
15,8104,10,100,0.0001,0.01,0.822,4095,4009
15,8204,10,100,0.0001,0.01,0.84,4143,4061
15,8304,10,100,0.0001,0.01,0.844,4195,4109
15,8404,10,100,0.0001,0.01,0.858,4246,4158
15,8504,10,100,0.0001,0.01,0.816,4293,4211
15,8604,10,100,0.0001,0.01,0.84,4340,4264
15,8704,10,100,0.0001,0.01,0.856,4387,4317
15,8804,10,100,0.0001,0.01,0.826,4434,4370
15,8904,10,100,0.0001,0.01,0.842,4480,4424
15,9004,10,100,0.0001,0.01,0.858,4527,4477
15,9104,10,100,0.0001,0.01,0.864,4577,4527
15,9204,10,100,0.0001,0.01,0.844,4626,4578
15,9304,10,100,0.0001,0.01,0.838,4678,4626
15,9404,10,100,0.0001,0.01,0.844,4727,4677
15,9504,10,100,0.0001,0.01,0.85,4769,4735
15,9604,10,100,0.0001,0.01,0.864,4826,4778
15,9704,10,100,0.0001,0.01,0.874,4875,4829
15,9804,10,100,0.0001,0.01,0.874,4922,4882
15,9904,10,100,0.0001,0.01,0.87,4970,4934
15,10004,10,100,0.0001,0.01,0.878,5020,4984
15,10104,10,100,0.0001,0.01,0.882,5068,5036
15,10204,10,100,0.0001,0.01,0.886,5121,5083
15,10304,10,100,0.0001,0.01,0.89,5171,5133
15,10404,10,100,0.0001,0.01,0.878,5225,5179
15,10504,10,100,0.0001,0.01,0.882,5268,5236
15,10604,10,100,0.0001,0.01,0.86,5318,5286
15,10704,10,100,0.0001,0.01,0.886,5364,5340
15,10804,10,100,0.0001,0.01,0.882,5415,5389
15,10904,10,100,0.0001,0.01,0.87,5462,5442
15,11004,10,100,0.0001,0.01,0.87,5521,5483
15,11104,10,100,0.0001,0.01,0.9,5569,5535
15,11204,10,100,0.0001,0.01,0.89,5622,5582
15,11304,10,100,0.0001,0.01,0.88,5671,5633
15,11404,10,100,0.0001,0.01,0.89,5720,5684
15,11504,10,100,0.0001,0.01,0.892,5767,5737
15,11604,10,100,0.0001,0.01,0.896,5813,5791
15,11704,10,100,0.0001,0.01,0.886,5864,5840
15,11804,10,100,0.0001,0.01,0.892,5920,5884
15,11904,10,100,0.0001,0.01,0.89,5973,5931
15,12004,10,100,0.0001,0.01,0.916,6031,5973
15,12104,10,100,0.0001,0.01,0.9,6078,6026
15,12204,10,100,0.0001,0.01,0.888,6122,6082
15,12304,10,100,0.0001,0.01,0.902,6169,6135
15,12404,10,100,0.0001,0.01,0.874,6212,6192
15,12504,10,100,0.0001,0.01,0.86,6259,6245
15,12604,10,100,0.0001,0.01,0.882,6314,6290
15,12704,10,100,0.0001,0.01,0.892,6362,6342
15,12804,10,100,0.0001,0.01,0.898,6412,6392
15,12904,10,100,0.0001,0.01,0.892,6462,6442
15,13004,10,100,0.0001,0.01,0.888,6512,6492
15,13104,10,100,0.0001,0.01,0.908,6567,6537
15,13204,10,100,0.0001,0.01,0.89,6617,6587
15,13304,10,100,0.0001,0.01,0.904,6667,6637
15,13404,10,100,0.0001,0.01,0.898,6717,6687
15,13504,10,100,0.0001,0.01,0.888,6762,6742
15,13604,10,100,0.0001,0.01,0.908,6803,6801
15,13704,10,100,0.0001,0.01,0.926,6840,6864
15,13804,10,100,0.0001,0.01,0.906,6888,6916
15,13904,10,100,0.0001,0.01,0.916,6942,6962
15,14004,10,100,0.0001,0.01,0.926,7001,7003
15,14104,10,100,0.0001,0.01,0.914,7052,7052
15,14204,10,100,0.0001,0.01,0.922,7108,7096
15,14304,10,100,0.0001,0.01,0.864,7156,7148
15,14404,10,100,0.0001,0.01,0.884,7207,7197
15,14504,10,100,0.0001,0.01,0.908,7258,7246
15,14604,10,100,0.0001,0.01,0.904,7303,7301
15,14704,10,100,0.0001,0.01,0.912,7351,7353
15,14804,10,100,0.0001,0.01,0.924,7407,7397
15,14904,10,100,0.0001,0.01,0.916,7456,7448
15,15004,10,100,0.0001,0.01,0.91,7504,7500
16,104,10,100,0.0001,0.01,0.506,50,54
16,204,10,100,0.0001,0.01,0.504,100,104
16,304,10,100,0.0001,0.01,0.552,148,156
16,404,10,100,0.0001,0.01,0.512,194,210
16,504,10,100,0.0001,0.01,0.544,247,257
16,604,10,100,0.0001,0.01,0.518,300,304
16,704,10,100,0.0001,0.01,0.5,353,351
16,804,10,100,0.0001,0.01,0.542,401,403
16,904,10,100,0.0001,0.01,0.532,456,448
16,1004,10,100,0.0001,0.01,0.514,508,496
16,1104,10,100,0.0001,0.01,0.51,545,559
16,1204,10,100,0.0001,0.01,0.504,592,612
16,1304,10,100,0.0001,0.01,0.476,641,663
16,1404,10,100,0.0001,0.01,0.468,693,711
16,1504,10,100,0.0001,0.01,0.476,740,764
16,1604,10,100,0.0001,0.01,0.442,794,810
16,1704,10,100,0.0001,0.01,0.49,840,864
16,1804,10,100,0.0001,0.01,0.484,890,914
16,1904,10,100,0.0001,0.01,0.468,938,966
16,2004,10,100,0.0001,0.01,0.49,986,1018
16,2104,10,100,0.0001,0.01,0.486,1032,1072
16,2204,10,100,0.0001,0.01,0.504,1081,1123
16,2304,10,100,0.0001,0.01,0.522,1135,1169
16,2404,10,100,0.0001,0.01,0.508,1189,1215
16,2504,10,100,0.0001,0.01,0.522,1241,1263
16,2604,10,100,0.0001,0.01,0.482,1294,1310
16,2704,10,100,0.0001,0.01,0.474,1350,1354
16,2804,10,100,0.0001,0.01,0.466,1396,1408
16,2904,10,100,0.0001,0.01,0.524,1443,1461
16,3004,10,100,0.0001,0.01,0.532,1494,1510
16,3104,10,100,0.0001,0.01,0.51,1543,1561
16,3204,10,100,0.0001,0.01,0.532,1597,1607
16,3304,10,100,0.0001,0.01,0.482,1646,1658
16,3404,10,100,0.0001,0.01,0.514,1694,1710
16,3504,10,100,0.0001,0.01,0.51,1739,1765
16,3604,10,100,0.0001,0.01,0.528,1791,1813
16,3704,10,100,0.0001,0.01,0.514,1843,1861
16,3804,10,100,0.0001,0.01,0.53,1897,1907
16,3904,10,100,0.0001,0.01,0.508,1951,1953
16,4004,10,100,0.0001,0.01,0.516,1999,2005
16,4104,10,100,0.0001,0.01,0.546,2044,2060
16,4204,10,100,0.0001,0.01,0.514,2095,2109
16,4304,10,100,0.0001,0.01,0.534,2146,2158
16,4404,10,100,0.0001,0.01,0.514,2200,2204
16,4504,10,100,0.0001,0.01,0.548,2247,2257
16,4604,10,100,0.0001,0.01,0.524,2305,2299
16,4704,10,100,0.0001,0.01,0.54,2365,2339
16,4804,10,100,0.0001,0.01,0.546,2422,2382
16,4904,10,100,0.0001,0.01,0.54,2472,2432
16,5004,10,100,0.0001,0.01,0.56,2530,2474
16,5104,10,100,0.0001,0.01,0.55,2578,2526
16,5204,10,100,0.0001,0.01,0.55,2623,2581
16,5304,10,100,0.0001,0.01,0.548,2666,2638
16,5404,10,100,0.0001,0.01,0.56,2721,2683
16,5504,10,100,0.0001,0.01,0.558,2769,2735
16,5604,10,100,0.0001,0.01,0.59,2814,2790
16,5704,10,100,0.0001,0.01,0.586,2863,2841
16,5804,10,100,0.0001,0.01,0.598,2909,2895
16,5904,10,100,0.0001,0.01,0.612,2963,2941
16,6004,10,100,0.0001,0.01,0.612,3017,2987
16,6104,10,100,0.0001,0.01,0.61,3063,3041
16,6204,10,100,0.0001,0.01,0.608,3119,3085
16,6304,10,100,0.0001,0.01,0.6,3176,3128
16,6404,10,100,0.0001,0.01,0.612,3233,3171
16,6504,10,100,0.0001,0.01,0.686,3282,3222
16,6604,10,100,0.0001,0.01,0.644,3333,3271
16,6704,10,100,0.0001,0.01,0.67,3383,3321
16,6804,10,100,0.0001,0.01,0.652,3434,3370
16,6904,10,100,0.0001,0.01,0.666,3486,3418
16,7004,10,100,0.0001,0.01,0.672,3544,3460
16,7104,10,100,0.0001,0.01,0.64,3597,3507
16,7204,10,100,0.0001,0.01,0.688,3641,3563
16,7304,10,100,0.0001,0.01,0.664,3698,3606
16,7404,10,100,0.0001,0.01,0.69,3752,3652
16,7504,10,100,0.0001,0.01,0.692,3816,3688
16,7604,10,100,0.0001,0.01,0.67,3859,3745
16,7704,10,100,0.0001,0.01,0.66,3915,3789
16,7804,10,100,0.0001,0.01,0.674,3955,3849
16,7904,10,100,0.0001,0.01,0.71,4008,3896
16,8004,10,100,0.0001,0.01,0.68,4058,3946
16,8104,10,100,0.0001,0.01,0.656,4112,3992
16,8204,10,100,0.0001,0.01,0.68,4164,4040
16,8304,10,100,0.0001,0.01,0.698,4212,4092
16,8404,10,100,0.0001,0.01,0.686,4253,4151
16,8504,10,100,0.0001,0.01,0.724,4300,4204
16,8604,10,100,0.0001,0.01,0.694,4351,4253
16,8704,10,100,0.0001,0.01,0.686,4403,4301
16,8804,10,100,0.0001,0.01,0.702,4456,4348
16,8904,10,100,0.0001,0.01,0.702,4501,4403
16,9004,10,100,0.0001,0.01,0.696,4540,4464
16,9104,10,100,0.0001,0.01,0.714,4584,4520
16,9204,10,100,0.0001,0.01,0.69,4637,4567
16,9304,10,100,0.0001,0.01,0.698,4677,4627
16,9404,10,100,0.0001,0.01,0.704,4717,4687
16,9504,10,100,0.0001,0.01,0.692,4764,4740
16,9604,10,100,0.0001,0.01,0.716,4811,4793
16,9704,10,100,0.0001,0.01,0.724,4864,4840
16,9804,10,100,0.0001,0.01,0.726,4916,4888
16,9904,10,100,0.0001,0.01,0.728,4965,4939
16,10004,10,100,0.0001,0.01,0.72,5011,4993
16,10104,10,100,0.0001,0.01,0.738,5060,5044
16,10204,10,100,0.0001,0.01,0.75,5102,5102
16,10304,10,100,0.0001,0.01,0.73,5156,5148
16,10404,10,100,0.0001,0.01,0.734,5215,5189
16,10504,10,100,0.0001,0.01,0.768,5257,5247
16,10604,10,100,0.0001,0.01,0.758,5305,5299
16,10704,10,100,0.0001,0.01,0.758,5346,5358
16,10804,10,100,0.0001,0.01,0.79,5394,5410
16,10904,10,100,0.0001,0.01,0.772,5447,5457
16,11004,10,100,0.0001,0.01,0.764,5496,5508
16,11104,10,100,0.0001,0.01,0.782,5549,5555
16,11204,10,100,0.0001,0.01,0.774,5602,5602
16,11304,10,100,0.0001,0.01,0.788,5652,5652
16,11404,10,100,0.0001,0.01,0.81,5685,5719
16,11504,10,100,0.0001,0.01,0.764,5736,5768
16,11604,10,100,0.0001,0.01,0.798,5782,5822
16,11704,10,100,0.0001,0.01,0.804,5821,5883
16,11804,10,100,0.0001,0.01,0.772,5881,5923
16,11904,10,100,0.0001,0.01,0.794,5935,5969
16,12004,10,100,0.0001,0.01,0.826,5983,6021
16,12104,10,100,0.0001,0.01,0.834,6033,6071
16,12204,10,100,0.0001,0.01,0.81,6081,6123
16,12304,10,100,0.0001,0.01,0.808,6130,6174
16,12404,10,100,0.0001,0.01,0.83,6179,6225
16,12504,10,100,0.0001,0.01,0.846,6240,6264
16,12604,10,100,0.0001,0.01,0.856,6282,6322
16,12704,10,100,0.0001,0.01,0.836,6330,6374
16,12804,10,100,0.0001,0.01,0.87,6384,6420
16,12904,10,100,0.0001,0.01,0.852,6434,6470
16,13004,10,100,0.0001,0.01,0.864,6487,6517
16,13104,10,100,0.0001,0.01,0.85,6533,6571
16,13204,10,100,0.0001,0.01,0.83,6582,6622
16,13304,10,100,0.0001,0.01,0.852,6642,6662
16,13404,10,100,0.0001,0.01,0.87,6689,6715
16,13504,10,100,0.0001,0.01,0.874,6743,6761
16,13604,10,100,0.0001,0.01,0.876,6784,6820
16,13704,10,100,0.0001,0.01,0.894,6839,6865
16,13804,10,100,0.0001,0.01,0.89,6894,6910
16,13904,10,100,0.0001,0.01,0.904,6945,6959
16,14004,10,100,0.0001,0.01,0.89,6994,7010
16,14104,10,100,0.0001,0.01,0.902,7042,7062
16,14204,10,100,0.0001,0.01,0.9,7088,7116
16,14304,10,100,0.0001,0.01,0.92,7139,7165
16,14404,10,100,0.0001,0.01,0.9,7185,7219
16,14504,10,100,0.0001,0.01,0.88,7231,7273
16,14604,10,100,0.0001,0.01,0.88,7279,7325
16,14704,10,100,0.0001,0.01,0.922,7330,7374
16,14804,10,100,0.0001,0.01,0.934,7389,7415
16,14904,10,100,0.0001,0.01,0.9,7440,7464
16,15004,10,100,0.0001,0.01,0.922,7488,7516
17,104,10,100,0.0001,0.01,0.542,55,49
17,204,10,100,0.0001,0.01,0.488,109,95
17,304,10,100,0.0001,0.01,0.45,159,145
17,404,10,100,0.0001,0.01,0.472,211,193
17,504,10,100,0.0001,0.01,0.486,263,241
17,604,10,100,0.0001,0.01,0.516,312,292
17,704,10,100,0.0001,0.01,0.492,366,338
17,804,10,100,0.0001,0.01,0.506,421,383
17,904,10,100,0.0001,0.01,0.494,470,434
17,1004,10,100,0.0001,0.01,0.502,519,485
17,1104,10,100,0.0001,0.01,0.484,574,530
17,1204,10,100,0.0001,0.01,0.5,625,579
17,1304,10,100,0.0001,0.01,0.534,672,632
17,1404,10,100,0.0001,0.01,0.534,717,687
17,1504,10,100,0.0001,0.01,0.542,767,737
17,1604,10,100,0.0001,0.01,0.538,816,788
17,1704,10,100,0.0001,0.01,0.55,871,833
17,1804,10,100,0.0001,0.01,0.578,925,879
17,1904,10,100,0.0001,0.01,0.578,973,931
17,2004,10,100,0.0001,0.01,0.64,1027,977
17,2104,10,100,0.0001,0.01,0.694,1079,1025
17,2204,10,100,0.0001,0.01,0.73,1127,1077
17,2304,10,100,0.0001,0.01,0.794,1174,1130
17,2404,10,100,0.0001,0.01,0.782,1223,1181
17,2504,10,100,0.0001,0.01,0.812,1275,1229
17,2604,10,100,0.0001,0.01,0.81,1319,1285
17,2704,10,100,0.0001,0.01,0.866,1371,1333
17,2804,10,100,0.0001,0.01,0.906,1417,1387
17,2904,10,100,0.0001,0.01,0.92,1473,1431
17,3004,10,100,0.0001,0.01,0.914,1525,1479
17,3104,10,100,0.0001,0.01,0.932,1572,1532
17,3204,10,100,0.0001,0.01,0.924,1621,1583
17,3304,10,100,0.0001,0.01,0.91,1668,1636
17,3404,10,100,0.0001,0.01,0.918,1722,1682
17,3504,10,100,0.0001,0.01,0.922,1769,1735
17,3604,10,100,0.0001,0.01,0.922,1822,1782
17,3704,10,100,0.0001,0.01,0.928,1874,1830
17,3804,10,100,0.0001,0.01,0.946,1918,1886
17,3904,10,100,0.0001,0.01,0.946,1964,1940
17,4004,10,100,0.0001,0.01,0.96,2011,1993
17,4104,10,100,0.0001,0.01,0.958,2062,2042
17,4204,10,100,0.0001,0.01,0.954,2106,2098
17,4304,10,100,0.0001,0.01,0.952,2159,2145
17,4404,10,100,0.0001,0.01,0.932,2206,2198
17,4504,10,100,0.0001,0.01,0.95,2251,2253
17,4604,10,100,0.0001,0.01,0.888,2292,2312
17,4704,10,100,0.0001,0.01,0.928,2350,2354
17,4804,10,100,0.0001,0.01,0.956,2393,2411
17,4904,10,100,0.0001,0.01,0.964,2444,2460
17,5004,10,100,0.0001,0.01,0.954,2493,2511
17,5104,10,100,0.0001,0.01,0.962,2540,2564
17,5204,10,100,0.0001,0.01,0.968,2594,2610
17,5304,10,100,0.0001,0.01,0.956,2640,2664
17,5404,10,100,0.0001,0.01,0.96,2691,2713
17,5504,10,100,0.0001,0.01,0.954,2740,2764
17,5604,10,100,0.0001,0.01,0.968,2790,2814
17,5704,10,100,0.0001,0.01,0.966,2837,2867
17,5804,10,100,0.0001,0.01,0.964,2892,2912
17,5904,10,100,0.0001,0.01,0.95,2939,2965
17,6004,10,100,0.0001,0.01,0.95,2993,3011
17,6104,10,100,0.0001,0.01,0.962,3042,3062
17,6204,10,100,0.0001,0.01,0.96,3091,3113
17,6304,10,100,0.0001,0.01,0.966,3140,3164
17,6404,10,100,0.0001,0.01,0.956,3190,3214
17,6504,10,100,0.0001,0.01,0.968,3233,3271
17,6604,10,100,0.0001,0.01,0.968,3285,3319
17,6704,10,100,0.0001,0.01,0.962,3338,3366
17,6804,10,100,0.0001,0.01,0.942,3389,3415
17,6904,10,100,0.0001,0.01,0.952,3440,3464
17,7004,10,100,0.0001,0.01,0.954,3480,3524
17,7104,10,100,0.0001,0.01,0.96,3534,3570
17,7204,10,100,0.0001,0.01,0.97,3585,3619
17,7304,10,100,0.0001,0.01,0.968,3634,3670
17,7404,10,100,0.0001,0.01,0.968,3680,3724
17,7504,10,100,0.0001,0.01,0.952,3737,3767
17,7604,10,100,0.0001,0.01,0.94,3785,3819
17,7704,10,100,0.0001,0.01,0.972,3844,3860
17,7804,10,100,0.0001,0.01,0.974,3890,3914
17,7904,10,100,0.0001,0.01,0.962,3937,3967
17,8004,10,100,0.0001,0.01,0.926,3979,4025
17,8104,10,100,0.0001,0.01,0.944,4031,4073
17,8204,10,100,0.0001,0.01,0.974,4083,4121
17,8304,10,100,0.0001,0.01,0.972,4138,4166
17,8404,10,100,0.0001,0.01,0.972,4181,4223
17,8504,10,100,0.0001,0.01,0.974,4244,4260
17,8604,10,100,0.0001,0.01,0.972,4298,4306
17,8704,10,100,0.0001,0.01,0.97,4350,4354
17,8804,10,100,0.0001,0.01,0.972,4390,4414
17,8904,10,100,0.0001,0.01,0.974,4445,4459
17,9004,10,100,0.0001,0.01,0.974,4502,4502
17,9104,10,100,0.0001,0.01,0.964,4546,4558
17,9204,10,100,0.0001,0.01,0.964,4600,4604
17,9304,10,100,0.0001,0.01,0.98,4655,4649
17,9404,10,100,0.0001,0.01,0.972,4708,4696
17,9504,10,100,0.0001,0.01,0.948,4757,4747
17,9604,10,100,0.0001,0.01,0.972,4814,4790
17,9704,10,100,0.0001,0.01,0.964,4862,4842
17,9804,10,100,0.0001,0.01,0.984,4922,4882
17,9904,10,100,0.0001,0.01,0.976,4970,4934
17,10004,10,100,0.0001,0.01,0.978,5021,4983
17,10104,10,100,0.0001,0.01,0.974,5073,5031
17,10204,10,100,0.0001,0.01,0.98,5119,5085
17,10304,10,100,0.0001,0.01,0.962,5168,5136
17,10404,10,100,0.0001,0.01,0.968,5220,5184
17,10504,10,100,0.0001,0.01,0.972,5273,5231
17,10604,10,100,0.0001,0.01,0.976,5321,5283
17,10704,10,100,0.0001,0.01,0.976,5378,5326
17,10804,10,100,0.0001,0.01,0.978,5429,5375
17,10904,10,100,0.0001,0.01,0.968,5481,5423
17,11004,10,100,0.0001,0.01,0.966,5536,5468
17,11104,10,100,0.0001,0.01,0.972,5578,5526
17,11204,10,100,0.0001,0.01,0.982,5626,5578
17,11304,10,100,0.0001,0.01,0.978,5673,5631
17,11404,10,100,0.0001,0.01,0.98,5714,5690
17,11504,10,100,0.0001,0.01,0.974,5765,5739
17,11604,10,100,0.0001,0.01,0.972,5817,5787
17,11704,10,100,0.0001,0.01,0.982,5864,5840
17,11804,10,100,0.0001,0.01,0.98,5907,5897
17,11904,10,100,0.0001,0.01,0.98,5961,5943
17,12004,10,100,0.0001,0.01,0.97,6011,5993
17,12104,10,100,0.0001,0.01,0.948,6062,6042
17,12204,10,100,0.0001,0.01,0.978,6122,6082
17,12304,10,100,0.0001,0.01,0.98,6166,6138
17,12404,10,100,0.0001,0.01,0.976,6224,6180
17,12504,10,100,0.0001,0.01,0.976,6276,6228
17,12604,10,100,0.0001,0.01,0.97,6323,6281
17,12704,10,100,0.0001,0.01,0.972,6371,6333
17,12804,10,100,0.0001,0.01,0.968,6423,6381
17,12904,10,100,0.0001,0.01,0.98,6467,6437
17,13004,10,100,0.0001,0.01,0.98,6525,6479
17,13104,10,100,0.0001,0.01,0.97,6570,6534
17,13204,10,100,0.0001,0.01,0.964,6624,6580
17,13304,10,100,0.0001,0.01,0.984,6673,6631
17,13404,10,100,0.0001,0.01,0.97,6726,6678
17,13504,10,100,0.0001,0.01,0.982,6781,6723
17,13604,10,100,0.0001,0.01,0.926,6824,6780
17,13704,10,100,0.0001,0.01,0.956,6875,6829
17,13804,10,100,0.0001,0.01,0.966,6910,6894
17,13904,10,100,0.0001,0.01,0.98,6963,6941
17,14004,10,100,0.0001,0.01,0.978,7014,6990
17,14104,10,100,0.0001,0.01,0.978,7065,7039
17,14204,10,100,0.0001,0.01,0.978,7123,7081
17,14304,10,100,0.0001,0.01,0.978,7172,7132
17,14404,10,100,0.0001,0.01,0.98,7219,7185
17,14504,10,100,0.0001,0.01,0.982,7271,7233
17,14604,10,100,0.0001,0.01,0.98,7318,7286
17,14704,10,100,0.0001,0.01,0.988,7367,7337
17,14804,10,100,0.0001,0.01,0.982,7425,7379
17,14904,10,100,0.0001,0.01,0.984,7474,7430
17,15004,10,100,0.0001,0.01,0.966,7523,7481
18,104,10,100,0.0001,0.01,0.508,47,57
18,204,10,100,0.0001,0.01,0.476,104,100
18,304,10,100,0.0001,0.01,0.462,153,151
18,404,10,100,0.0001,0.01,0.474,201,203
18,504,10,100,0.0001,0.01,0.458,252,252
18,604,10,100,0.0001,0.01,0.44,303,301
18,704,10,100,0.0001,0.01,0.464,352,352
18,804,10,100,0.0001,0.01,0.47,398,406
18,904,10,100,0.0001,0.01,0.468,445,459
18,1004,10,100,0.0001,0.01,0.484,487,517
18,1104,10,100,0.0001,0.01,0.498,548,556
18,1204,10,100,0.0001,0.01,0.488,592,612
18,1304,10,100,0.0001,0.01,0.462,639,665
18,1404,10,100,0.0001,0.01,0.48,689,715
18,1504,10,100,0.0001,0.01,0.466,746,758
18,1604,10,100,0.0001,0.01,0.5,806,798
18,1704,10,100,0.0001,0.01,0.482,861,843
18,1804,10,100,0.0001,0.01,0.506,915,889
18,1904,10,100,0.0001,0.01,0.504,961,943
18,2004,10,100,0.0001,0.01,0.552,1010,994
18,2104,10,100,0.0001,0.01,0.52,1062,1042
18,2204,10,100,0.0001,0.01,0.56,1121,1083
18,2304,10,100,0.0001,0.01,0.538,1171,1133
18,2404,10,100,0.0001,0.01,0.556,1224,1180
18,2504,10,100,0.0001,0.01,0.596,1275,1229
18,2604,10,100,0.0001,0.01,0.624,1325,1279
18,2704,10,100,0.0001,0.01,0.56,1371,1333
18,2804,10,100,0.0001,0.01,0.604,1416,1388
18,2904,10,100,0.0001,0.01,0.63,1469,1435
18,3004,10,100,0.0001,0.01,0.648,1521,1483
18,3104,10,100,0.0001,0.01,0.65,1571,1533
18,3204,10,100,0.0001,0.01,0.656,1619,1585
18,3304,10,100,0.0001,0.01,0.68,1667,1637
18,3404,10,100,0.0001,0.01,0.712,1725,1679
18,3504,10,100,0.0001,0.01,0.742,1778,1726
18,3604,10,100,0.0001,0.01,0.704,1833,1771
18,3704,10,100,0.0001,0.01,0.734,1885,1819
18,3804,10,100,0.0001,0.01,0.74,1939,1865
18,3904,10,100,0.0001,0.01,0.742,1990,1914
18,4004,10,100,0.0001,0.01,0.758,2035,1969
18,4104,10,100,0.0001,0.01,0.778,2087,2017
18,4204,10,100,0.0001,0.01,0.782,2137,2067
18,4304,10,100,0.0001,0.01,0.782,2186,2118
18,4404,10,100,0.0001,0.01,0.776,2239,2165
18,4504,10,100,0.0001,0.01,0.772,2283,2221
18,4604,10,100,0.0001,0.01,0.774,2334,2270
18,4704,10,100,0.0001,0.01,0.774,2371,2333
18,4804,10,100,0.0001,0.01,0.79,2416,2388
18,4904,10,100,0.0001,0.01,0.776,2465,2439
18,5004,10,100,0.0001,0.01,0.802,2520,2484
18,5104,10,100,0.0001,0.01,0.816,2563,2541
18,5204,10,100,0.0001,0.01,0.818,2614,2590
18,5304,10,100,0.0001,0.01,0.826,2665,2639
18,5404,10,100,0.0001,0.01,0.822,2710,2694
18,5504,10,100,0.0001,0.01,0.83,2759,2745
18,5604,10,100,0.0001,0.01,0.816,2814,2790
18,5704,10,100,0.0001,0.01,0.802,2859,2845
18,5804,10,100,0.0001,0.01,0.802,2909,2895
18,5904,10,100,0.0001,0.01,0.816,2954,2950
18,6004,10,100,0.0001,0.01,0.844,3005,2999
18,6104,10,100,0.0001,0.01,0.84,3057,3047
18,6204,10,100,0.0001,0.01,0.846,3108,3096
18,6304,10,100,0.0001,0.01,0.828,3160,3144
18,6404,10,100,0.0001,0.01,0.846,3213,3191
18,6504,10,100,0.0001,0.01,0.85,3270,3234
18,6604,10,100,0.0001,0.01,0.83,3323,3281
18,6704,10,100,0.0001,0.01,0.848,3367,3337
18,6804,10,100,0.0001,0.01,0.87,3412,3392
18,6904,10,100,0.0001,0.01,0.872,3458,3446
18,7004,10,100,0.0001,0.01,0.878,3512,3492
18,7104,10,100,0.0001,0.01,0.856,3568,3536
18,7204,10,100,0.0001,0.01,0.842,3618,3586
18,7304,10,100,0.0001,0.01,0.846,3659,3645
18,7404,10,100,0.0001,0.01,0.852,3702,3702
18,7504,10,100,0.0001,0.01,0.876,3753,3751
18,7604,10,100,0.0001,0.01,0.846,3800,3804
18,7704,10,100,0.0001,0.01,0.88,3845,3859
18,7804,10,100,0.0001,0.01,0.892,3894,3910
18,7904,10,100,0.0001,0.01,0.878,3946,3958
18,8004,10,100,0.0001,0.01,0.906,3992,4012
18,8104,10,100,0.0001,0.01,0.904,4040,4064
18,8204,10,100,0.0001,0.01,0.894,4094,4110
18,8304,10,100,0.0001,0.01,0.858,4142,4162
18,8404,10,100,0.0001,0.01,0.884,4197,4207
18,8504,10,100,0.0001,0.01,0.878,4231,4273
18,8604,10,100,0.0001,0.01,0.904,4274,4330
18,8704,10,100,0.0001,0.01,0.896,4324,4380
18,8804,10,100,0.0001,0.01,0.904,4377,4427
18,8904,10,100,0.0001,0.01,0.904,4429,4475
18,9004,10,100,0.0001,0.01,0.888,4473,4531
18,9104,10,100,0.0001,0.01,0.916,4520,4584
18,9204,10,100,0.0001,0.01,0.91,4581,4623
18,9304,10,100,0.0001,0.01,0.89,4622,4682
18,9404,10,100,0.0001,0.01,0.916,4671,4733
18,9504,10,100,0.0001,0.01,0.902,4728,4776
18,9604,10,100,0.0001,0.01,0.914,4775,4829
18,9704,10,100,0.0001,0.01,0.918,4829,4875
18,9804,10,100,0.0001,0.01,0.914,4878,4926
18,9904,10,100,0.0001,0.01,0.912,4932,4972
18,10004,10,100,0.0001,0.01,0.904,4979,5025
18,10104,10,100,0.0001,0.01,0.91,5028,5076
18,10204,10,100,0.0001,0.01,0.922,5077,5127
18,10304,10,100,0.0001,0.01,0.918,5126,5178
18,10404,10,100,0.0001,0.01,0.898,5171,5233
18,10504,10,100,0.0001,0.01,0.9,5214,5290
18,10604,10,100,0.0001,0.01,0.934,5268,5336
18,10704,10,100,0.0001,0.01,0.916,5328,5376
18,10804,10,100,0.0001,0.01,0.896,5376,5428
18,10904,10,100,0.0001,0.01,0.93,5413,5491
18,11004,10,100,0.0001,0.01,0.908,5457,5547
18,11104,10,100,0.0001,0.01,0.918,5506,5598
18,11204,10,100,0.0001,0.01,0.912,5573,5631
18,11304,10,100,0.0001,0.01,0.926,5627,5677
18,11404,10,100,0.0001,0.01,0.926,5680,5724
18,11504,10,100,0.0001,0.01,0.916,5733,5771
18,11604,10,100,0.0001,0.01,0.912,5791,5813
18,11704,10,100,0.0001,0.01,0.918,5825,5879
18,11804,10,100,0.0001,0.01,0.934,5875,5929
18,11904,10,100,0.0001,0.01,0.932,5922,5982
18,12004,10,100,0.0001,0.01,0.928,5970,6034
18,12104,10,100,0.0001,0.01,0.94,6021,6083
18,12204,10,100,0.0001,0.01,0.926,6071,6133
18,12304,10,100,0.0001,0.01,0.94,6130,6174
18,12404,10,100,0.0001,0.01,0.946,6190,6214
18,12504,10,100,0.0001,0.01,0.93,6234,6270
18,12604,10,100,0.0001,0.01,0.94,6280,6324
18,12704,10,100,0.0001,0.01,0.934,6332,6372
18,12804,10,100,0.0001,0.01,0.948,6377,6427
18,12904,10,100,0.0001,0.01,0.926,6423,6481
18,13004,10,100,0.0001,0.01,0.934,6483,6521
18,13104,10,100,0.0001,0.01,0.952,6537,6567
18,13204,10,100,0.0001,0.01,0.948,6587,6617
18,13304,10,100,0.0001,0.01,0.948,6641,6663
18,13404,10,100,0.0001,0.01,0.952,6688,6716
18,13504,10,100,0.0001,0.01,0.95,6733,6771
18,13604,10,100,0.0001,0.01,0.948,6780,6824
18,13704,10,100,0.0001,0.01,0.95,6834,6870
18,13804,10,100,0.0001,0.01,0.942,6886,6918
18,13904,10,100,0.0001,0.01,0.944,6929,6975
18,14004,10,100,0.0001,0.01,0.946,6981,7023
18,14104,10,100,0.0001,0.01,0.954,7032,7072
18,14204,10,100,0.0001,0.01,0.958,7080,7124
18,14304,10,100,0.0001,0.01,0.926,7134,7170
18,14404,10,100,0.0001,0.01,0.942,7190,7214
18,14504,10,100,0.0001,0.01,0.956,7241,7263
18,14604,10,100,0.0001,0.01,0.944,7293,7311
18,14704,10,100,0.0001,0.01,0.96,7349,7355
18,14804,10,100,0.0001,0.01,0.954,7396,7408
18,14904,10,100,0.0001,0.01,0.948,7445,7459
18,15004,10,100,0.0001,0.01,0.948,7503,7501
19,104,10,100,0.0001,0.01,0.498,48,56
19,204,10,100,0.0001,0.01,0.504,104,100
19,304,10,100,0.0001,0.01,0.53,154,150
19,404,10,100,0.0001,0.01,0.486,202,202
19,504,10,100,0.0001,0.01,0.482,243,261
19,604,10,100,0.0001,0.01,0.5,303,301
19,704,10,100,0.0001,0.01,0.514,345,359
19,804,10,100,0.0001,0.01,0.486,389,415
19,904,10,100,0.0001,0.01,0.534,432,472
19,1004,10,100,0.0001,0.01,0.516,479,525
19,1104,10,100,0.0001,0.01,0.52,532,572
19,1204,10,100,0.0001,0.01,0.53,583,621
19,1304,10,100,0.0001,0.01,0.504,633,671
19,1404,10,100,0.0001,0.01,0.542,679,725
19,1504,10,100,0.0001,0.01,0.558,734,770
19,1604,10,100,0.0001,0.01,0.53,782,822
19,1704,10,100,0.0001,0.01,0.54,835,869
19,1804,10,100,0.0001,0.01,0.55,886,918
19,1904,10,100,0.0001,0.01,0.568,933,971
19,2004,10,100,0.0001,0.01,0.56,989,1015
19,2104,10,100,0.0001,0.01,0.562,1036,1068
19,2204,10,100,0.0001,0.01,0.586,1084,1120
19,2304,10,100,0.0001,0.01,0.6,1132,1172
19,2404,10,100,0.0001,0.01,0.586,1188,1216
19,2504,10,100,0.0001,0.01,0.646,1242,1262
19,2604,10,100,0.0001,0.01,0.674,1298,1306
19,2704,10,100,0.0001,0.01,0.696,1350,1354
19,2804,10,100,0.0001,0.01,0.7,1400,1404
19,2904,10,100,0.0001,0.01,0.744,1449,1455
19,3004,10,100,0.0001,0.01,0.73,1502,1502
19,3104,10,100,0.0001,0.01,0.694,1549,1555
19,3204,10,100,0.0001,0.01,0.806,1593,1611
19,3304,10,100,0.0001,0.01,0.832,1652,1652
19,3404,10,100,0.0001,0.01,0.838,1710,1694
19,3504,10,100,0.0001,0.01,0.846,1755,1749
19,3604,10,100,0.0001,0.01,0.858,1804,1800
19,3704,10,100,0.0001,0.01,0.83,1862,1842
19,3804,10,100,0.0001,0.01,0.874,1907,1897
19,3904,10,100,0.0001,0.01,0.906,1958,1946
19,4004,10,100,0.0001,0.01,0.896,2012,1992
19,4104,10,100,0.0001,0.01,0.912,2060,2044
19,4204,10,100,0.0001,0.01,0.932,2111,2093
19,4304,10,100,0.0001,0.01,0.928,2160,2144
19,4404,10,100,0.0001,0.01,0.938,2203,2201
19,4504,10,100,0.0001,0.01,0.94,2251,2253
19,4604,10,100,0.0001,0.01,0.918,2298,2306
19,4704,10,100,0.0001,0.01,0.948,2343,2361
19,4804,10,100,0.0001,0.01,0.94,2395,2409
19,4904,10,100,0.0001,0.01,0.96,2443,2461
19,5004,10,100,0.0001,0.01,0.956,2502,2502
19,5104,10,100,0.0001,0.01,0.962,2558,2546
19,5204,10,100,0.0001,0.01,0.958,2603,2601
19,5304,10,100,0.0001,0.01,0.958,2650,2654
19,5404,10,100,0.0001,0.01,0.97,2699,2705
19,5504,10,100,0.0001,0.01,0.964,2744,2760
19,5604,10,100,0.0001,0.01,0.968,2795,2809
19,5704,10,100,0.0001,0.01,0.958,2843,2861
19,5804,10,100,0.0001,0.01,0.948,2890,2914
19,5904,10,100,0.0001,0.01,0.956,2944,2960
19,6004,10,100,0.0001,0.01,0.968,2997,3007
19,6104,10,100,0.0001,0.01,0.972,3046,3058
19,6204,10,100,0.0001,0.01,0.964,3093,3111
19,6304,10,100,0.0001,0.01,0.97,3137,3167
19,6404,10,100,0.0001,0.01,0.958,3195,3209
19,6504,10,100,0.0001,0.01,0.962,3244,3260
19,6604,10,100,0.0001,0.01,0.966,3299,3305
19,6704,10,100,0.0001,0.01,0.962,3343,3361
19,6804,10,100,0.0001,0.01,0.964,3394,3410
19,6904,10,100,0.0001,0.01,0.956,3444,3460
19,7004,10,100,0.0001,0.01,0.95,3495,3509
19,7104,10,100,0.0001,0.01,0.972,3551,3553
19,7204,10,100,0.0001,0.01,0.972,3600,3604
19,7304,10,100,0.0001,0.01,0.968,3644,3660
19,7404,10,100,0.0001,0.01,0.968,3696,3708
19,7504,10,100,0.0001,0.01,0.978,3752,3752
19,7604,10,100,0.0001,0.01,0.97,3806,3798
19,7704,10,100,0.0001,0.01,0.972,3856,3848
19,7804,10,100,0.0001,0.01,0.966,3911,3893
19,7904,10,100,0.0001,0.01,0.962,3963,3941
19,8004,10,100,0.0001,0.01,0.976,4021,3983
19,8104,10,100,0.0001,0.01,0.97,4065,4039
19,8204,10,100,0.0001,0.01,0.97,4119,4085
19,8304,10,100,0.0001,0.01,0.972,4166,4138
19,8404,10,100,0.0001,0.01,0.968,4214,4190
19,8504,10,100,0.0001,0.01,0.972,4268,4236
19,8604,10,100,0.0001,0.01,0.974,4317,4287
19,8704,10,100,0.0001,0.01,0.976,4361,4343
19,8804,10,100,0.0001,0.01,0.964,4410,4394
19,8904,10,100,0.0001,0.01,0.966,4457,4447
19,9004,10,100,0.0001,0.01,0.97,4503,4501
19,9104,10,100,0.0001,0.01,0.966,4552,4552
19,9204,10,100,0.0001,0.01,0.974,4601,4603
19,9304,10,100,0.0001,0.01,0.982,4649,4655
19,9404,10,100,0.0001,0.01,0.98,4698,4706
19,9504,10,100,0.0001,0.01,0.982,4740,4764
19,9604,10,100,0.0001,0.01,0.98,4784,4820
19,9704,10,100,0.0001,0.01,0.98,4835,4869
19,9804,10,100,0.0001,0.01,0.98,4878,4926
19,9904,10,100,0.0001,0.01,0.988,4929,4975
19,10004,10,100,0.0001,0.01,0.988,4980,5024
19,10104,10,100,0.0001,0.01,0.986,5022,5082
19,10204,10,100,0.0001,0.01,0.986,5074,5130
19,10304,10,100,0.0001,0.01,0.986,5125,5179
19,10404,10,100,0.0001,0.01,0.978,5173,5231
19,10504,10,100,0.0001,0.01,0.98,5227,5277
19,10604,10,100,0.0001,0.01,0.976,5272,5332
19,10704,10,100,0.0001,0.01,0.978,5318,5386
19,10804,10,100,0.0001,0.01,0.97,5363,5441
19,10904,10,100,0.0001,0.01,0.984,5412,5492
19,11004,10,100,0.0001,0.01,0.982,5465,5539
19,11104,10,100,0.0001,0.01,0.976,5518,5586
19,11204,10,100,0.0001,0.01,0.982,5573,5631
19,11304,10,100,0.0001,0.01,0.978,5623,5681
19,11404,10,100,0.0001,0.01,0.974,5668,5736
19,11504,10,100,0.0001,0.01,0.982,5722,5782
19,11604,10,100,0.0001,0.01,0.974,5772,5832
19,11704,10,100,0.0001,0.01,0.982,5823,5881
19,11804,10,100,0.0001,0.01,0.978,5874,5930
19,11904,10,100,0.0001,0.01,0.982,5922,5982
19,12004,10,100,0.0001,0.01,0.982,5983,6021
19,12104,10,100,0.0001,0.01,0.98,6037,6067
19,12204,10,100,0.0001,0.01,0.982,6081,6123
19,12304,10,100,0.0001,0.01,0.982,6139,6165
19,12404,10,100,0.0001,0.01,0.988,6183,6221
19,12504,10,100,0.0001,0.01,0.982,6232,6272
19,12604,10,100,0.0001,0.01,0.984,6276,6328
19,12704,10,100,0.0001,0.01,0.988,6323,6381
19,12804,10,100,0.0001,0.01,0.99,6362,6442
19,12904,10,100,0.0001,0.01,0.988,6415,6489
19,13004,10,100,0.0001,0.01,0.988,6458,6546
19,13104,10,100,0.0001,0.01,0.984,6513,6591
19,13204,10,100,0.0001,0.01,0.982,6562,6642
19,13304,10,100,0.0001,0.01,0.982,6619,6685
19,13404,10,100,0.0001,0.01,0.99,6684,6720
19,13504,10,100,0.0001,0.01,0.986,6736,6768
19,13604,10,100,0.0001,0.01,0.98,6789,6815
19,13704,10,100,0.0001,0.01,0.99,6835,6869
19,13804,10,100,0.0001,0.01,0.986,6885,6919
19,13904,10,100,0.0001,0.01,0.988,6931,6973
19,14004,10,100,0.0001,0.01,0.99,6983,7021
19,14104,10,100,0.0001,0.01,0.99,7037,7067
19,14204,10,100,0.0001,0.01,0.99,7089,7115
19,14304,10,100,0.0001,0.01,0.99,7141,7163
19,14404,10,100,0.0001,0.01,0.988,7191,7213
19,14504,10,100,0.0001,0.01,0.986,7245,7259
19,14604,10,100,0.0001,0.01,0.982,7299,7305
19,14704,10,100,0.0001,0.01,0.984,7350,7354
19,14804,10,100,0.0001,0.01,0.986,7395,7409
19,14904,10,100,0.0001,0.01,0.986,7450,7454
19,15004,10,100,0.0001,0.01,0.992,7495,7509
20,104,10,100,0.0001,0.01,0.5,53,51
20,204,10,100,0.0001,0.01,0.51,96,108
20,304,10,100,0.0001,0.01,0.502,145,159
20,404,10,100,0.0001,0.01,0.482,192,212
20,504,10,100,0.0001,0.01,0.496,238,266
20,604,10,100,0.0001,0.01,0.508,298,306
20,704,10,100,0.0001,0.01,0.512,347,357
20,804,10,100,0.0001,0.01,0.49,400,404
20,904,10,100,0.0001,0.01,0.532,450,454
20,1004,10,100,0.0001,0.01,0.512,499,505
20,1104,10,100,0.0001,0.01,0.484,553,551
20,1204,10,100,0.0001,0.01,0.518,604,600
20,1304,10,100,0.0001,0.01,0.522,652,652
20,1404,10,100,0.0001,0.01,0.55,700,704
20,1504,10,100,0.0001,0.01,0.552,748,756
20,1604,10,100,0.0001,0.01,0.59,786,818
20,1704,10,100,0.0001,0.01,0.578,835,869
20,1804,10,100,0.0001,0.01,0.61,887,917
20,1904,10,100,0.0001,0.01,0.596,937,967
20,2004,10,100,0.0001,0.01,0.586,987,1017
20,2104,10,100,0.0001,0.01,0.67,1044,1060
20,2204,10,100,0.0001,0.01,0.688,1090,1114
20,2304,10,100,0.0001,0.01,0.672,1147,1157
20,2404,10,100,0.0001,0.01,0.726,1201,1203
20,2504,10,100,0.0001,0.01,0.676,1256,1248
20,2604,10,100,0.0001,0.01,0.69,1302,1302
20,2704,10,100,0.0001,0.01,0.73,1347,1357
20,2804,10,100,0.0001,0.01,0.702,1391,1413
20,2904,10,100,0.0001,0.01,0.714,1440,1464
20,3004,10,100,0.0001,0.01,0.738,1493,1511
20,3104,10,100,0.0001,0.01,0.786,1537,1567
20,3204,10,100,0.0001,0.01,0.784,1578,1626
20,3304,10,100,0.0001,0.01,0.752,1633,1671
20,3404,10,100,0.0001,0.01,0.776,1685,1719
20,3504,10,100,0.0001,0.01,0.778,1728,1776
20,3604,10,100,0.0001,0.01,0.798,1789,1815
20,3704,10,100,0.0001,0.01,0.794,1833,1871
20,3804,10,100,0.0001,0.01,0.806,1886,1918
20,3904,10,100,0.0001,0.01,0.772,1935,1969
20,4004,10,100,0.0001,0.01,0.808,1984,2020
20,4104,10,100,0.0001,0.01,0.822,2038,2066
20,4204,10,100,0.0001,0.01,0.81,2094,2110
20,4304,10,100,0.0001,0.01,0.784,2142,2162
20,4404,10,100,0.0001,0.01,0.846,2197,2207
20,4504,10,100,0.0001,0.01,0.822,2252,2252
20,4604,10,100,0.0001,0.01,0.834,2300,2304
20,4704,10,100,0.0001,0.01,0.776,2353,2351
20,4804,10,100,0.0001,0.01,0.792,2406,2398
20,4904,10,100,0.0001,0.01,0.83,2458,2446
20,5004,10,100,0.0001,0.01,0.794,2505,2499
20,5104,10,100,0.0001,0.01,0.828,2559,2545
20,5204,10,100,0.0001,0.01,0.85,2615,2589
20,5304,10,100,0.0001,0.01,0.822,2672,2632
20,5404,10,100,0.0001,0.01,0.822,2721,2683
20,5504,10,100,0.0001,0.01,0.84,2768,2736
20,5604,10,100,0.0001,0.01,0.822,2817,2787
20,5704,10,100,0.0001,0.01,0.848,2867,2837
20,5804,10,100,0.0001,0.01,0.802,2905,2899
20,5904,10,100,0.0001,0.01,0.782,2956,2948
20,6004,10,100,0.0001,0.01,0.834,2999,3005
20,6104,10,100,0.0001,0.01,0.852,3045,3059
20,6204,10,100,0.0001,0.01,0.846,3094,3110
20,6304,10,100,0.0001,0.01,0.854,3141,3163
20,6404,10,100,0.0001,0.01,0.854,3190,3214
20,6504,10,100,0.0001,0.01,0.87,3234,3270
20,6604,10,100,0.0001,0.01,0.862,3289,3315
20,6704,10,100,0.0001,0.01,0.866,3338,3366
20,6804,10,100,0.0001,0.01,0.854,3391,3413
20,6904,10,100,0.0001,0.01,0.848,3438,3466
20,7004,10,100,0.0001,0.01,0.854,3490,3514
20,7104,10,100,0.0001,0.01,0.836,3543,3561
20,7204,10,100,0.0001,0.01,0.878,3595,3609
20,7304,10,100,0.0001,0.01,0.854,3649,3655
20,7404,10,100,0.0001,0.01,0.854,3692,3712
20,7504,10,100,0.0001,0.01,0.862,3736,3768
20,7604,10,100,0.0001,0.01,0.858,3795,3809
20,7704,10,100,0.0001,0.01,0.858,3849,3855
20,7804,10,100,0.0001,0.01,0.864,3890,3914
20,7904,10,100,0.0001,0.01,0.846,3940,3964
20,8004,10,100,0.0001,0.01,0.858,3989,4015
20,8104,10,100,0.0001,0.01,0.852,4038,4066
20,8204,10,100,0.0001,0.01,0.848,4091,4113
20,8304,10,100,0.0001,0.01,0.866,4148,4156
20,8404,10,100,0.0001,0.01,0.852,4198,4206
20,8504,10,100,0.0001,0.01,0.854,4248,4256
20,8604,10,100,0.0001,0.01,0.866,4297,4307
20,8704,10,100,0.0001,0.01,0.864,4347,4357
20,8804,10,100,0.0001,0.01,0.846,4391,4413
20,8904,10,100,0.0001,0.01,0.88,4435,4469
20,9004,10,100,0.0001,0.01,0.882,4492,4512
20,9104,10,100,0.0001,0.01,0.882,4543,4561
20,9204,10,100,0.0001,0.01,0.868,4590,4614
20,9304,10,100,0.0001,0.01,0.86,4631,4673
20,9404,10,100,0.0001,0.01,0.858,4684,4720
20,9504,10,100,0.0001,0.01,0.89,4734,4770
20,9604,10,100,0.0001,0.01,0.844,4793,4811
20,9704,10,100,0.0001,0.01,0.796,4853,4851
20,9804,10,100,0.0001,0.01,0.848,4905,4899
20,9904,10,100,0.0001,0.01,0.854,4955,4949
20,10004,10,100,0.0001,0.01,0.878,5004,5000
20,10104,10,100,0.0001,0.01,0.868,5056,5048
20,10204,10,100,0.0001,0.01,0.866,5112,5092
20,10304,10,100,0.0001,0.01,0.886,5159,5145
20,10404,10,100,0.0001,0.01,0.866,5208,5196
20,10504,10,100,0.0001,0.01,0.87,5262,5242
20,10604,10,100,0.0001,0.01,0.88,5309,5295
20,10704,10,100,0.0001,0.01,0.898,5363,5341
20,10804,10,100,0.0001,0.01,0.854,5412,5392
20,10904,10,100,0.0001,0.01,0.88,5460,5444
20,11004,10,100,0.0001,0.01,0.888,5508,5496
20,11104,10,100,0.0001,0.01,0.874,5563,5541
20,11204,10,100,0.0001,0.01,0.896,5614,5590
20,11304,10,100,0.0001,0.01,0.884,5659,5645
20,11404,10,100,0.0001,0.01,0.898,5715,5689
20,11504,10,100,0.0001,0.01,0.886,5771,5733
20,11604,10,100,0.0001,0.01,0.884,5822,5782
20,11704,10,100,0.0001,0.01,0.872,5871,5833
20,11804,10,100,0.0001,0.01,0.898,5926,5878
20,11904,10,100,0.0001,0.01,0.856,5967,5937
20,12004,10,100,0.0001,0.01,0.828,6010,5994
20,12104,10,100,0.0001,0.01,0.856,6059,6045
20,12204,10,100,0.0001,0.01,0.862,6111,6093
20,12304,10,100,0.0001,0.01,0.888,6156,6148
20,12404,10,100,0.0001,0.01,0.89,6208,6196
20,12504,10,100,0.0001,0.01,0.904,6269,6235
20,12604,10,100,0.0001,0.01,0.882,6311,6293
20,12704,10,100,0.0001,0.01,0.9,6370,6334
20,12804,10,100,0.0001,0.01,0.882,6414,6390
20,12904,10,100,0.0001,0.01,0.902,6468,6436
20,13004,10,100,0.0001,0.01,0.896,6518,6486
20,13104,10,100,0.0001,0.01,0.91,6558,6546
20,13204,10,100,0.0001,0.01,0.912,6608,6596
20,13304,10,100,0.0001,0.01,0.89,6661,6643
20,13404,10,100,0.0001,0.01,0.92,6714,6690
20,13504,10,100,0.0001,0.01,0.902,6758,6746
20,13604,10,100,0.0001,0.01,0.896,6797,6807
20,13704,10,100,0.0001,0.01,0.912,6849,6855
20,13804,10,100,0.0001,0.01,0.894,6898,6906
20,13904,10,100,0.0001,0.01,0.906,6953,6951
20,14004,10,100,0.0001,0.01,0.862,7003,7001
20,14104,10,100,0.0001,0.01,0.91,7045,7059
20,14204,10,100,0.0001,0.01,0.92,7099,7105
20,14304,10,100,0.0001,0.01,0.888,7151,7153
20,14404,10,100,0.0001,0.01,0.912,7197,7207
20,14504,10,100,0.0001,0.01,0.908,7247,7257
20,14604,10,100,0.0001,0.01,0.912,7297,7307
20,14704,10,100,0.0001,0.01,0.902,7351,7353
20,14804,10,100,0.0001,0.01,0.92,7400,7404
20,14904,10,100,0.0001,0.01,0.898,7450,7454
20,15004,10,100,0.0001,0.01,0.89,7502,7502
1,104,10,100,0.001,0.01,0.498,53,51
1,204,10,100,0.001,0.01,0.468,97,107
1,304,10,100,0.001,0.01,0.5,143,161
1,404,10,100,0.001,0.01,0.516,189,215
1,504,10,100,0.001,0.01,0.528,245,259
1,604,10,100,0.001,0.01,0.516,294,310
1,704,10,100,0.001,0.01,0.5,335,369
1,804,10,100,0.001,0.01,0.496,388,416
1,904,10,100,0.001,0.01,0.536,433,471
1,1004,10,100,0.001,0.01,0.502,484,520
1,1104,10,100,0.001,0.01,0.514,531,573
1,1204,10,100,0.001,0.01,0.504,576,628
1,1304,10,100,0.001,0.01,0.492,618,686
1,1404,10,100,0.001,0.01,0.486,670,734
1,1504,10,100,0.001,0.01,0.506,723,781
1,1604,10,100,0.001,0.01,0.486,771,833
1,1704,10,100,0.001,0.01,0.498,815,889
1,1804,10,100,0.001,0.01,0.556,858,946
1,1904,10,100,0.001,0.01,0.556,900,1004
1,2004,10,100,0.001,0.01,0.614,953,1051
1,2104,10,100,0.001,0.01,0.64,1003,1101
1,2204,10,100,0.001,0.01,0.684,1058,1146
1,2304,10,100,0.001,0.01,0.71,1092,1212
1,2404,10,100,0.001,0.01,0.722,1140,1264
1,2504,10,100,0.001,0.01,0.746,1187,1317
1,2604,10,100,0.001,0.01,0.76,1242,1362
1,2704,10,100,0.001,0.01,0.77,1304,1400
1,2804,10,100,0.001,0.01,0.786,1342,1462
1,2904,10,100,0.001,0.01,0.752,1394,1510
1,3004,10,100,0.001,0.01,0.782,1453,1551
1,3104,10,100,0.001,0.01,0.774,1505,1599
1,3204,10,100,0.001,0.01,0.764,1557,1647
1,3304,10,100,0.001,0.01,0.792,1611,1693
1,3404,10,100,0.001,0.01,0.798,1658,1746
1,3504,10,100,0.001,0.01,0.824,1707,1797
1,3604,10,100,0.001,0.01,0.786,1754,1850
1,3704,10,100,0.001,0.01,0.802,1811,1893
1,3804,10,100,0.001,0.01,0.836,1864,1940
1,3904,10,100,0.001,0.01,0.84,1913,1991
1,4004,10,100,0.001,0.01,0.858,1967,2037
1,4104,10,100,0.001,0.01,0.842,2010,2094
1,4204,10,100,0.001,0.01,0.856,2067,2137
1,4304,10,100,0.001,0.01,0.842,2112,2192
1,4404,10,100,0.001,0.01,0.856,2161,2243
1,4504,10,100,0.001,0.01,0.852,2206,2298
1,4604,10,100,0.001,0.01,0.85,2254,2350
1,4704,10,100,0.001,0.01,0.858,2307,2397
1,4804,10,100,0.001,0.01,0.854,2349,2455
1,4904,10,100,0.001,0.01,0.876,2397,2507
1,5004,10,100,0.001,0.01,0.842,2450,2554
1,5104,10,100,0.001,0.01,0.858,2497,2607
1,5204,10,100,0.001,0.01,0.816,2541,2663
1,5304,10,100,0.001,0.01,0.824,2597,2707
1,5404,10,100,0.001,0.01,0.836,2644,2760
1,5504,10,100,0.001,0.01,0.846,2693,2811
1,5604,10,100,0.001,0.01,0.854,2728,2876
1,5704,10,100,0.001,0.01,0.874,2779,2925
1,5804,10,100,0.001,0.01,0.862,2829,2975
1,5904,10,100,0.001,0.01,0.87,2875,3029
1,6004,10,100,0.001,0.01,0.872,2927,3077
1,6104,10,100,0.001,0.01,0.874,2982,3122
1,6204,10,100,0.001,0.01,0.852,3030,3174
1,6304,10,100,0.001,0.01,0.848,3077,3227
1,6404,10,100,0.001,0.01,0.858,3124,3280
1,6504,10,100,0.001,0.01,0.868,3175,3329
1,6604,10,100,0.001,0.01,0.89,3233,3371
1,6704,10,100,0.001,0.01,0.874,3282,3422
1,6804,10,100,0.001,0.01,0.876,3333,3471
1,6904,10,100,0.001,0.01,0.892,3379,3525
1,7004,10,100,0.001,0.01,0.884,3425,3579
1,7104,10,100,0.001,0.01,0.888,3478,3626
1,7204,10,100,0.001,0.01,0.89,3526,3678
1,7304,10,100,0.001,0.01,0.896,3580,3724
1,7404,10,100,0.001,0.01,0.89,3628,3776
1,7504,10,100,0.001,0.01,0.884,3681,3823
1,7604,10,100,0.001,0.01,0.882,3725,3879
1,7704,10,100,0.001,0.01,0.892,3778,3926
1,7804,10,100,0.001,0.01,0.872,3834,3970
1,7904,10,100,0.001,0.01,0.898,3878,4026
1,8004,10,100,0.001,0.01,0.894,3935,4069
1,8104,10,100,0.001,0.01,0.904,3980,4124
1,8204,10,100,0.001,0.01,0.896,4024,4180
1,8304,10,100,0.001,0.01,0.902,4078,4226
1,8404,10,100,0.001,0.01,0.868,4128,4276
1,8504,10,100,0.001,0.01,0.862,4184,4320
1,8604,10,100,0.001,0.01,0.88,4237,4367
1,8704,10,100,0.001,0.01,0.908,4285,4419
1,8804,10,100,0.001,0.01,0.892,4341,4463
1,8904,10,100,0.001,0.01,0.894,4388,4516
1,9004,10,100,0.001,0.01,0.916,4436,4568
1,9104,10,100,0.001,0.01,0.902,4476,4628
1,9204,10,100,0.001,0.01,0.912,4522,4682
1,9304,10,100,0.001,0.01,0.884,4577,4727
1,9404,10,100,0.001,0.01,0.888,4638,4766
1,9504,10,100,0.001,0.01,0.888,4695,4809
1,9604,10,100,0.001,0.01,0.9,4751,4853
1,9704,10,100,0.001,0.01,0.908,4800,4904
1,9804,10,100,0.001,0.01,0.906,4834,4970
1,9904,10,100,0.001,0.01,0.914,4885,5019
1,10004,10,100,0.001,0.01,0.9,4931,5073
1,10104,10,100,0.001,0.01,0.906,4971,5133
1,10204,10,100,0.001,0.01,0.916,5030,5174
1,10304,10,100,0.001,0.01,0.914,5080,5224
1,10404,10,100,0.001,0.01,0.91,5132,5272
1,10504,10,100,0.001,0.01,0.916,5182,5322
1,10604,10,100,0.001,0.01,0.922,5238,5366
1,10704,10,100,0.001,0.01,0.904,5292,5412
1,10804,10,100,0.001,0.01,0.912,5336,5468
1,10904,10,100,0.001,0.01,0.926,5386,5518
1,11004,10,100,0.001,0.01,0.896,5432,5572
1,11104,10,100,0.001,0.01,0.92,5479,5625
1,11204,10,100,0.001,0.01,0.918,5536,5668
1,11304,10,100,0.001,0.01,0.908,5591,5713
1,11404,10,100,0.001,0.01,0.908,5630,5774
1,11504,10,100,0.001,0.01,0.912,5680,5824
1,11604,10,100,0.001,0.01,0.924,5723,5881
1,11704,10,100,0.001,0.01,0.922,5769,5935
1,11804,10,100,0.001,0.01,0.92,5819,5985
1,11904,10,100,0.001,0.01,0.92,5876,6028
1,12004,10,100,0.001,0.01,0.912,5929,6075
1,12104,10,100,0.001,0.01,0.918,5986,6118
1,12204,10,100,0.001,0.01,0.918,6030,6174
1,12304,10,100,0.001,0.01,0.932,6095,6209
1,12404,10,100,0.001,0.01,0.924,6149,6255
1,12504,10,100,0.001,0.01,0.918,6197,6307
1,12604,10,100,0.001,0.01,0.922,6255,6349
1,12704,10,100,0.001,0.01,0.912,6311,6393
1,12804,10,100,0.001,0.01,0.914,6358,6446
1,12904,10,100,0.001,0.01,0.924,6408,6496
1,13004,10,100,0.001,0.01,0.922,6454,6550
1,13104,10,100,0.001,0.01,0.918,6511,6593
1,13204,10,100,0.001,0.01,0.92,6559,6645
1,13304,10,100,0.001,0.01,0.93,6606,6698
1,13404,10,100,0.001,0.01,0.93,6667,6737
1,13504,10,100,0.001,0.01,0.922,6717,6787
1,13604,10,100,0.001,0.01,0.926,6767,6837
1,13704,10,100,0.001,0.01,0.92,6821,6883
1,13804,10,100,0.001,0.01,0.916,6872,6932
1,13904,10,100,0.001,0.01,0.922,6924,6980
1,14004,10,100,0.001,0.01,0.922,6974,7030
1,14104,10,100,0.001,0.01,0.922,7027,7077
1,14204,10,100,0.001,0.01,0.924,7070,7134
1,14304,10,100,0.001,0.01,0.932,7120,7184
1,14404,10,100,0.001,0.01,0.914,7177,7227
1,14504,10,100,0.001,0.01,0.92,7235,7269
1,14604,10,100,0.001,0.01,0.896,7290,7314
1,14704,10,100,0.001,0.01,0.926,7344,7360
1,14804,10,100,0.001,0.01,0.928,7396,7408
1,14904,10,100,0.001,0.01,0.934,7449,7455
1,15004,10,100,0.001,0.01,0.932,7501,7503
2,104,10,100,0.001,0.01,0.484,54,50
2,204,10,100,0.001,0.01,0.496,104,100
2,304,10,100,0.001,0.01,0.512,154,150
2,404,10,100,0.001,0.01,0.536,195,209
2,504,10,100,0.001,0.01,0.536,244,260
2,604,10,100,0.001,0.01,0.52,295,309
2,704,10,100,0.001,0.01,0.56,351,353
2,804,10,100,0.001,0.01,0.524,405,399
2,904,10,100,0.001,0.01,0.516,457,447
2,1004,10,100,0.001,0.01,0.512,507,497
2,1104,10,100,0.001,0.01,0.562,562,542
2,1204,10,100,0.001,0.01,0.556,603,601
2,1304,10,100,0.001,0.01,0.546,652,652
2,1404,10,100,0.001,0.01,0.558,709,695
2,1504,10,100,0.001,0.01,0.546,765,739
2,1604,10,100,0.001,0.01,0.558,818,786
2,1704,10,100,0.001,0.01,0.546,876,828
2,1804,10,100,0.001,0.01,0.574,930,874
2,1904,10,100,0.001,0.01,0.596,970,934
2,2004,10,100,0.001,0.01,0.596,1022,982
2,2104,10,100,0.001,0.01,0.604,1076,1028
2,2204,10,100,0.001,0.01,0.646,1123,1081
2,2304,10,100,0.001,0.01,0.66,1172,1132
2,2404,10,100,0.001,0.01,0.706,1209,1195
2,2504,10,100,0.001,0.01,0.77,1260,1244
2,2604,10,100,0.001,0.01,0.8,1306,1298
2,2704,10,100,0.001,0.01,0.806,1360,1344
2,2804,10,100,0.001,0.01,0.834,1414,1390
2,2904,10,100,0.001,0.01,0.87,1463,1441
2,3004,10,100,0.001,0.01,0.886,1512,1492
2,3104,10,100,0.001,0.01,0.918,1566,1538
2,3204,10,100,0.001,0.01,0.894,1604,1600
2,3304,10,100,0.001,0.01,0.9,1647,1657
2,3404,10,100,0.001,0.01,0.896,1709,1695
2,3504,10,100,0.001,0.01,0.912,1755,1749
2,3604,10,100,0.001,0.01,0.93,1805,1799
2,3704,10,100,0.001,0.01,0.938,1840,1864
2,3804,10,100,0.001,0.01,0.936,1894,1910
2,3904,10,100,0.001,0.01,0.928,1941,1963
2,4004,10,100,0.001,0.01,0.944,1987,2017
2,4104,10,100,0.001,0.01,0.926,2038,2066
2,4204,10,100,0.001,0.01,0.944,2084,2120
2,4304,10,100,0.001,0.01,0.938,2133,2171
2,4404,10,100,0.001,0.01,0.938,2179,2225
2,4504,10,100,0.001,0.01,0.888,2231,2273
2,4604,10,100,0.001,0.01,0.928,2288,2316
2,4704,10,100,0.001,0.01,0.942,2334,2370
2,4804,10,100,0.001,0.01,0.95,2384,2420
2,4904,10,100,0.001,0.01,0.93,2433,2471
2,5004,10,100,0.001,0.01,0.952,2484,2520
2,5104,10,100,0.001,0.01,0.948,2524,2580
2,5204,10,100,0.001,0.01,0.948,2573,2631
2,5304,10,100,0.001,0.01,0.958,2622,2682
2,5404,10,100,0.001,0.01,0.966,2664,2740
2,5504,10,100,0.001,0.01,0.958,2709,2795
2,5604,10,100,0.001,0.01,0.954,2764,2840
2,5704,10,100,0.001,0.01,0.96,2814,2890
2,5804,10,100,0.001,0.01,0.93,2862,2942
2,5904,10,100,0.001,0.01,0.926,2913,2991
2,6004,10,100,0.001,0.01,0.94,2957,3047
2,6104,10,100,0.001,0.01,0.96,3009,3095
2,6204,10,100,0.001,0.01,0.958,3051,3153
2,6304,10,100,0.001,0.01,0.964,3097,3207
2,6404,10,100,0.001,0.01,0.968,3152,3252
2,6504,10,100,0.001,0.01,0.97,3203,3301
2,6604,10,100,0.001,0.01,0.968,3249,3355
2,6704,10,100,0.001,0.01,0.974,3302,3402
2,6804,10,100,0.001,0.01,0.976,3353,3451
2,6904,10,100,0.001,0.01,0.93,3408,3496
2,7004,10,100,0.001,0.01,0.914,3457,3547
2,7104,10,100,0.001,0.01,0.918,3505,3599
2,7204,10,100,0.001,0.01,0.956,3559,3645
2,7304,10,100,0.001,0.01,0.956,3606,3698
2,7404,10,100,0.001,0.01,0.968,3667,3737
2,7504,10,100,0.001,0.01,0.968,3718,3786
2,7604,10,100,0.001,0.01,0.966,3770,3834
2,7704,10,100,0.001,0.01,0.956,3827,3877
2,7804,10,100,0.001,0.01,0.948,3881,3923
2,7904,10,100,0.001,0.01,0.976,3926,3978
2,8004,10,100,0.001,0.01,0.972,3983,4021
2,8104,10,100,0.001,0.01,0.976,4024,4080
2,8204,10,100,0.001,0.01,0.974,4075,4129
2,8304,10,100,0.001,0.01,0.972,4127,4177
2,8404,10,100,0.001,0.01,0.95,4179,4225
2,8504,10,100,0.001,0.01,0.966,4234,4270
2,8604,10,100,0.001,0.01,0.966,4284,4320
2,8704,10,100,0.001,0.01,0.966,4332,4372
2,8804,10,100,0.001,0.01,0.97,4390,4414
2,8904,10,100,0.001,0.01,0.968,4441,4463
2,9004,10,100,0.001,0.01,0.946,4498,4506
2,9104,10,100,0.001,0.01,0.924,4542,4562
2,9204,10,100,0.001,0.01,0.968,4590,4614
2,9304,10,100,0.001,0.01,0.952,4632,4672
2,9404,10,100,0.001,0.01,0.964,4684,4720
2,9504,10,100,0.001,0.01,0.974,4736,4768
2,9604,10,100,0.001,0.01,0.974,4791,4813
2,9704,10,100,0.001,0.01,0.976,4832,4872
2,9804,10,100,0.001,0.01,0.974,4883,4921
2,9904,10,100,0.001,0.01,0.976,4931,4973
2,10004,10,100,0.001,0.01,0.97,4987,5017
2,10104,10,100,0.001,0.01,0.974,5038,5066
2,10204,10,100,0.001,0.01,0.978,5093,5111
2,10304,10,100,0.001,0.01,0.98,5141,5163
2,10404,10,100,0.001,0.01,0.966,5182,5222
2,10504,10,100,0.001,0.01,0.97,5236,5268
2,10604,10,100,0.001,0.01,0.974,5287,5317
2,10704,10,100,0.001,0.01,0.966,5349,5355
2,10804,10,100,0.001,0.01,0.972,5405,5399
2,10904,10,100,0.001,0.01,0.958,5457,5447
2,11004,10,100,0.001,0.01,0.96,5507,5497
2,11104,10,100,0.001,0.01,0.98,5551,5553
2,11204,10,100,0.001,0.01,0.974,5605,5599
2,11304,10,100,0.001,0.01,0.974,5652,5652
2,11404,10,100,0.001,0.01,0.978,5699,5705
2,11504,10,100,0.001,0.01,0.968,5753,5751
2,11604,10,100,0.001,0.01,0.968,5794,5810
2,11704,10,100,0.001,0.01,0.98,5838,5866
2,11804,10,100,0.001,0.01,0.978,5889,5915
2,11904,10,100,0.001,0.01,0.978,5935,5969
2,12004,10,100,0.001,0.01,0.978,5980,6024
2,12104,10,100,0.001,0.01,0.98,6024,6080
2,12204,10,100,0.001,0.01,0.958,6070,6134
2,12304,10,100,0.001,0.01,0.974,6120,6184
2,12404,10,100,0.001,0.01,0.98,6168,6236
2,12504,10,100,0.001,0.01,0.986,6221,6283
2,12604,10,100,0.001,0.01,0.98,6272,6332
2,12704,10,100,0.001,0.01,0.974,6330,6374
2,12804,10,100,0.001,0.01,0.978,6376,6428
2,12904,10,100,0.001,0.01,0.986,6429,6475
2,13004,10,100,0.001,0.01,0.98,6482,6522
2,13104,10,100,0.001,0.01,0.976,6537,6567
2,13204,10,100,0.001,0.01,0.986,6593,6611
2,13304,10,100,0.001,0.01,0.988,6646,6658
2,13404,10,100,0.001,0.01,0.984,6700,6704
2,13504,10,100,0.001,0.01,0.968,6753,6751
2,13604,10,100,0.001,0.01,0.976,6804,6800
2,13704,10,100,0.001,0.01,0.986,6853,6851
2,13804,10,100,0.001,0.01,0.984,6901,6903
2,13904,10,100,0.001,0.01,0.982,6955,6949
2,14004,10,100,0.001,0.01,0.978,7005,6999
2,14104,10,100,0.001,0.01,0.988,7054,7050
2,14204,10,100,0.001,0.01,0.986,7109,7095
2,14304,10,100,0.001,0.01,0.986,7161,7143
2,14404,10,100,0.001,0.01,0.982,7214,7190
2,14504,10,100,0.001,0.01,0.978,7267,7237
2,14604,10,100,0.001,0.01,0.984,7317,7287
2,14704,10,100,0.001,0.01,0.99,7368,7336
2,14804,10,100,0.001,0.01,0.986,7418,7386
2,14904,10,100,0.001,0.01,0.974,7466,7438
2,15004,10,100,0.001,0.01,0.986,7510,7494
3,104,10,100,0.001,0.01,0.496,47,57
3,204,10,100,0.001,0.01,0.532,100,104
3,304,10,100,0.001,0.01,0.504,154,150
3,404,10,100,0.001,0.01,0.52,206,198
3,504,10,100,0.001,0.01,0.506,257,247
3,604,10,100,0.001,0.01,0.506,307,297
3,704,10,100,0.001,0.01,0.486,350,354
3,804,10,100,0.001,0.01,0.482,409,395
3,904,10,100,0.001,0.01,0.48,458,446
3,1004,10,100,0.001,0.01,0.496,499,505
3,1104,10,100,0.001,0.01,0.458,549,555
3,1204,10,100,0.001,0.01,0.476,612,592
3,1304,10,100,0.001,0.01,0.476,661,643
3,1404,10,100,0.001,0.01,0.482,716,688
3,1504,10,100,0.001,0.01,0.518,772,732
3,1604,10,100,0.001,0.01,0.484,821,783
3,1704,10,100,0.001,0.01,0.492,861,843
3,1804,10,100,0.001,0.01,0.484,904,900
3,1904,10,100,0.001,0.01,0.49,951,953
3,2004,10,100,0.001,0.01,0.506,1004,1000
3,2104,10,100,0.001,0.01,0.488,1052,1052
3,2204,10,100,0.001,0.01,0.516,1107,1097
3,2304,10,100,0.001,0.01,0.492,1157,1147
3,2404,10,100,0.001,0.01,0.512,1211,1193
3,2504,10,100,0.001,0.01,0.476,1257,1247
3,2604,10,100,0.001,0.01,0.532,1308,1296
3,2704,10,100,0.001,0.01,0.51,1361,1343
3,2804,10,100,0.001,0.01,0.542,1401,1403
3,2904,10,100,0.001,0.01,0.534,1450,1454
3,3004,10,100,0.001,0.01,0.546,1505,1499
3,3104,10,100,0.001,0.01,0.536,1560,1544
3,3204,10,100,0.001,0.01,0.536,1608,1596
3,3304,10,100,0.001,0.01,0.562,1653,1651
3,3404,10,100,0.001,0.01,0.526,1700,1704
3,3504,10,100,0.001,0.01,0.536,1749,1755
3,3604,10,100,0.001,0.01,0.578,1795,1809
3,3704,10,100,0.001,0.01,0.576,1844,1860
3,3804,10,100,0.001,0.01,0.59,1895,1909
3,3904,10,100,0.001,0.01,0.566,1948,1956
3,4004,10,100,0.001,0.01,0.564,1995,2009
3,4104,10,100,0.001,0.01,0.59,2049,2055
3,4204,10,100,0.001,0.01,0.602,2101,2103
3,4304,10,100,0.001,0.01,0.598,2163,2141
3,4404,10,100,0.001,0.01,0.586,2207,2197
3,4504,10,100,0.001,0.01,0.64,2256,2248
3,4604,10,100,0.001,0.01,0.624,2306,2298
3,4704,10,100,0.001,0.01,0.614,2362,2342
3,4804,10,100,0.001,0.01,0.642,2418,2386
3,4904,10,100,0.001,0.01,0.64,2472,2432
3,5004,10,100,0.001,0.01,0.66,2524,2480
3,5104,10,100,0.001,0.01,0.644,2580,2524
3,5204,10,100,0.001,0.01,0.646,2634,2570
3,5304,10,100,0.001,0.01,0.664,2680,2624
3,5404,10,100,0.001,0.01,0.674,2725,2679
3,5504,10,100,0.001,0.01,0.66,2769,2735
3,5604,10,100,0.001,0.01,0.67,2819,2785
3,5704,10,100,0.001,0.01,0.666,2873,2831
3,5804,10,100,0.001,0.01,0.676,2917,2887
3,5904,10,100,0.001,0.01,0.666,2969,2935
3,6004,10,100,0.001,0.01,0.678,3029,2975
3,6104,10,100,0.001,0.01,0.68,3083,3021
3,6204,10,100,0.001,0.01,0.692,3131,3073
3,6304,10,100,0.001,0.01,0.694,3184,3120
3,6404,10,100,0.001,0.01,0.7,3235,3169
3,6504,10,100,0.001,0.01,0.728,3283,3221
3,6604,10,100,0.001,0.01,0.718,3325,3279
3,6704,10,100,0.001,0.01,0.732,3377,3327
3,6804,10,100,0.001,0.01,0.772,3423,3381
3,6904,10,100,0.001,0.01,0.72,3471,3433
3,7004,10,100,0.001,0.01,0.788,3514,3490
3,7104,10,100,0.001,0.01,0.774,3559,3545
3,7204,10,100,0.001,0.01,0.766,3608,3596
3,7304,10,100,0.001,0.01,0.762,3656,3648
3,7404,10,100,0.001,0.01,0.782,3708,3696
3,7504,10,100,0.001,0.01,0.718,3754,3750
3,7604,10,100,0.001,0.01,0.734,3809,3795
3,7704,10,100,0.001,0.01,0.778,3864,3840
3,7804,10,100,0.001,0.01,0.82,3918,3886
3,7904,10,100,0.001,0.01,0.776,3964,3940
3,8004,10,100,0.001,0.01,0.8,4009,3995
3,8104,10,100,0.001,0.01,0.798,4054,4050
3,8204,10,100,0.001,0.01,0.81,4106,4098
3,8304,10,100,0.001,0.01,0.808,4166,4138
3,8404,10,100,0.001,0.01,0.826,4219,4185
3,8504,10,100,0.001,0.01,0.846,4262,4242
3,8604,10,100,0.001,0.01,0.848,4310,4294
3,8704,10,100,0.001,0.01,0.842,4360,4344
3,8804,10,100,0.001,0.01,0.864,4412,4392
3,8904,10,100,0.001,0.01,0.868,4461,4443
3,9004,10,100,0.001,0.01,0.882,4508,4496
3,9104,10,100,0.001,0.01,0.872,4547,4557
3,9204,10,100,0.001,0.01,0.898,4600,4604
3,9304,10,100,0.001,0.01,0.872,4646,4658
3,9404,10,100,0.001,0.01,0.89,4695,4709
3,9504,10,100,0.001,0.01,0.876,4747,4757
3,9604,10,100,0.001,0.01,0.906,4796,4808
3,9704,10,100,0.001,0.01,0.906,4852,4852
3,9804,10,100,0.001,0.01,0.908,4903,4901
3,9904,10,100,0.001,0.01,0.916,4957,4947
3,10004,10,100,0.001,0.01,0.91,5015,4989
3,10104,10,100,0.001,0.01,0.916,5059,5045
3,10204,10,100,0.001,0.01,0.914,5111,5093
3,10304,10,100,0.001,0.01,0.92,5160,5144
3,10404,10,100,0.001,0.01,0.914,5204,5200
3,10504,10,100,0.001,0.01,0.93,5242,5262
3,10604,10,100,0.001,0.01,0.922,5298,5306
3,10704,10,100,0.001,0.01,0.928,5351,5353
3,10804,10,100,0.001,0.01,0.914,5398,5406
3,10904,10,100,0.001,0.01,0.938,5444,5460
3,11004,10,100,0.001,0.01,0.936,5500,5504
3,11104,10,100,0.001,0.01,0.922,5552,5552
3,11204,10,100,0.001,0.01,0.902,5595,5609
3,11304,10,100,0.001,0.01,0.92,5643,5661
3,11404,10,100,0.001,0.01,0.938,5693,5711
3,11504,10,100,0.001,0.01,0.904,5736,5768
3,11604,10,100,0.001,0.01,0.954,5794,5810
3,11704,10,100,0.001,0.01,0.942,5845,5859
3,11804,10,100,0.001,0.01,0.936,5894,5910
3,11904,10,100,0.001,0.01,0.934,5950,5954
3,12004,10,100,0.001,0.01,0.95,6001,6003
3,12104,10,100,0.001,0.01,0.96,6053,6051
3,12204,10,100,0.001,0.01,0.94,6104,6100
3,12304,10,100,0.001,0.01,0.964,6157,6147
3,12404,10,100,0.001,0.01,0.936,6207,6197
3,12504,10,100,0.001,0.01,0.96,6258,6246
3,12604,10,100,0.001,0.01,0.954,6302,6302
3,12704,10,100,0.001,0.01,0.94,6351,6353
3,12804,10,100,0.001,0.01,0.954,6402,6402
3,12904,10,100,0.001,0.01,0.972,6453,6451
3,13004,10,100,0.001,0.01,0.968,6503,6501
3,13104,10,100,0.001,0.01,0.958,6555,6549
3,13204,10,100,0.001,0.01,0.958,6600,6604
3,13304,10,100,0.001,0.01,0.966,6649,6655
3,13404,10,100,0.001,0.01,0.962,6705,6699
3,13504,10,100,0.001,0.01,0.966,6759,6745
3,13604,10,100,0.001,0.01,0.96,6809,6795
3,13704,10,100,0.001,0.01,0.97,6855,6849
3,13804,10,100,0.001,0.01,0.954,6905,6899
3,13904,10,100,0.001,0.01,0.942,6948,6956
3,14004,10,100,0.001,0.01,0.968,6995,7009
3,14104,10,100,0.001,0.01,0.986,7047,7057
3,14204,10,100,0.001,0.01,0.96,7097,7107
3,14304,10,100,0.001,0.01,0.98,7147,7157
3,14404,10,100,0.001,0.01,0.978,7197,7207
3,14504,10,100,0.001,0.01,0.96,7243,7261
3,14604,10,100,0.001,0.01,0.95,7295,7309
3,14704,10,100,0.001,0.01,0.97,7347,7357
3,14804,10,100,0.001,0.01,0.98,7407,7397
3,14904,10,100,0.001,0.01,0.98,7452,7452
3,15004,10,100,0.001,0.01,0.964,7500,7504
4,104,10,100,0.001,0.01,0.502,53,51
4,204,10,100,0.001,0.01,0.49,105,99
4,304,10,100,0.001,0.01,0.492,157,147
4,404,10,100,0.001,0.01,0.502,208,196
4,504,10,100,0.001,0.01,0.49,254,250
4,604,10,100,0.001,0.01,0.474,305,299
4,704,10,100,0.001,0.01,0.464,349,355
4,804,10,100,0.001,0.01,0.468,397,407
4,904,10,100,0.001,0.01,0.452,449,455
4,1004,10,100,0.001,0.01,0.468,504,500
4,1104,10,100,0.001,0.01,0.46,550,554
4,1204,10,100,0.001,0.01,0.488,601,603
4,1304,10,100,0.001,0.01,0.444,652,652
4,1404,10,100,0.001,0.01,0.462,702,702
4,1504,10,100,0.001,0.01,0.47,760,744
4,1604,10,100,0.001,0.01,0.468,819,785
4,1704,10,100,0.001,0.01,0.472,867,837
4,1804,10,100,0.001,0.01,0.484,925,879
4,1904,10,100,0.001,0.01,0.464,969,935
4,2004,10,100,0.001,0.01,0.484,1014,990
4,2104,10,100,0.001,0.01,0.446,1067,1037
4,2204,10,100,0.001,0.01,0.474,1112,1092
4,2304,10,100,0.001,0.01,0.462,1157,1147
4,2404,10,100,0.001,0.01,0.492,1201,1203
4,2504,10,100,0.001,0.01,0.518,1254,1250
4,2604,10,100,0.001,0.01,0.524,1306,1298
4,2704,10,100,0.001,0.01,0.518,1363,1341
4,2804,10,100,0.001,0.01,0.536,1416,1388
4,2904,10,100,0.001,0.01,0.52,1466,1438
4,3004,10,100,0.001,0.01,0.546,1508,1496
4,3104,10,100,0.001,0.01,0.518,1555,1549
4,3204,10,100,0.001,0.01,0.564,1610,1594
4,3304,10,100,0.001,0.01,0.54,1666,1638
4,3404,10,100,0.001,0.01,0.532,1720,1684
4,3504,10,100,0.001,0.01,0.538,1758,1746
4,3604,10,100,0.001,0.01,0.53,1811,1793
4,3704,10,100,0.001,0.01,0.576,1870,1834
4,3804,10,100,0.001,0.01,0.554,1917,1887
4,3904,10,100,0.001,0.01,0.512,1974,1930
4,4004,10,100,0.001,0.01,0.548,2025,1979
4,4104,10,100,0.001,0.01,0.598,2064,2040
4,4204,10,100,0.001,0.01,0.578,2112,2092
4,4304,10,100,0.001,0.01,0.584,2158,2146
4,4404,10,100,0.001,0.01,0.58,2203,2201
4,4504,10,100,0.001,0.01,0.608,2256,2248
4,4604,10,100,0.001,0.01,0.578,2309,2295
4,4704,10,100,0.001,0.01,0.606,2358,2346
4,4804,10,100,0.001,0.01,0.628,2408,2396
4,4904,10,100,0.001,0.01,0.62,2463,2441
4,5004,10,100,0.001,0.01,0.642,2509,2495
4,5104,10,100,0.001,0.01,0.62,2565,2539
4,5204,10,100,0.001,0.01,0.628,2612,2592
4,5304,10,100,0.001,0.01,0.632,2664,2640
4,5404,10,100,0.001,0.01,0.652,2715,2689
4,5504,10,100,0.001,0.01,0.632,2767,2737
4,5604,10,100,0.001,0.01,0.654,2819,2785
4,5704,10,100,0.001,0.01,0.656,2875,2829
4,5804,10,100,0.001,0.01,0.64,2916,2888
4,5904,10,100,0.001,0.01,0.64,2970,2934
4,6004,10,100,0.001,0.01,0.642,3011,2993
4,6104,10,100,0.001,0.01,0.68,3055,3049
4,6204,10,100,0.001,0.01,0.674,3102,3102
4,6304,10,100,0.001,0.01,0.684,3159,3145
4,6404,10,100,0.001,0.01,0.646,3199,3205
4,6504,10,100,0.001,0.01,0.624,3253,3251
4,6604,10,100,0.001,0.01,0.634,3304,3300
4,6704,10,100,0.001,0.01,0.666,3354,3350
4,6804,10,100,0.001,0.01,0.642,3404,3400
4,6904,10,100,0.001,0.01,0.674,3452,3452
4,7004,10,100,0.001,0.01,0.682,3506,3498
4,7104,10,100,0.001,0.01,0.694,3553,3551
4,7204,10,100,0.001,0.01,0.678,3600,3604
4,7304,10,100,0.001,0.01,0.666,3646,3658
4,7404,10,100,0.001,0.01,0.706,3696,3708
4,7504,10,100,0.001,0.01,0.702,3752,3752
4,7604,10,100,0.001,0.01,0.722,3803,3801
4,7704,10,100,0.001,0.01,0.696,3843,3861
4,7804,10,100,0.001,0.01,0.702,3899,3905
4,7904,10,100,0.001,0.01,0.688,3953,3951
4,8004,10,100,0.001,0.01,0.704,4010,3994
4,8104,10,100,0.001,0.01,0.688,4055,4049
4,8204,10,100,0.001,0.01,0.706,4098,4106
4,8304,10,100,0.001,0.01,0.692,4149,4155
4,8404,10,100,0.001,0.01,0.732,4184,4220
4,8504,10,100,0.001,0.01,0.716,4228,4276
4,8604,10,100,0.001,0.01,0.706,4283,4321
4,8704,10,100,0.001,0.01,0.668,4334,4370
4,8804,10,100,0.001,0.01,0.71,4379,4425
4,8904,10,100,0.001,0.01,0.706,4435,4469
4,9004,10,100,0.001,0.01,0.724,4485,4519
4,9104,10,100,0.001,0.01,0.708,4538,4566
4,9204,10,100,0.001,0.01,0.718,4591,4613
4,9304,10,100,0.001,0.01,0.764,4640,4664
4,9404,10,100,0.001,0.01,0.77,4698,4706
4,9504,10,100,0.001,0.01,0.75,4741,4763
4,9604,10,100,0.001,0.01,0.778,4784,4820
4,9704,10,100,0.001,0.01,0.762,4832,4872
4,9804,10,100,0.001,0.01,0.76,4880,4924
4,9904,10,100,0.001,0.01,0.766,4923,4981
4,10004,10,100,0.001,0.01,0.732,4976,5028
4,10104,10,100,0.001,0.01,0.784,5027,5077
4,10204,10,100,0.001,0.01,0.788,5078,5126
4,10304,10,100,0.001,0.01,0.764,5125,5179
4,10404,10,100,0.001,0.01,0.804,5175,5229
4,10504,10,100,0.001,0.01,0.814,5228,5276
4,10604,10,100,0.001,0.01,0.778,5278,5326
4,10704,10,100,0.001,0.01,0.784,5325,5379
4,10804,10,100,0.001,0.01,0.76,5375,5429
4,10904,10,100,0.001,0.01,0.774,5426,5478
4,11004,10,100,0.001,0.01,0.808,5482,5522
4,11104,10,100,0.001,0.01,0.814,5536,5568
4,11204,10,100,0.001,0.01,0.776,5590,5614
4,11304,10,100,0.001,0.01,0.81,5636,5668
4,11404,10,100,0.001,0.01,0.826,5678,5726
4,11504,10,100,0.001,0.01,0.802,5726,5778
4,11604,10,100,0.001,0.01,0.8,5780,5824
4,11704,10,100,0.001,0.01,0.806,5830,5874
4,11804,10,100,0.001,0.01,0.79,5885,5919
4,11904,10,100,0.001,0.01,0.746,5937,5967
4,12004,10,100,0.001,0.01,0.784,5990,6014
4,12104,10,100,0.001,0.01,0.806,6041,6063
4,12204,10,100,0.001,0.01,0.802,6094,6110
4,12304,10,100,0.001,0.01,0.782,6149,6155
4,12404,10,100,0.001,0.01,0.818,6198,6206
4,12504,10,100,0.001,0.01,0.822,6243,6261
4,12604,10,100,0.001,0.01,0.826,6295,6309
4,12704,10,100,0.001,0.01,0.86,6350,6354
4,12804,10,100,0.001,0.01,0.82,6398,6406
4,12904,10,100,0.001,0.01,0.84,6446,6458
4,13004,10,100,0.001,0.01,0.832,6501,6503
4,13104,10,100,0.001,0.01,0.816,6559,6545
4,13204,10,100,0.001,0.01,0.848,6610,6594
4,13304,10,100,0.001,0.01,0.864,6659,6645
4,13404,10,100,0.001,0.01,0.858,6708,6696
4,13504,10,100,0.001,0.01,0.836,6764,6740
4,13604,10,100,0.001,0.01,0.82,6809,6795
4,13704,10,100,0.001,0.01,0.852,6862,6842
4,13804,10,100,0.001,0.01,0.868,6905,6899
4,13904,10,100,0.001,0.01,0.864,6948,6956
4,14004,10,100,0.001,0.01,0.87,6998,7006
4,14104,10,100,0.001,0.01,0.856,7047,7057
4,14204,10,100,0.001,0.01,0.846,7094,7110
4,14304,10,100,0.001,0.01,0.836,7149,7155
4,14404,10,100,0.001,0.01,0.842,7203,7201
4,14504,10,100,0.001,0.01,0.868,7249,7255
4,14604,10,100,0.001,0.01,0.876,7294,7310
4,14704,10,100,0.001,0.01,0.866,7340,7364
4,14804,10,100,0.001,0.01,0.88,7389,7415
4,14904,10,100,0.001,0.01,0.886,7447,7457
4,15004,10,100,0.001,0.01,0.872,7504,7500
5,104,10,100,0.001,0.01,0.462,53,51
5,204,10,100,0.001,0.01,0.53,117,87
5,304,10,100,0.001,0.01,0.51,168,136
5,404,10,100,0.001,0.01,0.522,220,184
5,504,10,100,0.001,0.01,0.524,271,233
5,604,10,100,0.001,0.01,0.506,326,278
5,704,10,100,0.001,0.01,0.476,372,332
5,804,10,100,0.001,0.01,0.492,418,386
5,904,10,100,0.001,0.01,0.522,465,439
5,1004,10,100,0.001,0.01,0.49,508,496
5,1104,10,100,0.001,0.01,0.504,552,552
5,1204,10,100,0.001,0.01,0.512,598,606
5,1304,10,100,0.001,0.01,0.442,650,654
5,1404,10,100,0.001,0.01,0.484,696,708
5,1504,10,100,0.001,0.01,0.498,751,753
5,1604,10,100,0.001,0.01,0.512,805,799
5,1704,10,100,0.001,0.01,0.532,849,855
5,1804,10,100,0.001,0.01,0.544,899,905
5,1904,10,100,0.001,0.01,0.544,945,959
5,2004,10,100,0.001,0.01,0.544,987,1017
5,2104,10,100,0.001,0.01,0.564,1043,1061
5,2204,10,100,0.001,0.01,0.614,1089,1115
5,2304,10,100,0.001,0.01,0.6,1139,1165
5,2404,10,100,0.001,0.01,0.624,1185,1219
5,2504,10,100,0.001,0.01,0.648,1231,1273
5,2604,10,100,0.001,0.01,0.67,1288,1316
5,2704,10,100,0.001,0.01,0.658,1327,1377
5,2804,10,100,0.001,0.01,0.702,1379,1425
5,2904,10,100,0.001,0.01,0.722,1430,1474
5,3004,10,100,0.001,0.01,0.744,1481,1523
5,3104,10,100,0.001,0.01,0.79,1531,1573
5,3204,10,100,0.001,0.01,0.794,1572,1632
5,3304,10,100,0.001,0.01,0.822,1622,1682
5,3404,10,100,0.001,0.01,0.828,1680,1724
5,3504,10,100,0.001,0.01,0.826,1730,1774
5,3604,10,100,0.001,0.01,0.852,1778,1826
5,3704,10,100,0.001,0.01,0.836,1831,1873
5,3804,10,100,0.001,0.01,0.832,1880,1924
5,3904,10,100,0.001,0.01,0.87,1935,1969
5,4004,10,100,0.001,0.01,0.864,1981,2023
5,4104,10,100,0.001,0.01,0.86,2030,2074
5,4204,10,100,0.001,0.01,0.876,2079,2125
5,4304,10,100,0.001,0.01,0.882,2139,2165
5,4404,10,100,0.001,0.01,0.888,2185,2219
5,4504,10,100,0.001,0.01,0.898,2240,2264
5,4604,10,100,0.001,0.01,0.874,2292,2312
5,4704,10,100,0.001,0.01,0.9,2337,2367
5,4804,10,100,0.001,0.01,0.892,2384,2420
5,4904,10,100,0.001,0.01,0.9,2442,2462
5,5004,10,100,0.001,0.01,0.926,2493,2511
5,5104,10,100,0.001,0.01,0.906,2542,2562
5,5204,10,100,0.001,0.01,0.936,2588,2616
5,5304,10,100,0.001,0.01,0.9,2635,2669
5,5404,10,100,0.001,0.01,0.906,2677,2727
5,5504,10,100,0.001,0.01,0.9,2728,2776
5,5604,10,100,0.001,0.01,0.918,2771,2833
5,5704,10,100,0.001,0.01,0.946,2820,2884
5,5804,10,100,0.001,0.01,0.956,2874,2930
5,5904,10,100,0.001,0.01,0.95,2917,2987
5,6004,10,100,0.001,0.01,0.944,2978,3026
5,6104,10,100,0.001,0.01,0.934,3033,3071
5,6204,10,100,0.001,0.01,0.952,3089,3115
5,6304,10,100,0.001,0.01,0.944,3144,3160
5,6404,10,100,0.001,0.01,0.94,3189,3215
5,6504,10,100,0.001,0.01,0.938,3236,3268
5,6604,10,100,0.001,0.01,0.954,3287,3317
5,6704,10,100,0.001,0.01,0.948,3340,3364
5,6804,10,100,0.001,0.01,0.974,3380,3424
5,6904,10,100,0.001,0.01,0.966,3435,3469
5,7004,10,100,0.001,0.01,0.962,3495,3509
5,7104,10,100,0.001,0.01,0.97,3551,3553
5,7204,10,100,0.001,0.01,0.962,3600,3604
5,7304,10,100,0.001,0.01,0.966,3649,3655
5,7404,10,100,0.001,0.01,0.96,3689,3715
5,7504,10,100,0.001,0.01,0.966,3748,3756
5,7604,10,100,0.001,0.01,0.962,3794,3810
5,7704,10,100,0.001,0.01,0.944,3850,3854
5,7804,10,100,0.001,0.01,0.942,3896,3908
5,7904,10,100,0.001,0.01,0.946,3953,3951
5,8004,10,100,0.001,0.01,0.958,4006,3998
5,8104,10,100,0.001,0.01,0.966,4055,4049
5,8204,10,100,0.001,0.01,0.966,4102,4102
5,8304,10,100,0.001,0.01,0.974,4146,4158
5,8404,10,100,0.001,0.01,0.97,4199,4205
5,8504,10,100,0.001,0.01,0.972,4252,4252
5,8604,10,100,0.001,0.01,0.976,4301,4303
5,8704,10,100,0.001,0.01,0.982,4345,4359
5,8804,10,100,0.001,0.01,0.968,4392,4412
5,8904,10,100,0.001,0.01,0.968,4445,4459
5,9004,10,100,0.001,0.01,0.962,4497,4507
5,9104,10,100,0.001,0.01,0.97,4546,4558
5,9204,10,100,0.001,0.01,0.974,4600,4604
5,9304,10,100,0.001,0.01,0.972,4644,4660
5,9404,10,100,0.001,0.01,0.98,4690,4714
5,9504,10,100,0.001,0.01,0.978,4740,4764
5,9604,10,100,0.001,0.01,0.978,4799,4805
5,9704,10,100,0.001,0.01,0.976,4852,4852
5,9804,10,100,0.001,0.01,0.978,4898,4906
5,9904,10,100,0.001,0.01,0.976,4938,4966
5,10004,10,100,0.001,0.01,0.98,4994,5010
5,10104,10,100,0.001,0.01,0.98,5048,5056
5,10204,10,100,0.001,0.01,0.978,5094,5110
5,10304,10,100,0.001,0.01,0.978,5141,5163
5,10404,10,100,0.001,0.01,0.968,5184,5220
5,10504,10,100,0.001,0.01,0.978,5238,5266
5,10604,10,100,0.001,0.01,0.962,5289,5315
5,10704,10,100,0.001,0.01,0.974,5338,5366
5,10804,10,100,0.001,0.01,0.966,5383,5421
5,10904,10,100,0.001,0.01,0.97,5426,5478
5,11004,10,100,0.001,0.01,0.974,5476,5528
5,11104,10,100,0.001,0.01,0.98,5535,5569
5,11204,10,100,0.001,0.01,0.98,5590,5614
5,11304,10,100,0.001,0.01,0.978,5635,5669
5,11404,10,100,0.001,0.01,0.972,5689,5715
5,11504,10,100,0.001,0.01,0.972,5740,5764
5,11604,10,100,0.001,0.01,0.984,5794,5810
5,11704,10,100,0.001,0.01,0.984,5849,5855
5,11804,10,100,0.001,0.01,0.988,5895,5909
5,11904,10,100,0.001,0.01,0.99,5944,5960
5,12004,10,100,0.001,0.01,0.982,6000,6004
5,12104,10,100,0.001,0.01,0.98,6044,6060
5,12204,10,100,0.001,0.01,0.984,6092,6112
5,12304,10,100,0.001,0.01,0.984,6144,6160
5,12404,10,100,0.001,0.01,0.948,6195,6209
5,12504,10,100,0.001,0.01,0.964,6245,6259
5,12604,10,100,0.001,0.01,0.984,6296,6308
5,12704,10,100,0.001,0.01,0.988,6341,6363
5,12804,10,100,0.001,0.01,0.986,6391,6413
5,12904,10,100,0.001,0.01,0.986,6433,6471
5,13004,10,100,0.001,0.01,0.986,6485,6519
5,13104,10,100,0.001,0.01,0.986,6540,6564
5,13204,10,100,0.001,0.01,0.984,6591,6613
5,13304,10,100,0.001,0.01,0.986,6645,6659
5,13404,10,100,0.001,0.01,0.982,6696,6708
5,13504,10,100,0.001,0.01,0.984,6745,6759
5,13604,10,100,0.001,0.01,0.986,6801,6803
5,13704,10,100,0.001,0.01,0.988,6842,6862
5,13804,10,100,0.001,0.01,0.986,6891,6913
5,13904,10,100,0.001,0.01,0.964,6931,6973
5,14004,10,100,0.001,0.01,0.984,6979,7025
5,14104,10,100,0.001,0.01,0.986,7029,7075
5,14204,10,100,0.001,0.01,0.988,7082,7122
5,14304,10,100,0.001,0.01,0.99,7132,7172
5,14404,10,100,0.001,0.01,0.984,7190,7214
5,14504,10,100,0.001,0.01,0.988,7244,7260
5,14604,10,100,0.001,0.01,0.986,7287,7317
5,14704,10,100,0.001,0.01,0.986,7341,7363
5,14804,10,100,0.001,0.01,0.984,7388,7416
5,14904,10,100,0.001,0.01,0.984,7436,7468
5,15004,10,100,0.001,0.01,0.988,7483,7521
6,104,10,100,0.001,0.01,0.552,59,45
6,204,10,100,0.001,0.01,0.548,113,91
6,304,10,100,0.001,0.01,0.488,166,138
6,404,10,100,0.001,0.01,0.464,222,182
6,504,10,100,0.001,0.01,0.488,277,227
6,604,10,100,0.001,0.01,0.554,327,277
6,704,10,100,0.001,0.01,0.516,373,331
6,804,10,100,0.001,0.01,0.52,423,381
6,904,10,100,0.001,0.01,0.55,476,428
6,1004,10,100,0.001,0.01,0.538,530,474
6,1104,10,100,0.001,0.01,0.516,578,526
6,1204,10,100,0.001,0.01,0.494,618,586
6,1304,10,100,0.001,0.01,0.504,664,640
6,1404,10,100,0.001,0.01,0.564,724,680
6,1504,10,100,0.001,0.01,0.558,776,728
6,1604,10,100,0.001,0.01,0.584,829,775
6,1704,10,100,0.001,0.01,0.522,875,829
6,1804,10,100,0.001,0.01,0.592,926,878
6,1904,10,100,0.001,0.01,0.596,972,932
6,2004,10,100,0.001,0.01,0.604,1022,982
6,2104,10,100,0.001,0.01,0.606,1075,1029
6,2204,10,100,0.001,0.01,0.652,1123,1081
6,2304,10,100,0.001,0.01,0.662,1173,1131
6,2404,10,100,0.001,0.01,0.674,1223,1181
6,2504,10,100,0.001,0.01,0.702,1262,1242
6,2604,10,100,0.001,0.01,0.694,1316,1288
6,2704,10,100,0.001,0.01,0.718,1363,1341
6,2804,10,100,0.001,0.01,0.702,1413,1391
6,2904,10,100,0.001,0.01,0.652,1467,1437
6,3004,10,100,0.001,0.01,0.686,1512,1492
6,3104,10,100,0.001,0.01,0.734,1557,1547
6,3204,10,100,0.001,0.01,0.694,1606,1598
6,3304,10,100,0.001,0.01,0.72,1662,1642
6,3404,10,100,0.001,0.01,0.728,1709,1695
6,3504,10,100,0.001,0.01,0.744,1763,1741
6,3604,10,100,0.001,0.01,0.732,1812,1792
6,3704,10,100,0.001,0.01,0.76,1861,1843
6,3804,10,100,0.001,0.01,0.762,1915,1889
6,3904,10,100,0.001,0.01,0.758,1962,1942
6,4004,10,100,0.001,0.01,0.716,2007,1997
6,4104,10,100,0.001,0.01,0.728,2058,2046
6,4204,10,100,0.001,0.01,0.71,2108,2096
6,4304,10,100,0.001,0.01,0.758,2161,2143
6,4404,10,100,0.001,0.01,0.732,2211,2193
6,4504,10,100,0.001,0.01,0.748,2260,2244
6,4604,10,100,0.001,0.01,0.752,2309,2295
6,4704,10,100,0.001,0.01,0.746,2360,2344
6,4804,10,100,0.001,0.01,0.744,2410,2394
6,4904,10,100,0.001,0.01,0.73,2455,2449
6,5004,10,100,0.001,0.01,0.752,2504,2500
6,5104,10,100,0.001,0.01,0.768,2552,2552
6,5204,10,100,0.001,0.01,0.754,2600,2604
6,5304,10,100,0.001,0.01,0.742,2656,2648
6,5404,10,100,0.001,0.01,0.774,2706,2698
6,5504,10,100,0.001,0.01,0.76,2754,2750
6,5604,10,100,0.001,0.01,0.75,2810,2794
6,5704,10,100,0.001,0.01,0.776,2864,2840
6,5804,10,100,0.001,0.01,0.762,2914,2890
6,5904,10,100,0.001,0.01,0.768,2967,2937
6,6004,10,100,0.001,0.01,0.796,3018,2986
6,6104,10,100,0.001,0.01,0.794,3067,3037
6,6204,10,100,0.001,0.01,0.798,3112,3092
6,6304,10,100,0.001,0.01,0.804,3160,3144
6,6404,10,100,0.001,0.01,0.816,3200,3204
6,6504,10,100,0.001,0.01,0.812,3243,3261
6,6604,10,100,0.001,0.01,0.784,3281,3323
6,6704,10,100,0.001,0.01,0.766,3335,3369
6,6804,10,100,0.001,0.01,0.788,3392,3412
6,6904,10,100,0.001,0.01,0.808,3450,3454
6,7004,10,100,0.001,0.01,0.804,3501,3503
6,7104,10,100,0.001,0.01,0.8,3543,3561
6,7204,10,100,0.001,0.01,0.808,3595,3609
6,7304,10,100,0.001,0.01,0.818,3642,3662
6,7404,10,100,0.001,0.01,0.836,3691,3713
6,7504,10,100,0.001,0.01,0.834,3734,3770
6,7604,10,100,0.001,0.01,0.794,3789,3815
6,7704,10,100,0.001,0.01,0.844,3831,3873
6,7804,10,100,0.001,0.01,0.824,3879,3925
6,7904,10,100,0.001,0.01,0.856,3928,3976
6,8004,10,100,0.001,0.01,0.83,3975,4029
6,8104,10,100,0.001,0.01,0.866,4025,4079
6,8204,10,100,0.001,0.01,0.794,4074,4130
6,8304,10,100,0.001,0.01,0.838,4128,4176
6,8404,10,100,0.001,0.01,0.838,4183,4221
6,8504,10,100,0.001,0.01,0.866,4224,4280
6,8604,10,100,0.001,0.01,0.852,4274,4330
6,8704,10,100,0.001,0.01,0.868,4322,4382
6,8804,10,100,0.001,0.01,0.862,4374,4430
6,8904,10,100,0.001,0.01,0.864,4426,4478
6,9004,10,100,0.001,0.01,0.872,4478,4526
6,9104,10,100,0.001,0.01,0.872,4537,4567
6,9204,10,100,0.001,0.01,0.86,4588,4616
6,9304,10,100,0.001,0.01,0.868,4637,4667
6,9404,10,100,0.001,0.01,0.816,4689,4715
6,9504,10,100,0.001,0.01,0.806,4743,4761
6,9604,10,100,0.001,0.01,0.83,4792,4812
6,9704,10,100,0.001,0.01,0.846,4836,4868
6,9804,10,100,0.001,0.01,0.838,4886,4918
6,9904,10,100,0.001,0.01,0.858,4936,4968
6,10004,10,100,0.001,0.01,0.856,4989,5015
6,10104,10,100,0.001,0.01,0.85,5038,5066
6,10204,10,100,0.001,0.01,0.868,5081,5123
6,10304,10,100,0.001,0.01,0.858,5125,5179
6,10404,10,100,0.001,0.01,0.874,5171,5233
6,10504,10,100,0.001,0.01,0.876,5225,5279
6,10604,10,100,0.001,0.01,0.842,5274,5330
6,10704,10,100,0.001,0.01,0.828,5327,5377
6,10804,10,100,0.001,0.01,0.87,5378,5426
6,10904,10,100,0.001,0.01,0.882,5437,5467
6,11004,10,100,0.001,0.01,0.884,5486,5518
6,11104,10,100,0.001,0.01,0.87,5536,5568
6,11204,10,100,0.001,0.01,0.882,5583,5621
6,11304,10,100,0.001,0.01,0.894,5634,5670
6,11404,10,100,0.001,0.01,0.88,5680,5724
6,11504,10,100,0.001,0.01,0.894,5735,5769
6,11604,10,100,0.001,0.01,0.894,5776,5828
6,11704,10,100,0.001,0.01,0.888,5825,5879
6,11804,10,100,0.001,0.01,0.85,5869,5935
6,11904,10,100,0.001,0.01,0.886,5912,5992
6,12004,10,100,0.001,0.01,0.888,5972,6032
6,12104,10,100,0.001,0.01,0.882,6026,6078
6,12204,10,100,0.001,0.01,0.884,6080,6124
6,12304,10,100,0.001,0.01,0.896,6125,6179
6,12404,10,100,0.001,0.01,0.906,6177,6227
6,12504,10,100,0.001,0.01,0.898,6229,6275
6,12604,10,100,0.001,0.01,0.892,6289,6315
6,12704,10,100,0.001,0.01,0.88,6337,6367
6,12804,10,100,0.001,0.01,0.892,6391,6413
6,12904,10,100,0.001,0.01,0.908,6448,6456
6,13004,10,100,0.001,0.01,0.906,6501,6503
6,13104,10,100,0.001,0.01,0.904,6556,6548
6,13204,10,100,0.001,0.01,0.908,6604,6600
6,13304,10,100,0.001,0.01,0.906,6650,6654
6,13404,10,100,0.001,0.01,0.906,6699,6705
6,13504,10,100,0.001,0.01,0.9,6742,6762
6,13604,10,100,0.001,0.01,0.91,6790,6814
6,13704,10,100,0.001,0.01,0.912,6840,6864
6,13804,10,100,0.001,0.01,0.908,6893,6911
6,13904,10,100,0.001,0.01,0.922,6939,6965
6,14004,10,100,0.001,0.01,0.906,6988,7016
6,14104,10,100,0.001,0.01,0.922,7040,7064
6,14204,10,100,0.001,0.01,0.928,7084,7120
6,14304,10,100,0.001,0.01,0.936,7137,7167
6,14404,10,100,0.001,0.01,0.948,7187,7217
6,14504,10,100,0.001,0.01,0.938,7233,7271
6,14604,10,100,0.001,0.01,0.948,7281,7323
6,14704,10,100,0.001,0.01,0.94,7331,7373
6,14804,10,100,0.001,0.01,0.938,7373,7431
6,14904,10,100,0.001,0.01,0.94,7424,7480
6,15004,10,100,0.001,0.01,0.94,7476,7528
7,104,10,100,0.001,0.01,0.514,44,60
7,204,10,100,0.001,0.01,0.514,89,115
7,304,10,100,0.001,0.01,0.502,136,168
7,404,10,100,0.001,0.01,0.52,189,215
7,504,10,100,0.001,0.01,0.498,238,266
7,604,10,100,0.001,0.01,0.5,295,309
7,704,10,100,0.001,0.01,0.51,347,357
7,804,10,100,0.001,0.01,0.504,395,409
7,904,10,100,0.001,0.01,0.48,446,458
7,1004,10,100,0.001,0.01,0.502,503,501
7,1104,10,100,0.001,0.01,0.514,546,558
7,1204,10,100,0.001,0.01,0.532,599,605
7,1304,10,100,0.001,0.01,0.542,644,660
7,1404,10,100,0.001,0.01,0.532,697,707
7,1504,10,100,0.001,0.01,0.534,750,754
7,1604,10,100,0.001,0.01,0.54,799,805
7,1704,10,100,0.001,0.01,0.538,849,855
7,1804,10,100,0.001,0.01,0.544,902,902
7,1904,10,100,0.001,0.01,0.556,949,955
7,2004,10,100,0.001,0.01,0.574,996,1008
7,2104,10,100,0.001,0.01,0.594,1045,1059
7,2204,10,100,0.001,0.01,0.596,1103,1101
7,2304,10,100,0.001,0.01,0.606,1153,1151
7,2404,10,100,0.001,0.01,0.65,1201,1203
7,2504,10,100,0.001,0.01,0.678,1254,1250
7,2604,10,100,0.001,0.01,0.662,1293,1311
7,2704,10,100,0.001,0.01,0.72,1347,1357
7,2804,10,100,0.001,0.01,0.73,1390,1414
7,2904,10,100,0.001,0.01,0.758,1437,1467
7,3004,10,100,0.001,0.01,0.706,1486,1518
7,3104,10,100,0.001,0.01,0.728,1535,1569
7,3204,10,100,0.001,0.01,0.77,1581,1623
7,3304,10,100,0.001,0.01,0.78,1630,1674
7,3404,10,100,0.001,0.01,0.8,1683,1721
7,3504,10,100,0.001,0.01,0.83,1730,1774
7,3604,10,100,0.001,0.01,0.848,1778,1826
7,3704,10,100,0.001,0.01,0.832,1826,1878
7,3804,10,100,0.001,0.01,0.814,1881,1923
7,3904,10,100,0.001,0.01,0.79,1924,1980
7,4004,10,100,0.001,0.01,0.826,1976,2028
7,4104,10,100,0.001,0.01,0.836,2023,2081
7,4204,10,100,0.001,0.01,0.84,2071,2133
7,4304,10,100,0.001,0.01,0.854,2125,2179
7,4404,10,100,0.001,0.01,0.862,2162,2242
7,4504,10,100,0.001,0.01,0.856,2219,2285
7,4604,10,100,0.001,0.01,0.846,2270,2334
7,4704,10,100,0.001,0.01,0.848,2327,2377
7,4804,10,100,0.001,0.01,0.858,2372,2432
7,4904,10,100,0.001,0.01,0.856,2423,2481
7,5004,10,100,0.001,0.01,0.848,2466,2538
7,5104,10,100,0.001,0.01,0.874,2522,2582
7,5204,10,100,0.001,0.01,0.864,2572,2632
7,5304,10,100,0.001,0.01,0.878,2625,2679
7,5404,10,100,0.001,0.01,0.86,2679,2725
7,5504,10,100,0.001,0.01,0.884,2734,2770
7,5604,10,100,0.001,0.01,0.884,2777,2827
7,5704,10,100,0.001,0.01,0.88,2824,2880
7,5804,10,100,0.001,0.01,0.852,2883,2921
7,5904,10,100,0.001,0.01,0.866,2925,2979
7,6004,10,100,0.001,0.01,0.854,2971,3033
7,6104,10,100,0.001,0.01,0.874,3028,3076
7,6204,10,100,0.001,0.01,0.868,3075,3129
7,6304,10,100,0.001,0.01,0.888,3126,3178
7,6404,10,100,0.001,0.01,0.894,3180,3224
7,6504,10,100,0.001,0.01,0.892,3240,3264
7,6604,10,100,0.001,0.01,0.884,3290,3314
7,6704,10,100,0.001,0.01,0.884,3335,3369
7,6804,10,100,0.001,0.01,0.918,3381,3423
7,6904,10,100,0.001,0.01,0.898,3431,3473
7,7004,10,100,0.001,0.01,0.904,3476,3528
7,7104,10,100,0.001,0.01,0.922,3521,3583
7,7204,10,100,0.001,0.01,0.89,3567,3637
7,7304,10,100,0.001,0.01,0.884,3616,3688
7,7404,10,100,0.001,0.01,0.912,3668,3736
7,7504,10,100,0.001,0.01,0.89,3712,3792
7,7604,10,100,0.001,0.01,0.912,3767,3837
7,7704,10,100,0.001,0.01,0.916,3824,3880
7,7804,10,100,0.001,0.01,0.928,3873,3931
7,7904,10,100,0.001,0.01,0.916,3928,3976
7,8004,10,100,0.001,0.01,0.912,3982,4022
7,8104,10,100,0.001,0.01,0.926,4032,4072
7,8204,10,100,0.001,0.01,0.862,4078,4126
7,8304,10,100,0.001,0.01,0.92,4135,4169
7,8404,10,100,0.001,0.01,0.908,4189,4215
7,8504,10,100,0.001,0.01,0.902,4240,4264
7,8604,10,100,0.001,0.01,0.936,4294,4310
7,8704,10,100,0.001,0.01,0.932,4340,4364
7,8804,10,100,0.001,0.01,0.922,4387,4417
7,8904,10,100,0.001,0.01,0.932,4439,4465
7,9004,10,100,0.001,0.01,0.904,4490,4514
7,9104,10,100,0.001,0.01,0.926,4531,4573
7,9204,10,100,0.001,0.01,0.924,4576,4628
7,9304,10,100,0.001,0.01,0.934,4630,4674
7,9404,10,100,0.001,0.01,0.924,4684,4720
7,9504,10,100,0.001,0.01,0.912,4738,4766
7,9604,10,100,0.001,0.01,0.918,4789,4815
7,9704,10,100,0.001,0.01,0.902,4835,4869
7,9804,10,100,0.001,0.01,0.914,4879,4925
7,9904,10,100,0.001,0.01,0.934,4933,4971
7,10004,10,100,0.001,0.01,0.928,4983,5021
7,10104,10,100,0.001,0.01,0.92,5035,5069
7,10204,10,100,0.001,0.01,0.924,5084,5120
7,10304,10,100,0.001,0.01,0.938,5131,5173
7,10404,10,100,0.001,0.01,0.938,5180,5224
7,10504,10,100,0.001,0.01,0.932,5225,5279
7,10604,10,100,0.001,0.01,0.942,5279,5325
7,10704,10,100,0.001,0.01,0.938,5334,5370
7,10804,10,100,0.001,0.01,0.896,5387,5417
7,10904,10,100,0.001,0.01,0.932,5432,5472
7,11004,10,100,0.001,0.01,0.94,5490,5514
7,11104,10,100,0.001,0.01,0.932,5533,5571
7,11204,10,100,0.001,0.01,0.95,5591,5613
7,11304,10,100,0.001,0.01,0.948,5643,5661
7,11404,10,100,0.001,0.01,0.95,5687,5717
7,11504,10,100,0.001,0.01,0.942,5739,5765
7,11604,10,100,0.001,0.01,0.962,5777,5827
7,11704,10,100,0.001,0.01,0.948,5822,5882
7,11804,10,100,0.001,0.01,0.944,5872,5932
7,11904,10,100,0.001,0.01,0.954,5918,5986
7,12004,10,100,0.001,0.01,0.956,5967,6037
7,12104,10,100,0.001,0.01,0.95,6015,6089
7,12204,10,100,0.001,0.01,0.954,6062,6142
7,12304,10,100,0.001,0.01,0.946,6111,6193
7,12404,10,100,0.001,0.01,0.94,6170,6234
7,12504,10,100,0.001,0.01,0.946,6224,6280
7,12604,10,100,0.001,0.01,0.956,6281,6323
7,12704,10,100,0.001,0.01,0.948,6327,6377
7,12804,10,100,0.001,0.01,0.956,6391,6413
7,12904,10,100,0.001,0.01,0.95,6440,6464
7,13004,10,100,0.001,0.01,0.952,6502,6502
7,13104,10,100,0.001,0.01,0.956,6544,6560
7,13204,10,100,0.001,0.01,0.95,6602,6602
7,13304,10,100,0.001,0.01,0.952,6658,6646
7,13404,10,100,0.001,0.01,0.946,6705,6699
7,13504,10,100,0.001,0.01,0.97,6759,6745
7,13604,10,100,0.001,0.01,0.93,6817,6787
7,13704,10,100,0.001,0.01,0.966,6871,6833
7,13804,10,100,0.001,0.01,0.962,6921,6883
7,13904,10,100,0.001,0.01,0.962,6964,6940
7,14004,10,100,0.001,0.01,0.96,7012,6992
7,14104,10,100,0.001,0.01,0.948,7054,7050
7,14204,10,100,0.001,0.01,0.964,7109,7095
7,14304,10,100,0.001,0.01,0.96,7155,7149
7,14404,10,100,0.001,0.01,0.966,7207,7197
7,14504,10,100,0.001,0.01,0.954,7249,7255
7,14604,10,100,0.001,0.01,0.944,7308,7296
7,14704,10,100,0.001,0.01,0.964,7355,7349
7,14804,10,100,0.001,0.01,0.958,7403,7401
7,14904,10,100,0.001,0.01,0.964,7452,7452
7,15004,10,100,0.001,0.01,0.962,7495,7509
8,104,10,100,0.001,0.01,0.482,46,58
8,204,10,100,0.001,0.01,0.54,101,103
8,304,10,100,0.001,0.01,0.532,142,162
8,404,10,100,0.001,0.01,0.526,196,208
8,504,10,100,0.001,0.01,0.476,246,258
8,604,10,100,0.001,0.01,0.482,296,308
8,704,10,100,0.001,0.01,0.5,346,358
8,804,10,100,0.001,0.01,0.488,397,407
8,904,10,100,0.001,0.01,0.478,449,455
8,1004,10,100,0.001,0.01,0.484,490,514
8,1104,10,100,0.001,0.01,0.536,536,568
8,1204,10,100,0.001,0.01,0.484,588,616
8,1304,10,100,0.001,0.01,0.482,637,667
8,1404,10,100,0.001,0.01,0.506,698,706
8,1504,10,100,0.001,0.01,0.498,750,754
8,1604,10,100,0.001,0.01,0.484,806,798
8,1704,10,100,0.001,0.01,0.478,850,854
8,1804,10,100,0.001,0.01,0.52,899,905
8,1904,10,100,0.001,0.01,0.5,949,955
8,2004,10,100,0.001,0.01,0.544,987,1017
8,2104,10,100,0.001,0.01,0.52,1041,1063
8,2204,10,100,0.001,0.01,0.526,1095,1109
8,2304,10,100,0.001,0.01,0.534,1154,1150
8,2404,10,100,0.001,0.01,0.504,1205,1199
8,2504,10,100,0.001,0.01,0.488,1256,1248
8,2604,10,100,0.001,0.01,0.532,1303,1301
8,2704,10,100,0.001,0.01,0.52,1358,1346
8,2804,10,100,0.001,0.01,0.514,1400,1404
8,2904,10,100,0.001,0.01,0.51,1450,1454
8,3004,10,100,0.001,0.01,0.504,1508,1496
8,3104,10,100,0.001,0.01,0.516,1552,1552
8,3204,10,100,0.001,0.01,0.532,1600,1604
8,3304,10,100,0.001,0.01,0.53,1648,1656
8,3404,10,100,0.001,0.01,0.548,1693,1711
8,3504,10,100,0.001,0.01,0.548,1741,1763
8,3604,10,100,0.001,0.01,0.546,1792,1812
8,3704,10,100,0.001,0.01,0.562,1845,1859
8,3804,10,100,0.001,0.01,0.562,1896,1908
8,3904,10,100,0.001,0.01,0.546,1950,1954
8,4004,10,100,0.001,0.01,0.558,2002,2002
8,4104,10,100,0.001,0.01,0.568,2051,2053
8,4204,10,100,0.001,0.01,0.566,2099,2105
8,4304,10,100,0.001,0.01,0.592,2151,2153
8,4404,10,100,0.001,0.01,0.55,2195,2209
8,4504,10,100,0.001,0.01,0.618,2240,2264
8,4604,10,100,0.001,0.01,0.6,2294,2310
8,4704,10,100,0.001,0.01,0.614,2330,2374
8,4804,10,100,0.001,0.01,0.608,2375,2429
8,4904,10,100,0.001,0.01,0.626,2430,2474
8,5004,10,100,0.001,0.01,0.606,2478,2526
8,5104,10,100,0.001,0.01,0.626,2530,2574
8,5204,10,100,0.001,0.01,0.64,2586,2618
8,5304,10,100,0.001,0.01,0.642,2634,2670
8,5404,10,100,0.001,0.01,0.632,2687,2717
8,5504,10,100,0.001,0.01,0.68,2731,2773
8,5604,10,100,0.001,0.01,0.632,2777,2827
8,5704,10,100,0.001,0.01,0.646,2818,2886
8,5804,10,100,0.001,0.01,0.63,2863,2941
8,5904,10,100,0.001,0.01,0.646,2925,2979
8,6004,10,100,0.001,0.01,0.628,2973,3031
8,6104,10,100,0.001,0.01,0.668,3026,3078
8,6204,10,100,0.001,0.01,0.686,3077,3127
8,6304,10,100,0.001,0.01,0.684,3120,3184
8,6404,10,100,0.001,0.01,0.676,3173,3231
8,6504,10,100,0.001,0.01,0.678,3226,3278
8,6604,10,100,0.001,0.01,0.662,3268,3336
8,6704,10,100,0.001,0.01,0.648,3314,3390
8,6804,10,100,0.001,0.01,0.67,3367,3437
8,6904,10,100,0.001,0.01,0.674,3425,3479
8,7004,10,100,0.001,0.01,0.696,3477,3527
8,7104,10,100,0.001,0.01,0.69,3526,3578
8,7204,10,100,0.001,0.01,0.696,3580,3624
8,7304,10,100,0.001,0.01,0.686,3625,3679
8,7404,10,100,0.001,0.01,0.692,3667,3737
8,7504,10,100,0.001,0.01,0.69,3714,3790
8,7604,10,100,0.001,0.01,0.702,3769,3835
8,7704,10,100,0.001,0.01,0.698,3814,3890
8,7804,10,100,0.001,0.01,0.722,3868,3936
8,7904,10,100,0.001,0.01,0.704,3921,3983
8,8004,10,100,0.001,0.01,0.736,3971,4033
8,8104,10,100,0.001,0.01,0.71,4024,4080
8,8204,10,100,0.001,0.01,0.736,4071,4133
8,8304,10,100,0.001,0.01,0.768,4122,4182
8,8404,10,100,0.001,0.01,0.714,4174,4230
8,8504,10,100,0.001,0.01,0.74,4224,4280
8,8604,10,100,0.001,0.01,0.744,4275,4329
8,8704,10,100,0.001,0.01,0.732,4333,4371
8,8804,10,100,0.001,0.01,0.734,4382,4422
8,8904,10,100,0.001,0.01,0.768,4434,4470
8,9004,10,100,0.001,0.01,0.748,4481,4523
8,9104,10,100,0.001,0.01,0.738,4531,4573
8,9204,10,100,0.001,0.01,0.762,4580,4624
8,9304,10,100,0.001,0.01,0.762,4631,4673
8,9404,10,100,0.001,0.01,0.758,4686,4718
8,9504,10,100,0.001,0.01,0.78,4746,4758
8,9604,10,100,0.001,0.01,0.746,4798,4806
8,9704,10,100,0.001,0.01,0.764,4845,4859
8,9804,10,100,0.001,0.01,0.75,4901,4903
8,9904,10,100,0.001,0.01,0.774,4954,4950
8,10004,10,100,0.001,0.01,0.792,5002,5002
8,10104,10,100,0.001,0.01,0.774,5062,5042
8,10204,10,100,0.001,0.01,0.8,5119,5085
8,10304,10,100,0.001,0.01,0.762,5173,5131
8,10404,10,100,0.001,0.01,0.796,5220,5184
8,10504,10,100,0.001,0.01,0.8,5275,5229
8,10604,10,100,0.001,0.01,0.814,5329,5275
8,10704,10,100,0.001,0.01,0.768,5375,5329
8,10804,10,100,0.001,0.01,0.81,5428,5376
8,10904,10,100,0.001,0.01,0.816,5479,5425
8,11004,10,100,0.001,0.01,0.826,5534,5470
8,11104,10,100,0.001,0.01,0.8,5581,5523
8,11204,10,100,0.001,0.01,0.812,5628,5576
8,11304,10,100,0.001,0.01,0.832,5683,5621
8,11404,10,100,0.001,0.01,0.814,5731,5673
8,11504,10,100,0.001,0.01,0.824,5782,5722
8,11604,10,100,0.001,0.01,0.826,5835,5769
8,11704,10,100,0.001,0.01,0.858,5884,5820
8,11804,10,100,0.001,0.01,0.842,5931,5873
8,11904,10,100,0.001,0.01,0.818,5983,5921
8,12004,10,100,0.001,0.01,0.846,6025,5979
8,12104,10,100,0.001,0.01,0.854,6065,6039
8,12204,10,100,0.001,0.01,0.854,6120,6084
8,12304,10,100,0.001,0.01,0.87,6164,6140
8,12404,10,100,0.001,0.01,0.848,6218,6186
8,12504,10,100,0.001,0.01,0.872,6266,6238
8,12604,10,100,0.001,0.01,0.84,6323,6281
8,12704,10,100,0.001,0.01,0.884,6367,6337
8,12804,10,100,0.001,0.01,0.88,6414,6390
8,12904,10,100,0.001,0.01,0.878,6463,6441
8,13004,10,100,0.001,0.01,0.876,6516,6488
8,13104,10,100,0.001,0.01,0.896,6570,6534
8,13204,10,100,0.001,0.01,0.892,6620,6584
8,13304,10,100,0.001,0.01,0.884,6668,6636
8,13404,10,100,0.001,0.01,0.896,6721,6683
8,13504,10,100,0.001,0.01,0.892,6774,6730
8,13604,10,100,0.001,0.01,0.896,6818,6786
8,13704,10,100,0.001,0.01,0.888,6852,6852
8,13804,10,100,0.001,0.01,0.906,6899,6905
8,13904,10,100,0.001,0.01,0.92,6952,6952
8,14004,10,100,0.001,0.01,0.916,6996,7008
8,14104,10,100,0.001,0.01,0.914,7047,7057
8,14204,10,100,0.001,0.01,0.904,7102,7102
8,14304,10,100,0.001,0.01,0.894,7151,7153
8,14404,10,100,0.001,0.01,0.89,7204,7200
8,14504,10,100,0.001,0.01,0.89,7258,7246
8,14604,10,100,0.001,0.01,0.914,7310,7294
8,14704,10,100,0.001,0.01,0.908,7352,7352
8,14804,10,100,0.001,0.01,0.896,7405,7399
8,14904,10,100,0.001,0.01,0.922,7453,7451
8,15004,10,100,0.001,0.01,0.922,7491,7513
9,104,10,100,0.001,0.01,0.494,49,55
9,204,10,100,0.001,0.01,0.508,103,101
9,304,10,100,0.001,0.01,0.524,149,155
9,404,10,100,0.001,0.01,0.492,195,209
9,504,10,100,0.001,0.01,0.502,249,255
9,604,10,100,0.001,0.01,0.514,302,302
9,704,10,100,0.001,0.01,0.518,353,351
9,804,10,100,0.001,0.01,0.56,392,412
9,904,10,100,0.001,0.01,0.548,441,463
9,1004,10,100,0.001,0.01,0.544,484,520
9,1104,10,100,0.001,0.01,0.526,538,566
9,1204,10,100,0.001,0.01,0.562,589,615
9,1304,10,100,0.001,0.01,0.546,643,661
9,1404,10,100,0.001,0.01,0.554,695,709
9,1504,10,100,0.001,0.01,0.57,735,769
9,1604,10,100,0.001,0.01,0.532,781,823
9,1704,10,100,0.001,0.01,0.586,832,872
9,1804,10,100,0.001,0.01,0.642,885,919
9,1904,10,100,0.001,0.01,0.698,943,961
9,2004,10,100,0.001,0.01,0.706,992,1012
9,2104,10,100,0.001,0.01,0.716,1039,1065
9,2204,10,100,0.001,0.01,0.782,1088,1116
9,2304,10,100,0.001,0.01,0.77,1138,1166
9,2404,10,100,0.001,0.01,0.736,1192,1212
9,2504,10,100,0.001,0.01,0.79,1247,1257
9,2604,10,100,0.001,0.01,0.782,1302,1302
9,2704,10,100,0.001,0.01,0.798,1354,1350
9,2804,10,100,0.001,0.01,0.808,1405,1399
9,2904,10,100,0.001,0.01,0.832,1455,1449
9,3004,10,100,0.001,0.01,0.806,1507,1497
9,3104,10,100,0.001,0.01,0.832,1561,1543
9,3204,10,100,0.001,0.01,0.826,1609,1595
9,3304,10,100,0.001,0.01,0.814,1660,1644
9,3404,10,100,0.001,0.01,0.826,1707,1697
9,3504,10,100,0.001,0.01,0.84,1750,1754
9,3604,10,100,0.001,0.01,0.802,1803,1801
9,3704,10,100,0.001,0.01,0.842,1845,1859
9,3804,10,100,0.001,0.01,0.844,1893,1911
9,3904,10,100,0.001,0.01,0.834,1938,1966
9,4004,10,100,0.001,0.01,0.842,1988,2016
9,4104,10,100,0.001,0.01,0.85,2038,2066
9,4204,10,100,0.001,0.01,0.864,2085,2119
9,4304,10,100,0.001,0.01,0.862,2140,2164
9,4404,10,100,0.001,0.01,0.832,2188,2216
9,4504,10,100,0.001,0.01,0.864,2231,2273
9,4604,10,100,0.001,0.01,0.878,2279,2325
9,4704,10,100,0.001,0.01,0.856,2332,2372
9,4804,10,100,0.001,0.01,0.836,2380,2424
9,4904,10,100,0.001,0.01,0.83,2429,2475
9,5004,10,100,0.001,0.01,0.846,2475,2529
9,5104,10,100,0.001,0.01,0.86,2521,2583
9,5204,10,100,0.001,0.01,0.828,2572,2632
9,5304,10,100,0.001,0.01,0.84,2627,2677
9,5404,10,100,0.001,0.01,0.842,2678,2726
9,5504,10,100,0.001,0.01,0.86,2729,2775
9,5604,10,100,0.001,0.01,0.848,2778,2826
9,5704,10,100,0.001,0.01,0.87,2841,2863
9,5804,10,100,0.001,0.01,0.866,2895,2909
9,5904,10,100,0.001,0.01,0.884,2945,2959
9,6004,10,100,0.001,0.01,0.88,3002,3002
9,6104,10,100,0.001,0.01,0.898,3052,3052
9,6204,10,100,0.001,0.01,0.894,3112,3092
9,6304,10,100,0.001,0.01,0.888,3164,3140
9,6404,10,100,0.001,0.01,0.854,3214,3190
9,6504,10,100,0.001,0.01,0.874,3277,3227
9,6604,10,100,0.001,0.01,0.892,3319,3285
9,6704,10,100,0.001,0.01,0.878,3377,3327
9,6804,10,100,0.001,0.01,0.892,3428,3376
9,6904,10,100,0.001,0.01,0.888,3474,3430
9,7004,10,100,0.001,0.01,0.884,3527,3477
9,7104,10,100,0.001,0.01,0.894,3566,3538
9,7204,10,100,0.001,0.01,0.904,3619,3585
9,7304,10,100,0.001,0.01,0.888,3670,3634
9,7404,10,100,0.001,0.01,0.86,3718,3686
9,7504,10,100,0.001,0.01,0.886,3768,3736
9,7604,10,100,0.001,0.01,0.902,3816,3788
9,7704,10,100,0.001,0.01,0.902,3869,3835
9,7804,10,100,0.001,0.01,0.894,3917,3887
9,7904,10,100,0.001,0.01,0.914,3972,3932
9,8004,10,100,0.001,0.01,0.92,4025,3979
9,8104,10,100,0.001,0.01,0.908,4081,4023
9,8204,10,100,0.001,0.01,0.9,4135,4069
9,8304,10,100,0.001,0.01,0.912,4173,4131
9,8404,10,100,0.001,0.01,0.872,4220,4184
9,8504,10,100,0.001,0.01,0.91,4268,4236
9,8604,10,100,0.001,0.01,0.908,4310,4294
9,8704,10,100,0.001,0.01,0.908,4355,4349
9,8804,10,100,0.001,0.01,0.912,4404,4400
9,8904,10,100,0.001,0.01,0.9,4446,4458
9,9004,10,100,0.001,0.01,0.894,4495,4509
9,9104,10,100,0.001,0.01,0.914,4545,4559
9,9204,10,100,0.001,0.01,0.9,4594,4610
9,9304,10,100,0.001,0.01,0.914,4645,4659
9,9404,10,100,0.001,0.01,0.912,4694,4710
9,9504,10,100,0.001,0.01,0.904,4742,4762
9,9604,10,100,0.001,0.01,0.868,4787,4817
9,9704,10,100,0.001,0.01,0.908,4836,4868
9,9804,10,100,0.001,0.01,0.836,4886,4918
9,9904,10,100,0.001,0.01,0.884,4934,4970
9,10004,10,100,0.001,0.01,0.904,4988,5016
9,10104,10,100,0.001,0.01,0.924,5044,5060
9,10204,10,100,0.001,0.01,0.918,5097,5107
9,10304,10,100,0.001,0.01,0.922,5150,5154
9,10404,10,100,0.001,0.01,0.904,5206,5198
9,10504,10,100,0.001,0.01,0.924,5254,5250
9,10604,10,100,0.001,0.01,0.914,5316,5288
9,10704,10,100,0.001,0.01,0.908,5363,5341
9,10804,10,100,0.001,0.01,0.908,5416,5388
9,10904,10,100,0.001,0.01,0.94,5461,5443
9,11004,10,100,0.001,0.01,0.924,5511,5493
9,11104,10,100,0.001,0.01,0.918,5555,5549
9,11204,10,100,0.001,0.01,0.9,5605,5599
9,11304,10,100,0.001,0.01,0.922,5657,5647
9,11404,10,100,0.001,0.01,0.946,5707,5697
9,11504,10,100,0.001,0.01,0.932,5753,5751
9,11604,10,100,0.001,0.01,0.946,5803,5801
9,11704,10,100,0.001,0.01,0.94,5852,5852
9,11804,10,100,0.001,0.01,0.93,5907,5897
9,11904,10,100,0.001,0.01,0.938,5958,5946
9,12004,10,100,0.001,0.01,0.946,6007,5997
9,12104,10,100,0.001,0.01,0.924,6051,6053
9,12204,10,100,0.001,0.01,0.93,6108,6096
9,12304,10,100,0.001,0.01,0.956,6156,6148
9,12404,10,100,0.001,0.01,0.932,6207,6197
9,12504,10,100,0.001,0.01,0.938,6257,6247
9,12604,10,100,0.001,0.01,0.952,6304,6300
9,12704,10,100,0.001,0.01,0.938,6356,6348
9,12804,10,100,0.001,0.01,0.932,6398,6406
9,12904,10,100,0.001,0.01,0.944,6454,6450
9,13004,10,100,0.001,0.01,0.944,6496,6508
9,13104,10,100,0.001,0.01,0.946,6539,6565
9,13204,10,100,0.001,0.01,0.932,6590,6614
9,13304,10,100,0.001,0.01,0.944,6641,6663
9,13404,10,100,0.001,0.01,0.95,6685,6719
9,13504,10,100,0.001,0.01,0.944,6729,6775
9,13604,10,100,0.001,0.01,0.946,6787,6817
9,13704,10,100,0.001,0.01,0.952,6835,6869
9,13804,10,100,0.001,0.01,0.954,6891,6913
9,13904,10,100,0.001,0.01,0.944,6940,6964
9,14004,10,100,0.001,0.01,0.944,6996,7008
9,14104,10,100,0.001,0.01,0.946,7054,7050
9,14204,10,100,0.001,0.01,0.952,7100,7104
9,14304,10,100,0.001,0.01,0.954,7148,7156
9,14404,10,100,0.001,0.01,0.91,7200,7204
9,14504,10,100,0.001,0.01,0.95,7255,7249
9,14604,10,100,0.001,0.01,0.952,7313,7291
9,14704,10,100,0.001,0.01,0.946,7368,7336
9,14804,10,100,0.001,0.01,0.96,7405,7399
9,14904,10,100,0.001,0.01,0.95,7452,7452
9,15004,10,100,0.001,0.01,0.938,7499,7505
10,104,10,100,0.001,0.01,0.514,51,53
10,204,10,100,0.001,0.01,0.504,103,101
10,304,10,100,0.001,0.01,0.524,144,160
10,404,10,100,0.001,0.01,0.482,186,218
10,504,10,100,0.001,0.01,0.5,238,266
10,604,10,100,0.001,0.01,0.536,279,325
10,704,10,100,0.001,0.01,0.546,327,377
10,804,10,100,0.001,0.01,0.53,378,426
10,904,10,100,0.001,0.01,0.544,423,481
10,1004,10,100,0.001,0.01,0.55,472,532
10,1104,10,100,0.001,0.01,0.542,527,577
10,1204,10,100,0.001,0.01,0.542,577,627
10,1304,10,100,0.001,0.01,0.554,615,689
10,1404,10,100,0.001,0.01,0.56,674,730
10,1504,10,100,0.001,0.01,0.554,722,782
10,1604,10,100,0.001,0.01,0.568,770,834
10,1704,10,100,0.001,0.01,0.562,815,889
10,1804,10,100,0.001,0.01,0.594,863,941
10,1904,10,100,0.001,0.01,0.534,915,989
10,2004,10,100,0.001,0.01,0.58,968,1036
10,2104,10,100,0.001,0.01,0.546,1024,1080
10,2204,10,100,0.001,0.01,0.574,1074,1130
10,2304,10,100,0.001,0.01,0.59,1122,1182
10,2404,10,100,0.001,0.01,0.616,1173,1231
10,2504,10,100,0.001,0.01,0.666,1225,1279
10,2604,10,100,0.001,0.01,0.714,1281,1323
10,2704,10,100,0.001,0.01,0.71,1333,1371
10,2804,10,100,0.001,0.01,0.716,1398,1406
10,2904,10,100,0.001,0.01,0.784,1451,1453
10,3004,10,100,0.001,0.01,0.792,1501,1503
10,3104,10,100,0.001,0.01,0.832,1541,1563
10,3204,10,100,0.001,0.01,0.804,1601,1603
10,3304,10,100,0.001,0.01,0.82,1658,1646
10,3404,10,100,0.001,0.01,0.864,1707,1697
10,3504,10,100,0.001,0.01,0.844,1763,1741
10,3604,10,100,0.001,0.01,0.866,1809,1795
10,3704,10,100,0.001,0.01,0.862,1859,1845
10,3804,10,100,0.001,0.01,0.886,1898,1906
10,3904,10,100,0.001,0.01,0.882,1943,1961
10,4004,10,100,0.001,0.01,0.856,1991,2013
10,4104,10,100,0.001,0.01,0.884,2043,2061
10,4204,10,100,0.001,0.01,0.874,2094,2110
10,4304,10,100,0.001,0.01,0.89,2146,2158
10,4404,10,100,0.001,0.01,0.856,2198,2206
10,4504,10,100,0.001,0.01,0.804,2253,2251
10,4604,10,100,0.001,0.01,0.9,2305,2299
10,4704,10,100,0.001,0.01,0.88,2350,2354
10,4804,10,100,0.001,0.01,0.892,2403,2401
10,4904,10,100,0.001,0.01,0.894,2451,2453
10,5004,10,100,0.001,0.01,0.908,2494,2510
10,5104,10,100,0.001,0.01,0.91,2538,2566
10,5204,10,100,0.001,0.01,0.904,2584,2620
10,5304,10,100,0.001,0.01,0.92,2628,2676
10,5404,10,100,0.001,0.01,0.914,2681,2723
10,5504,10,100,0.001,0.01,0.924,2744,2760
10,5604,10,100,0.001,0.01,0.838,2795,2809
10,5704,10,100,0.001,0.01,0.86,2838,2866
10,5804,10,100,0.001,0.01,0.88,2891,2913
10,5904,10,100,0.001,0.01,0.906,2950,2954
10,6004,10,100,0.001,0.01,0.9,2997,3007
10,6104,10,100,0.001,0.01,0.906,3048,3056
10,6204,10,100,0.001,0.01,0.87,3101,3103
10,6304,10,100,0.001,0.01,0.916,3152,3152
10,6404,10,100,0.001,0.01,0.916,3199,3205
10,6504,10,100,0.001,0.01,0.916,3256,3248
10,6604,10,100,0.001,0.01,0.922,3305,3299
10,6704,10,100,0.001,0.01,0.926,3355,3349
10,6804,10,100,0.001,0.01,0.92,3407,3397
10,6904,10,100,0.001,0.01,0.93,3451,3453
10,7004,10,100,0.001,0.01,0.942,3496,3508
10,7104,10,100,0.001,0.01,0.92,3540,3564
10,7204,10,100,0.001,0.01,0.928,3596,3608
10,7304,10,100,0.001,0.01,0.924,3650,3654
10,7404,10,100,0.001,0.01,0.918,3690,3714
10,7504,10,100,0.001,0.01,0.922,3744,3760
10,7604,10,100,0.001,0.01,0.92,3791,3813
10,7704,10,100,0.001,0.01,0.934,3839,3865
10,7804,10,100,0.001,0.01,0.946,3881,3923
10,7904,10,100,0.001,0.01,0.926,3933,3971
10,8004,10,100,0.001,0.01,0.952,3989,4015
10,8104,10,100,0.001,0.01,0.938,4035,4069
10,8204,10,100,0.001,0.01,0.906,4085,4119
10,8304,10,100,0.001,0.01,0.944,4133,4171
10,8404,10,100,0.001,0.01,0.918,4185,4219
10,8504,10,100,0.001,0.01,0.944,4235,4269
10,8604,10,100,0.001,0.01,0.928,4283,4321
10,8704,10,100,0.001,0.01,0.944,4327,4377
10,8804,10,100,0.001,0.01,0.948,4371,4433
10,8904,10,100,0.001,0.01,0.96,4423,4481
10,9004,10,100,0.001,0.01,0.938,4466,4538
10,9104,10,100,0.001,0.01,0.956,4520,4584
10,9204,10,100,0.001,0.01,0.952,4563,4641
10,9304,10,100,0.001,0.01,0.952,4618,4686
10,9404,10,100,0.001,0.01,0.964,4672,4732
10,9504,10,100,0.001,0.01,0.954,4725,4779
10,9604,10,100,0.001,0.01,0.964,4770,4834
10,9704,10,100,0.001,0.01,0.95,4814,4890
10,9804,10,100,0.001,0.01,0.94,4859,4945
10,9904,10,100,0.001,0.01,0.948,4913,4991
10,10004,10,100,0.001,0.01,0.952,4960,5044
10,10104,10,100,0.001,0.01,0.958,5009,5095
10,10204,10,100,0.001,0.01,0.966,5065,5139
10,10304,10,100,0.001,0.01,0.97,5120,5184
10,10404,10,100,0.001,0.01,0.96,5174,5230
10,10504,10,100,0.001,0.01,0.964,5217,5287
10,10604,10,100,0.001,0.01,0.964,5269,5335
10,10704,10,100,0.001,0.01,0.964,5321,5383
10,10804,10,100,0.001,0.01,0.96,5372,5432
10,10904,10,100,0.001,0.01,0.974,5425,5479
10,11004,10,100,0.001,0.01,0.964,5466,5538
10,11104,10,100,0.001,0.01,0.958,5510,5594
10,11204,10,100,0.001,0.01,0.958,5567,5637
10,11304,10,100,0.001,0.01,0.972,5614,5690
10,11404,10,100,0.001,0.01,0.952,5662,5742
10,11504,10,100,0.001,0.01,0.972,5705,5799
10,11604,10,100,0.001,0.01,0.968,5750,5854
10,11704,10,100,0.001,0.01,0.972,5805,5899
10,11804,10,100,0.001,0.01,0.97,5855,5949
10,11904,10,100,0.001,0.01,0.97,5906,5998
10,12004,10,100,0.001,0.01,0.976,5958,6046
10,12104,10,100,0.001,0.01,0.978,6008,6096
10,12204,10,100,0.001,0.01,0.914,6049,6155
10,12304,10,100,0.001,0.01,0.95,6107,6197
10,12404,10,100,0.001,0.01,0.98,6159,6245
10,12504,10,100,0.001,0.01,0.988,6205,6299
10,12604,10,100,0.001,0.01,0.982,6252,6352
10,12704,10,100,0.001,0.01,0.98,6309,6395
10,12804,10,100,0.001,0.01,0.986,6359,6445
10,12904,10,100,0.001,0.01,0.992,6411,6493
10,13004,10,100,0.001,0.01,0.978,6460,6544
10,13104,10,100,0.001,0.01,0.976,6509,6595
10,13204,10,100,0.001,0.01,0.986,6571,6633
10,13304,10,100,0.001,0.01,0.99,6622,6682
10,13404,10,100,0.001,0.01,0.99,6676,6728
10,13504,10,100,0.001,0.01,0.986,6736,6768
10,13604,10,100,0.001,0.01,0.94,6784,6820
10,13704,10,100,0.001,0.01,0.962,6842,6862
10,13804,10,100,0.001,0.01,0.992,6894,6910
10,13904,10,100,0.001,0.01,0.99,6942,6962
10,14004,10,100,0.001,0.01,0.99,6990,7014
10,14104,10,100,0.001,0.01,0.994,7041,7063
10,14204,10,100,0.001,0.01,0.974,7094,7110
10,14304,10,100,0.001,0.01,0.97,7144,7160
10,14404,10,100,0.001,0.01,0.964,7191,7213
10,14504,10,100,0.001,0.01,0.982,7241,7263
10,14604,10,100,0.001,0.01,0.982,7290,7314
10,14704,10,100,0.001,0.01,0.98,7340,7364
10,14804,10,100,0.001,0.01,0.982,7397,7407
10,14904,10,100,0.001,0.01,0.988,7443,7461
10,15004,10,100,0.001,0.01,0.992,7505,7499
11,104,10,100,0.001,0.01,0.486,57,47
11,204,10,100,0.001,0.01,0.476,112,92
11,304,10,100,0.001,0.01,0.494,167,137
11,404,10,100,0.001,0.01,0.528,218,186
11,504,10,100,0.001,0.01,0.508,267,237
11,604,10,100,0.001,0.01,0.532,311,293
11,704,10,100,0.001,0.01,0.522,368,336
11,804,10,100,0.001,0.01,0.468,417,387
11,904,10,100,0.001,0.01,0.484,482,422
11,1004,10,100,0.001,0.01,0.494,543,461
11,1104,10,100,0.001,0.01,0.548,594,510
11,1204,10,100,0.001,0.01,0.568,651,553
11,1304,10,100,0.001,0.01,0.536,701,603
11,1404,10,100,0.001,0.01,0.552,740,664
11,1504,10,100,0.001,0.01,0.528,789,715
11,1604,10,100,0.001,0.01,0.592,839,765
11,1704,10,100,0.001,0.01,0.628,892,812
11,1804,10,100,0.001,0.01,0.6,939,865
11,1904,10,100,0.001,0.01,0.652,993,911
11,2004,10,100,0.001,0.01,0.666,1042,962
11,2104,10,100,0.001,0.01,0.626,1096,1008
11,2204,10,100,0.001,0.01,0.692,1146,1058
11,2304,10,100,0.001,0.01,0.654,1194,1110
11,2404,10,100,0.001,0.01,0.702,1243,1161
11,2504,10,100,0.001,0.01,0.708,1289,1215
11,2604,10,100,0.001,0.01,0.686,1338,1266
11,2704,10,100,0.001,0.01,0.726,1389,1315
11,2804,10,100,0.001,0.01,0.73,1435,1369
11,2904,10,100,0.001,0.01,0.728,1477,1427
11,3004,10,100,0.001,0.01,0.724,1526,1478
11,3104,10,100,0.001,0.01,0.754,1579,1525
11,3204,10,100,0.001,0.01,0.742,1628,1576
11,3304,10,100,0.001,0.01,0.694,1673,1631
11,3404,10,100,0.001,0.01,0.694,1723,1681
11,3504,10,100,0.001,0.01,0.74,1774,1730
11,3604,10,100,0.001,0.01,0.742,1832,1772
11,3704,10,100,0.001,0.01,0.762,1874,1830
11,3804,10,100,0.001,0.01,0.758,1920,1884
11,3904,10,100,0.001,0.01,0.738,1963,1941
11,4004,10,100,0.001,0.01,0.708,2014,1990
11,4104,10,100,0.001,0.01,0.752,2068,2036
11,4204,10,100,0.001,0.01,0.774,2120,2084
11,4304,10,100,0.001,0.01,0.768,2164,2140
11,4404,10,100,0.001,0.01,0.792,2216,2188
11,4504,10,100,0.001,0.01,0.786,2263,2241
11,4604,10,100,0.001,0.01,0.774,2318,2286
11,4704,10,100,0.001,0.01,0.78,2372,2332
11,4804,10,100,0.001,0.01,0.744,2424,2380
11,4904,10,100,0.001,0.01,0.786,2481,2423
11,5004,10,100,0.001,0.01,0.778,2527,2477
11,5104,10,100,0.001,0.01,0.768,2580,2524
11,5204,10,100,0.001,0.01,0.77,2627,2577
11,5304,10,100,0.001,0.01,0.744,2677,2627
11,5404,10,100,0.001,0.01,0.746,2726,2678
11,5504,10,100,0.001,0.01,0.782,2775,2729
11,5604,10,100,0.001,0.01,0.798,2822,2782
11,5704,10,100,0.001,0.01,0.8,2868,2836
11,5804,10,100,0.001,0.01,0.792,2924,2880
11,5904,10,100,0.001,0.01,0.776,2976,2928
11,6004,10,100,0.001,0.01,0.786,3028,2976
11,6104,10,100,0.001,0.01,0.8,3089,3015
11,6204,10,100,0.001,0.01,0.816,3148,3056
11,6304,10,100,0.001,0.01,0.816,3194,3110
11,6404,10,100,0.001,0.01,0.78,3248,3156
11,6504,10,100,0.001,0.01,0.808,3300,3204
11,6604,10,100,0.001,0.01,0.774,3352,3252
11,6704,10,100,0.001,0.01,0.822,3394,3310
11,6804,10,100,0.001,0.01,0.79,3438,3366
11,6904,10,100,0.001,0.01,0.806,3485,3419
11,7004,10,100,0.001,0.01,0.822,3534,3470
11,7104,10,100,0.001,0.01,0.812,3582,3522
11,7204,10,100,0.001,0.01,0.83,3632,3572
11,7304,10,100,0.001,0.01,0.822,3685,3619
11,7404,10,100,0.001,0.01,0.804,3737,3667
11,7504,10,100,0.001,0.01,0.81,3781,3723
11,7604,10,100,0.001,0.01,0.828,3833,3771
11,7704,10,100,0.001,0.01,0.81,3891,3813
11,7804,10,100,0.001,0.01,0.834,3937,3867
11,7904,10,100,0.001,0.01,0.806,3987,3917
11,8004,10,100,0.001,0.01,0.838,4044,3960
11,8104,10,100,0.001,0.01,0.828,4088,4016
11,8204,10,100,0.001,0.01,0.81,4128,4076
11,8304,10,100,0.001,0.01,0.81,4174,4130
11,8404,10,100,0.001,0.01,0.824,4226,4178
11,8504,10,100,0.001,0.01,0.856,4266,4238
11,8604,10,100,0.001,0.01,0.822,4320,4284
11,8704,10,100,0.001,0.01,0.872,4369,4335
11,8804,10,100,0.001,0.01,0.844,4425,4379
11,8904,10,100,0.001,0.01,0.832,4473,4431
11,9004,10,100,0.001,0.01,0.852,4519,4485
11,9104,10,100,0.001,0.01,0.858,4563,4541
11,9204,10,100,0.001,0.01,0.87,4611,4593
11,9304,10,100,0.001,0.01,0.876,4653,4651
11,9404,10,100,0.001,0.01,0.868,4704,4700
11,9504,10,100,0.001,0.01,0.892,4760,4744
11,9604,10,100,0.001,0.01,0.868,4813,4791
11,9704,10,100,0.001,0.01,0.8,4865,4839
11,9804,10,100,0.001,0.01,0.878,4901,4903
11,9904,10,100,0.001,0.01,0.858,4954,4950
11,10004,10,100,0.001,0.01,0.872,5007,4997
11,10104,10,100,0.001,0.01,0.88,5057,5047
11,10204,10,100,0.001,0.01,0.87,5111,5093
11,10304,10,100,0.001,0.01,0.874,5156,5148
11,10404,10,100,0.001,0.01,0.898,5217,5187
11,10504,10,100,0.001,0.01,0.902,5269,5235
11,10604,10,100,0.001,0.01,0.886,5325,5279
11,10704,10,100,0.001,0.01,0.9,5377,5327
11,10804,10,100,0.001,0.01,0.884,5429,5375
11,10904,10,100,0.001,0.01,0.856,5477,5427
11,11004,10,100,0.001,0.01,0.914,5527,5477
11,11104,10,100,0.001,0.01,0.906,5571,5533
11,11204,10,100,0.001,0.01,0.906,5625,5579
11,11304,10,100,0.001,0.01,0.888,5675,5629
11,11404,10,100,0.001,0.01,0.858,5719,5685
11,11504,10,100,0.001,0.01,0.902,5769,5735
11,11604,10,100,0.001,0.01,0.918,5814,5790
11,11704,10,100,0.001,0.01,0.898,5869,5835
11,11804,10,100,0.001,0.01,0.906,5927,5877
11,11904,10,100,0.001,0.01,0.91,5977,5927
11,12004,10,100,0.001,0.01,0.92,6028,5976
11,12104,10,100,0.001,0.01,0.92,6077,6027
11,12204,10,100,0.001,0.01,0.924,6128,6076
11,12304,10,100,0.001,0.01,0.91,6174,6130
11,12404,10,100,0.001,0.01,0.904,6222,6182
11,12504,10,100,0.001,0.01,0.938,6271,6233
11,12604,10,100,0.001,0.01,0.928,6327,6277
11,12704,10,100,0.001,0.01,0.924,6376,6328
11,12804,10,100,0.001,0.01,0.922,6431,6373
11,12904,10,100,0.001,0.01,0.934,6471,6433
11,13004,10,100,0.001,0.01,0.934,6528,6476
11,13104,10,100,0.001,0.01,0.922,6574,6530
11,13204,10,100,0.001,0.01,0.916,6625,6579
11,13304,10,100,0.001,0.01,0.934,6680,6624
11,13404,10,100,0.001,0.01,0.932,6725,6679
11,13504,10,100,0.001,0.01,0.936,6772,6732
11,13604,10,100,0.001,0.01,0.956,6824,6780
11,13704,10,100,0.001,0.01,0.94,6868,6836
11,13804,10,100,0.001,0.01,0.928,6915,6889
11,13904,10,100,0.001,0.01,0.954,6960,6944
11,14004,10,100,0.001,0.01,0.942,7002,7002
11,14104,10,100,0.001,0.01,0.948,7049,7055
11,14204,10,100,0.001,0.01,0.926,7103,7101
11,14304,10,100,0.001,0.01,0.962,7153,7151
11,14404,10,100,0.001,0.01,0.928,7211,7193
11,14504,10,100,0.001,0.01,0.954,7265,7239
11,14604,10,100,0.001,0.01,0.962,7320,7284
11,14704,10,100,0.001,0.01,0.95,7372,7332
11,14804,10,100,0.001,0.01,0.946,7421,7383
11,14904,10,100,0.001,0.01,0.95,7466,7438
11,15004,10,100,0.001,0.01,0.956,7509,7495
12,104,10,100,0.001,0.01,0.536,44,60
12,204,10,100,0.001,0.01,0.476,93,111
12,304,10,100,0.001,0.01,0.5,138,166
12,404,10,100,0.001,0.01,0.516,198,206
12,504,10,100,0.001,0.01,0.488,256,248
12,604,10,100,0.001,0.01,0.492,304,300
12,704,10,100,0.001,0.01,0.554,350,354
12,804,10,100,0.001,0.01,0.534,399,405
12,904,10,100,0.001,0.01,0.524,448,456
12,1004,10,100,0.001,0.01,0.476,497,507
12,1104,10,100,0.001,0.01,0.492,556,548
12,1204,10,100,0.001,0.01,0.51,605,599
12,1304,10,100,0.001,0.01,0.492,649,655
12,1404,10,100,0.001,0.01,0.494,707,697
12,1504,10,100,0.001,0.01,0.478,755,749
12,1604,10,100,0.001,0.01,0.534,808,796
12,1704,10,100,0.001,0.01,0.498,855,849
12,1804,10,100,0.001,0.01,0.524,910,894
12,1904,10,100,0.001,0.01,0.49,961,943
12,2004,10,100,0.001,0.01,0.528,1005,999
12,2104,10,100,0.001,0.01,0.514,1058,1046
12,2204,10,100,0.001,0.01,0.546,1102,1102
12,2304,10,100,0.001,0.01,0.564,1150,1154
12,2404,10,100,0.001,0.01,0.58,1202,1202
12,2504,10,100,0.001,0.01,0.582,1258,1246
12,2604,10,100,0.001,0.01,0.634,1303,1301
12,2704,10,100,0.001,0.01,0.68,1341,1363
12,2804,10,100,0.001,0.01,0.672,1390,1414
12,2904,10,100,0.001,0.01,0.686,1437,1467
12,3004,10,100,0.001,0.01,0.718,1484,1520
12,3104,10,100,0.001,0.01,0.722,1539,1565
12,3204,10,100,0.001,0.01,0.73,1596,1608
12,3304,10,100,0.001,0.01,0.752,1643,1661
12,3404,10,100,0.001,0.01,0.782,1695,1709
12,3504,10,100,0.001,0.01,0.764,1738,1766
12,3604,10,100,0.001,0.01,0.818,1784,1820
12,3704,10,100,0.001,0.01,0.82,1842,1862
12,3804,10,100,0.001,0.01,0.83,1886,1918
12,3904,10,100,0.001,0.01,0.824,1940,1964
12,4004,10,100,0.001,0.01,0.846,1985,2019
12,4104,10,100,0.001,0.01,0.864,2040,2064
12,4204,10,100,0.001,0.01,0.864,2092,2112
12,4304,10,100,0.001,0.01,0.834,2143,2161
12,4404,10,100,0.001,0.01,0.846,2191,2213
12,4504,10,100,0.001,0.01,0.854,2246,2258
12,4604,10,100,0.001,0.01,0.872,2295,2309
12,4704,10,100,0.001,0.01,0.856,2341,2363
12,4804,10,100,0.001,0.01,0.882,2396,2408
12,4904,10,100,0.001,0.01,0.862,2454,2450
12,5004,10,100,0.001,0.01,0.86,2498,2506
12,5104,10,100,0.001,0.01,0.872,2540,2564
12,5204,10,100,0.001,0.01,0.896,2586,2618
12,5304,10,100,0.001,0.01,0.88,2635,2669
12,5404,10,100,0.001,0.01,0.886,2684,2720
12,5504,10,100,0.001,0.01,0.888,2735,2769
12,5604,10,100,0.001,0.01,0.856,2783,2821
12,5704,10,100,0.001,0.01,0.89,2833,2871
12,5804,10,100,0.001,0.01,0.894,2878,2926
12,5904,10,100,0.001,0.01,0.864,2928,2976
12,6004,10,100,0.001,0.01,0.888,2973,3031
12,6104,10,100,0.001,0.01,0.892,3024,3080
12,6204,10,100,0.001,0.01,0.882,3074,3130
12,6304,10,100,0.001,0.01,0.892,3123,3181
12,6404,10,100,0.001,0.01,0.894,3173,3231
12,6504,10,100,0.001,0.01,0.898,3216,3288
12,6604,10,100,0.001,0.01,0.88,3271,3333
12,6704,10,100,0.001,0.01,0.908,3313,3391
12,6804,10,100,0.001,0.01,0.896,3363,3441
12,6904,10,100,0.001,0.01,0.914,3415,3489
12,7004,10,100,0.001,0.01,0.922,3468,3536
12,7104,10,100,0.001,0.01,0.904,3524,3580
12,7204,10,100,0.001,0.01,0.914,3567,3637
12,7304,10,100,0.001,0.01,0.9,3619,3685
12,7404,10,100,0.001,0.01,0.908,3666,3738
12,7504,10,100,0.001,0.01,0.906,3716,3788
12,7604,10,100,0.001,0.01,0.91,3772,3832
12,7704,10,100,0.001,0.01,0.916,3820,3884
12,7804,10,100,0.001,0.01,0.926,3875,3929
12,7904,10,100,0.001,0.01,0.908,3923,3981
12,8004,10,100,0.001,0.01,0.908,3967,4037
12,8104,10,100,0.001,0.01,0.918,4014,4090
12,8204,10,100,0.001,0.01,0.926,4061,4143
12,8304,10,100,0.001,0.01,0.928,4108,4196
12,8404,10,100,0.001,0.01,0.876,4157,4247
12,8504,10,100,0.001,0.01,0.894,4208,4296
12,8604,10,100,0.001,0.01,0.902,4265,4339
12,8704,10,100,0.001,0.01,0.906,4317,4387
12,8804,10,100,0.001,0.01,0.908,4366,4438
12,8904,10,100,0.001,0.01,0.916,4417,4487
12,9004,10,100,0.001,0.01,0.924,4472,4532
12,9104,10,100,0.001,0.01,0.918,4519,4585
12,9204,10,100,0.001,0.01,0.92,4572,4632
12,9304,10,100,0.001,0.01,0.924,4626,4678
12,9404,10,100,0.001,0.01,0.916,4685,4719
12,9504,10,100,0.001,0.01,0.908,4727,4777
12,9604,10,100,0.001,0.01,0.918,4778,4826
12,9704,10,100,0.001,0.01,0.918,4832,4872
12,9804,10,100,0.001,0.01,0.918,4887,4917
12,9904,10,100,0.001,0.01,0.912,4936,4968
12,10004,10,100,0.001,0.01,0.94,4995,5009
12,10104,10,100,0.001,0.01,0.942,5042,5062
12,10204,10,100,0.001,0.01,0.936,5090,5114
12,10304,10,100,0.001,0.01,0.934,5138,5166
12,10404,10,100,0.001,0.01,0.922,5193,5211
12,10504,10,100,0.001,0.01,0.932,5246,5258
12,10604,10,100,0.001,0.01,0.924,5294,5310
12,10704,10,100,0.001,0.01,0.93,5342,5362
12,10804,10,100,0.001,0.01,0.936,5389,5415
12,10904,10,100,0.001,0.01,0.936,5439,5465
12,11004,10,100,0.001,0.01,0.874,5498,5506
12,11104,10,100,0.001,0.01,0.906,5555,5549
12,11204,10,100,0.001,0.01,0.906,5608,5596
12,11304,10,100,0.001,0.01,0.916,5645,5659
12,11404,10,100,0.001,0.01,0.916,5707,5697
12,11504,10,100,0.001,0.01,0.932,5757,5747
12,11604,10,100,0.001,0.01,0.948,5810,5794
12,11704,10,100,0.001,0.01,0.938,5859,5845
12,11804,10,100,0.001,0.01,0.934,5910,5894
12,11904,10,100,0.001,0.01,0.934,5954,5950
12,12004,10,100,0.001,0.01,0.932,6013,5991
12,12104,10,100,0.001,0.01,0.926,6054,6050
12,12204,10,100,0.001,0.01,0.942,6106,6098
12,12304,10,100,0.001,0.01,0.928,6159,6145
12,12404,10,100,0.001,0.01,0.932,6213,6191
12,12504,10,100,0.001,0.01,0.926,6264,6240
12,12604,10,100,0.001,0.01,0.934,6310,6294
12,12704,10,100,0.001,0.01,0.934,6366,6338
12,12804,10,100,0.001,0.01,0.94,6410,6394
12,12904,10,100,0.001,0.01,0.936,6460,6444
12,13004,10,100,0.001,0.01,0.944,6505,6499
12,13104,10,100,0.001,0.01,0.94,6560,6544
12,13204,10,100,0.001,0.01,0.93,6598,6606
12,13304,10,100,0.001,0.01,0.918,6656,6648
12,13404,10,100,0.001,0.01,0.93,6704,6700
12,13504,10,100,0.001,0.01,0.936,6751,6753
12,13604,10,100,0.001,0.01,0.934,6804,6800
12,13704,10,100,0.001,0.01,0.932,6856,6848
12,13804,10,100,0.001,0.01,0.942,6908,6896
12,13904,10,100,0.001,0.01,0.934,6958,6946
12,14004,10,100,0.001,0.01,0.926,7003,7001
12,14104,10,100,0.001,0.01,0.944,7055,7049
12,14204,10,100,0.001,0.01,0.948,7102,7102
12,14304,10,100,0.001,0.01,0.936,7141,7163
12,14404,10,100,0.001,0.01,0.94,7192,7212
12,14504,10,100,0.001,0.01,0.948,7247,7257
12,14604,10,100,0.001,0.01,0.944,7289,7315
12,14704,10,100,0.001,0.01,0.946,7338,7366
12,14804,10,100,0.001,0.01,0.944,7392,7412
12,14904,10,100,0.001,0.01,0.944,7439,7465
12,15004,10,100,0.001,0.01,0.928,7490,7514
13,104,10,100,0.001,0.01,0.478,47,57
13,204,10,100,0.001,0.01,0.478,102,102
13,304,10,100,0.001,0.01,0.546,150,154
13,404,10,100,0.001,0.01,0.516,196,208
13,504,10,100,0.001,0.01,0.504,246,258
13,604,10,100,0.001,0.01,0.47,295,309
13,704,10,100,0.001,0.01,0.492,345,359
13,804,10,100,0.001,0.01,0.506,406,398
13,904,10,100,0.001,0.01,0.5,466,438
13,1004,10,100,0.001,0.01,0.478,516,488
13,1104,10,100,0.001,0.01,0.492,576,528
13,1204,10,100,0.001,0.01,0.504,630,574
13,1304,10,100,0.001,0.01,0.548,685,619
13,1404,10,100,0.001,0.01,0.502,737,667
13,1504,10,100,0.001,0.01,0.498,785,719
13,1604,10,100,0.001,0.01,0.514,832,772
13,1704,10,100,0.001,0.01,0.52,880,824
13,1804,10,100,0.001,0.01,0.588,935,869
13,1904,10,100,0.001,0.01,0.57,988,916
13,2004,10,100,0.001,0.01,0.586,1034,970
13,2104,10,100,0.001,0.01,0.608,1083,1021
13,2204,10,100,0.001,0.01,0.614,1135,1069
13,2304,10,100,0.001,0.01,0.63,1186,1118
13,2404,10,100,0.001,0.01,0.634,1235,1169
13,2504,10,100,0.001,0.01,0.588,1287,1217
13,2604,10,100,0.001,0.01,0.638,1336,1268
13,2704,10,100,0.001,0.01,0.612,1386,1318
13,2804,10,100,0.001,0.01,0.61,1436,1368
13,2904,10,100,0.001,0.01,0.636,1481,1423
13,3004,10,100,0.001,0.01,0.632,1528,1476
13,3104,10,100,0.001,0.01,0.636,1582,1522
13,3204,10,100,0.001,0.01,0.646,1633,1571
13,3304,10,100,0.001,0.01,0.65,1683,1621
13,3404,10,100,0.001,0.01,0.666,1733,1671
13,3504,10,100,0.001,0.01,0.684,1785,1719
13,3604,10,100,0.001,0.01,0.664,1843,1761
13,3704,10,100,0.001,0.01,0.692,1890,1814
13,3804,10,100,0.001,0.01,0.664,1941,1863
13,3904,10,100,0.001,0.01,0.698,1989,1915
13,4004,10,100,0.001,0.01,0.664,2044,1960
13,4104,10,100,0.001,0.01,0.674,2093,2011
13,4204,10,100,0.001,0.01,0.676,2131,2073
13,4304,10,100,0.001,0.01,0.702,2182,2122
13,4404,10,100,0.001,0.01,0.696,2221,2183
13,4504,10,100,0.001,0.01,0.684,2273,2231
13,4604,10,100,0.001,0.01,0.676,2321,2283
13,4704,10,100,0.001,0.01,0.702,2365,2339
13,4804,10,100,0.001,0.01,0.692,2419,2385
13,4904,10,100,0.001,0.01,0.71,2462,2442
13,5004,10,100,0.001,0.01,0.676,2508,2496
13,5104,10,100,0.001,0.01,0.68,2558,2546
13,5204,10,100,0.001,0.01,0.694,2611,2593
13,5304,10,100,0.001,0.01,0.698,2664,2640
13,5404,10,100,0.001,0.01,0.718,2721,2683
13,5504,10,100,0.001,0.01,0.704,2767,2737
13,5604,10,100,0.001,0.01,0.72,2817,2787
13,5704,10,100,0.001,0.01,0.688,2871,2833
13,5804,10,100,0.001,0.01,0.708,2926,2878
13,5904,10,100,0.001,0.01,0.708,2983,2921
13,6004,10,100,0.001,0.01,0.722,3031,2973
13,6104,10,100,0.001,0.01,0.718,3074,3030
13,6204,10,100,0.001,0.01,0.724,3129,3075
13,6304,10,100,0.001,0.01,0.704,3179,3125
13,6404,10,100,0.001,0.01,0.708,3241,3163
13,6504,10,100,0.001,0.01,0.732,3292,3212
13,6604,10,100,0.001,0.01,0.688,3341,3263
13,6704,10,100,0.001,0.01,0.736,3385,3319
13,6804,10,100,0.001,0.01,0.734,3439,3365
13,6904,10,100,0.001,0.01,0.74,3489,3415
13,7004,10,100,0.001,0.01,0.728,3538,3466
13,7104,10,100,0.001,0.01,0.738,3585,3519
13,7204,10,100,0.001,0.01,0.762,3642,3562
13,7304,10,100,0.001,0.01,0.74,3690,3614
13,7404,10,100,0.001,0.01,0.742,3738,3666
13,7504,10,100,0.001,0.01,0.762,3784,3720
13,7604,10,100,0.001,0.01,0.742,3836,3768
13,7704,10,100,0.001,0.01,0.762,3880,3824
13,7804,10,100,0.001,0.01,0.74,3922,3882
13,7904,10,100,0.001,0.01,0.722,3969,3935
13,8004,10,100,0.001,0.01,0.748,4019,3985
13,8104,10,100,0.001,0.01,0.742,4073,4031
13,8204,10,100,0.001,0.01,0.746,4126,4078
13,8304,10,100,0.001,0.01,0.772,4171,4133
13,8404,10,100,0.001,0.01,0.746,4223,4181
13,8504,10,100,0.001,0.01,0.758,4275,4229
13,8604,10,100,0.001,0.01,0.778,4322,4282
13,8704,10,100,0.001,0.01,0.762,4362,4342
13,8804,10,100,0.001,0.01,0.772,4405,4399
13,8904,10,100,0.001,0.01,0.752,4462,4442
13,9004,10,100,0.001,0.01,0.762,4511,4493
13,9104,10,100,0.001,0.01,0.766,4561,4543
13,9204,10,100,0.001,0.01,0.776,4611,4593
13,9304,10,100,0.001,0.01,0.76,4660,4644
13,9404,10,100,0.001,0.01,0.794,4712,4692
13,9504,10,100,0.001,0.01,0.788,4769,4735
13,9604,10,100,0.001,0.01,0.786,4819,4785
13,9704,10,100,0.001,0.01,0.782,4875,4829
13,9804,10,100,0.001,0.01,0.796,4931,4873
13,9904,10,100,0.001,0.01,0.808,4980,4924
13,10004,10,100,0.001,0.01,0.784,5029,4975
13,10104,10,100,0.001,0.01,0.804,5086,5018
13,10204,10,100,0.001,0.01,0.816,5131,5073
13,10304,10,100,0.001,0.01,0.818,5175,5129
13,10404,10,100,0.001,0.01,0.82,5225,5179
13,10504,10,100,0.001,0.01,0.798,5275,5229
13,10604,10,100,0.001,0.01,0.808,5315,5289
13,10704,10,100,0.001,0.01,0.806,5371,5333
13,10804,10,100,0.001,0.01,0.808,5414,5390
13,10904,10,100,0.001,0.01,0.804,5464,5440
13,11004,10,100,0.001,0.01,0.81,5517,5487
13,11104,10,100,0.001,0.01,0.792,5562,5542
13,11204,10,100,0.001,0.01,0.826,5616,5588
13,11304,10,100,0.001,0.01,0.832,5669,5635
13,11404,10,100,0.001,0.01,0.806,5717,5687
13,11504,10,100,0.001,0.01,0.842,5779,5725
13,11604,10,100,0.001,0.01,0.834,5834,5770
13,11704,10,100,0.001,0.01,0.79,5873,5831
13,11804,10,100,0.001,0.01,0.806,5924,5880
13,11904,10,100,0.001,0.01,0.772,5964,5940
13,12004,10,100,0.001,0.01,0.822,6017,5987
13,12104,10,100,0.001,0.01,0.844,6070,6034
13,12204,10,100,0.001,0.01,0.846,6126,6078
13,12304,10,100,0.001,0.01,0.846,6183,6121
13,12404,10,100,0.001,0.01,0.84,6219,6185
13,12504,10,100,0.001,0.01,0.836,6270,6234
13,12604,10,100,0.001,0.01,0.824,6324,6280
13,12704,10,100,0.001,0.01,0.84,6372,6332
13,12804,10,100,0.001,0.01,0.842,6429,6375
13,12904,10,100,0.001,0.01,0.852,6481,6423
13,13004,10,100,0.001,0.01,0.85,6527,6477
13,13104,10,100,0.001,0.01,0.85,6570,6534
13,13204,10,100,0.001,0.01,0.852,6621,6583
13,13304,10,100,0.001,0.01,0.834,6668,6636
13,13404,10,100,0.001,0.01,0.834,6709,6695
13,13504,10,100,0.001,0.01,0.868,6761,6743
13,13604,10,100,0.001,0.01,0.85,6810,6794
13,13704,10,100,0.001,0.01,0.862,6862,6842
13,13804,10,100,0.001,0.01,0.83,6915,6889
13,13904,10,100,0.001,0.01,0.824,6965,6939
13,14004,10,100,0.001,0.01,0.856,7022,6982
13,14104,10,100,0.001,0.01,0.844,7080,7024
13,14204,10,100,0.001,0.01,0.856,7134,7070
13,14304,10,100,0.001,0.01,0.864,7179,7125
13,14404,10,100,0.001,0.01,0.854,7224,7180
13,14504,10,100,0.001,0.01,0.868,7262,7242
13,14604,10,100,0.001,0.01,0.818,7308,7296
13,14704,10,100,0.001,0.01,0.844,7360,7344
13,14804,10,100,0.001,0.01,0.866,7415,7389
13,14904,10,100,0.001,0.01,0.848,7465,7439
13,15004,10,100,0.001,0.01,0.852,7513,7491
14,104,10,100,0.001,0.01,0.518,57,47
14,204,10,100,0.001,0.01,0.508,104,100
14,304,10,100,0.001,0.01,0.5,148,156
14,404,10,100,0.001,0.01,0.488,199,205
14,504,10,100,0.001,0.01,0.47,243,261
14,604,10,100,0.001,0.01,0.498,289,315
14,704,10,100,0.001,0.01,0.482,337,367
14,804,10,100,0.001,0.01,0.51,389,415
14,904,10,100,0.001,0.01,0.526,442,462
14,1004,10,100,0.001,0.01,0.494,485,519
14,1104,10,100,0.001,0.01,0.518,541,563
14,1204,10,100,0.001,0.01,0.498,580,624
14,1304,10,100,0.001,0.01,0.502,626,678
14,1404,10,100,0.001,0.01,0.514,683,721
14,1504,10,100,0.001,0.01,0.496,738,766
14,1604,10,100,0.001,0.01,0.526,794,810
14,1704,10,100,0.001,0.01,0.528,837,867
14,1804,10,100,0.001,0.01,0.52,884,920
14,1904,10,100,0.001,0.01,0.508,937,967
14,2004,10,100,0.001,0.01,0.522,981,1023
14,2104,10,100,0.001,0.01,0.506,1030,1074
14,2204,10,100,0.001,0.01,0.5,1081,1123
14,2304,10,100,0.001,0.01,0.514,1134,1170
14,2404,10,100,0.001,0.01,0.51,1180,1224
14,2504,10,100,0.001,0.01,0.52,1224,1280
14,2604,10,100,0.001,0.01,0.52,1282,1322
14,2704,10,100,0.001,0.01,0.518,1328,1376
14,2804,10,100,0.001,0.01,0.53,1374,1430
14,2904,10,100,0.001,0.01,0.562,1428,1476
14,3004,10,100,0.001,0.01,0.568,1474,1530
14,3104,10,100,0.001,0.01,0.57,1533,1571
14,3204,10,100,0.001,0.01,0.592,1583,1621
14,3304,10,100,0.001,0.01,0.586,1636,1668
14,3404,10,100,0.001,0.01,0.542,1682,1722
14,3504,10,100,0.001,0.01,0.554,1733,1771
14,3604,10,100,0.001,0.01,0.588,1772,1832
14,3704,10,100,0.001,0.01,0.604,1824,1880
14,3804,10,100,0.001,0.01,0.612,1871,1933
14,3904,10,100,0.001,0.01,0.64,1918,1986
14,4004,10,100,0.001,0.01,0.618,1971,2033
14,4104,10,100,0.001,0.01,0.602,2021,2083
14,4204,10,100,0.001,0.01,0.624,2071,2133
14,4304,10,100,0.001,0.01,0.634,2118,2186
14,4404,10,100,0.001,0.01,0.642,2169,2235
14,4504,10,100,0.001,0.01,0.624,2221,2283
14,4604,10,100,0.001,0.01,0.638,2267,2337
14,4704,10,100,0.001,0.01,0.66,2324,2380
14,4804,10,100,0.001,0.01,0.65,2377,2427
14,4904,10,100,0.001,0.01,0.658,2428,2476
14,5004,10,100,0.001,0.01,0.656,2480,2524
14,5104,10,100,0.001,0.01,0.65,2526,2578
14,5204,10,100,0.001,0.01,0.644,2584,2620
14,5304,10,100,0.001,0.01,0.642,2627,2677
14,5404,10,100,0.001,0.01,0.662,2675,2729
14,5504,10,100,0.001,0.01,0.682,2728,2776
14,5604,10,100,0.001,0.01,0.666,2779,2825
14,5704,10,100,0.001,0.01,0.648,2833,2871
14,5804,10,100,0.001,0.01,0.652,2884,2920
14,5904,10,100,0.001,0.01,0.67,2933,2971
14,6004,10,100,0.001,0.01,0.676,2983,3021
14,6104,10,100,0.001,0.01,0.658,3031,3073
14,6204,10,100,0.001,0.01,0.666,3087,3117
14,6304,10,100,0.001,0.01,0.632,3131,3173
14,6404,10,100,0.001,0.01,0.7,3183,3221
14,6504,10,100,0.001,0.01,0.692,3235,3269
14,6604,10,100,0.001,0.01,0.7,3284,3320
14,6704,10,100,0.001,0.01,0.7,3342,3362
14,6804,10,100,0.001,0.01,0.708,3390,3414
14,6904,10,100,0.001,0.01,0.69,3440,3464
14,7004,10,100,0.001,0.01,0.716,3487,3517
14,7104,10,100,0.001,0.01,0.686,3537,3567
14,7204,10,100,0.001,0.01,0.682,3585,3619
14,7304,10,100,0.001,0.01,0.7,3629,3675
14,7404,10,100,0.001,0.01,0.702,3685,3719
14,7504,10,100,0.001,0.01,0.706,3728,3776
14,7604,10,100,0.001,0.01,0.732,3784,3820
14,7704,10,100,0.001,0.01,0.714,3829,3875
14,7804,10,100,0.001,0.01,0.722,3868,3936
14,7904,10,100,0.001,0.01,0.728,3918,3986
14,8004,10,100,0.001,0.01,0.72,3971,4033
14,8104,10,100,0.001,0.01,0.7,4020,4084
14,8204,10,100,0.001,0.01,0.734,4080,4124
14,8304,10,100,0.001,0.01,0.752,4120,4184
14,8404,10,100,0.001,0.01,0.75,4179,4225
14,8504,10,100,0.001,0.01,0.71,4232,4272
14,8604,10,100,0.001,0.01,0.712,4283,4321
14,8704,10,100,0.001,0.01,0.728,4340,4364
14,8804,10,100,0.001,0.01,0.744,4394,4410
14,8904,10,100,0.001,0.01,0.754,4438,4466
14,9004,10,100,0.001,0.01,0.722,4494,4510
14,9104,10,100,0.001,0.01,0.748,4546,4558
14,9204,10,100,0.001,0.01,0.754,4592,4612
14,9304,10,100,0.001,0.01,0.776,4635,4669
14,9404,10,100,0.001,0.01,0.722,4687,4717
14,9504,10,100,0.001,0.01,0.752,4739,4765
14,9604,10,100,0.001,0.01,0.752,4777,4827
14,9704,10,100,0.001,0.01,0.778,4826,4878
14,9804,10,100,0.001,0.01,0.772,4877,4927
14,9904,10,100,0.001,0.01,0.778,4927,4977
14,10004,10,100,0.001,0.01,0.776,4983,5021
14,10104,10,100,0.001,0.01,0.78,5039,5065
14,10204,10,100,0.001,0.01,0.77,5097,5107
14,10304,10,100,0.001,0.01,0.772,5149,5155
14,10404,10,100,0.001,0.01,0.78,5193,5211
14,10504,10,100,0.001,0.01,0.792,5249,5255
14,10604,10,100,0.001,0.01,0.798,5310,5294
14,10704,10,100,0.001,0.01,0.788,5358,5346
14,10804,10,100,0.001,0.01,0.772,5399,5405
14,10904,10,100,0.001,0.01,0.792,5442,5462
14,11004,10,100,0.001,0.01,0.808,5492,5512
14,11104,10,100,0.001,0.01,0.776,5534,5570
14,11204,10,100,0.001,0.01,0.774,5589,5615
14,11304,10,100,0.001,0.01,0.77,5642,5662
14,11404,10,100,0.001,0.01,0.77,5692,5712
14,11504,10,100,0.001,0.01,0.762,5743,5761
14,11604,10,100,0.001,0.01,0.79,5792,5812
14,11704,10,100,0.001,0.01,0.792,5843,5861
14,11804,10,100,0.001,0.01,0.782,5887,5917
14,11904,10,100,0.001,0.01,0.794,5941,5963
14,12004,10,100,0.001,0.01,0.802,5998,6006
14,12104,10,100,0.001,0.01,0.796,6048,6056
14,12204,10,100,0.001,0.01,0.788,6092,6112
14,12304,10,100,0.001,0.01,0.814,6146,6158
14,12404,10,100,0.001,0.01,0.794,6203,6201
14,12504,10,100,0.001,0.01,0.808,6255,6249
14,12604,10,100,0.001,0.01,0.83,6293,6311
14,12704,10,100,0.001,0.01,0.808,6343,6361
14,12804,10,100,0.001,0.01,0.82,6392,6412
14,12904,10,100,0.001,0.01,0.824,6446,6458
14,13004,10,100,0.001,0.01,0.796,6499,6505
14,13104,10,100,0.001,0.01,0.836,6557,6547
14,13204,10,100,0.001,0.01,0.798,6605,6599
14,13304,10,100,0.001,0.01,0.788,6653,6651
14,13404,10,100,0.001,0.01,0.838,6701,6703
14,13504,10,100,0.001,0.01,0.808,6747,6757
14,13604,10,100,0.001,0.01,0.802,6790,6814
14,13704,10,100,0.001,0.01,0.826,6844,6860
14,13804,10,100,0.001,0.01,0.796,6891,6913
14,13904,10,100,0.001,0.01,0.81,6943,6961
14,14004,10,100,0.001,0.01,0.816,6996,7008
14,14104,10,100,0.001,0.01,0.822,7049,7055
14,14204,10,100,0.001,0.01,0.826,7096,7108
14,14304,10,100,0.001,0.01,0.832,7149,7155
14,14404,10,100,0.001,0.01,0.804,7193,7211
14,14504,10,100,0.001,0.01,0.824,7239,7265
14,14604,10,100,0.001,0.01,0.83,7295,7309
14,14704,10,100,0.001,0.01,0.832,7346,7358
14,14804,10,100,0.001,0.01,0.836,7399,7405
14,14904,10,100,0.001,0.01,0.838,7445,7459
14,15004,10,100,0.001,0.01,0.844,7491,7513
15,104,10,100,0.001,0.01,0.462,47,57
15,204,10,100,0.001,0.01,0.506,99,105
15,304,10,100,0.001,0.01,0.516,155,149
15,404,10,100,0.001,0.01,0.502,203,201
15,504,10,100,0.001,0.01,0.482,246,258
15,604,10,100,0.001,0.01,0.488,296,308
15,704,10,100,0.001,0.01,0.522,353,351
15,804,10,100,0.001,0.01,0.506,403,401
15,904,10,100,0.001,0.01,0.506,453,451
15,1004,10,100,0.001,0.01,0.524,496,508
15,1104,10,100,0.001,0.01,0.526,552,552
15,1204,10,100,0.001,0.01,0.556,601,603
15,1304,10,100,0.001,0.01,0.508,640,664
15,1404,10,100,0.001,0.01,0.536,699,705
15,1504,10,100,0.001,0.01,0.478,759,745
15,1604,10,100,0.001,0.01,0.516,804,800
15,1704,10,100,0.001,0.01,0.51,862,842
15,1804,10,100,0.001,0.01,0.486,914,890
15,1904,10,100,0.001,0.01,0.522,962,942
15,2004,10,100,0.001,0.01,0.522,1015,989
15,2104,10,100,0.001,0.01,0.536,1070,1034
15,2204,10,100,0.001,0.01,0.532,1117,1087
15,2304,10,100,0.001,0.01,0.5,1167,1137
15,2404,10,100,0.001,0.01,0.526,1224,1180
15,2504,10,100,0.001,0.01,0.504,1270,1234
15,2604,10,100,0.001,0.01,0.536,1320,1284
15,2704,10,100,0.001,0.01,0.56,1377,1327
15,2804,10,100,0.001,0.01,0.552,1422,1382
15,2904,10,100,0.001,0.01,0.57,1471,1433
15,3004,10,100,0.001,0.01,0.568,1529,1475
15,3104,10,100,0.001,0.01,0.59,1597,1507
15,3204,10,100,0.001,0.01,0.606,1649,1555
15,3304,10,100,0.001,0.01,0.63,1695,1609
15,3404,10,100,0.001,0.01,0.612,1747,1657
15,3504,10,100,0.001,0.01,0.618,1783,1721
15,3604,10,100,0.001,0.01,0.63,1837,1767
15,3704,10,100,0.001,0.01,0.646,1880,1824
15,3804,10,100,0.001,0.01,0.662,1931,1873
15,3904,10,100,0.001,0.01,0.676,1984,1920
15,4004,10,100,0.001,0.01,0.71,2037,1967
15,4104,10,100,0.001,0.01,0.744,2089,2015
15,4204,10,100,0.001,0.01,0.742,2129,2075
15,4304,10,100,0.001,0.01,0.76,2186,2118
15,4404,10,100,0.001,0.01,0.774,2239,2165
15,4504,10,100,0.001,0.01,0.75,2294,2210
15,4604,10,100,0.001,0.01,0.78,2347,2257
15,4704,10,100,0.001,0.01,0.784,2391,2313
15,4804,10,100,0.001,0.01,0.802,2430,2374
15,4904,10,100,0.001,0.01,0.8,2477,2427
15,5004,10,100,0.001,0.01,0.816,2532,2472
15,5104,10,100,0.001,0.01,0.812,2580,2524
15,5204,10,100,0.001,0.01,0.866,2625,2579
15,5304,10,100,0.001,0.01,0.86,2680,2624
15,5404,10,100,0.001,0.01,0.872,2721,2683
15,5504,10,100,0.001,0.01,0.9,2774,2730
15,5604,10,100,0.001,0.01,0.9,2827,2777
15,5704,10,100,0.001,0.01,0.9,2883,2821
15,5804,10,100,0.001,0.01,0.918,2932,2872
15,5904,10,100,0.001,0.01,0.91,2981,2923
15,6004,10,100,0.001,0.01,0.906,3029,2975
15,6104,10,100,0.001,0.01,0.934,3071,3033
15,6204,10,100,0.001,0.01,0.92,3116,3088
15,6304,10,100,0.001,0.01,0.926,3164,3140
15,6404,10,100,0.001,0.01,0.91,3216,3188
15,6504,10,100,0.001,0.01,0.914,3266,3238
15,6604,10,100,0.001,0.01,0.916,3317,3287
15,6704,10,100,0.001,0.01,0.932,3365,3339
15,6804,10,100,0.001,0.01,0.934,3411,3393
15,6904,10,100,0.001,0.01,0.942,3464,3440
15,7004,10,100,0.001,0.01,0.936,3513,3491
15,7104,10,100,0.001,0.01,0.91,3560,3544
15,7204,10,100,0.001,0.01,0.942,3608,3596
15,7304,10,100,0.001,0.01,0.956,3663,3641
15,7404,10,100,0.001,0.01,0.96,3724,3680
15,7504,10,100,0.001,0.01,0.944,3778,3726
15,7604,10,100,0.001,0.01,0.958,3833,3771
15,7704,10,100,0.001,0.01,0.96,3889,3815
15,7804,10,100,0.001,0.01,0.962,3934,3870
15,7904,10,100,0.001,0.01,0.966,3993,3911
15,8004,10,100,0.001,0.01,0.956,4052,3952
15,8104,10,100,0.001,0.01,0.964,4102,4002
15,8204,10,100,0.001,0.01,0.954,4161,4043
15,8304,10,100,0.001,0.01,0.948,4204,4100
15,8404,10,100,0.001,0.01,0.96,4249,4155
15,8504,10,100,0.001,0.01,0.96,4303,4201
15,8604,10,100,0.001,0.01,0.96,4349,4255
15,8704,10,100,0.001,0.01,0.966,4399,4305
15,8804,10,100,0.001,0.01,0.97,4447,4357
15,8904,10,100,0.001,0.01,0.97,4490,4414
15,9004,10,100,0.001,0.01,0.97,4543,4461
15,9104,10,100,0.001,0.01,0.972,4593,4511
15,9204,10,100,0.001,0.01,0.966,4649,4555
15,9304,10,100,0.001,0.01,0.976,4697,4607
15,9404,10,100,0.001,0.01,0.972,4751,4653
15,9504,10,100,0.001,0.01,0.97,4808,4696
15,9604,10,100,0.001,0.01,0.974,4859,4745
15,9704,10,100,0.001,0.01,0.974,4906,4798
15,9804,10,100,0.001,0.01,0.964,4960,4844
15,9904,10,100,0.001,0.01,0.974,5005,4899
15,10004,10,100,0.001,0.01,0.97,5057,4947
15,10104,10,100,0.001,0.01,0.974,5105,4999
15,10204,10,100,0.001,0.01,0.978,5151,5053
15,10304,10,100,0.001,0.01,0.972,5198,5106
15,10404,10,100,0.001,0.01,0.966,5254,5150
15,10504,10,100,0.001,0.01,0.97,5302,5202
15,10604,10,100,0.001,0.01,0.974,5343,5261
15,10704,10,100,0.001,0.01,0.964,5392,5312
15,10804,10,100,0.001,0.01,0.978,5440,5364
15,10904,10,100,0.001,0.01,0.976,5490,5414
15,11004,10,100,0.001,0.01,0.976,5541,5463
15,11104,10,100,0.001,0.01,0.98,5581,5523
15,11204,10,100,0.001,0.01,0.978,5635,5569
15,11304,10,100,0.001,0.01,0.982,5689,5615
15,11404,10,100,0.001,0.01,0.976,5739,5665
15,11504,10,100,0.001,0.01,0.976,5787,5717
15,11604,10,100,0.001,0.01,0.98,5842,5762
15,11704,10,100,0.001,0.01,0.974,5889,5815
15,11804,10,100,0.001,0.01,0.982,5939,5865
15,11904,10,100,0.001,0.01,0.976,5998,5906
15,12004,10,100,0.001,0.01,0.908,6047,5957
15,12104,10,100,0.001,0.01,0.966,6096,6008
15,12204,10,100,0.001,0.01,0.968,6150,6054
15,12304,10,100,0.001,0.01,0.974,6195,6109
15,12404,10,100,0.001,0.01,0.984,6243,6161
15,12504,10,100,0.001,0.01,0.982,6297,6207
15,12604,10,100,0.001,0.01,0.986,6336,6268
15,12704,10,100,0.001,0.01,0.982,6387,6317
15,12804,10,100,0.001,0.01,0.982,6441,6363
15,12904,10,100,0.001,0.01,0.988,6485,6419
15,13004,10,100,0.001,0.01,0.984,6526,6478
15,13104,10,100,0.001,0.01,0.984,6579,6525
15,13204,10,100,0.001,0.01,0.982,6634,6570
15,13304,10,100,0.001,0.01,0.984,6682,6622
15,13404,10,100,0.001,0.01,0.972,6736,6668
15,13504,10,100,0.001,0.01,0.976,6796,6708
15,13604,10,100,0.001,0.01,0.982,6840,6764
15,13704,10,100,0.001,0.01,0.984,6880,6824
15,13804,10,100,0.001,0.01,0.982,6923,6881
15,13904,10,100,0.001,0.01,0.984,6982,6922
15,14004,10,100,0.001,0.01,0.984,7033,6971
15,14104,10,100,0.001,0.01,0.98,7087,7017
15,14204,10,100,0.001,0.01,0.982,7135,7069
15,14304,10,100,0.001,0.01,0.982,7180,7124
15,14404,10,100,0.001,0.01,0.984,7222,7182
15,14504,10,100,0.001,0.01,0.984,7283,7221
15,14604,10,100,0.001,0.01,0.984,7332,7272
15,14704,10,100,0.001,0.01,0.978,7386,7318
15,14804,10,100,0.001,0.01,0.98,7433,7371
15,14904,10,100,0.001,0.01,0.972,7477,7427
15,15004,10,100,0.001,0.01,0.974,7521,7483
16,104,10,100,0.001,0.01,0.488,50,54
16,204,10,100,0.001,0.01,0.516,103,101
16,304,10,100,0.001,0.01,0.516,156,148
16,404,10,100,0.001,0.01,0.516,202,202
16,504,10,100,0.001,0.01,0.522,250,254
16,604,10,100,0.001,0.01,0.546,299,305
16,704,10,100,0.001,0.01,0.528,352,352
16,804,10,100,0.001,0.01,0.512,398,406
16,904,10,100,0.001,0.01,0.504,448,456
16,1004,10,100,0.001,0.01,0.522,497,507
16,1104,10,100,0.001,0.01,0.5,544,560
16,1204,10,100,0.001,0.01,0.502,585,619
16,1304,10,100,0.001,0.01,0.484,631,673
16,1404,10,100,0.001,0.01,0.528,678,726
16,1504,10,100,0.001,0.01,0.534,727,777
16,1604,10,100,0.001,0.01,0.51,773,831
16,1704,10,100,0.001,0.01,0.524,819,885
16,1804,10,100,0.001,0.01,0.512,865,939
16,1904,10,100,0.001,0.01,0.512,917,987
16,2004,10,100,0.001,0.01,0.534,965,1039
16,2104,10,100,0.001,0.01,0.512,1015,1089
16,2204,10,100,0.001,0.01,0.534,1072,1132
16,2304,10,100,0.001,0.01,0.526,1121,1183
16,2404,10,100,0.001,0.01,0.546,1168,1236
16,2504,10,100,0.001,0.01,0.548,1222,1282
16,2604,10,100,0.001,0.01,0.564,1266,1338
16,2704,10,100,0.001,0.01,0.534,1320,1384
16,2804,10,100,0.001,0.01,0.522,1367,1437
16,2904,10,100,0.001,0.01,0.57,1421,1483
16,3004,10,100,0.001,0.01,0.578,1473,1531
16,3104,10,100,0.001,0.01,0.6,1522,1582
16,3204,10,100,0.001,0.01,0.614,1571,1633
16,3304,10,100,0.001,0.01,0.594,1621,1683
16,3404,10,100,0.001,0.01,0.572,1666,1738
16,3504,10,100,0.001,0.01,0.594,1711,1793
16,3604,10,100,0.001,0.01,0.624,1756,1848
16,3704,10,100,0.001,0.01,0.624,1805,1899
16,3804,10,100,0.001,0.01,0.64,1853,1951
16,3904,10,100,0.001,0.01,0.652,1908,1996
16,4004,10,100,0.001,0.01,0.652,1956,2048
16,4104,10,100,0.001,0.01,0.66,2020,2084
16,4204,10,100,0.001,0.01,0.66,2063,2141
16,4304,10,100,0.001,0.01,0.66,2116,2188
16,4404,10,100,0.001,0.01,0.682,2170,2234
16,4504,10,100,0.001,0.01,0.698,2217,2287
16,4604,10,100,0.001,0.01,0.716,2270,2334
16,4704,10,100,0.001,0.01,0.688,2314,2390
16,4804,10,100,0.001,0.01,0.706,2378,2426
16,4904,10,100,0.001,0.01,0.676,2428,2476
16,5004,10,100,0.001,0.01,0.71,2477,2527
16,5104,10,100,0.001,0.01,0.702,2536,2568
16,5204,10,100,0.001,0.01,0.708,2589,2615
16,5304,10,100,0.001,0.01,0.698,2633,2671
16,5404,10,100,0.001,0.01,0.676,2681,2723
16,5504,10,100,0.001,0.01,0.712,2729,2775
16,5604,10,100,0.001,0.01,0.71,2790,2814
16,5704,10,100,0.001,0.01,0.71,2827,2877
16,5804,10,100,0.001,0.01,0.722,2876,2928
16,5904,10,100,0.001,0.01,0.738,2924,2980
16,6004,10,100,0.001,0.01,0.704,2983,3021
16,6104,10,100,0.001,0.01,0.71,3043,3061
16,6204,10,100,0.001,0.01,0.708,3088,3116
16,6304,10,100,0.001,0.01,0.662,3137,3167
16,6404,10,100,0.001,0.01,0.772,3186,3218
16,6504,10,100,0.001,0.01,0.764,3234,3270
16,6604,10,100,0.001,0.01,0.788,3282,3322
16,6704,10,100,0.001,0.01,0.794,3330,3374
16,6804,10,100,0.001,0.01,0.792,3378,3426
16,6904,10,100,0.001,0.01,0.78,3420,3484
16,7004,10,100,0.001,0.01,0.82,3470,3534
16,7104,10,100,0.001,0.01,0.812,3525,3579
16,7204,10,100,0.001,0.01,0.804,3572,3632
16,7304,10,100,0.001,0.01,0.798,3622,3682
16,7404,10,100,0.001,0.01,0.802,3675,3729
16,7504,10,100,0.001,0.01,0.758,3725,3779
16,7604,10,100,0.001,0.01,0.794,3778,3826
16,7704,10,100,0.001,0.01,0.804,3834,3870
16,7804,10,100,0.001,0.01,0.808,3877,3927
16,7904,10,100,0.001,0.01,0.784,3922,3982
16,8004,10,100,0.001,0.01,0.796,3965,4039
16,8104,10,100,0.001,0.01,0.794,4016,4088
16,8204,10,100,0.001,0.01,0.83,4058,4146
16,8304,10,100,0.001,0.01,0.8,4110,4194
16,8404,10,100,0.001,0.01,0.812,4162,4242
16,8504,10,100,0.001,0.01,0.826,4209,4295
16,8604,10,100,0.001,0.01,0.838,4260,4344
16,8704,10,100,0.001,0.01,0.83,4312,4392
16,8804,10,100,0.001,0.01,0.818,4362,4442
16,8904,10,100,0.001,0.01,0.852,4414,4490
16,9004,10,100,0.001,0.01,0.84,4469,4535
16,9104,10,100,0.001,0.01,0.834,4524,4580
16,9204,10,100,0.001,0.01,0.85,4573,4631
16,9304,10,100,0.001,0.01,0.838,4623,4681
16,9404,10,100,0.001,0.01,0.858,4677,4727
16,9504,10,100,0.001,0.01,0.846,4736,4768
16,9604,10,100,0.001,0.01,0.854,4783,4821
16,9704,10,100,0.001,0.01,0.836,4839,4865
16,9804,10,100,0.001,0.01,0.844,4892,4912
16,9904,10,100,0.001,0.01,0.852,4945,4959
16,10004,10,100,0.001,0.01,0.87,4990,5014
16,10104,10,100,0.001,0.01,0.872,5038,5066
16,10204,10,100,0.001,0.01,0.86,5091,5113
16,10304,10,100,0.001,0.01,0.84,5133,5171
16,10404,10,100,0.001,0.01,0.858,5178,5226
16,10504,10,100,0.001,0.01,0.846,5229,5275
16,10604,10,100,0.001,0.01,0.852,5277,5327
16,10704,10,100,0.001,0.01,0.87,5333,5371
16,10804,10,100,0.001,0.01,0.84,5385,5419
16,10904,10,100,0.001,0.01,0.854,5434,5470
16,11004,10,100,0.001,0.01,0.866,5486,5518
16,11104,10,100,0.001,0.01,0.876,5533,5571
16,11204,10,100,0.001,0.01,0.872,5587,5617
16,11304,10,100,0.001,0.01,0.846,5629,5675
16,11404,10,100,0.001,0.01,0.826,5683,5721
16,11504,10,100,0.001,0.01,0.85,5737,5767
16,11604,10,100,0.001,0.01,0.89,5785,5819
16,11704,10,100,0.001,0.01,0.888,5836,5868
16,11804,10,100,0.001,0.01,0.876,5884,5920
16,11904,10,100,0.001,0.01,0.876,5931,5973
16,12004,10,100,0.001,0.01,0.87,5976,6028
16,12104,10,100,0.001,0.01,0.882,6029,6075
16,12204,10,100,0.001,0.01,0.874,6078,6126
16,12304,10,100,0.001,0.01,0.884,6129,6175
16,12404,10,100,0.001,0.01,0.846,6179,6225
16,12504,10,100,0.001,0.01,0.868,6226,6278
16,12604,10,100,0.001,0.01,0.86,6277,6327
16,12704,10,100,0.001,0.01,0.84,6332,6372
16,12804,10,100,0.001,0.01,0.864,6391,6413
16,12904,10,100,0.001,0.01,0.868,6437,6467
16,13004,10,100,0.001,0.01,0.84,6499,6505
16,13104,10,100,0.001,0.01,0.85,6548,6556
16,13204,10,100,0.001,0.01,0.88,6592,6612
16,13304,10,100,0.001,0.01,0.874,6644,6660
16,13404,10,100,0.001,0.01,0.854,6704,6700
16,13504,10,100,0.001,0.01,0.856,6758,6746
16,13604,10,100,0.001,0.01,0.878,6813,6791
16,13704,10,100,0.001,0.01,0.876,6870,6834
16,13804,10,100,0.001,0.01,0.888,6920,6884
16,13904,10,100,0.001,0.01,0.882,6966,6938
16,14004,10,100,0.001,0.01,0.874,7006,6998
16,14104,10,100,0.001,0.01,0.858,7049,7055
16,14204,10,100,0.001,0.01,0.838,7099,7105
16,14304,10,100,0.001,0.01,0.802,7152,7152
16,14404,10,100,0.001,0.01,0.83,7197,7207
16,14504,10,100,0.001,0.01,0.864,7243,7261
16,14604,10,100,0.001,0.01,0.87,7290,7314
16,14704,10,100,0.001,0.01,0.85,7347,7357
16,14804,10,100,0.001,0.01,0.852,7399,7405
16,14904,10,100,0.001,0.01,0.89,7454,7450
16,15004,10,100,0.001,0.01,0.872,7508,7496
17,104,10,100,0.001,0.01,0.502,50,54
17,204,10,100,0.001,0.01,0.464,100,104
17,304,10,100,0.001,0.01,0.506,146,158
17,404,10,100,0.001,0.01,0.53,202,202
17,504,10,100,0.001,0.01,0.53,254,250
17,604,10,100,0.001,0.01,0.53,302,302
17,704,10,100,0.001,0.01,0.532,351,353
17,804,10,100,0.001,0.01,0.546,401,403
17,904,10,100,0.001,0.01,0.532,447,457
17,1004,10,100,0.001,0.01,0.506,497,507
17,1104,10,100,0.001,0.01,0.524,546,558
17,1204,10,100,0.001,0.01,0.528,597,607
17,1304,10,100,0.001,0.01,0.5,653,651
17,1404,10,100,0.001,0.01,0.544,702,702
17,1504,10,100,0.001,0.01,0.522,749,755
17,1604,10,100,0.001,0.01,0.572,805,799
17,1704,10,100,0.001,0.01,0.548,857,847
17,1804,10,100,0.001,0.01,0.572,914,890
17,1904,10,100,0.001,0.01,0.566,965,939
17,2004,10,100,0.001,0.01,0.604,1017,987
17,2104,10,100,0.001,0.01,0.636,1063,1041
17,2204,10,100,0.001,0.01,0.668,1116,1088
17,2304,10,100,0.001,0.01,0.646,1164,1140
17,2404,10,100,0.001,0.01,0.65,1209,1195
17,2504,10,100,0.001,0.01,0.672,1261,1243
17,2604,10,100,0.001,0.01,0.654,1312,1292
17,2704,10,100,0.001,0.01,0.672,1355,1349
17,2804,10,100,0.001,0.01,0.668,1411,1393
17,2904,10,100,0.001,0.01,0.688,1457,1447
17,3004,10,100,0.001,0.01,0.634,1502,1502
17,3104,10,100,0.001,0.01,0.688,1553,1551
17,3204,10,100,0.001,0.01,0.68,1605,1599
17,3304,10,100,0.001,0.01,0.69,1651,1653
17,3404,10,100,0.001,0.01,0.69,1706,1698
17,3504,10,100,0.001,0.01,0.704,1757,1747
17,3604,10,100,0.001,0.01,0.682,1813,1791
17,3704,10,100,0.001,0.01,0.728,1854,1850
17,3804,10,100,0.001,0.01,0.71,1899,1905
17,3904,10,100,0.001,0.01,0.732,1953,1951
17,4004,10,100,0.001,0.01,0.726,2002,2002
17,4104,10,100,0.001,0.01,0.738,2046,2058
17,4204,10,100,0.001,0.01,0.752,2099,2105
17,4304,10,100,0.001,0.01,0.752,2145,2159
17,4404,10,100,0.001,0.01,0.762,2195,2209
17,4504,10,100,0.001,0.01,0.742,2246,2258
17,4604,10,100,0.001,0.01,0.756,2298,2306
17,4704,10,100,0.001,0.01,0.752,2343,2361
17,4804,10,100,0.001,0.01,0.766,2400,2404
17,4904,10,100,0.001,0.01,0.776,2449,2455
17,5004,10,100,0.001,0.01,0.762,2497,2507
17,5104,10,100,0.001,0.01,0.75,2547,2557
17,5204,10,100,0.001,0.01,0.772,2594,2610
17,5304,10,100,0.001,0.01,0.74,2642,2662
17,5404,10,100,0.001,0.01,0.734,2692,2712
17,5504,10,100,0.001,0.01,0.786,2737,2767
17,5604,10,100,0.001,0.01,0.77,2788,2816
17,5704,10,100,0.001,0.01,0.774,2836,2868
17,5804,10,100,0.001,0.01,0.776,2887,2917
17,5904,10,100,0.001,0.01,0.796,2935,2969
17,6004,10,100,0.001,0.01,0.744,2987,3017
17,6104,10,100,0.001,0.01,0.742,3032,3072
17,6204,10,100,0.001,0.01,0.762,3080,3124
17,6304,10,100,0.001,0.01,0.784,3132,3172
17,6404,10,100,0.001,0.01,0.784,3169,3235
17,6504,10,100,0.001,0.01,0.77,3222,3282
17,6604,10,100,0.001,0.01,0.776,3275,3329
17,6704,10,100,0.001,0.01,0.786,3331,3373
17,6804,10,100,0.001,0.01,0.77,3375,3429
17,6904,10,100,0.001,0.01,0.786,3427,3477
17,7004,10,100,0.001,0.01,0.784,3478,3526
17,7104,10,100,0.001,0.01,0.786,3533,3571
17,7204,10,100,0.001,0.01,0.794,3580,3624
17,7304,10,100,0.001,0.01,0.786,3627,3677
17,7404,10,100,0.001,0.01,0.796,3677,3727
17,7504,10,100,0.001,0.01,0.77,3727,3777
17,7604,10,100,0.001,0.01,0.776,3774,3830
17,7704,10,100,0.001,0.01,0.792,3824,3880
17,7804,10,100,0.001,0.01,0.798,3871,3933
17,7904,10,100,0.001,0.01,0.774,3922,3982
17,8004,10,100,0.001,0.01,0.77,3969,4035
17,8104,10,100,0.001,0.01,0.804,4024,4080
17,8204,10,100,0.001,0.01,0.822,4065,4139
17,8304,10,100,0.001,0.01,0.778,4120,4184
17,8404,10,100,0.001,0.01,0.818,4171,4233
17,8504,10,100,0.001,0.01,0.82,4209,4295
17,8604,10,100,0.001,0.01,0.796,4260,4344
17,8704,10,100,0.001,0.01,0.802,4314,4390
17,8804,10,100,0.001,0.01,0.794,4363,4441
17,8904,10,100,0.001,0.01,0.808,4412,4492
17,9004,10,100,0.001,0.01,0.826,4465,4539
17,9104,10,100,0.001,0.01,0.826,4519,4585
17,9204,10,100,0.001,0.01,0.776,4563,4641
17,9304,10,100,0.001,0.01,0.798,4615,4689
17,9404,10,100,0.001,0.01,0.824,4657,4747
17,9504,10,100,0.001,0.01,0.836,4717,4787
17,9604,10,100,0.001,0.01,0.786,4768,4836
17,9704,10,100,0.001,0.01,0.804,4821,4883
17,9804,10,100,0.001,0.01,0.814,4869,4935
17,9904,10,100,0.001,0.01,0.83,4919,4985
17,10004,10,100,0.001,0.01,0.826,4961,5043
17,10104,10,100,0.001,0.01,0.834,5003,5101
17,10204,10,100,0.001,0.01,0.84,5051,5153
17,10304,10,100,0.001,0.01,0.82,5105,5199
17,10404,10,100,0.001,0.01,0.83,5167,5237
17,10504,10,100,0.001,0.01,0.834,5228,5276
17,10604,10,100,0.001,0.01,0.838,5278,5326
17,10704,10,100,0.001,0.01,0.804,5318,5386
17,10804,10,100,0.001,0.01,0.844,5360,5444
17,10904,10,100,0.001,0.01,0.846,5412,5492
17,11004,10,100,0.001,0.01,0.836,5460,5544
17,11104,10,100,0.001,0.01,0.836,5506,5598
17,11204,10,100,0.001,0.01,0.824,5561,5643
17,11304,10,100,0.001,0.01,0.84,5609,5695
17,11404,10,100,0.001,0.01,0.8,5664,5740
17,11504,10,100,0.001,0.01,0.824,5720,5784
17,11604,10,100,0.001,0.01,0.828,5765,5839
17,11704,10,100,0.001,0.01,0.852,5823,5881
17,11804,10,100,0.001,0.01,0.866,5871,5933
17,11904,10,100,0.001,0.01,0.856,5921,5983
17,12004,10,100,0.001,0.01,0.84,5973,6031
17,12104,10,100,0.001,0.01,0.866,6029,6075
17,12204,10,100,0.001,0.01,0.868,6071,6133
17,12304,10,100,0.001,0.01,0.86,6120,6184
17,12404,10,100,0.001,0.01,0.856,6180,6224
17,12504,10,100,0.001,0.01,0.862,6226,6278
17,12604,10,100,0.001,0.01,0.848,6276,6328
17,12704,10,100,0.001,0.01,0.856,6328,6376
17,12804,10,100,0.001,0.01,0.858,6379,6425
17,12904,10,100,0.001,0.01,0.86,6431,6473
17,13004,10,100,0.001,0.01,0.866,6485,6519
17,13104,10,100,0.001,0.01,0.87,6537,6567
17,13204,10,100,0.001,0.01,0.854,6588,6616
17,13304,10,100,0.001,0.01,0.838,6637,6667
17,13404,10,100,0.001,0.01,0.872,6685,6719
17,13504,10,100,0.001,0.01,0.856,6734,6770
17,13604,10,100,0.001,0.01,0.842,6781,6823
17,13704,10,100,0.001,0.01,0.856,6837,6867
17,13804,10,100,0.001,0.01,0.854,6887,6917
17,13904,10,100,0.001,0.01,0.866,6934,6970
17,14004,10,100,0.001,0.01,0.868,6985,7019
17,14104,10,100,0.001,0.01,0.866,7037,7067
17,14204,10,100,0.001,0.01,0.882,7094,7110
17,14304,10,100,0.001,0.01,0.868,7155,7149
17,14404,10,100,0.001,0.01,0.87,7207,7197
17,14504,10,100,0.001,0.01,0.848,7261,7243
17,14604,10,100,0.001,0.01,0.884,7320,7284
17,14704,10,100,0.001,0.01,0.86,7365,7339
17,14804,10,100,0.001,0.01,0.878,7404,7400
17,14904,10,100,0.001,0.01,0.872,7449,7455
17,15004,10,100,0.001,0.01,0.87,7503,7501
18,104,10,100,0.001,0.01,0.502,47,57
18,204,10,100,0.001,0.01,0.492,93,111
18,304,10,100,0.001,0.01,0.504,143,161
18,404,10,100,0.001,0.01,0.482,197,207
18,504,10,100,0.001,0.01,0.5,244,260
18,604,10,100,0.001,0.01,0.466,295,309
18,704,10,100,0.001,0.01,0.502,332,372
18,804,10,100,0.001,0.01,0.5,378,426
18,904,10,100,0.001,0.01,0.476,429,475
18,1004,10,100,0.001,0.01,0.474,476,528
18,1104,10,100,0.001,0.01,0.496,522,582
18,1204,10,100,0.001,0.01,0.462,573,631
18,1304,10,100,0.001,0.01,0.47,626,678
18,1404,10,100,0.001,0.01,0.46,670,734
18,1504,10,100,0.001,0.01,0.488,709,795
18,1604,10,100,0.001,0.01,0.462,757,847
18,1704,10,100,0.001,0.01,0.514,811,893
18,1804,10,100,0.001,0.01,0.476,865,939
18,1904,10,100,0.001,0.01,0.47,908,996
18,2004,10,100,0.001,0.01,0.478,950,1054
18,2104,10,100,0.001,0.01,0.498,990,1114
18,2204,10,100,0.001,0.01,0.47,1037,1167
18,2304,10,100,0.001,0.01,0.508,1077,1227
18,2404,10,100,0.001,0.01,0.488,1122,1282
18,2504,10,100,0.001,0.01,0.48,1168,1336
18,2604,10,100,0.001,0.01,0.496,1214,1390
18,2704,10,100,0.001,0.01,0.484,1260,1444
18,2804,10,100,0.001,0.01,0.47,1309,1495
18,2904,10,100,0.001,0.01,0.482,1364,1540
18,3004,10,100,0.001,0.01,0.502,1410,1594
18,3104,10,100,0.001,0.01,0.468,1461,1643
18,3204,10,100,0.001,0.01,0.49,1509,1695
18,3304,10,100,0.001,0.01,0.468,1559,1745
18,3404,10,100,0.001,0.01,0.47,1603,1801
18,3504,10,100,0.001,0.01,0.464,1651,1853
18,3604,10,100,0.001,0.01,0.464,1696,1908
18,3704,10,100,0.001,0.01,0.46,1758,1946
18,3804,10,100,0.001,0.01,0.448,1813,1991
18,3904,10,100,0.001,0.01,0.468,1864,2040
18,4004,10,100,0.001,0.01,0.46,1916,2088
18,4104,10,100,0.001,0.01,0.482,1965,2139
18,4204,10,100,0.001,0.01,0.488,2026,2178
18,4304,10,100,0.001,0.01,0.476,2085,2219
18,4404,10,100,0.001,0.01,0.478,2132,2272
18,4504,10,100,0.001,0.01,0.476,2191,2313
18,4604,10,100,0.001,0.01,0.504,2254,2350
18,4704,10,100,0.001,0.01,0.53,2298,2406
18,4804,10,100,0.001,0.01,0.502,2349,2455
18,4904,10,100,0.001,0.01,0.532,2402,2502
18,5004,10,100,0.001,0.01,0.554,2451,2553
18,5104,10,100,0.001,0.01,0.542,2513,2591
18,5204,10,100,0.001,0.01,0.536,2568,2636
18,5304,10,100,0.001,0.01,0.554,2620,2684
18,5404,10,100,0.001,0.01,0.542,2676,2728
18,5504,10,100,0.001,0.01,0.53,2721,2783
18,5604,10,100,0.001,0.01,0.55,2768,2836
18,5704,10,100,0.001,0.01,0.558,2822,2882
18,5804,10,100,0.001,0.01,0.582,2857,2947
18,5904,10,100,0.001,0.01,0.57,2911,2993
18,6004,10,100,0.001,0.01,0.582,2965,3039
18,6104,10,100,0.001,0.01,0.592,3015,3089
18,6204,10,100,0.001,0.01,0.59,3070,3134
18,6304,10,100,0.001,0.01,0.584,3121,3183
18,6404,10,100,0.001,0.01,0.582,3174,3230
18,6504,10,100,0.001,0.01,0.53,3220,3284
18,6604,10,100,0.001,0.01,0.58,3266,3338
18,6704,10,100,0.001,0.01,0.604,3321,3383
18,6804,10,100,0.001,0.01,0.572,3360,3444
18,6904,10,100,0.001,0.01,0.61,3411,3493
18,7004,10,100,0.001,0.01,0.602,3470,3534
18,7104,10,100,0.001,0.01,0.634,3511,3593
18,7204,10,100,0.001,0.01,0.636,3556,3648
18,7304,10,100,0.001,0.01,0.624,3603,3701
18,7404,10,100,0.001,0.01,0.628,3648,3756
18,7504,10,100,0.001,0.01,0.646,3705,3799
18,7604,10,100,0.001,0.01,0.662,3759,3845
18,7704,10,100,0.001,0.01,0.632,3801,3903
18,7804,10,100,0.001,0.01,0.65,3848,3956
18,7904,10,100,0.001,0.01,0.654,3906,3998
18,8004,10,100,0.001,0.01,0.652,3956,4048
18,8104,10,100,0.001,0.01,0.662,4015,4089
18,8204,10,100,0.001,0.01,0.624,4066,4138
18,8304,10,100,0.001,0.01,0.638,4115,4189
18,8404,10,100,0.001,0.01,0.638,4177,4227
18,8504,10,100,0.001,0.01,0.66,4227,4277
18,8604,10,100,0.001,0.01,0.654,4272,4332
18,8704,10,100,0.001,0.01,0.684,4330,4374
18,8804,10,100,0.001,0.01,0.67,4384,4420
18,8904,10,100,0.001,0.01,0.672,4437,4467
18,9004,10,100,0.001,0.01,0.674,4489,4515
18,9104,10,100,0.001,0.01,0.684,4538,4566
18,9204,10,100,0.001,0.01,0.684,4589,4615
18,9304,10,100,0.001,0.01,0.706,4642,4662
18,9404,10,100,0.001,0.01,0.67,4687,4717
18,9504,10,100,0.001,0.01,0.736,4746,4758
18,9604,10,100,0.001,0.01,0.684,4799,4805
18,9704,10,100,0.001,0.01,0.716,4846,4858
18,9804,10,100,0.001,0.01,0.696,4891,4913
18,9904,10,100,0.001,0.01,0.678,4945,4959
18,10004,10,100,0.001,0.01,0.7,4994,5010
18,10104,10,100,0.001,0.01,0.71,5053,5051
18,10204,10,100,0.001,0.01,0.75,5114,5090
18,10304,10,100,0.001,0.01,0.742,5167,5137
18,10404,10,100,0.001,0.01,0.736,5229,5175
18,10504,10,100,0.001,0.01,0.736,5283,5221
18,10604,10,100,0.001,0.01,0.754,5330,5274
18,10704,10,100,0.001,0.01,0.734,5384,5320
18,10804,10,100,0.001,0.01,0.738,5432,5372
18,10904,10,100,0.001,0.01,0.738,5483,5421
18,11004,10,100,0.001,0.01,0.738,5528,5476
18,11104,10,100,0.001,0.01,0.758,5576,5528
18,11204,10,100,0.001,0.01,0.736,5620,5584
18,11304,10,100,0.001,0.01,0.744,5677,5627
18,11404,10,100,0.001,0.01,0.734,5732,5672
18,11504,10,100,0.001,0.01,0.784,5787,5717
18,11604,10,100,0.001,0.01,0.762,5833,5771
18,11704,10,100,0.001,0.01,0.768,5890,5814
18,11804,10,100,0.001,0.01,0.776,5943,5861
18,11904,10,100,0.001,0.01,0.784,5997,5907
18,12004,10,100,0.001,0.01,0.762,6046,5958
18,12104,10,100,0.001,0.01,0.802,6095,6009
18,12204,10,100,0.001,0.01,0.772,6148,6056
18,12304,10,100,0.001,0.01,0.812,6195,6109
18,12404,10,100,0.001,0.01,0.782,6244,6160
18,12504,10,100,0.001,0.01,0.786,6293,6211
18,12604,10,100,0.001,0.01,0.782,6347,6257
18,12704,10,100,0.001,0.01,0.808,6395,6309
18,12804,10,100,0.001,0.01,0.808,6437,6367
18,12904,10,100,0.001,0.01,0.794,6475,6429
18,13004,10,100,0.001,0.01,0.778,6532,6472
18,13104,10,100,0.001,0.01,0.788,6578,6526
18,13204,10,100,0.001,0.01,0.816,6632,6572
18,13304,10,100,0.001,0.01,0.784,6685,6619
18,13404,10,100,0.001,0.01,0.816,6731,6673
18,13504,10,100,0.001,0.01,0.802,6774,6730
18,13604,10,100,0.001,0.01,0.802,6822,6782
18,13704,10,100,0.001,0.01,0.814,6871,6833
18,13804,10,100,0.001,0.01,0.824,6913,6891
18,13904,10,100,0.001,0.01,0.812,6958,6946
18,14004,10,100,0.001,0.01,0.808,7005,6999
18,14104,10,100,0.001,0.01,0.806,7062,7042
18,14204,10,100,0.001,0.01,0.83,7116,7088
18,14304,10,100,0.001,0.01,0.81,7157,7147
18,14404,10,100,0.001,0.01,0.838,7207,7197
18,14504,10,100,0.001,0.01,0.832,7257,7247
18,14604,10,100,0.001,0.01,0.812,7312,7292
18,14704,10,100,0.001,0.01,0.832,7357,7347
18,14804,10,100,0.001,0.01,0.832,7410,7394
18,14904,10,100,0.001,0.01,0.852,7458,7446
18,15004,10,100,0.001,0.01,0.83,7501,7503
19,104,10,100,0.001,0.01,0.52,53,51
19,204,10,100,0.001,0.01,0.508,95,109
19,304,10,100,0.001,0.01,0.494,147,157
19,404,10,100,0.001,0.01,0.516,193,211
19,504,10,100,0.001,0.01,0.51,242,262
19,604,10,100,0.001,0.01,0.502,293,311
19,704,10,100,0.001,0.01,0.51,336,368
19,804,10,100,0.001,0.01,0.504,392,412
19,904,10,100,0.001,0.01,0.526,437,467
19,1004,10,100,0.001,0.01,0.504,493,511
19,1104,10,100,0.001,0.01,0.476,547,557
19,1204,10,100,0.001,0.01,0.468,594,610
19,1304,10,100,0.001,0.01,0.47,651,653
19,1404,10,100,0.001,0.01,0.474,705,699
19,1504,10,100,0.001,0.01,0.484,757,747
19,1604,10,100,0.001,0.01,0.472,807,797
19,1704,10,100,0.001,0.01,0.504,855,849
19,1804,10,100,0.001,0.01,0.506,911,893
19,1904,10,100,0.001,0.01,0.476,960,944
19,2004,10,100,0.001,0.01,0.498,1003,1001
19,2104,10,100,0.001,0.01,0.502,1056,1048
19,2204,10,100,0.001,0.01,0.494,1102,1102
19,2304,10,100,0.001,0.01,0.478,1146,1158
19,2404,10,100,0.001,0.01,0.516,1199,1205
19,2504,10,100,0.001,0.01,0.474,1247,1257
19,2604,10,100,0.001,0.01,0.502,1305,1299
19,2704,10,100,0.001,0.01,0.514,1358,1346
19,2804,10,100,0.001,0.01,0.53,1416,1388
19,2904,10,100,0.001,0.01,0.532,1473,1431
19,3004,10,100,0.001,0.01,0.504,1520,1484
19,3104,10,100,0.001,0.01,0.558,1573,1531
19,3204,10,100,0.001,0.01,0.542,1627,1577
19,3304,10,100,0.001,0.01,0.524,1679,1625
19,3404,10,100,0.001,0.01,0.512,1724,1680
19,3504,10,100,0.001,0.01,0.572,1770,1734
19,3604,10,100,0.001,0.01,0.564,1815,1789
19,3704,10,100,0.001,0.01,0.57,1857,1847
19,3804,10,100,0.001,0.01,0.552,1907,1897
19,3904,10,100,0.001,0.01,0.544,1960,1944
19,4004,10,100,0.001,0.01,0.556,2019,1985
19,4104,10,100,0.001,0.01,0.554,2070,2034
19,4204,10,100,0.001,0.01,0.564,2124,2080
19,4304,10,100,0.001,0.01,0.576,2170,2134
19,4404,10,100,0.001,0.01,0.558,2211,2193
19,4504,10,100,0.001,0.01,0.586,2262,2242
19,4604,10,100,0.001,0.01,0.588,2310,2294
19,4704,10,100,0.001,0.01,0.57,2359,2345
19,4804,10,100,0.001,0.01,0.59,2409,2395
19,4904,10,100,0.001,0.01,0.606,2468,2436
19,5004,10,100,0.001,0.01,0.586,2518,2486
19,5104,10,100,0.001,0.01,0.584,2566,2538
19,5204,10,100,0.001,0.01,0.594,2615,2589
19,5304,10,100,0.001,0.01,0.592,2666,2638
19,5404,10,100,0.001,0.01,0.564,2723,2681
19,5504,10,100,0.001,0.01,0.588,2779,2725
19,5604,10,100,0.001,0.01,0.582,2825,2779
19,5704,10,100,0.001,0.01,0.614,2879,2825
19,5804,10,100,0.001,0.01,0.626,2922,2882
19,5904,10,100,0.001,0.01,0.598,2964,2940
19,6004,10,100,0.001,0.01,0.588,3013,2991
19,6104,10,100,0.001,0.01,0.612,3057,3047
19,6204,10,100,0.001,0.01,0.632,3107,3097
19,6304,10,100,0.001,0.01,0.646,3156,3148
19,6404,10,100,0.001,0.01,0.598,3208,3196
19,6504,10,100,0.001,0.01,0.598,3258,3246
19,6604,10,100,0.001,0.01,0.604,3318,3286
19,6704,10,100,0.001,0.01,0.61,3365,3339
19,6804,10,100,0.001,0.01,0.62,3423,3381
19,6904,10,100,0.001,0.01,0.632,3474,3430
19,7004,10,100,0.001,0.01,0.646,3522,3482
19,7104,10,100,0.001,0.01,0.596,3572,3532
19,7204,10,100,0.001,0.01,0.636,3621,3583
19,7304,10,100,0.001,0.01,0.648,3663,3641
19,7404,10,100,0.001,0.01,0.622,3717,3687
19,7504,10,100,0.001,0.01,0.64,3771,3733
19,7604,10,100,0.001,0.01,0.65,3824,3780
19,7704,10,100,0.001,0.01,0.638,3874,3830
19,7804,10,100,0.001,0.01,0.664,3924,3880
19,7904,10,100,0.001,0.01,0.648,3975,3929
19,8004,10,100,0.001,0.01,0.692,4029,3975
19,8104,10,100,0.001,0.01,0.698,4082,4022
19,8204,10,100,0.001,0.01,0.67,4135,4069
19,8304,10,100,0.001,0.01,0.68,4181,4123
19,8404,10,100,0.001,0.01,0.694,4228,4176
19,8504,10,100,0.001,0.01,0.708,4289,4215
19,8604,10,100,0.001,0.01,0.682,4342,4262
19,8704,10,100,0.001,0.01,0.702,4394,4310
19,8804,10,100,0.001,0.01,0.724,4447,4357
19,8904,10,100,0.001,0.01,0.734,4492,4412
19,9004,10,100,0.001,0.01,0.684,4542,4462
19,9104,10,100,0.001,0.01,0.72,4586,4518
19,9204,10,100,0.001,0.01,0.684,4635,4569
19,9304,10,100,0.001,0.01,0.702,4679,4625
19,9404,10,100,0.001,0.01,0.694,4725,4679
19,9504,10,100,0.001,0.01,0.706,4771,4733
19,9604,10,100,0.001,0.01,0.692,4832,4772
19,9704,10,100,0.001,0.01,0.716,4883,4821
19,9804,10,100,0.001,0.01,0.708,4933,4871
19,9904,10,100,0.001,0.01,0.752,4970,4934
19,10004,10,100,0.001,0.01,0.72,5020,4984
19,10104,10,100,0.001,0.01,0.734,5065,5039
19,10204,10,100,0.001,0.01,0.74,5123,5081
19,10304,10,100,0.001,0.01,0.712,5173,5131
19,10404,10,100,0.001,0.01,0.75,5209,5195
19,10504,10,100,0.001,0.01,0.758,5258,5246
19,10604,10,100,0.001,0.01,0.762,5305,5299
19,10704,10,100,0.001,0.01,0.754,5353,5351
19,10804,10,100,0.001,0.01,0.762,5395,5409
19,10904,10,100,0.001,0.01,0.734,5442,5462
19,11004,10,100,0.001,0.01,0.748,5491,5513
19,11104,10,100,0.001,0.01,0.748,5545,5559
19,11204,10,100,0.001,0.01,0.74,5589,5615
19,11304,10,100,0.001,0.01,0.752,5639,5665
19,11404,10,100,0.001,0.01,0.742,5684,5720
19,11504,10,100,0.001,0.01,0.784,5734,5770
19,11604,10,100,0.001,0.01,0.752,5787,5817
19,11704,10,100,0.001,0.01,0.762,5846,5858
19,11804,10,100,0.001,0.01,0.786,5895,5909
19,11904,10,100,0.001,0.01,0.784,5949,5955
19,12004,10,100,0.001,0.01,0.774,5996,6008
19,12104,10,100,0.001,0.01,0.766,6048,6056
19,12204,10,100,0.001,0.01,0.792,6100,6104
19,12304,10,100,0.001,0.01,0.78,6142,6162
19,12404,10,100,0.001,0.01,0.792,6190,6214
19,12504,10,100,0.001,0.01,0.786,6236,6268
19,12604,10,100,0.001,0.01,0.774,6283,6321
19,12704,10,100,0.001,0.01,0.774,6332,6372
19,12804,10,100,0.001,0.01,0.79,6383,6421
19,12904,10,100,0.001,0.01,0.802,6436,6468
19,13004,10,100,0.001,0.01,0.782,6499,6505
19,13104,10,100,0.001,0.01,0.788,6548,6556
19,13204,10,100,0.001,0.01,0.75,6612,6592
19,13304,10,100,0.001,0.01,0.774,6670,6634
19,13404,10,100,0.001,0.01,0.796,6720,6684
19,13504,10,100,0.001,0.01,0.786,6770,6734
19,13604,10,100,0.001,0.01,0.808,6820,6784
19,13704,10,100,0.001,0.01,0.798,6879,6825
19,13804,10,100,0.001,0.01,0.792,6934,6870
19,13904,10,100,0.001,0.01,0.824,6989,6915
19,14004,10,100,0.001,0.01,0.798,7041,6963
19,14104,10,100,0.001,0.01,0.814,7091,7013
19,14204,10,100,0.001,0.01,0.76,7136,7068
19,14304,10,100,0.001,0.01,0.816,7187,7117
19,14404,10,100,0.001,0.01,0.814,7239,7165
19,14504,10,100,0.001,0.01,0.846,7286,7218
19,14604,10,100,0.001,0.01,0.81,7327,7277
19,14704,10,100,0.001,0.01,0.848,7370,7334
19,14804,10,100,0.001,0.01,0.846,7412,7392
19,14904,10,100,0.001,0.01,0.844,7466,7438
19,15004,10,100,0.001,0.01,0.826,7514,7490
20,104,10,100,0.001,0.01,0.512,57,47
20,204,10,100,0.001,0.01,0.51,102,102
20,304,10,100,0.001,0.01,0.516,150,154
20,404,10,100,0.001,0.01,0.512,207,197
20,504,10,100,0.001,0.01,0.488,250,254
20,604,10,100,0.001,0.01,0.524,298,306
20,704,10,100,0.001,0.01,0.542,350,354
20,804,10,100,0.001,0.01,0.508,388,416
20,904,10,100,0.001,0.01,0.522,439,465
20,1004,10,100,0.001,0.01,0.532,492,512
20,1104,10,100,0.001,0.01,0.53,540,564
20,1204,10,100,0.001,0.01,0.502,590,614
20,1304,10,100,0.001,0.01,0.512,641,663
20,1404,10,100,0.001,0.01,0.51,691,713
20,1504,10,100,0.001,0.01,0.522,735,769
20,1604,10,100,0.001,0.01,0.532,789,815
20,1704,10,100,0.001,0.01,0.526,845,859
20,1804,10,100,0.001,0.01,0.566,894,910
20,1904,10,100,0.001,0.01,0.578,940,964
20,2004,10,100,0.001,0.01,0.584,997,1007
20,2104,10,100,0.001,0.01,0.632,1047,1057
20,2204,10,100,0.001,0.01,0.63,1105,1099
20,2304,10,100,0.001,0.01,0.656,1165,1139
20,2404,10,100,0.001,0.01,0.716,1216,1188
20,2504,10,100,0.001,0.01,0.74,1271,1233
20,2604,10,100,0.001,0.01,0.812,1324,1280
20,2704,10,100,0.001,0.01,0.8,1379,1325
20,2804,10,100,0.001,0.01,0.844,1425,1379
20,2904,10,100,0.001,0.01,0.898,1474,1430
20,3004,10,100,0.001,0.01,0.92,1525,1479
20,3104,10,100,0.001,0.01,0.922,1570,1534
20,3204,10,100,0.001,0.01,0.932,1621,1583
20,3304,10,100,0.001,0.01,0.948,1673,1631
20,3404,10,100,0.001,0.01,0.958,1721,1683
20,3504,10,100,0.001,0.01,0.95,1764,1740
20,3604,10,100,0.001,0.01,0.934,1811,1793
20,3704,10,100,0.001,0.01,0.96,1855,1849
20,3804,10,100,0.001,0.01,0.962,1915,1889
20,3904,10,100,0.001,0.01,0.95,1966,1938
20,4004,10,100,0.001,0.01,0.942,2016,1988
20,4104,10,100,0.001,0.01,0.952,2075,2029
20,4204,10,100,0.001,0.01,0.952,2134,2070
20,4304,10,100,0.001,0.01,0.962,2191,2113
20,4404,10,100,0.001,0.01,0.946,2244,2160
20,4504,10,100,0.001,0.01,0.968,2296,2208
20,4604,10,100,0.001,0.01,0.97,2335,2269
20,4704,10,100,0.001,0.01,0.962,2384,2320
20,4804,10,100,0.001,0.01,0.968,2433,2371
20,4904,10,100,0.001,0.01,0.968,2482,2422
20,5004,10,100,0.001,0.01,0.97,2530,2474
20,5104,10,100,0.001,0.01,0.974,2582,2522
20,5204,10,100,0.001,0.01,0.972,2637,2567
20,5304,10,100,0.001,0.01,0.97,2697,2607
20,5404,10,100,0.001,0.01,0.97,2741,2663
20,5504,10,100,0.001,0.01,0.968,2789,2715
20,5604,10,100,0.001,0.01,0.962,2838,2766
20,5704,10,100,0.001,0.01,0.964,2885,2819
20,5804,10,100,0.001,0.01,0.954,2929,2875
20,5904,10,100,0.001,0.01,0.974,2970,2934
20,6004,10,100,0.001,0.01,0.97,3025,2979
20,6104,10,100,0.001,0.01,0.97,3072,3032
20,6204,10,100,0.001,0.01,0.974,3127,3077
20,6304,10,100,0.001,0.01,0.972,3172,3132
20,6404,10,100,0.001,0.01,0.97,3229,3175
20,6504,10,100,0.001,0.01,0.982,3279,3225
20,6604,10,100,0.001,0.01,0.974,3334,3270
20,6704,10,100,0.001,0.01,0.98,3373,3331
20,6804,10,100,0.001,0.01,0.974,3417,3387
20,6904,10,100,0.001,0.01,0.97,3467,3437
20,7004,10,100,0.001,0.01,0.976,3514,3490
20,7104,10,100,0.001,0.01,0.984,3557,3547
20,7204,10,100,0.001,0.01,0.962,3605,3599
20,7304,10,100,0.001,0.01,0.968,3658,3646
20,7404,10,100,0.001,0.01,0.98,3705,3699
20,7504,10,100,0.001,0.01,0.984,3754,3750
20,7604,10,100,0.001,0.01,0.984,3806,3798
20,7704,10,100,0.001,0.01,0.98,3861,3843
20,7804,10,100,0.001,0.01,0.98,3919,3885
20,7904,10,100,0.001,0.01,0.94,3967,3937
20,8004,10,100,0.001,0.01,0.988,4013,3991
20,8104,10,100,0.001,0.01,0.984,4064,4040
20,8204,10,100,0.001,0.01,0.992,4112,4092
20,8304,10,100,0.001,0.01,0.99,4160,4144
20,8404,10,100,0.001,0.01,0.978,4216,4188
20,8504,10,100,0.001,0.01,0.99,4262,4242
20,8604,10,100,0.001,0.01,0.994,4306,4298
20,8704,10,100,0.001,0.01,0.992,4357,4347
20,8804,10,100,0.001,0.01,0.994,4410,4394
20,8904,10,100,0.001,0.01,0.988,4461,4443
20,9004,10,100,0.001,0.01,0.992,4511,4493
20,9104,10,100,0.001,0.01,0.99,4558,4546
20,9204,10,100,0.001,0.01,0.986,4610,4594
20,9304,10,100,0.001,0.01,0.984,4662,4642
20,9404,10,100,0.001,0.01,0.978,4717,4687
20,9504,10,100,0.001,0.01,0.984,4770,4734
20,9604,10,100,0.001,0.01,0.982,4809,4795
20,9704,10,100,0.001,0.01,0.978,4860,4844
20,9804,10,100,0.001,0.01,0.984,4910,4894
20,9904,10,100,0.001,0.01,0.962,4955,4949
20,10004,10,100,0.001,0.01,0.976,4995,5009
20,10104,10,100,0.001,0.01,0.986,5038,5066
20,10204,10,100,0.001,0.01,0.984,5092,5112
20,10304,10,100,0.001,0.01,0.986,5151,5153
20,10404,10,100,0.001,0.01,0.988,5210,5194
20,10504,10,100,0.001,0.01,0.992,5259,5245
20,10604,10,100,0.001,0.01,0.986,5313,5291
20,10704,10,100,0.001,0.01,0.994,5367,5337
20,10804,10,100,0.001,0.01,0.994,5423,5381
20,10904,10,100,0.001,0.01,0.992,5468,5436
20,11004,10,100,0.001,0.01,0.97,5517,5487
20,11104,10,100,0.001,0.01,0.956,5574,5530
20,11204,10,100,0.001,0.01,0.986,5630,5574
20,11304,10,100,0.001,0.01,0.988,5695,5609
20,11404,10,100,0.001,0.01,0.992,5737,5667
20,11504,10,100,0.001,0.01,0.992,5790,5714
20,11604,10,100,0.001,0.01,0.996,5833,5771
20,11704,10,100,0.001,0.01,0.998,5874,5830
20,11804,10,100,0.001,0.01,0.99,5931,5873
20,11904,10,100,0.001,0.01,0.992,5969,5935
20,12004,10,100,0.001,0.01,0.994,6020,5984
20,12104,10,100,0.001,0.01,0.992,6071,6033
20,12204,10,100,0.001,0.01,0.994,6122,6082
20,12304,10,100,0.001,0.01,0.994,6165,6139
20,12404,10,100,0.001,0.01,0.988,6213,6191
20,12504,10,100,0.001,0.01,0.992,6255,6249
20,12604,10,100,0.001,0.01,0.992,6298,6306
20,12704,10,100,0.001,0.01,0.996,6350,6354
20,12804,10,100,0.001,0.01,0.996,6394,6410
20,12904,10,100,0.001,0.01,0.994,6439,6465
20,13004,10,100,0.001,0.01,0.996,6488,6516
20,13104,10,100,0.001,0.01,0.996,6541,6563
20,13204,10,100,0.001,0.01,0.994,6596,6608
20,13304,10,100,0.001,0.01,0.994,6649,6655
20,13404,10,100,0.001,0.01,0.99,6704,6700
20,13504,10,100,0.001,0.01,0.99,6756,6748
20,13604,10,100,0.001,0.01,0.99,6807,6797
20,13704,10,100,0.001,0.01,0.996,6847,6857
20,13804,10,100,0.001,0.01,0.998,6898,6906
20,13904,10,100,0.001,0.01,0.99,6941,6963
20,14004,10,100,0.001,0.01,0.996,6995,7009
20,14104,10,100,0.001,0.01,0.994,7043,7061
20,14204,10,100,0.001,0.01,0.998,7098,7106
20,14304,10,100,0.001,0.01,0.996,7145,7159
20,14404,10,100,0.001,0.01,0.998,7197,7207
20,14504,10,100,0.001,0.01,1.0,7245,7259
20,14604,10,100,0.001,0.01,1.0,7291,7313
20,14704,10,100,0.001,0.01,1.0,7338,7366
20,14804,10,100,0.001,0.01,1.0,7396,7408
20,14904,10,100,0.001,0.01,1.0,7445,7459
20,15004,10,100,0.001,0.01,1.0,7496,7508
