trial,train_size,embed_dim,hidden_dim,alpha,learning_rate,accuracy,batch_pos,batch_neg
1,104,10,100,1e-05,0.01,0.504,52,52
1,204,10,100,1e-05,0.01,0.512,98,106
1,304,10,100,1e-05,0.01,0.5,146,158
1,404,10,100,1e-05,0.01,0.496,207,197
1,504,10,100,1e-05,0.01,0.502,256,248
1,604,10,100,1e-05,0.01,0.52,303,301
1,704,10,100,1e-05,0.01,0.532,354,350
1,804,10,100,1e-05,0.01,0.526,401,403
1,904,10,100,1e-05,0.01,0.54,448,456
1,1004,10,100,1e-05,0.01,0.528,499,505
1,1104,10,100,1e-05,0.01,0.494,544,560
1,1204,10,100,1e-05,0.01,0.502,594,610
1,1304,10,100,1e-05,0.01,0.518,637,667
1,1404,10,100,1e-05,0.01,0.534,686,718
1,1504,10,100,1e-05,0.01,0.51,733,771
1,1604,10,100,1e-05,0.01,0.498,778,826
1,1704,10,100,1e-05,0.01,0.502,830,874
1,1804,10,100,1e-05,0.01,0.536,877,927
1,1904,10,100,1e-05,0.01,0.53,929,975
1,2004,10,100,1e-05,0.01,0.524,973,1031
1,2104,10,100,1e-05,0.01,0.502,1022,1082
1,2204,10,100,1e-05,0.01,0.502,1064,1140
1,2304,10,100,1e-05,0.01,0.526,1113,1191
1,2404,10,100,1e-05,0.01,0.55,1168,1236
1,2504,10,100,1e-05,0.01,0.54,1229,1275
1,2604,10,100,1e-05,0.01,0.502,1271,1333
1,2704,10,100,1e-05,0.01,0.506,1312,1392
1,2804,10,100,1e-05,0.01,0.49,1364,1440
1,2904,10,100,1e-05,0.01,0.512,1413,1491
1,3004,10,100,1e-05,0.01,0.516,1463,1541
1,3104,10,100,1e-05,0.01,0.51,1523,1581
1,3204,10,100,1e-05,0.01,0.502,1580,1624
1,3304,10,100,1e-05,0.01,0.534,1633,1671
1,3404,10,100,1e-05,0.01,0.516,1683,1721
1,3504,10,100,1e-05,0.01,0.486,1734,1770
1,3604,10,100,1e-05,0.01,0.506,1792,1812
1,3704,10,100,1e-05,0.01,0.506,1836,1868
1,3804,10,100,1e-05,0.01,0.48,1889,1915
1,3904,10,100,1e-05,0.01,0.52,1946,1958
1,4004,10,100,1e-05,0.01,0.494,1992,2012
1,4104,10,100,1e-05,0.01,0.518,2046,2058
1,4204,10,100,1e-05,0.01,0.49,2092,2112
1,4304,10,100,1e-05,0.01,0.506,2142,2162
1,4404,10,100,1e-05,0.01,0.488,2188,2216
1,4504,10,100,1e-05,0.01,0.51,2240,2264
1,4604,10,100,1e-05,0.01,0.5,2299,2305
1,4704,10,100,1e-05,0.01,0.494,2346,2358
1,4804,10,100,1e-05,0.01,0.504,2396,2408
1,4904,10,100,1e-05,0.01,0.514,2442,2462
1,5004,10,100,1e-05,0.01,0.512,2491,2513
1,5104,10,100,1e-05,0.01,0.504,2542,2562
1,5204,10,100,1e-05,0.01,0.544,2594,2610
1,5304,10,100,1e-05,0.01,0.512,2649,2655
1,5404,10,100,1e-05,0.01,0.534,2703,2701
1,5504,10,100,1e-05,0.01,0.538,2754,2750
1,5604,10,100,1e-05,0.01,0.532,2795,2809
1,5704,10,100,1e-05,0.01,0.534,2848,2856
1,5804,10,100,1e-05,0.01,0.536,2891,2913
1,5904,10,100,1e-05,0.01,0.55,2943,2961
1,6004,10,100,1e-05,0.01,0.576,2993,3011
1,6104,10,100,1e-05,0.01,0.554,3036,3068
1,6204,10,100,1e-05,0.01,0.58,3081,3123
1,6304,10,100,1e-05,0.01,0.546,3136,3168
1,6404,10,100,1e-05,0.01,0.584,3189,3215
1,6504,10,100,1e-05,0.01,0.576,3240,3264
1,6604,10,100,1e-05,0.01,0.588,3284,3320
1,6704,10,100,1e-05,0.01,0.61,3342,3362
1,6804,10,100,1e-05,0.01,0.602,3395,3409
1,6904,10,100,1e-05,0.01,0.606,3444,3460
1,7004,10,100,1e-05,0.01,0.628,3497,3507
1,7104,10,100,1e-05,0.01,0.646,3548,3556
1,7204,10,100,1e-05,0.01,0.622,3595,3609
1,7304,10,100,1e-05,0.01,0.618,3651,3653
1,7404,10,100,1e-05,0.01,0.666,3708,3696
1,7504,10,100,1e-05,0.01,0.64,3757,3747
1,7604,10,100,1e-05,0.01,0.626,3805,3799
1,7704,10,100,1e-05,0.01,0.632,3854,3850
1,7804,10,100,1e-05,0.01,0.644,3900,3904
1,7904,10,100,1e-05,0.01,0.684,3956,3948
1,8004,10,100,1e-05,0.01,0.656,4006,3998
1,8104,10,100,1e-05,0.01,0.682,4063,4041
1,8204,10,100,1e-05,0.01,0.698,4108,4096
1,8304,10,100,1e-05,0.01,0.712,4152,4152
1,8404,10,100,1e-05,0.01,0.7,4202,4202
1,8504,10,100,1e-05,0.01,0.718,4254,4250
1,8604,10,100,1e-05,0.01,0.712,4298,4306
1,8704,10,100,1e-05,0.01,0.692,4354,4350
1,8804,10,100,1e-05,0.01,0.738,4401,4403
1,8904,10,100,1e-05,0.01,0.708,4444,4460
1,9004,10,100,1e-05,0.01,0.754,4489,4515
1,9104,10,100,1e-05,0.01,0.75,4532,4572
1,9204,10,100,1e-05,0.01,0.732,4583,4621
1,9304,10,100,1e-05,0.01,0.752,4627,4677
1,9404,10,100,1e-05,0.01,0.728,4675,4729
1,9504,10,100,1e-05,0.01,0.756,4724,4780
1,9604,10,100,1e-05,0.01,0.742,4776,4828
1,9704,10,100,1e-05,0.01,0.752,4829,4875
1,9804,10,100,1e-05,0.01,0.768,4888,4916
1,9904,10,100,1e-05,0.01,0.764,4938,4966
1,10004,10,100,1e-05,0.01,0.772,4990,5014
1,10104,10,100,1e-05,0.01,0.73,5048,5056
1,10204,10,100,1e-05,0.01,0.79,5105,5099
1,10304,10,100,1e-05,0.01,0.762,5155,5149
1,10404,10,100,1e-05,0.01,0.784,5206,5198
1,10504,10,100,1e-05,0.01,0.798,5263,5241
1,10604,10,100,1e-05,0.01,0.772,5319,5285
1,10704,10,100,1e-05,0.01,0.796,5368,5336
1,10804,10,100,1e-05,0.01,0.81,5414,5390
1,10904,10,100,1e-05,0.01,0.798,5464,5440
1,11004,10,100,1e-05,0.01,0.788,5513,5491
1,11104,10,100,1e-05,0.01,0.812,5564,5540
1,11204,10,100,1e-05,0.01,0.818,5607,5597
1,11304,10,100,1e-05,0.01,0.834,5655,5649
1,11404,10,100,1e-05,0.01,0.816,5706,5698
1,11504,10,100,1e-05,0.01,0.806,5749,5755
1,11604,10,100,1e-05,0.01,0.832,5792,5812
1,11704,10,100,1e-05,0.01,0.806,5842,5862
1,11804,10,100,1e-05,0.01,0.824,5899,5905
1,11904,10,100,1e-05,0.01,0.824,5945,5959
1,12004,10,100,1e-05,0.01,0.82,5996,6008
1,12104,10,100,1e-05,0.01,0.816,6044,6060
1,12204,10,100,1e-05,0.01,0.842,6094,6110
1,12304,10,100,1e-05,0.01,0.856,6141,6163
1,12404,10,100,1e-05,0.01,0.842,6186,6218
1,12504,10,100,1e-05,0.01,0.88,6232,6272
1,12604,10,100,1e-05,0.01,0.876,6285,6319
1,12704,10,100,1e-05,0.01,0.89,6334,6370
1,12804,10,100,1e-05,0.01,0.908,6393,6411
1,12904,10,100,1e-05,0.01,0.882,6436,6468
1,13004,10,100,1e-05,0.01,0.86,6487,6517
1,13104,10,100,1e-05,0.01,0.896,6535,6569
1,13204,10,100,1e-05,0.01,0.898,6576,6628
1,13304,10,100,1e-05,0.01,0.922,6631,6673
1,13404,10,100,1e-05,0.01,0.914,6682,6722
1,13504,10,100,1e-05,0.01,0.926,6734,6770
1,13604,10,100,1e-05,0.01,0.93,6797,6807
1,13704,10,100,1e-05,0.01,0.95,6836,6868
1,13804,10,100,1e-05,0.01,0.942,6884,6920
1,13904,10,100,1e-05,0.01,0.936,6930,6974
1,14004,10,100,1e-05,0.01,0.91,6988,7016
1,14104,10,100,1e-05,0.01,0.928,7040,7064
1,14204,10,100,1e-05,0.01,0.942,7090,7114
1,14304,10,100,1e-05,0.01,0.948,7132,7172
1,14404,10,100,1e-05,0.01,0.942,7183,7221
1,14504,10,100,1e-05,0.01,0.934,7238,7266
1,14604,10,100,1e-05,0.01,0.936,7291,7313
1,14704,10,100,1e-05,0.01,0.954,7339,7365
1,14804,10,100,1e-05,0.01,0.952,7397,7407
1,14904,10,100,1e-05,0.01,0.958,7445,7459
1,15004,10,100,1e-05,0.01,0.966,7501,7503
2,104,10,100,1e-05,0.01,0.508,67,37
2,204,10,100,1e-05,0.01,0.51,116,88
2,304,10,100,1e-05,0.01,0.538,159,145
2,404,10,100,1e-05,0.01,0.496,205,199
2,504,10,100,1e-05,0.01,0.516,252,252
2,604,10,100,1e-05,0.01,0.518,304,300
2,704,10,100,1e-05,0.01,0.526,351,353
2,804,10,100,1e-05,0.01,0.544,406,398
2,904,10,100,1e-05,0.01,0.534,456,448
2,1004,10,100,1e-05,0.01,0.532,508,496
2,1104,10,100,1e-05,0.01,0.56,557,547
2,1204,10,100,1e-05,0.01,0.552,607,597
2,1304,10,100,1e-05,0.01,0.546,657,647
2,1404,10,100,1e-05,0.01,0.532,702,702
2,1504,10,100,1e-05,0.01,0.536,750,754
2,1604,10,100,1e-05,0.01,0.502,806,798
2,1704,10,100,1e-05,0.01,0.56,845,859
2,1804,10,100,1e-05,0.01,0.512,889,915
2,1904,10,100,1e-05,0.01,0.512,935,969
2,2004,10,100,1e-05,0.01,0.522,980,1024
2,2104,10,100,1e-05,0.01,0.54,1026,1078
2,2204,10,100,1e-05,0.01,0.522,1082,1122
2,2304,10,100,1e-05,0.01,0.506,1129,1175
2,2404,10,100,1e-05,0.01,0.546,1181,1223
2,2504,10,100,1e-05,0.01,0.558,1229,1275
2,2604,10,100,1e-05,0.01,0.578,1282,1322
2,2704,10,100,1e-05,0.01,0.572,1332,1372
2,2804,10,100,1e-05,0.01,0.61,1387,1417
2,2904,10,100,1e-05,0.01,0.588,1438,1466
2,3004,10,100,1e-05,0.01,0.612,1482,1522
2,3104,10,100,1e-05,0.01,0.652,1534,1570
2,3204,10,100,1e-05,0.01,0.648,1584,1620
2,3304,10,100,1e-05,0.01,0.65,1635,1669
2,3404,10,100,1e-05,0.01,0.698,1680,1724
2,3504,10,100,1e-05,0.01,0.686,1728,1776
2,3604,10,100,1e-05,0.01,0.67,1778,1826
2,3704,10,100,1e-05,0.01,0.692,1831,1873
2,3804,10,100,1e-05,0.01,0.74,1872,1932
2,3904,10,100,1e-05,0.01,0.746,1923,1981
2,4004,10,100,1e-05,0.01,0.744,1968,2036
2,4104,10,100,1e-05,0.01,0.726,2021,2083
2,4204,10,100,1e-05,0.01,0.742,2063,2141
2,4304,10,100,1e-05,0.01,0.738,2103,2201
2,4404,10,100,1e-05,0.01,0.752,2146,2258
2,4504,10,100,1e-05,0.01,0.788,2196,2308
2,4604,10,100,1e-05,0.01,0.776,2250,2354
2,4704,10,100,1e-05,0.01,0.804,2297,2407
2,4804,10,100,1e-05,0.01,0.808,2349,2455
2,4904,10,100,1e-05,0.01,0.83,2390,2514
2,5004,10,100,1e-05,0.01,0.808,2450,2554
2,5104,10,100,1e-05,0.01,0.8,2510,2594
2,5204,10,100,1e-05,0.01,0.8,2566,2638
2,5304,10,100,1e-05,0.01,0.82,2619,2685
2,5404,10,100,1e-05,0.01,0.824,2669,2735
2,5504,10,100,1e-05,0.01,0.844,2719,2785
2,5604,10,100,1e-05,0.01,0.848,2765,2839
2,5704,10,100,1e-05,0.01,0.852,2815,2889
2,5804,10,100,1e-05,0.01,0.864,2862,2942
2,5904,10,100,1e-05,0.01,0.844,2915,2989
2,6004,10,100,1e-05,0.01,0.85,2968,3036
2,6104,10,100,1e-05,0.01,0.852,3013,3091
2,6204,10,100,1e-05,0.01,0.86,3062,3142
2,6304,10,100,1e-05,0.01,0.858,3105,3199
2,6404,10,100,1e-05,0.01,0.86,3162,3242
2,6504,10,100,1e-05,0.01,0.846,3211,3293
2,6604,10,100,1e-05,0.01,0.866,3255,3349
2,6704,10,100,1e-05,0.01,0.878,3302,3402
2,6804,10,100,1e-05,0.01,0.856,3352,3452
2,6904,10,100,1e-05,0.01,0.852,3403,3501
2,7004,10,100,1e-05,0.01,0.872,3456,3548
2,7104,10,100,1e-05,0.01,0.868,3501,3603
2,7204,10,100,1e-05,0.01,0.872,3551,3653
2,7304,10,100,1e-05,0.01,0.866,3607,3697
2,7404,10,100,1e-05,0.01,0.86,3660,3744
2,7504,10,100,1e-05,0.01,0.862,3709,3795
2,7604,10,100,1e-05,0.01,0.882,3751,3853
2,7704,10,100,1e-05,0.01,0.87,3799,3905
2,7804,10,100,1e-05,0.01,0.882,3844,3960
2,7904,10,100,1e-05,0.01,0.886,3897,4007
2,8004,10,100,1e-05,0.01,0.904,3951,4053
2,8104,10,100,1e-05,0.01,0.912,4000,4104
2,8204,10,100,1e-05,0.01,0.912,4053,4151
2,8304,10,100,1e-05,0.01,0.91,4100,4204
2,8404,10,100,1e-05,0.01,0.9,4152,4252
2,8504,10,100,1e-05,0.01,0.916,4207,4297
2,8604,10,100,1e-05,0.01,0.908,4262,4342
2,8704,10,100,1e-05,0.01,0.91,4305,4399
2,8804,10,100,1e-05,0.01,0.912,4362,4442
2,8904,10,100,1e-05,0.01,0.896,4412,4492
2,9004,10,100,1e-05,0.01,0.896,4450,4554
2,9104,10,100,1e-05,0.01,0.904,4498,4606
2,9204,10,100,1e-05,0.01,0.898,4551,4653
2,9304,10,100,1e-05,0.01,0.924,4598,4706
2,9404,10,100,1e-05,0.01,0.912,4649,4755
2,9504,10,100,1e-05,0.01,0.914,4707,4797
2,9604,10,100,1e-05,0.01,0.922,4766,4838
2,9704,10,100,1e-05,0.01,0.918,4810,4894
2,9804,10,100,1e-05,0.01,0.928,4859,4945
2,9904,10,100,1e-05,0.01,0.93,4908,4996
2,10004,10,100,1e-05,0.01,0.942,4959,5045
2,10104,10,100,1e-05,0.01,0.942,5005,5099
2,10204,10,100,1e-05,0.01,0.94,5057,5147
2,10304,10,100,1e-05,0.01,0.916,5107,5197
2,10404,10,100,1e-05,0.01,0.93,5155,5249
2,10504,10,100,1e-05,0.01,0.926,5203,5301
2,10604,10,100,1e-05,0.01,0.922,5249,5355
2,10704,10,100,1e-05,0.01,0.946,5300,5404
2,10804,10,100,1e-05,0.01,0.94,5353,5451
2,10904,10,100,1e-05,0.01,0.942,5401,5503
2,11004,10,100,1e-05,0.01,0.956,5450,5554
2,11104,10,100,1e-05,0.01,0.946,5494,5610
2,11204,10,100,1e-05,0.01,0.954,5543,5661
2,11304,10,100,1e-05,0.01,0.94,5601,5703
2,11404,10,100,1e-05,0.01,0.938,5653,5751
2,11504,10,100,1e-05,0.01,0.93,5716,5788
2,11604,10,100,1e-05,0.01,0.938,5770,5834
2,11704,10,100,1e-05,0.01,0.936,5820,5884
2,11804,10,100,1e-05,0.01,0.954,5865,5939
2,11904,10,100,1e-05,0.01,0.956,5918,5986
2,12004,10,100,1e-05,0.01,0.956,5978,6026
2,12104,10,100,1e-05,0.01,0.958,6024,6080
2,12204,10,100,1e-05,0.01,0.952,6082,6122
2,12304,10,100,1e-05,0.01,0.964,6133,6171
2,12404,10,100,1e-05,0.01,0.964,6186,6218
2,12504,10,100,1e-05,0.01,0.964,6234,6270
2,12604,10,100,1e-05,0.01,0.946,6280,6324
2,12704,10,100,1e-05,0.01,0.948,6337,6367
2,12804,10,100,1e-05,0.01,0.948,6395,6409
2,12904,10,100,1e-05,0.01,0.952,6437,6467
2,13004,10,100,1e-05,0.01,0.938,6486,6518
2,13104,10,100,1e-05,0.01,0.932,6532,6572
2,13204,10,100,1e-05,0.01,0.944,6586,6618
2,13304,10,100,1e-05,0.01,0.97,6639,6665
2,13404,10,100,1e-05,0.01,0.972,6681,6723
2,13504,10,100,1e-05,0.01,0.966,6729,6775
2,13604,10,100,1e-05,0.01,0.974,6785,6819
2,13704,10,100,1e-05,0.01,0.974,6839,6865
2,13804,10,100,1e-05,0.01,0.974,6888,6916
2,13904,10,100,1e-05,0.01,0.974,6944,6960
2,14004,10,100,1e-05,0.01,0.97,7000,7004
2,14104,10,100,1e-05,0.01,0.972,7040,7064
2,14204,10,100,1e-05,0.01,0.962,7091,7113
2,14304,10,100,1e-05,0.01,0.968,7146,7158
2,14404,10,100,1e-05,0.01,0.968,7194,7210
2,14504,10,100,1e-05,0.01,0.976,7252,7252
2,14604,10,100,1e-05,0.01,0.984,7301,7303
2,14704,10,100,1e-05,0.01,0.982,7356,7348
2,14804,10,100,1e-05,0.01,0.974,7406,7398
2,14904,10,100,1e-05,0.01,0.972,7451,7453
2,15004,10,100,1e-05,0.01,0.978,7498,7506
3,104,10,100,1e-05,0.01,0.492,55,49
3,204,10,100,1e-05,0.01,0.522,93,111
3,304,10,100,1e-05,0.01,0.522,148,156
3,404,10,100,1e-05,0.01,0.504,205,199
3,504,10,100,1e-05,0.01,0.5,247,257
3,604,10,100,1e-05,0.01,0.498,298,306
3,704,10,100,1e-05,0.01,0.46,363,341
3,804,10,100,1e-05,0.01,0.488,406,398
3,904,10,100,1e-05,0.01,0.52,459,445
3,1004,10,100,1e-05,0.01,0.482,506,498
3,1104,10,100,1e-05,0.01,0.456,561,543
3,1204,10,100,1e-05,0.01,0.472,605,599
3,1304,10,100,1e-05,0.01,0.464,655,649
3,1404,10,100,1e-05,0.01,0.472,711,693
3,1504,10,100,1e-05,0.01,0.494,752,752
3,1604,10,100,1e-05,0.01,0.51,805,799
3,1704,10,100,1e-05,0.01,0.512,862,842
3,1804,10,100,1e-05,0.01,0.498,918,886
3,1904,10,100,1e-05,0.01,0.486,967,937
3,2004,10,100,1e-05,0.01,0.504,1027,977
3,2104,10,100,1e-05,0.01,0.504,1080,1024
3,2204,10,100,1e-05,0.01,0.494,1138,1066
3,2304,10,100,1e-05,0.01,0.5,1187,1117
3,2404,10,100,1e-05,0.01,0.498,1236,1168
3,2504,10,100,1e-05,0.01,0.51,1284,1220
3,2604,10,100,1e-05,0.01,0.518,1335,1269
3,2704,10,100,1e-05,0.01,0.534,1393,1311
3,2804,10,100,1e-05,0.01,0.518,1444,1360
3,2904,10,100,1e-05,0.01,0.548,1495,1409
3,3004,10,100,1e-05,0.01,0.544,1544,1460
3,3104,10,100,1e-05,0.01,0.554,1592,1512
3,3204,10,100,1e-05,0.01,0.568,1641,1563
3,3304,10,100,1e-05,0.01,0.586,1684,1620
3,3404,10,100,1e-05,0.01,0.592,1731,1673
3,3504,10,100,1e-05,0.01,0.586,1787,1717
3,3604,10,100,1e-05,0.01,0.598,1832,1772
3,3704,10,100,1e-05,0.01,0.642,1877,1827
3,3804,10,100,1e-05,0.01,0.64,1926,1878
3,3904,10,100,1e-05,0.01,0.614,1966,1938
3,4004,10,100,1e-05,0.01,0.636,2014,1990
3,4104,10,100,1e-05,0.01,0.658,2063,2041
3,4204,10,100,1e-05,0.01,0.66,2103,2101
3,4304,10,100,1e-05,0.01,0.618,2144,2160
3,4404,10,100,1e-05,0.01,0.614,2195,2209
3,4504,10,100,1e-05,0.01,0.642,2251,2253
3,4604,10,100,1e-05,0.01,0.666,2304,2300
3,4704,10,100,1e-05,0.01,0.682,2353,2351
3,4804,10,100,1e-05,0.01,0.664,2409,2395
3,4904,10,100,1e-05,0.01,0.664,2460,2444
3,5004,10,100,1e-05,0.01,0.696,2515,2489
3,5104,10,100,1e-05,0.01,0.7,2563,2541
3,5204,10,100,1e-05,0.01,0.69,2614,2590
3,5304,10,100,1e-05,0.01,0.7,2665,2639
3,5404,10,100,1e-05,0.01,0.724,2715,2689
3,5504,10,100,1e-05,0.01,0.736,2762,2742
3,5604,10,100,1e-05,0.01,0.746,2816,2788
3,5704,10,100,1e-05,0.01,0.708,2865,2839
3,5804,10,100,1e-05,0.01,0.74,2912,2892
3,5904,10,100,1e-05,0.01,0.768,2963,2941
3,6004,10,100,1e-05,0.01,0.764,3011,2993
3,6104,10,100,1e-05,0.01,0.756,3059,3045
3,6204,10,100,1e-05,0.01,0.73,3109,3095
3,6304,10,100,1e-05,0.01,0.75,3162,3142
3,6404,10,100,1e-05,0.01,0.758,3213,3191
3,6504,10,100,1e-05,0.01,0.778,3258,3246
3,6604,10,100,1e-05,0.01,0.78,3306,3298
3,6704,10,100,1e-05,0.01,0.776,3349,3355
3,6804,10,100,1e-05,0.01,0.79,3398,3406
3,6904,10,100,1e-05,0.01,0.8,3447,3457
3,7004,10,100,1e-05,0.01,0.762,3494,3510
3,7104,10,100,1e-05,0.01,0.688,3551,3553
3,7204,10,100,1e-05,0.01,0.744,3603,3601
3,7304,10,100,1e-05,0.01,0.744,3658,3646
3,7404,10,100,1e-05,0.01,0.754,3714,3690
3,7504,10,100,1e-05,0.01,0.788,3758,3746
3,7604,10,100,1e-05,0.01,0.778,3807,3797
3,7704,10,100,1e-05,0.01,0.744,3862,3842
3,7804,10,100,1e-05,0.01,0.754,3915,3889
3,7904,10,100,1e-05,0.01,0.81,3965,3939
3,8004,10,100,1e-05,0.01,0.778,4017,3987
3,8104,10,100,1e-05,0.01,0.762,4062,4042
3,8204,10,100,1e-05,0.01,0.834,4119,4085
3,8304,10,100,1e-05,0.01,0.812,4167,4137
3,8404,10,100,1e-05,0.01,0.832,4212,4192
3,8504,10,100,1e-05,0.01,0.818,4257,4247
3,8604,10,100,1e-05,0.01,0.858,4304,4300
3,8704,10,100,1e-05,0.01,0.84,4352,4352
3,8804,10,100,1e-05,0.01,0.84,4406,4398
3,8904,10,100,1e-05,0.01,0.836,4457,4447
3,9004,10,100,1e-05,0.01,0.85,4509,4495
3,9104,10,100,1e-05,0.01,0.846,4548,4556
3,9204,10,100,1e-05,0.01,0.878,4600,4604
3,9304,10,100,1e-05,0.01,0.872,4646,4658
3,9404,10,100,1e-05,0.01,0.868,4693,4711
3,9504,10,100,1e-05,0.01,0.858,4748,4756
3,9604,10,100,1e-05,0.01,0.856,4794,4810
3,9704,10,100,1e-05,0.01,0.896,4844,4860
3,9804,10,100,1e-05,0.01,0.872,4896,4908
3,9904,10,100,1e-05,0.01,0.882,4944,4960
3,10004,10,100,1e-05,0.01,0.902,4993,5011
3,10104,10,100,1e-05,0.01,0.892,5036,5068
3,10204,10,100,1e-05,0.01,0.894,5084,5120
3,10304,10,100,1e-05,0.01,0.908,5137,5167
3,10404,10,100,1e-05,0.01,0.902,5191,5213
3,10504,10,100,1e-05,0.01,0.92,5239,5265
3,10604,10,100,1e-05,0.01,0.92,5288,5316
3,10704,10,100,1e-05,0.01,0.92,5339,5365
3,10804,10,100,1e-05,0.01,0.922,5387,5417
3,10904,10,100,1e-05,0.01,0.93,5431,5473
3,11004,10,100,1e-05,0.01,0.91,5492,5512
3,11104,10,100,1e-05,0.01,0.92,5545,5559
3,11204,10,100,1e-05,0.01,0.924,5594,5610
3,11304,10,100,1e-05,0.01,0.922,5643,5661
3,11404,10,100,1e-05,0.01,0.926,5690,5714
3,11504,10,100,1e-05,0.01,0.926,5739,5765
3,11604,10,100,1e-05,0.01,0.926,5794,5810
3,11704,10,100,1e-05,0.01,0.938,5847,5857
3,11804,10,100,1e-05,0.01,0.932,5897,5907
3,11904,10,100,1e-05,0.01,0.932,5943,5961
3,12004,10,100,1e-05,0.01,0.946,5977,6027
3,12104,10,100,1e-05,0.01,0.946,6031,6073
3,12204,10,100,1e-05,0.01,0.934,6082,6122
3,12304,10,100,1e-05,0.01,0.948,6133,6171
3,12404,10,100,1e-05,0.01,0.938,6192,6212
3,12504,10,100,1e-05,0.01,0.942,6245,6259
3,12604,10,100,1e-05,0.01,0.942,6303,6301
3,12704,10,100,1e-05,0.01,0.952,6352,6352
3,12804,10,100,1e-05,0.01,0.962,6399,6405
3,12904,10,100,1e-05,0.01,0.954,6453,6451
3,13004,10,100,1e-05,0.01,0.96,6508,6496
3,13104,10,100,1e-05,0.01,0.964,6555,6549
3,13204,10,100,1e-05,0.01,0.964,6601,6603
3,13304,10,100,1e-05,0.01,0.94,6648,6656
3,13404,10,100,1e-05,0.01,0.962,6692,6712
3,13504,10,100,1e-05,0.01,0.97,6740,6764
3,13604,10,100,1e-05,0.01,0.97,6793,6811
3,13704,10,100,1e-05,0.01,0.972,6839,6865
3,13804,10,100,1e-05,0.01,0.978,6888,6916
3,13904,10,100,1e-05,0.01,0.978,6937,6967
3,14004,10,100,1e-05,0.01,0.976,6990,7014
3,14104,10,100,1e-05,0.01,0.928,7032,7072
3,14204,10,100,1e-05,0.01,0.97,7089,7115
3,14304,10,100,1e-05,0.01,0.972,7136,7168
3,14404,10,100,1e-05,0.01,0.986,7180,7224
3,14504,10,100,1e-05,0.01,0.986,7234,7270
3,14604,10,100,1e-05,0.01,0.972,7282,7322
3,14704,10,100,1e-05,0.01,0.982,7329,7375
3,14804,10,100,1e-05,0.01,0.976,7390,7414
3,14904,10,100,1e-05,0.01,0.984,7448,7456
3,15004,10,100,1e-05,0.01,0.982,7498,7506
4,104,10,100,1e-05,0.01,0.49,55,49
4,204,10,100,1e-05,0.01,0.502,99,105
4,304,10,100,1e-05,0.01,0.532,144,160
4,404,10,100,1e-05,0.01,0.514,198,206
4,504,10,100,1e-05,0.01,0.546,251,253
4,604,10,100,1e-05,0.01,0.526,292,312
4,704,10,100,1e-05,0.01,0.522,337,367
4,804,10,100,1e-05,0.01,0.504,393,411
4,904,10,100,1e-05,0.01,0.534,436,468
4,1004,10,100,1e-05,0.01,0.544,486,518
4,1104,10,100,1e-05,0.01,0.49,536,568
4,1204,10,100,1e-05,0.01,0.522,586,618
4,1304,10,100,1e-05,0.01,0.508,643,661
4,1404,10,100,1e-05,0.01,0.522,705,699
4,1504,10,100,1e-05,0.01,0.506,757,747
4,1604,10,100,1e-05,0.01,0.552,809,795
4,1704,10,100,1e-05,0.01,0.524,856,848
4,1804,10,100,1e-05,0.01,0.53,910,894
4,1904,10,100,1e-05,0.01,0.514,969,935
4,2004,10,100,1e-05,0.01,0.536,1035,969
4,2104,10,100,1e-05,0.01,0.564,1087,1017
4,2204,10,100,1e-05,0.01,0.538,1143,1061
4,2304,10,100,1e-05,0.01,0.574,1189,1115
4,2404,10,100,1e-05,0.01,0.574,1244,1160
4,2504,10,100,1e-05,0.01,0.584,1284,1220
4,2604,10,100,1e-05,0.01,0.612,1343,1261
4,2704,10,100,1e-05,0.01,0.632,1403,1301
4,2804,10,100,1e-05,0.01,0.596,1456,1348
4,2904,10,100,1e-05,0.01,0.682,1504,1400
4,3004,10,100,1e-05,0.01,0.646,1549,1455
4,3104,10,100,1e-05,0.01,0.702,1601,1503
4,3204,10,100,1e-05,0.01,0.716,1657,1547
4,3304,10,100,1e-05,0.01,0.71,1709,1595
4,3404,10,100,1e-05,0.01,0.702,1753,1651
4,3504,10,100,1e-05,0.01,0.72,1812,1692
4,3604,10,100,1e-05,0.01,0.752,1866,1738
4,3704,10,100,1e-05,0.01,0.742,1922,1782
4,3804,10,100,1e-05,0.01,0.742,1982,1822
4,3904,10,100,1e-05,0.01,0.776,2036,1868
4,4004,10,100,1e-05,0.01,0.77,2081,1923
4,4104,10,100,1e-05,0.01,0.742,2134,1970
4,4204,10,100,1e-05,0.01,0.76,2189,2015
4,4304,10,100,1e-05,0.01,0.784,2228,2076
4,4404,10,100,1e-05,0.01,0.806,2277,2127
4,4504,10,100,1e-05,0.01,0.798,2325,2179
4,4604,10,100,1e-05,0.01,0.796,2372,2232
4,4704,10,100,1e-05,0.01,0.776,2422,2282
4,4804,10,100,1e-05,0.01,0.758,2471,2333
4,4904,10,100,1e-05,0.01,0.774,2521,2383
4,5004,10,100,1e-05,0.01,0.834,2573,2431
4,5104,10,100,1e-05,0.01,0.824,2619,2485
4,5204,10,100,1e-05,0.01,0.814,2667,2537
4,5304,10,100,1e-05,0.01,0.814,2722,2582
4,5404,10,100,1e-05,0.01,0.828,2767,2637
4,5504,10,100,1e-05,0.01,0.82,2826,2678
4,5604,10,100,1e-05,0.01,0.824,2875,2729
4,5704,10,100,1e-05,0.01,0.836,2932,2772
4,5804,10,100,1e-05,0.01,0.828,2981,2823
4,5904,10,100,1e-05,0.01,0.88,3032,2872
4,6004,10,100,1e-05,0.01,0.876,3079,2925
4,6104,10,100,1e-05,0.01,0.882,3129,2975
4,6204,10,100,1e-05,0.01,0.894,3174,3030
4,6304,10,100,1e-05,0.01,0.9,3218,3086
4,6404,10,100,1e-05,0.01,0.88,3278,3126
4,6504,10,100,1e-05,0.01,0.884,3331,3173
4,6604,10,100,1e-05,0.01,0.902,3382,3222
4,6704,10,100,1e-05,0.01,0.892,3433,3271
4,6804,10,100,1e-05,0.01,0.924,3478,3326
4,6904,10,100,1e-05,0.01,0.902,3531,3373
4,7004,10,100,1e-05,0.01,0.898,3582,3422
4,7104,10,100,1e-05,0.01,0.892,3623,3481
4,7204,10,100,1e-05,0.01,0.89,3670,3534
4,7304,10,100,1e-05,0.01,0.888,3713,3591
4,7404,10,100,1e-05,0.01,0.9,3759,3645
4,7504,10,100,1e-05,0.01,0.922,3806,3698
4,7604,10,100,1e-05,0.01,0.93,3864,3740
4,7704,10,100,1e-05,0.01,0.924,3914,3790
4,7804,10,100,1e-05,0.01,0.924,3960,3844
4,7904,10,100,1e-05,0.01,0.924,4005,3899
4,8004,10,100,1e-05,0.01,0.932,4048,3956
4,8104,10,100,1e-05,0.01,0.936,4101,4003
4,8204,10,100,1e-05,0.01,0.936,4151,4053
4,8304,10,100,1e-05,0.01,0.938,4200,4104
4,8404,10,100,1e-05,0.01,0.93,4251,4153
4,8504,10,100,1e-05,0.01,0.92,4304,4200
4,8604,10,100,1e-05,0.01,0.904,4353,4251
4,8704,10,100,1e-05,0.01,0.878,4410,4294
4,8804,10,100,1e-05,0.01,0.936,4460,4344
4,8904,10,100,1e-05,0.01,0.93,4511,4393
4,9004,10,100,1e-05,0.01,0.942,4552,4452
4,9104,10,100,1e-05,0.01,0.946,4610,4494
4,9204,10,100,1e-05,0.01,0.946,4660,4544
4,9304,10,100,1e-05,0.01,0.944,4707,4597
4,9404,10,100,1e-05,0.01,0.942,4749,4655
4,9504,10,100,1e-05,0.01,0.96,4804,4700
4,9604,10,100,1e-05,0.01,0.96,4858,4746
4,9704,10,100,1e-05,0.01,0.956,4901,4803
4,9804,10,100,1e-05,0.01,0.95,4950,4854
4,9904,10,100,1e-05,0.01,0.95,5005,4899
4,10004,10,100,1e-05,0.01,0.93,5053,4951
4,10104,10,100,1e-05,0.01,0.948,5100,5004
4,10204,10,100,1e-05,0.01,0.956,5159,5045
4,10304,10,100,1e-05,0.01,0.952,5201,5103
4,10404,10,100,1e-05,0.01,0.958,5250,5154
4,10504,10,100,1e-05,0.01,0.976,5293,5211
4,10604,10,100,1e-05,0.01,0.966,5336,5268
4,10704,10,100,1e-05,0.01,0.98,5385,5319
4,10804,10,100,1e-05,0.01,0.978,5436,5368
4,10904,10,100,1e-05,0.01,0.98,5482,5422
4,11004,10,100,1e-05,0.01,0.976,5527,5477
4,11104,10,100,1e-05,0.01,0.982,5579,5525
4,11204,10,100,1e-05,0.01,0.978,5642,5562
4,11304,10,100,1e-05,0.01,0.976,5691,5613
4,11404,10,100,1e-05,0.01,0.958,5738,5666
4,11504,10,100,1e-05,0.01,0.972,5787,5717
4,11604,10,100,1e-05,0.01,0.956,5831,5773
4,11704,10,100,1e-05,0.01,0.91,5876,5828
4,11804,10,100,1e-05,0.01,0.972,5931,5873
4,11904,10,100,1e-05,0.01,0.988,5976,5928
4,12004,10,100,1e-05,0.01,0.98,6024,5980
4,12104,10,100,1e-05,0.01,0.988,6078,6026
4,12204,10,100,1e-05,0.01,0.984,6129,6075
4,12304,10,100,1e-05,0.01,0.99,6174,6130
4,12404,10,100,1e-05,0.01,0.982,6222,6182
4,12504,10,100,1e-05,0.01,0.966,6266,6238
4,12604,10,100,1e-05,0.01,0.974,6316,6288
4,12704,10,100,1e-05,0.01,0.974,6353,6351
4,12804,10,100,1e-05,0.01,0.982,6404,6400
4,12904,10,100,1e-05,0.01,0.986,6448,6456
4,13004,10,100,1e-05,0.01,0.988,6501,6503
4,13104,10,100,1e-05,0.01,0.988,6551,6553
4,13204,10,100,1e-05,0.01,0.988,6597,6607
4,13304,10,100,1e-05,0.01,0.99,6646,6658
4,13404,10,100,1e-05,0.01,0.99,6698,6706
4,13504,10,100,1e-05,0.01,0.99,6748,6756
4,13604,10,100,1e-05,0.01,0.988,6807,6797
4,13704,10,100,1e-05,0.01,0.986,6853,6851
4,13804,10,100,1e-05,0.01,0.986,6906,6898
4,13904,10,100,1e-05,0.01,0.984,6962,6942
4,14004,10,100,1e-05,0.01,0.978,7012,6992
4,14104,10,100,1e-05,0.01,0.986,7062,7042
4,14204,10,100,1e-05,0.01,0.978,7107,7097
4,14304,10,100,1e-05,0.01,0.984,7151,7153
4,14404,10,100,1e-05,0.01,0.974,7204,7200
4,14504,10,100,1e-05,0.01,0.988,7260,7244
4,14604,10,100,1e-05,0.01,0.992,7311,7293
4,14704,10,100,1e-05,0.01,0.988,7359,7345
4,14804,10,100,1e-05,0.01,0.984,7405,7399
4,14904,10,100,1e-05,0.01,0.992,7458,7446
4,15004,10,100,1e-05,0.01,0.99,7507,7497
5,104,10,100,1e-05,0.01,0.464,42,62
5,204,10,100,1e-05,0.01,0.458,100,104
5,304,10,100,1e-05,0.01,0.502,158,146
5,404,10,100,1e-05,0.01,0.486,208,196
5,504,10,100,1e-05,0.01,0.51,252,252
5,604,10,100,1e-05,0.01,0.49,302,302
5,704,10,100,1e-05,0.01,0.502,358,346
5,804,10,100,1e-05,0.01,0.528,407,397
5,904,10,100,1e-05,0.01,0.48,449,455
5,1004,10,100,1e-05,0.01,0.468,496,508
5,1104,10,100,1e-05,0.01,0.482,544,560
5,1204,10,100,1e-05,0.01,0.482,591,613
5,1304,10,100,1e-05,0.01,0.472,641,663
5,1404,10,100,1e-05,0.01,0.464,687,717
5,1504,10,100,1e-05,0.01,0.44,735,769
5,1604,10,100,1e-05,0.01,0.462,785,819
5,1704,10,100,1e-05,0.01,0.506,828,876
5,1804,10,100,1e-05,0.01,0.482,873,931
5,1904,10,100,1e-05,0.01,0.498,914,990
5,2004,10,100,1e-05,0.01,0.498,971,1033
5,2104,10,100,1e-05,0.01,0.538,1015,1089
5,2204,10,100,1e-05,0.01,0.51,1071,1133
5,2304,10,100,1e-05,0.01,0.54,1126,1178
5,2404,10,100,1e-05,0.01,0.57,1174,1230
5,2504,10,100,1e-05,0.01,0.59,1223,1281
5,2604,10,100,1e-05,0.01,0.618,1267,1337
5,2704,10,100,1e-05,0.01,0.63,1318,1386
5,2804,10,100,1e-05,0.01,0.644,1371,1433
5,2904,10,100,1e-05,0.01,0.65,1419,1485
5,3004,10,100,1e-05,0.01,0.698,1475,1529
5,3104,10,100,1e-05,0.01,0.726,1529,1575
5,3204,10,100,1e-05,0.01,0.744,1571,1633
5,3304,10,100,1e-05,0.01,0.762,1628,1676
5,3404,10,100,1e-05,0.01,0.78,1679,1725
5,3504,10,100,1e-05,0.01,0.696,1734,1770
5,3604,10,100,1e-05,0.01,0.762,1779,1825
5,3704,10,100,1e-05,0.01,0.778,1826,1878
5,3804,10,100,1e-05,0.01,0.776,1878,1926
5,3904,10,100,1e-05,0.01,0.79,1928,1976
5,4004,10,100,1e-05,0.01,0.814,1973,2031
5,4104,10,100,1e-05,0.01,0.802,2025,2079
5,4204,10,100,1e-05,0.01,0.818,2077,2127
5,4304,10,100,1e-05,0.01,0.84,2125,2179
5,4404,10,100,1e-05,0.01,0.858,2174,2230
5,4504,10,100,1e-05,0.01,0.862,2232,2272
5,4604,10,100,1e-05,0.01,0.862,2285,2319
5,4704,10,100,1e-05,0.01,0.856,2338,2366
5,4804,10,100,1e-05,0.01,0.868,2376,2428
5,4904,10,100,1e-05,0.01,0.888,2423,2481
5,5004,10,100,1e-05,0.01,0.88,2477,2527
5,5104,10,100,1e-05,0.01,0.866,2533,2571
5,5204,10,100,1e-05,0.01,0.9,2580,2624
5,5304,10,100,1e-05,0.01,0.868,2629,2675
5,5404,10,100,1e-05,0.01,0.886,2679,2725
5,5504,10,100,1e-05,0.01,0.898,2737,2767
5,5604,10,100,1e-05,0.01,0.902,2791,2813
5,5704,10,100,1e-05,0.01,0.888,2839,2865
5,5804,10,100,1e-05,0.01,0.896,2878,2926
5,5904,10,100,1e-05,0.01,0.918,2933,2971
5,6004,10,100,1e-05,0.01,0.914,2991,3013
5,6104,10,100,1e-05,0.01,0.908,3043,3061
5,6204,10,100,1e-05,0.01,0.912,3091,3113
5,6304,10,100,1e-05,0.01,0.928,3142,3162
5,6404,10,100,1e-05,0.01,0.902,3198,3206
5,6504,10,100,1e-05,0.01,0.91,3246,3258
5,6604,10,100,1e-05,0.01,0.93,3303,3301
5,6704,10,100,1e-05,0.01,0.932,3346,3358
5,6804,10,100,1e-05,0.01,0.944,3397,3407
5,6904,10,100,1e-05,0.01,0.93,3444,3460
5,7004,10,100,1e-05,0.01,0.92,3489,3515
5,7104,10,100,1e-05,0.01,0.918,3538,3566
5,7204,10,100,1e-05,0.01,0.918,3592,3612
5,7304,10,100,1e-05,0.01,0.952,3641,3663
5,7404,10,100,1e-05,0.01,0.946,3687,3717
5,7504,10,100,1e-05,0.01,0.946,3730,3774
5,7604,10,100,1e-05,0.01,0.948,3777,3827
5,7704,10,100,1e-05,0.01,0.954,3834,3870
5,7804,10,100,1e-05,0.01,0.952,3882,3922
5,7904,10,100,1e-05,0.01,0.952,3935,3969
5,8004,10,100,1e-05,0.01,0.96,3992,4012
5,8104,10,100,1e-05,0.01,0.962,4037,4067
5,8204,10,100,1e-05,0.01,0.962,4084,4120
5,8304,10,100,1e-05,0.01,0.97,4139,4165
5,8404,10,100,1e-05,0.01,0.966,4191,4213
5,8504,10,100,1e-05,0.01,0.966,4243,4261
5,8604,10,100,1e-05,0.01,0.956,4296,4308
5,8704,10,100,1e-05,0.01,0.964,4351,4353
5,8804,10,100,1e-05,0.01,0.956,4399,4405
5,8904,10,100,1e-05,0.01,0.94,4449,4455
5,9004,10,100,1e-05,0.01,0.956,4503,4501
5,9104,10,100,1e-05,0.01,0.972,4549,4555
5,9204,10,100,1e-05,0.01,0.98,4590,4614
5,9304,10,100,1e-05,0.01,0.98,4634,4670
5,9404,10,100,1e-05,0.01,0.978,4683,4721
5,9504,10,100,1e-05,0.01,0.976,4732,4772
5,9604,10,100,1e-05,0.01,0.972,4781,4823
5,9704,10,100,1e-05,0.01,0.978,4834,4870
5,9804,10,100,1e-05,0.01,0.97,4878,4926
5,9904,10,100,1e-05,0.01,0.976,4935,4969
5,10004,10,100,1e-05,0.01,0.98,4979,5025
5,10104,10,100,1e-05,0.01,0.98,5016,5088
5,10204,10,100,1e-05,0.01,0.978,5060,5144
5,10304,10,100,1e-05,0.01,0.976,5125,5179
5,10404,10,100,1e-05,0.01,0.982,5181,5223
5,10504,10,100,1e-05,0.01,0.968,5223,5281
5,10604,10,100,1e-05,0.01,0.978,5285,5319
5,10704,10,100,1e-05,0.01,0.986,5342,5362
5,10804,10,100,1e-05,0.01,0.984,5388,5416
5,10904,10,100,1e-05,0.01,0.986,5438,5466
5,11004,10,100,1e-05,0.01,0.978,5490,5514
5,11104,10,100,1e-05,0.01,0.984,5535,5569
5,11204,10,100,1e-05,0.01,0.986,5586,5618
5,11304,10,100,1e-05,0.01,0.982,5633,5671
5,11404,10,100,1e-05,0.01,0.99,5678,5726
5,11504,10,100,1e-05,0.01,0.986,5729,5775
5,11604,10,100,1e-05,0.01,0.978,5794,5810
5,11704,10,100,1e-05,0.01,0.986,5846,5858
5,11804,10,100,1e-05,0.01,0.99,5905,5899
5,11904,10,100,1e-05,0.01,0.992,5962,5942
5,12004,10,100,1e-05,0.01,0.99,6006,5998
5,12104,10,100,1e-05,0.01,0.99,6065,6039
5,12204,10,100,1e-05,0.01,0.978,6118,6086
5,12304,10,100,1e-05,0.01,0.976,6167,6137
5,12404,10,100,1e-05,0.01,0.988,6215,6189
5,12504,10,100,1e-05,0.01,0.988,6267,6237
5,12604,10,100,1e-05,0.01,0.978,6316,6288
5,12704,10,100,1e-05,0.01,0.986,6366,6338
5,12804,10,100,1e-05,0.01,0.992,6414,6390
5,12904,10,100,1e-05,0.01,0.986,6461,6443
5,13004,10,100,1e-05,0.01,0.988,6509,6495
5,13104,10,100,1e-05,0.01,0.992,6556,6548
5,13204,10,100,1e-05,0.01,0.996,6613,6591
5,13304,10,100,1e-05,0.01,0.994,6665,6639
5,13404,10,100,1e-05,0.01,0.996,6721,6683
5,13504,10,100,1e-05,0.01,0.996,6767,6737
5,13604,10,100,1e-05,0.01,0.994,6820,6784
5,13704,10,100,1e-05,0.01,0.992,6864,6840
5,13804,10,100,1e-05,0.01,0.988,6911,6893
5,13904,10,100,1e-05,0.01,0.978,6953,6951
5,14004,10,100,1e-05,0.01,0.97,7002,7002
5,14104,10,100,1e-05,0.01,0.986,7043,7061
5,14204,10,100,1e-05,0.01,0.996,7094,7110
5,14304,10,100,1e-05,0.01,0.996,7145,7159
5,14404,10,100,1e-05,0.01,0.994,7195,7209
5,14504,10,100,1e-05,0.01,0.996,7245,7259
5,14604,10,100,1e-05,0.01,0.996,7299,7305
5,14704,10,100,1e-05,0.01,1.0,7345,7359
5,14804,10,100,1e-05,0.01,0.996,7397,7407
5,14904,10,100,1e-05,0.01,0.988,7436,7468
5,15004,10,100,1e-05,0.01,0.986,7484,7520
6,104,10,100,1e-05,0.01,0.526,56,48
6,204,10,100,1e-05,0.01,0.518,110,94
6,304,10,100,1e-05,0.01,0.498,163,141
6,404,10,100,1e-05,0.01,0.536,217,187
6,504,10,100,1e-05,0.01,0.5,274,230
6,604,10,100,1e-05,0.01,0.492,327,277
6,704,10,100,1e-05,0.01,0.486,377,327
6,804,10,100,1e-05,0.01,0.518,427,377
6,904,10,100,1e-05,0.01,0.504,478,426
6,1004,10,100,1e-05,0.01,0.51,527,477
6,1104,10,100,1e-05,0.01,0.482,578,526
6,1204,10,100,1e-05,0.01,0.53,634,570
6,1304,10,100,1e-05,0.01,0.546,680,624
6,1404,10,100,1e-05,0.01,0.528,727,677
6,1504,10,100,1e-05,0.01,0.534,783,721
6,1604,10,100,1e-05,0.01,0.532,824,780
6,1704,10,100,1e-05,0.01,0.54,887,817
6,1804,10,100,1e-05,0.01,0.508,940,864
6,1904,10,100,1e-05,0.01,0.558,993,911
6,2004,10,100,1e-05,0.01,0.566,1047,957
6,2104,10,100,1e-05,0.01,0.548,1112,992
6,2204,10,100,1e-05,0.01,0.576,1156,1048
6,2304,10,100,1e-05,0.01,0.594,1211,1093
6,2404,10,100,1e-05,0.01,0.58,1259,1145
6,2504,10,100,1e-05,0.01,0.62,1302,1202
6,2604,10,100,1e-05,0.01,0.678,1351,1253
6,2704,10,100,1e-05,0.01,0.696,1399,1305
6,2804,10,100,1e-05,0.01,0.688,1450,1354
6,2904,10,100,1e-05,0.01,0.68,1504,1400
6,3004,10,100,1e-05,0.01,0.748,1550,1454
6,3104,10,100,1e-05,0.01,0.772,1598,1506
6,3204,10,100,1e-05,0.01,0.796,1650,1554
6,3304,10,100,1e-05,0.01,0.814,1716,1588
6,3404,10,100,1e-05,0.01,0.848,1762,1642
6,3504,10,100,1e-05,0.01,0.854,1813,1691
6,3604,10,100,1e-05,0.01,0.798,1853,1751
6,3704,10,100,1e-05,0.01,0.848,1896,1808
6,3804,10,100,1e-05,0.01,0.814,1950,1854
6,3904,10,100,1e-05,0.01,0.784,2002,1902
6,4004,10,100,1e-05,0.01,0.85,2050,1954
6,4104,10,100,1e-05,0.01,0.88,2105,1999
6,4204,10,100,1e-05,0.01,0.884,2150,2054
6,4304,10,100,1e-05,0.01,0.904,2205,2099
6,4404,10,100,1e-05,0.01,0.894,2264,2140
6,4504,10,100,1e-05,0.01,0.916,2315,2189
6,4604,10,100,1e-05,0.01,0.916,2349,2255
6,4704,10,100,1e-05,0.01,0.928,2390,2314
6,4804,10,100,1e-05,0.01,0.916,2430,2374
6,4904,10,100,1e-05,0.01,0.928,2484,2420
6,5004,10,100,1e-05,0.01,0.922,2539,2465
6,5104,10,100,1e-05,0.01,0.926,2598,2506
6,5204,10,100,1e-05,0.01,0.93,2642,2562
6,5304,10,100,1e-05,0.01,0.942,2690,2614
6,5404,10,100,1e-05,0.01,0.94,2739,2665
6,5504,10,100,1e-05,0.01,0.93,2785,2719
6,5604,10,100,1e-05,0.01,0.946,2838,2766
6,5704,10,100,1e-05,0.01,0.956,2885,2819
6,5804,10,100,1e-05,0.01,0.954,2929,2875
6,5904,10,100,1e-05,0.01,0.942,2981,2923
6,6004,10,100,1e-05,0.01,0.954,3041,2963
6,6104,10,100,1e-05,0.01,0.938,3083,3021
6,6204,10,100,1e-05,0.01,0.946,3135,3069
6,6304,10,100,1e-05,0.01,0.924,3183,3121
6,6404,10,100,1e-05,0.01,0.964,3232,3172
6,6504,10,100,1e-05,0.01,0.97,3272,3232
6,6604,10,100,1e-05,0.01,0.974,3330,3274
6,6704,10,100,1e-05,0.01,0.972,3380,3324
6,6804,10,100,1e-05,0.01,0.966,3429,3375
6,6904,10,100,1e-05,0.01,0.978,3473,3431
6,7004,10,100,1e-05,0.01,0.976,3524,3480
6,7104,10,100,1e-05,0.01,0.976,3570,3534
6,7204,10,100,1e-05,0.01,0.982,3609,3595
6,7304,10,100,1e-05,0.01,0.978,3659,3645
6,7404,10,100,1e-05,0.01,0.982,3718,3686
6,7504,10,100,1e-05,0.01,0.984,3774,3730
6,7604,10,100,1e-05,0.01,0.986,3820,3784
6,7704,10,100,1e-05,0.01,0.986,3859,3845
6,7804,10,100,1e-05,0.01,0.984,3912,3892
6,7904,10,100,1e-05,0.01,0.984,3971,3933
6,8004,10,100,1e-05,0.01,0.982,4027,3977
6,8104,10,100,1e-05,0.01,0.98,4074,4030
6,8204,10,100,1e-05,0.01,0.964,4125,4079
6,8304,10,100,1e-05,0.01,0.984,4174,4130
6,8404,10,100,1e-05,0.01,0.968,4228,4176
6,8504,10,100,1e-05,0.01,0.974,4284,4220
6,8604,10,100,1e-05,0.01,0.982,4331,4273
6,8704,10,100,1e-05,0.01,0.99,4385,4319
6,8804,10,100,1e-05,0.01,0.99,4438,4366
6,8904,10,100,1e-05,0.01,0.986,4486,4418
6,9004,10,100,1e-05,0.01,0.99,4529,4475
6,9104,10,100,1e-05,0.01,0.99,4577,4527
6,9204,10,100,1e-05,0.01,0.99,4628,4576
6,9304,10,100,1e-05,0.01,0.99,4680,4624
6,9404,10,100,1e-05,0.01,0.986,4735,4669
6,9504,10,100,1e-05,0.01,0.984,4786,4718
6,9604,10,100,1e-05,0.01,0.988,4826,4778
6,9704,10,100,1e-05,0.01,0.984,4869,4835
6,9804,10,100,1e-05,0.01,0.976,4912,4892
6,9904,10,100,1e-05,0.01,0.98,4960,4944
6,10004,10,100,1e-05,0.01,0.988,5019,4985
6,10104,10,100,1e-05,0.01,0.988,5071,5033
6,10204,10,100,1e-05,0.01,0.99,5123,5081
6,10304,10,100,1e-05,0.01,0.988,5173,5131
6,10404,10,100,1e-05,0.01,0.988,5219,5185
6,10504,10,100,1e-05,0.01,0.99,5276,5228
6,10604,10,100,1e-05,0.01,0.99,5327,5277
6,10704,10,100,1e-05,0.01,0.99,5378,5326
6,10804,10,100,1e-05,0.01,0.99,5432,5372
6,10904,10,100,1e-05,0.01,0.99,5488,5416
6,11004,10,100,1e-05,0.01,0.988,5540,5464
6,11104,10,100,1e-05,0.01,0.99,5585,5519
6,11204,10,100,1e-05,0.01,0.99,5633,5571
6,11304,10,100,1e-05,0.01,0.99,5680,5624
6,11404,10,100,1e-05,0.01,0.984,5731,5673
6,11504,10,100,1e-05,0.01,0.978,5780,5724
6,11604,10,100,1e-05,0.01,0.988,5830,5774
6,11704,10,100,1e-05,0.01,0.988,5879,5825
6,11804,10,100,1e-05,0.01,0.988,5926,5878
6,11904,10,100,1e-05,0.01,0.988,5976,5928
6,12004,10,100,1e-05,0.01,0.988,6021,5983
6,12104,10,100,1e-05,0.01,0.99,6074,6030
6,12204,10,100,1e-05,0.01,0.99,6131,6073
6,12304,10,100,1e-05,0.01,0.988,6180,6124
6,12404,10,100,1e-05,0.01,0.992,6229,6175
6,12504,10,100,1e-05,0.01,0.992,6264,6240
6,12604,10,100,1e-05,0.01,0.994,6304,6300
6,12704,10,100,1e-05,0.01,0.992,6354,6350
6,12804,10,100,1e-05,0.01,0.992,6411,6393
6,12904,10,100,1e-05,0.01,0.976,6464,6440
6,13004,10,100,1e-05,0.01,0.988,6506,6498
6,13104,10,100,1e-05,0.01,0.984,6548,6556
6,13204,10,100,1e-05,0.01,0.99,6596,6608
6,13304,10,100,1e-05,0.01,0.994,6658,6646
6,13404,10,100,1e-05,0.01,0.988,6716,6688
6,13504,10,100,1e-05,0.01,0.992,6762,6742
6,13604,10,100,1e-05,0.01,0.992,6800,6804
6,13704,10,100,1e-05,0.01,0.992,6846,6858
6,13804,10,100,1e-05,0.01,0.992,6900,6904
6,13904,10,100,1e-05,0.01,0.992,6953,6951
6,14004,10,100,1e-05,0.01,0.994,7003,7001
6,14104,10,100,1e-05,0.01,0.992,7045,7059
6,14204,10,100,1e-05,0.01,0.988,7093,7111
6,14304,10,100,1e-05,0.01,0.988,7143,7161
6,14404,10,100,1e-05,0.01,0.984,7188,7216
6,14504,10,100,1e-05,0.01,0.99,7229,7275
6,14604,10,100,1e-05,0.01,0.986,7279,7325
6,14704,10,100,1e-05,0.01,0.988,7335,7369
6,14804,10,100,1e-05,0.01,0.992,7391,7413
6,14904,10,100,1e-05,0.01,0.992,7447,7457
6,15004,10,100,1e-05,0.01,0.99,7504,7500
7,104,10,100,1e-05,0.01,0.48,50,54
7,204,10,100,1e-05,0.01,0.468,97,107
7,304,10,100,1e-05,0.01,0.476,147,157
7,404,10,100,1e-05,0.01,0.488,196,208
7,504,10,100,1e-05,0.01,0.52,245,259
7,604,10,100,1e-05,0.01,0.504,294,310
7,704,10,100,1e-05,0.01,0.486,338,366
7,804,10,100,1e-05,0.01,0.476,395,409
7,904,10,100,1e-05,0.01,0.496,448,456
7,1004,10,100,1e-05,0.01,0.486,502,502
7,1104,10,100,1e-05,0.01,0.476,548,556
7,1204,10,100,1e-05,0.01,0.51,605,599
7,1304,10,100,1e-05,0.01,0.5,653,651
7,1404,10,100,1e-05,0.01,0.468,705,699
7,1504,10,100,1e-05,0.01,0.504,756,748
7,1604,10,100,1e-05,0.01,0.494,801,803
7,1704,10,100,1e-05,0.01,0.494,853,851
7,1804,10,100,1e-05,0.01,0.504,901,903
7,1904,10,100,1e-05,0.01,0.53,943,961
7,2004,10,100,1e-05,0.01,0.536,992,1012
7,2104,10,100,1e-05,0.01,0.542,1043,1061
7,2204,10,100,1e-05,0.01,0.566,1095,1109
7,2304,10,100,1e-05,0.01,0.586,1148,1156
7,2404,10,100,1e-05,0.01,0.586,1195,1209
7,2504,10,100,1e-05,0.01,0.624,1235,1269
7,2604,10,100,1e-05,0.01,0.638,1291,1313
7,2704,10,100,1e-05,0.01,0.616,1342,1362
7,2804,10,100,1e-05,0.01,0.646,1397,1407
7,2904,10,100,1e-05,0.01,0.66,1448,1456
7,3004,10,100,1e-05,0.01,0.704,1497,1507
7,3104,10,100,1e-05,0.01,0.7,1545,1559
7,3204,10,100,1e-05,0.01,0.754,1595,1609
7,3304,10,100,1e-05,0.01,0.794,1648,1656
7,3404,10,100,1e-05,0.01,0.796,1697,1707
7,3504,10,100,1e-05,0.01,0.81,1749,1755
7,3604,10,100,1e-05,0.01,0.824,1803,1801
7,3704,10,100,1e-05,0.01,0.836,1851,1853
7,3804,10,100,1e-05,0.01,0.846,1899,1905
7,3904,10,100,1e-05,0.01,0.848,1948,1956
7,4004,10,100,1e-05,0.01,0.846,1996,2008
7,4104,10,100,1e-05,0.01,0.872,2043,2061
7,4204,10,100,1e-05,0.01,0.868,2090,2114
7,4304,10,100,1e-05,0.01,0.866,2143,2161
7,4404,10,100,1e-05,0.01,0.902,2192,2212
7,4504,10,100,1e-05,0.01,0.882,2236,2268
7,4604,10,100,1e-05,0.01,0.91,2286,2318
7,4704,10,100,1e-05,0.01,0.916,2335,2369
7,4804,10,100,1e-05,0.01,0.918,2384,2420
7,4904,10,100,1e-05,0.01,0.928,2434,2470
7,5004,10,100,1e-05,0.01,0.922,2481,2523
7,5104,10,100,1e-05,0.01,0.918,2535,2569
7,5204,10,100,1e-05,0.01,0.928,2592,2612
7,5304,10,100,1e-05,0.01,0.932,2640,2664
7,5404,10,100,1e-05,0.01,0.93,2695,2709
7,5504,10,100,1e-05,0.01,0.938,2755,2749
7,5604,10,100,1e-05,0.01,0.932,2811,2793
7,5704,10,100,1e-05,0.01,0.928,2863,2841
7,5804,10,100,1e-05,0.01,0.924,2917,2887
7,5904,10,100,1e-05,0.01,0.93,2965,2939
7,6004,10,100,1e-05,0.01,0.91,3012,2992
7,6104,10,100,1e-05,0.01,0.918,3052,3052
7,6204,10,100,1e-05,0.01,0.944,3097,3107
7,6304,10,100,1e-05,0.01,0.954,3152,3152
7,6404,10,100,1e-05,0.01,0.944,3203,3201
7,6504,10,100,1e-05,0.01,0.956,3251,3253
7,6604,10,100,1e-05,0.01,0.956,3303,3301
7,6704,10,100,1e-05,0.01,0.96,3352,3352
7,6804,10,100,1e-05,0.01,0.962,3396,3408
7,6904,10,100,1e-05,0.01,0.946,3448,3456
7,7004,10,100,1e-05,0.01,0.956,3497,3507
7,7104,10,100,1e-05,0.01,0.956,3543,3561
7,7204,10,100,1e-05,0.01,0.952,3597,3607
7,7304,10,100,1e-05,0.01,0.958,3645,3659
7,7404,10,100,1e-05,0.01,0.962,3693,3711
7,7504,10,100,1e-05,0.01,0.96,3740,3764
7,7604,10,100,1e-05,0.01,0.964,3788,3816
7,7704,10,100,1e-05,0.01,0.966,3846,3858
7,7804,10,100,1e-05,0.01,0.964,3892,3912
7,7904,10,100,1e-05,0.01,0.968,3939,3965
7,8004,10,100,1e-05,0.01,0.968,3992,4012
7,8104,10,100,1e-05,0.01,0.972,4042,4062
7,8204,10,100,1e-05,0.01,0.97,4094,4110
7,8304,10,100,1e-05,0.01,0.97,4131,4173
7,8404,10,100,1e-05,0.01,0.968,4176,4228
7,8504,10,100,1e-05,0.01,0.972,4232,4272
7,8604,10,100,1e-05,0.01,0.962,4278,4326
7,8704,10,100,1e-05,0.01,0.966,4328,4376
7,8804,10,100,1e-05,0.01,0.9,4376,4428
7,8904,10,100,1e-05,0.01,0.948,4425,4479
7,9004,10,100,1e-05,0.01,0.962,4476,4528
7,9104,10,100,1e-05,0.01,0.964,4525,4579
7,9204,10,100,1e-05,0.01,0.97,4568,4636
7,9304,10,100,1e-05,0.01,0.962,4619,4685
7,9404,10,100,1e-05,0.01,0.97,4656,4748
7,9504,10,100,1e-05,0.01,0.972,4705,4799
7,9604,10,100,1e-05,0.01,0.97,4758,4846
7,9704,10,100,1e-05,0.01,0.976,4814,4890
7,9804,10,100,1e-05,0.01,0.972,4859,4945
7,9904,10,100,1e-05,0.01,0.964,4910,4994
7,10004,10,100,1e-05,0.01,0.962,4959,5045
7,10104,10,100,1e-05,0.01,0.968,5006,5098
7,10204,10,100,1e-05,0.01,0.962,5052,5152
7,10304,10,100,1e-05,0.01,0.962,5099,5205
7,10404,10,100,1e-05,0.01,0.974,5153,5251
7,10504,10,100,1e-05,0.01,0.968,5206,5298
7,10604,10,100,1e-05,0.01,0.97,5255,5349
7,10704,10,100,1e-05,0.01,0.962,5318,5386
7,10804,10,100,1e-05,0.01,0.978,5366,5438
7,10904,10,100,1e-05,0.01,0.972,5418,5486
7,11004,10,100,1e-05,0.01,0.974,5468,5536
7,11104,10,100,1e-05,0.01,0.976,5519,5585
7,11204,10,100,1e-05,0.01,0.98,5577,5627
7,11304,10,100,1e-05,0.01,0.974,5626,5678
7,11404,10,100,1e-05,0.01,0.972,5680,5724
7,11504,10,100,1e-05,0.01,0.962,5726,5778
7,11604,10,100,1e-05,0.01,0.972,5776,5828
7,11704,10,100,1e-05,0.01,0.978,5823,5881
7,11804,10,100,1e-05,0.01,0.97,5871,5933
7,11904,10,100,1e-05,0.01,0.976,5919,5985
7,12004,10,100,1e-05,0.01,0.974,5971,6033
7,12104,10,100,1e-05,0.01,0.97,6025,6079
7,12204,10,100,1e-05,0.01,0.966,6081,6123
7,12304,10,100,1e-05,0.01,0.972,6138,6166
7,12404,10,100,1e-05,0.01,0.976,6194,6210
7,12504,10,100,1e-05,0.01,0.976,6244,6260
7,12604,10,100,1e-05,0.01,0.982,6292,6312
7,12704,10,100,1e-05,0.01,0.978,6339,6365
7,12804,10,100,1e-05,0.01,0.978,6394,6410
7,12904,10,100,1e-05,0.01,0.97,6443,6461
7,13004,10,100,1e-05,0.01,0.976,6494,6510
7,13104,10,100,1e-05,0.01,0.962,6540,6564
7,13204,10,100,1e-05,0.01,0.97,6600,6604
7,13304,10,100,1e-05,0.01,0.974,6641,6663
7,13404,10,100,1e-05,0.01,0.976,6692,6712
7,13504,10,100,1e-05,0.01,0.978,6739,6765
7,13604,10,100,1e-05,0.01,0.984,6789,6815
7,13704,10,100,1e-05,0.01,0.98,6838,6866
7,13804,10,100,1e-05,0.01,0.98,6890,6914
7,13904,10,100,1e-05,0.01,0.982,6942,6962
7,14004,10,100,1e-05,0.01,0.98,6992,7012
7,14104,10,100,1e-05,0.01,0.978,7044,7060
7,14204,10,100,1e-05,0.01,0.982,7091,7113
7,14304,10,100,1e-05,0.01,0.982,7147,7157
7,14404,10,100,1e-05,0.01,0.984,7198,7206
7,14504,10,100,1e-05,0.01,0.988,7248,7256
7,14604,10,100,1e-05,0.01,0.982,7297,7307
7,14704,10,100,1e-05,0.01,0.98,7345,7359
7,14804,10,100,1e-05,0.01,0.984,7399,7405
7,14904,10,100,1e-05,0.01,0.976,7447,7457
7,15004,10,100,1e-05,0.01,0.978,7497,7507
8,104,10,100,1e-05,0.01,0.468,47,57
8,204,10,100,1e-05,0.01,0.492,86,118
8,304,10,100,1e-05,0.01,0.438,131,173
8,404,10,100,1e-05,0.01,0.494,177,227
8,504,10,100,1e-05,0.01,0.478,219,285
8,604,10,100,1e-05,0.01,0.496,267,337
8,704,10,100,1e-05,0.01,0.474,313,391
8,804,10,100,1e-05,0.01,0.45,358,446
8,904,10,100,1e-05,0.01,0.488,409,495
8,1004,10,100,1e-05,0.01,0.518,461,543
8,1104,10,100,1e-05,0.01,0.518,522,582
8,1204,10,100,1e-05,0.01,0.496,579,625
8,1304,10,100,1e-05,0.01,0.492,620,684
8,1404,10,100,1e-05,0.01,0.466,666,738
8,1504,10,100,1e-05,0.01,0.486,715,789
8,1604,10,100,1e-05,0.01,0.474,768,836
8,1704,10,100,1e-05,0.01,0.504,814,890
8,1804,10,100,1e-05,0.01,0.486,860,944
8,1904,10,100,1e-05,0.01,0.482,914,990
8,2004,10,100,1e-05,0.01,0.502,965,1039
8,2104,10,100,1e-05,0.01,0.512,1022,1082
8,2204,10,100,1e-05,0.01,0.526,1071,1133
8,2304,10,100,1e-05,0.01,0.544,1125,1179
8,2404,10,100,1e-05,0.01,0.552,1183,1221
8,2504,10,100,1e-05,0.01,0.582,1232,1272
8,2604,10,100,1e-05,0.01,0.616,1279,1325
8,2704,10,100,1e-05,0.01,0.6,1332,1372
8,2804,10,100,1e-05,0.01,0.66,1374,1430
8,2904,10,100,1e-05,0.01,0.708,1424,1480
8,3004,10,100,1e-05,0.01,0.732,1480,1524
8,3104,10,100,1e-05,0.01,0.772,1527,1577
8,3204,10,100,1e-05,0.01,0.756,1581,1623
8,3304,10,100,1e-05,0.01,0.794,1630,1674
8,3404,10,100,1e-05,0.01,0.808,1675,1729
8,3504,10,100,1e-05,0.01,0.806,1728,1776
8,3604,10,100,1e-05,0.01,0.83,1786,1818
8,3704,10,100,1e-05,0.01,0.84,1840,1864
8,3804,10,100,1e-05,0.01,0.848,1888,1916
8,3904,10,100,1e-05,0.01,0.872,1943,1961
8,4004,10,100,1e-05,0.01,0.874,1996,2008
8,4104,10,100,1e-05,0.01,0.882,2040,2064
8,4204,10,100,1e-05,0.01,0.872,2095,2109
8,4304,10,100,1e-05,0.01,0.888,2138,2166
8,4404,10,100,1e-05,0.01,0.888,2188,2216
8,4504,10,100,1e-05,0.01,0.908,2236,2268
8,4604,10,100,1e-05,0.01,0.904,2288,2316
8,4704,10,100,1e-05,0.01,0.886,2338,2366
8,4804,10,100,1e-05,0.01,0.888,2388,2416
8,4904,10,100,1e-05,0.01,0.9,2434,2470
8,5004,10,100,1e-05,0.01,0.876,2484,2520
8,5104,10,100,1e-05,0.01,0.894,2540,2564
8,5204,10,100,1e-05,0.01,0.906,2585,2619
8,5304,10,100,1e-05,0.01,0.872,2634,2670
8,5404,10,100,1e-05,0.01,0.908,2685,2719
8,5504,10,100,1e-05,0.01,0.91,2741,2763
8,5604,10,100,1e-05,0.01,0.922,2790,2814
8,5704,10,100,1e-05,0.01,0.936,2831,2873
8,5804,10,100,1e-05,0.01,0.93,2881,2923
8,5904,10,100,1e-05,0.01,0.928,2933,2971
8,6004,10,100,1e-05,0.01,0.892,2974,3030
8,6104,10,100,1e-05,0.01,0.93,3030,3074
8,6204,10,100,1e-05,0.01,0.926,3085,3119
8,6304,10,100,1e-05,0.01,0.924,3135,3169
8,6404,10,100,1e-05,0.01,0.942,3190,3214
8,6504,10,100,1e-05,0.01,0.94,3245,3259
8,6604,10,100,1e-05,0.01,0.958,3288,3316
8,6704,10,100,1e-05,0.01,0.96,3341,3363
8,6804,10,100,1e-05,0.01,0.95,3401,3403
8,6904,10,100,1e-05,0.01,0.952,3448,3456
8,7004,10,100,1e-05,0.01,0.956,3504,3500
8,7104,10,100,1e-05,0.01,0.936,3554,3550
8,7204,10,100,1e-05,0.01,0.942,3605,3599
8,7304,10,100,1e-05,0.01,0.948,3654,3650
8,7404,10,100,1e-05,0.01,0.948,3700,3704
8,7504,10,100,1e-05,0.01,0.928,3753,3751
8,7604,10,100,1e-05,0.01,0.942,3800,3804
8,7704,10,100,1e-05,0.01,0.956,3859,3845
8,7804,10,100,1e-05,0.01,0.962,3912,3892
8,7904,10,100,1e-05,0.01,0.964,3958,3946
8,8004,10,100,1e-05,0.01,0.964,4004,4000
8,8104,10,100,1e-05,0.01,0.972,4049,4055
8,8204,10,100,1e-05,0.01,0.968,4107,4097
8,8304,10,100,1e-05,0.01,0.972,4159,4145
8,8404,10,100,1e-05,0.01,0.958,4214,4190
8,8504,10,100,1e-05,0.01,0.954,4261,4243
8,8604,10,100,1e-05,0.01,0.964,4323,4281
8,8704,10,100,1e-05,0.01,0.968,4376,4328
8,8804,10,100,1e-05,0.01,0.964,4422,4382
8,8904,10,100,1e-05,0.01,0.956,4470,4434
8,9004,10,100,1e-05,0.01,0.964,4507,4497
8,9104,10,100,1e-05,0.01,0.976,4553,4551
8,9204,10,100,1e-05,0.01,0.966,4599,4605
8,9304,10,100,1e-05,0.01,0.976,4643,4661
8,9404,10,100,1e-05,0.01,0.974,4693,4711
8,9504,10,100,1e-05,0.01,0.966,4749,4755
8,9604,10,100,1e-05,0.01,0.964,4797,4807
8,9704,10,100,1e-05,0.01,0.972,4848,4856
8,9804,10,100,1e-05,0.01,0.982,4897,4907
8,9904,10,100,1e-05,0.01,0.98,4951,4953
8,10004,10,100,1e-05,0.01,0.986,5007,4997
8,10104,10,100,1e-05,0.01,0.98,5061,5043
8,10204,10,100,1e-05,0.01,0.984,5107,5097
8,10304,10,100,1e-05,0.01,0.98,5166,5138
8,10404,10,100,1e-05,0.01,0.978,5214,5190
8,10504,10,100,1e-05,0.01,0.968,5270,5234
8,10604,10,100,1e-05,0.01,0.982,5315,5289
8,10704,10,100,1e-05,0.01,0.982,5362,5342
8,10804,10,100,1e-05,0.01,0.986,5414,5390
8,10904,10,100,1e-05,0.01,0.984,5470,5434
8,11004,10,100,1e-05,0.01,0.966,5513,5491
8,11104,10,100,1e-05,0.01,0.986,5560,5544
8,11204,10,100,1e-05,0.01,0.976,5612,5592
8,11304,10,100,1e-05,0.01,0.974,5665,5639
8,11404,10,100,1e-05,0.01,0.976,5725,5679
8,11504,10,100,1e-05,0.01,0.972,5775,5729
8,11604,10,100,1e-05,0.01,0.972,5818,5786
8,11704,10,100,1e-05,0.01,0.988,5871,5833
8,11804,10,100,1e-05,0.01,0.986,5915,5889
8,11904,10,100,1e-05,0.01,0.986,5965,5939
8,12004,10,100,1e-05,0.01,0.988,6013,5991
8,12104,10,100,1e-05,0.01,0.99,6059,6045
8,12204,10,100,1e-05,0.01,0.99,6106,6098
8,12304,10,100,1e-05,0.01,0.988,6156,6148
8,12404,10,100,1e-05,0.01,0.992,6203,6201
8,12504,10,100,1e-05,0.01,0.984,6249,6255
8,12604,10,100,1e-05,0.01,0.988,6309,6295
8,12704,10,100,1e-05,0.01,0.99,6355,6349
8,12804,10,100,1e-05,0.01,0.99,6410,6394
8,12904,10,100,1e-05,0.01,0.988,6460,6444
8,13004,10,100,1e-05,0.01,0.986,6506,6498
8,13104,10,100,1e-05,0.01,0.98,6557,6547
8,13204,10,100,1e-05,0.01,0.964,6607,6597
8,13304,10,100,1e-05,0.01,0.982,6661,6643
8,13404,10,100,1e-05,0.01,0.99,6712,6692
8,13504,10,100,1e-05,0.01,0.992,6763,6741
8,13604,10,100,1e-05,0.01,0.992,6802,6802
8,13704,10,100,1e-05,0.01,0.992,6850,6854
8,13804,10,100,1e-05,0.01,0.992,6909,6895
8,13904,10,100,1e-05,0.01,0.992,6959,6945
8,14004,10,100,1e-05,0.01,0.992,7009,6995
8,14104,10,100,1e-05,0.01,0.994,7058,7046
8,14204,10,100,1e-05,0.01,0.996,7109,7095
8,14304,10,100,1e-05,0.01,0.996,7158,7146
8,14404,10,100,1e-05,0.01,0.984,7214,7190
8,14504,10,100,1e-05,0.01,0.988,7256,7248
8,14604,10,100,1e-05,0.01,0.986,7306,7298
8,14704,10,100,1e-05,0.01,0.992,7354,7350
8,14804,10,100,1e-05,0.01,0.998,7404,7400
8,14904,10,100,1e-05,0.01,0.992,7449,7455
8,15004,10,100,1e-05,0.01,0.982,7498,7506
9,104,10,100,1e-05,0.01,0.506,41,63
9,204,10,100,1e-05,0.01,0.516,88,116
9,304,10,100,1e-05,0.01,0.498,140,164
9,404,10,100,1e-05,0.01,0.506,183,221
9,504,10,100,1e-05,0.01,0.542,233,271
9,604,10,100,1e-05,0.01,0.526,279,325
9,704,10,100,1e-05,0.01,0.518,324,380
9,804,10,100,1e-05,0.01,0.49,377,427
9,904,10,100,1e-05,0.01,0.516,431,473
9,1004,10,100,1e-05,0.01,0.484,474,530
9,1104,10,100,1e-05,0.01,0.48,525,579
9,1204,10,100,1e-05,0.01,0.478,572,632
9,1304,10,100,1e-05,0.01,0.502,622,682
9,1404,10,100,1e-05,0.01,0.486,675,729
9,1504,10,100,1e-05,0.01,0.53,729,775
9,1604,10,100,1e-05,0.01,0.508,771,833
9,1704,10,100,1e-05,0.01,0.508,826,878
9,1804,10,100,1e-05,0.01,0.532,877,927
9,1904,10,100,1e-05,0.01,0.526,928,976
9,2004,10,100,1e-05,0.01,0.548,978,1026
9,2104,10,100,1e-05,0.01,0.566,1024,1080
9,2204,10,100,1e-05,0.01,0.566,1077,1127
9,2304,10,100,1e-05,0.01,0.586,1120,1184
9,2404,10,100,1e-05,0.01,0.644,1179,1225
9,2504,10,100,1e-05,0.01,0.666,1229,1275
9,2604,10,100,1e-05,0.01,0.674,1280,1324
9,2704,10,100,1e-05,0.01,0.722,1331,1373
9,2804,10,100,1e-05,0.01,0.762,1379,1425
9,2904,10,100,1e-05,0.01,0.756,1426,1478
9,3004,10,100,1e-05,0.01,0.77,1479,1525
9,3104,10,100,1e-05,0.01,0.804,1535,1569
9,3204,10,100,1e-05,0.01,0.818,1582,1622
9,3304,10,100,1e-05,0.01,0.816,1641,1663
9,3404,10,100,1e-05,0.01,0.816,1696,1708
9,3504,10,100,1e-05,0.01,0.842,1743,1761
9,3604,10,100,1e-05,0.01,0.846,1792,1812
9,3704,10,100,1e-05,0.01,0.864,1837,1867
9,3804,10,100,1e-05,0.01,0.832,1889,1915
9,3904,10,100,1e-05,0.01,0.864,1939,1965
9,4004,10,100,1e-05,0.01,0.866,1990,2014
9,4104,10,100,1e-05,0.01,0.892,2044,2060
9,4204,10,100,1e-05,0.01,0.892,2088,2116
9,4304,10,100,1e-05,0.01,0.904,2138,2166
9,4404,10,100,1e-05,0.01,0.904,2192,2212
9,4504,10,100,1e-05,0.01,0.92,2239,2265
9,4604,10,100,1e-05,0.01,0.922,2287,2317
9,4704,10,100,1e-05,0.01,0.926,2342,2362
9,4804,10,100,1e-05,0.01,0.918,2390,2414
9,4904,10,100,1e-05,0.01,0.92,2438,2466
9,5004,10,100,1e-05,0.01,0.918,2499,2505
9,5104,10,100,1e-05,0.01,0.906,2551,2553
9,5204,10,100,1e-05,0.01,0.914,2594,2610
9,5304,10,100,1e-05,0.01,0.92,2649,2655
9,5404,10,100,1e-05,0.01,0.916,2695,2709
9,5504,10,100,1e-05,0.01,0.896,2753,2751
9,5604,10,100,1e-05,0.01,0.904,2811,2793
9,5704,10,100,1e-05,0.01,0.94,2858,2846
9,5804,10,100,1e-05,0.01,0.946,2908,2896
9,5904,10,100,1e-05,0.01,0.946,2958,2946
9,6004,10,100,1e-05,0.01,0.938,3010,2994
9,6104,10,100,1e-05,0.01,0.906,3056,3048
9,6204,10,100,1e-05,0.01,0.934,3106,3098
9,6304,10,100,1e-05,0.01,0.944,3157,3147
9,6404,10,100,1e-05,0.01,0.952,3212,3192
9,6504,10,100,1e-05,0.01,0.954,3258,3246
9,6604,10,100,1e-05,0.01,0.96,3316,3288
9,6704,10,100,1e-05,0.01,0.966,3365,3339
9,6804,10,100,1e-05,0.01,0.96,3416,3388
9,6904,10,100,1e-05,0.01,0.964,3467,3437
9,7004,10,100,1e-05,0.01,0.964,3517,3487
9,7104,10,100,1e-05,0.01,0.968,3567,3537
9,7204,10,100,1e-05,0.01,0.968,3614,3590
9,7304,10,100,1e-05,0.01,0.96,3664,3640
9,7404,10,100,1e-05,0.01,0.96,3712,3692
9,7504,10,100,1e-05,0.01,0.968,3767,3737
9,7604,10,100,1e-05,0.01,0.97,3825,3779
9,7704,10,100,1e-05,0.01,0.97,3878,3826
9,7804,10,100,1e-05,0.01,0.96,3925,3879
9,7904,10,100,1e-05,0.01,0.962,3970,3934
9,8004,10,100,1e-05,0.01,0.952,4024,3980
9,8104,10,100,1e-05,0.01,0.962,4083,4021
9,8204,10,100,1e-05,0.01,0.966,4136,4068
9,8304,10,100,1e-05,0.01,0.972,4185,4119
9,8404,10,100,1e-05,0.01,0.976,4235,4169
9,8504,10,100,1e-05,0.01,0.974,4287,4217
9,8604,10,100,1e-05,0.01,0.978,4330,4274
9,8704,10,100,1e-05,0.01,0.978,4382,4322
9,8804,10,100,1e-05,0.01,0.97,4437,4367
9,8904,10,100,1e-05,0.01,0.954,4483,4421
9,9004,10,100,1e-05,0.01,0.964,4538,4466
9,9104,10,100,1e-05,0.01,0.972,4593,4511
9,9204,10,100,1e-05,0.01,0.968,4646,4558
9,9304,10,100,1e-05,0.01,0.966,4693,4611
9,9404,10,100,1e-05,0.01,0.978,4740,4664
9,9504,10,100,1e-05,0.01,0.984,4791,4713
9,9604,10,100,1e-05,0.01,0.978,4837,4767
9,9704,10,100,1e-05,0.01,0.982,4882,4822
9,9804,10,100,1e-05,0.01,0.982,4933,4871
9,9904,10,100,1e-05,0.01,0.984,4990,4914
9,10004,10,100,1e-05,0.01,0.982,5042,4962
9,10104,10,100,1e-05,0.01,0.982,5089,5015
9,10204,10,100,1e-05,0.01,0.982,5141,5063
9,10304,10,100,1e-05,0.01,0.984,5190,5114
9,10404,10,100,1e-05,0.01,0.982,5235,5169
9,10504,10,100,1e-05,0.01,0.984,5291,5213
9,10604,10,100,1e-05,0.01,0.984,5337,5267
9,10704,10,100,1e-05,0.01,0.982,5390,5314
9,10804,10,100,1e-05,0.01,0.984,5445,5359
9,10904,10,100,1e-05,0.01,0.984,5490,5414
9,11004,10,100,1e-05,0.01,0.976,5544,5460
9,11104,10,100,1e-05,0.01,0.974,5594,5510
9,11204,10,100,1e-05,0.01,0.974,5648,5556
9,11304,10,100,1e-05,0.01,0.972,5698,5606
9,11404,10,100,1e-05,0.01,0.986,5741,5663
9,11504,10,100,1e-05,0.01,0.988,5796,5708
9,11604,10,100,1e-05,0.01,0.988,5845,5759
9,11704,10,100,1e-05,0.01,0.992,5897,5807
9,11804,10,100,1e-05,0.01,0.994,5953,5851
9,11904,10,100,1e-05,0.01,0.994,6002,5902
9,12004,10,100,1e-05,0.01,0.994,6050,5954
9,12104,10,100,1e-05,0.01,0.994,6106,5998
9,12204,10,100,1e-05,0.01,0.994,6157,6047
9,12304,10,100,1e-05,0.01,0.994,6200,6104
9,12404,10,100,1e-05,0.01,0.994,6255,6149
9,12504,10,100,1e-05,0.01,0.994,6298,6206
9,12604,10,100,1e-05,0.01,0.994,6350,6254
9,12704,10,100,1e-05,0.01,0.994,6400,6304
9,12804,10,100,1e-05,0.01,0.994,6448,6356
9,12904,10,100,1e-05,0.01,0.994,6492,6412
9,13004,10,100,1e-05,0.01,0.994,6541,6463
9,13104,10,100,1e-05,0.01,0.994,6590,6514
9,13204,10,100,1e-05,0.01,0.982,6636,6568
9,13304,10,100,1e-05,0.01,0.98,6682,6622
9,13404,10,100,1e-05,0.01,0.99,6728,6676
9,13504,10,100,1e-05,0.01,0.982,6776,6728
9,13604,10,100,1e-05,0.01,0.99,6825,6779
9,13704,10,100,1e-05,0.01,0.99,6867,6837
9,13804,10,100,1e-05,0.01,0.992,6920,6884
9,13904,10,100,1e-05,0.01,0.992,6970,6934
9,14004,10,100,1e-05,0.01,0.994,7021,6983
9,14104,10,100,1e-05,0.01,0.996,7064,7040
9,14204,10,100,1e-05,0.01,0.99,7114,7090
9,14304,10,100,1e-05,0.01,0.99,7166,7138
9,14404,10,100,1e-05,0.01,0.99,7213,7191
9,14504,10,100,1e-05,0.01,0.976,7269,7235
9,14604,10,100,1e-05,0.01,0.992,7318,7286
9,14704,10,100,1e-05,0.01,0.982,7367,7337
9,14804,10,100,1e-05,0.01,0.994,7417,7387
9,14904,10,100,1e-05,0.01,0.994,7466,7438
9,15004,10,100,1e-05,0.01,0.996,7505,7499
10,104,10,100,1e-05,0.01,0.498,50,54
10,204,10,100,1e-05,0.01,0.5,101,103
10,304,10,100,1e-05,0.01,0.5,143,161
10,404,10,100,1e-05,0.01,0.502,190,214
10,504,10,100,1e-05,0.01,0.514,238,266
10,604,10,100,1e-05,0.01,0.512,294,310
10,704,10,100,1e-05,0.01,0.51,357,347
10,804,10,100,1e-05,0.01,0.514,418,386
10,904,10,100,1e-05,0.01,0.52,476,428
10,1004,10,100,1e-05,0.01,0.508,518,486
10,1104,10,100,1e-05,0.01,0.542,568,536
10,1204,10,100,1e-05,0.01,0.502,622,582
10,1304,10,100,1e-05,0.01,0.528,675,629
10,1404,10,100,1e-05,0.01,0.506,725,679
10,1504,10,100,1e-05,0.01,0.514,775,729
10,1604,10,100,1e-05,0.01,0.524,827,777
10,1704,10,100,1e-05,0.01,0.522,876,828
10,1804,10,100,1e-05,0.01,0.518,933,871
10,1904,10,100,1e-05,0.01,0.49,981,923
10,2004,10,100,1e-05,0.01,0.512,1030,974
10,2104,10,100,1e-05,0.01,0.506,1085,1019
10,2204,10,100,1e-05,0.01,0.51,1142,1062
10,2304,10,100,1e-05,0.01,0.564,1192,1112
10,2404,10,100,1e-05,0.01,0.542,1236,1168
10,2504,10,100,1e-05,0.01,0.568,1285,1219
10,2604,10,100,1e-05,0.01,0.56,1339,1265
10,2704,10,100,1e-05,0.01,0.582,1391,1313
10,2804,10,100,1e-05,0.01,0.642,1441,1363
10,2904,10,100,1e-05,0.01,0.644,1491,1413
10,3004,10,100,1e-05,0.01,0.648,1541,1463
10,3104,10,100,1e-05,0.01,0.68,1586,1518
10,3204,10,100,1e-05,0.01,0.636,1631,1573
10,3304,10,100,1e-05,0.01,0.73,1690,1614
10,3404,10,100,1e-05,0.01,0.744,1737,1667
10,3504,10,100,1e-05,0.01,0.774,1791,1713
10,3604,10,100,1e-05,0.01,0.764,1837,1767
10,3704,10,100,1e-05,0.01,0.802,1890,1814
10,3804,10,100,1e-05,0.01,0.746,1936,1868
10,3904,10,100,1e-05,0.01,0.804,1985,1919
10,4004,10,100,1e-05,0.01,0.79,2033,1971
10,4104,10,100,1e-05,0.01,0.804,2076,2028
10,4204,10,100,1e-05,0.01,0.798,2125,2079
10,4304,10,100,1e-05,0.01,0.806,2178,2126
10,4404,10,100,1e-05,0.01,0.818,2224,2180
10,4504,10,100,1e-05,0.01,0.808,2274,2230
10,4604,10,100,1e-05,0.01,0.828,2317,2287
10,4704,10,100,1e-05,0.01,0.834,2373,2331
10,4804,10,100,1e-05,0.01,0.832,2419,2385
10,4904,10,100,1e-05,0.01,0.854,2473,2431
10,5004,10,100,1e-05,0.01,0.864,2523,2481
10,5104,10,100,1e-05,0.01,0.842,2582,2522
10,5204,10,100,1e-05,0.01,0.846,2644,2560
10,5304,10,100,1e-05,0.01,0.88,2698,2606
10,5404,10,100,1e-05,0.01,0.862,2749,2655
10,5504,10,100,1e-05,0.01,0.882,2798,2706
10,5604,10,100,1e-05,0.01,0.888,2861,2743
10,5704,10,100,1e-05,0.01,0.892,2920,2784
10,5804,10,100,1e-05,0.01,0.904,2983,2821
10,5904,10,100,1e-05,0.01,0.914,3035,2869
10,6004,10,100,1e-05,0.01,0.908,3083,2921
10,6104,10,100,1e-05,0.01,0.912,3136,2968
10,6204,10,100,1e-05,0.01,0.904,3186,3018
10,6304,10,100,1e-05,0.01,0.916,3230,3074
10,6404,10,100,1e-05,0.01,0.91,3277,3127
10,6504,10,100,1e-05,0.01,0.928,3328,3176
10,6604,10,100,1e-05,0.01,0.932,3379,3225
10,6704,10,100,1e-05,0.01,0.93,3435,3269
10,6804,10,100,1e-05,0.01,0.924,3489,3315
10,6904,10,100,1e-05,0.01,0.898,3536,3368
10,7004,10,100,1e-05,0.01,0.918,3585,3419
10,7104,10,100,1e-05,0.01,0.902,3632,3472
10,7204,10,100,1e-05,0.01,0.924,3685,3519
10,7304,10,100,1e-05,0.01,0.932,3732,3572
10,7404,10,100,1e-05,0.01,0.942,3789,3615
10,7504,10,100,1e-05,0.01,0.93,3844,3660
10,7604,10,100,1e-05,0.01,0.926,3890,3714
10,7704,10,100,1e-05,0.01,0.94,3938,3766
10,7804,10,100,1e-05,0.01,0.936,3985,3819
10,7904,10,100,1e-05,0.01,0.946,4034,3870
10,8004,10,100,1e-05,0.01,0.946,4088,3916
10,8104,10,100,1e-05,0.01,0.952,4135,3969
10,8204,10,100,1e-05,0.01,0.952,4185,4019
10,8304,10,100,1e-05,0.01,0.948,4231,4073
10,8404,10,100,1e-05,0.01,0.94,4277,4127
10,8504,10,100,1e-05,0.01,0.948,4339,4165
10,8604,10,100,1e-05,0.01,0.944,4383,4221
10,8704,10,100,1e-05,0.01,0.954,4437,4267
10,8804,10,100,1e-05,0.01,0.928,4490,4314
10,8904,10,100,1e-05,0.01,0.946,4530,4374
10,9004,10,100,1e-05,0.01,0.94,4579,4425
10,9104,10,100,1e-05,0.01,0.93,4634,4470
10,9204,10,100,1e-05,0.01,0.954,4687,4517
10,9304,10,100,1e-05,0.01,0.964,4735,4569
10,9404,10,100,1e-05,0.01,0.964,4784,4620
10,9504,10,100,1e-05,0.01,0.96,4835,4669
10,9604,10,100,1e-05,0.01,0.96,4890,4714
10,9704,10,100,1e-05,0.01,0.956,4934,4770
10,9804,10,100,1e-05,0.01,0.956,4977,4827
10,9904,10,100,1e-05,0.01,0.958,5020,4884
10,10004,10,100,1e-05,0.01,0.958,5060,4944
10,10104,10,100,1e-05,0.01,0.968,5102,5002
10,10204,10,100,1e-05,0.01,0.956,5153,5051
10,10304,10,100,1e-05,0.01,0.974,5203,5101
10,10404,10,100,1e-05,0.01,0.97,5255,5149
10,10504,10,100,1e-05,0.01,0.966,5306,5198
10,10604,10,100,1e-05,0.01,0.962,5364,5240
10,10704,10,100,1e-05,0.01,0.968,5412,5292
10,10804,10,100,1e-05,0.01,0.956,5453,5351
10,10904,10,100,1e-05,0.01,0.962,5500,5404
10,11004,10,100,1e-05,0.01,0.964,5546,5458
10,11104,10,100,1e-05,0.01,0.964,5593,5511
10,11204,10,100,1e-05,0.01,0.964,5642,5562
10,11304,10,100,1e-05,0.01,0.968,5684,5620
10,11404,10,100,1e-05,0.01,0.974,5743,5661
10,11504,10,100,1e-05,0.01,0.974,5799,5705
10,11604,10,100,1e-05,0.01,0.976,5843,5761
10,11704,10,100,1e-05,0.01,0.968,5894,5810
10,11804,10,100,1e-05,0.01,0.974,5945,5859
10,11904,10,100,1e-05,0.01,0.98,5993,5911
10,12004,10,100,1e-05,0.01,0.97,6042,5962
10,12104,10,100,1e-05,0.01,0.98,6099,6005
10,12204,10,100,1e-05,0.01,0.986,6143,6061
10,12304,10,100,1e-05,0.01,0.978,6200,6104
10,12404,10,100,1e-05,0.01,0.988,6252,6152
10,12504,10,100,1e-05,0.01,0.986,6299,6205
10,12604,10,100,1e-05,0.01,0.982,6343,6261
10,12704,10,100,1e-05,0.01,0.98,6386,6318
10,12804,10,100,1e-05,0.01,0.982,6432,6372
10,12904,10,100,1e-05,0.01,0.978,6483,6421
10,13004,10,100,1e-05,0.01,0.984,6534,6470
10,13104,10,100,1e-05,0.01,0.98,6582,6522
10,13204,10,100,1e-05,0.01,0.976,6625,6579
10,13304,10,100,1e-05,0.01,0.982,6670,6634
10,13404,10,100,1e-05,0.01,0.968,6720,6684
10,13504,10,100,1e-05,0.01,0.972,6770,6734
10,13604,10,100,1e-05,0.01,0.974,6826,6778
10,13704,10,100,1e-05,0.01,0.978,6871,6833
10,13804,10,100,1e-05,0.01,0.984,6920,6884
10,13904,10,100,1e-05,0.01,0.99,6956,6948
10,14004,10,100,1e-05,0.01,0.982,7004,7000
10,14104,10,100,1e-05,0.01,0.986,7056,7048
10,14204,10,100,1e-05,0.01,0.984,7102,7102
10,14304,10,100,1e-05,0.01,0.98,7153,7151
10,14404,10,100,1e-05,0.01,0.962,7206,7198
10,14504,10,100,1e-05,0.01,0.984,7253,7251
10,14604,10,100,1e-05,0.01,0.98,7303,7301
10,14704,10,100,1e-05,0.01,0.986,7352,7352
10,14804,10,100,1e-05,0.01,0.986,7403,7401
10,14904,10,100,1e-05,0.01,0.984,7450,7454
10,15004,10,100,1e-05,0.01,0.984,7503,7501
11,104,10,100,1e-05,0.01,0.482,56,48
11,204,10,100,1e-05,0.01,0.51,101,103
11,304,10,100,1e-05,0.01,0.518,142,162
11,404,10,100,1e-05,0.01,0.48,204,200
11,504,10,100,1e-05,0.01,0.474,255,249
11,604,10,100,1e-05,0.01,0.504,303,301
11,704,10,100,1e-05,0.01,0.492,353,351
11,804,10,100,1e-05,0.01,0.466,406,398
11,904,10,100,1e-05,0.01,0.456,454,450
11,1004,10,100,1e-05,0.01,0.472,498,506
11,1104,10,100,1e-05,0.01,0.504,552,552
11,1204,10,100,1e-05,0.01,0.512,605,599
11,1304,10,100,1e-05,0.01,0.496,654,650
11,1404,10,100,1e-05,0.01,0.504,708,696
11,1504,10,100,1e-05,0.01,0.502,758,746
11,1604,10,100,1e-05,0.01,0.49,800,804
11,1704,10,100,1e-05,0.01,0.52,846,858
11,1804,10,100,1e-05,0.01,0.504,892,912
11,1904,10,100,1e-05,0.01,0.536,941,963
11,2004,10,100,1e-05,0.01,0.536,994,1010
11,2104,10,100,1e-05,0.01,0.562,1047,1057
11,2204,10,100,1e-05,0.01,0.59,1095,1109
11,2304,10,100,1e-05,0.01,0.606,1143,1161
11,2404,10,100,1e-05,0.01,0.624,1194,1210
11,2504,10,100,1e-05,0.01,0.564,1242,1262
11,2604,10,100,1e-05,0.01,0.618,1294,1310
11,2704,10,100,1e-05,0.01,0.608,1334,1370
11,2804,10,100,1e-05,0.01,0.664,1385,1419
11,2904,10,100,1e-05,0.01,0.682,1439,1465
11,3004,10,100,1e-05,0.01,0.694,1491,1513
11,3104,10,100,1e-05,0.01,0.67,1542,1562
11,3204,10,100,1e-05,0.01,0.686,1589,1615
11,3304,10,100,1e-05,0.01,0.714,1642,1662
11,3404,10,100,1e-05,0.01,0.728,1687,1717
11,3504,10,100,1e-05,0.01,0.756,1747,1757
11,3604,10,100,1e-05,0.01,0.788,1798,1806
11,3704,10,100,1e-05,0.01,0.744,1848,1856
11,3804,10,100,1e-05,0.01,0.76,1901,1903
11,3904,10,100,1e-05,0.01,0.792,1947,1957
11,4004,10,100,1e-05,0.01,0.776,1994,2010
11,4104,10,100,1e-05,0.01,0.752,2036,2068
11,4204,10,100,1e-05,0.01,0.778,2085,2119
11,4304,10,100,1e-05,0.01,0.82,2133,2171
11,4404,10,100,1e-05,0.01,0.818,2184,2220
11,4504,10,100,1e-05,0.01,0.834,2231,2273
11,4604,10,100,1e-05,0.01,0.816,2287,2317
11,4704,10,100,1e-05,0.01,0.842,2338,2366
11,4804,10,100,1e-05,0.01,0.852,2383,2421
11,4904,10,100,1e-05,0.01,0.844,2432,2472
11,5004,10,100,1e-05,0.01,0.858,2487,2517
11,5104,10,100,1e-05,0.01,0.838,2548,2556
11,5204,10,100,1e-05,0.01,0.864,2591,2613
11,5304,10,100,1e-05,0.01,0.848,2636,2668
11,5404,10,100,1e-05,0.01,0.858,2693,2711
11,5504,10,100,1e-05,0.01,0.842,2741,2763
11,5604,10,100,1e-05,0.01,0.852,2796,2808
11,5704,10,100,1e-05,0.01,0.888,2844,2860
11,5804,10,100,1e-05,0.01,0.884,2890,2914
11,5904,10,100,1e-05,0.01,0.89,2937,2967
11,6004,10,100,1e-05,0.01,0.894,2986,3018
11,6104,10,100,1e-05,0.01,0.886,3038,3066
11,6204,10,100,1e-05,0.01,0.894,3093,3111
11,6304,10,100,1e-05,0.01,0.9,3147,3157
11,6404,10,100,1e-05,0.01,0.894,3191,3213
11,6504,10,100,1e-05,0.01,0.902,3238,3266
11,6604,10,100,1e-05,0.01,0.892,3294,3310
11,6704,10,100,1e-05,0.01,0.908,3348,3356
11,6804,10,100,1e-05,0.01,0.908,3399,3405
11,6904,10,100,1e-05,0.01,0.878,3455,3449
11,7004,10,100,1e-05,0.01,0.918,3505,3499
11,7104,10,100,1e-05,0.01,0.908,3555,3549
11,7204,10,100,1e-05,0.01,0.904,3594,3610
11,7304,10,100,1e-05,0.01,0.906,3647,3657
11,7404,10,100,1e-05,0.01,0.896,3686,3718
11,7504,10,100,1e-05,0.01,0.846,3739,3765
11,7604,10,100,1e-05,0.01,0.908,3790,3814
11,7704,10,100,1e-05,0.01,0.9,3845,3859
11,7804,10,100,1e-05,0.01,0.908,3890,3914
11,7904,10,100,1e-05,0.01,0.928,3931,3973
11,8004,10,100,1e-05,0.01,0.928,3983,4021
11,8104,10,100,1e-05,0.01,0.934,4035,4069
11,8204,10,100,1e-05,0.01,0.936,4085,4119
11,8304,10,100,1e-05,0.01,0.93,4141,4163
11,8404,10,100,1e-05,0.01,0.946,4189,4215
11,8504,10,100,1e-05,0.01,0.934,4237,4267
11,8604,10,100,1e-05,0.01,0.918,4291,4313
11,8704,10,100,1e-05,0.01,0.924,4338,4366
11,8804,10,100,1e-05,0.01,0.926,4385,4419
11,8904,10,100,1e-05,0.01,0.912,4430,4474
11,9004,10,100,1e-05,0.01,0.94,4486,4518
11,9104,10,100,1e-05,0.01,0.944,4522,4582
11,9204,10,100,1e-05,0.01,0.94,4573,4631
11,9304,10,100,1e-05,0.01,0.938,4631,4673
11,9404,10,100,1e-05,0.01,0.932,4684,4720
11,9504,10,100,1e-05,0.01,0.954,4743,4761
11,9604,10,100,1e-05,0.01,0.948,4796,4808
11,9704,10,100,1e-05,0.01,0.956,4854,4850
11,9804,10,100,1e-05,0.01,0.946,4902,4902
11,9904,10,100,1e-05,0.01,0.934,4961,4943
11,10004,10,100,1e-05,0.01,0.926,5017,4987
11,10104,10,100,1e-05,0.01,0.928,5054,5050
11,10204,10,100,1e-05,0.01,0.942,5094,5110
11,10304,10,100,1e-05,0.01,0.954,5147,5157
11,10404,10,100,1e-05,0.01,0.956,5193,5211
11,10504,10,100,1e-05,0.01,0.962,5251,5253
11,10604,10,100,1e-05,0.01,0.956,5295,5309
11,10704,10,100,1e-05,0.01,0.958,5343,5361
11,10804,10,100,1e-05,0.01,0.96,5395,5409
11,10904,10,100,1e-05,0.01,0.952,5450,5454
11,11004,10,100,1e-05,0.01,0.952,5508,5496
11,11104,10,100,1e-05,0.01,0.95,5556,5548
11,11204,10,100,1e-05,0.01,0.95,5605,5599
11,11304,10,100,1e-05,0.01,0.948,5650,5654
11,11404,10,100,1e-05,0.01,0.952,5698,5706
11,11504,10,100,1e-05,0.01,0.936,5748,5756
11,11604,10,100,1e-05,0.01,0.954,5796,5808
11,11704,10,100,1e-05,0.01,0.948,5844,5860
11,11804,10,100,1e-05,0.01,0.958,5892,5912
11,11904,10,100,1e-05,0.01,0.942,5946,5958
11,12004,10,100,1e-05,0.01,0.95,5997,6007
11,12104,10,100,1e-05,0.01,0.954,6060,6044
11,12204,10,100,1e-05,0.01,0.952,6101,6103
11,12304,10,100,1e-05,0.01,0.958,6144,6160
11,12404,10,100,1e-05,0.01,0.964,6194,6210
11,12504,10,100,1e-05,0.01,0.974,6241,6263
11,12604,10,100,1e-05,0.01,0.956,6296,6308
11,12704,10,100,1e-05,0.01,0.966,6352,6352
11,12804,10,100,1e-05,0.01,0.96,6401,6403
11,12904,10,100,1e-05,0.01,0.96,6445,6459
11,13004,10,100,1e-05,0.01,0.96,6497,6507
11,13104,10,100,1e-05,0.01,0.962,6547,6557
11,13204,10,100,1e-05,0.01,0.966,6599,6605
11,13304,10,100,1e-05,0.01,0.97,6649,6655
11,13404,10,100,1e-05,0.01,0.974,6693,6711
11,13504,10,100,1e-05,0.01,0.956,6738,6766
11,13604,10,100,1e-05,0.01,0.978,6801,6803
11,13704,10,100,1e-05,0.01,0.968,6858,6846
11,13804,10,100,1e-05,0.01,0.972,6910,6894
11,13904,10,100,1e-05,0.01,0.97,6962,6942
11,14004,10,100,1e-05,0.01,0.98,7008,6996
11,14104,10,100,1e-05,0.01,0.97,7062,7042
11,14204,10,100,1e-05,0.01,0.976,7110,7094
11,14304,10,100,1e-05,0.01,0.972,7156,7148
11,14404,10,100,1e-05,0.01,0.972,7207,7197
11,14504,10,100,1e-05,0.01,0.97,7260,7244
11,14604,10,100,1e-05,0.01,0.954,7310,7294
11,14704,10,100,1e-05,0.01,0.966,7358,7346
11,14804,10,100,1e-05,0.01,0.974,7409,7395
11,14904,10,100,1e-05,0.01,0.98,7458,7446
11,15004,10,100,1e-05,0.01,0.986,7503,7501
12,104,10,100,1e-05,0.01,0.536,50,54
12,204,10,100,1e-05,0.01,0.496,96,108
12,304,10,100,1e-05,0.01,0.532,141,163
12,404,10,100,1e-05,0.01,0.532,186,218
12,504,10,100,1e-05,0.01,0.53,243,261
12,604,10,100,1e-05,0.01,0.492,296,308
12,704,10,100,1e-05,0.01,0.518,352,352
12,804,10,100,1e-05,0.01,0.528,403,401
12,904,10,100,1e-05,0.01,0.512,457,447
12,1004,10,100,1e-05,0.01,0.506,512,492
12,1104,10,100,1e-05,0.01,0.486,561,543
12,1204,10,100,1e-05,0.01,0.514,609,595
12,1304,10,100,1e-05,0.01,0.522,657,647
12,1404,10,100,1e-05,0.01,0.534,707,697
12,1504,10,100,1e-05,0.01,0.518,756,748
12,1604,10,100,1e-05,0.01,0.55,817,787
12,1704,10,100,1e-05,0.01,0.546,867,837
12,1804,10,100,1e-05,0.01,0.546,915,889
12,1904,10,100,1e-05,0.01,0.572,959,945
12,2004,10,100,1e-05,0.01,0.542,1004,1000
12,2104,10,100,1e-05,0.01,0.546,1060,1044
12,2204,10,100,1e-05,0.01,0.566,1118,1086
12,2304,10,100,1e-05,0.01,0.558,1169,1135
12,2404,10,100,1e-05,0.01,0.584,1217,1187
12,2504,10,100,1e-05,0.01,0.586,1275,1229
12,2604,10,100,1e-05,0.01,0.6,1321,1283
12,2704,10,100,1e-05,0.01,0.582,1375,1329
12,2804,10,100,1e-05,0.01,0.604,1430,1374
12,2904,10,100,1e-05,0.01,0.628,1477,1427
12,3004,10,100,1e-05,0.01,0.646,1520,1484
12,3104,10,100,1e-05,0.01,0.652,1567,1537
12,3204,10,100,1e-05,0.01,0.684,1614,1590
12,3304,10,100,1e-05,0.01,0.684,1670,1634
12,3404,10,100,1e-05,0.01,0.702,1715,1689
12,3504,10,100,1e-05,0.01,0.732,1767,1737
12,3604,10,100,1e-05,0.01,0.73,1832,1772
12,3704,10,100,1e-05,0.01,0.754,1884,1820
12,3804,10,100,1e-05,0.01,0.744,1931,1873
12,3904,10,100,1e-05,0.01,0.766,1984,1920
12,4004,10,100,1e-05,0.01,0.736,2040,1964
12,4104,10,100,1e-05,0.01,0.736,2087,2017
12,4204,10,100,1e-05,0.01,0.766,2130,2074
12,4304,10,100,1e-05,0.01,0.81,2177,2127
12,4404,10,100,1e-05,0.01,0.804,2228,2176
12,4504,10,100,1e-05,0.01,0.816,2282,2222
12,4604,10,100,1e-05,0.01,0.808,2326,2278
12,4704,10,100,1e-05,0.01,0.82,2377,2327
12,4804,10,100,1e-05,0.01,0.828,2419,2385
12,4904,10,100,1e-05,0.01,0.844,2472,2432
12,5004,10,100,1e-05,0.01,0.86,2521,2483
12,5104,10,100,1e-05,0.01,0.868,2565,2539
12,5204,10,100,1e-05,0.01,0.862,2613,2591
12,5304,10,100,1e-05,0.01,0.864,2659,2645
12,5404,10,100,1e-05,0.01,0.856,2705,2699
12,5504,10,100,1e-05,0.01,0.868,2756,2748
12,5604,10,100,1e-05,0.01,0.848,2816,2788
12,5704,10,100,1e-05,0.01,0.862,2871,2833
12,5804,10,100,1e-05,0.01,0.856,2919,2885
12,5904,10,100,1e-05,0.01,0.874,2970,2934
12,6004,10,100,1e-05,0.01,0.89,3021,2983
12,6104,10,100,1e-05,0.01,0.88,3073,3031
12,6204,10,100,1e-05,0.01,0.902,3116,3088
12,6304,10,100,1e-05,0.01,0.888,3168,3136
12,6404,10,100,1e-05,0.01,0.874,3218,3186
12,6504,10,100,1e-05,0.01,0.912,3254,3250
12,6604,10,100,1e-05,0.01,0.902,3312,3292
12,6704,10,100,1e-05,0.01,0.892,3359,3345
12,6804,10,100,1e-05,0.01,0.88,3415,3389
12,6904,10,100,1e-05,0.01,0.886,3462,3442
12,7004,10,100,1e-05,0.01,0.904,3509,3495
12,7104,10,100,1e-05,0.01,0.898,3561,3543
12,7204,10,100,1e-05,0.01,0.904,3613,3591
12,7304,10,100,1e-05,0.01,0.92,3660,3644
12,7404,10,100,1e-05,0.01,0.918,3708,3696
12,7504,10,100,1e-05,0.01,0.918,3756,3748
12,7604,10,100,1e-05,0.01,0.93,3799,3805
12,7704,10,100,1e-05,0.01,0.922,3851,3853
12,7804,10,100,1e-05,0.01,0.906,3907,3897
12,7904,10,100,1e-05,0.01,0.926,3949,3955
12,8004,10,100,1e-05,0.01,0.916,4003,4001
12,8104,10,100,1e-05,0.01,0.91,4055,4049
12,8204,10,100,1e-05,0.01,0.936,4098,4106
12,8304,10,100,1e-05,0.01,0.934,4149,4155
12,8404,10,100,1e-05,0.01,0.946,4192,4212
12,8504,10,100,1e-05,0.01,0.944,4237,4267
12,8604,10,100,1e-05,0.01,0.94,4277,4327
12,8704,10,100,1e-05,0.01,0.95,4330,4374
12,8804,10,100,1e-05,0.01,0.94,4381,4423
12,8904,10,100,1e-05,0.01,0.944,4426,4478
12,9004,10,100,1e-05,0.01,0.946,4483,4521
12,9104,10,100,1e-05,0.01,0.932,4534,4570
12,9204,10,100,1e-05,0.01,0.946,4591,4613
12,9304,10,100,1e-05,0.01,0.944,4633,4671
12,9404,10,100,1e-05,0.01,0.946,4678,4726
12,9504,10,100,1e-05,0.01,0.956,4735,4769
12,9604,10,100,1e-05,0.01,0.962,4784,4820
12,9704,10,100,1e-05,0.01,0.966,4830,4874
12,9804,10,100,1e-05,0.01,0.964,4886,4918
12,9904,10,100,1e-05,0.01,0.964,4932,4972
12,10004,10,100,1e-05,0.01,0.96,4979,5025
12,10104,10,100,1e-05,0.01,0.954,5031,5073
12,10204,10,100,1e-05,0.01,0.958,5081,5123
12,10304,10,100,1e-05,0.01,0.966,5125,5179
12,10404,10,100,1e-05,0.01,0.976,5175,5229
12,10504,10,100,1e-05,0.01,0.972,5229,5275
12,10604,10,100,1e-05,0.01,0.962,5281,5323
12,10704,10,100,1e-05,0.01,0.978,5340,5364
12,10804,10,100,1e-05,0.01,0.974,5388,5416
12,10904,10,100,1e-05,0.01,0.968,5444,5460
12,11004,10,100,1e-05,0.01,0.982,5495,5509
12,11104,10,100,1e-05,0.01,0.962,5548,5556
12,11204,10,100,1e-05,0.01,0.958,5597,5607
12,11304,10,100,1e-05,0.01,0.944,5656,5648
12,11404,10,100,1e-05,0.01,0.966,5702,5702
12,11504,10,100,1e-05,0.01,0.966,5752,5752
12,11604,10,100,1e-05,0.01,0.964,5797,5807
12,11704,10,100,1e-05,0.01,0.97,5849,5855
12,11804,10,100,1e-05,0.01,0.982,5901,5903
12,11904,10,100,1e-05,0.01,0.976,5948,5956
12,12004,10,100,1e-05,0.01,0.978,5997,6007
12,12104,10,100,1e-05,0.01,0.978,6047,6057
12,12204,10,100,1e-05,0.01,0.972,6096,6108
12,12304,10,100,1e-05,0.01,0.984,6159,6145
12,12404,10,100,1e-05,0.01,0.976,6205,6199
12,12504,10,100,1e-05,0.01,0.978,6245,6259
12,12604,10,100,1e-05,0.01,0.974,6297,6307
12,12704,10,100,1e-05,0.01,0.98,6341,6363
12,12804,10,100,1e-05,0.01,0.98,6391,6413
12,12904,10,100,1e-05,0.01,0.978,6444,6460
12,13004,10,100,1e-05,0.01,0.968,6490,6514
12,13104,10,100,1e-05,0.01,0.966,6544,6560
12,13204,10,100,1e-05,0.01,0.974,6594,6610
12,13304,10,100,1e-05,0.01,0.978,6640,6664
12,13404,10,100,1e-05,0.01,0.976,6692,6712
12,13504,10,100,1e-05,0.01,0.986,6756,6748
12,13604,10,100,1e-05,0.01,0.982,6810,6794
12,13704,10,100,1e-05,0.01,0.982,6862,6842
12,13804,10,100,1e-05,0.01,0.982,6914,6890
12,13904,10,100,1e-05,0.01,0.984,6961,6943
12,14004,10,100,1e-05,0.01,0.978,7013,6991
12,14104,10,100,1e-05,0.01,0.978,7062,7042
12,14204,10,100,1e-05,0.01,0.976,7112,7092
12,14304,10,100,1e-05,0.01,0.974,7158,7146
12,14404,10,100,1e-05,0.01,0.956,7215,7189
12,14504,10,100,1e-05,0.01,0.984,7270,7234
12,14604,10,100,1e-05,0.01,0.982,7323,7281
12,14704,10,100,1e-05,0.01,0.986,7375,7329
12,14804,10,100,1e-05,0.01,0.988,7423,7381
12,14904,10,100,1e-05,0.01,0.99,7463,7441
12,15004,10,100,1e-05,0.01,0.99,7517,7487
13,104,10,100,1e-05,0.01,0.53,56,48
13,204,10,100,1e-05,0.01,0.512,104,100
13,304,10,100,1e-05,0.01,0.52,151,153
13,404,10,100,1e-05,0.01,0.49,201,203
13,504,10,100,1e-05,0.01,0.536,260,244
13,604,10,100,1e-05,0.01,0.544,310,294
13,704,10,100,1e-05,0.01,0.532,358,346
13,804,10,100,1e-05,0.01,0.532,411,393
13,904,10,100,1e-05,0.01,0.516,454,450
13,1004,10,100,1e-05,0.01,0.524,505,499
13,1104,10,100,1e-05,0.01,0.54,562,542
13,1204,10,100,1e-05,0.01,0.498,611,593
13,1304,10,100,1e-05,0.01,0.508,658,646
13,1404,10,100,1e-05,0.01,0.534,704,700
13,1504,10,100,1e-05,0.01,0.55,760,744
13,1604,10,100,1e-05,0.01,0.532,805,799
13,1704,10,100,1e-05,0.01,0.514,855,849
13,1804,10,100,1e-05,0.01,0.542,900,904
13,1904,10,100,1e-05,0.01,0.552,948,956
13,2004,10,100,1e-05,0.01,0.586,996,1008
13,2104,10,100,1e-05,0.01,0.608,1041,1063
13,2204,10,100,1e-05,0.01,0.616,1086,1118
13,2304,10,100,1e-05,0.01,0.624,1139,1165
13,2404,10,100,1e-05,0.01,0.654,1186,1218
13,2504,10,100,1e-05,0.01,0.674,1239,1265
13,2604,10,100,1e-05,0.01,0.69,1297,1307
13,2704,10,100,1e-05,0.01,0.706,1346,1358
13,2804,10,100,1e-05,0.01,0.714,1406,1398
13,2904,10,100,1e-05,0.01,0.784,1453,1451
13,3004,10,100,1e-05,0.01,0.776,1500,1504
13,3104,10,100,1e-05,0.01,0.762,1547,1557
13,3204,10,100,1e-05,0.01,0.826,1591,1613
13,3304,10,100,1e-05,0.01,0.834,1642,1662
13,3404,10,100,1e-05,0.01,0.842,1691,1713
13,3504,10,100,1e-05,0.01,0.836,1736,1768
13,3604,10,100,1e-05,0.01,0.862,1787,1817
13,3704,10,100,1e-05,0.01,0.888,1843,1861
13,3804,10,100,1e-05,0.01,0.87,1886,1918
13,3904,10,100,1e-05,0.01,0.878,1944,1960
13,4004,10,100,1e-05,0.01,0.878,2007,1997
13,4104,10,100,1e-05,0.01,0.882,2055,2049
13,4204,10,100,1e-05,0.01,0.888,2106,2098
13,4304,10,100,1e-05,0.01,0.906,2157,2147
13,4404,10,100,1e-05,0.01,0.902,2206,2198
13,4504,10,100,1e-05,0.01,0.914,2258,2246
13,4604,10,100,1e-05,0.01,0.916,2302,2302
13,4704,10,100,1e-05,0.01,0.93,2350,2354
13,4804,10,100,1e-05,0.01,0.924,2408,2396
13,4904,10,100,1e-05,0.01,0.926,2454,2450
13,5004,10,100,1e-05,0.01,0.904,2503,2501
13,5104,10,100,1e-05,0.01,0.92,2551,2553
13,5204,10,100,1e-05,0.01,0.928,2602,2602
13,5304,10,100,1e-05,0.01,0.928,2661,2643
13,5404,10,100,1e-05,0.01,0.924,2709,2695
13,5504,10,100,1e-05,0.01,0.93,2760,2744
13,5604,10,100,1e-05,0.01,0.936,2810,2794
13,5704,10,100,1e-05,0.01,0.934,2858,2846
13,5804,10,100,1e-05,0.01,0.928,2902,2902
13,5904,10,100,1e-05,0.01,0.932,2950,2954
13,6004,10,100,1e-05,0.01,0.926,2993,3011
13,6104,10,100,1e-05,0.01,0.94,3043,3061
13,6204,10,100,1e-05,0.01,0.944,3086,3118
13,6304,10,100,1e-05,0.01,0.946,3135,3169
13,6404,10,100,1e-05,0.01,0.934,3187,3217
13,6504,10,100,1e-05,0.01,0.952,3230,3274
13,6604,10,100,1e-05,0.01,0.958,3287,3317
13,6704,10,100,1e-05,0.01,0.964,3342,3362
13,6804,10,100,1e-05,0.01,0.96,3388,3416
13,6904,10,100,1e-05,0.01,0.97,3436,3468
13,7004,10,100,1e-05,0.01,0.958,3482,3522
13,7104,10,100,1e-05,0.01,0.958,3534,3570
13,7204,10,100,1e-05,0.01,0.958,3579,3625
13,7304,10,100,1e-05,0.01,0.964,3635,3669
13,7404,10,100,1e-05,0.01,0.948,3679,3725
13,7504,10,100,1e-05,0.01,0.95,3734,3770
13,7604,10,100,1e-05,0.01,0.952,3772,3832
13,7704,10,100,1e-05,0.01,0.956,3828,3876
13,7804,10,100,1e-05,0.01,0.96,3882,3922
13,7904,10,100,1e-05,0.01,0.946,3937,3967
13,8004,10,100,1e-05,0.01,0.966,3979,4025
13,8104,10,100,1e-05,0.01,0.97,4030,4074
13,8204,10,100,1e-05,0.01,0.968,4080,4124
13,8304,10,100,1e-05,0.01,0.968,4132,4172
13,8404,10,100,1e-05,0.01,0.966,4185,4219
13,8504,10,100,1e-05,0.01,0.972,4234,4270
13,8604,10,100,1e-05,0.01,0.97,4286,4318
13,8704,10,100,1e-05,0.01,0.972,4339,4365
13,8804,10,100,1e-05,0.01,0.976,4393,4411
13,8904,10,100,1e-05,0.01,0.966,4446,4458
13,9004,10,100,1e-05,0.01,0.97,4489,4515
13,9104,10,100,1e-05,0.01,0.966,4542,4562
13,9204,10,100,1e-05,0.01,0.96,4592,4612
13,9304,10,100,1e-05,0.01,0.974,4645,4659
13,9404,10,100,1e-05,0.01,0.978,4690,4714
13,9504,10,100,1e-05,0.01,0.974,4735,4769
13,9604,10,100,1e-05,0.01,0.97,4786,4818
13,9704,10,100,1e-05,0.01,0.978,4846,4858
13,9804,10,100,1e-05,0.01,0.974,4898,4906
13,9904,10,100,1e-05,0.01,0.974,4937,4967
13,10004,10,100,1e-05,0.01,0.974,4986,5018
13,10104,10,100,1e-05,0.01,0.972,5027,5077
13,10204,10,100,1e-05,0.01,0.972,5066,5138
13,10304,10,100,1e-05,0.01,0.964,5118,5186
13,10404,10,100,1e-05,0.01,0.976,5167,5237
13,10504,10,100,1e-05,0.01,0.958,5222,5282
13,10604,10,100,1e-05,0.01,0.974,5277,5327
13,10704,10,100,1e-05,0.01,0.976,5326,5378
13,10804,10,100,1e-05,0.01,0.972,5382,5422
13,10904,10,100,1e-05,0.01,0.978,5434,5470
13,11004,10,100,1e-05,0.01,0.976,5480,5524
13,11104,10,100,1e-05,0.01,0.976,5531,5573
13,11204,10,100,1e-05,0.01,0.972,5586,5618
13,11304,10,100,1e-05,0.01,0.984,5636,5668
13,11404,10,100,1e-05,0.01,0.988,5691,5713
13,11504,10,100,1e-05,0.01,0.98,5738,5766
13,11604,10,100,1e-05,0.01,0.986,5793,5811
13,11704,10,100,1e-05,0.01,0.982,5839,5865
13,11804,10,100,1e-05,0.01,0.982,5905,5899
13,11904,10,100,1e-05,0.01,0.988,5952,5952
13,12004,10,100,1e-05,0.01,0.988,6006,5998
13,12104,10,100,1e-05,0.01,0.982,6057,6047
13,12204,10,100,1e-05,0.01,0.986,6098,6106
13,12304,10,100,1e-05,0.01,0.988,6152,6152
13,12404,10,100,1e-05,0.01,0.982,6204,6200
13,12504,10,100,1e-05,0.01,0.986,6253,6251
13,12604,10,100,1e-05,0.01,0.988,6309,6295
13,12704,10,100,1e-05,0.01,0.988,6364,6340
13,12804,10,100,1e-05,0.01,0.982,6411,6393
13,12904,10,100,1e-05,0.01,0.974,6469,6435
13,13004,10,100,1e-05,0.01,0.966,6519,6485
13,13104,10,100,1e-05,0.01,0.98,6569,6535
13,13204,10,100,1e-05,0.01,0.986,6611,6593
13,13304,10,100,1e-05,0.01,0.99,6664,6640
13,13404,10,100,1e-05,0.01,0.994,6705,6699
13,13504,10,100,1e-05,0.01,0.984,6758,6746
13,13604,10,100,1e-05,0.01,0.988,6807,6797
13,13704,10,100,1e-05,0.01,0.99,6853,6851
13,13804,10,100,1e-05,0.01,0.988,6904,6900
13,13904,10,100,1e-05,0.01,0.988,6951,6953
13,14004,10,100,1e-05,0.01,0.988,7005,6999
13,14104,10,100,1e-05,0.01,0.99,7047,7057
13,14204,10,100,1e-05,0.01,0.986,7095,7109
13,14304,10,100,1e-05,0.01,0.984,7144,7160
13,14404,10,100,1e-05,0.01,0.978,7197,7207
13,14504,10,100,1e-05,0.01,0.982,7246,7258
13,14604,10,100,1e-05,0.01,0.986,7295,7309
13,14704,10,100,1e-05,0.01,0.99,7349,7355
13,14804,10,100,1e-05,0.01,0.99,7397,7407
13,14904,10,100,1e-05,0.01,0.992,7448,7456
13,15004,10,100,1e-05,0.01,0.988,7495,7509
14,104,10,100,1e-05,0.01,0.498,54,50
14,204,10,100,1e-05,0.01,0.494,103,101
14,304,10,100,1e-05,0.01,0.466,155,149
14,404,10,100,1e-05,0.01,0.478,205,199
14,504,10,100,1e-05,0.01,0.474,251,253
14,604,10,100,1e-05,0.01,0.46,297,307
14,704,10,100,1e-05,0.01,0.484,349,355
14,804,10,100,1e-05,0.01,0.514,401,403
14,904,10,100,1e-05,0.01,0.51,446,458
14,1004,10,100,1e-05,0.01,0.49,500,504
14,1104,10,100,1e-05,0.01,0.494,539,565
14,1204,10,100,1e-05,0.01,0.508,588,616
14,1304,10,100,1e-05,0.01,0.48,636,668
14,1404,10,100,1e-05,0.01,0.476,682,722
14,1504,10,100,1e-05,0.01,0.496,735,769
14,1604,10,100,1e-05,0.01,0.478,785,819
14,1704,10,100,1e-05,0.01,0.482,836,868
14,1804,10,100,1e-05,0.01,0.484,890,914
14,1904,10,100,1e-05,0.01,0.514,944,960
14,2004,10,100,1e-05,0.01,0.498,990,1014
14,2104,10,100,1e-05,0.01,0.522,1040,1064
14,2204,10,100,1e-05,0.01,0.548,1098,1106
14,2304,10,100,1e-05,0.01,0.576,1152,1152
14,2404,10,100,1e-05,0.01,0.564,1202,1202
14,2504,10,100,1e-05,0.01,0.566,1252,1252
14,2604,10,100,1e-05,0.01,0.576,1308,1296
14,2704,10,100,1e-05,0.01,0.602,1361,1343
14,2804,10,100,1e-05,0.01,0.654,1400,1404
14,2904,10,100,1e-05,0.01,0.588,1458,1446
14,3004,10,100,1e-05,0.01,0.634,1504,1500
14,3104,10,100,1e-05,0.01,0.648,1559,1545
14,3204,10,100,1e-05,0.01,0.672,1607,1597
14,3304,10,100,1e-05,0.01,0.712,1660,1644
14,3404,10,100,1e-05,0.01,0.68,1701,1703
14,3504,10,100,1e-05,0.01,0.69,1750,1754
14,3604,10,100,1e-05,0.01,0.684,1796,1808
14,3704,10,100,1e-05,0.01,0.706,1853,1851
14,3804,10,100,1e-05,0.01,0.686,1895,1909
14,3904,10,100,1e-05,0.01,0.7,1951,1953
14,4004,10,100,1e-05,0.01,0.754,2009,1995
14,4104,10,100,1e-05,0.01,0.754,2059,2045
14,4204,10,100,1e-05,0.01,0.748,2107,2097
14,4304,10,100,1e-05,0.01,0.744,2154,2150
14,4404,10,100,1e-05,0.01,0.758,2209,2195
14,4504,10,100,1e-05,0.01,0.754,2263,2241
14,4604,10,100,1e-05,0.01,0.764,2312,2292
14,4704,10,100,1e-05,0.01,0.77,2359,2345
14,4804,10,100,1e-05,0.01,0.766,2407,2397
14,4904,10,100,1e-05,0.01,0.81,2458,2446
14,5004,10,100,1e-05,0.01,0.778,2507,2497
14,5104,10,100,1e-05,0.01,0.784,2562,2542
14,5204,10,100,1e-05,0.01,0.812,2618,2586
14,5304,10,100,1e-05,0.01,0.808,2666,2638
14,5404,10,100,1e-05,0.01,0.776,2707,2697
14,5504,10,100,1e-05,0.01,0.822,2767,2737
14,5604,10,100,1e-05,0.01,0.78,2809,2795
14,5704,10,100,1e-05,0.01,0.812,2868,2836
14,5804,10,100,1e-05,0.01,0.81,2911,2893
14,5904,10,100,1e-05,0.01,0.788,2959,2945
14,6004,10,100,1e-05,0.01,0.832,3013,2991
14,6104,10,100,1e-05,0.01,0.834,3060,3044
14,6204,10,100,1e-05,0.01,0.844,3116,3088
14,6304,10,100,1e-05,0.01,0.838,3162,3142
14,6404,10,100,1e-05,0.01,0.84,3206,3198
14,6504,10,100,1e-05,0.01,0.836,3255,3249
14,6604,10,100,1e-05,0.01,0.834,3296,3308
14,6704,10,100,1e-05,0.01,0.838,3343,3361
14,6804,10,100,1e-05,0.01,0.872,3395,3409
14,6904,10,100,1e-05,0.01,0.86,3437,3467
14,7004,10,100,1e-05,0.01,0.864,3483,3521
14,7104,10,100,1e-05,0.01,0.87,3535,3569
14,7204,10,100,1e-05,0.01,0.862,3583,3621
14,7304,10,100,1e-05,0.01,0.864,3641,3663
14,7404,10,100,1e-05,0.01,0.88,3693,3711
14,7504,10,100,1e-05,0.01,0.874,3737,3767
14,7604,10,100,1e-05,0.01,0.88,3794,3810
14,7704,10,100,1e-05,0.01,0.88,3850,3854
14,7804,10,100,1e-05,0.01,0.88,3899,3905
14,7904,10,100,1e-05,0.01,0.886,3947,3957
14,8004,10,100,1e-05,0.01,0.89,4005,3999
14,8104,10,100,1e-05,0.01,0.908,4056,4048
14,8204,10,100,1e-05,0.01,0.91,4110,4094
14,8304,10,100,1e-05,0.01,0.908,4154,4150
14,8404,10,100,1e-05,0.01,0.906,4202,4202
14,8504,10,100,1e-05,0.01,0.898,4244,4260
14,8604,10,100,1e-05,0.01,0.896,4301,4303
14,8704,10,100,1e-05,0.01,0.896,4358,4346
14,8804,10,100,1e-05,0.01,0.91,4396,4408
14,8904,10,100,1e-05,0.01,0.904,4449,4455
14,9004,10,100,1e-05,0.01,0.914,4499,4505
14,9104,10,100,1e-05,0.01,0.924,4555,4549
14,9204,10,100,1e-05,0.01,0.894,4607,4597
14,9304,10,100,1e-05,0.01,0.906,4665,4639
14,9404,10,100,1e-05,0.01,0.912,4721,4683
14,9504,10,100,1e-05,0.01,0.9,4771,4733
14,9604,10,100,1e-05,0.01,0.922,4823,4781
14,9704,10,100,1e-05,0.01,0.926,4875,4829
14,9804,10,100,1e-05,0.01,0.932,4931,4873
14,9904,10,100,1e-05,0.01,0.948,4973,4931
14,10004,10,100,1e-05,0.01,0.928,5017,4987
14,10104,10,100,1e-05,0.01,0.934,5067,5037
14,10204,10,100,1e-05,0.01,0.928,5117,5087
14,10304,10,100,1e-05,0.01,0.934,5167,5137
14,10404,10,100,1e-05,0.01,0.944,5220,5184
14,10504,10,100,1e-05,0.01,0.924,5276,5228
14,10604,10,100,1e-05,0.01,0.906,5320,5284
14,10704,10,100,1e-05,0.01,0.942,5364,5340
14,10804,10,100,1e-05,0.01,0.956,5405,5399
14,10904,10,100,1e-05,0.01,0.956,5458,5446
14,11004,10,100,1e-05,0.01,0.958,5514,5490
14,11104,10,100,1e-05,0.01,0.962,5566,5538
14,11204,10,100,1e-05,0.01,0.972,5607,5597
14,11304,10,100,1e-05,0.01,0.97,5662,5642
14,11404,10,100,1e-05,0.01,0.976,5716,5688
14,11504,10,100,1e-05,0.01,0.966,5761,5743
14,11604,10,100,1e-05,0.01,0.962,5804,5800
14,11704,10,100,1e-05,0.01,0.962,5853,5851
14,11804,10,100,1e-05,0.01,0.96,5901,5903
14,11904,10,100,1e-05,0.01,0.966,5956,5948
14,12004,10,100,1e-05,0.01,0.946,6009,5995
14,12104,10,100,1e-05,0.01,0.962,6057,6047
14,12204,10,100,1e-05,0.01,0.95,6110,6094
14,12304,10,100,1e-05,0.01,0.96,6172,6132
14,12404,10,100,1e-05,0.01,0.968,6232,6172
14,12504,10,100,1e-05,0.01,0.982,6276,6228
14,12604,10,100,1e-05,0.01,0.98,6324,6280
14,12704,10,100,1e-05,0.01,0.98,6370,6334
14,12804,10,100,1e-05,0.01,0.982,6433,6371
14,12904,10,100,1e-05,0.01,0.982,6482,6422
14,13004,10,100,1e-05,0.01,0.976,6528,6476
14,13104,10,100,1e-05,0.01,0.98,6570,6534
14,13204,10,100,1e-05,0.01,0.976,6628,6576
14,13304,10,100,1e-05,0.01,0.976,6678,6626
14,13404,10,100,1e-05,0.01,0.978,6735,6669
14,13504,10,100,1e-05,0.01,0.982,6793,6711
14,13604,10,100,1e-05,0.01,0.978,6837,6767
14,13704,10,100,1e-05,0.01,0.976,6879,6825
14,13804,10,100,1e-05,0.01,0.98,6928,6876
14,13904,10,100,1e-05,0.01,0.986,6977,6927
14,14004,10,100,1e-05,0.01,0.984,7029,6975
14,14104,10,100,1e-05,0.01,0.982,7078,7026
14,14204,10,100,1e-05,0.01,0.986,7124,7080
14,14304,10,100,1e-05,0.01,0.988,7170,7134
14,14404,10,100,1e-05,0.01,0.98,7213,7191
14,14504,10,100,1e-05,0.01,0.982,7264,7240
14,14604,10,100,1e-05,0.01,0.98,7314,7290
14,14704,10,100,1e-05,0.01,0.972,7364,7340
14,14804,10,100,1e-05,0.01,0.97,7407,7397
14,14904,10,100,1e-05,0.01,0.982,7455,7449
14,15004,10,100,1e-05,0.01,0.99,7502,7502
15,104,10,100,1e-05,0.01,0.482,55,49
15,204,10,100,1e-05,0.01,0.55,97,107
15,304,10,100,1e-05,0.01,0.504,145,159
15,404,10,100,1e-05,0.01,0.544,189,215
15,504,10,100,1e-05,0.01,0.538,242,262
15,604,10,100,1e-05,0.01,0.542,289,315
15,704,10,100,1e-05,0.01,0.476,344,360
15,804,10,100,1e-05,0.01,0.514,396,408
15,904,10,100,1e-05,0.01,0.478,449,455
15,1004,10,100,1e-05,0.01,0.502,496,508
15,1104,10,100,1e-05,0.01,0.506,540,564
15,1204,10,100,1e-05,0.01,0.51,594,610
15,1304,10,100,1e-05,0.01,0.514,645,659
15,1404,10,100,1e-05,0.01,0.554,696,708
15,1504,10,100,1e-05,0.01,0.522,745,759
15,1604,10,100,1e-05,0.01,0.55,799,805
15,1704,10,100,1e-05,0.01,0.532,850,854
15,1804,10,100,1e-05,0.01,0.56,893,911
15,1904,10,100,1e-05,0.01,0.586,950,954
15,2004,10,100,1e-05,0.01,0.594,1002,1002
15,2104,10,100,1e-05,0.01,0.604,1046,1058
15,2204,10,100,1e-05,0.01,0.598,1095,1109
15,2304,10,100,1e-05,0.01,0.63,1140,1164
15,2404,10,100,1e-05,0.01,0.684,1182,1222
15,2504,10,100,1e-05,0.01,0.656,1237,1267
15,2604,10,100,1e-05,0.01,0.688,1281,1323
15,2704,10,100,1e-05,0.01,0.744,1331,1373
15,2804,10,100,1e-05,0.01,0.776,1383,1421
15,2904,10,100,1e-05,0.01,0.782,1437,1467
15,3004,10,100,1e-05,0.01,0.792,1494,1510
15,3104,10,100,1e-05,0.01,0.83,1537,1567
15,3204,10,100,1e-05,0.01,0.822,1590,1614
15,3304,10,100,1e-05,0.01,0.842,1636,1668
15,3404,10,100,1e-05,0.01,0.828,1687,1717
15,3504,10,100,1e-05,0.01,0.858,1743,1761
15,3604,10,100,1e-05,0.01,0.862,1800,1804
15,3704,10,100,1e-05,0.01,0.888,1842,1862
15,3804,10,100,1e-05,0.01,0.88,1895,1909
15,3904,10,100,1e-05,0.01,0.898,1953,1951
15,4004,10,100,1e-05,0.01,0.858,2001,2003
15,4104,10,100,1e-05,0.01,0.872,2048,2056
15,4204,10,100,1e-05,0.01,0.896,2101,2103
15,4304,10,100,1e-05,0.01,0.906,2144,2160
15,4404,10,100,1e-05,0.01,0.912,2197,2207
15,4504,10,100,1e-05,0.01,0.898,2253,2251
15,4604,10,100,1e-05,0.01,0.914,2297,2307
15,4704,10,100,1e-05,0.01,0.926,2355,2349
15,4804,10,100,1e-05,0.01,0.916,2399,2405
15,4904,10,100,1e-05,0.01,0.912,2444,2460
15,5004,10,100,1e-05,0.01,0.926,2491,2513
15,5104,10,100,1e-05,0.01,0.9,2535,2569
15,5204,10,100,1e-05,0.01,0.92,2579,2625
15,5304,10,100,1e-05,0.01,0.944,2641,2663
15,5404,10,100,1e-05,0.01,0.934,2689,2715
15,5504,10,100,1e-05,0.01,0.938,2745,2759
15,5604,10,100,1e-05,0.01,0.93,2792,2812
15,5704,10,100,1e-05,0.01,0.948,2845,2859
15,5804,10,100,1e-05,0.01,0.94,2902,2902
15,5904,10,100,1e-05,0.01,0.938,2945,2959
15,6004,10,100,1e-05,0.01,0.93,2988,3016
15,6104,10,100,1e-05,0.01,0.936,3039,3065
15,6204,10,100,1e-05,0.01,0.956,3091,3113
15,6304,10,100,1e-05,0.01,0.958,3141,3163
15,6404,10,100,1e-05,0.01,0.954,3189,3215
15,6504,10,100,1e-05,0.01,0.952,3242,3262
15,6604,10,100,1e-05,0.01,0.952,3288,3316
15,6704,10,100,1e-05,0.01,0.902,3335,3369
15,6804,10,100,1e-05,0.01,0.952,3379,3425
15,6904,10,100,1e-05,0.01,0.964,3426,3478
15,7004,10,100,1e-05,0.01,0.974,3482,3522
15,7104,10,100,1e-05,0.01,0.97,3535,3569
15,7204,10,100,1e-05,0.01,0.978,3584,3620
15,7304,10,100,1e-05,0.01,0.972,3630,3674
15,7404,10,100,1e-05,0.01,0.976,3684,3720
15,7504,10,100,1e-05,0.01,0.966,3733,3771
15,7604,10,100,1e-05,0.01,0.968,3778,3826
15,7704,10,100,1e-05,0.01,0.97,3823,3881
15,7804,10,100,1e-05,0.01,0.962,3872,3932
15,7904,10,100,1e-05,0.01,0.976,3929,3975
15,8004,10,100,1e-05,0.01,0.97,3977,4027
15,8104,10,100,1e-05,0.01,0.976,4025,4079
15,8204,10,100,1e-05,0.01,0.966,4076,4128
15,8304,10,100,1e-05,0.01,0.976,4135,4169
15,8404,10,100,1e-05,0.01,0.978,4187,4217
15,8504,10,100,1e-05,0.01,0.97,4233,4271
15,8604,10,100,1e-05,0.01,0.976,4283,4321
15,8704,10,100,1e-05,0.01,0.966,4335,4369
15,8804,10,100,1e-05,0.01,0.988,4381,4423
15,8904,10,100,1e-05,0.01,0.98,4427,4477
15,9004,10,100,1e-05,0.01,0.978,4474,4530
15,9104,10,100,1e-05,0.01,0.988,4533,4571
15,9204,10,100,1e-05,0.01,0.988,4584,4620
15,9304,10,100,1e-05,0.01,0.986,4631,4673
15,9404,10,100,1e-05,0.01,0.988,4672,4732
15,9504,10,100,1e-05,0.01,0.986,4721,4783
15,9604,10,100,1e-05,0.01,0.988,4773,4831
15,9704,10,100,1e-05,0.01,0.982,4822,4882
15,9804,10,100,1e-05,0.01,0.984,4877,4927
15,9904,10,100,1e-05,0.01,0.99,4930,4974
15,10004,10,100,1e-05,0.01,0.988,4978,5026
15,10104,10,100,1e-05,0.01,0.984,5020,5084
15,10204,10,100,1e-05,0.01,0.972,5067,5137
15,10304,10,100,1e-05,0.01,0.98,5114,5190
15,10404,10,100,1e-05,0.01,0.994,5164,5240
15,10504,10,100,1e-05,0.01,0.994,5216,5288
15,10604,10,100,1e-05,0.01,0.992,5261,5343
15,10704,10,100,1e-05,0.01,0.988,5316,5388
15,10804,10,100,1e-05,0.01,0.986,5367,5437
15,10904,10,100,1e-05,0.01,0.99,5418,5486
15,11004,10,100,1e-05,0.01,0.986,5465,5539
15,11104,10,100,1e-05,0.01,0.986,5515,5589
15,11204,10,100,1e-05,0.01,0.98,5569,5635
15,11304,10,100,1e-05,0.01,0.962,5616,5688
15,11404,10,100,1e-05,0.01,0.982,5661,5743
15,11504,10,100,1e-05,0.01,0.994,5705,5799
15,11604,10,100,1e-05,0.01,0.984,5752,5852
15,11704,10,100,1e-05,0.01,0.988,5807,5897
15,11804,10,100,1e-05,0.01,0.984,5856,5948
15,11904,10,100,1e-05,0.01,0.99,5904,6000
15,12004,10,100,1e-05,0.01,0.992,5957,6047
15,12104,10,100,1e-05,0.01,0.988,6015,6089
15,12204,10,100,1e-05,0.01,0.99,6076,6128
15,12304,10,100,1e-05,0.01,0.984,6122,6182
15,12404,10,100,1e-05,0.01,0.958,6167,6237
15,12504,10,100,1e-05,0.01,0.986,6220,6284
15,12604,10,100,1e-05,0.01,0.99,6270,6334
15,12704,10,100,1e-05,0.01,0.992,6318,6386
15,12804,10,100,1e-05,0.01,0.992,6370,6434
15,12904,10,100,1e-05,0.01,0.992,6435,6469
15,13004,10,100,1e-05,0.01,0.992,6486,6518
15,13104,10,100,1e-05,0.01,0.992,6539,6565
15,13204,10,100,1e-05,0.01,0.978,6598,6606
15,13304,10,100,1e-05,0.01,0.982,6650,6654
15,13404,10,100,1e-05,0.01,0.982,6705,6699
15,13504,10,100,1e-05,0.01,0.988,6754,6750
15,13604,10,100,1e-05,0.01,0.99,6808,6796
15,13704,10,100,1e-05,0.01,0.992,6858,6846
15,13804,10,100,1e-05,0.01,0.986,6907,6897
15,13904,10,100,1e-05,0.01,0.986,6959,6945
15,14004,10,100,1e-05,0.01,0.988,7019,6985
15,14104,10,100,1e-05,0.01,0.994,7066,7038
15,14204,10,100,1e-05,0.01,0.992,7109,7095
15,14304,10,100,1e-05,0.01,0.992,7168,7136
15,14404,10,100,1e-05,0.01,0.992,7211,7193
15,14504,10,100,1e-05,0.01,0.988,7271,7233
15,14604,10,100,1e-05,0.01,0.99,7317,7287
15,14704,10,100,1e-05,0.01,0.976,7361,7343
15,14804,10,100,1e-05,0.01,0.976,7419,7385
15,14904,10,100,1e-05,0.01,0.99,7463,7441
15,15004,10,100,1e-05,0.01,0.994,7525,7479
16,104,10,100,1e-05,0.01,0.516,58,46
16,204,10,100,1e-05,0.01,0.506,100,104
16,304,10,100,1e-05,0.01,0.5,146,158
16,404,10,100,1e-05,0.01,0.496,199,205
16,504,10,100,1e-05,0.01,0.498,245,259
16,604,10,100,1e-05,0.01,0.518,291,313
16,704,10,100,1e-05,0.01,0.518,333,371
16,804,10,100,1e-05,0.01,0.518,375,429
16,904,10,100,1e-05,0.01,0.524,423,481
16,1004,10,100,1e-05,0.01,0.538,479,525
16,1104,10,100,1e-05,0.01,0.536,533,571
16,1204,10,100,1e-05,0.01,0.544,582,622
16,1304,10,100,1e-05,0.01,0.532,622,682
16,1404,10,100,1e-05,0.01,0.522,683,721
16,1504,10,100,1e-05,0.01,0.5,729,775
16,1604,10,100,1e-05,0.01,0.562,782,822
16,1704,10,100,1e-05,0.01,0.546,834,870
16,1804,10,100,1e-05,0.01,0.554,879,925
16,1904,10,100,1e-05,0.01,0.546,933,971
16,2004,10,100,1e-05,0.01,0.564,987,1017
16,2104,10,100,1e-05,0.01,0.548,1035,1069
16,2204,10,100,1e-05,0.01,0.544,1084,1120
16,2304,10,100,1e-05,0.01,0.594,1135,1169
16,2404,10,100,1e-05,0.01,0.588,1187,1217
16,2504,10,100,1e-05,0.01,0.614,1242,1262
16,2604,10,100,1e-05,0.01,0.652,1298,1306
16,2704,10,100,1e-05,0.01,0.672,1347,1357
16,2804,10,100,1e-05,0.01,0.658,1399,1405
16,2904,10,100,1e-05,0.01,0.7,1454,1450
16,3004,10,100,1e-05,0.01,0.72,1515,1489
16,3104,10,100,1e-05,0.01,0.77,1567,1537
16,3204,10,100,1e-05,0.01,0.772,1617,1587
16,3304,10,100,1e-05,0.01,0.766,1669,1635
16,3404,10,100,1e-05,0.01,0.8,1717,1687
16,3504,10,100,1e-05,0.01,0.8,1774,1730
16,3604,10,100,1e-05,0.01,0.812,1825,1779
16,3704,10,100,1e-05,0.01,0.856,1870,1834
16,3804,10,100,1e-05,0.01,0.858,1918,1886
16,3904,10,100,1e-05,0.01,0.818,1973,1931
16,4004,10,100,1e-05,0.01,0.878,2017,1987
16,4104,10,100,1e-05,0.01,0.898,2067,2037
16,4204,10,100,1e-05,0.01,0.876,2122,2082
16,4304,10,100,1e-05,0.01,0.898,2170,2134
16,4404,10,100,1e-05,0.01,0.894,2221,2183
16,4504,10,100,1e-05,0.01,0.908,2276,2228
16,4604,10,100,1e-05,0.01,0.898,2330,2274
16,4704,10,100,1e-05,0.01,0.902,2379,2325
16,4804,10,100,1e-05,0.01,0.92,2429,2375
16,4904,10,100,1e-05,0.01,0.932,2480,2424
16,5004,10,100,1e-05,0.01,0.918,2533,2471
16,5104,10,100,1e-05,0.01,0.898,2585,2519
16,5204,10,100,1e-05,0.01,0.912,2630,2574
16,5304,10,100,1e-05,0.01,0.93,2677,2627
16,5404,10,100,1e-05,0.01,0.94,2723,2681
16,5504,10,100,1e-05,0.01,0.944,2778,2726
16,5604,10,100,1e-05,0.01,0.958,2830,2774
16,5704,10,100,1e-05,0.01,0.966,2890,2814
16,5804,10,100,1e-05,0.01,0.962,2938,2866
16,5904,10,100,1e-05,0.01,0.968,2985,2919
16,6004,10,100,1e-05,0.01,0.962,3031,2973
16,6104,10,100,1e-05,0.01,0.952,3079,3025
16,6204,10,100,1e-05,0.01,0.972,3131,3073
16,6304,10,100,1e-05,0.01,0.966,3174,3130
16,6404,10,100,1e-05,0.01,0.964,3229,3175
16,6504,10,100,1e-05,0.01,0.97,3282,3222
16,6604,10,100,1e-05,0.01,0.966,3320,3284
16,6704,10,100,1e-05,0.01,0.962,3369,3335
16,6804,10,100,1e-05,0.01,0.958,3420,3384
16,6904,10,100,1e-05,0.01,0.974,3472,3432
16,7004,10,100,1e-05,0.01,0.974,3527,3477
16,7104,10,100,1e-05,0.01,0.964,3576,3528
16,7204,10,100,1e-05,0.01,0.978,3621,3583
16,7304,10,100,1e-05,0.01,0.972,3675,3629
16,7404,10,100,1e-05,0.01,0.964,3721,3683
16,7504,10,100,1e-05,0.01,0.964,3766,3738
16,7604,10,100,1e-05,0.01,0.974,3817,3787
16,7704,10,100,1e-05,0.01,0.982,3863,3841
16,7804,10,100,1e-05,0.01,0.984,3909,3895
16,7904,10,100,1e-05,0.01,0.986,3957,3947
16,8004,10,100,1e-05,0.01,0.986,4022,3982
16,8104,10,100,1e-05,0.01,0.984,4072,4032
16,8204,10,100,1e-05,0.01,0.982,4126,4078
16,8304,10,100,1e-05,0.01,0.97,4175,4129
16,8404,10,100,1e-05,0.01,0.968,4223,4181
16,8504,10,100,1e-05,0.01,0.97,4275,4229
16,8604,10,100,1e-05,0.01,0.98,4317,4287
16,8704,10,100,1e-05,0.01,0.988,4364,4340
16,8804,10,100,1e-05,0.01,0.97,4422,4382
16,8904,10,100,1e-05,0.01,0.982,4480,4424
16,9004,10,100,1e-05,0.01,0.984,4537,4467
16,9104,10,100,1e-05,0.01,0.986,4592,4512
16,9204,10,100,1e-05,0.01,0.978,4643,4561
16,9304,10,100,1e-05,0.01,0.99,4695,4609
16,9404,10,100,1e-05,0.01,0.986,4748,4656
16,9504,10,100,1e-05,0.01,0.976,4799,4705
16,9604,10,100,1e-05,0.01,0.99,4858,4746
16,9704,10,100,1e-05,0.01,0.99,4908,4796
16,9804,10,100,1e-05,0.01,0.99,4957,4847
16,9904,10,100,1e-05,0.01,0.974,5006,4898
16,10004,10,100,1e-05,0.01,0.966,5053,4951
16,10104,10,100,1e-05,0.01,0.986,5107,4997
16,10204,10,100,1e-05,0.01,0.988,5150,5054
16,10304,10,100,1e-05,0.01,0.978,5206,5098
16,10404,10,100,1e-05,0.01,0.988,5255,5149
16,10504,10,100,1e-05,0.01,0.99,5297,5207
16,10604,10,100,1e-05,0.01,0.99,5345,5259
16,10704,10,100,1e-05,0.01,0.99,5396,5308
16,10804,10,100,1e-05,0.01,0.994,5440,5364
16,10904,10,100,1e-05,0.01,0.986,5491,5413
16,11004,10,100,1e-05,0.01,0.986,5532,5472
16,11104,10,100,1e-05,0.01,0.988,5575,5529
16,11204,10,100,1e-05,0.01,0.986,5626,5578
16,11304,10,100,1e-05,0.01,0.992,5682,5622
16,11404,10,100,1e-05,0.01,0.992,5727,5677
16,11504,10,100,1e-05,0.01,0.994,5773,5731
16,11604,10,100,1e-05,0.01,0.982,5819,5785
16,11704,10,100,1e-05,0.01,0.984,5861,5843
16,11804,10,100,1e-05,0.01,0.99,5912,5892
16,11904,10,100,1e-05,0.01,0.992,5956,5948
16,12004,10,100,1e-05,0.01,0.986,6005,5999
16,12104,10,100,1e-05,0.01,0.99,6051,6053
16,12204,10,100,1e-05,0.01,0.97,6106,6098
16,12304,10,100,1e-05,0.01,0.99,6156,6148
16,12404,10,100,1e-05,0.01,0.99,6204,6200
16,12504,10,100,1e-05,0.01,0.994,6246,6258
16,12604,10,100,1e-05,0.01,0.994,6295,6309
16,12704,10,100,1e-05,0.01,0.992,6343,6361
16,12804,10,100,1e-05,0.01,0.992,6387,6417
16,12904,10,100,1e-05,0.01,0.994,6440,6464
16,13004,10,100,1e-05,0.01,0.994,6492,6512
16,13104,10,100,1e-05,0.01,0.982,6538,6566
16,13204,10,100,1e-05,0.01,0.986,6592,6612
16,13304,10,100,1e-05,0.01,0.988,6637,6667
16,13404,10,100,1e-05,0.01,0.992,6687,6717
16,13504,10,100,1e-05,0.01,0.992,6749,6755
16,13604,10,100,1e-05,0.01,0.994,6794,6810
16,13704,10,100,1e-05,0.01,0.988,6837,6867
16,13804,10,100,1e-05,0.01,0.994,6893,6911
16,13904,10,100,1e-05,0.01,0.996,6943,6961
16,14004,10,100,1e-05,0.01,0.994,6994,7010
16,14104,10,100,1e-05,0.01,0.996,7045,7059
16,14204,10,100,1e-05,0.01,0.992,7089,7115
16,14304,10,100,1e-05,0.01,0.994,7140,7164
16,14404,10,100,1e-05,0.01,0.974,7191,7213
16,14504,10,100,1e-05,0.01,0.996,7242,7262
16,14604,10,100,1e-05,0.01,1.0,7286,7318
16,14704,10,100,1e-05,0.01,0.994,7348,7356
16,14804,10,100,1e-05,0.01,0.998,7400,7404
16,14904,10,100,1e-05,0.01,0.994,7452,7452
16,15004,10,100,1e-05,0.01,0.99,7499,7505
17,104,10,100,1e-05,0.01,0.508,46,58
17,204,10,100,1e-05,0.01,0.49,92,112
17,304,10,100,1e-05,0.01,0.49,150,154
17,404,10,100,1e-05,0.01,0.51,195,209
17,504,10,100,1e-05,0.01,0.534,242,262
17,604,10,100,1e-05,0.01,0.516,290,314
17,704,10,100,1e-05,0.01,0.49,335,369
17,804,10,100,1e-05,0.01,0.5,388,416
17,904,10,100,1e-05,0.01,0.508,440,464
17,1004,10,100,1e-05,0.01,0.514,490,514
17,1104,10,100,1e-05,0.01,0.496,548,556
17,1204,10,100,1e-05,0.01,0.51,598,606
17,1304,10,100,1e-05,0.01,0.518,644,660
17,1404,10,100,1e-05,0.01,0.516,693,711
17,1504,10,100,1e-05,0.01,0.534,746,758
17,1604,10,100,1e-05,0.01,0.532,800,804
17,1704,10,100,1e-05,0.01,0.54,850,854
17,1804,10,100,1e-05,0.01,0.562,905,899
17,1904,10,100,1e-05,0.01,0.568,954,950
17,2004,10,100,1e-05,0.01,0.6,1004,1000
17,2104,10,100,1e-05,0.01,0.626,1062,1042
17,2204,10,100,1e-05,0.01,0.648,1110,1094
17,2304,10,100,1e-05,0.01,0.66,1153,1151
17,2404,10,100,1e-05,0.01,0.654,1198,1206
17,2504,10,100,1e-05,0.01,0.68,1251,1253
17,2604,10,100,1e-05,0.01,0.73,1297,1307
17,2704,10,100,1e-05,0.01,0.732,1347,1357
17,2804,10,100,1e-05,0.01,0.766,1398,1406
17,2904,10,100,1e-05,0.01,0.8,1452,1452
17,3004,10,100,1e-05,0.01,0.79,1503,1501
17,3104,10,100,1e-05,0.01,0.844,1559,1545
17,3204,10,100,1e-05,0.01,0.864,1604,1600
17,3304,10,100,1e-05,0.01,0.888,1648,1656
17,3404,10,100,1e-05,0.01,0.862,1702,1702
17,3504,10,100,1e-05,0.01,0.84,1757,1747
17,3604,10,100,1e-05,0.01,0.858,1810,1794
17,3704,10,100,1e-05,0.01,0.886,1856,1848
17,3804,10,100,1e-05,0.01,0.908,1910,1894
17,3904,10,100,1e-05,0.01,0.88,1961,1943
17,4004,10,100,1e-05,0.01,0.896,2015,1989
17,4104,10,100,1e-05,0.01,0.908,2061,2043
17,4204,10,100,1e-05,0.01,0.942,2100,2104
17,4304,10,100,1e-05,0.01,0.944,2151,2153
17,4404,10,100,1e-05,0.01,0.934,2200,2204
17,4504,10,100,1e-05,0.01,0.93,2242,2262
17,4604,10,100,1e-05,0.01,0.95,2286,2318
17,4704,10,100,1e-05,0.01,0.944,2338,2366
17,4804,10,100,1e-05,0.01,0.938,2387,2417
17,4904,10,100,1e-05,0.01,0.938,2443,2461
17,5004,10,100,1e-05,0.01,0.93,2490,2514
17,5104,10,100,1e-05,0.01,0.95,2542,2562
17,5204,10,100,1e-05,0.01,0.962,2592,2612
17,5304,10,100,1e-05,0.01,0.966,2640,2664
17,5404,10,100,1e-05,0.01,0.968,2684,2720
17,5504,10,100,1e-05,0.01,0.972,2730,2774
17,5604,10,100,1e-05,0.01,0.964,2775,2829
17,5704,10,100,1e-05,0.01,0.95,2822,2882
17,5804,10,100,1e-05,0.01,0.964,2869,2935
17,5904,10,100,1e-05,0.01,0.95,2918,2986
17,6004,10,100,1e-05,0.01,0.93,2965,3039
17,6104,10,100,1e-05,0.01,0.976,3024,3080
17,6204,10,100,1e-05,0.01,0.97,3072,3132
17,6304,10,100,1e-05,0.01,0.978,3124,3180
17,6404,10,100,1e-05,0.01,0.974,3178,3226
17,6504,10,100,1e-05,0.01,0.982,3230,3274
17,6604,10,100,1e-05,0.01,0.982,3279,3325
17,6704,10,100,1e-05,0.01,0.984,3326,3378
17,6804,10,100,1e-05,0.01,0.984,3381,3423
17,6904,10,100,1e-05,0.01,0.984,3427,3477
17,7004,10,100,1e-05,0.01,0.982,3483,3521
17,7104,10,100,1e-05,0.01,0.98,3535,3569
17,7204,10,100,1e-05,0.01,0.986,3586,3618
17,7304,10,100,1e-05,0.01,0.986,3636,3668
17,7404,10,100,1e-05,0.01,0.988,3684,3720
17,7504,10,100,1e-05,0.01,0.986,3738,3766
17,7604,10,100,1e-05,0.01,0.988,3791,3813
17,7704,10,100,1e-05,0.01,0.97,3847,3857
17,7804,10,100,1e-05,0.01,0.974,3890,3914
17,7904,10,100,1e-05,0.01,0.978,3951,3953
17,8004,10,100,1e-05,0.01,0.982,4001,4003
17,8104,10,100,1e-05,0.01,0.982,4052,4052
17,8204,10,100,1e-05,0.01,0.982,4102,4102
17,8304,10,100,1e-05,0.01,0.986,4146,4158
17,8404,10,100,1e-05,0.01,0.986,4195,4209
17,8504,10,100,1e-05,0.01,0.986,4241,4263
17,8604,10,100,1e-05,0.01,0.988,4288,4316
17,8704,10,100,1e-05,0.01,0.982,4334,4370
17,8804,10,100,1e-05,0.01,0.986,4381,4423
17,8904,10,100,1e-05,0.01,0.988,4432,4472
17,9004,10,100,1e-05,0.01,0.988,4486,4518
17,9104,10,100,1e-05,0.01,0.984,4543,4561
17,9204,10,100,1e-05,0.01,0.982,4593,4611
17,9304,10,100,1e-05,0.01,0.986,4637,4667
17,9404,10,100,1e-05,0.01,0.974,4689,4715
17,9504,10,100,1e-05,0.01,0.988,4737,4767
17,9604,10,100,1e-05,0.01,0.988,4799,4805
17,9704,10,100,1e-05,0.01,0.982,4856,4848
17,9804,10,100,1e-05,0.01,0.988,4908,4896
17,9904,10,100,1e-05,0.01,0.99,4952,4952
17,10004,10,100,1e-05,0.01,0.99,4999,5005
17,10104,10,100,1e-05,0.01,0.992,5046,5058
17,10204,10,100,1e-05,0.01,0.99,5093,5111
17,10304,10,100,1e-05,0.01,0.992,5143,5161
17,10404,10,100,1e-05,0.01,0.992,5190,5214
17,10504,10,100,1e-05,0.01,0.99,5233,5271
17,10604,10,100,1e-05,0.01,0.982,5278,5326
17,10704,10,100,1e-05,0.01,0.99,5330,5374
17,10804,10,100,1e-05,0.01,0.986,5382,5422
17,10904,10,100,1e-05,0.01,0.996,5433,5471
17,11004,10,100,1e-05,0.01,0.994,5498,5506
17,11104,10,100,1e-05,0.01,0.996,5548,5556
17,11204,10,100,1e-05,0.01,0.99,5595,5609
17,11304,10,100,1e-05,0.01,0.992,5644,5660
17,11404,10,100,1e-05,0.01,0.99,5690,5714
17,11504,10,100,1e-05,0.01,0.998,5744,5760
17,11604,10,100,1e-05,0.01,0.998,5787,5817
17,11704,10,100,1e-05,0.01,0.998,5834,5870
17,11804,10,100,1e-05,0.01,0.996,5888,5916
17,11904,10,100,1e-05,0.01,0.994,5934,5970
17,12004,10,100,1e-05,0.01,0.994,5984,6020
17,12104,10,100,1e-05,0.01,0.99,6041,6063
17,12204,10,100,1e-05,0.01,0.99,6098,6106
17,12304,10,100,1e-05,0.01,0.992,6154,6150
17,12404,10,100,1e-05,0.01,0.984,6202,6202
17,12504,10,100,1e-05,0.01,0.998,6250,6254
17,12604,10,100,1e-05,0.01,0.994,6301,6303
17,12704,10,100,1e-05,0.01,0.998,6345,6359
17,12804,10,100,1e-05,0.01,0.996,6396,6408
17,12904,10,100,1e-05,0.01,0.998,6442,6462
17,13004,10,100,1e-05,0.01,0.994,6495,6509
17,13104,10,100,1e-05,0.01,0.998,6554,6550
17,13204,10,100,1e-05,0.01,0.998,6607,6597
17,13304,10,100,1e-05,0.01,0.998,6650,6654
17,13404,10,100,1e-05,0.01,0.986,6697,6707
17,13504,10,100,1e-05,0.01,0.994,6751,6753
17,13604,10,100,1e-05,0.01,0.994,6795,6809
17,13704,10,100,1e-05,0.01,0.998,6850,6854
17,13804,10,100,1e-05,0.01,0.998,6897,6907
17,13904,10,100,1e-05,0.01,1.0,6943,6961
17,14004,10,100,1e-05,0.01,0.998,6997,7007
17,14104,10,100,1e-05,0.01,0.998,7056,7048
17,14204,10,100,1e-05,0.01,1.0,7106,7098
17,14304,10,100,1e-05,0.01,1.0,7154,7150
17,14404,10,100,1e-05,0.01,0.998,7206,7198
17,14504,10,100,1e-05,0.01,0.996,7256,7248
17,14604,10,100,1e-05,0.01,0.998,7303,7301
17,14704,10,100,1e-05,0.01,0.994,7353,7351
17,14804,10,100,1e-05,0.01,0.99,7397,7407
17,14904,10,100,1e-05,0.01,1.0,7449,7455
17,15004,10,100,1e-05,0.01,1.0,7497,7507
18,104,10,100,1e-05,0.01,0.476,48,56
18,204,10,100,1e-05,0.01,0.508,101,103
18,304,10,100,1e-05,0.01,0.52,149,155
18,404,10,100,1e-05,0.01,0.508,204,200
18,504,10,100,1e-05,0.01,0.496,258,246
18,604,10,100,1e-05,0.01,0.506,307,297
18,704,10,100,1e-05,0.01,0.486,359,345
18,804,10,100,1e-05,0.01,0.486,411,393
18,904,10,100,1e-05,0.01,0.486,461,443
18,1004,10,100,1e-05,0.01,0.504,511,493
18,1104,10,100,1e-05,0.01,0.484,564,540
18,1204,10,100,1e-05,0.01,0.5,622,582
18,1304,10,100,1e-05,0.01,0.48,681,623
18,1404,10,100,1e-05,0.01,0.488,733,671
18,1504,10,100,1e-05,0.01,0.51,781,723
18,1604,10,100,1e-05,0.01,0.48,835,769
18,1704,10,100,1e-05,0.01,0.518,879,825
18,1804,10,100,1e-05,0.01,0.508,927,877
18,1904,10,100,1e-05,0.01,0.516,976,928
18,2004,10,100,1e-05,0.01,0.514,1022,982
18,2104,10,100,1e-05,0.01,0.518,1075,1029
18,2204,10,100,1e-05,0.01,0.542,1118,1086
18,2304,10,100,1e-05,0.01,0.58,1169,1135
18,2404,10,100,1e-05,0.01,0.586,1216,1188
18,2504,10,100,1e-05,0.01,0.62,1261,1243
18,2604,10,100,1e-05,0.01,0.616,1306,1298
18,2704,10,100,1e-05,0.01,0.58,1350,1354
18,2804,10,100,1e-05,0.01,0.62,1397,1407
18,2904,10,100,1e-05,0.01,0.62,1447,1457
18,3004,10,100,1e-05,0.01,0.672,1495,1509
18,3104,10,100,1e-05,0.01,0.696,1537,1567
18,3204,10,100,1e-05,0.01,0.702,1583,1621
18,3304,10,100,1e-05,0.01,0.698,1630,1674
18,3404,10,100,1e-05,0.01,0.742,1679,1725
18,3504,10,100,1e-05,0.01,0.76,1721,1783
18,3604,10,100,1e-05,0.01,0.796,1772,1832
18,3704,10,100,1e-05,0.01,0.798,1819,1885
18,3804,10,100,1e-05,0.01,0.794,1868,1936
18,3904,10,100,1e-05,0.01,0.79,1923,1981
18,4004,10,100,1e-05,0.01,0.812,1965,2039
18,4104,10,100,1e-05,0.01,0.84,2007,2097
18,4204,10,100,1e-05,0.01,0.852,2044,2160
18,4304,10,100,1e-05,0.01,0.868,2096,2208
18,4404,10,100,1e-05,0.01,0.872,2142,2262
18,4504,10,100,1e-05,0.01,0.88,2206,2298
18,4604,10,100,1e-05,0.01,0.86,2251,2353
18,4704,10,100,1e-05,0.01,0.874,2305,2399
18,4804,10,100,1e-05,0.01,0.888,2355,2449
18,4904,10,100,1e-05,0.01,0.886,2404,2500
18,5004,10,100,1e-05,0.01,0.902,2441,2563
18,5104,10,100,1e-05,0.01,0.896,2487,2617
18,5204,10,100,1e-05,0.01,0.896,2544,2660
18,5304,10,100,1e-05,0.01,0.876,2607,2697
18,5404,10,100,1e-05,0.01,0.866,2649,2755
18,5504,10,100,1e-05,0.01,0.882,2711,2793
18,5604,10,100,1e-05,0.01,0.896,2767,2837
18,5704,10,100,1e-05,0.01,0.918,2819,2885
18,5804,10,100,1e-05,0.01,0.91,2872,2932
18,5904,10,100,1e-05,0.01,0.93,2930,2974
18,6004,10,100,1e-05,0.01,0.906,2979,3025
18,6104,10,100,1e-05,0.01,0.92,3027,3077
18,6204,10,100,1e-05,0.01,0.924,3082,3122
18,6304,10,100,1e-05,0.01,0.914,3127,3177
18,6404,10,100,1e-05,0.01,0.93,3180,3224
18,6504,10,100,1e-05,0.01,0.934,3231,3273
18,6604,10,100,1e-05,0.01,0.936,3278,3326
18,6704,10,100,1e-05,0.01,0.942,3335,3369
18,6804,10,100,1e-05,0.01,0.928,3386,3418
18,6904,10,100,1e-05,0.01,0.904,3441,3463
18,7004,10,100,1e-05,0.01,0.914,3496,3508
18,7104,10,100,1e-05,0.01,0.954,3546,3558
18,7204,10,100,1e-05,0.01,0.94,3594,3610
18,7304,10,100,1e-05,0.01,0.95,3638,3666
18,7404,10,100,1e-05,0.01,0.944,3691,3713
18,7504,10,100,1e-05,0.01,0.948,3740,3764
18,7604,10,100,1e-05,0.01,0.95,3792,3812
18,7704,10,100,1e-05,0.01,0.962,3841,3863
18,7804,10,100,1e-05,0.01,0.962,3895,3909
18,7904,10,100,1e-05,0.01,0.962,3944,3960
18,8004,10,100,1e-05,0.01,0.966,3990,4014
18,8104,10,100,1e-05,0.01,0.966,4042,4062
18,8204,10,100,1e-05,0.01,0.96,4094,4110
18,8304,10,100,1e-05,0.01,0.958,4150,4154
18,8404,10,100,1e-05,0.01,0.974,4203,4201
18,8504,10,100,1e-05,0.01,0.972,4243,4261
18,8604,10,100,1e-05,0.01,0.96,4286,4318
18,8704,10,100,1e-05,0.01,0.962,4334,4370
18,8804,10,100,1e-05,0.01,0.98,4381,4423
18,8904,10,100,1e-05,0.01,0.97,4428,4476
18,9004,10,100,1e-05,0.01,0.954,4479,4525
18,9104,10,100,1e-05,0.01,0.986,4525,4579
18,9204,10,100,1e-05,0.01,0.972,4577,4627
18,9304,10,100,1e-05,0.01,0.982,4624,4680
18,9404,10,100,1e-05,0.01,0.972,4677,4727
18,9504,10,100,1e-05,0.01,0.97,4719,4785
18,9604,10,100,1e-05,0.01,0.978,4763,4841
18,9704,10,100,1e-05,0.01,0.986,4813,4891
18,9804,10,100,1e-05,0.01,0.976,4865,4939
18,9904,10,100,1e-05,0.01,0.982,4917,4987
18,10004,10,100,1e-05,0.01,0.974,4969,5035
18,10104,10,100,1e-05,0.01,0.988,5022,5082
18,10204,10,100,1e-05,0.01,0.982,5068,5136
18,10304,10,100,1e-05,0.01,0.974,5127,5177
18,10404,10,100,1e-05,0.01,0.974,5182,5222
18,10504,10,100,1e-05,0.01,0.982,5232,5272
18,10604,10,100,1e-05,0.01,0.974,5276,5328
18,10704,10,100,1e-05,0.01,0.974,5323,5381
18,10804,10,100,1e-05,0.01,0.984,5376,5428
18,10904,10,100,1e-05,0.01,0.984,5424,5480
18,11004,10,100,1e-05,0.01,0.99,5475,5529
18,11104,10,100,1e-05,0.01,0.974,5527,5577
18,11204,10,100,1e-05,0.01,0.996,5581,5623
18,11304,10,100,1e-05,0.01,0.986,5629,5675
18,11404,10,100,1e-05,0.01,0.994,5681,5723
18,11504,10,100,1e-05,0.01,0.992,5733,5771
18,11604,10,100,1e-05,0.01,0.968,5781,5823
18,11704,10,100,1e-05,0.01,0.982,5833,5871
18,11804,10,100,1e-05,0.01,0.982,5885,5919
18,11904,10,100,1e-05,0.01,0.99,5936,5968
18,12004,10,100,1e-05,0.01,0.982,5979,6025
18,12104,10,100,1e-05,0.01,0.994,6033,6071
18,12204,10,100,1e-05,0.01,0.994,6078,6126
18,12304,10,100,1e-05,0.01,0.996,6130,6174
18,12404,10,100,1e-05,0.01,0.988,6182,6222
18,12504,10,100,1e-05,0.01,0.998,6229,6275
18,12604,10,100,1e-05,0.01,0.998,6278,6326
18,12704,10,100,1e-05,0.01,0.996,6328,6376
18,12804,10,100,1e-05,0.01,0.998,6378,6426
18,12904,10,100,1e-05,0.01,0.996,6429,6475
18,13004,10,100,1e-05,0.01,0.998,6481,6523
18,13104,10,100,1e-05,0.01,0.982,6529,6575
18,13204,10,100,1e-05,0.01,0.976,6576,6628
18,13304,10,100,1e-05,0.01,0.976,6626,6678
18,13404,10,100,1e-05,0.01,0.99,6683,6721
18,13504,10,100,1e-05,0.01,0.994,6737,6767
18,13604,10,100,1e-05,0.01,0.99,6786,6818
18,13704,10,100,1e-05,0.01,0.992,6837,6867
18,13804,10,100,1e-05,0.01,0.996,6895,6909
18,13904,10,100,1e-05,0.01,0.996,6944,6960
18,14004,10,100,1e-05,0.01,0.996,7001,7003
18,14104,10,100,1e-05,0.01,0.996,7053,7051
18,14204,10,100,1e-05,0.01,0.994,7098,7106
18,14304,10,100,1e-05,0.01,0.988,7152,7152
18,14404,10,100,1e-05,0.01,0.994,7193,7211
18,14504,10,100,1e-05,0.01,0.988,7250,7254
18,14604,10,100,1e-05,0.01,0.996,7308,7296
18,14704,10,100,1e-05,0.01,0.992,7344,7360
18,14804,10,100,1e-05,0.01,0.99,7394,7410
18,14904,10,100,1e-05,0.01,0.986,7442,7462
18,15004,10,100,1e-05,0.01,0.992,7492,7512
19,104,10,100,1e-05,0.01,0.506,54,50
19,204,10,100,1e-05,0.01,0.484,102,102
19,304,10,100,1e-05,0.01,0.49,151,153
19,404,10,100,1e-05,0.01,0.508,209,195
19,504,10,100,1e-05,0.01,0.488,265,239
19,604,10,100,1e-05,0.01,0.52,313,291
19,704,10,100,1e-05,0.01,0.498,363,341
19,804,10,100,1e-05,0.01,0.498,412,392
19,904,10,100,1e-05,0.01,0.512,464,440
19,1004,10,100,1e-05,0.01,0.468,505,499
19,1104,10,100,1e-05,0.01,0.484,556,548
19,1204,10,100,1e-05,0.01,0.51,603,601
19,1304,10,100,1e-05,0.01,0.462,653,651
19,1404,10,100,1e-05,0.01,0.468,706,698
19,1504,10,100,1e-05,0.01,0.508,758,746
19,1604,10,100,1e-05,0.01,0.478,803,801
19,1704,10,100,1e-05,0.01,0.494,860,844
19,1804,10,100,1e-05,0.01,0.496,904,900
19,1904,10,100,1e-05,0.01,0.484,954,950
19,2004,10,100,1e-05,0.01,0.512,1009,995
19,2104,10,100,1e-05,0.01,0.482,1057,1047
19,2204,10,100,1e-05,0.01,0.502,1104,1100
19,2304,10,100,1e-05,0.01,0.514,1156,1148
19,2404,10,100,1e-05,0.01,0.538,1197,1207
19,2504,10,100,1e-05,0.01,0.548,1247,1257
19,2604,10,100,1e-05,0.01,0.558,1294,1310
19,2704,10,100,1e-05,0.01,0.592,1349,1355
19,2804,10,100,1e-05,0.01,0.638,1395,1409
19,2904,10,100,1e-05,0.01,0.632,1449,1455
19,3004,10,100,1e-05,0.01,0.692,1500,1504
19,3104,10,100,1e-05,0.01,0.644,1547,1557
19,3204,10,100,1e-05,0.01,0.698,1603,1601
19,3304,10,100,1e-05,0.01,0.704,1649,1655
19,3404,10,100,1e-05,0.01,0.688,1704,1700
19,3504,10,100,1e-05,0.01,0.722,1751,1753
19,3604,10,100,1e-05,0.01,0.756,1797,1807
19,3704,10,100,1e-05,0.01,0.77,1844,1860
19,3804,10,100,1e-05,0.01,0.782,1889,1915
19,3904,10,100,1e-05,0.01,0.776,1945,1959
19,4004,10,100,1e-05,0.01,0.798,1993,2011
19,4104,10,100,1e-05,0.01,0.818,2038,2066
19,4204,10,100,1e-05,0.01,0.802,2081,2123
19,4304,10,100,1e-05,0.01,0.772,2143,2161
19,4404,10,100,1e-05,0.01,0.836,2197,2207
19,4504,10,100,1e-05,0.01,0.86,2246,2258
19,4604,10,100,1e-05,0.01,0.868,2299,2305
19,4704,10,100,1e-05,0.01,0.87,2342,2362
19,4804,10,100,1e-05,0.01,0.886,2390,2414
19,4904,10,100,1e-05,0.01,0.882,2440,2464
19,5004,10,100,1e-05,0.01,0.906,2486,2518
19,5104,10,100,1e-05,0.01,0.898,2535,2569
19,5204,10,100,1e-05,0.01,0.89,2585,2619
19,5304,10,100,1e-05,0.01,0.904,2637,2667
19,5404,10,100,1e-05,0.01,0.892,2689,2715
19,5504,10,100,1e-05,0.01,0.908,2743,2761
19,5604,10,100,1e-05,0.01,0.916,2792,2812
19,5704,10,100,1e-05,0.01,0.894,2846,2858
19,5804,10,100,1e-05,0.01,0.918,2911,2893
19,5904,10,100,1e-05,0.01,0.894,2958,2946
19,6004,10,100,1e-05,0.01,0.926,3001,3003
19,6104,10,100,1e-05,0.01,0.942,3047,3057
19,6204,10,100,1e-05,0.01,0.936,3093,3111
19,6304,10,100,1e-05,0.01,0.934,3142,3162
19,6404,10,100,1e-05,0.01,0.936,3191,3213
19,6504,10,100,1e-05,0.01,0.942,3248,3256
19,6604,10,100,1e-05,0.01,0.934,3302,3302
19,6704,10,100,1e-05,0.01,0.922,3354,3350
19,6804,10,100,1e-05,0.01,0.944,3405,3399
19,6904,10,100,1e-05,0.01,0.948,3461,3443
19,7004,10,100,1e-05,0.01,0.948,3513,3491
19,7104,10,100,1e-05,0.01,0.944,3567,3537
19,7204,10,100,1e-05,0.01,0.934,3617,3587
19,7304,10,100,1e-05,0.01,0.946,3671,3633
19,7404,10,100,1e-05,0.01,0.95,3725,3679
19,7504,10,100,1e-05,0.01,0.944,3772,3732
19,7604,10,100,1e-05,0.01,0.95,3824,3780
19,7704,10,100,1e-05,0.01,0.96,3870,3834
19,7804,10,100,1e-05,0.01,0.962,3916,3888
19,7904,10,100,1e-05,0.01,0.948,3964,3940
19,8004,10,100,1e-05,0.01,0.958,4011,3993
19,8104,10,100,1e-05,0.01,0.952,4053,4051
19,8204,10,100,1e-05,0.01,0.97,4101,4103
19,8304,10,100,1e-05,0.01,0.968,4143,4161
19,8404,10,100,1e-05,0.01,0.968,4194,4210
19,8504,10,100,1e-05,0.01,0.958,4238,4266
19,8604,10,100,1e-05,0.01,0.966,4281,4323
19,8704,10,100,1e-05,0.01,0.968,4321,4383
19,8804,10,100,1e-05,0.01,0.962,4370,4434
19,8904,10,100,1e-05,0.01,0.954,4413,4491
19,9004,10,100,1e-05,0.01,0.956,4461,4543
19,9104,10,100,1e-05,0.01,0.966,4516,4588
19,9204,10,100,1e-05,0.01,0.956,4570,4634
19,9304,10,100,1e-05,0.01,0.972,4622,4682
19,9404,10,100,1e-05,0.01,0.97,4678,4726
19,9504,10,100,1e-05,0.01,0.97,4728,4776
19,9604,10,100,1e-05,0.01,0.978,4776,4828
19,9704,10,100,1e-05,0.01,0.964,4835,4869
19,9804,10,100,1e-05,0.01,0.98,4881,4923
19,9904,10,100,1e-05,0.01,0.98,4936,4968
19,10004,10,100,1e-05,0.01,0.982,4989,5015
19,10104,10,100,1e-05,0.01,0.98,5045,5059
19,10204,10,100,1e-05,0.01,0.976,5100,5104
19,10304,10,100,1e-05,0.01,0.984,5143,5161
19,10404,10,100,1e-05,0.01,0.982,5204,5200
19,10504,10,100,1e-05,0.01,0.972,5253,5251
19,10604,10,100,1e-05,0.01,0.968,5303,5301
19,10704,10,100,1e-05,0.01,0.97,5353,5351
19,10804,10,100,1e-05,0.01,0.984,5400,5404
19,10904,10,100,1e-05,0.01,0.984,5445,5459
19,11004,10,100,1e-05,0.01,0.978,5493,5511
19,11104,10,100,1e-05,0.01,0.976,5544,5560
19,11204,10,100,1e-05,0.01,0.976,5593,5611
19,11304,10,100,1e-05,0.01,0.982,5642,5662
19,11404,10,100,1e-05,0.01,0.976,5692,5712
19,11504,10,100,1e-05,0.01,0.98,5739,5765
19,11604,10,100,1e-05,0.01,0.982,5784,5820
19,11704,10,100,1e-05,0.01,0.98,5827,5877
19,11804,10,100,1e-05,0.01,0.984,5881,5923
19,11904,10,100,1e-05,0.01,0.978,5925,5979
19,12004,10,100,1e-05,0.01,0.964,5984,6020
19,12104,10,100,1e-05,0.01,0.968,6037,6067
19,12204,10,100,1e-05,0.01,0.974,6091,6113
19,12304,10,100,1e-05,0.01,0.97,6141,6163
19,12404,10,100,1e-05,0.01,0.978,6196,6208
19,12504,10,100,1e-05,0.01,0.98,6244,6260
19,12604,10,100,1e-05,0.01,0.978,6294,6310
19,12704,10,100,1e-05,0.01,0.984,6339,6365
19,12804,10,100,1e-05,0.01,0.984,6394,6410
19,12904,10,100,1e-05,0.01,0.98,6443,6461
19,13004,10,100,1e-05,0.01,0.978,6489,6515
19,13104,10,100,1e-05,0.01,0.982,6544,6560
19,13204,10,100,1e-05,0.01,0.974,6601,6603
19,13304,10,100,1e-05,0.01,0.982,6655,6649
19,13404,10,100,1e-05,0.01,0.98,6704,6700
19,13504,10,100,1e-05,0.01,0.976,6752,6752
19,13604,10,100,1e-05,0.01,0.978,6805,6799
19,13704,10,100,1e-05,0.01,0.98,6858,6846
19,13804,10,100,1e-05,0.01,0.982,6904,6900
19,13904,10,100,1e-05,0.01,0.982,6954,6950
19,14004,10,100,1e-05,0.01,0.978,7009,6995
19,14104,10,100,1e-05,0.01,0.982,7065,7039
19,14204,10,100,1e-05,0.01,0.986,7114,7090
19,14304,10,100,1e-05,0.01,0.994,7157,7147
19,14404,10,100,1e-05,0.01,0.994,7200,7204
19,14504,10,100,1e-05,0.01,0.99,7243,7261
19,14604,10,100,1e-05,0.01,0.988,7299,7305
19,14704,10,100,1e-05,0.01,0.992,7357,7347
19,14804,10,100,1e-05,0.01,0.98,7409,7395
19,14904,10,100,1e-05,0.01,0.988,7458,7446
19,15004,10,100,1e-05,0.01,0.992,7501,7503
20,104,10,100,1e-05,0.01,0.49,44,60
20,204,10,100,1e-05,0.01,0.478,103,101
20,304,10,100,1e-05,0.01,0.478,152,152
20,404,10,100,1e-05,0.01,0.504,202,202
20,504,10,100,1e-05,0.01,0.508,256,248
20,604,10,100,1e-05,0.01,0.518,308,296
20,704,10,100,1e-05,0.01,0.506,361,343
20,804,10,100,1e-05,0.01,0.5,415,389
20,904,10,100,1e-05,0.01,0.486,465,439
20,1004,10,100,1e-05,0.01,0.494,506,498
20,1104,10,100,1e-05,0.01,0.494,554,550
20,1204,10,100,1e-05,0.01,0.494,602,602
20,1304,10,100,1e-05,0.01,0.51,662,642
20,1404,10,100,1e-05,0.01,0.528,724,680
20,1504,10,100,1e-05,0.01,0.492,770,734
20,1604,10,100,1e-05,0.01,0.504,821,783
20,1704,10,100,1e-05,0.01,0.51,870,834
20,1804,10,100,1e-05,0.01,0.496,923,881
20,1904,10,100,1e-05,0.01,0.522,966,938
20,2004,10,100,1e-05,0.01,0.528,1017,987
20,2104,10,100,1e-05,0.01,0.552,1063,1041
20,2204,10,100,1e-05,0.01,0.566,1112,1092
20,2304,10,100,1e-05,0.01,0.588,1166,1138
20,2404,10,100,1e-05,0.01,0.59,1210,1194
20,2504,10,100,1e-05,0.01,0.658,1256,1248
20,2604,10,100,1e-05,0.01,0.67,1311,1293
20,2704,10,100,1e-05,0.01,0.678,1363,1341
20,2804,10,100,1e-05,0.01,0.69,1412,1392
20,2904,10,100,1e-05,0.01,0.738,1462,1442
20,3004,10,100,1e-05,0.01,0.734,1505,1499
20,3104,10,100,1e-05,0.01,0.716,1556,1548
20,3204,10,100,1e-05,0.01,0.766,1602,1602
20,3304,10,100,1e-05,0.01,0.78,1663,1641
20,3404,10,100,1e-05,0.01,0.814,1713,1691
20,3504,10,100,1e-05,0.01,0.816,1768,1736
20,3604,10,100,1e-05,0.01,0.84,1820,1784
20,3704,10,100,1e-05,0.01,0.838,1867,1837
20,3804,10,100,1e-05,0.01,0.84,1917,1887
20,3904,10,100,1e-05,0.01,0.832,1968,1936
20,4004,10,100,1e-05,0.01,0.866,2007,1997
20,4104,10,100,1e-05,0.01,0.856,2063,2041
20,4204,10,100,1e-05,0.01,0.874,2114,2090
20,4304,10,100,1e-05,0.01,0.862,2152,2152
20,4404,10,100,1e-05,0.01,0.864,2209,2195
20,4504,10,100,1e-05,0.01,0.886,2259,2245
20,4604,10,100,1e-05,0.01,0.882,2315,2289
20,4704,10,100,1e-05,0.01,0.91,2365,2339
20,4804,10,100,1e-05,0.01,0.902,2407,2397
20,4904,10,100,1e-05,0.01,0.908,2458,2446
20,5004,10,100,1e-05,0.01,0.93,2503,2501
20,5104,10,100,1e-05,0.01,0.942,2558,2546
20,5204,10,100,1e-05,0.01,0.936,2601,2603
20,5304,10,100,1e-05,0.01,0.942,2650,2654
20,5404,10,100,1e-05,0.01,0.944,2702,2702
20,5504,10,100,1e-05,0.01,0.94,2754,2750
20,5604,10,100,1e-05,0.01,0.954,2813,2791
20,5704,10,100,1e-05,0.01,0.942,2866,2838
20,5804,10,100,1e-05,0.01,0.946,2914,2890
20,5904,10,100,1e-05,0.01,0.95,2961,2943
20,6004,10,100,1e-05,0.01,0.946,3012,2992
20,6104,10,100,1e-05,0.01,0.932,3061,3043
20,6204,10,100,1e-05,0.01,0.936,3105,3099
20,6304,10,100,1e-05,0.01,0.924,3156,3148
20,6404,10,100,1e-05,0.01,0.95,3196,3208
20,6504,10,100,1e-05,0.01,0.942,3249,3255
20,6604,10,100,1e-05,0.01,0.952,3296,3308
20,6704,10,100,1e-05,0.01,0.968,3344,3360
20,6804,10,100,1e-05,0.01,0.968,3398,3406
20,6904,10,100,1e-05,0.01,0.972,3443,3461
20,7004,10,100,1e-05,0.01,0.97,3486,3518
20,7104,10,100,1e-05,0.01,0.964,3533,3571
20,7204,10,100,1e-05,0.01,0.97,3581,3623
20,7304,10,100,1e-05,0.01,0.972,3630,3674
20,7404,10,100,1e-05,0.01,0.97,3678,3726
20,7504,10,100,1e-05,0.01,0.972,3717,3787
20,7604,10,100,1e-05,0.01,0.976,3754,3850
20,7704,10,100,1e-05,0.01,0.968,3803,3901
20,7804,10,100,1e-05,0.01,0.984,3855,3949
20,7904,10,100,1e-05,0.01,0.974,3903,4001
20,8004,10,100,1e-05,0.01,0.968,3953,4051
20,8104,10,100,1e-05,0.01,0.96,4005,4099
20,8204,10,100,1e-05,0.01,0.96,4053,4151
20,8304,10,100,1e-05,0.01,0.952,4093,4211
20,8404,10,100,1e-05,0.01,0.964,4137,4267
20,8504,10,100,1e-05,0.01,0.97,4189,4315
20,8604,10,100,1e-05,0.01,0.978,4236,4368
20,8704,10,100,1e-05,0.01,0.982,4287,4417
20,8804,10,100,1e-05,0.01,0.974,4330,4474
20,8904,10,100,1e-05,0.01,0.974,4384,4520
20,9004,10,100,1e-05,0.01,0.98,4437,4567
20,9104,10,100,1e-05,0.01,0.984,4493,4611
20,9204,10,100,1e-05,0.01,0.978,4539,4665
20,9304,10,100,1e-05,0.01,0.98,4585,4719
20,9404,10,100,1e-05,0.01,0.982,4638,4766
20,9504,10,100,1e-05,0.01,0.982,4691,4813
20,9604,10,100,1e-05,0.01,0.978,4748,4856
20,9704,10,100,1e-05,0.01,0.976,4794,4910
20,9804,10,100,1e-05,0.01,0.978,4843,4961
20,9904,10,100,1e-05,0.01,0.968,4901,5003
20,10004,10,100,1e-05,0.01,0.972,4953,5051
20,10104,10,100,1e-05,0.01,0.982,5006,5098
20,10204,10,100,1e-05,0.01,0.988,5055,5149
20,10304,10,100,1e-05,0.01,0.978,5116,5188
20,10404,10,100,1e-05,0.01,0.988,5160,5244
20,10504,10,100,1e-05,0.01,0.992,5207,5297
20,10604,10,100,1e-05,0.01,0.994,5257,5347
20,10704,10,100,1e-05,0.01,0.992,5308,5396
20,10804,10,100,1e-05,0.01,0.992,5364,5440
20,10904,10,100,1e-05,0.01,0.988,5421,5483
20,11004,10,100,1e-05,0.01,0.99,5465,5539
20,11104,10,100,1e-05,0.01,0.992,5514,5590
20,11204,10,100,1e-05,0.01,0.98,5565,5639
20,11304,10,100,1e-05,0.01,0.982,5606,5698
20,11404,10,100,1e-05,0.01,0.972,5657,5747
20,11504,10,100,1e-05,0.01,0.986,5711,5793
20,11604,10,100,1e-05,0.01,0.986,5764,5840
20,11704,10,100,1e-05,0.01,0.998,5817,5887
20,11804,10,100,1e-05,0.01,0.984,5866,5938
20,11904,10,100,1e-05,0.01,0.992,5919,5985
20,12004,10,100,1e-05,0.01,0.996,5972,6032
20,12104,10,100,1e-05,0.01,0.992,6021,6083
20,12204,10,100,1e-05,0.01,0.996,6072,6132
20,12304,10,100,1e-05,0.01,0.996,6128,6176
20,12404,10,100,1e-05,0.01,0.998,6175,6229
20,12504,10,100,1e-05,0.01,0.998,6230,6274
20,12604,10,100,1e-05,0.01,0.998,6276,6328
20,12704,10,100,1e-05,0.01,0.994,6321,6383
20,12804,10,100,1e-05,0.01,0.994,6373,6431
20,12904,10,100,1e-05,0.01,0.982,6419,6485
20,13004,10,100,1e-05,0.01,0.986,6475,6529
20,13104,10,100,1e-05,0.01,0.992,6527,6577
20,13204,10,100,1e-05,0.01,0.996,6580,6624
20,13304,10,100,1e-05,0.01,0.996,6628,6676
20,13404,10,100,1e-05,0.01,0.998,6687,6717
20,13504,10,100,1e-05,0.01,0.992,6740,6764
20,13604,10,100,1e-05,0.01,0.994,6789,6815
20,13704,10,100,1e-05,0.01,0.996,6835,6869
20,13804,10,100,1e-05,0.01,0.986,6884,6920
20,13904,10,100,1e-05,0.01,0.992,6933,6971
20,14004,10,100,1e-05,0.01,0.994,6977,7027
20,14104,10,100,1e-05,0.01,0.998,7030,7074
20,14204,10,100,1e-05,0.01,0.996,7081,7123
20,14304,10,100,1e-05,0.01,0.996,7133,7171
20,14404,10,100,1e-05,0.01,0.996,7190,7214
20,14504,10,100,1e-05,0.01,0.996,7250,7254
20,14604,10,100,1e-05,0.01,0.998,7301,7303
20,14704,10,100,1e-05,0.01,0.998,7349,7355
20,14804,10,100,1e-05,0.01,0.998,7400,7404
20,14904,10,100,1e-05,0.01,0.996,7454,7450
20,15004,10,100,1e-05,0.01,0.996,7497,7507
1,104,10,100,0.0001,0.01,0.46,48,56
1,204,10,100,0.0001,0.01,0.488,96,108
1,304,10,100,0.0001,0.01,0.488,150,154
1,404,10,100,0.0001,0.01,0.492,207,197
1,504,10,100,0.0001,0.01,0.508,262,242
1,604,10,100,0.0001,0.01,0.544,307,297
1,704,10,100,0.0001,0.01,0.534,353,351
1,804,10,100,0.0001,0.01,0.502,393,411
1,904,10,100,0.0001,0.01,0.522,442,462
1,1004,10,100,0.0001,0.01,0.484,487,517
1,1104,10,100,0.0001,0.01,0.494,534,570
1,1204,10,100,0.0001,0.01,0.494,586,618
1,1304,10,100,0.0001,0.01,0.486,630,674
1,1404,10,100,0.0001,0.01,0.49,678,726
1,1504,10,100,0.0001,0.01,0.49,724,780
1,1604,10,100,0.0001,0.01,0.466,771,833
1,1704,10,100,0.0001,0.01,0.476,820,884
1,1804,10,100,0.0001,0.01,0.486,871,933
1,1904,10,100,0.0001,0.01,0.466,905,999
1,2004,10,100,0.0001,0.01,0.508,944,1060
1,2104,10,100,0.0001,0.01,0.492,998,1106
1,2204,10,100,0.0001,0.01,0.524,1041,1163
1,2304,10,100,0.0001,0.01,0.524,1095,1209
1,2404,10,100,0.0001,0.01,0.502,1143,1261
1,2504,10,100,0.0001,0.01,0.49,1194,1310
1,2604,10,100,0.0001,0.01,0.51,1254,1350
1,2704,10,100,0.0001,0.01,0.51,1309,1395
1,2804,10,100,0.0001,0.01,0.552,1357,1447
1,2904,10,100,0.0001,0.01,0.482,1412,1492
1,3004,10,100,0.0001,0.01,0.528,1472,1532
1,3104,10,100,0.0001,0.01,0.508,1515,1589
1,3204,10,100,0.0001,0.01,0.53,1565,1639
1,3304,10,100,0.0001,0.01,0.516,1613,1691
1,3404,10,100,0.0001,0.01,0.526,1661,1743
1,3504,10,100,0.0001,0.01,0.524,1708,1796
1,3604,10,100,0.0001,0.01,0.518,1761,1843
1,3704,10,100,0.0001,0.01,0.522,1803,1901
1,3804,10,100,0.0001,0.01,0.51,1848,1956
1,3904,10,100,0.0001,0.01,0.498,1893,2011
1,4004,10,100,0.0001,0.01,0.526,1942,2062
1,4104,10,100,0.0001,0.01,0.524,1993,2111
1,4204,10,100,0.0001,0.01,0.538,2048,2156
1,4304,10,100,0.0001,0.01,0.542,2096,2208
1,4404,10,100,0.0001,0.01,0.54,2148,2256
1,4504,10,100,0.0001,0.01,0.554,2208,2296
1,4604,10,100,0.0001,0.01,0.55,2255,2349
1,4704,10,100,0.0001,0.01,0.58,2307,2397
1,4804,10,100,0.0001,0.01,0.586,2360,2444
1,4904,10,100,0.0001,0.01,0.578,2413,2491
1,5004,10,100,0.0001,0.01,0.592,2464,2540
1,5104,10,100,0.0001,0.01,0.59,2514,2590
1,5204,10,100,0.0001,0.01,0.63,2573,2631
1,5304,10,100,0.0001,0.01,0.622,2620,2684
1,5404,10,100,0.0001,0.01,0.644,2677,2727
1,5504,10,100,0.0001,0.01,0.656,2722,2782
1,5604,10,100,0.0001,0.01,0.666,2765,2839
1,5704,10,100,0.0001,0.01,0.626,2813,2891
1,5804,10,100,0.0001,0.01,0.648,2862,2942
1,5904,10,100,0.0001,0.01,0.652,2906,2998
1,6004,10,100,0.0001,0.01,0.664,2953,3051
1,6104,10,100,0.0001,0.01,0.66,3011,3093
1,6204,10,100,0.0001,0.01,0.662,3066,3138
1,6304,10,100,0.0001,0.01,0.682,3116,3188
1,6404,10,100,0.0001,0.01,0.652,3162,3242
1,6504,10,100,0.0001,0.01,0.62,3217,3287
1,6604,10,100,0.0001,0.01,0.61,3277,3327
1,6704,10,100,0.0001,0.01,0.642,3324,3380
1,6804,10,100,0.0001,0.01,0.652,3378,3426
1,6904,10,100,0.0001,0.01,0.642,3428,3476
1,7004,10,100,0.0001,0.01,0.654,3477,3527
1,7104,10,100,0.0001,0.01,0.652,3528,3576
1,7204,10,100,0.0001,0.01,0.65,3573,3631
1,7304,10,100,0.0001,0.01,0.674,3629,3675
1,7404,10,100,0.0001,0.01,0.674,3674,3730
1,7504,10,100,0.0001,0.01,0.71,3722,3782
1,7604,10,100,0.0001,0.01,0.714,3765,3839
1,7704,10,100,0.0001,0.01,0.678,3823,3881
1,7804,10,100,0.0001,0.01,0.696,3871,3933
1,7904,10,100,0.0001,0.01,0.714,3922,3982
1,8004,10,100,0.0001,0.01,0.716,3974,4030
1,8104,10,100,0.0001,0.01,0.72,4032,4072
1,8204,10,100,0.0001,0.01,0.734,4077,4127
1,8304,10,100,0.0001,0.01,0.722,4126,4178
1,8404,10,100,0.0001,0.01,0.724,4178,4226
1,8504,10,100,0.0001,0.01,0.736,4229,4275
1,8604,10,100,0.0001,0.01,0.754,4275,4329
1,8704,10,100,0.0001,0.01,0.758,4319,4385
1,8804,10,100,0.0001,0.01,0.752,4367,4437
1,8904,10,100,0.0001,0.01,0.762,4422,4482
1,9004,10,100,0.0001,0.01,0.764,4462,4542
1,9104,10,100,0.0001,0.01,0.762,4514,4590
1,9204,10,100,0.0001,0.01,0.76,4564,4640
1,9304,10,100,0.0001,0.01,0.78,4617,4687
1,9404,10,100,0.0001,0.01,0.782,4670,4734
1,9504,10,100,0.0001,0.01,0.782,4720,4784
1,9604,10,100,0.0001,0.01,0.766,4774,4830
1,9704,10,100,0.0001,0.01,0.696,4815,4889
1,9804,10,100,0.0001,0.01,0.712,4856,4948
1,9904,10,100,0.0001,0.01,0.756,4901,5003
1,10004,10,100,0.0001,0.01,0.778,4953,5051
1,10104,10,100,0.0001,0.01,0.764,5008,5096
1,10204,10,100,0.0001,0.01,0.78,5052,5152
1,10304,10,100,0.0001,0.01,0.792,5106,5198
1,10404,10,100,0.0001,0.01,0.8,5158,5246
1,10504,10,100,0.0001,0.01,0.78,5217,5287
1,10604,10,100,0.0001,0.01,0.798,5262,5342
1,10704,10,100,0.0001,0.01,0.838,5307,5397
1,10804,10,100,0.0001,0.01,0.85,5368,5436
1,10904,10,100,0.0001,0.01,0.852,5417,5487
1,11004,10,100,0.0001,0.01,0.842,5471,5533
1,11104,10,100,0.0001,0.01,0.85,5518,5586
1,11204,10,100,0.0001,0.01,0.846,5566,5638
1,11304,10,100,0.0001,0.01,0.85,5619,5685
1,11404,10,100,0.0001,0.01,0.866,5676,5728
1,11504,10,100,0.0001,0.01,0.886,5724,5780
1,11604,10,100,0.0001,0.01,0.888,5782,5822
1,11704,10,100,0.0001,0.01,0.902,5832,5872
1,11804,10,100,0.0001,0.01,0.882,5876,5928
1,11904,10,100,0.0001,0.01,0.916,5939,5965
1,12004,10,100,0.0001,0.01,0.9,5992,6012
1,12104,10,100,0.0001,0.01,0.89,6047,6057
1,12204,10,100,0.0001,0.01,0.912,6089,6115
1,12304,10,100,0.0001,0.01,0.926,6144,6160
1,12404,10,100,0.0001,0.01,0.92,6200,6204
1,12504,10,100,0.0001,0.01,0.934,6254,6250
1,12604,10,100,0.0001,0.01,0.938,6303,6301
1,12704,10,100,0.0001,0.01,0.936,6350,6354
1,12804,10,100,0.0001,0.01,0.936,6401,6403
1,12904,10,100,0.0001,0.01,0.92,6444,6460
1,13004,10,100,0.0001,0.01,0.938,6499,6505
1,13104,10,100,0.0001,0.01,0.942,6555,6549
1,13204,10,100,0.0001,0.01,0.934,6604,6600
1,13304,10,100,0.0001,0.01,0.948,6651,6653
1,13404,10,100,0.0001,0.01,0.956,6704,6700
1,13504,10,100,0.0001,0.01,0.954,6753,6751
1,13604,10,100,0.0001,0.01,0.952,6807,6797
1,13704,10,100,0.0001,0.01,0.934,6853,6851
1,13804,10,100,0.0001,0.01,0.952,6907,6897
1,13904,10,100,0.0001,0.01,0.956,6953,6951
1,14004,10,100,0.0001,0.01,0.964,7000,7004
1,14104,10,100,0.0001,0.01,0.97,7044,7060
1,14204,10,100,0.0001,0.01,0.968,7099,7105
1,14304,10,100,0.0001,0.01,0.956,7150,7154
1,14404,10,100,0.0001,0.01,0.972,7195,7209
1,14504,10,100,0.0001,0.01,0.962,7246,7258
1,14604,10,100,0.0001,0.01,0.962,7285,7319
1,14704,10,100,0.0001,0.01,0.974,7341,7363
1,14804,10,100,0.0001,0.01,0.966,7394,7410
1,14904,10,100,0.0001,0.01,0.96,7450,7454
1,15004,10,100,0.0001,0.01,0.962,7499,7505
2,104,10,100,0.0001,0.01,0.516,46,58
2,204,10,100,0.0001,0.01,0.476,87,117
2,304,10,100,0.0001,0.01,0.5,134,170
2,404,10,100,0.0001,0.01,0.514,184,220
2,504,10,100,0.0001,0.01,0.48,244,260
2,604,10,100,0.0001,0.01,0.478,292,312
2,704,10,100,0.0001,0.01,0.534,341,363
2,804,10,100,0.0001,0.01,0.49,394,410
2,904,10,100,0.0001,0.01,0.504,446,458
2,1004,10,100,0.0001,0.01,0.538,498,506
2,1104,10,100,0.0001,0.01,0.512,545,559
2,1204,10,100,0.0001,0.01,0.536,608,596
2,1304,10,100,0.0001,0.01,0.498,663,641
2,1404,10,100,0.0001,0.01,0.514,720,684
2,1504,10,100,0.0001,0.01,0.522,773,731
2,1604,10,100,0.0001,0.01,0.538,822,782
2,1704,10,100,0.0001,0.01,0.538,866,838
2,1804,10,100,0.0001,0.01,0.552,917,887
2,1904,10,100,0.0001,0.01,0.566,966,938
2,2004,10,100,0.0001,0.01,0.594,1016,988
2,2104,10,100,0.0001,0.01,0.596,1065,1039
2,2204,10,100,0.0001,0.01,0.61,1109,1095
2,2304,10,100,0.0001,0.01,0.596,1158,1146
2,2404,10,100,0.0001,0.01,0.63,1204,1200
2,2504,10,100,0.0001,0.01,0.64,1250,1254
2,2604,10,100,0.0001,0.01,0.7,1291,1313
2,2704,10,100,0.0001,0.01,0.702,1346,1358
2,2804,10,100,0.0001,0.01,0.742,1395,1409
2,2904,10,100,0.0001,0.01,0.788,1447,1457
2,3004,10,100,0.0001,0.01,0.82,1496,1508
2,3104,10,100,0.0001,0.01,0.832,1543,1561
2,3204,10,100,0.0001,0.01,0.832,1593,1611
2,3304,10,100,0.0001,0.01,0.856,1647,1657
2,3404,10,100,0.0001,0.01,0.884,1707,1697
2,3504,10,100,0.0001,0.01,0.888,1763,1741
2,3604,10,100,0.0001,0.01,0.884,1809,1795
2,3704,10,100,0.0001,0.01,0.902,1855,1849
2,3804,10,100,0.0001,0.01,0.904,1903,1901
2,3904,10,100,0.0001,0.01,0.89,1948,1956
2,4004,10,100,0.0001,0.01,0.906,1991,2013
2,4104,10,100,0.0001,0.01,0.93,2049,2055
2,4204,10,100,0.0001,0.01,0.94,2099,2105
2,4304,10,100,0.0001,0.01,0.956,2144,2160
2,4404,10,100,0.0001,0.01,0.95,2196,2208
2,4504,10,100,0.0001,0.01,0.962,2242,2262
2,4604,10,100,0.0001,0.01,0.956,2303,2301
2,4704,10,100,0.0001,0.01,0.954,2360,2344
2,4804,10,100,0.0001,0.01,0.964,2416,2388
2,4904,10,100,0.0001,0.01,0.96,2471,2433
2,5004,10,100,0.0001,0.01,0.968,2524,2480
2,5104,10,100,0.0001,0.01,0.962,2578,2526
2,5204,10,100,0.0001,0.01,0.964,2632,2572
2,5304,10,100,0.0001,0.01,0.966,2674,2630
2,5404,10,100,0.0001,0.01,0.974,2720,2684
2,5504,10,100,0.0001,0.01,0.972,2774,2730
2,5604,10,100,0.0001,0.01,0.958,2834,2770
2,5704,10,100,0.0001,0.01,0.964,2887,2817
2,5804,10,100,0.0001,0.01,0.972,2937,2867
2,5904,10,100,0.0001,0.01,0.972,2990,2914
2,6004,10,100,0.0001,0.01,0.958,3032,2972
2,6104,10,100,0.0001,0.01,0.97,3084,3020
2,6204,10,100,0.0001,0.01,0.97,3142,3062
2,6304,10,100,0.0001,0.01,0.956,3189,3115
2,6404,10,100,0.0001,0.01,0.968,3237,3167
2,6504,10,100,0.0001,0.01,0.968,3284,3220
2,6604,10,100,0.0001,0.01,0.976,3331,3273
2,6704,10,100,0.0001,0.01,0.978,3379,3325
2,6804,10,100,0.0001,0.01,0.984,3436,3368
2,6904,10,100,0.0001,0.01,0.982,3492,3412
2,7004,10,100,0.0001,0.01,0.98,3541,3463
2,7104,10,100,0.0001,0.01,0.98,3588,3516
2,7204,10,100,0.0001,0.01,0.986,3644,3560
2,7304,10,100,0.0001,0.01,0.984,3678,3626
2,7404,10,100,0.0001,0.01,0.978,3725,3679
2,7504,10,100,0.0001,0.01,0.984,3773,3731
2,7604,10,100,0.0001,0.01,0.982,3816,3788
2,7704,10,100,0.0001,0.01,0.976,3865,3839
2,7804,10,100,0.0001,0.01,0.98,3916,3888
2,7904,10,100,0.0001,0.01,0.976,3973,3931
2,8004,10,100,0.0001,0.01,0.978,4020,3984
2,8104,10,100,0.0001,0.01,0.99,4069,4035
2,8204,10,100,0.0001,0.01,0.99,4122,4082
2,8304,10,100,0.0001,0.01,0.982,4172,4132
2,8404,10,100,0.0001,0.01,0.988,4217,4187
2,8504,10,100,0.0001,0.01,0.984,4271,4233
2,8604,10,100,0.0001,0.01,0.99,4318,4286
2,8704,10,100,0.0001,0.01,0.992,4372,4332
2,8804,10,100,0.0001,0.01,0.992,4425,4379
2,8904,10,100,0.0001,0.01,0.996,4474,4430
2,9004,10,100,0.0001,0.01,0.996,4519,4485
2,9104,10,100,0.0001,0.01,0.994,4569,4535
2,9204,10,100,0.0001,0.01,0.988,4623,4581
2,9304,10,100,0.0001,0.01,0.988,4674,4630
2,9404,10,100,0.0001,0.01,0.98,4720,4684
2,9504,10,100,0.0001,0.01,0.964,4765,4739
2,9604,10,100,0.0001,0.01,0.964,4819,4785
2,9704,10,100,0.0001,0.01,0.992,4866,4838
2,9804,10,100,0.0001,0.01,0.994,4917,4887
2,9904,10,100,0.0001,0.01,0.994,4967,4937
2,10004,10,100,0.0001,0.01,0.994,5016,4988
2,10104,10,100,0.0001,0.01,0.996,5065,5039
2,10204,10,100,0.0001,0.01,0.994,5109,5095
2,10304,10,100,0.0001,0.01,0.996,5148,5156
2,10404,10,100,0.0001,0.01,0.996,5197,5207
2,10504,10,100,0.0001,0.01,0.994,5256,5248
2,10604,10,100,0.0001,0.01,0.992,5292,5312
2,10704,10,100,0.0001,0.01,0.99,5342,5362
2,10804,10,100,0.0001,0.01,0.994,5392,5412
2,10904,10,100,0.0001,0.01,0.994,5452,5452
2,11004,10,100,0.0001,0.01,0.994,5500,5504
2,11104,10,100,0.0001,0.01,0.99,5544,5560
2,11204,10,100,0.0001,0.01,0.98,5592,5612
2,11304,10,100,0.0001,0.01,0.99,5642,5662
2,11404,10,100,0.0001,0.01,0.992,5700,5704
2,11504,10,100,0.0001,0.01,0.996,5751,5753
2,11604,10,100,0.0001,0.01,0.996,5805,5799
2,11704,10,100,0.0001,0.01,0.996,5853,5851
2,11804,10,100,0.0001,0.01,0.992,5904,5900
2,11904,10,100,0.0001,0.01,0.994,5954,5950
2,12004,10,100,0.0001,0.01,0.996,6001,6003
2,12104,10,100,0.0001,0.01,0.994,6049,6055
2,12204,10,100,0.0001,0.01,0.996,6101,6103
2,12304,10,100,0.0001,0.01,0.996,6144,6160
2,12404,10,100,0.0001,0.01,0.996,6201,6203
2,12504,10,100,0.0001,0.01,0.994,6248,6256
2,12604,10,100,0.0001,0.01,0.99,6306,6298
2,12704,10,100,0.0001,0.01,0.98,6354,6350
2,12804,10,100,0.0001,0.01,0.984,6403,6401
2,12904,10,100,0.0001,0.01,0.99,6451,6453
2,13004,10,100,0.0001,0.01,0.994,6494,6510
2,13104,10,100,0.0001,0.01,0.996,6539,6565
2,13204,10,100,0.0001,0.01,0.996,6589,6615
2,13304,10,100,0.0001,0.01,0.996,6636,6668
2,13404,10,100,0.0001,0.01,0.996,6684,6720
2,13504,10,100,0.0001,0.01,0.996,6738,6766
2,13604,10,100,0.0001,0.01,0.998,6782,6822
2,13704,10,100,0.0001,0.01,0.998,6838,6866
2,13804,10,100,0.0001,0.01,0.996,6886,6918
2,13904,10,100,0.0001,0.01,0.996,6937,6967
2,14004,10,100,0.0001,0.01,0.992,6990,7014
2,14104,10,100,0.0001,0.01,0.992,7036,7068
2,14204,10,100,0.0001,0.01,0.996,7086,7118
2,14304,10,100,0.0001,0.01,0.994,7134,7170
2,14404,10,100,0.0001,0.01,0.984,7187,7217
2,14504,10,100,0.0001,0.01,1.0,7237,7267
2,14604,10,100,0.0001,0.01,0.998,7286,7318
2,14704,10,100,0.0001,0.01,0.998,7331,7373
2,14804,10,100,0.0001,0.01,0.992,7384,7420
2,14904,10,100,0.0001,0.01,0.996,7436,7468
2,15004,10,100,0.0001,0.01,0.996,7489,7515
3,104,10,100,0.0001,0.01,0.488,47,57
3,204,10,100,0.0001,0.01,0.506,102,102
3,304,10,100,0.0001,0.01,0.556,159,145
3,404,10,100,0.0001,0.01,0.504,213,191
3,504,10,100,0.0001,0.01,0.502,261,243
3,604,10,100,0.0001,0.01,0.552,308,296
3,704,10,100,0.0001,0.01,0.518,358,346
3,804,10,100,0.0001,0.01,0.49,412,392
3,904,10,100,0.0001,0.01,0.5,461,443
3,1004,10,100,0.0001,0.01,0.496,511,493
3,1104,10,100,0.0001,0.01,0.506,564,540
3,1204,10,100,0.0001,0.01,0.532,600,604
3,1304,10,100,0.0001,0.01,0.522,650,654
3,1404,10,100,0.0001,0.01,0.524,698,706
3,1504,10,100,0.0001,0.01,0.508,750,754
3,1604,10,100,0.0001,0.01,0.53,806,798
3,1704,10,100,0.0001,0.01,0.54,858,846
3,1804,10,100,0.0001,0.01,0.522,904,900
3,1904,10,100,0.0001,0.01,0.564,955,949
3,2004,10,100,0.0001,0.01,0.574,1007,997
3,2104,10,100,0.0001,0.01,0.556,1062,1042
3,2204,10,100,0.0001,0.01,0.594,1110,1094
3,2304,10,100,0.0001,0.01,0.63,1167,1137
3,2404,10,100,0.0001,0.01,0.668,1219,1185
3,2504,10,100,0.0001,0.01,0.658,1268,1236
3,2604,10,100,0.0001,0.01,0.676,1326,1278
3,2704,10,100,0.0001,0.01,0.732,1376,1328
3,2804,10,100,0.0001,0.01,0.742,1428,1376
3,2904,10,100,0.0001,0.01,0.748,1474,1430
3,3004,10,100,0.0001,0.01,0.796,1522,1482
3,3104,10,100,0.0001,0.01,0.802,1563,1541
3,3204,10,100,0.0001,0.01,0.812,1608,1596
3,3304,10,100,0.0001,0.01,0.822,1656,1648
3,3404,10,100,0.0001,0.01,0.814,1703,1701
3,3504,10,100,0.0001,0.01,0.826,1751,1753
3,3604,10,100,0.0001,0.01,0.846,1793,1811
3,3704,10,100,0.0001,0.01,0.856,1851,1853
3,3804,10,100,0.0001,0.01,0.87,1904,1900
3,3904,10,100,0.0001,0.01,0.834,1949,1955
3,4004,10,100,0.0001,0.01,0.836,2009,1995
3,4104,10,100,0.0001,0.01,0.852,2054,2050
3,4204,10,100,0.0001,0.01,0.87,2103,2101
3,4304,10,100,0.0001,0.01,0.868,2155,2149
3,4404,10,100,0.0001,0.01,0.894,2207,2197
3,4504,10,100,0.0001,0.01,0.884,2258,2246
3,4604,10,100,0.0001,0.01,0.906,2309,2295
3,4704,10,100,0.0001,0.01,0.904,2358,2346
3,4804,10,100,0.0001,0.01,0.902,2414,2390
3,4904,10,100,0.0001,0.01,0.904,2462,2442
3,5004,10,100,0.0001,0.01,0.914,2507,2497
3,5104,10,100,0.0001,0.01,0.918,2562,2542
3,5204,10,100,0.0001,0.01,0.926,2613,2591
3,5304,10,100,0.0001,0.01,0.906,2661,2643
3,5404,10,100,0.0001,0.01,0.926,2707,2697
3,5504,10,100,0.0001,0.01,0.914,2754,2750
3,5604,10,100,0.0001,0.01,0.916,2813,2791
3,5704,10,100,0.0001,0.01,0.928,2863,2841
3,5804,10,100,0.0001,0.01,0.928,2915,2889
3,5904,10,100,0.0001,0.01,0.912,2963,2941
3,6004,10,100,0.0001,0.01,0.926,3009,2995
3,6104,10,100,0.0001,0.01,0.908,3062,3042
3,6204,10,100,0.0001,0.01,0.918,3118,3086
3,6304,10,100,0.0001,0.01,0.94,3169,3135
3,6404,10,100,0.0001,0.01,0.924,3218,3186
3,6504,10,100,0.0001,0.01,0.946,3257,3247
3,6604,10,100,0.0001,0.01,0.932,3295,3309
3,6704,10,100,0.0001,0.01,0.938,3339,3365
3,6804,10,100,0.0001,0.01,0.948,3388,3416
3,6904,10,100,0.0001,0.01,0.942,3443,3461
3,7004,10,100,0.0001,0.01,0.942,3484,3520
3,7104,10,100,0.0001,0.01,0.946,3532,3572
3,7204,10,100,0.0001,0.01,0.942,3575,3629
3,7304,10,100,0.0001,0.01,0.95,3625,3679
3,7404,10,100,0.0001,0.01,0.946,3675,3729
3,7504,10,100,0.0001,0.01,0.938,3729,3775
3,7604,10,100,0.0001,0.01,0.948,3779,3825
3,7704,10,100,0.0001,0.01,0.952,3823,3881
3,7804,10,100,0.0001,0.01,0.946,3873,3931
3,7904,10,100,0.0001,0.01,0.958,3928,3976
3,8004,10,100,0.0001,0.01,0.958,3978,4026
3,8104,10,100,0.0001,0.01,0.966,4015,4089
3,8204,10,100,0.0001,0.01,0.96,4081,4123
3,8304,10,100,0.0001,0.01,0.966,4128,4176
3,8404,10,100,0.0001,0.01,0.964,4176,4228
3,8504,10,100,0.0001,0.01,0.956,4225,4279
3,8604,10,100,0.0001,0.01,0.952,4281,4323
3,8704,10,100,0.0001,0.01,0.968,4325,4379
3,8804,10,100,0.0001,0.01,0.956,4368,4436
3,8904,10,100,0.0001,0.01,0.944,4419,4485
3,9004,10,100,0.0001,0.01,0.966,4478,4526
3,9104,10,100,0.0001,0.01,0.962,4538,4566
3,9204,10,100,0.0001,0.01,0.966,4586,4618
3,9304,10,100,0.0001,0.01,0.968,4635,4669
3,9404,10,100,0.0001,0.01,0.966,4686,4718
3,9504,10,100,0.0001,0.01,0.968,4731,4773
3,9604,10,100,0.0001,0.01,0.964,4779,4825
3,9704,10,100,0.0001,0.01,0.976,4831,4873
3,9804,10,100,0.0001,0.01,0.97,4886,4918
3,9904,10,100,0.0001,0.01,0.974,4931,4973
3,10004,10,100,0.0001,0.01,0.974,4991,5013
3,10104,10,100,0.0001,0.01,0.972,5035,5069
3,10204,10,100,0.0001,0.01,0.944,5089,5115
3,10304,10,100,0.0001,0.01,0.954,5137,5167
3,10404,10,100,0.0001,0.01,0.952,5179,5225
3,10504,10,100,0.0001,0.01,0.986,5230,5274
3,10604,10,100,0.0001,0.01,0.984,5284,5320
3,10704,10,100,0.0001,0.01,0.982,5333,5371
3,10804,10,100,0.0001,0.01,0.986,5378,5426
3,10904,10,100,0.0001,0.01,0.984,5426,5478
3,11004,10,100,0.0001,0.01,0.988,5474,5530
3,11104,10,100,0.0001,0.01,0.988,5530,5574
3,11204,10,100,0.0001,0.01,0.986,5582,5622
3,11304,10,100,0.0001,0.01,0.986,5635,5669
3,11404,10,100,0.0001,0.01,0.984,5690,5714
3,11504,10,100,0.0001,0.01,0.988,5739,5765
3,11604,10,100,0.0001,0.01,0.986,5791,5813
3,11704,10,100,0.0001,0.01,0.986,5840,5864
3,11804,10,100,0.0001,0.01,0.984,5885,5919
3,11904,10,100,0.0001,0.01,0.982,5937,5967
3,12004,10,100,0.0001,0.01,0.958,5991,6013
3,12104,10,100,0.0001,0.01,0.982,6037,6067
3,12204,10,100,0.0001,0.01,0.992,6083,6121
3,12304,10,100,0.0001,0.01,0.992,6131,6173
3,12404,10,100,0.0001,0.01,0.986,6191,6213
3,12504,10,100,0.0001,0.01,0.986,6246,6258
3,12604,10,100,0.0001,0.01,0.99,6299,6305
3,12704,10,100,0.0001,0.01,0.992,6344,6360
3,12804,10,100,0.0001,0.01,0.992,6391,6413
3,12904,10,100,0.0001,0.01,0.994,6446,6458
3,13004,10,100,0.0001,0.01,1.0,6506,6498
3,13104,10,100,0.0001,0.01,0.996,6556,6548
3,13204,10,100,0.0001,0.01,0.994,6606,6598
3,13304,10,100,0.0001,0.01,0.978,6654,6650
3,13404,10,100,0.0001,0.01,0.986,6708,6696
3,13504,10,100,0.0001,0.01,0.99,6758,6746
3,13604,10,100,0.0001,0.01,0.99,6802,6802
3,13704,10,100,0.0001,0.01,0.988,6854,6850
3,13804,10,100,0.0001,0.01,0.992,6901,6903
3,13904,10,100,0.0001,0.01,0.99,6950,6954
3,14004,10,100,0.0001,0.01,0.99,7001,7003
3,14104,10,100,0.0001,0.01,0.992,7049,7055
3,14204,10,100,0.0001,0.01,0.99,7100,7104
3,14304,10,100,0.0001,0.01,0.992,7150,7154
3,14404,10,100,0.0001,0.01,0.99,7202,7202
3,14504,10,100,0.0001,0.01,0.992,7255,7249
3,14604,10,100,0.0001,0.01,0.99,7306,7298
3,14704,10,100,0.0001,0.01,0.992,7347,7357
3,14804,10,100,0.0001,0.01,0.992,7394,7410
3,14904,10,100,0.0001,0.01,0.99,7441,7463
3,15004,10,100,0.0001,0.01,0.996,7490,7514
4,104,10,100,0.0001,0.01,0.526,51,53
4,204,10,100,0.0001,0.01,0.468,99,105
4,304,10,100,0.0001,0.01,0.47,152,152
4,404,10,100,0.0001,0.01,0.498,206,198
4,504,10,100,0.0001,0.01,0.502,260,244
4,604,10,100,0.0001,0.01,0.502,305,299
4,704,10,100,0.0001,0.01,0.48,355,349
4,804,10,100,0.0001,0.01,0.502,404,400
4,904,10,100,0.0001,0.01,0.538,457,447
4,1004,10,100,0.0001,0.01,0.532,496,508
4,1104,10,100,0.0001,0.01,0.512,548,556
4,1204,10,100,0.0001,0.01,0.528,600,604
4,1304,10,100,0.0001,0.01,0.564,656,648
4,1404,10,100,0.0001,0.01,0.57,701,703
4,1504,10,100,0.0001,0.01,0.578,749,755
4,1604,10,100,0.0001,0.01,0.528,797,807
4,1704,10,100,0.0001,0.01,0.526,848,856
4,1804,10,100,0.0001,0.01,0.542,897,907
4,1904,10,100,0.0001,0.01,0.526,948,956
4,2004,10,100,0.0001,0.01,0.55,1006,998
4,2104,10,100,0.0001,0.01,0.542,1054,1050
4,2204,10,100,0.0001,0.01,0.566,1100,1104
4,2304,10,100,0.0001,0.01,0.594,1150,1154
4,2404,10,100,0.0001,0.01,0.572,1198,1206
4,2504,10,100,0.0001,0.01,0.578,1248,1256
4,2604,10,100,0.0001,0.01,0.642,1297,1307
4,2704,10,100,0.0001,0.01,0.64,1346,1358
4,2804,10,100,0.0001,0.01,0.71,1394,1410
4,2904,10,100,0.0001,0.01,0.706,1445,1459
4,3004,10,100,0.0001,0.01,0.714,1500,1504
4,3104,10,100,0.0001,0.01,0.762,1551,1553
4,3204,10,100,0.0001,0.01,0.784,1605,1599
4,3304,10,100,0.0001,0.01,0.78,1657,1647
4,3404,10,100,0.0001,0.01,0.858,1705,1699
4,3504,10,100,0.0001,0.01,0.826,1752,1752
4,3604,10,100,0.0001,0.01,0.876,1802,1802
4,3704,10,100,0.0001,0.01,0.894,1856,1848
4,3804,10,100,0.0001,0.01,0.88,1899,1905
4,3904,10,100,0.0001,0.01,0.882,1950,1954
4,4004,10,100,0.0001,0.01,0.9,2008,1996
4,4104,10,100,0.0001,0.01,0.9,2057,2047
4,4204,10,100,0.0001,0.01,0.912,2107,2097
4,4304,10,100,0.0001,0.01,0.902,2165,2139
4,4404,10,100,0.0001,0.01,0.938,2213,2191
4,4504,10,100,0.0001,0.01,0.932,2265,2239
4,4604,10,100,0.0001,0.01,0.908,2302,2302
4,4704,10,100,0.0001,0.01,0.888,2346,2358
4,4804,10,100,0.0001,0.01,0.904,2400,2404
4,4904,10,100,0.0001,0.01,0.898,2453,2451
4,5004,10,100,0.0001,0.01,0.932,2508,2496
4,5104,10,100,0.0001,0.01,0.926,2552,2552
4,5204,10,100,0.0001,0.01,0.93,2603,2601
4,5304,10,100,0.0001,0.01,0.932,2653,2651
4,5404,10,100,0.0001,0.01,0.94,2702,2702
4,5504,10,100,0.0001,0.01,0.94,2753,2751
4,5604,10,100,0.0001,0.01,0.942,2797,2807
4,5704,10,100,0.0001,0.01,0.95,2846,2858
4,5804,10,100,0.0001,0.01,0.944,2902,2902
4,5904,10,100,0.0001,0.01,0.956,2955,2949
4,6004,10,100,0.0001,0.01,0.954,2996,3008
4,6104,10,100,0.0001,0.01,0.956,3039,3065
4,6204,10,100,0.0001,0.01,0.936,3088,3116
4,6304,10,100,0.0001,0.01,0.956,3137,3167
4,6404,10,100,0.0001,0.01,0.94,3181,3223
4,6504,10,100,0.0001,0.01,0.956,3233,3271
4,6604,10,100,0.0001,0.01,0.966,3287,3317
4,6704,10,100,0.0001,0.01,0.958,3341,3363
4,6804,10,100,0.0001,0.01,0.958,3390,3414
4,6904,10,100,0.0001,0.01,0.966,3438,3466
4,7004,10,100,0.0001,0.01,0.966,3487,3517
4,7104,10,100,0.0001,0.01,0.97,3530,3574
4,7204,10,100,0.0001,0.01,0.974,3587,3617
4,7304,10,100,0.0001,0.01,0.97,3640,3664
4,7404,10,100,0.0001,0.01,0.958,3687,3717
4,7504,10,100,0.0001,0.01,0.97,3738,3766
4,7604,10,100,0.0001,0.01,0.968,3783,3821
4,7704,10,100,0.0001,0.01,0.938,3831,3873
4,7804,10,100,0.0001,0.01,0.97,3877,3927
4,7904,10,100,0.0001,0.01,0.974,3923,3981
4,8004,10,100,0.0001,0.01,0.976,3976,4028
4,8104,10,100,0.0001,0.01,0.972,4022,4082
4,8204,10,100,0.0001,0.01,0.978,4078,4126
4,8304,10,100,0.0001,0.01,0.982,4125,4179
4,8404,10,100,0.0001,0.01,0.982,4175,4229
4,8504,10,100,0.0001,0.01,0.98,4228,4276
4,8604,10,100,0.0001,0.01,0.982,4283,4321
4,8704,10,100,0.0001,0.01,0.984,4327,4377
4,8804,10,100,0.0001,0.01,0.984,4379,4425
4,8904,10,100,0.0001,0.01,0.988,4431,4473
4,9004,10,100,0.0001,0.01,0.97,4472,4532
4,9104,10,100,0.0001,0.01,0.98,4525,4579
4,9204,10,100,0.0001,0.01,0.968,4575,4629
4,9304,10,100,0.0001,0.01,0.976,4626,4678
4,9404,10,100,0.0001,0.01,0.97,4671,4733
4,9504,10,100,0.0001,0.01,0.976,4724,4780
4,9604,10,100,0.0001,0.01,0.946,4777,4827
4,9704,10,100,0.0001,0.01,0.978,4821,4883
4,9804,10,100,0.0001,0.01,0.98,4871,4933
4,9904,10,100,0.0001,0.01,0.98,4925,4979
4,10004,10,100,0.0001,0.01,0.976,4968,5036
4,10104,10,100,0.0001,0.01,0.982,5013,5091
4,10204,10,100,0.0001,0.01,0.986,5063,5141
4,10304,10,100,0.0001,0.01,0.98,5114,5190
4,10404,10,100,0.0001,0.01,0.984,5168,5236
4,10504,10,100,0.0001,0.01,0.972,5217,5287
4,10604,10,100,0.0001,0.01,0.968,5267,5337
4,10704,10,100,0.0001,0.01,0.984,5325,5379
4,10804,10,100,0.0001,0.01,0.98,5383,5421
4,10904,10,100,0.0001,0.01,0.99,5430,5474
4,11004,10,100,0.0001,0.01,0.988,5477,5527
4,11104,10,100,0.0001,0.01,0.972,5528,5576
4,11204,10,100,0.0001,0.01,0.982,5578,5626
4,11304,10,100,0.0001,0.01,0.994,5628,5676
4,11404,10,100,0.0001,0.01,0.986,5672,5732
4,11504,10,100,0.0001,0.01,0.986,5724,5780
4,11604,10,100,0.0001,0.01,0.986,5781,5823
4,11704,10,100,0.0001,0.01,0.97,5843,5861
4,11804,10,100,0.0001,0.01,0.99,5902,5902
4,11904,10,100,0.0001,0.01,0.994,5948,5956
4,12004,10,100,0.0001,0.01,0.986,6001,6003
4,12104,10,100,0.0001,0.01,0.99,6047,6057
4,12204,10,100,0.0001,0.01,0.994,6098,6106
4,12304,10,100,0.0001,0.01,0.984,6147,6157
4,12404,10,100,0.0001,0.01,0.988,6192,6212
4,12504,10,100,0.0001,0.01,0.988,6241,6263
4,12604,10,100,0.0001,0.01,0.992,6297,6307
4,12704,10,100,0.0001,0.01,0.988,6339,6365
4,12804,10,100,0.0001,0.01,0.994,6387,6417
4,12904,10,100,0.0001,0.01,0.986,6436,6468
4,13004,10,100,0.0001,0.01,0.984,6488,6516
4,13104,10,100,0.0001,0.01,0.988,6531,6573
4,13204,10,100,0.0001,0.01,0.99,6586,6618
4,13304,10,100,0.0001,0.01,0.994,6632,6672
4,13404,10,100,0.0001,0.01,0.988,6682,6722
4,13504,10,100,0.0001,0.01,0.986,6730,6774
4,13604,10,100,0.0001,0.01,0.99,6779,6825
4,13704,10,100,0.0001,0.01,0.99,6837,6867
4,13804,10,100,0.0001,0.01,0.99,6890,6914
4,13904,10,100,0.0001,0.01,0.992,6936,6968
4,14004,10,100,0.0001,0.01,0.992,6987,7017
4,14104,10,100,0.0001,0.01,0.98,7036,7068
4,14204,10,100,0.0001,0.01,0.984,7094,7110
4,14304,10,100,0.0001,0.01,0.994,7149,7155
4,14404,10,100,0.0001,0.01,0.992,7190,7214
4,14504,10,100,0.0001,0.01,0.99,7237,7267
4,14604,10,100,0.0001,0.01,0.992,7285,7319
4,14704,10,100,0.0001,0.01,0.978,7335,7369
4,14804,10,100,0.0001,0.01,0.984,7379,7425
4,14904,10,100,0.0001,0.01,0.988,7426,7478
4,15004,10,100,0.0001,0.01,0.978,7488,7516
5,104,10,100,0.0001,0.01,0.514,54,50
5,204,10,100,0.0001,0.01,0.51,100,104
5,304,10,100,0.0001,0.01,0.528,155,149
5,404,10,100,0.0001,0.01,0.528,204,200
5,504,10,100,0.0001,0.01,0.528,248,256
5,604,10,100,0.0001,0.01,0.526,297,307
5,704,10,100,0.0001,0.01,0.532,353,351
5,804,10,100,0.0001,0.01,0.528,397,407
5,904,10,100,0.0001,0.01,0.536,441,463
5,1004,10,100,0.0001,0.01,0.53,498,506
5,1104,10,100,0.0001,0.01,0.554,544,560
5,1204,10,100,0.0001,0.01,0.568,596,608
5,1304,10,100,0.0001,0.01,0.562,651,653
5,1404,10,100,0.0001,0.01,0.54,692,712
5,1504,10,100,0.0001,0.01,0.55,744,760
5,1604,10,100,0.0001,0.01,0.562,799,805
5,1704,10,100,0.0001,0.01,0.554,857,847
5,1804,10,100,0.0001,0.01,0.572,906,898
5,1904,10,100,0.0001,0.01,0.53,951,953
5,2004,10,100,0.0001,0.01,0.604,998,1006
5,2104,10,100,0.0001,0.01,0.61,1053,1051
5,2204,10,100,0.0001,0.01,0.578,1096,1108
5,2304,10,100,0.0001,0.01,0.582,1142,1162
5,2404,10,100,0.0001,0.01,0.588,1187,1217
5,2504,10,100,0.0001,0.01,0.592,1234,1270
5,2604,10,100,0.0001,0.01,0.606,1287,1317
5,2704,10,100,0.0001,0.01,0.628,1343,1361
5,2804,10,100,0.0001,0.01,0.626,1402,1402
5,2904,10,100,0.0001,0.01,0.654,1454,1450
5,3004,10,100,0.0001,0.01,0.706,1497,1507
5,3104,10,100,0.0001,0.01,0.684,1534,1570
5,3204,10,100,0.0001,0.01,0.742,1589,1615
5,3304,10,100,0.0001,0.01,0.762,1637,1667
5,3404,10,100,0.0001,0.01,0.746,1689,1715
5,3504,10,100,0.0001,0.01,0.758,1745,1759
5,3604,10,100,0.0001,0.01,0.762,1795,1809
5,3704,10,100,0.0001,0.01,0.802,1849,1855
5,3804,10,100,0.0001,0.01,0.798,1904,1900
5,3904,10,100,0.0001,0.01,0.824,1950,1954
5,4004,10,100,0.0001,0.01,0.84,2001,2003
5,4104,10,100,0.0001,0.01,0.816,2040,2064
5,4204,10,100,0.0001,0.01,0.846,2078,2126
5,4304,10,100,0.0001,0.01,0.832,2128,2176
5,4404,10,100,0.0001,0.01,0.842,2186,2218
5,4504,10,100,0.0001,0.01,0.83,2240,2264
5,4604,10,100,0.0001,0.01,0.866,2296,2308
5,4704,10,100,0.0001,0.01,0.87,2350,2354
5,4804,10,100,0.0001,0.01,0.878,2396,2408
5,4904,10,100,0.0001,0.01,0.87,2446,2458
5,5004,10,100,0.0001,0.01,0.872,2494,2510
5,5104,10,100,0.0001,0.01,0.876,2554,2550
5,5204,10,100,0.0001,0.01,0.882,2604,2600
5,5304,10,100,0.0001,0.01,0.876,2654,2650
5,5404,10,100,0.0001,0.01,0.892,2702,2702
5,5504,10,100,0.0001,0.01,0.892,2758,2746
5,5604,10,100,0.0001,0.01,0.912,2809,2795
5,5704,10,100,0.0001,0.01,0.914,2854,2850
5,5804,10,100,0.0001,0.01,0.91,2908,2896
5,5904,10,100,0.0001,0.01,0.906,2966,2938
5,6004,10,100,0.0001,0.01,0.872,3020,2984
5,6104,10,100,0.0001,0.01,0.908,3065,3039
5,6204,10,100,0.0001,0.01,0.912,3121,3083
5,6304,10,100,0.0001,0.01,0.916,3162,3142
5,6404,10,100,0.0001,0.01,0.93,3207,3197
5,6504,10,100,0.0001,0.01,0.94,3260,3244
5,6604,10,100,0.0001,0.01,0.94,3303,3301
5,6704,10,100,0.0001,0.01,0.952,3355,3349
5,6804,10,100,0.0001,0.01,0.956,3402,3402
5,6904,10,100,0.0001,0.01,0.954,3450,3454
5,7004,10,100,0.0001,0.01,0.95,3499,3505
5,7104,10,100,0.0001,0.01,0.952,3547,3557
5,7204,10,100,0.0001,0.01,0.94,3590,3614
5,7304,10,100,0.0001,0.01,0.946,3643,3661
5,7404,10,100,0.0001,0.01,0.94,3692,3712
5,7504,10,100,0.0001,0.01,0.948,3745,3759
5,7604,10,100,0.0001,0.01,0.918,3791,3813
5,7704,10,100,0.0001,0.01,0.91,3840,3864
5,7804,10,100,0.0001,0.01,0.938,3888,3916
5,7904,10,100,0.0001,0.01,0.956,3929,3975
5,8004,10,100,0.0001,0.01,0.964,3982,4022
5,8104,10,100,0.0001,0.01,0.968,4031,4073
5,8204,10,100,0.0001,0.01,0.97,4084,4120
5,8304,10,100,0.0001,0.01,0.968,4131,4173
5,8404,10,100,0.0001,0.01,0.97,4184,4220
5,8504,10,100,0.0001,0.01,0.956,4231,4273
5,8604,10,100,0.0001,0.01,0.97,4276,4328
5,8704,10,100,0.0001,0.01,0.976,4336,4368
5,8804,10,100,0.0001,0.01,0.952,4392,4412
5,8904,10,100,0.0001,0.01,0.97,4445,4459
5,9004,10,100,0.0001,0.01,0.974,4502,4502
5,9104,10,100,0.0001,0.01,0.972,4553,4551
5,9204,10,100,0.0001,0.01,0.966,4598,4606
5,9304,10,100,0.0001,0.01,0.968,4647,4657
5,9404,10,100,0.0001,0.01,0.974,4693,4711
5,9504,10,100,0.0001,0.01,0.952,4738,4766
5,9604,10,100,0.0001,0.01,0.972,4790,4814
5,9704,10,100,0.0001,0.01,0.97,4844,4860
5,9804,10,100,0.0001,0.01,0.978,4902,4902
5,9904,10,100,0.0001,0.01,0.978,4954,4950
5,10004,10,100,0.0001,0.01,0.984,4998,5006
5,10104,10,100,0.0001,0.01,0.978,5050,5054
5,10204,10,100,0.0001,0.01,0.982,5111,5093
5,10304,10,100,0.0001,0.01,0.988,5162,5142
5,10404,10,100,0.0001,0.01,0.978,5211,5193
5,10504,10,100,0.0001,0.01,0.982,5254,5250
5,10604,10,100,0.0001,0.01,0.974,5308,5296
5,10704,10,100,0.0001,0.01,0.976,5363,5341
5,10804,10,100,0.0001,0.01,0.984,5410,5394
5,10904,10,100,0.0001,0.01,0.986,5458,5446
5,11004,10,100,0.0001,0.01,0.984,5509,5495
5,11104,10,100,0.0001,0.01,0.968,5552,5552
5,11204,10,100,0.0001,0.01,0.978,5601,5603
5,11304,10,100,0.0001,0.01,0.978,5646,5658
5,11404,10,100,0.0001,0.01,0.978,5698,5706
5,11504,10,100,0.0001,0.01,0.994,5755,5749
5,11604,10,100,0.0001,0.01,0.98,5807,5797
5,11704,10,100,0.0001,0.01,0.988,5863,5841
5,11804,10,100,0.0001,0.01,0.992,5921,5883
5,11904,10,100,0.0001,0.01,0.99,5970,5934
5,12004,10,100,0.0001,0.01,0.988,6026,5978
5,12104,10,100,0.0001,0.01,0.99,6073,6031
5,12204,10,100,0.0001,0.01,0.98,6125,6079
5,12304,10,100,0.0001,0.01,0.986,6175,6129
5,12404,10,100,0.0001,0.01,0.978,6227,6177
5,12504,10,100,0.0001,0.01,0.984,6279,6225
5,12604,10,100,0.0001,0.01,0.956,6330,6274
5,12704,10,100,0.0001,0.01,0.984,6376,6328
5,12804,10,100,0.0001,0.01,0.992,6432,6372
5,12904,10,100,0.0001,0.01,0.99,6483,6421
5,13004,10,100,0.0001,0.01,0.988,6523,6481
5,13104,10,100,0.0001,0.01,0.994,6575,6529
5,13204,10,100,0.0001,0.01,0.994,6630,6574
5,13304,10,100,0.0001,0.01,0.992,6679,6625
5,13404,10,100,0.0001,0.01,0.994,6720,6684
5,13504,10,100,0.0001,0.01,0.994,6771,6733
5,13604,10,100,0.0001,0.01,0.994,6816,6788
5,13704,10,100,0.0001,0.01,0.986,6867,6837
5,13804,10,100,0.0001,0.01,0.978,6912,6892
5,13904,10,100,0.0001,0.01,0.976,6955,6949
5,14004,10,100,0.0001,0.01,0.99,7008,6996
5,14104,10,100,0.0001,0.01,0.994,7067,7037
5,14204,10,100,0.0001,0.01,0.99,7114,7090
5,14304,10,100,0.0001,0.01,0.994,7161,7143
5,14404,10,100,0.0001,0.01,0.994,7217,7187
5,14504,10,100,0.0001,0.01,0.992,7271,7233
5,14604,10,100,0.0001,0.01,0.988,7318,7286
5,14704,10,100,0.0001,0.01,0.994,7362,7342
5,14804,10,100,0.0001,0.01,0.994,7417,7387
5,14904,10,100,0.0001,0.01,0.982,7464,7440
5,15004,10,100,0.0001,0.01,0.994,7508,7496
6,104,10,100,0.0001,0.01,0.526,63,41
6,204,10,100,0.0001,0.01,0.536,110,94
6,304,10,100,0.0001,0.01,0.532,162,142
6,404,10,100,0.0001,0.01,0.502,216,188
6,504,10,100,0.0001,0.01,0.52,270,234
6,604,10,100,0.0001,0.01,0.504,322,282
6,704,10,100,0.0001,0.01,0.488,367,337
6,804,10,100,0.0001,0.01,0.532,412,392
6,904,10,100,0.0001,0.01,0.524,462,442
6,1004,10,100,0.0001,0.01,0.536,516,488
6,1104,10,100,0.0001,0.01,0.542,570,534
6,1204,10,100,0.0001,0.01,0.526,624,580
6,1304,10,100,0.0001,0.01,0.528,666,638
6,1404,10,100,0.0001,0.01,0.538,726,678
6,1504,10,100,0.0001,0.01,0.514,777,727
6,1604,10,100,0.0001,0.01,0.528,828,776
6,1704,10,100,0.0001,0.01,0.548,884,820
6,1804,10,100,0.0001,0.01,0.512,934,870
6,1904,10,100,0.0001,0.01,0.54,991,913
6,2004,10,100,0.0001,0.01,0.544,1041,963
6,2104,10,100,0.0001,0.01,0.546,1096,1008
6,2204,10,100,0.0001,0.01,0.556,1151,1053
6,2304,10,100,0.0001,0.01,0.594,1202,1102
6,2404,10,100,0.0001,0.01,0.592,1251,1153
6,2504,10,100,0.0001,0.01,0.62,1298,1206
6,2604,10,100,0.0001,0.01,0.632,1349,1255
6,2704,10,100,0.0001,0.01,0.638,1404,1300
6,2804,10,100,0.0001,0.01,0.674,1454,1350
6,2904,10,100,0.0001,0.01,0.66,1509,1395
6,3004,10,100,0.0001,0.01,0.684,1559,1445
6,3104,10,100,0.0001,0.01,0.696,1603,1501
6,3204,10,100,0.0001,0.01,0.718,1653,1551
6,3304,10,100,0.0001,0.01,0.726,1697,1607
6,3404,10,100,0.0001,0.01,0.714,1747,1657
6,3504,10,100,0.0001,0.01,0.73,1799,1705
6,3604,10,100,0.0001,0.01,0.728,1850,1754
6,3704,10,100,0.0001,0.01,0.746,1899,1805
6,3804,10,100,0.0001,0.01,0.772,1940,1864
6,3904,10,100,0.0001,0.01,0.75,1993,1911
6,4004,10,100,0.0001,0.01,0.764,2044,1960
6,4104,10,100,0.0001,0.01,0.762,2091,2013
6,4204,10,100,0.0001,0.01,0.78,2140,2064
6,4304,10,100,0.0001,0.01,0.774,2194,2110
6,4404,10,100,0.0001,0.01,0.8,2242,2162
6,4504,10,100,0.0001,0.01,0.794,2291,2213
6,4604,10,100,0.0001,0.01,0.798,2343,2261
6,4704,10,100,0.0001,0.01,0.808,2397,2307
6,4804,10,100,0.0001,0.01,0.816,2451,2353
6,4904,10,100,0.0001,0.01,0.834,2497,2407
6,5004,10,100,0.0001,0.01,0.814,2544,2460
6,5104,10,100,0.0001,0.01,0.81,2595,2509
6,5204,10,100,0.0001,0.01,0.832,2643,2561
6,5304,10,100,0.0001,0.01,0.808,2689,2615
6,5404,10,100,0.0001,0.01,0.832,2736,2668
6,5504,10,100,0.0001,0.01,0.824,2779,2725
6,5604,10,100,0.0001,0.01,0.846,2838,2766
6,5704,10,100,0.0001,0.01,0.868,2879,2825
6,5804,10,100,0.0001,0.01,0.864,2929,2875
6,5904,10,100,0.0001,0.01,0.868,2977,2927
6,6004,10,100,0.0001,0.01,0.876,3030,2974
6,6104,10,100,0.0001,0.01,0.86,3083,3021
6,6204,10,100,0.0001,0.01,0.87,3126,3078
6,6304,10,100,0.0001,0.01,0.874,3168,3136
6,6404,10,100,0.0001,0.01,0.892,3212,3192
6,6504,10,100,0.0001,0.01,0.882,3257,3247
6,6604,10,100,0.0001,0.01,0.896,3310,3294
6,6704,10,100,0.0001,0.01,0.886,3351,3353
6,6804,10,100,0.0001,0.01,0.88,3401,3403
6,6904,10,100,0.0001,0.01,0.912,3448,3456
6,7004,10,100,0.0001,0.01,0.906,3496,3508
6,7104,10,100,0.0001,0.01,0.906,3553,3551
6,7204,10,100,0.0001,0.01,0.912,3603,3601
6,7304,10,100,0.0001,0.01,0.904,3656,3648
6,7404,10,100,0.0001,0.01,0.912,3701,3703
6,7504,10,100,0.0001,0.01,0.894,3759,3745
6,7604,10,100,0.0001,0.01,0.888,3803,3801
6,7704,10,100,0.0001,0.01,0.914,3851,3853
6,7804,10,100,0.0001,0.01,0.902,3899,3905
6,7904,10,100,0.0001,0.01,0.926,3955,3949
6,8004,10,100,0.0001,0.01,0.924,4003,4001
6,8104,10,100,0.0001,0.01,0.932,4057,4047
6,8204,10,100,0.0001,0.01,0.936,4106,4098
6,8304,10,100,0.0001,0.01,0.934,4162,4142
6,8404,10,100,0.0001,0.01,0.938,4215,4189
6,8504,10,100,0.0001,0.01,0.932,4269,4235
6,8604,10,100,0.0001,0.01,0.934,4320,4284
6,8704,10,100,0.0001,0.01,0.944,4378,4326
6,8804,10,100,0.0001,0.01,0.944,4425,4379
6,8904,10,100,0.0001,0.01,0.938,4475,4429
6,9004,10,100,0.0001,0.01,0.938,4522,4482
6,9104,10,100,0.0001,0.01,0.944,4566,4538
6,9204,10,100,0.0001,0.01,0.958,4614,4590
6,9304,10,100,0.0001,0.01,0.928,4659,4645
6,9404,10,100,0.0001,0.01,0.936,4707,4697
6,9504,10,100,0.0001,0.01,0.94,4761,4743
6,9604,10,100,0.0001,0.01,0.952,4817,4787
6,9704,10,100,0.0001,0.01,0.958,4871,4833
6,9804,10,100,0.0001,0.01,0.956,4920,4884
6,9904,10,100,0.0001,0.01,0.956,4968,4936
6,10004,10,100,0.0001,0.01,0.968,5021,4983
6,10104,10,100,0.0001,0.01,0.96,5076,5028
6,10204,10,100,0.0001,0.01,0.952,5127,5077
6,10304,10,100,0.0001,0.01,0.956,5179,5125
6,10404,10,100,0.0001,0.01,0.94,5225,5179
6,10504,10,100,0.0001,0.01,0.966,5272,5232
6,10604,10,100,0.0001,0.01,0.952,5315,5289
6,10704,10,100,0.0001,0.01,0.946,5368,5336
6,10804,10,100,0.0001,0.01,0.97,5421,5383
6,10904,10,100,0.0001,0.01,0.974,5474,5430
6,11004,10,100,0.0001,0.01,0.96,5528,5476
6,11104,10,100,0.0001,0.01,0.974,5578,5526
6,11204,10,100,0.0001,0.01,0.968,5629,5575
6,11304,10,100,0.0001,0.01,0.976,5675,5629
6,11404,10,100,0.0001,0.01,0.982,5728,5676
6,11504,10,100,0.0001,0.01,0.976,5773,5731
6,11604,10,100,0.0001,0.01,0.976,5822,5782
6,11704,10,100,0.0001,0.01,0.976,5875,5829
6,11804,10,100,0.0001,0.01,0.978,5925,5879
6,11904,10,100,0.0001,0.01,0.982,5970,5934
6,12004,10,100,0.0001,0.01,0.976,6023,5981
6,12104,10,100,0.0001,0.01,0.968,6083,6021
6,12204,10,100,0.0001,0.01,0.98,6127,6077
6,12304,10,100,0.0001,0.01,0.98,6176,6128
6,12404,10,100,0.0001,0.01,0.978,6220,6184
6,12504,10,100,0.0001,0.01,0.982,6261,6243
6,12604,10,100,0.0001,0.01,0.98,6314,6290
6,12704,10,100,0.0001,0.01,0.984,6367,6337
6,12804,10,100,0.0001,0.01,0.99,6415,6389
6,12904,10,100,0.0001,0.01,0.988,6467,6437
6,13004,10,100,0.0001,0.01,0.98,6511,6493
6,13104,10,100,0.0001,0.01,0.98,6568,6536
6,13204,10,100,0.0001,0.01,0.986,6620,6584
6,13304,10,100,0.0001,0.01,0.994,6663,6641
6,13404,10,100,0.0001,0.01,0.988,6705,6699
6,13504,10,100,0.0001,0.01,0.994,6755,6749
6,13604,10,100,0.0001,0.01,0.992,6805,6799
6,13704,10,100,0.0001,0.01,0.99,6855,6849
6,13804,10,100,0.0001,0.01,0.968,6895,6909
6,13904,10,100,0.0001,0.01,0.982,6949,6955
6,14004,10,100,0.0001,0.01,0.972,6997,7007
6,14104,10,100,0.0001,0.01,0.99,7044,7060
6,14204,10,100,0.0001,0.01,0.982,7090,7114
6,14304,10,100,0.0001,0.01,0.988,7141,7163
6,14404,10,100,0.0001,0.01,0.988,7185,7219
6,14504,10,100,0.0001,0.01,0.992,7234,7270
6,14604,10,100,0.0001,0.01,0.994,7286,7318
6,14704,10,100,0.0001,0.01,0.994,7336,7368
6,14804,10,100,0.0001,0.01,0.996,7393,7411
6,14904,10,100,0.0001,0.01,0.998,7445,7459
6,15004,10,100,0.0001,0.01,0.998,7489,7515
7,104,10,100,0.0001,0.01,0.498,44,60
7,204,10,100,0.0001,0.01,0.5,86,118
7,304,10,100,0.0001,0.01,0.508,128,176
7,404,10,100,0.0001,0.01,0.506,173,231
7,504,10,100,0.0001,0.01,0.484,229,275
7,604,10,100,0.0001,0.01,0.488,285,319
7,704,10,100,0.0001,0.01,0.49,341,363
7,804,10,100,0.0001,0.01,0.504,390,414
7,904,10,100,0.0001,0.01,0.51,437,467
7,1004,10,100,0.0001,0.01,0.508,488,516
7,1104,10,100,0.0001,0.01,0.506,535,569
7,1204,10,100,0.0001,0.01,0.496,582,622
7,1304,10,100,0.0001,0.01,0.506,625,679
7,1404,10,100,0.0001,0.01,0.496,679,725
7,1504,10,100,0.0001,0.01,0.484,732,772
7,1604,10,100,0.0001,0.01,0.484,775,829
7,1704,10,100,0.0001,0.01,0.504,825,879
7,1804,10,100,0.0001,0.01,0.504,869,935
7,1904,10,100,0.0001,0.01,0.482,924,980
7,2004,10,100,0.0001,0.01,0.488,979,1025
7,2104,10,100,0.0001,0.01,0.502,1029,1075
7,2204,10,100,0.0001,0.01,0.498,1073,1131
7,2304,10,100,0.0001,0.01,0.532,1125,1179
7,2404,10,100,0.0001,0.01,0.5,1174,1230
7,2504,10,100,0.0001,0.01,0.512,1226,1278
7,2604,10,100,0.0001,0.01,0.532,1285,1319
7,2704,10,100,0.0001,0.01,0.522,1326,1378
7,2804,10,100,0.0001,0.01,0.522,1384,1420
7,2904,10,100,0.0001,0.01,0.51,1445,1459
7,3004,10,100,0.0001,0.01,0.528,1497,1507
7,3104,10,100,0.0001,0.01,0.512,1549,1555
7,3204,10,100,0.0001,0.01,0.528,1591,1613
7,3304,10,100,0.0001,0.01,0.506,1653,1651
7,3404,10,100,0.0001,0.01,0.522,1710,1694
7,3504,10,100,0.0001,0.01,0.496,1764,1740
7,3604,10,100,0.0001,0.01,0.524,1817,1787
7,3704,10,100,0.0001,0.01,0.496,1867,1837
7,3804,10,100,0.0001,0.01,0.522,1913,1891
7,3904,10,100,0.0001,0.01,0.52,1957,1947
7,4004,10,100,0.0001,0.01,0.54,2012,1992
7,4104,10,100,0.0001,0.01,0.552,2068,2036
7,4204,10,100,0.0001,0.01,0.554,2116,2088
7,4304,10,100,0.0001,0.01,0.54,2172,2132
7,4404,10,100,0.0001,0.01,0.562,2225,2179
7,4504,10,100,0.0001,0.01,0.564,2270,2234
7,4604,10,100,0.0001,0.01,0.584,2320,2284
7,4704,10,100,0.0001,0.01,0.588,2373,2331
7,4804,10,100,0.0001,0.01,0.614,2421,2383
7,4904,10,100,0.0001,0.01,0.634,2460,2444
7,5004,10,100,0.0001,0.01,0.6,2511,2493
7,5104,10,100,0.0001,0.01,0.576,2559,2545
7,5204,10,100,0.0001,0.01,0.654,2607,2597
7,5304,10,100,0.0001,0.01,0.632,2651,2653
7,5404,10,100,0.0001,0.01,0.666,2708,2696
7,5504,10,100,0.0001,0.01,0.658,2753,2751
7,5604,10,100,0.0001,0.01,0.636,2809,2795
7,5704,10,100,0.0001,0.01,0.622,2849,2855
7,5804,10,100,0.0001,0.01,0.638,2890,2914
7,5904,10,100,0.0001,0.01,0.69,2941,2963
7,6004,10,100,0.0001,0.01,0.69,2996,3008
7,6104,10,100,0.0001,0.01,0.666,3047,3057
7,6204,10,100,0.0001,0.01,0.66,3102,3102
7,6304,10,100,0.0001,0.01,0.702,3149,3155
7,6404,10,100,0.0001,0.01,0.7,3197,3207
7,6504,10,100,0.0001,0.01,0.684,3244,3260
7,6604,10,100,0.0001,0.01,0.684,3292,3312
7,6704,10,100,0.0001,0.01,0.704,3350,3354
7,6804,10,100,0.0001,0.01,0.686,3402,3402
7,6904,10,100,0.0001,0.01,0.69,3450,3454
7,7004,10,100,0.0001,0.01,0.716,3496,3508
7,7104,10,100,0.0001,0.01,0.706,3555,3549
7,7204,10,100,0.0001,0.01,0.7,3602,3602
7,7304,10,100,0.0001,0.01,0.708,3648,3656
7,7404,10,100,0.0001,0.01,0.7,3707,3697
7,7504,10,100,0.0001,0.01,0.69,3753,3751
7,7604,10,100,0.0001,0.01,0.716,3803,3801
7,7704,10,100,0.0001,0.01,0.72,3847,3857
7,7804,10,100,0.0001,0.01,0.722,3897,3907
7,7904,10,100,0.0001,0.01,0.722,3945,3959
7,8004,10,100,0.0001,0.01,0.74,3993,4011
7,8104,10,100,0.0001,0.01,0.694,4038,4066
7,8204,10,100,0.0001,0.01,0.73,4097,4107
7,8304,10,100,0.0001,0.01,0.642,4155,4149
7,8404,10,100,0.0001,0.01,0.65,4204,4200
7,8504,10,100,0.0001,0.01,0.67,4252,4252
7,8604,10,100,0.0001,0.01,0.668,4303,4301
7,8704,10,100,0.0001,0.01,0.676,4360,4344
7,8804,10,100,0.0001,0.01,0.68,4417,4387
7,8904,10,100,0.0001,0.01,0.708,4464,4440
7,9004,10,100,0.0001,0.01,0.72,4516,4488
7,9104,10,100,0.0001,0.01,0.734,4558,4546
7,9204,10,100,0.0001,0.01,0.75,4612,4592
7,9304,10,100,0.0001,0.01,0.742,4671,4633
7,9404,10,100,0.0001,0.01,0.728,4720,4684
7,9504,10,100,0.0001,0.01,0.742,4776,4728
7,9604,10,100,0.0001,0.01,0.74,4824,4780
7,9704,10,100,0.0001,0.01,0.73,4876,4828
7,9804,10,100,0.0001,0.01,0.758,4919,4885
7,9904,10,100,0.0001,0.01,0.774,4973,4931
7,10004,10,100,0.0001,0.01,0.774,5018,4986
7,10104,10,100,0.0001,0.01,0.762,5070,5034
7,10204,10,100,0.0001,0.01,0.768,5117,5087
7,10304,10,100,0.0001,0.01,0.764,5165,5139
7,10404,10,100,0.0001,0.01,0.76,5211,5193
7,10504,10,100,0.0001,0.01,0.782,5250,5254
7,10604,10,100,0.0001,0.01,0.798,5300,5304
7,10704,10,100,0.0001,0.01,0.806,5348,5356
7,10804,10,100,0.0001,0.01,0.808,5394,5410
7,10904,10,100,0.0001,0.01,0.814,5446,5458
7,11004,10,100,0.0001,0.01,0.82,5509,5495
7,11104,10,100,0.0001,0.01,0.814,5548,5556
7,11204,10,100,0.0001,0.01,0.832,5587,5617
7,11304,10,100,0.0001,0.01,0.822,5643,5661
7,11404,10,100,0.0001,0.01,0.818,5698,5706
7,11504,10,100,0.0001,0.01,0.838,5741,5763
7,11604,10,100,0.0001,0.01,0.828,5784,5820
7,11704,10,100,0.0001,0.01,0.822,5840,5864
7,11804,10,100,0.0001,0.01,0.818,5888,5916
7,11904,10,100,0.0001,0.01,0.844,5938,5966
7,12004,10,100,0.0001,0.01,0.85,5998,6006
7,12104,10,100,0.0001,0.01,0.864,6054,6050
7,12204,10,100,0.0001,0.01,0.848,6100,6104
7,12304,10,100,0.0001,0.01,0.856,6150,6154
7,12404,10,100,0.0001,0.01,0.886,6207,6197
7,12504,10,100,0.0001,0.01,0.88,6255,6249
7,12604,10,100,0.0001,0.01,0.87,6299,6305
7,12704,10,100,0.0001,0.01,0.876,6355,6349
7,12804,10,100,0.0001,0.01,0.86,6400,6404
7,12904,10,100,0.0001,0.01,0.876,6458,6446
7,13004,10,100,0.0001,0.01,0.892,6504,6500
7,13104,10,100,0.0001,0.01,0.888,6550,6554
7,13204,10,100,0.0001,0.01,0.886,6600,6604
7,13304,10,100,0.0001,0.01,0.878,6643,6661
7,13404,10,100,0.0001,0.01,0.914,6697,6707
7,13504,10,100,0.0001,0.01,0.904,6750,6754
7,13604,10,100,0.0001,0.01,0.892,6800,6804
7,13704,10,100,0.0001,0.01,0.87,6850,6854
7,13804,10,100,0.0001,0.01,0.898,6904,6900
7,13904,10,100,0.0001,0.01,0.908,6949,6955
7,14004,10,100,0.0001,0.01,0.914,7007,6997
7,14104,10,100,0.0001,0.01,0.902,7056,7048
7,14204,10,100,0.0001,0.01,0.916,7106,7098
7,14304,10,100,0.0001,0.01,0.914,7154,7150
7,14404,10,100,0.0001,0.01,0.924,7207,7197
7,14504,10,100,0.0001,0.01,0.926,7260,7244
7,14604,10,100,0.0001,0.01,0.93,7313,7291
7,14704,10,100,0.0001,0.01,0.94,7359,7345
7,14804,10,100,0.0001,0.01,0.928,7402,7402
7,14904,10,100,0.0001,0.01,0.918,7446,7458
7,15004,10,100,0.0001,0.01,0.934,7502,7502
8,104,10,100,0.0001,0.01,0.49,50,54
8,204,10,100,0.0001,0.01,0.51,94,110
8,304,10,100,0.0001,0.01,0.506,153,151
8,404,10,100,0.0001,0.01,0.488,204,200
8,504,10,100,0.0001,0.01,0.486,254,250
8,604,10,100,0.0001,0.01,0.532,309,295
8,704,10,100,0.0001,0.01,0.512,353,351
8,804,10,100,0.0001,0.01,0.518,398,406
8,904,10,100,0.0001,0.01,0.556,444,460
8,1004,10,100,0.0001,0.01,0.558,497,507
8,1104,10,100,0.0001,0.01,0.536,550,554
8,1204,10,100,0.0001,0.01,0.54,598,606
8,1304,10,100,0.0001,0.01,0.548,648,656
8,1404,10,100,0.0001,0.01,0.536,700,704
8,1504,10,100,0.0001,0.01,0.502,749,755
8,1604,10,100,0.0001,0.01,0.576,791,813
8,1704,10,100,0.0001,0.01,0.562,837,867
8,1804,10,100,0.0001,0.01,0.572,890,914
8,1904,10,100,0.0001,0.01,0.57,946,958
8,2004,10,100,0.0001,0.01,0.62,992,1012
8,2104,10,100,0.0001,0.01,0.61,1040,1064
8,2204,10,100,0.0001,0.01,0.616,1085,1119
8,2304,10,100,0.0001,0.01,0.612,1133,1171
8,2404,10,100,0.0001,0.01,0.67,1184,1220
8,2504,10,100,0.0001,0.01,0.704,1231,1273
8,2604,10,100,0.0001,0.01,0.732,1280,1324
8,2704,10,100,0.0001,0.01,0.702,1327,1377
8,2804,10,100,0.0001,0.01,0.712,1372,1432
8,2904,10,100,0.0001,0.01,0.74,1425,1479
8,3004,10,100,0.0001,0.01,0.696,1479,1525
8,3104,10,100,0.0001,0.01,0.75,1535,1569
8,3204,10,100,0.0001,0.01,0.776,1579,1625
8,3304,10,100,0.0001,0.01,0.78,1633,1671
8,3404,10,100,0.0001,0.01,0.802,1682,1722
8,3504,10,100,0.0001,0.01,0.804,1737,1767
8,3604,10,100,0.0001,0.01,0.834,1786,1818
8,3704,10,100,0.0001,0.01,0.814,1841,1863
8,3804,10,100,0.0001,0.01,0.844,1890,1914
8,3904,10,100,0.0001,0.01,0.852,1940,1964
8,4004,10,100,0.0001,0.01,0.842,1994,2010
8,4104,10,100,0.0001,0.01,0.848,2044,2060
8,4204,10,100,0.0001,0.01,0.848,2097,2107
8,4304,10,100,0.0001,0.01,0.852,2150,2154
8,4404,10,100,0.0001,0.01,0.872,2197,2207
8,4504,10,100,0.0001,0.01,0.886,2244,2260
8,4604,10,100,0.0001,0.01,0.892,2296,2308
8,4704,10,100,0.0001,0.01,0.904,2351,2353
8,4804,10,100,0.0001,0.01,0.892,2406,2398
8,4904,10,100,0.0001,0.01,0.912,2455,2449
8,5004,10,100,0.0001,0.01,0.902,2505,2499
8,5104,10,100,0.0001,0.01,0.916,2554,2550
8,5204,10,100,0.0001,0.01,0.93,2604,2600
8,5304,10,100,0.0001,0.01,0.928,2666,2638
8,5404,10,100,0.0001,0.01,0.934,2712,2692
8,5504,10,100,0.0001,0.01,0.934,2759,2745
8,5604,10,100,0.0001,0.01,0.934,2807,2797
8,5704,10,100,0.0001,0.01,0.938,2856,2848
8,5804,10,100,0.0001,0.01,0.936,2896,2908
8,5904,10,100,0.0001,0.01,0.938,2944,2960
8,6004,10,100,0.0001,0.01,0.95,2995,3009
8,6104,10,100,0.0001,0.01,0.94,3049,3055
8,6204,10,100,0.0001,0.01,0.936,3100,3104
8,6304,10,100,0.0001,0.01,0.944,3156,3148
8,6404,10,100,0.0001,0.01,0.936,3203,3201
8,6504,10,100,0.0001,0.01,0.944,3252,3252
8,6604,10,100,0.0001,0.01,0.95,3300,3304
8,6704,10,100,0.0001,0.01,0.946,3345,3359
8,6804,10,100,0.0001,0.01,0.946,3402,3402
8,6904,10,100,0.0001,0.01,0.946,3460,3444
8,7004,10,100,0.0001,0.01,0.94,3514,3490
8,7104,10,100,0.0001,0.01,0.946,3569,3535
8,7204,10,100,0.0001,0.01,0.934,3623,3581
8,7304,10,100,0.0001,0.01,0.936,3665,3639
8,7404,10,100,0.0001,0.01,0.94,3722,3682
8,7504,10,100,0.0001,0.01,0.964,3776,3728
8,7604,10,100,0.0001,0.01,0.958,3828,3776
8,7704,10,100,0.0001,0.01,0.952,3875,3829
8,7804,10,100,0.0001,0.01,0.966,3922,3882
8,7904,10,100,0.0001,0.01,0.962,3970,3934
8,8004,10,100,0.0001,0.01,0.94,4019,3985
8,8104,10,100,0.0001,0.01,0.944,4068,4036
8,8204,10,100,0.0001,0.01,0.96,4117,4087
8,8304,10,100,0.0001,0.01,0.964,4172,4132
8,8404,10,100,0.0001,0.01,0.972,4219,4185
8,8504,10,100,0.0001,0.01,0.98,4274,4230
8,8604,10,100,0.0001,0.01,0.97,4324,4280
8,8704,10,100,0.0001,0.01,0.968,4369,4335
8,8804,10,100,0.0001,0.01,0.974,4428,4376
8,8904,10,100,0.0001,0.01,0.974,4478,4426
8,9004,10,100,0.0001,0.01,0.974,4531,4473
8,9104,10,100,0.0001,0.01,0.976,4579,4525
8,9204,10,100,0.0001,0.01,0.968,4626,4578
8,9304,10,100,0.0001,0.01,0.978,4681,4623
8,9404,10,100,0.0001,0.01,0.964,4730,4674
8,9504,10,100,0.0001,0.01,0.974,4785,4719
8,9604,10,100,0.0001,0.01,0.964,4834,4770
8,9704,10,100,0.0001,0.01,0.966,4881,4823
8,9804,10,100,0.0001,0.01,0.968,4939,4865
8,9904,10,100,0.0001,0.01,0.96,4985,4919
8,10004,10,100,0.0001,0.01,0.974,5034,4970
8,10104,10,100,0.0001,0.01,0.972,5073,5031
8,10204,10,100,0.0001,0.01,0.978,5115,5089
8,10304,10,100,0.0001,0.01,0.982,5178,5126
8,10404,10,100,0.0001,0.01,0.978,5225,5179
8,10504,10,100,0.0001,0.01,0.978,5268,5236
8,10604,10,100,0.0001,0.01,0.982,5316,5288
8,10704,10,100,0.0001,0.01,0.978,5367,5337
8,10804,10,100,0.0001,0.01,0.982,5407,5397
8,10904,10,100,0.0001,0.01,0.984,5454,5450
8,11004,10,100,0.0001,0.01,0.976,5498,5506
8,11104,10,100,0.0001,0.01,0.982,5550,5554
8,11204,10,100,0.0001,0.01,0.978,5595,5609
8,11304,10,100,0.0001,0.01,0.982,5660,5644
8,11404,10,100,0.0001,0.01,0.984,5711,5693
8,11504,10,100,0.0001,0.01,0.97,5760,5744
8,11604,10,100,0.0001,0.01,0.978,5797,5807
8,11704,10,100,0.0001,0.01,0.98,5845,5859
8,11804,10,100,0.0001,0.01,0.974,5889,5915
8,11904,10,100,0.0001,0.01,0.986,5939,5965
8,12004,10,100,0.0001,0.01,0.982,5990,6014
8,12104,10,100,0.0001,0.01,0.986,6041,6063
8,12204,10,100,0.0001,0.01,0.986,6093,6111
8,12304,10,100,0.0001,0.01,0.986,6144,6160
8,12404,10,100,0.0001,0.01,0.99,6189,6215
8,12504,10,100,0.0001,0.01,0.99,6243,6261
8,12604,10,100,0.0001,0.01,0.988,6289,6315
8,12704,10,100,0.0001,0.01,0.986,6342,6362
8,12804,10,100,0.0001,0.01,0.988,6391,6413
8,12904,10,100,0.0001,0.01,0.986,6446,6458
8,13004,10,100,0.0001,0.01,0.986,6494,6510
8,13104,10,100,0.0001,0.01,0.98,6547,6557
8,13204,10,100,0.0001,0.01,0.98,6596,6608
8,13304,10,100,0.0001,0.01,0.982,6637,6667
8,13404,10,100,0.0001,0.01,0.984,6685,6719
8,13504,10,100,0.0001,0.01,0.984,6741,6763
8,13604,10,100,0.0001,0.01,0.988,6793,6811
8,13704,10,100,0.0001,0.01,0.988,6836,6868
8,13804,10,100,0.0001,0.01,0.984,6885,6919
8,13904,10,100,0.0001,0.01,0.98,6937,6967
8,14004,10,100,0.0001,0.01,0.988,6981,7023
8,14104,10,100,0.0001,0.01,0.984,7036,7068
8,14204,10,100,0.0001,0.01,0.984,7092,7112
8,14304,10,100,0.0001,0.01,0.99,7143,7161
8,14404,10,100,0.0001,0.01,0.994,7191,7213
8,14504,10,100,0.0001,0.01,0.982,7239,7265
8,14604,10,100,0.0001,0.01,0.986,7293,7311
8,14704,10,100,0.0001,0.01,0.994,7355,7349
8,14804,10,100,0.0001,0.01,0.994,7401,7403
8,14904,10,100,0.0001,0.01,0.994,7447,7457
8,15004,10,100,0.0001,0.01,0.994,7495,7509
9,104,10,100,0.0001,0.01,0.492,46,58
9,204,10,100,0.0001,0.01,0.488,105,99
9,304,10,100,0.0001,0.01,0.51,153,151
9,404,10,100,0.0001,0.01,0.49,201,203
9,504,10,100,0.0001,0.01,0.484,248,256
9,604,10,100,0.0001,0.01,0.482,291,313
9,704,10,100,0.0001,0.01,0.484,346,358
9,804,10,100,0.0001,0.01,0.5,392,412
9,904,10,100,0.0001,0.01,0.508,446,458
9,1004,10,100,0.0001,0.01,0.514,494,510
9,1104,10,100,0.0001,0.01,0.476,539,565
9,1204,10,100,0.0001,0.01,0.52,590,614
9,1304,10,100,0.0001,0.01,0.518,638,666
9,1404,10,100,0.0001,0.01,0.564,691,713
9,1504,10,100,0.0001,0.01,0.542,736,768
9,1604,10,100,0.0001,0.01,0.566,790,814
9,1704,10,100,0.0001,0.01,0.558,835,869
9,1804,10,100,0.0001,0.01,0.578,880,924
9,1904,10,100,0.0001,0.01,0.574,931,973
9,2004,10,100,0.0001,0.01,0.624,979,1025
9,2104,10,100,0.0001,0.01,0.588,1034,1070
9,2204,10,100,0.0001,0.01,0.616,1082,1122
9,2304,10,100,0.0001,0.01,0.632,1126,1178
9,2404,10,100,0.0001,0.01,0.67,1180,1224
9,2504,10,100,0.0001,0.01,0.67,1229,1275
9,2604,10,100,0.0001,0.01,0.678,1276,1328
9,2704,10,100,0.0001,0.01,0.698,1323,1381
9,2804,10,100,0.0001,0.01,0.704,1363,1441
9,2904,10,100,0.0001,0.01,0.746,1410,1494
9,3004,10,100,0.0001,0.01,0.754,1459,1545
9,3104,10,100,0.0001,0.01,0.756,1505,1599
9,3204,10,100,0.0001,0.01,0.784,1551,1653
9,3304,10,100,0.0001,0.01,0.752,1597,1707
9,3404,10,100,0.0001,0.01,0.774,1656,1748
9,3504,10,100,0.0001,0.01,0.776,1706,1798
9,3604,10,100,0.0001,0.01,0.774,1761,1843
9,3704,10,100,0.0001,0.01,0.806,1809,1895
9,3804,10,100,0.0001,0.01,0.826,1862,1942
9,3904,10,100,0.0001,0.01,0.806,1919,1985
9,4004,10,100,0.0001,0.01,0.816,1973,2031
9,4104,10,100,0.0001,0.01,0.822,2033,2071
9,4204,10,100,0.0001,0.01,0.832,2086,2118
9,4304,10,100,0.0001,0.01,0.848,2134,2170
9,4404,10,100,0.0001,0.01,0.858,2184,2220
9,4504,10,100,0.0001,0.01,0.868,2232,2272
9,4604,10,100,0.0001,0.01,0.856,2280,2324
9,4704,10,100,0.0001,0.01,0.874,2335,2369
9,4804,10,100,0.0001,0.01,0.862,2375,2429
9,4904,10,100,0.0001,0.01,0.856,2430,2474
9,5004,10,100,0.0001,0.01,0.868,2495,2509
9,5104,10,100,0.0001,0.01,0.898,2535,2569
9,5204,10,100,0.0001,0.01,0.886,2590,2614
9,5304,10,100,0.0001,0.01,0.896,2640,2664
9,5404,10,100,0.0001,0.01,0.91,2695,2709
9,5504,10,100,0.0001,0.01,0.908,2746,2758
9,5604,10,100,0.0001,0.01,0.91,2795,2809
9,5704,10,100,0.0001,0.01,0.908,2842,2862
9,5804,10,100,0.0001,0.01,0.928,2893,2911
9,5904,10,100,0.0001,0.01,0.918,2937,2967
9,6004,10,100,0.0001,0.01,0.916,2980,3024
9,6104,10,100,0.0001,0.01,0.928,3022,3082
9,6204,10,100,0.0001,0.01,0.924,3074,3130
9,6304,10,100,0.0001,0.01,0.904,3127,3177
9,6404,10,100,0.0001,0.01,0.914,3180,3224
9,6504,10,100,0.0001,0.01,0.884,3231,3273
9,6604,10,100,0.0001,0.01,0.898,3276,3328
9,6704,10,100,0.0001,0.01,0.914,3323,3381
9,6804,10,100,0.0001,0.01,0.932,3372,3432
9,6904,10,100,0.0001,0.01,0.936,3425,3479
9,7004,10,100,0.0001,0.01,0.938,3479,3525
9,7104,10,100,0.0001,0.01,0.938,3522,3582
9,7204,10,100,0.0001,0.01,0.942,3574,3630
9,7304,10,100,0.0001,0.01,0.946,3619,3685
9,7404,10,100,0.0001,0.01,0.954,3669,3735
9,7504,10,100,0.0001,0.01,0.938,3716,3788
9,7604,10,100,0.0001,0.01,0.946,3762,3842
9,7704,10,100,0.0001,0.01,0.948,3812,3892
9,7804,10,100,0.0001,0.01,0.944,3857,3947
9,7904,10,100,0.0001,0.01,0.922,3911,3993
9,8004,10,100,0.0001,0.01,0.934,3962,4042
9,8104,10,100,0.0001,0.01,0.94,4010,4094
9,8204,10,100,0.0001,0.01,0.956,4056,4148
9,8304,10,100,0.0001,0.01,0.956,4109,4195
9,8404,10,100,0.0001,0.01,0.968,4156,4248
9,8504,10,100,0.0001,0.01,0.972,4206,4298
9,8604,10,100,0.0001,0.01,0.968,4253,4351
9,8704,10,100,0.0001,0.01,0.96,4307,4397
9,8804,10,100,0.0001,0.01,0.954,4358,4446
9,8904,10,100,0.0001,0.01,0.964,4404,4500
9,9004,10,100,0.0001,0.01,0.948,4448,4556
9,9104,10,100,0.0001,0.01,0.948,4498,4606
9,9204,10,100,0.0001,0.01,0.942,4546,4658
9,9304,10,100,0.0001,0.01,0.952,4586,4718
9,9404,10,100,0.0001,0.01,0.96,4642,4762
9,9504,10,100,0.0001,0.01,0.954,4697,4807
9,9604,10,100,0.0001,0.01,0.962,4757,4847
9,9704,10,100,0.0001,0.01,0.97,4810,4894
9,9804,10,100,0.0001,0.01,0.976,4862,4942
9,9904,10,100,0.0001,0.01,0.964,4914,4990
9,10004,10,100,0.0001,0.01,0.968,4963,5041
9,10104,10,100,0.0001,0.01,0.97,5015,5089
9,10204,10,100,0.0001,0.01,0.976,5071,5133
9,10304,10,100,0.0001,0.01,0.966,5130,5174
9,10404,10,100,0.0001,0.01,0.952,5183,5221
9,10504,10,100,0.0001,0.01,0.962,5226,5278
9,10604,10,100,0.0001,0.01,0.964,5272,5332
9,10704,10,100,0.0001,0.01,0.972,5326,5378
9,10804,10,100,0.0001,0.01,0.966,5376,5428
9,10904,10,100,0.0001,0.01,0.96,5426,5478
9,11004,10,100,0.0001,0.01,0.96,5472,5532
9,11104,10,100,0.0001,0.01,0.976,5519,5585
9,11204,10,100,0.0001,0.01,0.972,5574,5630
9,11304,10,100,0.0001,0.01,0.97,5623,5681
9,11404,10,100,0.0001,0.01,0.972,5672,5732
9,11504,10,100,0.0001,0.01,0.974,5720,5784
9,11604,10,100,0.0001,0.01,0.972,5768,5836
9,11704,10,100,0.0001,0.01,0.972,5827,5877
9,11804,10,100,0.0001,0.01,0.976,5879,5925
9,11904,10,100,0.0001,0.01,0.98,5928,5976
9,12004,10,100,0.0001,0.01,0.98,5976,6028
9,12104,10,100,0.0001,0.01,0.978,6026,6078
9,12204,10,100,0.0001,0.01,0.974,6076,6128
9,12304,10,100,0.0001,0.01,0.97,6129,6175
9,12404,10,100,0.0001,0.01,0.978,6173,6231
9,12504,10,100,0.0001,0.01,0.98,6225,6279
9,12604,10,100,0.0001,0.01,0.976,6280,6324
9,12704,10,100,0.0001,0.01,0.97,6330,6374
9,12804,10,100,0.0001,0.01,0.972,6387,6417
9,12904,10,100,0.0001,0.01,0.974,6436,6468
9,13004,10,100,0.0001,0.01,0.978,6484,6520
9,13104,10,100,0.0001,0.01,0.976,6544,6560
9,13204,10,100,0.0001,0.01,0.978,6591,6613
9,13304,10,100,0.0001,0.01,0.982,6645,6659
9,13404,10,100,0.0001,0.01,0.986,6692,6712
9,13504,10,100,0.0001,0.01,0.966,6749,6755
9,13604,10,100,0.0001,0.01,0.982,6801,6803
9,13704,10,100,0.0001,0.01,0.978,6850,6854
9,13804,10,100,0.0001,0.01,0.978,6903,6901
9,13904,10,100,0.0001,0.01,0.986,6950,6954
9,14004,10,100,0.0001,0.01,0.968,7001,7003
9,14104,10,100,0.0001,0.01,0.98,7047,7057
9,14204,10,100,0.0001,0.01,0.984,7101,7103
9,14304,10,100,0.0001,0.01,0.982,7158,7146
9,14404,10,100,0.0001,0.01,0.98,7213,7191
9,14504,10,100,0.0001,0.01,0.974,7262,7242
9,14604,10,100,0.0001,0.01,0.974,7304,7300
9,14704,10,100,0.0001,0.01,0.992,7352,7352
9,14804,10,100,0.0001,0.01,0.982,7404,7400
9,14904,10,100,0.0001,0.01,0.986,7450,7454
9,15004,10,100,0.0001,0.01,0.986,7498,7506
10,104,10,100,0.0001,0.01,0.552,55,49
10,204,10,100,0.0001,0.01,0.546,103,101
10,304,10,100,0.0001,0.01,0.542,154,150
10,404,10,100,0.0001,0.01,0.554,204,200
10,504,10,100,0.0001,0.01,0.536,256,248
10,604,10,100,0.0001,0.01,0.542,304,300
10,704,10,100,0.0001,0.01,0.54,356,348
10,804,10,100,0.0001,0.01,0.532,398,406
10,904,10,100,0.0001,0.01,0.556,447,457
10,1004,10,100,0.0001,0.01,0.496,501,503
10,1104,10,100,0.0001,0.01,0.52,554,550
10,1204,10,100,0.0001,0.01,0.54,602,602
10,1304,10,100,0.0001,0.01,0.538,645,659
10,1404,10,100,0.0001,0.01,0.494,693,711
10,1504,10,100,0.0001,0.01,0.51,738,766
10,1604,10,100,0.0001,0.01,0.518,784,820
10,1704,10,100,0.0001,0.01,0.476,836,868
10,1804,10,100,0.0001,0.01,0.514,879,925
10,1904,10,100,0.0001,0.01,0.484,931,973
10,2004,10,100,0.0001,0.01,0.48,987,1017
10,2104,10,100,0.0001,0.01,0.484,1034,1070
10,2204,10,100,0.0001,0.01,0.524,1084,1120
10,2304,10,100,0.0001,0.01,0.514,1137,1167
10,2404,10,100,0.0001,0.01,0.526,1172,1232
10,2504,10,100,0.0001,0.01,0.492,1224,1280
10,2604,10,100,0.0001,0.01,0.502,1265,1339
10,2704,10,100,0.0001,0.01,0.516,1320,1384
10,2804,10,100,0.0001,0.01,0.518,1374,1430
10,2904,10,100,0.0001,0.01,0.534,1430,1474
10,3004,10,100,0.0001,0.01,0.556,1473,1531
10,3104,10,100,0.0001,0.01,0.518,1527,1577
10,3204,10,100,0.0001,0.01,0.542,1584,1620
10,3304,10,100,0.0001,0.01,0.534,1633,1671
10,3404,10,100,0.0001,0.01,0.552,1678,1726
10,3504,10,100,0.0001,0.01,0.552,1729,1775
10,3604,10,100,0.0001,0.01,0.544,1773,1831
10,3704,10,100,0.0001,0.01,0.556,1824,1880
10,3804,10,100,0.0001,0.01,0.554,1878,1926
10,3904,10,100,0.0001,0.01,0.582,1926,1978
10,4004,10,100,0.0001,0.01,0.546,1975,2029
10,4104,10,100,0.0001,0.01,0.59,2022,2082
10,4204,10,100,0.0001,0.01,0.592,2077,2127
10,4304,10,100,0.0001,0.01,0.606,2129,2175
10,4404,10,100,0.0001,0.01,0.598,2178,2226
10,4504,10,100,0.0001,0.01,0.614,2222,2282
10,4604,10,100,0.0001,0.01,0.632,2278,2326
10,4704,10,100,0.0001,0.01,0.614,2331,2373
10,4804,10,100,0.0001,0.01,0.64,2380,2424
10,4904,10,100,0.0001,0.01,0.626,2430,2474
10,5004,10,100,0.0001,0.01,0.62,2476,2528
10,5104,10,100,0.0001,0.01,0.676,2528,2576
10,5204,10,100,0.0001,0.01,0.68,2590,2614
10,5304,10,100,0.0001,0.01,0.67,2641,2663
10,5404,10,100,0.0001,0.01,0.668,2690,2714
10,5504,10,100,0.0001,0.01,0.636,2737,2767
10,5604,10,100,0.0001,0.01,0.672,2789,2815
10,5704,10,100,0.0001,0.01,0.698,2839,2865
10,5804,10,100,0.0001,0.01,0.678,2891,2913
10,5904,10,100,0.0001,0.01,0.724,2939,2965
10,6004,10,100,0.0001,0.01,0.706,2989,3015
10,6104,10,100,0.0001,0.01,0.718,3041,3063
10,6204,10,100,0.0001,0.01,0.726,3089,3115
10,6304,10,100,0.0001,0.01,0.708,3136,3168
10,6404,10,100,0.0001,0.01,0.732,3187,3217
10,6504,10,100,0.0001,0.01,0.752,3233,3271
10,6604,10,100,0.0001,0.01,0.768,3282,3322
10,6704,10,100,0.0001,0.01,0.776,3328,3376
10,6804,10,100,0.0001,0.01,0.784,3377,3427
10,6904,10,100,0.0001,0.01,0.77,3420,3484
10,7004,10,100,0.0001,0.01,0.778,3466,3538
10,7104,10,100,0.0001,0.01,0.808,3518,3586
10,7204,10,100,0.0001,0.01,0.814,3565,3639
10,7304,10,100,0.0001,0.01,0.81,3616,3688
10,7404,10,100,0.0001,0.01,0.804,3667,3737
10,7504,10,100,0.0001,0.01,0.808,3721,3783
10,7604,10,100,0.0001,0.01,0.82,3782,3822
10,7704,10,100,0.0001,0.01,0.824,3839,3865
10,7804,10,100,0.0001,0.01,0.838,3890,3914
10,7904,10,100,0.0001,0.01,0.848,3944,3960
10,8004,10,100,0.0001,0.01,0.876,3994,4010
10,8104,10,100,0.0001,0.01,0.866,4051,4053
10,8204,10,100,0.0001,0.01,0.914,4105,4099
10,8304,10,100,0.0001,0.01,0.89,4157,4147
10,8404,10,100,0.0001,0.01,0.892,4208,4196
10,8504,10,100,0.0001,0.01,0.89,4268,4236
10,8604,10,100,0.0001,0.01,0.908,4320,4284
10,8704,10,100,0.0001,0.01,0.894,4373,4331
10,8804,10,100,0.0001,0.01,0.89,4418,4386
10,8904,10,100,0.0001,0.01,0.912,4467,4437
10,9004,10,100,0.0001,0.01,0.896,4509,4495
10,9104,10,100,0.0001,0.01,0.918,4570,4534
10,9204,10,100,0.0001,0.01,0.934,4632,4572
10,9304,10,100,0.0001,0.01,0.946,4691,4613
10,9404,10,100,0.0001,0.01,0.928,4747,4657
10,9504,10,100,0.0001,0.01,0.938,4798,4706
10,9604,10,100,0.0001,0.01,0.946,4852,4752
10,9704,10,100,0.0001,0.01,0.944,4901,4803
10,9804,10,100,0.0001,0.01,0.934,4956,4848
10,9904,10,100,0.0001,0.01,0.934,4997,4907
10,10004,10,100,0.0001,0.01,0.948,5045,4959
10,10104,10,100,0.0001,0.01,0.946,5095,5009
10,10204,10,100,0.0001,0.01,0.966,5149,5055
10,10304,10,100,0.0001,0.01,0.958,5198,5106
10,10404,10,100,0.0001,0.01,0.954,5257,5147
10,10504,10,100,0.0001,0.01,0.958,5306,5198
10,10604,10,100,0.0001,0.01,0.952,5354,5250
10,10704,10,100,0.0001,0.01,0.962,5416,5288
10,10804,10,100,0.0001,0.01,0.942,5465,5339
10,10904,10,100,0.0001,0.01,0.954,5505,5399
10,11004,10,100,0.0001,0.01,0.96,5559,5445
10,11104,10,100,0.0001,0.01,0.952,5600,5504
10,11204,10,100,0.0001,0.01,0.946,5651,5553
10,11304,10,100,0.0001,0.01,0.964,5699,5605
10,11404,10,100,0.0001,0.01,0.972,5752,5652
10,11504,10,100,0.0001,0.01,0.972,5804,5700
10,11604,10,100,0.0001,0.01,0.948,5852,5752
10,11704,10,100,0.0001,0.01,0.926,5901,5803
10,11804,10,100,0.0001,0.01,0.97,5941,5863
10,11904,10,100,0.0001,0.01,0.974,5995,5909
10,12004,10,100,0.0001,0.01,0.978,6042,5962
10,12104,10,100,0.0001,0.01,0.982,6092,6012
10,12204,10,100,0.0001,0.01,0.986,6139,6065
10,12304,10,100,0.0001,0.01,0.988,6188,6116
10,12404,10,100,0.0001,0.01,0.984,6234,6170
10,12504,10,100,0.0001,0.01,0.982,6276,6228
10,12604,10,100,0.0001,0.01,0.976,6326,6278
10,12704,10,100,0.0001,0.01,0.974,6368,6336
10,12804,10,100,0.0001,0.01,0.98,6419,6385
10,12904,10,100,0.0001,0.01,0.978,6469,6435
10,13004,10,100,0.0001,0.01,0.982,6515,6489
10,13104,10,100,0.0001,0.01,0.988,6555,6549
10,13204,10,100,0.0001,0.01,0.984,6606,6598
10,13304,10,100,0.0001,0.01,0.974,6651,6653
10,13404,10,100,0.0001,0.01,0.97,6704,6700
10,13504,10,100,0.0001,0.01,0.974,6752,6752
10,13604,10,100,0.0001,0.01,0.976,6800,6804
10,13704,10,100,0.0001,0.01,0.986,6844,6860
10,13804,10,100,0.0001,0.01,0.982,6892,6912
10,13904,10,100,0.0001,0.01,0.988,6944,6960
10,14004,10,100,0.0001,0.01,0.988,6994,7010
10,14104,10,100,0.0001,0.01,0.988,7047,7057
10,14204,10,100,0.0001,0.01,0.988,7100,7104
10,14304,10,100,0.0001,0.01,0.988,7152,7152
10,14404,10,100,0.0001,0.01,0.988,7208,7196
10,14504,10,100,0.0001,0.01,0.988,7264,7240
10,14604,10,100,0.0001,0.01,0.974,7315,7289
10,14704,10,100,0.0001,0.01,0.976,7362,7342
10,14804,10,100,0.0001,0.01,0.964,7412,7392
10,14904,10,100,0.0001,0.01,0.986,7463,7441
10,15004,10,100,0.0001,0.01,0.982,7509,7495
11,104,10,100,0.0001,0.01,0.478,53,51
11,204,10,100,0.0001,0.01,0.52,106,98
11,304,10,100,0.0001,0.01,0.498,153,151
11,404,10,100,0.0001,0.01,0.466,208,196
11,504,10,100,0.0001,0.01,0.474,251,253
11,604,10,100,0.0001,0.01,0.482,309,295
11,704,10,100,0.0001,0.01,0.486,358,346
11,804,10,100,0.0001,0.01,0.496,408,396
11,904,10,100,0.0001,0.01,0.466,456,448
11,1004,10,100,0.0001,0.01,0.466,508,496
11,1104,10,100,0.0001,0.01,0.508,550,554
11,1204,10,100,0.0001,0.01,0.484,598,606
11,1304,10,100,0.0001,0.01,0.486,647,657
11,1404,10,100,0.0001,0.01,0.506,693,711
11,1504,10,100,0.0001,0.01,0.482,752,752
11,1604,10,100,0.0001,0.01,0.514,802,802
11,1704,10,100,0.0001,0.01,0.508,847,857
11,1804,10,100,0.0001,0.01,0.498,901,903
11,1904,10,100,0.0001,0.01,0.554,949,955
11,2004,10,100,0.0001,0.01,0.514,995,1009
11,2104,10,100,0.0001,0.01,0.538,1048,1056
11,2204,10,100,0.0001,0.01,0.534,1096,1108
11,2304,10,100,0.0001,0.01,0.574,1144,1160
11,2404,10,100,0.0001,0.01,0.576,1200,1204
11,2504,10,100,0.0001,0.01,0.57,1246,1258
11,2604,10,100,0.0001,0.01,0.62,1299,1305
11,2704,10,100,0.0001,0.01,0.666,1350,1354
11,2804,10,100,0.0001,0.01,0.624,1400,1404
11,2904,10,100,0.0001,0.01,0.662,1456,1448
11,3004,10,100,0.0001,0.01,0.686,1499,1505
11,3104,10,100,0.0001,0.01,0.636,1543,1561
11,3204,10,100,0.0001,0.01,0.716,1589,1615
11,3304,10,100,0.0001,0.01,0.708,1647,1657
11,3404,10,100,0.0001,0.01,0.706,1699,1705
11,3504,10,100,0.0001,0.01,0.762,1748,1756
11,3604,10,100,0.0001,0.01,0.76,1792,1812
11,3704,10,100,0.0001,0.01,0.776,1840,1864
11,3804,10,100,0.0001,0.01,0.784,1883,1921
11,3904,10,100,0.0001,0.01,0.752,1934,1970
11,4004,10,100,0.0001,0.01,0.768,1990,2014
11,4104,10,100,0.0001,0.01,0.784,2041,2063
11,4204,10,100,0.0001,0.01,0.792,2095,2109
11,4304,10,100,0.0001,0.01,0.806,2148,2156
11,4404,10,100,0.0001,0.01,0.796,2198,2206
11,4504,10,100,0.0001,0.01,0.828,2254,2250
11,4604,10,100,0.0001,0.01,0.848,2304,2300
11,4704,10,100,0.0001,0.01,0.848,2346,2358
11,4804,10,100,0.0001,0.01,0.872,2404,2400
11,4904,10,100,0.0001,0.01,0.83,2455,2449
11,5004,10,100,0.0001,0.01,0.824,2514,2490
11,5104,10,100,0.0001,0.01,0.85,2562,2542
11,5204,10,100,0.0001,0.01,0.864,2617,2587
11,5304,10,100,0.0001,0.01,0.868,2662,2642
11,5404,10,100,0.0001,0.01,0.85,2712,2692
11,5504,10,100,0.0001,0.01,0.868,2758,2746
11,5604,10,100,0.0001,0.01,0.884,2803,2801
11,5704,10,100,0.0001,0.01,0.878,2858,2846
11,5804,10,100,0.0001,0.01,0.894,2903,2901
11,5904,10,100,0.0001,0.01,0.894,2947,2957
11,6004,10,100,0.0001,0.01,0.874,3007,2997
11,6104,10,100,0.0001,0.01,0.884,3058,3046
11,6204,10,100,0.0001,0.01,0.892,3101,3103
11,6304,10,100,0.0001,0.01,0.906,3156,3148
11,6404,10,100,0.0001,0.01,0.91,3201,3203
11,6504,10,100,0.0001,0.01,0.91,3244,3260
11,6604,10,100,0.0001,0.01,0.916,3294,3310
11,6704,10,100,0.0001,0.01,0.91,3346,3358
11,6804,10,100,0.0001,0.01,0.864,3403,3401
11,6904,10,100,0.0001,0.01,0.902,3456,3448
11,7004,10,100,0.0001,0.01,0.894,3515,3489
11,7104,10,100,0.0001,0.01,0.904,3567,3537
11,7204,10,100,0.0001,0.01,0.894,3618,3586
11,7304,10,100,0.0001,0.01,0.92,3674,3630
11,7404,10,100,0.0001,0.01,0.92,3721,3683
11,7504,10,100,0.0001,0.01,0.94,3768,3736
11,7604,10,100,0.0001,0.01,0.926,3816,3788
11,7704,10,100,0.0001,0.01,0.93,3866,3838
11,7804,10,100,0.0001,0.01,0.932,3916,3888
11,7904,10,100,0.0001,0.01,0.882,3961,3943
11,8004,10,100,0.0001,0.01,0.92,4013,3991
11,8104,10,100,0.0001,0.01,0.92,4059,4045
11,8204,10,100,0.0001,0.01,0.912,4111,4093
11,8304,10,100,0.0001,0.01,0.942,4155,4149
11,8404,10,100,0.0001,0.01,0.922,4206,4198
11,8504,10,100,0.0001,0.01,0.918,4255,4249
11,8604,10,100,0.0001,0.01,0.932,4309,4295
11,8704,10,100,0.0001,0.01,0.942,4363,4341
11,8804,10,100,0.0001,0.01,0.94,4407,4397
11,8904,10,100,0.0001,0.01,0.938,4444,4460
11,9004,10,100,0.0001,0.01,0.948,4495,4509
11,9104,10,100,0.0001,0.01,0.94,4537,4567
11,9204,10,100,0.0001,0.01,0.936,4586,4618
11,9304,10,100,0.0001,0.01,0.95,4633,4671
11,9404,10,100,0.0001,0.01,0.948,4679,4725
11,9504,10,100,0.0001,0.01,0.952,4728,4776
11,9604,10,100,0.0001,0.01,0.946,4780,4824
11,9704,10,100,0.0001,0.01,0.964,4829,4875
11,9804,10,100,0.0001,0.01,0.962,4872,4932
11,9904,10,100,0.0001,0.01,0.948,4925,4979
11,10004,10,100,0.0001,0.01,0.954,4978,5026
11,10104,10,100,0.0001,0.01,0.958,5018,5086
11,10204,10,100,0.0001,0.01,0.962,5061,5143
11,10304,10,100,0.0001,0.01,0.964,5116,5188
11,10404,10,100,0.0001,0.01,0.952,5174,5230
11,10504,10,100,0.0001,0.01,0.954,5226,5278
11,10604,10,100,0.0001,0.01,0.968,5277,5327
11,10704,10,100,0.0001,0.01,0.964,5331,5373
11,10804,10,100,0.0001,0.01,0.96,5384,5420
11,10904,10,100,0.0001,0.01,0.956,5430,5474
11,11004,10,100,0.0001,0.01,0.966,5468,5536
11,11104,10,100,0.0001,0.01,0.976,5526,5578
11,11204,10,100,0.0001,0.01,0.966,5578,5626
11,11304,10,100,0.0001,0.01,0.982,5630,5674
11,11404,10,100,0.0001,0.01,0.962,5669,5735
11,11504,10,100,0.0001,0.01,0.97,5718,5786
11,11604,10,100,0.0001,0.01,0.94,5761,5843
11,11704,10,100,0.0001,0.01,0.942,5812,5892
11,11804,10,100,0.0001,0.01,0.962,5866,5938
11,11904,10,100,0.0001,0.01,0.962,5917,5987
11,12004,10,100,0.0001,0.01,0.974,5965,6039
11,12104,10,100,0.0001,0.01,0.976,6022,6082
11,12204,10,100,0.0001,0.01,0.984,6071,6133
11,12304,10,100,0.0001,0.01,0.98,6131,6173
11,12404,10,100,0.0001,0.01,0.976,6180,6224
11,12504,10,100,0.0001,0.01,0.976,6229,6275
11,12604,10,100,0.0001,0.01,0.972,6283,6321
11,12704,10,100,0.0001,0.01,0.962,6335,6369
11,12804,10,100,0.0001,0.01,0.966,6387,6417
11,12904,10,100,0.0001,0.01,0.976,6444,6460
11,13004,10,100,0.0001,0.01,0.972,6492,6512
11,13104,10,100,0.0001,0.01,0.97,6538,6566
11,13204,10,100,0.0001,0.01,0.982,6590,6614
11,13304,10,100,0.0001,0.01,0.98,6645,6659
11,13404,10,100,0.0001,0.01,0.978,6701,6703
11,13504,10,100,0.0001,0.01,0.976,6744,6760
11,13604,10,100,0.0001,0.01,0.982,6804,6800
11,13704,10,100,0.0001,0.01,0.98,6859,6845
11,13804,10,100,0.0001,0.01,0.968,6913,6891
11,13904,10,100,0.0001,0.01,0.958,6960,6944
11,14004,10,100,0.0001,0.01,0.974,7012,6992
11,14104,10,100,0.0001,0.01,0.982,7055,7049
11,14204,10,100,0.0001,0.01,0.984,7100,7104
11,14304,10,100,0.0001,0.01,0.982,7148,7156
11,14404,10,100,0.0001,0.01,0.982,7195,7209
11,14504,10,100,0.0001,0.01,0.984,7244,7260
11,14604,10,100,0.0001,0.01,0.978,7299,7305
11,14704,10,100,0.0001,0.01,0.976,7350,7354
11,14804,10,100,0.0001,0.01,0.982,7401,7403
11,14904,10,100,0.0001,0.01,0.984,7453,7451
11,15004,10,100,0.0001,0.01,0.976,7513,7491
12,104,10,100,0.0001,0.01,0.488,47,57
12,204,10,100,0.0001,0.01,0.512,96,108
12,304,10,100,0.0001,0.01,0.488,140,164
12,404,10,100,0.0001,0.01,0.51,188,216
12,504,10,100,0.0001,0.01,0.51,236,268
12,604,10,100,0.0001,0.01,0.532,286,318
12,704,10,100,0.0001,0.01,0.512,331,373
12,804,10,100,0.0001,0.01,0.532,377,427
12,904,10,100,0.0001,0.01,0.538,428,476
12,1004,10,100,0.0001,0.01,0.548,484,520
12,1104,10,100,0.0001,0.01,0.53,541,563
12,1204,10,100,0.0001,0.01,0.502,595,609
12,1304,10,100,0.0001,0.01,0.546,648,656
12,1404,10,100,0.0001,0.01,0.514,697,707
12,1504,10,100,0.0001,0.01,0.534,725,779
12,1604,10,100,0.0001,0.01,0.522,775,829
12,1704,10,100,0.0001,0.01,0.554,820,884
12,1804,10,100,0.0001,0.01,0.542,868,936
12,1904,10,100,0.0001,0.01,0.556,922,982
12,2004,10,100,0.0001,0.01,0.56,971,1033
12,2104,10,100,0.0001,0.01,0.57,1023,1081
12,2204,10,100,0.0001,0.01,0.596,1078,1126
12,2304,10,100,0.0001,0.01,0.592,1119,1185
12,2404,10,100,0.0001,0.01,0.626,1168,1236
12,2504,10,100,0.0001,0.01,0.644,1231,1273
12,2604,10,100,0.0001,0.01,0.686,1283,1321
12,2704,10,100,0.0001,0.01,0.676,1331,1373
12,2804,10,100,0.0001,0.01,0.71,1380,1424
12,2904,10,100,0.0001,0.01,0.714,1438,1466
12,3004,10,100,0.0001,0.01,0.788,1487,1517
12,3104,10,100,0.0001,0.01,0.732,1536,1568
12,3204,10,100,0.0001,0.01,0.792,1586,1618
12,3304,10,100,0.0001,0.01,0.804,1635,1669
12,3404,10,100,0.0001,0.01,0.816,1681,1723
12,3504,10,100,0.0001,0.01,0.848,1722,1782
12,3604,10,100,0.0001,0.01,0.86,1780,1824
12,3704,10,100,0.0001,0.01,0.854,1840,1864
12,3804,10,100,0.0001,0.01,0.868,1894,1910
12,3904,10,100,0.0001,0.01,0.864,1949,1955
12,4004,10,100,0.0001,0.01,0.886,2000,2004
12,4104,10,100,0.0001,0.01,0.872,2050,2054
12,4204,10,100,0.0001,0.01,0.844,2103,2101
12,4304,10,100,0.0001,0.01,0.908,2151,2153
12,4404,10,100,0.0001,0.01,0.882,2202,2202
12,4504,10,100,0.0001,0.01,0.892,2254,2250
12,4604,10,100,0.0001,0.01,0.888,2306,2298
12,4704,10,100,0.0001,0.01,0.912,2357,2347
12,4804,10,100,0.0001,0.01,0.904,2399,2405
12,4904,10,100,0.0001,0.01,0.914,2444,2460
12,5004,10,100,0.0001,0.01,0.914,2494,2510
12,5104,10,100,0.0001,0.01,0.924,2557,2547
12,5204,10,100,0.0001,0.01,0.914,2607,2597
12,5304,10,100,0.0001,0.01,0.888,2660,2644
12,5404,10,100,0.0001,0.01,0.9,2705,2699
12,5504,10,100,0.0001,0.01,0.92,2760,2744
12,5604,10,100,0.0001,0.01,0.932,2803,2801
12,5704,10,100,0.0001,0.01,0.942,2862,2842
12,5804,10,100,0.0001,0.01,0.938,2913,2891
12,5904,10,100,0.0001,0.01,0.934,2967,2937
12,6004,10,100,0.0001,0.01,0.938,3017,2987
12,6104,10,100,0.0001,0.01,0.95,3062,3042
12,6204,10,100,0.0001,0.01,0.938,3114,3090
12,6304,10,100,0.0001,0.01,0.912,3160,3144
12,6404,10,100,0.0001,0.01,0.926,3214,3190
12,6504,10,100,0.0001,0.01,0.948,3261,3243
12,6604,10,100,0.0001,0.01,0.956,3313,3291
12,6704,10,100,0.0001,0.01,0.948,3358,3346
12,6804,10,100,0.0001,0.01,0.956,3402,3402
12,6904,10,100,0.0001,0.01,0.96,3451,3453
12,7004,10,100,0.0001,0.01,0.966,3501,3503
12,7104,10,100,0.0001,0.01,0.954,3551,3553
12,7204,10,100,0.0001,0.01,0.952,3605,3599
12,7304,10,100,0.0001,0.01,0.954,3652,3652
12,7404,10,100,0.0001,0.01,0.958,3695,3709
12,7504,10,100,0.0001,0.01,0.954,3741,3763
12,7604,10,100,0.0001,0.01,0.942,3793,3811
12,7704,10,100,0.0001,0.01,0.944,3841,3863
12,7804,10,100,0.0001,0.01,0.948,3891,3913
12,7904,10,100,0.0001,0.01,0.964,3935,3969
12,8004,10,100,0.0001,0.01,0.954,3986,4018
12,8104,10,100,0.0001,0.01,0.95,4037,4067
12,8204,10,100,0.0001,0.01,0.964,4088,4116
12,8304,10,100,0.0001,0.01,0.966,4137,4167
12,8404,10,100,0.0001,0.01,0.958,4188,4216
12,8504,10,100,0.0001,0.01,0.962,4243,4261
12,8604,10,100,0.0001,0.01,0.962,4292,4312
12,8704,10,100,0.0001,0.01,0.958,4333,4371
12,8804,10,100,0.0001,0.01,0.958,4389,4415
12,8904,10,100,0.0001,0.01,0.962,4446,4458
12,9004,10,100,0.0001,0.01,0.968,4500,4504
12,9104,10,100,0.0001,0.01,0.954,4561,4543
12,9204,10,100,0.0001,0.01,0.96,4612,4592
12,9304,10,100,0.0001,0.01,0.97,4659,4645
12,9404,10,100,0.0001,0.01,0.966,4705,4699
12,9504,10,100,0.0001,0.01,0.974,4757,4747
12,9604,10,100,0.0001,0.01,0.934,4810,4794
12,9704,10,100,0.0001,0.01,0.962,4864,4840
12,9804,10,100,0.0001,0.01,0.964,4912,4892
12,9904,10,100,0.0001,0.01,0.972,4960,4944
12,10004,10,100,0.0001,0.01,0.976,5008,4996
12,10104,10,100,0.0001,0.01,0.978,5060,5044
12,10204,10,100,0.0001,0.01,0.972,5113,5091
12,10304,10,100,0.0001,0.01,0.972,5167,5137
12,10404,10,100,0.0001,0.01,0.978,5227,5177
12,10504,10,100,0.0001,0.01,0.978,5284,5220
12,10604,10,100,0.0001,0.01,0.982,5340,5264
12,10704,10,100,0.0001,0.01,0.972,5388,5316
12,10804,10,100,0.0001,0.01,0.968,5446,5358
12,10904,10,100,0.0001,0.01,0.972,5489,5415
12,11004,10,100,0.0001,0.01,0.962,5541,5463
12,11104,10,100,0.0001,0.01,0.972,5595,5509
12,11204,10,100,0.0001,0.01,0.978,5639,5565
12,11304,10,100,0.0001,0.01,0.972,5697,5607
12,11404,10,100,0.0001,0.01,0.986,5749,5655
12,11504,10,100,0.0001,0.01,0.98,5789,5715
12,11604,10,100,0.0001,0.01,0.984,5840,5764
12,11704,10,100,0.0001,0.01,0.98,5884,5820
12,11804,10,100,0.0001,0.01,0.984,5932,5872
12,11904,10,100,0.0001,0.01,0.984,5990,5914
12,12004,10,100,0.0001,0.01,0.968,6028,5976
12,12104,10,100,0.0001,0.01,0.974,6074,6030
12,12204,10,100,0.0001,0.01,0.972,6128,6076
12,12304,10,100,0.0001,0.01,0.98,6178,6126
12,12404,10,100,0.0001,0.01,0.98,6222,6182
12,12504,10,100,0.0001,0.01,0.986,6269,6235
12,12604,10,100,0.0001,0.01,0.978,6320,6284
12,12704,10,100,0.0001,0.01,0.988,6365,6339
12,12804,10,100,0.0001,0.01,0.994,6414,6390
12,12904,10,100,0.0001,0.01,0.99,6469,6435
12,13004,10,100,0.0001,0.01,0.98,6519,6485
12,13104,10,100,0.0001,0.01,0.978,6574,6530
12,13204,10,100,0.0001,0.01,0.986,6629,6575
12,13304,10,100,0.0001,0.01,0.976,6677,6627
12,13404,10,100,0.0001,0.01,0.974,6723,6681
12,13504,10,100,0.0001,0.01,0.974,6774,6730
12,13604,10,100,0.0001,0.01,0.988,6826,6778
12,13704,10,100,0.0001,0.01,0.99,6876,6828
12,13804,10,100,0.0001,0.01,0.992,6927,6877
12,13904,10,100,0.0001,0.01,0.99,6980,6924
12,14004,10,100,0.0001,0.01,0.99,7026,6978
12,14104,10,100,0.0001,0.01,0.988,7078,7026
12,14204,10,100,0.0001,0.01,0.988,7133,7071
12,14304,10,100,0.0001,0.01,0.988,7173,7131
12,14404,10,100,0.0001,0.01,0.99,7220,7184
12,14504,10,100,0.0001,0.01,0.992,7270,7234
12,14604,10,100,0.0001,0.01,0.992,7320,7284
12,14704,10,100,0.0001,0.01,0.978,7380,7324
12,14804,10,100,0.0001,0.01,0.982,7429,7375
12,14904,10,100,0.0001,0.01,0.988,7474,7430
12,15004,10,100,0.0001,0.01,0.992,7523,7481
13,104,10,100,0.0001,0.01,0.484,58,46
13,204,10,100,0.0001,0.01,0.502,115,89
13,304,10,100,0.0001,0.01,0.494,157,147
13,404,10,100,0.0001,0.01,0.516,210,194
13,504,10,100,0.0001,0.01,0.512,254,250
13,604,10,100,0.0001,0.01,0.51,299,305
13,704,10,100,0.0001,0.01,0.502,352,352
13,804,10,100,0.0001,0.01,0.532,398,406
13,904,10,100,0.0001,0.01,0.52,447,457
13,1004,10,100,0.0001,0.01,0.514,494,510
13,1104,10,100,0.0001,0.01,0.504,537,567
13,1204,10,100,0.0001,0.01,0.48,597,607
13,1304,10,100,0.0001,0.01,0.476,644,660
13,1404,10,100,0.0001,0.01,0.482,689,715
13,1504,10,100,0.0001,0.01,0.478,742,762
13,1604,10,100,0.0001,0.01,0.488,791,813
13,1704,10,100,0.0001,0.01,0.47,843,861
13,1804,10,100,0.0001,0.01,0.49,895,909
13,1904,10,100,0.0001,0.01,0.476,946,958
13,2004,10,100,0.0001,0.01,0.508,996,1008
13,2104,10,100,0.0001,0.01,0.506,1053,1051
13,2204,10,100,0.0001,0.01,0.508,1102,1102
13,2304,10,100,0.0001,0.01,0.532,1144,1160
13,2404,10,100,0.0001,0.01,0.522,1196,1208
13,2504,10,100,0.0001,0.01,0.576,1255,1249
13,2604,10,100,0.0001,0.01,0.6,1303,1301
13,2704,10,100,0.0001,0.01,0.634,1354,1350
13,2804,10,100,0.0001,0.01,0.682,1407,1397
13,2904,10,100,0.0001,0.01,0.682,1457,1447
13,3004,10,100,0.0001,0.01,0.73,1500,1504
13,3104,10,100,0.0001,0.01,0.754,1550,1554
13,3204,10,100,0.0001,0.01,0.764,1597,1607
13,3304,10,100,0.0001,0.01,0.78,1642,1662
13,3404,10,100,0.0001,0.01,0.82,1693,1711
13,3504,10,100,0.0001,0.01,0.828,1743,1761
13,3604,10,100,0.0001,0.01,0.838,1795,1809
13,3704,10,100,0.0001,0.01,0.814,1845,1859
13,3804,10,100,0.0001,0.01,0.852,1890,1914
13,3904,10,100,0.0001,0.01,0.858,1937,1967
13,4004,10,100,0.0001,0.01,0.872,1992,2012
13,4104,10,100,0.0001,0.01,0.868,2037,2067
13,4204,10,100,0.0001,0.01,0.888,2088,2116
13,4304,10,100,0.0001,0.01,0.894,2136,2168
13,4404,10,100,0.0001,0.01,0.898,2192,2212
13,4504,10,100,0.0001,0.01,0.91,2241,2263
13,4604,10,100,0.0001,0.01,0.898,2289,2315
13,4704,10,100,0.0001,0.01,0.894,2341,2363
13,4804,10,100,0.0001,0.01,0.886,2392,2412
13,4904,10,100,0.0001,0.01,0.906,2450,2454
13,5004,10,100,0.0001,0.01,0.904,2501,2503
13,5104,10,100,0.0001,0.01,0.914,2548,2556
13,5204,10,100,0.0001,0.01,0.906,2594,2610
13,5304,10,100,0.0001,0.01,0.916,2638,2666
13,5404,10,100,0.0001,0.01,0.914,2690,2714
13,5504,10,100,0.0001,0.01,0.916,2740,2764
13,5604,10,100,0.0001,0.01,0.92,2782,2822
13,5704,10,100,0.0001,0.01,0.926,2829,2875
13,5804,10,100,0.0001,0.01,0.924,2875,2929
13,5904,10,100,0.0001,0.01,0.924,2919,2985
13,6004,10,100,0.0001,0.01,0.932,2974,3030
13,6104,10,100,0.0001,0.01,0.916,3012,3092
13,6204,10,100,0.0001,0.01,0.936,3055,3149
13,6304,10,100,0.0001,0.01,0.916,3099,3205
13,6404,10,100,0.0001,0.01,0.93,3150,3254
13,6504,10,100,0.0001,0.01,0.922,3207,3297
13,6604,10,100,0.0001,0.01,0.924,3262,3342
13,6704,10,100,0.0001,0.01,0.94,3311,3393
13,6804,10,100,0.0001,0.01,0.948,3361,3443
13,6904,10,100,0.0001,0.01,0.938,3415,3489
13,7004,10,100,0.0001,0.01,0.938,3469,3535
13,7104,10,100,0.0001,0.01,0.946,3515,3589
13,7204,10,100,0.0001,0.01,0.952,3561,3643
13,7304,10,100,0.0001,0.01,0.954,3607,3697
13,7404,10,100,0.0001,0.01,0.95,3651,3753
13,7504,10,100,0.0001,0.01,0.956,3698,3806
13,7604,10,100,0.0001,0.01,0.96,3742,3862
13,7704,10,100,0.0001,0.01,0.956,3792,3912
13,7804,10,100,0.0001,0.01,0.942,3839,3965
13,7904,10,100,0.0001,0.01,0.95,3894,4010
13,8004,10,100,0.0001,0.01,0.956,3944,4060
13,8104,10,100,0.0001,0.01,0.932,3997,4107
13,8204,10,100,0.0001,0.01,0.918,4053,4151
13,8304,10,100,0.0001,0.01,0.934,4095,4209
13,8404,10,100,0.0001,0.01,0.96,4145,4259
13,8504,10,100,0.0001,0.01,0.956,4202,4302
13,8604,10,100,0.0001,0.01,0.958,4251,4353
13,8704,10,100,0.0001,0.01,0.962,4306,4398
13,8804,10,100,0.0001,0.01,0.96,4351,4453
13,8904,10,100,0.0001,0.01,0.958,4398,4506
13,9004,10,100,0.0001,0.01,0.96,4445,4559
13,9104,10,100,0.0001,0.01,0.962,4492,4612
13,9204,10,100,0.0001,0.01,0.972,4540,4664
13,9304,10,100,0.0001,0.01,0.958,4591,4713
13,9404,10,100,0.0001,0.01,0.958,4636,4768
13,9504,10,100,0.0001,0.01,0.964,4674,4830
13,9604,10,100,0.0001,0.01,0.96,4722,4882
13,9704,10,100,0.0001,0.01,0.932,4762,4942
13,9804,10,100,0.0001,0.01,0.956,4806,4998
13,9904,10,100,0.0001,0.01,0.964,4859,5045
13,10004,10,100,0.0001,0.01,0.962,4906,5098
13,10104,10,100,0.0001,0.01,0.97,4958,5146
13,10204,10,100,0.0001,0.01,0.968,5002,5202
13,10304,10,100,0.0001,0.01,0.974,5059,5245
13,10404,10,100,0.0001,0.01,0.98,5107,5297
13,10504,10,100,0.0001,0.01,0.978,5159,5345
13,10604,10,100,0.0001,0.01,0.976,5212,5392
13,10704,10,100,0.0001,0.01,0.976,5275,5429
13,10804,10,100,0.0001,0.01,0.978,5319,5485
13,10904,10,100,0.0001,0.01,0.978,5374,5530
13,11004,10,100,0.0001,0.01,0.978,5431,5573
13,11104,10,100,0.0001,0.01,0.976,5478,5626
13,11204,10,100,0.0001,0.01,0.978,5532,5672
13,11304,10,100,0.0001,0.01,0.976,5584,5720
13,11404,10,100,0.0001,0.01,0.98,5637,5767
13,11504,10,100,0.0001,0.01,0.964,5694,5810
13,11604,10,100,0.0001,0.01,0.966,5741,5863
13,11704,10,100,0.0001,0.01,0.95,5793,5911
13,11804,10,100,0.0001,0.01,0.98,5838,5966
13,11904,10,100,0.0001,0.01,0.974,5893,6011
13,12004,10,100,0.0001,0.01,0.984,5948,6056
13,12104,10,100,0.0001,0.01,0.986,5999,6105
13,12204,10,100,0.0001,0.01,0.984,6059,6145
13,12304,10,100,0.0001,0.01,0.984,6116,6188
13,12404,10,100,0.0001,0.01,0.984,6174,6230
13,12504,10,100,0.0001,0.01,0.986,6216,6288
13,12604,10,100,0.0001,0.01,0.984,6265,6339
13,12704,10,100,0.0001,0.01,0.982,6318,6386
13,12804,10,100,0.0001,0.01,0.982,6368,6436
13,12904,10,100,0.0001,0.01,0.974,6419,6485
13,13004,10,100,0.0001,0.01,0.978,6467,6537
13,13104,10,100,0.0001,0.01,0.978,6518,6586
13,13204,10,100,0.0001,0.01,0.984,6575,6629
13,13304,10,100,0.0001,0.01,0.984,6620,6684
13,13404,10,100,0.0001,0.01,0.986,6672,6732
13,13504,10,100,0.0001,0.01,0.986,6734,6770
13,13604,10,100,0.0001,0.01,0.992,6777,6827
13,13704,10,100,0.0001,0.01,0.982,6827,6877
13,13804,10,100,0.0001,0.01,0.988,6882,6922
13,13904,10,100,0.0001,0.01,0.996,6930,6974
13,14004,10,100,0.0001,0.01,0.986,6986,7018
13,14104,10,100,0.0001,0.01,0.976,7036,7068
13,14204,10,100,0.0001,0.01,0.988,7085,7119
13,14304,10,100,0.0001,0.01,0.992,7131,7173
13,14404,10,100,0.0001,0.01,0.994,7186,7218
13,14504,10,100,0.0001,0.01,0.994,7242,7262
13,14604,10,100,0.0001,0.01,0.992,7290,7314
13,14704,10,100,0.0001,0.01,0.99,7344,7360
13,14804,10,100,0.0001,0.01,0.994,7396,7408
13,14904,10,100,0.0001,0.01,0.992,7445,7459
13,15004,10,100,0.0001,0.01,0.98,7499,7505
14,104,10,100,0.0001,0.01,0.47,55,49
14,204,10,100,0.0001,0.01,0.488,113,91
14,304,10,100,0.0001,0.01,0.482,154,150
14,404,10,100,0.0001,0.01,0.52,204,200
14,504,10,100,0.0001,0.01,0.486,253,251
14,604,10,100,0.0001,0.01,0.472,296,308
14,704,10,100,0.0001,0.01,0.502,349,355
14,804,10,100,0.0001,0.01,0.524,393,411
14,904,10,100,0.0001,0.01,0.524,444,460
14,1004,10,100,0.0001,0.01,0.526,493,511
14,1104,10,100,0.0001,0.01,0.498,542,562
14,1204,10,100,0.0001,0.01,0.516,597,607
14,1304,10,100,0.0001,0.01,0.528,653,651
14,1404,10,100,0.0001,0.01,0.522,698,706
14,1504,10,100,0.0001,0.01,0.51,747,757
14,1604,10,100,0.0001,0.01,0.546,802,802
14,1704,10,100,0.0001,0.01,0.508,849,855
14,1804,10,100,0.0001,0.01,0.498,899,905
14,1904,10,100,0.0001,0.01,0.53,947,957
14,2004,10,100,0.0001,0.01,0.556,1002,1002
14,2104,10,100,0.0001,0.01,0.566,1060,1044
14,2204,10,100,0.0001,0.01,0.558,1105,1099
14,2304,10,100,0.0001,0.01,0.546,1150,1154
14,2404,10,100,0.0001,0.01,0.576,1202,1202
14,2504,10,100,0.0001,0.01,0.582,1244,1260
14,2604,10,100,0.0001,0.01,0.572,1290,1314
14,2704,10,100,0.0001,0.01,0.59,1345,1359
14,2804,10,100,0.0001,0.01,0.598,1393,1411
14,2904,10,100,0.0001,0.01,0.562,1442,1462
14,3004,10,100,0.0001,0.01,0.57,1495,1509
14,3104,10,100,0.0001,0.01,0.598,1543,1561
14,3204,10,100,0.0001,0.01,0.59,1591,1613
14,3304,10,100,0.0001,0.01,0.64,1643,1661
14,3404,10,100,0.0001,0.01,0.654,1690,1714
14,3504,10,100,0.0001,0.01,0.622,1739,1765
14,3604,10,100,0.0001,0.01,0.64,1789,1815
14,3704,10,100,0.0001,0.01,0.654,1839,1865
14,3804,10,100,0.0001,0.01,0.666,1896,1908
14,3904,10,100,0.0001,0.01,0.68,1944,1960
14,4004,10,100,0.0001,0.01,0.676,1984,2020
14,4104,10,100,0.0001,0.01,0.688,2030,2074
14,4204,10,100,0.0001,0.01,0.684,2078,2126
14,4304,10,100,0.0001,0.01,0.702,2122,2182
14,4404,10,100,0.0001,0.01,0.714,2168,2236
14,4504,10,100,0.0001,0.01,0.74,2224,2280
14,4604,10,100,0.0001,0.01,0.738,2277,2327
14,4704,10,100,0.0001,0.01,0.756,2324,2380
14,4804,10,100,0.0001,0.01,0.728,2370,2434
14,4904,10,100,0.0001,0.01,0.716,2428,2476
14,5004,10,100,0.0001,0.01,0.738,2481,2523
14,5104,10,100,0.0001,0.01,0.758,2538,2566
14,5204,10,100,0.0001,0.01,0.792,2599,2605
14,5304,10,100,0.0001,0.01,0.79,2651,2653
14,5404,10,100,0.0001,0.01,0.788,2703,2701
14,5504,10,100,0.0001,0.01,0.79,2754,2750
14,5604,10,100,0.0001,0.01,0.796,2801,2803
14,5704,10,100,0.0001,0.01,0.758,2854,2850
14,5804,10,100,0.0001,0.01,0.816,2905,2899
14,5904,10,100,0.0001,0.01,0.824,2962,2942
14,6004,10,100,0.0001,0.01,0.814,3009,2995
14,6104,10,100,0.0001,0.01,0.82,3054,3050
14,6204,10,100,0.0001,0.01,0.85,3106,3098
14,6304,10,100,0.0001,0.01,0.868,3151,3153
14,6404,10,100,0.0001,0.01,0.884,3208,3196
14,6504,10,100,0.0001,0.01,0.884,3262,3242
14,6604,10,100,0.0001,0.01,0.878,3299,3305
14,6704,10,100,0.0001,0.01,0.876,3354,3350
14,6804,10,100,0.0001,0.01,0.886,3405,3399
14,6904,10,100,0.0001,0.01,0.862,3458,3446
14,7004,10,100,0.0001,0.01,0.878,3518,3486
14,7104,10,100,0.0001,0.01,0.886,3567,3537
14,7204,10,100,0.0001,0.01,0.908,3607,3597
14,7304,10,100,0.0001,0.01,0.92,3656,3648
14,7404,10,100,0.0001,0.01,0.922,3704,3700
14,7504,10,100,0.0001,0.01,0.908,3756,3748
14,7604,10,100,0.0001,0.01,0.922,3811,3793
14,7704,10,100,0.0001,0.01,0.932,3868,3836
14,7804,10,100,0.0001,0.01,0.938,3915,3889
14,7904,10,100,0.0001,0.01,0.922,3959,3945
14,8004,10,100,0.0001,0.01,0.908,4013,3991
14,8104,10,100,0.0001,0.01,0.916,4052,4052
14,8204,10,100,0.0001,0.01,0.918,4100,4104
14,8304,10,100,0.0001,0.01,0.91,4153,4151
14,8404,10,100,0.0001,0.01,0.928,4206,4198
14,8504,10,100,0.0001,0.01,0.922,4253,4251
14,8604,10,100,0.0001,0.01,0.946,4296,4308
14,8704,10,100,0.0001,0.01,0.942,4345,4359
14,8804,10,100,0.0001,0.01,0.938,4398,4406
14,8904,10,100,0.0001,0.01,0.954,4446,4458
14,9004,10,100,0.0001,0.01,0.934,4489,4515
14,9104,10,100,0.0001,0.01,0.906,4543,4561
14,9204,10,100,0.0001,0.01,0.94,4598,4606
14,9304,10,100,0.0001,0.01,0.938,4643,4661
14,9404,10,100,0.0001,0.01,0.964,4691,4713
14,9504,10,100,0.0001,0.01,0.966,4741,4763
14,9604,10,100,0.0001,0.01,0.976,4782,4822
14,9704,10,100,0.0001,0.01,0.964,4831,4873
14,9804,10,100,0.0001,0.01,0.978,4886,4918
14,9904,10,100,0.0001,0.01,0.964,4935,4969
14,10004,10,100,0.0001,0.01,0.968,4980,5024
14,10104,10,100,0.0001,0.01,0.958,5034,5070
14,10204,10,100,0.0001,0.01,0.968,5082,5122
14,10304,10,100,0.0001,0.01,0.97,5136,5168
14,10404,10,100,0.0001,0.01,0.972,5190,5214
14,10504,10,100,0.0001,0.01,0.966,5240,5264
14,10604,10,100,0.0001,0.01,0.968,5283,5321
14,10704,10,100,0.0001,0.01,0.964,5333,5371
14,10804,10,100,0.0001,0.01,0.95,5386,5418
14,10904,10,100,0.0001,0.01,0.968,5440,5464
14,11004,10,100,0.0001,0.01,0.972,5491,5513
14,11104,10,100,0.0001,0.01,0.966,5535,5569
14,11204,10,100,0.0001,0.01,0.934,5590,5614
14,11304,10,100,0.0001,0.01,0.926,5644,5660
14,11404,10,100,0.0001,0.01,0.972,5690,5714
14,11504,10,100,0.0001,0.01,0.978,5744,5760
14,11604,10,100,0.0001,0.01,0.978,5790,5814
14,11704,10,100,0.0001,0.01,0.974,5839,5865
14,11804,10,100,0.0001,0.01,0.978,5897,5907
14,11904,10,100,0.0001,0.01,0.974,5947,5957
14,12004,10,100,0.0001,0.01,0.978,6006,5998
14,12104,10,100,0.0001,0.01,0.98,6062,6042
14,12204,10,100,0.0001,0.01,0.974,6120,6084
14,12304,10,100,0.0001,0.01,0.972,6173,6131
14,12404,10,100,0.0001,0.01,0.986,6229,6175
14,12504,10,100,0.0001,0.01,0.984,6285,6219
14,12604,10,100,0.0001,0.01,0.98,6340,6264
14,12704,10,100,0.0001,0.01,0.98,6385,6319
14,12804,10,100,0.0001,0.01,0.978,6432,6372
14,12904,10,100,0.0001,0.01,0.986,6473,6431
14,13004,10,100,0.0001,0.01,0.986,6526,6478
14,13104,10,100,0.0001,0.01,0.988,6584,6520
14,13204,10,100,0.0001,0.01,0.968,6637,6567
14,13304,10,100,0.0001,0.01,0.978,6682,6622
14,13404,10,100,0.0001,0.01,0.972,6741,6663
14,13504,10,100,0.0001,0.01,0.978,6794,6710
14,13604,10,100,0.0001,0.01,0.982,6839,6765
14,13704,10,100,0.0001,0.01,0.99,6884,6820
14,13804,10,100,0.0001,0.01,0.988,6932,6872
14,13904,10,100,0.0001,0.01,0.99,6972,6932
14,14004,10,100,0.0001,0.01,0.986,7019,6985
14,14104,10,100,0.0001,0.01,0.99,7057,7047
14,14204,10,100,0.0001,0.01,0.982,7118,7086
14,14304,10,100,0.0001,0.01,0.984,7165,7139
14,14404,10,100,0.0001,0.01,0.99,7218,7186
14,14504,10,100,0.0001,0.01,0.992,7269,7235
14,14604,10,100,0.0001,0.01,0.982,7320,7284
14,14704,10,100,0.0001,0.01,0.99,7370,7334
14,14804,10,100,0.0001,0.01,0.976,7423,7381
14,14904,10,100,0.0001,0.01,0.988,7468,7436
14,15004,10,100,0.0001,0.01,0.992,7516,7488
15,104,10,100,0.0001,0.01,0.502,49,55
15,204,10,100,0.0001,0.01,0.502,97,107
15,304,10,100,0.0001,0.01,0.492,153,151
15,404,10,100,0.0001,0.01,0.5,207,197
15,504,10,100,0.0001,0.01,0.492,258,246
15,604,10,100,0.0001,0.01,0.508,314,290
15,704,10,100,0.0001,0.01,0.502,370,334
15,804,10,100,0.0001,0.01,0.51,424,380
15,904,10,100,0.0001,0.01,0.528,484,420
15,1004,10,100,0.0001,0.01,0.52,535,469
15,1104,10,100,0.0001,0.01,0.528,580,524
15,1204,10,100,0.0001,0.01,0.5,631,573
15,1304,10,100,0.0001,0.01,0.552,688,616
15,1404,10,100,0.0001,0.01,0.532,743,661
15,1504,10,100,0.0001,0.01,0.518,800,704
15,1604,10,100,0.0001,0.01,0.514,848,756
15,1704,10,100,0.0001,0.01,0.51,907,797
15,1804,10,100,0.0001,0.01,0.548,954,850
15,1904,10,100,0.0001,0.01,0.526,1009,895
15,2004,10,100,0.0001,0.01,0.552,1057,947
15,2104,10,100,0.0001,0.01,0.562,1109,995
15,2204,10,100,0.0001,0.01,0.594,1156,1048
15,2304,10,100,0.0001,0.01,0.562,1197,1107
15,2404,10,100,0.0001,0.01,0.636,1250,1154
15,2504,10,100,0.0001,0.01,0.628,1298,1206
15,2604,10,100,0.0001,0.01,0.644,1347,1257
15,2704,10,100,0.0001,0.01,0.662,1390,1314
15,2804,10,100,0.0001,0.01,0.664,1444,1360
15,2904,10,100,0.0001,0.01,0.664,1503,1401
15,3004,10,100,0.0001,0.01,0.682,1551,1453
15,3104,10,100,0.0001,0.01,0.708,1597,1507
15,3204,10,100,0.0001,0.01,0.732,1644,1560
15,3304,10,100,0.0001,0.01,0.726,1698,1606
15,3404,10,100,0.0001,0.01,0.752,1750,1654
15,3504,10,100,0.0001,0.01,0.792,1800,1704
15,3604,10,100,0.0001,0.01,0.774,1844,1760
15,3704,10,100,0.0001,0.01,0.808,1901,1803
15,3804,10,100,0.0001,0.01,0.826,1940,1864
15,3904,10,100,0.0001,0.01,0.83,1994,1910
15,4004,10,100,0.0001,0.01,0.834,2040,1964
15,4104,10,100,0.0001,0.01,0.848,2090,2014
15,4204,10,100,0.0001,0.01,0.844,2138,2066
15,4304,10,100,0.0001,0.01,0.874,2190,2114
15,4404,10,100,0.0001,0.01,0.854,2237,2167
15,4504,10,100,0.0001,0.01,0.87,2284,2220
15,4604,10,100,0.0001,0.01,0.844,2328,2276
15,4704,10,100,0.0001,0.01,0.866,2379,2325
15,4804,10,100,0.0001,0.01,0.856,2431,2373
15,4904,10,100,0.0001,0.01,0.884,2478,2426
15,5004,10,100,0.0001,0.01,0.894,2523,2481
15,5104,10,100,0.0001,0.01,0.89,2569,2535
15,5204,10,100,0.0001,0.01,0.91,2626,2578
15,5304,10,100,0.0001,0.01,0.922,2677,2627
15,5404,10,100,0.0001,0.01,0.912,2724,2680
15,5504,10,100,0.0001,0.01,0.9,2772,2732
15,5604,10,100,0.0001,0.01,0.922,2828,2776
15,5704,10,100,0.0001,0.01,0.924,2875,2829
15,5804,10,100,0.0001,0.01,0.92,2923,2881
15,5904,10,100,0.0001,0.01,0.938,2979,2925
15,6004,10,100,0.0001,0.01,0.926,3019,2985
15,6104,10,100,0.0001,0.01,0.932,3079,3025
15,6204,10,100,0.0001,0.01,0.934,3124,3080
15,6304,10,100,0.0001,0.01,0.934,3170,3134
15,6404,10,100,0.0001,0.01,0.928,3221,3183
15,6504,10,100,0.0001,0.01,0.928,3266,3238
15,6604,10,100,0.0001,0.01,0.914,3317,3287
15,6704,10,100,0.0001,0.01,0.928,3363,3341
15,6804,10,100,0.0001,0.01,0.928,3416,3388
15,6904,10,100,0.0001,0.01,0.95,3454,3450
15,7004,10,100,0.0001,0.01,0.938,3500,3504
15,7104,10,100,0.0001,0.01,0.944,3547,3557
15,7204,10,100,0.0001,0.01,0.958,3587,3617
15,7304,10,100,0.0001,0.01,0.954,3642,3662
15,7404,10,100,0.0001,0.01,0.958,3699,3705
15,7504,10,100,0.0001,0.01,0.946,3750,3754
15,7604,10,100,0.0001,0.01,0.954,3804,3800
15,7704,10,100,0.0001,0.01,0.932,3854,3850
15,7804,10,100,0.0001,0.01,0.974,3901,3903
15,7904,10,100,0.0001,0.01,0.97,3953,3951
15,8004,10,100,0.0001,0.01,0.966,4003,4001
15,8104,10,100,0.0001,0.01,0.97,4055,4049
15,8204,10,100,0.0001,0.01,0.966,4102,4102
15,8304,10,100,0.0001,0.01,0.97,4149,4155
15,8404,10,100,0.0001,0.01,0.974,4198,4206
15,8504,10,100,0.0001,0.01,0.968,4246,4258
15,8604,10,100,0.0001,0.01,0.976,4294,4310
15,8704,10,100,0.0001,0.01,0.97,4344,4360
15,8804,10,100,0.0001,0.01,0.968,4395,4409
15,8904,10,100,0.0001,0.01,0.964,4440,4464
15,9004,10,100,0.0001,0.01,0.98,4481,4523
15,9104,10,100,0.0001,0.01,0.972,4518,4586
15,9204,10,100,0.0001,0.01,0.966,4573,4631
15,9304,10,100,0.0001,0.01,0.972,4623,4681
15,9404,10,100,0.0001,0.01,0.972,4670,4734
15,9504,10,100,0.0001,0.01,0.976,4719,4785
15,9604,10,100,0.0001,0.01,0.972,4767,4837
15,9704,10,100,0.0001,0.01,0.974,4822,4882
15,9804,10,100,0.0001,0.01,0.968,4874,4930
15,9904,10,100,0.0001,0.01,0.972,4929,4975
15,10004,10,100,0.0001,0.01,0.974,4973,5031
15,10104,10,100,0.0001,0.01,0.974,5020,5084
15,10204,10,100,0.0001,0.01,0.98,5072,5132
15,10304,10,100,0.0001,0.01,0.97,5113,5191
15,10404,10,100,0.0001,0.01,0.958,5174,5230
15,10504,10,100,0.0001,0.01,0.946,5220,5284
15,10604,10,100,0.0001,0.01,0.974,5266,5338
15,10704,10,100,0.0001,0.01,0.974,5327,5377
15,10804,10,100,0.0001,0.01,0.986,5367,5437
15,10904,10,100,0.0001,0.01,0.98,5416,5488
15,11004,10,100,0.0001,0.01,0.982,5468,5536
15,11104,10,100,0.0001,0.01,0.978,5519,5585
15,11204,10,100,0.0001,0.01,0.988,5563,5641
15,11304,10,100,0.0001,0.01,0.984,5615,5689
15,11404,10,100,0.0001,0.01,0.982,5663,5741
15,11504,10,100,0.0001,0.01,0.986,5716,5788
15,11604,10,100,0.0001,0.01,0.984,5773,5831
15,11704,10,100,0.0001,0.01,0.982,5825,5879
15,11804,10,100,0.0001,0.01,0.98,5863,5941
15,11904,10,100,0.0001,0.01,0.972,5920,5984
15,12004,10,100,0.0001,0.01,0.962,5965,6039
15,12104,10,100,0.0001,0.01,0.97,6023,6081
15,12204,10,100,0.0001,0.01,0.98,6081,6123
15,12304,10,100,0.0001,0.01,0.984,6128,6176
15,12404,10,100,0.0001,0.01,0.986,6171,6233
15,12504,10,100,0.0001,0.01,0.986,6223,6281
15,12604,10,100,0.0001,0.01,0.984,6283,6321
15,12704,10,100,0.0001,0.01,0.984,6337,6367
15,12804,10,100,0.0001,0.01,0.988,6386,6418
15,12904,10,100,0.0001,0.01,0.988,6430,6474
15,13004,10,100,0.0001,0.01,0.988,6475,6529
15,13104,10,100,0.0001,0.01,0.988,6530,6574
15,13204,10,100,0.0001,0.01,0.986,6590,6614
15,13304,10,100,0.0001,0.01,0.988,6640,6664
15,13404,10,100,0.0001,0.01,0.99,6693,6711
15,13504,10,100,0.0001,0.01,0.988,6742,6762
15,13604,10,100,0.0001,0.01,0.98,6784,6820
15,13704,10,100,0.0001,0.01,0.968,6834,6870
15,13804,10,100,0.0001,0.01,0.982,6880,6924
15,13904,10,100,0.0001,0.01,0.988,6933,6971
15,14004,10,100,0.0001,0.01,0.978,6989,7015
15,14104,10,100,0.0001,0.01,0.98,7039,7065
15,14204,10,100,0.0001,0.01,0.988,7087,7117
15,14304,10,100,0.0001,0.01,0.986,7136,7168
15,14404,10,100,0.0001,0.01,0.986,7185,7219
15,14504,10,100,0.0001,0.01,0.986,7244,7260
15,14604,10,100,0.0001,0.01,0.988,7302,7302
15,14704,10,100,0.0001,0.01,0.984,7352,7352
15,14804,10,100,0.0001,0.01,0.984,7405,7399
15,14904,10,100,0.0001,0.01,0.988,7451,7453
15,15004,10,100,0.0001,0.01,0.994,7503,7501
16,104,10,100,0.0001,0.01,0.488,53,51
16,204,10,100,0.0001,0.01,0.49,104,100
16,304,10,100,0.0001,0.01,0.496,147,157
16,404,10,100,0.0001,0.01,0.478,201,203
16,504,10,100,0.0001,0.01,0.482,251,253
16,604,10,100,0.0001,0.01,0.5,295,309
16,704,10,100,0.0001,0.01,0.524,348,356
16,804,10,100,0.0001,0.01,0.524,394,410
16,904,10,100,0.0001,0.01,0.52,451,453
16,1004,10,100,0.0001,0.01,0.526,492,512
16,1104,10,100,0.0001,0.01,0.51,540,564
16,1204,10,100,0.0001,0.01,0.494,588,616
16,1304,10,100,0.0001,0.01,0.514,641,663
16,1404,10,100,0.0001,0.01,0.526,695,709
16,1504,10,100,0.0001,0.01,0.518,751,753
16,1604,10,100,0.0001,0.01,0.51,793,811
16,1704,10,100,0.0001,0.01,0.488,837,867
16,1804,10,100,0.0001,0.01,0.498,888,916
16,1904,10,100,0.0001,0.01,0.512,942,962
16,2004,10,100,0.0001,0.01,0.504,993,1011
16,2104,10,100,0.0001,0.01,0.51,1041,1063
16,2204,10,100,0.0001,0.01,0.53,1084,1120
16,2304,10,100,0.0001,0.01,0.524,1129,1175
16,2404,10,100,0.0001,0.01,0.532,1176,1228
16,2504,10,100,0.0001,0.01,0.536,1224,1280
16,2604,10,100,0.0001,0.01,0.582,1270,1334
16,2704,10,100,0.0001,0.01,0.618,1306,1398
16,2804,10,100,0.0001,0.01,0.634,1363,1441
16,2904,10,100,0.0001,0.01,0.648,1410,1494
16,3004,10,100,0.0001,0.01,0.652,1468,1536
16,3104,10,100,0.0001,0.01,0.69,1517,1587
16,3204,10,100,0.0001,0.01,0.722,1567,1637
16,3304,10,100,0.0001,0.01,0.712,1626,1678
16,3404,10,100,0.0001,0.01,0.722,1674,1730
16,3504,10,100,0.0001,0.01,0.714,1727,1777
16,3604,10,100,0.0001,0.01,0.73,1772,1832
16,3704,10,100,0.0001,0.01,0.762,1818,1886
16,3804,10,100,0.0001,0.01,0.768,1868,1936
16,3904,10,100,0.0001,0.01,0.764,1916,1988
16,4004,10,100,0.0001,0.01,0.766,1981,2023
16,4104,10,100,0.0001,0.01,0.79,2028,2076
16,4204,10,100,0.0001,0.01,0.812,2074,2130
16,4304,10,100,0.0001,0.01,0.806,2125,2179
16,4404,10,100,0.0001,0.01,0.838,2176,2228
16,4504,10,100,0.0001,0.01,0.85,2218,2286
16,4604,10,100,0.0001,0.01,0.814,2259,2345
16,4704,10,100,0.0001,0.01,0.838,2315,2389
16,4804,10,100,0.0001,0.01,0.818,2365,2439
16,4904,10,100,0.0001,0.01,0.824,2406,2498
16,5004,10,100,0.0001,0.01,0.846,2453,2551
16,5104,10,100,0.0001,0.01,0.852,2505,2599
16,5204,10,100,0.0001,0.01,0.844,2556,2648
16,5304,10,100,0.0001,0.01,0.87,2601,2703
16,5404,10,100,0.0001,0.01,0.872,2647,2757
16,5504,10,100,0.0001,0.01,0.882,2698,2806
16,5604,10,100,0.0001,0.01,0.872,2749,2855
16,5704,10,100,0.0001,0.01,0.88,2804,2900
16,5804,10,100,0.0001,0.01,0.886,2856,2948
16,5904,10,100,0.0001,0.01,0.876,2910,2994
16,6004,10,100,0.0001,0.01,0.89,2965,3039
16,6104,10,100,0.0001,0.01,0.878,3019,3085
16,6204,10,100,0.0001,0.01,0.878,3071,3133
16,6304,10,100,0.0001,0.01,0.876,3117,3187
16,6404,10,100,0.0001,0.01,0.886,3171,3233
16,6504,10,100,0.0001,0.01,0.884,3217,3287
16,6604,10,100,0.0001,0.01,0.89,3275,3329
16,6704,10,100,0.0001,0.01,0.906,3325,3379
16,6804,10,100,0.0001,0.01,0.9,3372,3432
16,6904,10,100,0.0001,0.01,0.888,3429,3475
16,7004,10,100,0.0001,0.01,0.91,3474,3530
16,7104,10,100,0.0001,0.01,0.906,3518,3586
16,7204,10,100,0.0001,0.01,0.902,3561,3643
16,7304,10,100,0.0001,0.01,0.902,3607,3697
16,7404,10,100,0.0001,0.01,0.932,3653,3751
16,7504,10,100,0.0001,0.01,0.914,3703,3801
16,7604,10,100,0.0001,0.01,0.918,3764,3840
16,7704,10,100,0.0001,0.01,0.94,3808,3896
16,7804,10,100,0.0001,0.01,0.906,3856,3948
16,7904,10,100,0.0001,0.01,0.914,3903,4001
16,8004,10,100,0.0001,0.01,0.946,3953,4051
16,8104,10,100,0.0001,0.01,0.902,3991,4113
16,8204,10,100,0.0001,0.01,0.932,4042,4162
16,8304,10,100,0.0001,0.01,0.938,4091,4213
16,8404,10,100,0.0001,0.01,0.928,4137,4267
16,8504,10,100,0.0001,0.01,0.932,4194,4310
16,8604,10,100,0.0001,0.01,0.936,4243,4361
16,8704,10,100,0.0001,0.01,0.934,4289,4415
16,8804,10,100,0.0001,0.01,0.93,4334,4470
16,8904,10,100,0.0001,0.01,0.936,4391,4513
16,9004,10,100,0.0001,0.01,0.936,4437,4567
16,9104,10,100,0.0001,0.01,0.92,4481,4623
16,9204,10,100,0.0001,0.01,0.934,4531,4673
16,9304,10,100,0.0001,0.01,0.926,4578,4726
16,9404,10,100,0.0001,0.01,0.93,4627,4777
16,9504,10,100,0.0001,0.01,0.942,4675,4829
16,9604,10,100,0.0001,0.01,0.926,4728,4876
16,9704,10,100,0.0001,0.01,0.93,4786,4918
16,9804,10,100,0.0001,0.01,0.932,4841,4963
16,9904,10,100,0.0001,0.01,0.952,4896,5008
16,10004,10,100,0.0001,0.01,0.946,4955,5049
16,10104,10,100,0.0001,0.01,0.95,5008,5096
16,10204,10,100,0.0001,0.01,0.962,5053,5151
16,10304,10,100,0.0001,0.01,0.954,5111,5193
16,10404,10,100,0.0001,0.01,0.954,5161,5243
16,10504,10,100,0.0001,0.01,0.962,5209,5295
16,10604,10,100,0.0001,0.01,0.966,5260,5344
16,10704,10,100,0.0001,0.01,0.952,5315,5389
16,10804,10,100,0.0001,0.01,0.946,5367,5437
16,10904,10,100,0.0001,0.01,0.958,5416,5488
16,11004,10,100,0.0001,0.01,0.962,5465,5539
16,11104,10,100,0.0001,0.01,0.956,5517,5587
16,11204,10,100,0.0001,0.01,0.962,5555,5649
16,11304,10,100,0.0001,0.01,0.96,5616,5688
16,11404,10,100,0.0001,0.01,0.964,5667,5737
16,11504,10,100,0.0001,0.01,0.966,5717,5787
16,11604,10,100,0.0001,0.01,0.96,5766,5838
16,11704,10,100,0.0001,0.01,0.95,5812,5892
16,11804,10,100,0.0001,0.01,0.96,5856,5948
16,11904,10,100,0.0001,0.01,0.966,5899,6005
16,12004,10,100,0.0001,0.01,0.966,5940,6064
16,12104,10,100,0.0001,0.01,0.964,5989,6115
16,12204,10,100,0.0001,0.01,0.952,6037,6167
16,12304,10,100,0.0001,0.01,0.954,6087,6217
16,12404,10,100,0.0001,0.01,0.96,6142,6262
16,12504,10,100,0.0001,0.01,0.96,6194,6310
16,12604,10,100,0.0001,0.01,0.97,6249,6355
16,12704,10,100,0.0001,0.01,0.976,6298,6406
16,12804,10,100,0.0001,0.01,0.972,6347,6457
16,12904,10,100,0.0001,0.01,0.964,6405,6499
16,13004,10,100,0.0001,0.01,0.974,6454,6550
16,13104,10,100,0.0001,0.01,0.972,6501,6603
16,13204,10,100,0.0001,0.01,0.968,6553,6651
16,13304,10,100,0.0001,0.01,0.956,6619,6685
16,13404,10,100,0.0001,0.01,0.952,6670,6734
16,13504,10,100,0.0001,0.01,0.978,6721,6783
16,13604,10,100,0.0001,0.01,0.976,6767,6837
16,13704,10,100,0.0001,0.01,0.974,6824,6880
16,13804,10,100,0.0001,0.01,0.968,6872,6932
16,13904,10,100,0.0001,0.01,0.978,6923,6981
16,14004,10,100,0.0001,0.01,0.978,6983,7021
16,14104,10,100,0.0001,0.01,0.98,7029,7075
16,14204,10,100,0.0001,0.01,0.972,7083,7121
16,14304,10,100,0.0001,0.01,0.968,7134,7170
16,14404,10,100,0.0001,0.01,0.972,7188,7216
16,14504,10,100,0.0001,0.01,0.974,7241,7263
16,14604,10,100,0.0001,0.01,0.98,7291,7313
16,14704,10,100,0.0001,0.01,0.972,7341,7363
16,14804,10,100,0.0001,0.01,0.978,7389,7415
16,14904,10,100,0.0001,0.01,0.97,7436,7468
16,15004,10,100,0.0001,0.01,0.972,7492,7512
17,104,10,100,0.0001,0.01,0.504,47,57
17,204,10,100,0.0001,0.01,0.492,103,101
17,304,10,100,0.0001,0.01,0.488,159,145
17,404,10,100,0.0001,0.01,0.498,208,196
17,504,10,100,0.0001,0.01,0.514,261,243
17,604,10,100,0.0001,0.01,0.514,306,298
17,704,10,100,0.0001,0.01,0.486,359,345
17,804,10,100,0.0001,0.01,0.496,406,398
17,904,10,100,0.0001,0.01,0.504,459,445
17,1004,10,100,0.0001,0.01,0.546,506,498
17,1104,10,100,0.0001,0.01,0.548,550,554
17,1204,10,100,0.0001,0.01,0.558,609,595
17,1304,10,100,0.0001,0.01,0.548,651,653
17,1404,10,100,0.0001,0.01,0.548,689,715
17,1504,10,100,0.0001,0.01,0.56,740,764
17,1604,10,100,0.0001,0.01,0.556,796,808
17,1704,10,100,0.0001,0.01,0.55,846,858
17,1804,10,100,0.0001,0.01,0.59,901,903
17,1904,10,100,0.0001,0.01,0.596,953,951
17,2004,10,100,0.0001,0.01,0.582,1006,998
17,2104,10,100,0.0001,0.01,0.614,1059,1045
17,2204,10,100,0.0001,0.01,0.618,1100,1104
17,2304,10,100,0.0001,0.01,0.664,1147,1157
17,2404,10,100,0.0001,0.01,0.668,1197,1207
17,2504,10,100,0.0001,0.01,0.712,1247,1257
17,2604,10,100,0.0001,0.01,0.732,1298,1306
17,2704,10,100,0.0001,0.01,0.764,1348,1356
17,2804,10,100,0.0001,0.01,0.782,1401,1403
17,2904,10,100,0.0001,0.01,0.796,1444,1460
17,3004,10,100,0.0001,0.01,0.77,1503,1501
17,3104,10,100,0.0001,0.01,0.842,1560,1544
17,3204,10,100,0.0001,0.01,0.838,1615,1589
17,3304,10,100,0.0001,0.01,0.862,1664,1640
17,3404,10,100,0.0001,0.01,0.872,1712,1692
17,3504,10,100,0.0001,0.01,0.862,1763,1741
17,3604,10,100,0.0001,0.01,0.868,1810,1794
17,3704,10,100,0.0001,0.01,0.878,1865,1839
17,3804,10,100,0.0001,0.01,0.878,1907,1897
17,3904,10,100,0.0001,0.01,0.9,1954,1950
17,4004,10,100,0.0001,0.01,0.892,2007,1997
17,4104,10,100,0.0001,0.01,0.914,2056,2048
17,4204,10,100,0.0001,0.01,0.884,2114,2090
17,4304,10,100,0.0001,0.01,0.906,2169,2135
17,4404,10,100,0.0001,0.01,0.926,2217,2187
17,4504,10,100,0.0001,0.01,0.926,2258,2246
17,4604,10,100,0.0001,0.01,0.932,2310,2294
17,4704,10,100,0.0001,0.01,0.924,2365,2339
17,4804,10,100,0.0001,0.01,0.916,2409,2395
17,4904,10,100,0.0001,0.01,0.898,2458,2446
17,5004,10,100,0.0001,0.01,0.934,2512,2492
17,5104,10,100,0.0001,0.01,0.954,2550,2554
17,5204,10,100,0.0001,0.01,0.954,2595,2609
17,5304,10,100,0.0001,0.01,0.958,2653,2651
17,5404,10,100,0.0001,0.01,0.956,2704,2700
17,5504,10,100,0.0001,0.01,0.948,2757,2747
17,5604,10,100,0.0001,0.01,0.962,2805,2799
17,5704,10,100,0.0001,0.01,0.94,2856,2848
17,5804,10,100,0.0001,0.01,0.94,2904,2900
17,5904,10,100,0.0001,0.01,0.954,2949,2955
17,6004,10,100,0.0001,0.01,0.96,2999,3005
17,6104,10,100,0.0001,0.01,0.962,3047,3057
17,6204,10,100,0.0001,0.01,0.962,3100,3104
17,6304,10,100,0.0001,0.01,0.972,3161,3143
17,6404,10,100,0.0001,0.01,0.978,3207,3197
17,6504,10,100,0.0001,0.01,0.964,3262,3242
17,6604,10,100,0.0001,0.01,0.964,3312,3292
17,6704,10,100,0.0001,0.01,0.974,3354,3350
17,6804,10,100,0.0001,0.01,0.976,3404,3400
17,6904,10,100,0.0001,0.01,0.97,3452,3452
17,7004,10,100,0.0001,0.01,0.972,3498,3506
17,7104,10,100,0.0001,0.01,0.968,3551,3553
17,7204,10,100,0.0001,0.01,0.956,3604,3600
17,7304,10,100,0.0001,0.01,0.982,3650,3654
17,7404,10,100,0.0001,0.01,0.98,3703,3701
17,7504,10,100,0.0001,0.01,0.984,3754,3750
17,7604,10,100,0.0001,0.01,0.978,3811,3793
17,7704,10,100,0.0001,0.01,0.972,3853,3851
17,7804,10,100,0.0001,0.01,0.984,3896,3908
17,7904,10,100,0.0001,0.01,0.978,3947,3957
17,8004,10,100,0.0001,0.01,0.96,4008,3996
17,8104,10,100,0.0001,0.01,0.978,4054,4050
17,8204,10,100,0.0001,0.01,0.982,4099,4105
17,8304,10,100,0.0001,0.01,0.976,4149,4155
17,8404,10,100,0.0001,0.01,0.988,4192,4212
17,8504,10,100,0.0001,0.01,0.988,4248,4256
17,8604,10,100,0.0001,0.01,0.986,4289,4315
17,8704,10,100,0.0001,0.01,0.982,4343,4361
17,8804,10,100,0.0001,0.01,0.976,4389,4415
17,8904,10,100,0.0001,0.01,0.982,4438,4466
17,9004,10,100,0.0001,0.01,0.97,4485,4519
17,9104,10,100,0.0001,0.01,0.986,4542,4562
17,9204,10,100,0.0001,0.01,0.986,4580,4624
17,9304,10,100,0.0001,0.01,0.978,4626,4678
17,9404,10,100,0.0001,0.01,0.992,4677,4727
17,9504,10,100,0.0001,0.01,0.992,4724,4780
17,9604,10,100,0.0001,0.01,0.99,4774,4830
17,9704,10,100,0.0001,0.01,0.968,4817,4887
17,9804,10,100,0.0001,0.01,0.976,4873,4931
17,9904,10,100,0.0001,0.01,0.986,4927,4977
17,10004,10,100,0.0001,0.01,0.988,4975,5029
17,10104,10,100,0.0001,0.01,0.99,5028,5076
17,10204,10,100,0.0001,0.01,0.99,5070,5134
17,10304,10,100,0.0001,0.01,0.99,5118,5186
17,10404,10,100,0.0001,0.01,0.982,5172,5232
17,10504,10,100,0.0001,0.01,0.984,5227,5277
17,10604,10,100,0.0001,0.01,0.99,5282,5322
17,10704,10,100,0.0001,0.01,0.99,5330,5374
17,10804,10,100,0.0001,0.01,0.996,5389,5415
17,10904,10,100,0.0001,0.01,0.996,5435,5469
17,11004,10,100,0.0001,0.01,0.99,5488,5516
17,11104,10,100,0.0001,0.01,0.992,5535,5569
17,11204,10,100,0.0001,0.01,0.994,5583,5621
17,11304,10,100,0.0001,0.01,0.994,5629,5675
17,11404,10,100,0.0001,0.01,0.994,5678,5726
17,11504,10,100,0.0001,0.01,0.994,5730,5774
17,11604,10,100,0.0001,0.01,0.988,5770,5834
17,11704,10,100,0.0001,0.01,0.986,5817,5887
17,11804,10,100,0.0001,0.01,0.988,5863,5941
17,11904,10,100,0.0001,0.01,0.994,5899,6005
17,12004,10,100,0.0001,0.01,0.992,5949,6055
17,12104,10,100,0.0001,0.01,0.99,5993,6111
17,12204,10,100,0.0001,0.01,0.994,6045,6159
17,12304,10,100,0.0001,0.01,0.994,6089,6215
17,12404,10,100,0.0001,0.01,0.99,6145,6259
17,12504,10,100,0.0001,0.01,0.992,6193,6311
17,12604,10,100,0.0001,0.01,0.992,6250,6354
17,12704,10,100,0.0001,0.01,0.994,6304,6400
17,12804,10,100,0.0001,0.01,0.992,6354,6450
17,12904,10,100,0.0001,0.01,0.992,6409,6495
17,13004,10,100,0.0001,0.01,0.994,6455,6549
17,13104,10,100,0.0001,0.01,0.988,6510,6594
17,13204,10,100,0.0001,0.01,0.99,6557,6647
17,13304,10,100,0.0001,0.01,0.992,6611,6693
17,13404,10,100,0.0001,0.01,0.998,6662,6742
17,13504,10,100,0.0001,0.01,0.998,6715,6789
17,13604,10,100,0.0001,0.01,0.992,6769,6835
17,13704,10,100,0.0001,0.01,0.988,6820,6884
17,13804,10,100,0.0001,0.01,0.99,6878,6926
17,13904,10,100,0.0001,0.01,0.99,6931,6973
17,14004,10,100,0.0001,0.01,0.994,6983,7021
17,14104,10,100,0.0001,0.01,0.998,7033,7071
17,14204,10,100,0.0001,0.01,0.996,7094,7110
17,14304,10,100,0.0001,0.01,0.994,7140,7164
17,14404,10,100,0.0001,0.01,0.996,7190,7214
17,14504,10,100,0.0001,0.01,0.994,7242,7262
17,14604,10,100,0.0001,0.01,0.994,7293,7311
17,14704,10,100,0.0001,0.01,1.0,7343,7361
17,14804,10,100,0.0001,0.01,0.996,7395,7409
17,14904,10,100,0.0001,0.01,0.994,7442,7462
17,15004,10,100,0.0001,0.01,0.998,7500,7504
18,104,10,100,0.0001,0.01,0.538,52,52
18,204,10,100,0.0001,0.01,0.524,104,100
18,304,10,100,0.0001,0.01,0.514,150,154
18,404,10,100,0.0001,0.01,0.53,205,199
18,504,10,100,0.0001,0.01,0.54,260,244
18,604,10,100,0.0001,0.01,0.498,311,293
18,704,10,100,0.0001,0.01,0.55,352,352
18,804,10,100,0.0001,0.01,0.548,390,414
18,904,10,100,0.0001,0.01,0.502,437,467
18,1004,10,100,0.0001,0.01,0.496,488,516
18,1104,10,100,0.0001,0.01,0.506,539,565
18,1204,10,100,0.0001,0.01,0.508,592,612
18,1304,10,100,0.0001,0.01,0.526,645,659
18,1404,10,100,0.0001,0.01,0.532,696,708
18,1504,10,100,0.0001,0.01,0.52,746,758
18,1604,10,100,0.0001,0.01,0.506,801,803
18,1704,10,100,0.0001,0.01,0.484,843,861
18,1804,10,100,0.0001,0.01,0.512,900,904
18,1904,10,100,0.0001,0.01,0.54,945,959
18,2004,10,100,0.0001,0.01,0.556,988,1016
18,2104,10,100,0.0001,0.01,0.516,1035,1069
18,2204,10,100,0.0001,0.01,0.53,1080,1124
18,2304,10,100,0.0001,0.01,0.542,1126,1178
18,2404,10,100,0.0001,0.01,0.568,1181,1223
18,2504,10,100,0.0001,0.01,0.558,1227,1277
18,2604,10,100,0.0001,0.01,0.546,1277,1327
18,2704,10,100,0.0001,0.01,0.544,1331,1373
18,2804,10,100,0.0001,0.01,0.588,1384,1420
18,2904,10,100,0.0001,0.01,0.588,1437,1467
18,3004,10,100,0.0001,0.01,0.604,1491,1513
18,3104,10,100,0.0001,0.01,0.598,1543,1561
18,3204,10,100,0.0001,0.01,0.598,1598,1606
18,3304,10,100,0.0001,0.01,0.6,1639,1665
18,3404,10,100,0.0001,0.01,0.636,1683,1721
18,3504,10,100,0.0001,0.01,0.62,1729,1775
18,3604,10,100,0.0001,0.01,0.608,1782,1822
18,3704,10,100,0.0001,0.01,0.62,1835,1869
18,3804,10,100,0.0001,0.01,0.66,1891,1913
18,3904,10,100,0.0001,0.01,0.674,1940,1964
18,4004,10,100,0.0001,0.01,0.648,1989,2015
18,4104,10,100,0.0001,0.01,0.654,2030,2074
18,4204,10,100,0.0001,0.01,0.646,2086,2118
18,4304,10,100,0.0001,0.01,0.696,2137,2167
18,4404,10,100,0.0001,0.01,0.696,2187,2217
18,4504,10,100,0.0001,0.01,0.704,2235,2269
18,4604,10,100,0.0001,0.01,0.722,2282,2322
18,4704,10,100,0.0001,0.01,0.732,2335,2369
18,4804,10,100,0.0001,0.01,0.73,2382,2422
18,4904,10,100,0.0001,0.01,0.724,2431,2473
18,5004,10,100,0.0001,0.01,0.718,2484,2520
18,5104,10,100,0.0001,0.01,0.724,2526,2578
18,5204,10,100,0.0001,0.01,0.712,2583,2621
18,5304,10,100,0.0001,0.01,0.784,2639,2665
18,5404,10,100,0.0001,0.01,0.754,2688,2716
18,5504,10,100,0.0001,0.01,0.754,2742,2762
18,5604,10,100,0.0001,0.01,0.752,2787,2817
18,5704,10,100,0.0001,0.01,0.786,2834,2870
18,5804,10,100,0.0001,0.01,0.776,2885,2919
18,5904,10,100,0.0001,0.01,0.748,2941,2963
18,6004,10,100,0.0001,0.01,0.752,2995,3009
18,6104,10,100,0.0001,0.01,0.738,3049,3055
18,6204,10,100,0.0001,0.01,0.798,3092,3112
18,6304,10,100,0.0001,0.01,0.808,3154,3150
18,6404,10,100,0.0001,0.01,0.828,3199,3205
18,6504,10,100,0.0001,0.01,0.836,3262,3242
18,6604,10,100,0.0001,0.01,0.86,3315,3289
18,6704,10,100,0.0001,0.01,0.836,3370,3334
18,6804,10,100,0.0001,0.01,0.854,3419,3385
18,6904,10,100,0.0001,0.01,0.852,3466,3438
18,7004,10,100,0.0001,0.01,0.874,3515,3489
18,7104,10,100,0.0001,0.01,0.854,3566,3538
18,7204,10,100,0.0001,0.01,0.862,3617,3587
18,7304,10,100,0.0001,0.01,0.886,3666,3638
18,7404,10,100,0.0001,0.01,0.86,3715,3689
18,7504,10,100,0.0001,0.01,0.91,3769,3735
18,7604,10,100,0.0001,0.01,0.902,3818,3786
18,7704,10,100,0.0001,0.01,0.9,3873,3831
18,7804,10,100,0.0001,0.01,0.9,3921,3883
18,7904,10,100,0.0001,0.01,0.914,3979,3925
18,8004,10,100,0.0001,0.01,0.924,4028,3976
18,8104,10,100,0.0001,0.01,0.916,4075,4029
18,8204,10,100,0.0001,0.01,0.904,4121,4083
18,8304,10,100,0.0001,0.01,0.908,4173,4131
18,8404,10,100,0.0001,0.01,0.894,4214,4190
18,8504,10,100,0.0001,0.01,0.896,4258,4246
18,8604,10,100,0.0001,0.01,0.896,4308,4296
18,8704,10,100,0.0001,0.01,0.916,4355,4349
18,8804,10,100,0.0001,0.01,0.936,4402,4402
18,8904,10,100,0.0001,0.01,0.924,4449,4455
18,9004,10,100,0.0001,0.01,0.934,4505,4499
18,9104,10,100,0.0001,0.01,0.932,4553,4551
18,9204,10,100,0.0001,0.01,0.944,4602,4602
18,9304,10,100,0.0001,0.01,0.95,4646,4658
18,9404,10,100,0.0001,0.01,0.964,4694,4710
18,9504,10,100,0.0001,0.01,0.958,4746,4758
18,9604,10,100,0.0001,0.01,0.96,4797,4807
18,9704,10,100,0.0001,0.01,0.952,4860,4844
18,9804,10,100,0.0001,0.01,0.95,4911,4893
18,9904,10,100,0.0001,0.01,0.936,4971,4933
18,10004,10,100,0.0001,0.01,0.952,5010,4994
18,10104,10,100,0.0001,0.01,0.952,5056,5048
18,10204,10,100,0.0001,0.01,0.944,5109,5095
18,10304,10,100,0.0001,0.01,0.966,5153,5151
18,10404,10,100,0.0001,0.01,0.962,5198,5206
18,10504,10,100,0.0001,0.01,0.966,5252,5252
18,10604,10,100,0.0001,0.01,0.962,5303,5301
18,10704,10,100,0.0001,0.01,0.962,5353,5351
18,10804,10,100,0.0001,0.01,0.974,5404,5400
18,10904,10,100,0.0001,0.01,0.972,5460,5444
18,11004,10,100,0.0001,0.01,0.976,5511,5493
18,11104,10,100,0.0001,0.01,0.976,5556,5548
18,11204,10,100,0.0001,0.01,0.984,5608,5596
18,11304,10,100,0.0001,0.01,0.984,5663,5641
18,11404,10,100,0.0001,0.01,0.986,5714,5690
18,11504,10,100,0.0001,0.01,0.982,5760,5744
18,11604,10,100,0.0001,0.01,0.976,5805,5799
18,11704,10,100,0.0001,0.01,0.972,5853,5851
18,11804,10,100,0.0001,0.01,0.948,5907,5897
18,11904,10,100,0.0001,0.01,0.962,5951,5953
18,12004,10,100,0.0001,0.01,0.978,6004,6000
18,12104,10,100,0.0001,0.01,0.982,6061,6043
18,12204,10,100,0.0001,0.01,0.992,6115,6089
18,12304,10,100,0.0001,0.01,0.99,6166,6138
18,12404,10,100,0.0001,0.01,0.99,6212,6192
18,12504,10,100,0.0001,0.01,0.992,6266,6238
18,12604,10,100,0.0001,0.01,0.992,6322,6282
18,12704,10,100,0.0001,0.01,0.988,6378,6326
18,12804,10,100,0.0001,0.01,0.988,6415,6389
18,12904,10,100,0.0001,0.01,0.99,6462,6442
18,13004,10,100,0.0001,0.01,0.988,6509,6495
18,13104,10,100,0.0001,0.01,0.978,6558,6546
18,13204,10,100,0.0001,0.01,0.954,6609,6595
18,13304,10,100,0.0001,0.01,0.984,6660,6644
18,13404,10,100,0.0001,0.01,0.96,6706,6698
18,13504,10,100,0.0001,0.01,0.992,6759,6745
18,13604,10,100,0.0001,0.01,0.986,6818,6786
18,13704,10,100,0.0001,0.01,0.992,6867,6837
18,13804,10,100,0.0001,0.01,0.99,6911,6893
18,13904,10,100,0.0001,0.01,0.994,6962,6942
18,14004,10,100,0.0001,0.01,0.992,7014,6990
18,14104,10,100,0.0001,0.01,0.992,7067,7037
18,14204,10,100,0.0001,0.01,0.994,7106,7098
18,14304,10,100,0.0001,0.01,0.988,7158,7146
18,14404,10,100,0.0001,0.01,0.988,7215,7189
18,14504,10,100,0.0001,0.01,0.998,7260,7244
18,14604,10,100,0.0001,0.01,0.998,7309,7295
18,14704,10,100,0.0001,0.01,0.99,7362,7342
18,14804,10,100,0.0001,0.01,0.986,7413,7391
18,14904,10,100,0.0001,0.01,0.988,7457,7447
18,15004,10,100,0.0001,0.01,0.986,7511,7493
19,104,10,100,0.0001,0.01,0.506,45,59
19,204,10,100,0.0001,0.01,0.49,91,113
19,304,10,100,0.0001,0.01,0.464,145,159
19,404,10,100,0.0001,0.01,0.492,195,209
19,504,10,100,0.0001,0.01,0.522,241,263
19,604,10,100,0.0001,0.01,0.496,281,323
19,704,10,100,0.0001,0.01,0.512,334,370
19,804,10,100,0.0001,0.01,0.524,388,416
19,904,10,100,0.0001,0.01,0.524,438,466
19,1004,10,100,0.0001,0.01,0.544,494,510
19,1104,10,100,0.0001,0.01,0.556,542,562
19,1204,10,100,0.0001,0.01,0.538,593,611
19,1304,10,100,0.0001,0.01,0.538,636,668
19,1404,10,100,0.0001,0.01,0.544,686,718
19,1504,10,100,0.0001,0.01,0.544,740,764
19,1604,10,100,0.0001,0.01,0.564,799,805
19,1704,10,100,0.0001,0.01,0.558,853,851
19,1804,10,100,0.0001,0.01,0.554,907,897
19,1904,10,100,0.0001,0.01,0.54,956,948
19,2004,10,100,0.0001,0.01,0.55,1006,998
19,2104,10,100,0.0001,0.01,0.544,1054,1050
19,2204,10,100,0.0001,0.01,0.568,1102,1102
19,2304,10,100,0.0001,0.01,0.538,1150,1154
19,2404,10,100,0.0001,0.01,0.578,1207,1197
19,2504,10,100,0.0001,0.01,0.57,1254,1250
19,2604,10,100,0.0001,0.01,0.616,1315,1289
19,2704,10,100,0.0001,0.01,0.622,1363,1341
19,2804,10,100,0.0001,0.01,0.652,1413,1391
19,2904,10,100,0.0001,0.01,0.68,1452,1452
19,3004,10,100,0.0001,0.01,0.714,1504,1500
19,3104,10,100,0.0001,0.01,0.686,1554,1550
19,3204,10,100,0.0001,0.01,0.704,1601,1603
19,3304,10,100,0.0001,0.01,0.682,1646,1658
19,3404,10,100,0.0001,0.01,0.748,1698,1706
19,3504,10,100,0.0001,0.01,0.748,1749,1755
19,3604,10,100,0.0001,0.01,0.762,1796,1808
19,3704,10,100,0.0001,0.01,0.808,1851,1853
19,3804,10,100,0.0001,0.01,0.794,1907,1897
19,3904,10,100,0.0001,0.01,0.804,1954,1950
19,4004,10,100,0.0001,0.01,0.828,2007,1997
19,4104,10,100,0.0001,0.01,0.81,2052,2052
19,4204,10,100,0.0001,0.01,0.846,2105,2099
19,4304,10,100,0.0001,0.01,0.842,2159,2145
19,4404,10,100,0.0001,0.01,0.86,2209,2195
19,4504,10,100,0.0001,0.01,0.852,2249,2255
19,4604,10,100,0.0001,0.01,0.858,2292,2312
19,4704,10,100,0.0001,0.01,0.852,2340,2364
19,4804,10,100,0.0001,0.01,0.858,2388,2416
19,4904,10,100,0.0001,0.01,0.868,2437,2467
19,5004,10,100,0.0001,0.01,0.862,2499,2505
19,5104,10,100,0.0001,0.01,0.866,2547,2557
19,5204,10,100,0.0001,0.01,0.846,2603,2601
19,5304,10,100,0.0001,0.01,0.848,2657,2647
19,5404,10,100,0.0001,0.01,0.868,2704,2700
19,5504,10,100,0.0001,0.01,0.88,2767,2737
19,5604,10,100,0.0001,0.01,0.87,2817,2787
19,5704,10,100,0.0001,0.01,0.87,2868,2836
19,5804,10,100,0.0001,0.01,0.888,2923,2881
19,5904,10,100,0.0001,0.01,0.876,2970,2934
19,6004,10,100,0.0001,0.01,0.91,3029,2975
19,6104,10,100,0.0001,0.01,0.914,3066,3038
19,6204,10,100,0.0001,0.01,0.88,3118,3086
19,6304,10,100,0.0001,0.01,0.836,3180,3124
19,6404,10,100,0.0001,0.01,0.896,3227,3177
19,6504,10,100,0.0001,0.01,0.908,3282,3222
19,6604,10,100,0.0001,0.01,0.908,3334,3270
19,6704,10,100,0.0001,0.01,0.928,3393,3311
19,6804,10,100,0.0001,0.01,0.926,3444,3360
19,6904,10,100,0.0001,0.01,0.918,3493,3411
19,7004,10,100,0.0001,0.01,0.926,3545,3459
19,7104,10,100,0.0001,0.01,0.936,3587,3517
19,7204,10,100,0.0001,0.01,0.946,3639,3565
19,7304,10,100,0.0001,0.01,0.93,3696,3608
19,7404,10,100,0.0001,0.01,0.94,3750,3654
19,7504,10,100,0.0001,0.01,0.94,3806,3698
19,7604,10,100,0.0001,0.01,0.932,3842,3762
19,7704,10,100,0.0001,0.01,0.938,3891,3813
19,7804,10,100,0.0001,0.01,0.934,3939,3865
19,7904,10,100,0.0001,0.01,0.936,3985,3919
19,8004,10,100,0.0001,0.01,0.924,4034,3970
19,8104,10,100,0.0001,0.01,0.944,4086,4018
19,8204,10,100,0.0001,0.01,0.956,4129,4075
19,8304,10,100,0.0001,0.01,0.952,4181,4123
19,8404,10,100,0.0001,0.01,0.954,4223,4181
19,8504,10,100,0.0001,0.01,0.968,4281,4223
19,8604,10,100,0.0001,0.01,0.954,4342,4262
19,8704,10,100,0.0001,0.01,0.96,4400,4304
19,8804,10,100,0.0001,0.01,0.962,4449,4355
19,8904,10,100,0.0001,0.01,0.972,4496,4408
19,9004,10,100,0.0001,0.01,0.966,4543,4461
19,9104,10,100,0.0001,0.01,0.96,4594,4510
19,9204,10,100,0.0001,0.01,0.944,4643,4561
19,9304,10,100,0.0001,0.01,0.966,4694,4610
19,9404,10,100,0.0001,0.01,0.968,4736,4668
19,9504,10,100,0.0001,0.01,0.97,4788,4716
19,9604,10,100,0.0001,0.01,0.974,4831,4773
19,9704,10,100,0.0001,0.01,0.97,4876,4828
19,9804,10,100,0.0001,0.01,0.95,4923,4881
19,9904,10,100,0.0001,0.01,0.958,4979,4925
19,10004,10,100,0.0001,0.01,0.96,5033,4971
19,10104,10,100,0.0001,0.01,0.97,5073,5031
19,10204,10,100,0.0001,0.01,0.966,5128,5076
19,10304,10,100,0.0001,0.01,0.972,5183,5121
19,10404,10,100,0.0001,0.01,0.97,5230,5174
19,10504,10,100,0.0001,0.01,0.968,5282,5222
19,10604,10,100,0.0001,0.01,0.978,5336,5268
19,10704,10,100,0.0001,0.01,0.984,5381,5323
19,10804,10,100,0.0001,0.01,0.976,5434,5370
19,10904,10,100,0.0001,0.01,0.98,5489,5415
19,11004,10,100,0.0001,0.01,0.978,5538,5466
19,11104,10,100,0.0001,0.01,0.972,5593,5511
19,11204,10,100,0.0001,0.01,0.942,5654,5550
19,11304,10,100,0.0001,0.01,0.962,5695,5609
19,11404,10,100,0.0001,0.01,0.982,5740,5664
19,11504,10,100,0.0001,0.01,0.988,5792,5712
19,11604,10,100,0.0001,0.01,0.988,5837,5767
19,11704,10,100,0.0001,0.01,0.986,5885,5819
19,11804,10,100,0.0001,0.01,0.988,5934,5870
19,11904,10,100,0.0001,0.01,0.978,5987,5917
19,12004,10,100,0.0001,0.01,0.984,6036,5968
19,12104,10,100,0.0001,0.01,0.982,6091,6013
19,12204,10,100,0.0001,0.01,0.992,6140,6064
19,12304,10,100,0.0001,0.01,0.984,6190,6114
19,12404,10,100,0.0001,0.01,0.97,6242,6162
19,12504,10,100,0.0001,0.01,0.98,6292,6212
19,12604,10,100,0.0001,0.01,0.994,6341,6263
19,12704,10,100,0.0001,0.01,0.992,6397,6307
19,12804,10,100,0.0001,0.01,0.99,6441,6363
19,12904,10,100,0.0001,0.01,0.99,6490,6414
19,13004,10,100,0.0001,0.01,0.994,6530,6474
19,13104,10,100,0.0001,0.01,0.992,6583,6521
19,13204,10,100,0.0001,0.01,0.992,6629,6575
19,13304,10,100,0.0001,0.01,0.994,6677,6627
19,13404,10,100,0.0001,0.01,0.992,6729,6675
19,13504,10,100,0.0001,0.01,0.99,6780,6724
19,13604,10,100,0.0001,0.01,0.988,6838,6766
19,13704,10,100,0.0001,0.01,0.978,6878,6826
19,13804,10,100,0.0001,0.01,0.994,6923,6881
19,13904,10,100,0.0001,0.01,0.984,6971,6933
19,14004,10,100,0.0001,0.01,0.982,7019,6985
19,14104,10,100,0.0001,0.01,0.986,7069,7035
19,14204,10,100,0.0001,0.01,0.992,7113,7091
19,14304,10,100,0.0001,0.01,0.998,7158,7146
19,14404,10,100,0.0001,0.01,0.994,7216,7188
19,14504,10,100,0.0001,0.01,0.998,7269,7235
19,14604,10,100,0.0001,0.01,0.998,7315,7289
19,14704,10,100,0.0001,0.01,0.998,7356,7348
19,14804,10,100,0.0001,0.01,0.998,7407,7397
19,14904,10,100,0.0001,0.01,0.998,7449,7455
19,15004,10,100,0.0001,0.01,0.984,7495,7509
20,104,10,100,0.0001,0.01,0.484,48,56
20,204,10,100,0.0001,0.01,0.522,99,105
20,304,10,100,0.0001,0.01,0.51,151,153
20,404,10,100,0.0001,0.01,0.476,200,204
20,504,10,100,0.0001,0.01,0.488,256,248
20,604,10,100,0.0001,0.01,0.522,294,310
20,704,10,100,0.0001,0.01,0.482,338,366
20,804,10,100,0.0001,0.01,0.478,383,421
20,904,10,100,0.0001,0.01,0.49,427,477
20,1004,10,100,0.0001,0.01,0.514,476,528
20,1104,10,100,0.0001,0.01,0.508,536,568
20,1204,10,100,0.0001,0.01,0.5,601,603
20,1304,10,100,0.0001,0.01,0.49,648,656
20,1404,10,100,0.0001,0.01,0.47,700,704
20,1504,10,100,0.0001,0.01,0.51,752,752
20,1604,10,100,0.0001,0.01,0.472,803,801
20,1704,10,100,0.0001,0.01,0.53,848,856
20,1804,10,100,0.0001,0.01,0.56,896,908
20,1904,10,100,0.0001,0.01,0.52,952,952
20,2004,10,100,0.0001,0.01,0.49,997,1007
20,2104,10,100,0.0001,0.01,0.512,1046,1058
20,2204,10,100,0.0001,0.01,0.522,1084,1120
20,2304,10,100,0.0001,0.01,0.556,1135,1169
20,2404,10,100,0.0001,0.01,0.544,1193,1211
20,2504,10,100,0.0001,0.01,0.574,1245,1259
20,2604,10,100,0.0001,0.01,0.564,1295,1309
20,2704,10,100,0.0001,0.01,0.604,1336,1368
20,2804,10,100,0.0001,0.01,0.602,1387,1417
20,2904,10,100,0.0001,0.01,0.622,1441,1463
20,3004,10,100,0.0001,0.01,0.592,1495,1509
20,3104,10,100,0.0001,0.01,0.636,1545,1559
20,3204,10,100,0.0001,0.01,0.648,1601,1603
20,3304,10,100,0.0001,0.01,0.656,1643,1661
20,3404,10,100,0.0001,0.01,0.672,1698,1706
20,3504,10,100,0.0001,0.01,0.678,1747,1757
20,3604,10,100,0.0001,0.01,0.688,1798,1806
20,3704,10,100,0.0001,0.01,0.7,1844,1860
20,3804,10,100,0.0001,0.01,0.718,1892,1912
20,3904,10,100,0.0001,0.01,0.744,1942,1962
20,4004,10,100,0.0001,0.01,0.748,1993,2011
20,4104,10,100,0.0001,0.01,0.758,2042,2062
20,4204,10,100,0.0001,0.01,0.744,2091,2113
20,4304,10,100,0.0001,0.01,0.778,2141,2163
20,4404,10,100,0.0001,0.01,0.754,2191,2213
20,4504,10,100,0.0001,0.01,0.746,2243,2261
20,4604,10,100,0.0001,0.01,0.772,2293,2311
20,4704,10,100,0.0001,0.01,0.75,2337,2367
20,4804,10,100,0.0001,0.01,0.782,2380,2424
20,4904,10,100,0.0001,0.01,0.782,2430,2474
20,5004,10,100,0.0001,0.01,0.78,2485,2519
20,5104,10,100,0.0001,0.01,0.776,2543,2561
20,5204,10,100,0.0001,0.01,0.78,2586,2618
20,5304,10,100,0.0001,0.01,0.786,2635,2669
20,5404,10,100,0.0001,0.01,0.794,2688,2716
20,5504,10,100,0.0001,0.01,0.794,2730,2774
20,5604,10,100,0.0001,0.01,0.8,2776,2828
20,5704,10,100,0.0001,0.01,0.79,2822,2882
20,5804,10,100,0.0001,0.01,0.798,2873,2931
20,5904,10,100,0.0001,0.01,0.82,2924,2980
20,6004,10,100,0.0001,0.01,0.832,2972,3032
20,6104,10,100,0.0001,0.01,0.814,3019,3085
20,6204,10,100,0.0001,0.01,0.818,3076,3128
20,6304,10,100,0.0001,0.01,0.82,3129,3175
20,6404,10,100,0.0001,0.01,0.826,3164,3240
20,6504,10,100,0.0001,0.01,0.838,3217,3287
20,6604,10,100,0.0001,0.01,0.814,3265,3339
20,6704,10,100,0.0001,0.01,0.812,3310,3394
20,6804,10,100,0.0001,0.01,0.844,3365,3439
20,6904,10,100,0.0001,0.01,0.85,3418,3486
20,7004,10,100,0.0001,0.01,0.844,3471,3533
20,7104,10,100,0.0001,0.01,0.85,3524,3580
20,7204,10,100,0.0001,0.01,0.854,3584,3620
20,7304,10,100,0.0001,0.01,0.826,3634,3670
20,7404,10,100,0.0001,0.01,0.82,3687,3717
20,7504,10,100,0.0001,0.01,0.852,3733,3771
20,7604,10,100,0.0001,0.01,0.864,3788,3816
20,7704,10,100,0.0001,0.01,0.856,3852,3852
20,7804,10,100,0.0001,0.01,0.874,3903,3901
20,7904,10,100,0.0001,0.01,0.872,3951,3953
20,8004,10,100,0.0001,0.01,0.872,3998,4006
20,8104,10,100,0.0001,0.01,0.866,4052,4052
20,8204,10,100,0.0001,0.01,0.882,4103,4101
20,8304,10,100,0.0001,0.01,0.888,4156,4148
20,8404,10,100,0.0001,0.01,0.83,4200,4204
20,8504,10,100,0.0001,0.01,0.84,4259,4245
20,8604,10,100,0.0001,0.01,0.888,4308,4296
20,8704,10,100,0.0001,0.01,0.902,4352,4352
20,8804,10,100,0.0001,0.01,0.91,4406,4398
20,8904,10,100,0.0001,0.01,0.896,4459,4445
20,9004,10,100,0.0001,0.01,0.9,4505,4499
20,9104,10,100,0.0001,0.01,0.904,4548,4556
20,9204,10,100,0.0001,0.01,0.904,4597,4607
20,9304,10,100,0.0001,0.01,0.908,4652,4652
20,9404,10,100,0.0001,0.01,0.912,4701,4703
20,9504,10,100,0.0001,0.01,0.924,4750,4754
20,9604,10,100,0.0001,0.01,0.904,4797,4807
20,9704,10,100,0.0001,0.01,0.914,4853,4851
20,9804,10,100,0.0001,0.01,0.92,4895,4909
20,9904,10,100,0.0001,0.01,0.918,4946,4958
20,10004,10,100,0.0001,0.01,0.942,4993,5011
20,10104,10,100,0.0001,0.01,0.936,5046,5058
20,10204,10,100,0.0001,0.01,0.936,5096,5108
20,10304,10,100,0.0001,0.01,0.92,5138,5166
20,10404,10,100,0.0001,0.01,0.956,5177,5227
20,10504,10,100,0.0001,0.01,0.94,5224,5280
20,10604,10,100,0.0001,0.01,0.946,5279,5325
20,10704,10,100,0.0001,0.01,0.944,5332,5372
20,10804,10,100,0.0001,0.01,0.94,5383,5421
20,10904,10,100,0.0001,0.01,0.924,5442,5462
20,11004,10,100,0.0001,0.01,0.948,5492,5512
20,11104,10,100,0.0001,0.01,0.94,5540,5564
20,11204,10,100,0.0001,0.01,0.96,5592,5612
20,11304,10,100,0.0001,0.01,0.96,5645,5659
20,11404,10,100,0.0001,0.01,0.948,5696,5708
20,11504,10,100,0.0001,0.01,0.958,5749,5755
20,11604,10,100,0.0001,0.01,0.958,5803,5801
20,11704,10,100,0.0001,0.01,0.96,5862,5842
20,11804,10,100,0.0001,0.01,0.95,5910,5894
20,11904,10,100,0.0001,0.01,0.968,5953,5951
20,12004,10,100,0.0001,0.01,0.958,6009,5995
20,12104,10,100,0.0001,0.01,0.96,6069,6035
20,12204,10,100,0.0001,0.01,0.968,6131,6073
20,12304,10,100,0.0001,0.01,0.968,6186,6118
20,12404,10,100,0.0001,0.01,0.968,6235,6169
20,12504,10,100,0.0001,0.01,0.97,6292,6212
20,12604,10,100,0.0001,0.01,0.962,6335,6269
20,12704,10,100,0.0001,0.01,0.956,6387,6317
20,12804,10,100,0.0001,0.01,0.95,6435,6369
20,12904,10,100,0.0001,0.01,0.97,6485,6419
20,13004,10,100,0.0001,0.01,0.962,6533,6471
20,13104,10,100,0.0001,0.01,0.974,6583,6521
20,13204,10,100,0.0001,0.01,0.968,6631,6573
20,13304,10,100,0.0001,0.01,0.972,6675,6629
20,13404,10,100,0.0001,0.01,0.97,6722,6682
20,13504,10,100,0.0001,0.01,0.98,6777,6727
20,13604,10,100,0.0001,0.01,0.97,6826,6778
20,13704,10,100,0.0001,0.01,0.984,6868,6836
20,13804,10,100,0.0001,0.01,0.986,6914,6890
20,13904,10,100,0.0001,0.01,0.972,6966,6938
20,14004,10,100,0.0001,0.01,0.98,7015,6989
20,14104,10,100,0.0001,0.01,0.98,7071,7033
20,14204,10,100,0.0001,0.01,0.97,7128,7076
20,14304,10,100,0.0001,0.01,0.976,7169,7135
20,14404,10,100,0.0001,0.01,0.972,7222,7182
20,14504,10,100,0.0001,0.01,0.98,7277,7227
20,14604,10,100,0.0001,0.01,0.982,7323,7281
20,14704,10,100,0.0001,0.01,0.98,7375,7329
20,14804,10,100,0.0001,0.01,0.974,7416,7388
20,14904,10,100,0.0001,0.01,0.98,7465,7439
20,15004,10,100,0.0001,0.01,0.968,7515,7489
1,104,10,100,0.001,0.01,0.512,58,46
1,204,10,100,0.001,0.01,0.516,114,90
1,304,10,100,0.001,0.01,0.536,168,136
1,404,10,100,0.001,0.01,0.506,210,194
1,504,10,100,0.001,0.01,0.508,260,244
1,604,10,100,0.001,0.01,0.514,316,288
1,704,10,100,0.001,0.01,0.538,370,334
1,804,10,100,0.001,0.01,0.558,417,387
1,904,10,100,0.001,0.01,0.52,470,434
1,1004,10,100,0.001,0.01,0.522,519,485
1,1104,10,100,0.001,0.01,0.554,571,533
1,1204,10,100,0.001,0.01,0.536,621,583
1,1304,10,100,0.001,0.01,0.514,679,625
1,1404,10,100,0.001,0.01,0.546,724,680
1,1504,10,100,0.001,0.01,0.536,787,717
1,1604,10,100,0.001,0.01,0.53,840,764
1,1704,10,100,0.001,0.01,0.552,890,814
1,1804,10,100,0.001,0.01,0.536,939,865
1,1904,10,100,0.001,0.01,0.546,997,907
1,2004,10,100,0.001,0.01,0.538,1040,964
1,2104,10,100,0.001,0.01,0.544,1087,1017
1,2204,10,100,0.001,0.01,0.554,1142,1062
1,2304,10,100,0.001,0.01,0.562,1189,1115
1,2404,10,100,0.001,0.01,0.556,1236,1168
1,2504,10,100,0.001,0.01,0.572,1289,1215
1,2604,10,100,0.001,0.01,0.626,1339,1265
1,2704,10,100,0.001,0.01,0.606,1388,1316
1,2804,10,100,0.001,0.01,0.586,1437,1367
1,2904,10,100,0.001,0.01,0.658,1489,1415
1,3004,10,100,0.001,0.01,0.656,1547,1457
1,3104,10,100,0.001,0.01,0.672,1594,1510
1,3204,10,100,0.001,0.01,0.664,1645,1559
1,3304,10,100,0.001,0.01,0.688,1699,1605
1,3404,10,100,0.001,0.01,0.702,1759,1645
1,3504,10,100,0.001,0.01,0.74,1807,1697
1,3604,10,100,0.001,0.01,0.74,1856,1748
1,3704,10,100,0.001,0.01,0.772,1906,1798
1,3804,10,100,0.001,0.01,0.778,1952,1852
1,3904,10,100,0.001,0.01,0.778,1995,1909
1,4004,10,100,0.001,0.01,0.772,2043,1961
1,4104,10,100,0.001,0.01,0.772,2086,2018
1,4204,10,100,0.001,0.01,0.792,2139,2065
1,4304,10,100,0.001,0.01,0.832,2190,2114
1,4404,10,100,0.001,0.01,0.824,2242,2162
1,4504,10,100,0.001,0.01,0.836,2285,2219
1,4604,10,100,0.001,0.01,0.836,2336,2268
1,4704,10,100,0.001,0.01,0.854,2393,2311
1,4804,10,100,0.001,0.01,0.848,2439,2365
1,4904,10,100,0.001,0.01,0.856,2491,2413
1,5004,10,100,0.001,0.01,0.866,2539,2465
1,5104,10,100,0.001,0.01,0.872,2578,2526
1,5204,10,100,0.001,0.01,0.882,2625,2579
1,5304,10,100,0.001,0.01,0.906,2678,2626
1,5404,10,100,0.001,0.01,0.898,2731,2673
1,5504,10,100,0.001,0.01,0.898,2765,2739
1,5604,10,100,0.001,0.01,0.906,2812,2792
1,5704,10,100,0.001,0.01,0.904,2859,2845
1,5804,10,100,0.001,0.01,0.908,2909,2895
1,5904,10,100,0.001,0.01,0.916,2962,2942
1,6004,10,100,0.001,0.01,0.91,3009,2995
1,6104,10,100,0.001,0.01,0.912,3056,3048
1,6204,10,100,0.001,0.01,0.922,3109,3095
1,6304,10,100,0.001,0.01,0.912,3160,3144
1,6404,10,100,0.001,0.01,0.932,3206,3198
1,6504,10,100,0.001,0.01,0.922,3258,3246
1,6604,10,100,0.001,0.01,0.93,3308,3296
1,6704,10,100,0.001,0.01,0.92,3359,3345
1,6804,10,100,0.001,0.01,0.924,3418,3386
1,6904,10,100,0.001,0.01,0.928,3477,3427
1,7004,10,100,0.001,0.01,0.928,3530,3474
1,7104,10,100,0.001,0.01,0.944,3580,3524
1,7204,10,100,0.001,0.01,0.92,3634,3570
1,7304,10,100,0.001,0.01,0.91,3682,3622
1,7404,10,100,0.001,0.01,0.932,3726,3678
1,7504,10,100,0.001,0.01,0.936,3771,3733
1,7604,10,100,0.001,0.01,0.948,3817,3787
1,7704,10,100,0.001,0.01,0.958,3863,3841
1,7804,10,100,0.001,0.01,0.958,3916,3888
1,7904,10,100,0.001,0.01,0.952,3966,3938
1,8004,10,100,0.001,0.01,0.964,4009,3995
1,8104,10,100,0.001,0.01,0.958,4060,4044
1,8204,10,100,0.001,0.01,0.96,4111,4093
1,8304,10,100,0.001,0.01,0.964,4160,4144
1,8404,10,100,0.001,0.01,0.97,4213,4191
1,8504,10,100,0.001,0.01,0.964,4262,4242
1,8604,10,100,0.001,0.01,0.964,4311,4293
1,8704,10,100,0.001,0.01,0.97,4353,4351
1,8804,10,100,0.001,0.01,0.968,4407,4397
1,8904,10,100,0.001,0.01,0.964,4456,4448
1,9004,10,100,0.001,0.01,0.958,4497,4507
1,9104,10,100,0.001,0.01,0.962,4554,4550
1,9204,10,100,0.001,0.01,0.936,4602,4602
1,9304,10,100,0.001,0.01,0.966,4653,4651
1,9404,10,100,0.001,0.01,0.968,4694,4710
1,9504,10,100,0.001,0.01,0.958,4747,4757
1,9604,10,100,0.001,0.01,0.974,4795,4809
1,9704,10,100,0.001,0.01,0.976,4844,4860
1,9804,10,100,0.001,0.01,0.978,4886,4918
1,9904,10,100,0.001,0.01,0.974,4931,4973
1,10004,10,100,0.001,0.01,0.97,4980,5024
1,10104,10,100,0.001,0.01,0.976,5018,5086
1,10204,10,100,0.001,0.01,0.972,5072,5132
1,10304,10,100,0.001,0.01,0.972,5128,5176
1,10404,10,100,0.001,0.01,0.98,5167,5237
1,10504,10,100,0.001,0.01,0.988,5221,5283
1,10604,10,100,0.001,0.01,0.986,5265,5339
1,10704,10,100,0.001,0.01,0.986,5318,5386
1,10804,10,100,0.001,0.01,0.988,5375,5429
1,10904,10,100,0.001,0.01,0.978,5423,5481
1,11004,10,100,0.001,0.01,0.982,5486,5518
1,11104,10,100,0.001,0.01,0.98,5548,5556
1,11204,10,100,0.001,0.01,0.962,5606,5598
1,11304,10,100,0.001,0.01,0.976,5659,5645
1,11404,10,100,0.001,0.01,0.974,5709,5695
1,11504,10,100,0.001,0.01,0.98,5751,5753
1,11604,10,100,0.001,0.01,0.988,5802,5802
1,11704,10,100,0.001,0.01,0.99,5853,5851
1,11804,10,100,0.001,0.01,0.992,5907,5897
1,11904,10,100,0.001,0.01,0.988,5964,5940
1,12004,10,100,0.001,0.01,0.99,6023,5981
1,12104,10,100,0.001,0.01,0.986,6073,6031
1,12204,10,100,0.001,0.01,0.984,6116,6088
1,12304,10,100,0.001,0.01,0.99,6158,6146
1,12404,10,100,0.001,0.01,0.98,6211,6193
1,12504,10,100,0.001,0.01,0.978,6262,6242
1,12604,10,100,0.001,0.01,0.978,6320,6284
1,12704,10,100,0.001,0.01,0.98,6364,6340
1,12804,10,100,0.001,0.01,0.988,6415,6389
1,12904,10,100,0.001,0.01,0.99,6464,6440
1,13004,10,100,0.001,0.01,0.982,6515,6489
1,13104,10,100,0.001,0.01,0.984,6563,6541
1,13204,10,100,0.001,0.01,0.99,6613,6591
1,13304,10,100,0.001,0.01,0.988,6661,6643
1,13404,10,100,0.001,0.01,0.934,6708,6696
1,13504,10,100,0.001,0.01,0.966,6757,6747
1,13604,10,100,0.001,0.01,0.984,6809,6795
1,13704,10,100,0.001,0.01,0.994,6863,6841
1,13804,10,100,0.001,0.01,0.994,6915,6889
1,13904,10,100,0.001,0.01,0.996,6968,6936
1,14004,10,100,0.001,0.01,0.992,7023,6981
1,14104,10,100,0.001,0.01,0.99,7070,7034
1,14204,10,100,0.001,0.01,0.986,7112,7092
1,14304,10,100,0.001,0.01,0.99,7162,7142
1,14404,10,100,0.001,0.01,0.99,7208,7196
1,14504,10,100,0.001,0.01,0.992,7255,7249
1,14604,10,100,0.001,0.01,0.998,7302,7302
1,14704,10,100,0.001,0.01,0.994,7351,7353
1,14804,10,100,0.001,0.01,0.992,7397,7407
1,14904,10,100,0.001,0.01,0.982,7445,7459
1,15004,10,100,0.001,0.01,0.986,7496,7508
2,104,10,100,0.001,0.01,0.514,53,51
2,204,10,100,0.001,0.01,0.48,99,105
2,304,10,100,0.001,0.01,0.504,142,162
2,404,10,100,0.001,0.01,0.514,189,215
2,504,10,100,0.001,0.01,0.494,241,263
2,604,10,100,0.001,0.01,0.49,295,309
2,704,10,100,0.001,0.01,0.478,338,366
2,804,10,100,0.001,0.01,0.448,388,416
2,904,10,100,0.001,0.01,0.51,439,465
2,1004,10,100,0.001,0.01,0.468,489,515
2,1104,10,100,0.001,0.01,0.506,537,567
2,1204,10,100,0.001,0.01,0.49,589,615
2,1304,10,100,0.001,0.01,0.516,639,665
2,1404,10,100,0.001,0.01,0.492,689,715
2,1504,10,100,0.001,0.01,0.51,734,770
2,1604,10,100,0.001,0.01,0.498,784,820
2,1704,10,100,0.001,0.01,0.474,834,870
2,1804,10,100,0.001,0.01,0.49,885,919
2,1904,10,100,0.001,0.01,0.536,927,977
2,2004,10,100,0.001,0.01,0.502,977,1027
2,2104,10,100,0.001,0.01,0.556,1026,1078
2,2204,10,100,0.001,0.01,0.53,1079,1125
2,2304,10,100,0.001,0.01,0.582,1126,1178
2,2404,10,100,0.001,0.01,0.576,1179,1225
2,2504,10,100,0.001,0.01,0.572,1233,1271
2,2604,10,100,0.001,0.01,0.646,1282,1322
2,2704,10,100,0.001,0.01,0.694,1338,1366
2,2804,10,100,0.001,0.01,0.69,1386,1418
2,2904,10,100,0.001,0.01,0.698,1439,1465
2,3004,10,100,0.001,0.01,0.754,1492,1512
2,3104,10,100,0.001,0.01,0.786,1538,1566
2,3204,10,100,0.001,0.01,0.788,1589,1615
2,3304,10,100,0.001,0.01,0.824,1636,1668
2,3404,10,100,0.001,0.01,0.828,1681,1723
2,3504,10,100,0.001,0.01,0.848,1738,1766
2,3604,10,100,0.001,0.01,0.842,1785,1819
2,3704,10,100,0.001,0.01,0.868,1837,1867
2,3804,10,100,0.001,0.01,0.864,1891,1913
2,3904,10,100,0.001,0.01,0.884,1943,1961
2,4004,10,100,0.001,0.01,0.882,1997,2007
2,4104,10,100,0.001,0.01,0.882,2053,2051
2,4204,10,100,0.001,0.01,0.892,2100,2104
2,4304,10,100,0.001,0.01,0.888,2150,2154
2,4404,10,100,0.001,0.01,0.888,2207,2197
2,4504,10,100,0.001,0.01,0.878,2254,2250
2,4604,10,100,0.001,0.01,0.89,2303,2301
2,4704,10,100,0.001,0.01,0.906,2343,2361
2,4804,10,100,0.001,0.01,0.9,2397,2407
2,4904,10,100,0.001,0.01,0.916,2448,2456
2,5004,10,100,0.001,0.01,0.926,2509,2495
2,5104,10,100,0.001,0.01,0.922,2559,2545
2,5204,10,100,0.001,0.01,0.914,2612,2592
2,5304,10,100,0.001,0.01,0.92,2669,2635
2,5404,10,100,0.001,0.01,0.938,2725,2679
2,5504,10,100,0.001,0.01,0.926,2771,2733
2,5604,10,100,0.001,0.01,0.92,2830,2774
2,5704,10,100,0.001,0.01,0.932,2886,2818
2,5804,10,100,0.001,0.01,0.946,2935,2869
2,5904,10,100,0.001,0.01,0.934,2985,2919
2,6004,10,100,0.001,0.01,0.932,3039,2965
2,6104,10,100,0.001,0.01,0.942,3093,3011
2,6204,10,100,0.001,0.01,0.942,3140,3064
2,6304,10,100,0.001,0.01,0.946,3190,3114
2,6404,10,100,0.001,0.01,0.946,3235,3169
2,6504,10,100,0.001,0.01,0.944,3286,3218
2,6604,10,100,0.001,0.01,0.942,3334,3270
2,6704,10,100,0.001,0.01,0.946,3385,3319
2,6804,10,100,0.001,0.01,0.95,3438,3366
2,6904,10,100,0.001,0.01,0.934,3483,3421
2,7004,10,100,0.001,0.01,0.936,3526,3478
2,7104,10,100,0.001,0.01,0.946,3568,3536
2,7204,10,100,0.001,0.01,0.946,3614,3590
2,7304,10,100,0.001,0.01,0.946,3658,3646
2,7404,10,100,0.001,0.01,0.95,3707,3697
2,7504,10,100,0.001,0.01,0.962,3747,3757
2,7604,10,100,0.001,0.01,0.95,3788,3816
2,7704,10,100,0.001,0.01,0.956,3833,3871
2,7804,10,100,0.001,0.01,0.958,3877,3927
2,7904,10,100,0.001,0.01,0.958,3918,3986
2,8004,10,100,0.001,0.01,0.946,3964,4040
2,8104,10,100,0.001,0.01,0.956,4021,4083
2,8204,10,100,0.001,0.01,0.962,4073,4131
2,8304,10,100,0.001,0.01,0.954,4122,4182
2,8404,10,100,0.001,0.01,0.968,4173,4231
2,8504,10,100,0.001,0.01,0.968,4229,4275
2,8604,10,100,0.001,0.01,0.966,4280,4324
2,8704,10,100,0.001,0.01,0.962,4333,4371
2,8804,10,100,0.001,0.01,0.952,4385,4419
2,8904,10,100,0.001,0.01,0.96,4430,4474
2,9004,10,100,0.001,0.01,0.98,4486,4518
2,9104,10,100,0.001,0.01,0.978,4536,4568
2,9204,10,100,0.001,0.01,0.976,4593,4611
2,9304,10,100,0.001,0.01,0.962,4639,4665
2,9404,10,100,0.001,0.01,0.97,4695,4709
2,9504,10,100,0.001,0.01,0.968,4752,4752
2,9604,10,100,0.001,0.01,0.972,4808,4796
2,9704,10,100,0.001,0.01,0.978,4863,4841
2,9804,10,100,0.001,0.01,0.962,4913,4891
2,9904,10,100,0.001,0.01,0.97,4964,4940
2,10004,10,100,0.001,0.01,0.972,5009,4995
2,10104,10,100,0.001,0.01,0.976,5073,5031
2,10204,10,100,0.001,0.01,0.978,5124,5080
2,10304,10,100,0.001,0.01,0.98,5177,5127
2,10404,10,100,0.001,0.01,0.98,5225,5179
2,10504,10,100,0.001,0.01,0.982,5289,5215
2,10604,10,100,0.001,0.01,0.98,5341,5263
2,10704,10,100,0.001,0.01,0.982,5390,5314
2,10804,10,100,0.001,0.01,0.976,5430,5374
2,10904,10,100,0.001,0.01,0.976,5475,5429
2,11004,10,100,0.001,0.01,0.982,5524,5480
2,11104,10,100,0.001,0.01,0.976,5570,5534
2,11204,10,100,0.001,0.01,0.976,5617,5587
2,11304,10,100,0.001,0.01,0.96,5667,5637
2,11404,10,100,0.001,0.01,0.964,5717,5687
2,11504,10,100,0.001,0.01,0.98,5763,5741
2,11604,10,100,0.001,0.01,0.984,5805,5799
2,11704,10,100,0.001,0.01,0.986,5857,5847
2,11804,10,100,0.001,0.01,0.98,5903,5901
2,11904,10,100,0.001,0.01,0.982,5950,5954
2,12004,10,100,0.001,0.01,0.98,6001,6003
2,12104,10,100,0.001,0.01,0.982,6050,6054
2,12204,10,100,0.001,0.01,0.984,6100,6104
2,12304,10,100,0.001,0.01,0.98,6152,6152
2,12404,10,100,0.001,0.01,0.982,6202,6202
2,12504,10,100,0.001,0.01,0.982,6252,6252
2,12604,10,100,0.001,0.01,0.98,6302,6302
2,12704,10,100,0.001,0.01,0.978,6353,6351
2,12804,10,100,0.001,0.01,0.988,6411,6393
2,12904,10,100,0.001,0.01,0.986,6464,6440
2,13004,10,100,0.001,0.01,0.982,6508,6496
2,13104,10,100,0.001,0.01,0.988,6556,6548
2,13204,10,100,0.001,0.01,0.984,6604,6600
2,13304,10,100,0.001,0.01,0.984,6662,6642
2,13404,10,100,0.001,0.01,0.98,6716,6688
2,13504,10,100,0.001,0.01,0.978,6768,6736
2,13604,10,100,0.001,0.01,0.982,6821,6783
2,13704,10,100,0.001,0.01,0.982,6878,6826
2,13804,10,100,0.001,0.01,0.984,6934,6870
2,13904,10,100,0.001,0.01,0.982,6984,6920
2,14004,10,100,0.001,0.01,0.982,7029,6975
2,14104,10,100,0.001,0.01,0.982,7075,7029
2,14204,10,100,0.001,0.01,0.988,7130,7074
2,14304,10,100,0.001,0.01,0.986,7180,7124
2,14404,10,100,0.001,0.01,0.988,7237,7167
2,14504,10,100,0.001,0.01,0.99,7278,7226
2,14604,10,100,0.001,0.01,0.988,7329,7275
2,14704,10,100,0.001,0.01,0.982,7374,7330
2,14804,10,100,0.001,0.01,0.986,7414,7390
2,14904,10,100,0.001,0.01,0.982,7466,7438
2,15004,10,100,0.001,0.01,0.986,7510,7494
3,104,10,100,0.001,0.01,0.476,59,45
3,204,10,100,0.001,0.01,0.474,106,98
3,304,10,100,0.001,0.01,0.488,163,141
3,404,10,100,0.001,0.01,0.514,214,190
3,504,10,100,0.001,0.01,0.496,264,240
3,604,10,100,0.001,0.01,0.462,312,292
3,704,10,100,0.001,0.01,0.486,360,344
3,804,10,100,0.001,0.01,0.474,415,389
3,904,10,100,0.001,0.01,0.49,467,437
3,1004,10,100,0.001,0.01,0.48,513,491
3,1104,10,100,0.001,0.01,0.534,556,548
3,1204,10,100,0.001,0.01,0.548,604,600
3,1304,10,100,0.001,0.01,0.564,653,651
3,1404,10,100,0.001,0.01,0.556,694,710
3,1504,10,100,0.001,0.01,0.574,739,765
3,1604,10,100,0.001,0.01,0.61,796,808
3,1704,10,100,0.001,0.01,0.6,841,863
3,1804,10,100,0.001,0.01,0.642,889,915
3,1904,10,100,0.001,0.01,0.632,949,955
3,2004,10,100,0.001,0.01,0.594,1001,1003
3,2104,10,100,0.001,0.01,0.676,1047,1057
3,2204,10,100,0.001,0.01,0.68,1104,1100
3,2304,10,100,0.001,0.01,0.71,1156,1148
3,2404,10,100,0.001,0.01,0.718,1209,1195
3,2504,10,100,0.001,0.01,0.72,1257,1247
3,2604,10,100,0.001,0.01,0.776,1310,1294
3,2704,10,100,0.001,0.01,0.744,1372,1332
3,2804,10,100,0.001,0.01,0.764,1417,1387
3,2904,10,100,0.001,0.01,0.738,1472,1432
3,3004,10,100,0.001,0.01,0.766,1526,1478
3,3104,10,100,0.001,0.01,0.78,1569,1535
3,3204,10,100,0.001,0.01,0.758,1613,1591
3,3304,10,100,0.001,0.01,0.782,1673,1631
3,3404,10,100,0.001,0.01,0.796,1731,1673
3,3504,10,100,0.001,0.01,0.812,1782,1722
3,3604,10,100,0.001,0.01,0.82,1826,1778
3,3704,10,100,0.001,0.01,0.796,1875,1829
3,3804,10,100,0.001,0.01,0.798,1928,1876
3,3904,10,100,0.001,0.01,0.794,1981,1923
3,4004,10,100,0.001,0.01,0.768,2027,1977
3,4104,10,100,0.001,0.01,0.802,2079,2025
3,4204,10,100,0.001,0.01,0.81,2135,2069
3,4304,10,100,0.001,0.01,0.832,2189,2115
3,4404,10,100,0.001,0.01,0.822,2238,2166
3,4504,10,100,0.001,0.01,0.818,2290,2214
3,4604,10,100,0.001,0.01,0.858,2337,2267
3,4704,10,100,0.001,0.01,0.822,2386,2318
3,4804,10,100,0.001,0.01,0.796,2430,2374
3,4904,10,100,0.001,0.01,0.83,2483,2421
3,5004,10,100,0.001,0.01,0.846,2527,2477
3,5104,10,100,0.001,0.01,0.874,2577,2527
3,5204,10,100,0.001,0.01,0.854,2621,2583
3,5304,10,100,0.001,0.01,0.882,2674,2630
3,5404,10,100,0.001,0.01,0.854,2717,2687
3,5504,10,100,0.001,0.01,0.862,2779,2725
3,5604,10,100,0.001,0.01,0.85,2825,2779
3,5704,10,100,0.001,0.01,0.86,2872,2832
3,5804,10,100,0.001,0.01,0.862,2915,2889
3,5904,10,100,0.001,0.01,0.896,2958,2946
3,6004,10,100,0.001,0.01,0.886,3006,2998
3,6104,10,100,0.001,0.01,0.894,3053,3051
3,6204,10,100,0.001,0.01,0.906,3094,3110
3,6304,10,100,0.001,0.01,0.906,3149,3155
3,6404,10,100,0.001,0.01,0.898,3207,3197
3,6504,10,100,0.001,0.01,0.896,3248,3256
3,6604,10,100,0.001,0.01,0.884,3300,3304
3,6704,10,100,0.001,0.01,0.922,3353,3351
3,6804,10,100,0.001,0.01,0.856,3412,3392
3,6904,10,100,0.001,0.01,0.926,3460,3444
3,7004,10,100,0.001,0.01,0.916,3498,3506
3,7104,10,100,0.001,0.01,0.93,3554,3550
3,7204,10,100,0.001,0.01,0.944,3608,3596
3,7304,10,100,0.001,0.01,0.934,3666,3638
3,7404,10,100,0.001,0.01,0.896,3719,3685
3,7504,10,100,0.001,0.01,0.908,3779,3725
3,7604,10,100,0.001,0.01,0.918,3819,3785
3,7704,10,100,0.001,0.01,0.918,3874,3830
3,7804,10,100,0.001,0.01,0.932,3924,3880
3,7904,10,100,0.001,0.01,0.94,3982,3922
3,8004,10,100,0.001,0.01,0.896,4039,3965
3,8104,10,100,0.001,0.01,0.936,4086,4018
3,8204,10,100,0.001,0.01,0.936,4137,4067
3,8304,10,100,0.001,0.01,0.942,4178,4126
3,8404,10,100,0.001,0.01,0.932,4228,4176
3,8504,10,100,0.001,0.01,0.934,4282,4222
3,8604,10,100,0.001,0.01,0.886,4334,4270
3,8704,10,100,0.001,0.01,0.898,4377,4327
3,8804,10,100,0.001,0.01,0.906,4428,4376
3,8904,10,100,0.001,0.01,0.94,4483,4421
3,9004,10,100,0.001,0.01,0.93,4542,4462
3,9104,10,100,0.001,0.01,0.934,4590,4514
3,9204,10,100,0.001,0.01,0.94,4641,4563
3,9304,10,100,0.001,0.01,0.95,4692,4612
3,9404,10,100,0.001,0.01,0.868,4737,4667
3,9504,10,100,0.001,0.01,0.936,4786,4718
3,9604,10,100,0.001,0.01,0.95,4836,4768
3,9704,10,100,0.001,0.01,0.958,4882,4822
3,9804,10,100,0.001,0.01,0.954,4928,4876
3,9904,10,100,0.001,0.01,0.962,4982,4922
3,10004,10,100,0.001,0.01,0.958,5038,4966
3,10104,10,100,0.001,0.01,0.952,5087,5017
3,10204,10,100,0.001,0.01,0.96,5134,5070
3,10304,10,100,0.001,0.01,0.958,5181,5123
3,10404,10,100,0.001,0.01,0.918,5232,5172
3,10504,10,100,0.001,0.01,0.946,5282,5222
3,10604,10,100,0.001,0.01,0.944,5322,5282
3,10704,10,100,0.001,0.01,0.958,5373,5331
3,10804,10,100,0.001,0.01,0.964,5417,5387
3,10904,10,100,0.001,0.01,0.956,5464,5440
3,11004,10,100,0.001,0.01,0.962,5510,5494
3,11104,10,100,0.001,0.01,0.946,5564,5540
3,11204,10,100,0.001,0.01,0.908,5610,5594
3,11304,10,100,0.001,0.01,0.96,5657,5647
3,11404,10,100,0.001,0.01,0.958,5711,5693
3,11504,10,100,0.001,0.01,0.946,5757,5747
3,11604,10,100,0.001,0.01,0.954,5815,5789
3,11704,10,100,0.001,0.01,0.958,5871,5833
3,11804,10,100,0.001,0.01,0.96,5920,5884
3,11904,10,100,0.001,0.01,0.96,5963,5941
3,12004,10,100,0.001,0.01,0.936,6011,5993
3,12104,10,100,0.001,0.01,0.962,6057,6047
3,12204,10,100,0.001,0.01,0.97,6104,6100
3,12304,10,100,0.001,0.01,0.964,6154,6150
3,12404,10,100,0.001,0.01,0.926,6210,6194
3,12504,10,100,0.001,0.01,0.954,6261,6243
3,12604,10,100,0.001,0.01,0.974,6309,6295
3,12704,10,100,0.001,0.01,0.964,6355,6349
3,12804,10,100,0.001,0.01,0.96,6403,6401
3,12904,10,100,0.001,0.01,0.97,6458,6446
3,13004,10,100,0.001,0.01,0.96,6514,6490
3,13104,10,100,0.001,0.01,0.972,6561,6543
3,13204,10,100,0.001,0.01,0.966,6616,6588
3,13304,10,100,0.001,0.01,0.968,6663,6641
3,13404,10,100,0.001,0.01,0.958,6715,6689
3,13504,10,100,0.001,0.01,0.972,6760,6744
3,13604,10,100,0.001,0.01,0.96,6815,6789
3,13704,10,100,0.001,0.01,0.972,6861,6843
3,13804,10,100,0.001,0.01,0.976,6902,6902
3,13904,10,100,0.001,0.01,0.974,6948,6956
3,14004,10,100,0.001,0.01,0.968,6994,7010
3,14104,10,100,0.001,0.01,0.962,7049,7055
3,14204,10,100,0.001,0.01,0.97,7100,7104
3,14304,10,100,0.001,0.01,0.962,7145,7159
3,14404,10,100,0.001,0.01,0.974,7193,7211
3,14504,10,100,0.001,0.01,0.968,7249,7255
3,14604,10,100,0.001,0.01,0.978,7308,7296
3,14704,10,100,0.001,0.01,0.98,7355,7349
3,14804,10,100,0.001,0.01,0.98,7407,7397
3,14904,10,100,0.001,0.01,0.978,7460,7444
3,15004,10,100,0.001,0.01,0.976,7508,7496
4,104,10,100,0.001,0.01,0.452,54,50
4,204,10,100,0.001,0.01,0.52,104,100
4,304,10,100,0.001,0.01,0.518,157,147
4,404,10,100,0.001,0.01,0.488,208,196
4,504,10,100,0.001,0.01,0.488,266,238
4,604,10,100,0.001,0.01,0.508,311,293
4,704,10,100,0.001,0.01,0.49,359,345
4,804,10,100,0.001,0.01,0.486,417,387
4,904,10,100,0.001,0.01,0.468,465,439
4,1004,10,100,0.001,0.01,0.484,519,485
4,1104,10,100,0.001,0.01,0.472,572,532
4,1204,10,100,0.001,0.01,0.486,616,588
4,1304,10,100,0.001,0.01,0.502,672,632
4,1404,10,100,0.001,0.01,0.498,727,677
4,1504,10,100,0.001,0.01,0.496,780,724
4,1604,10,100,0.001,0.01,0.49,820,784
4,1704,10,100,0.001,0.01,0.52,866,838
4,1804,10,100,0.001,0.01,0.508,916,888
4,1904,10,100,0.001,0.01,0.506,970,934
4,2004,10,100,0.001,0.01,0.53,1016,988
4,2104,10,100,0.001,0.01,0.566,1069,1035
4,2204,10,100,0.001,0.01,0.56,1126,1078
4,2304,10,100,0.001,0.01,0.576,1167,1137
4,2404,10,100,0.001,0.01,0.626,1226,1178
4,2504,10,100,0.001,0.01,0.636,1276,1228
4,2604,10,100,0.001,0.01,0.67,1324,1280
4,2704,10,100,0.001,0.01,0.74,1376,1328
4,2804,10,100,0.001,0.01,0.776,1428,1376
4,2904,10,100,0.001,0.01,0.806,1475,1429
4,3004,10,100,0.001,0.01,0.834,1522,1482
4,3104,10,100,0.001,0.01,0.828,1569,1535
4,3204,10,100,0.001,0.01,0.838,1612,1592
4,3304,10,100,0.001,0.01,0.854,1670,1634
4,3404,10,100,0.001,0.01,0.85,1714,1690
4,3504,10,100,0.001,0.01,0.862,1767,1737
4,3604,10,100,0.001,0.01,0.884,1816,1788
4,3704,10,100,0.001,0.01,0.886,1872,1832
4,3804,10,100,0.001,0.01,0.902,1921,1883
4,3904,10,100,0.001,0.01,0.896,1972,1932
4,4004,10,100,0.001,0.01,0.902,2023,1981
4,4104,10,100,0.001,0.01,0.89,2078,2026
4,4204,10,100,0.001,0.01,0.892,2128,2076
4,4304,10,100,0.001,0.01,0.91,2175,2129
4,4404,10,100,0.001,0.01,0.914,2234,2170
4,4504,10,100,0.001,0.01,0.914,2283,2221
4,4604,10,100,0.001,0.01,0.916,2336,2268
4,4704,10,100,0.001,0.01,0.886,2386,2318
4,4804,10,100,0.001,0.01,0.914,2437,2367
4,4904,10,100,0.001,0.01,0.882,2491,2413
4,5004,10,100,0.001,0.01,0.932,2538,2466
4,5104,10,100,0.001,0.01,0.936,2583,2521
4,5204,10,100,0.001,0.01,0.946,2642,2562
4,5304,10,100,0.001,0.01,0.94,2693,2611
4,5404,10,100,0.001,0.01,0.954,2747,2657
4,5504,10,100,0.001,0.01,0.95,2795,2709
4,5604,10,100,0.001,0.01,0.958,2848,2756
4,5704,10,100,0.001,0.01,0.948,2884,2820
4,5804,10,100,0.001,0.01,0.948,2938,2866
4,5904,10,100,0.001,0.01,0.942,2993,2911
4,6004,10,100,0.001,0.01,0.942,3033,2971
4,6104,10,100,0.001,0.01,0.948,3071,3033
4,6204,10,100,0.001,0.01,0.944,3118,3086
4,6304,10,100,0.001,0.01,0.924,3163,3141
4,6404,10,100,0.001,0.01,0.944,3215,3189
4,6504,10,100,0.001,0.01,0.938,3264,3240
4,6604,10,100,0.001,0.01,0.948,3326,3278
4,6704,10,100,0.001,0.01,0.952,3377,3327
4,6804,10,100,0.001,0.01,0.948,3433,3371
4,6904,10,100,0.001,0.01,0.952,3485,3419
4,7004,10,100,0.001,0.01,0.95,3539,3465
4,7104,10,100,0.001,0.01,0.962,3593,3511
4,7204,10,100,0.001,0.01,0.958,3643,3561
4,7304,10,100,0.001,0.01,0.954,3690,3614
4,7404,10,100,0.001,0.01,0.962,3737,3667
4,7504,10,100,0.001,0.01,0.958,3789,3715
4,7604,10,100,0.001,0.01,0.952,3842,3762
4,7704,10,100,0.001,0.01,0.968,3892,3812
4,7804,10,100,0.001,0.01,0.968,3941,3863
4,7904,10,100,0.001,0.01,0.962,3997,3907
4,8004,10,100,0.001,0.01,0.966,4044,3960
4,8104,10,100,0.001,0.01,0.968,4091,4013
4,8204,10,100,0.001,0.01,0.966,4138,4066
4,8304,10,100,0.001,0.01,0.962,4200,4104
4,8404,10,100,0.001,0.01,0.96,4243,4161
4,8504,10,100,0.001,0.01,0.962,4306,4198
4,8604,10,100,0.001,0.01,0.944,4360,4244
4,8704,10,100,0.001,0.01,0.966,4411,4293
4,8804,10,100,0.001,0.01,0.958,4461,4343
4,8904,10,100,0.001,0.01,0.96,4515,4389
4,9004,10,100,0.001,0.01,0.974,4560,4444
4,9104,10,100,0.001,0.01,0.974,4605,4499
4,9204,10,100,0.001,0.01,0.972,4655,4549
4,9304,10,100,0.001,0.01,0.966,4706,4598
4,9404,10,100,0.001,0.01,0.978,4754,4650
4,9504,10,100,0.001,0.01,0.97,4803,4701
4,9604,10,100,0.001,0.01,0.972,4850,4754
4,9704,10,100,0.001,0.01,0.964,4898,4806
4,9804,10,100,0.001,0.01,0.952,4940,4864
4,9904,10,100,0.001,0.01,0.97,4990,4914
4,10004,10,100,0.001,0.01,0.974,5042,4962
4,10104,10,100,0.001,0.01,0.972,5096,5008
4,10204,10,100,0.001,0.01,0.972,5150,5054
4,10304,10,100,0.001,0.01,0.984,5192,5112
4,10404,10,100,0.001,0.01,0.974,5242,5162
4,10504,10,100,0.001,0.01,0.978,5291,5213
4,10604,10,100,0.001,0.01,0.974,5340,5264
4,10704,10,100,0.001,0.01,0.978,5381,5323
4,10804,10,100,0.001,0.01,0.974,5426,5378
4,10904,10,100,0.001,0.01,0.95,5477,5427
4,11004,10,100,0.001,0.01,0.97,5529,5475
4,11104,10,100,0.001,0.01,0.984,5576,5528
4,11204,10,100,0.001,0.01,0.98,5630,5574
4,11304,10,100,0.001,0.01,0.982,5678,5626
4,11404,10,100,0.001,0.01,0.986,5735,5669
4,11504,10,100,0.001,0.01,0.986,5779,5725
4,11604,10,100,0.001,0.01,0.986,5823,5781
4,11704,10,100,0.001,0.01,0.984,5867,5837
4,11804,10,100,0.001,0.01,0.984,5923,5881
4,11904,10,100,0.001,0.01,0.978,5978,5926
4,12004,10,100,0.001,0.01,0.968,6022,5982
4,12104,10,100,0.001,0.01,0.976,6070,6034
4,12204,10,100,0.001,0.01,0.984,6110,6094
4,12304,10,100,0.001,0.01,0.98,6153,6151
4,12404,10,100,0.001,0.01,0.986,6202,6202
4,12504,10,100,0.001,0.01,0.99,6252,6252
4,12604,10,100,0.001,0.01,0.984,6299,6305
4,12704,10,100,0.001,0.01,0.982,6348,6356
4,12804,10,100,0.001,0.01,0.988,6406,6398
4,12904,10,100,0.001,0.01,0.99,6464,6440
4,13004,10,100,0.001,0.01,0.988,6517,6487
4,13104,10,100,0.001,0.01,0.992,6557,6547
4,13204,10,100,0.001,0.01,0.988,6607,6597
4,13304,10,100,0.001,0.01,0.99,6660,6644
4,13404,10,100,0.001,0.01,0.984,6711,6693
4,13504,10,100,0.001,0.01,0.986,6757,6747
4,13604,10,100,0.001,0.01,0.986,6798,6806
4,13704,10,100,0.001,0.01,0.98,6847,6857
4,13804,10,100,0.001,0.01,0.974,6894,6910
4,13904,10,100,0.001,0.01,0.988,6947,6957
4,14004,10,100,0.001,0.01,0.982,6999,7005
4,14104,10,100,0.001,0.01,0.992,7053,7051
4,14204,10,100,0.001,0.01,0.994,7107,7097
4,14304,10,100,0.001,0.01,0.99,7149,7155
4,14404,10,100,0.001,0.01,0.988,7205,7199
4,14504,10,100,0.001,0.01,0.988,7258,7246
4,14604,10,100,0.001,0.01,0.992,7314,7290
4,14704,10,100,0.001,0.01,0.982,7365,7339
4,14804,10,100,0.001,0.01,0.982,7416,7388
4,14904,10,100,0.001,0.01,0.984,7477,7427
4,15004,10,100,0.001,0.01,0.99,7526,7478
5,104,10,100,0.001,0.01,0.494,51,53
5,204,10,100,0.001,0.01,0.486,96,108
5,304,10,100,0.001,0.01,0.48,154,150
5,404,10,100,0.001,0.01,0.506,210,194
5,504,10,100,0.001,0.01,0.49,268,236
5,604,10,100,0.001,0.01,0.46,320,284
5,704,10,100,0.001,0.01,0.474,373,331
5,804,10,100,0.001,0.01,0.474,432,372
5,904,10,100,0.001,0.01,0.5,475,429
5,1004,10,100,0.001,0.01,0.478,528,476
5,1104,10,100,0.001,0.01,0.504,580,524
5,1204,10,100,0.001,0.01,0.482,625,579
5,1304,10,100,0.001,0.01,0.514,673,631
5,1404,10,100,0.001,0.01,0.51,719,685
5,1504,10,100,0.001,0.01,0.502,770,734
5,1604,10,100,0.001,0.01,0.498,820,784
5,1704,10,100,0.001,0.01,0.512,867,837
5,1804,10,100,0.001,0.01,0.536,913,891
5,1904,10,100,0.001,0.01,0.556,960,944
5,2004,10,100,0.001,0.01,0.598,1016,988
5,2104,10,100,0.001,0.01,0.582,1067,1037
5,2204,10,100,0.001,0.01,0.618,1113,1091
5,2304,10,100,0.001,0.01,0.642,1168,1136
5,2404,10,100,0.001,0.01,0.698,1219,1185
5,2504,10,100,0.001,0.01,0.698,1260,1244
5,2604,10,100,0.001,0.01,0.742,1315,1289
5,2704,10,100,0.001,0.01,0.754,1354,1350
5,2804,10,100,0.001,0.01,0.782,1414,1390
5,2904,10,100,0.001,0.01,0.82,1467,1437
5,3004,10,100,0.001,0.01,0.8,1518,1486
5,3104,10,100,0.001,0.01,0.81,1571,1533
5,3204,10,100,0.001,0.01,0.822,1626,1578
5,3304,10,100,0.001,0.01,0.854,1680,1624
5,3404,10,100,0.001,0.01,0.856,1727,1677
5,3504,10,100,0.001,0.01,0.88,1782,1722
5,3604,10,100,0.001,0.01,0.868,1834,1770
5,3704,10,100,0.001,0.01,0.878,1884,1820
5,3804,10,100,0.001,0.01,0.878,1930,1874
5,3904,10,100,0.001,0.01,0.89,1973,1931
5,4004,10,100,0.001,0.01,0.882,2024,1980
5,4104,10,100,0.001,0.01,0.894,2077,2027
5,4204,10,100,0.001,0.01,0.884,2118,2086
5,4304,10,100,0.001,0.01,0.896,2168,2136
5,4404,10,100,0.001,0.01,0.904,2227,2177
5,4504,10,100,0.001,0.01,0.89,2278,2226
5,4604,10,100,0.001,0.01,0.902,2323,2281
5,4704,10,100,0.001,0.01,0.92,2375,2329
5,4804,10,100,0.001,0.01,0.912,2426,2378
5,4904,10,100,0.001,0.01,0.926,2481,2423
5,5004,10,100,0.001,0.01,0.912,2528,2476
5,5104,10,100,0.001,0.01,0.938,2570,2534
5,5204,10,100,0.001,0.01,0.916,2619,2585
5,5304,10,100,0.001,0.01,0.926,2657,2647
5,5404,10,100,0.001,0.01,0.92,2708,2696
5,5504,10,100,0.001,0.01,0.93,2764,2740
5,5604,10,100,0.001,0.01,0.942,2812,2792
5,5704,10,100,0.001,0.01,0.932,2863,2841
5,5804,10,100,0.001,0.01,0.946,2905,2899
5,5904,10,100,0.001,0.01,0.946,2961,2943
5,6004,10,100,0.001,0.01,0.94,3012,2992
5,6104,10,100,0.001,0.01,0.916,3068,3036
5,6204,10,100,0.001,0.01,0.946,3113,3091
5,6304,10,100,0.001,0.01,0.954,3166,3138
5,6404,10,100,0.001,0.01,0.952,3211,3193
5,6504,10,100,0.001,0.01,0.954,3256,3248
5,6604,10,100,0.001,0.01,0.946,3307,3297
5,6704,10,100,0.001,0.01,0.952,3351,3353
5,6804,10,100,0.001,0.01,0.96,3397,3407
5,6904,10,100,0.001,0.01,0.962,3451,3453
5,7004,10,100,0.001,0.01,0.966,3496,3508
5,7104,10,100,0.001,0.01,0.962,3537,3567
5,7204,10,100,0.001,0.01,0.956,3583,3621
5,7304,10,100,0.001,0.01,0.968,3638,3666
5,7404,10,100,0.001,0.01,0.96,3680,3724
5,7504,10,100,0.001,0.01,0.968,3732,3772
5,7604,10,100,0.001,0.01,0.96,3789,3815
5,7704,10,100,0.001,0.01,0.97,3846,3858
5,7804,10,100,0.001,0.01,0.96,3900,3904
5,7904,10,100,0.001,0.01,0.952,3947,3957
5,8004,10,100,0.001,0.01,0.958,3997,4007
5,8104,10,100,0.001,0.01,0.972,4049,4055
5,8204,10,100,0.001,0.01,0.972,4098,4106
5,8304,10,100,0.001,0.01,0.968,4143,4161
5,8404,10,100,0.001,0.01,0.968,4190,4214
5,8504,10,100,0.001,0.01,0.972,4242,4262
5,8604,10,100,0.001,0.01,0.97,4293,4311
5,8704,10,100,0.001,0.01,0.972,4345,4359
5,8804,10,100,0.001,0.01,0.97,4394,4410
5,8904,10,100,0.001,0.01,0.964,4439,4465
5,9004,10,100,0.001,0.01,0.968,4493,4511
5,9104,10,100,0.001,0.01,0.974,4549,4555
5,9204,10,100,0.001,0.01,0.974,4604,4600
5,9304,10,100,0.001,0.01,0.976,4652,4652
5,9404,10,100,0.001,0.01,0.974,4698,4706
5,9504,10,100,0.001,0.01,0.968,4748,4756
5,9604,10,100,0.001,0.01,0.968,4800,4804
5,9704,10,100,0.001,0.01,0.972,4855,4849
5,9804,10,100,0.001,0.01,0.956,4907,4897
5,9904,10,100,0.001,0.01,0.972,4949,4955
5,10004,10,100,0.001,0.01,0.97,4995,5009
5,10104,10,100,0.001,0.01,0.97,5039,5065
5,10204,10,100,0.001,0.01,0.974,5094,5110
5,10304,10,100,0.001,0.01,0.976,5144,5160
5,10404,10,100,0.001,0.01,0.974,5198,5206
5,10504,10,100,0.001,0.01,0.978,5255,5249
5,10604,10,100,0.001,0.01,0.982,5315,5289
5,10704,10,100,0.001,0.01,0.982,5363,5341
5,10804,10,100,0.001,0.01,0.982,5420,5384
5,10904,10,100,0.001,0.01,0.982,5474,5430
5,11004,10,100,0.001,0.01,0.978,5525,5479
5,11104,10,100,0.001,0.01,0.978,5575,5529
5,11204,10,100,0.001,0.01,0.978,5626,5578
5,11304,10,100,0.001,0.01,0.98,5668,5636
5,11404,10,100,0.001,0.01,0.964,5720,5684
5,11504,10,100,0.001,0.01,0.974,5775,5729
5,11604,10,100,0.001,0.01,0.976,5822,5782
5,11704,10,100,0.001,0.01,0.976,5861,5843
5,11804,10,100,0.001,0.01,0.984,5909,5895
5,11904,10,100,0.001,0.01,0.982,5967,5937
5,12004,10,100,0.001,0.01,0.982,6015,5989
5,12104,10,100,0.001,0.01,0.98,6078,6026
5,12204,10,100,0.001,0.01,0.984,6133,6071
5,12304,10,100,0.001,0.01,0.976,6175,6129
5,12404,10,100,0.001,0.01,0.984,6234,6170
5,12504,10,100,0.001,0.01,0.982,6278,6226
5,12604,10,100,0.001,0.01,0.986,6330,6274
5,12704,10,100,0.001,0.01,0.978,6383,6321
5,12804,10,100,0.001,0.01,0.98,6422,6382
5,12904,10,100,0.001,0.01,0.986,6463,6441
5,13004,10,100,0.001,0.01,0.982,6510,6494
5,13104,10,100,0.001,0.01,0.982,6555,6549
5,13204,10,100,0.001,0.01,0.98,6604,6600
5,13304,10,100,0.001,0.01,0.98,6651,6653
5,13404,10,100,0.001,0.01,0.982,6694,6710
5,13504,10,100,0.001,0.01,0.98,6742,6762
5,13604,10,100,0.001,0.01,0.972,6793,6811
5,13704,10,100,0.001,0.01,0.978,6846,6858
5,13804,10,100,0.001,0.01,0.972,6888,6916
5,13904,10,100,0.001,0.01,0.982,6943,6961
5,14004,10,100,0.001,0.01,0.984,6986,7018
5,14104,10,100,0.001,0.01,0.99,7036,7068
5,14204,10,100,0.001,0.01,0.986,7081,7123
5,14304,10,100,0.001,0.01,0.986,7143,7161
5,14404,10,100,0.001,0.01,0.984,7190,7214
5,14504,10,100,0.001,0.01,0.984,7243,7261
5,14604,10,100,0.001,0.01,0.982,7295,7309
5,14704,10,100,0.001,0.01,0.98,7354,7350
5,14804,10,100,0.001,0.01,0.982,7402,7402
5,14904,10,100,0.001,0.01,0.982,7454,7450
5,15004,10,100,0.001,0.01,0.984,7499,7505
6,104,10,100,0.001,0.01,0.488,45,59
6,204,10,100,0.001,0.01,0.476,97,107
6,304,10,100,0.001,0.01,0.496,152,152
6,404,10,100,0.001,0.01,0.482,206,198
6,504,10,100,0.001,0.01,0.484,263,241
6,604,10,100,0.001,0.01,0.49,308,296
6,704,10,100,0.001,0.01,0.492,353,351
6,804,10,100,0.001,0.01,0.472,402,402
6,904,10,100,0.001,0.01,0.474,452,452
6,1004,10,100,0.001,0.01,0.508,509,495
6,1104,10,100,0.001,0.01,0.506,554,550
6,1204,10,100,0.001,0.01,0.512,598,606
6,1304,10,100,0.001,0.01,0.514,651,653
6,1404,10,100,0.001,0.01,0.51,697,707
6,1504,10,100,0.001,0.01,0.526,749,755
6,1604,10,100,0.001,0.01,0.542,798,806
6,1704,10,100,0.001,0.01,0.528,839,865
6,1804,10,100,0.001,0.01,0.558,884,920
6,1904,10,100,0.001,0.01,0.56,938,966
6,2004,10,100,0.001,0.01,0.576,989,1015
6,2104,10,100,0.001,0.01,0.612,1040,1064
6,2204,10,100,0.001,0.01,0.582,1092,1112
6,2304,10,100,0.001,0.01,0.658,1141,1163
6,2404,10,100,0.001,0.01,0.686,1197,1207
6,2504,10,100,0.001,0.01,0.694,1249,1255
6,2604,10,100,0.001,0.01,0.686,1295,1309
6,2704,10,100,0.001,0.01,0.754,1350,1354
6,2804,10,100,0.001,0.01,0.768,1400,1404
6,2904,10,100,0.001,0.01,0.728,1454,1450
6,3004,10,100,0.001,0.01,0.794,1508,1496
6,3104,10,100,0.001,0.01,0.81,1553,1551
6,3204,10,100,0.001,0.01,0.834,1600,1604
6,3304,10,100,0.001,0.01,0.836,1642,1662
6,3404,10,100,0.001,0.01,0.848,1696,1708
6,3504,10,100,0.001,0.01,0.852,1746,1758
6,3604,10,100,0.001,0.01,0.86,1791,1813
6,3704,10,100,0.001,0.01,0.862,1839,1865
6,3804,10,100,0.001,0.01,0.878,1891,1913
6,3904,10,100,0.001,0.01,0.88,1944,1960
6,4004,10,100,0.001,0.01,0.872,1993,2011
6,4104,10,100,0.001,0.01,0.88,2040,2064
6,4204,10,100,0.001,0.01,0.868,2098,2106
6,4304,10,100,0.001,0.01,0.894,2145,2159
6,4404,10,100,0.001,0.01,0.896,2187,2217
6,4504,10,100,0.001,0.01,0.888,2241,2263
6,4604,10,100,0.001,0.01,0.904,2301,2303
6,4704,10,100,0.001,0.01,0.906,2350,2354
6,4804,10,100,0.001,0.01,0.892,2398,2406
6,4904,10,100,0.001,0.01,0.916,2450,2454
6,5004,10,100,0.001,0.01,0.904,2496,2508
6,5104,10,100,0.001,0.01,0.892,2544,2560
6,5204,10,100,0.001,0.01,0.908,2598,2606
6,5304,10,100,0.001,0.01,0.934,2642,2662
6,5404,10,100,0.001,0.01,0.934,2684,2720
6,5504,10,100,0.001,0.01,0.928,2733,2771
6,5604,10,100,0.001,0.01,0.918,2786,2818
6,5704,10,100,0.001,0.01,0.934,2838,2866
6,5804,10,100,0.001,0.01,0.912,2892,2912
6,5904,10,100,0.001,0.01,0.924,2940,2964
6,6004,10,100,0.001,0.01,0.916,2980,3024
6,6104,10,100,0.001,0.01,0.938,3031,3073
6,6204,10,100,0.001,0.01,0.94,3077,3127
6,6304,10,100,0.001,0.01,0.94,3121,3183
6,6404,10,100,0.001,0.01,0.942,3167,3237
6,6504,10,100,0.001,0.01,0.942,3215,3289
6,6604,10,100,0.001,0.01,0.928,3264,3340
6,6704,10,100,0.001,0.01,0.938,3313,3391
6,6804,10,100,0.001,0.01,0.944,3368,3436
6,6904,10,100,0.001,0.01,0.938,3420,3484
6,7004,10,100,0.001,0.01,0.942,3471,3533
6,7104,10,100,0.001,0.01,0.94,3519,3585
6,7204,10,100,0.001,0.01,0.952,3573,3631
6,7304,10,100,0.001,0.01,0.946,3630,3674
6,7404,10,100,0.001,0.01,0.952,3670,3734
6,7504,10,100,0.001,0.01,0.954,3711,3793
6,7604,10,100,0.001,0.01,0.916,3752,3852
6,7704,10,100,0.001,0.01,0.952,3804,3900
6,7804,10,100,0.001,0.01,0.946,3857,3947
6,7904,10,100,0.001,0.01,0.948,3902,4002
6,8004,10,100,0.001,0.01,0.954,3949,4055
6,8104,10,100,0.001,0.01,0.952,3997,4107
6,8204,10,100,0.001,0.01,0.95,4050,4154
6,8304,10,100,0.001,0.01,0.958,4100,4204
6,8404,10,100,0.001,0.01,0.962,4155,4249
6,8504,10,100,0.001,0.01,0.964,4204,4300
6,8604,10,100,0.001,0.01,0.962,4256,4348
6,8704,10,100,0.001,0.01,0.968,4306,4398
6,8804,10,100,0.001,0.01,0.966,4358,4446
6,8904,10,100,0.001,0.01,0.974,4409,4495
6,9004,10,100,0.001,0.01,0.978,4465,4539
6,9104,10,100,0.001,0.01,0.972,4512,4592
6,9204,10,100,0.001,0.01,0.936,4565,4639
6,9304,10,100,0.001,0.01,0.964,4617,4687
6,9404,10,100,0.001,0.01,0.968,4674,4730
6,9504,10,100,0.001,0.01,0.974,4728,4776
6,9604,10,100,0.001,0.01,0.976,4772,4832
6,9704,10,100,0.001,0.01,0.974,4823,4881
6,9804,10,100,0.001,0.01,0.974,4875,4929
6,9904,10,100,0.001,0.01,0.972,4923,4981
6,10004,10,100,0.001,0.01,0.97,4969,5035
6,10104,10,100,0.001,0.01,0.974,5030,5074
6,10204,10,100,0.001,0.01,0.974,5079,5125
6,10304,10,100,0.001,0.01,0.98,5138,5166
6,10404,10,100,0.001,0.01,0.95,5183,5221
6,10504,10,100,0.001,0.01,0.968,5227,5277
6,10604,10,100,0.001,0.01,0.976,5273,5331
6,10704,10,100,0.001,0.01,0.974,5318,5386
6,10804,10,100,0.001,0.01,0.978,5361,5443
6,10904,10,100,0.001,0.01,0.978,5413,5491
6,11004,10,100,0.001,0.01,0.98,5461,5543
6,11104,10,100,0.001,0.01,0.978,5514,5590
6,11204,10,100,0.001,0.01,0.976,5580,5624
6,11304,10,100,0.001,0.01,0.978,5631,5673
6,11404,10,100,0.001,0.01,0.974,5678,5726
6,11504,10,100,0.001,0.01,0.986,5724,5780
6,11604,10,100,0.001,0.01,0.972,5773,5831
6,11704,10,100,0.001,0.01,0.974,5825,5879
6,11804,10,100,0.001,0.01,0.984,5873,5931
6,11904,10,100,0.001,0.01,0.984,5923,5981
6,12004,10,100,0.001,0.01,0.99,5977,6027
6,12104,10,100,0.001,0.01,0.996,6021,6083
6,12204,10,100,0.001,0.01,0.994,6070,6134
6,12304,10,100,0.001,0.01,0.994,6119,6185
6,12404,10,100,0.001,0.01,0.996,6168,6236
6,12504,10,100,0.001,0.01,0.972,6226,6278
6,12604,10,100,0.001,0.01,0.978,6275,6329
6,12704,10,100,0.001,0.01,0.992,6314,6390
6,12804,10,100,0.001,0.01,0.996,6359,6445
6,12904,10,100,0.001,0.01,0.994,6418,6486
6,13004,10,100,0.001,0.01,0.998,6462,6542
6,13104,10,100,0.001,0.01,0.992,6513,6591
6,13204,10,100,0.001,0.01,0.994,6558,6646
6,13304,10,100,0.001,0.01,0.996,6607,6697
6,13404,10,100,0.001,0.01,0.996,6663,6741
6,13504,10,100,0.001,0.01,0.996,6720,6784
6,13604,10,100,0.001,0.01,0.994,6769,6835
6,13704,10,100,0.001,0.01,0.986,6817,6887
6,13804,10,100,0.001,0.01,0.982,6870,6934
6,13904,10,100,0.001,0.01,0.994,6931,6973
6,14004,10,100,0.001,0.01,0.992,6978,7026
6,14104,10,100,0.001,0.01,0.994,7029,7075
6,14204,10,100,0.001,0.01,0.994,7086,7118
6,14304,10,100,0.001,0.01,0.996,7144,7160
6,14404,10,100,0.001,0.01,0.994,7188,7216
6,14504,10,100,0.001,0.01,0.988,7236,7268
6,14604,10,100,0.001,0.01,0.988,7290,7314
6,14704,10,100,0.001,0.01,0.992,7337,7367
6,14804,10,100,0.001,0.01,0.988,7386,7418
6,14904,10,100,0.001,0.01,0.996,7440,7464
6,15004,10,100,0.001,0.01,0.994,7495,7509
7,104,10,100,0.001,0.01,0.52,53,51
7,204,10,100,0.001,0.01,0.482,98,106
7,304,10,100,0.001,0.01,0.484,154,150
7,404,10,100,0.001,0.01,0.526,201,203
7,504,10,100,0.001,0.01,0.514,245,259
7,604,10,100,0.001,0.01,0.474,294,310
7,704,10,100,0.001,0.01,0.48,347,357
7,804,10,100,0.001,0.01,0.502,393,411
7,904,10,100,0.001,0.01,0.476,437,467
7,1004,10,100,0.001,0.01,0.492,488,516
7,1104,10,100,0.001,0.01,0.478,544,560
7,1204,10,100,0.001,0.01,0.484,596,608
7,1304,10,100,0.001,0.01,0.476,643,661
7,1404,10,100,0.001,0.01,0.482,697,707
7,1504,10,100,0.001,0.01,0.502,753,751
7,1604,10,100,0.001,0.01,0.532,805,799
7,1704,10,100,0.001,0.01,0.514,853,851
7,1804,10,100,0.001,0.01,0.502,907,897
7,1904,10,100,0.001,0.01,0.548,952,952
7,2004,10,100,0.001,0.01,0.528,999,1005
7,2104,10,100,0.001,0.01,0.566,1050,1054
7,2204,10,100,0.001,0.01,0.554,1111,1093
7,2304,10,100,0.001,0.01,0.552,1156,1148
7,2404,10,100,0.001,0.01,0.544,1207,1197
7,2504,10,100,0.001,0.01,0.59,1258,1246
7,2604,10,100,0.001,0.01,0.598,1304,1300
7,2704,10,100,0.001,0.01,0.578,1360,1344
7,2804,10,100,0.001,0.01,0.594,1411,1393
7,2904,10,100,0.001,0.01,0.634,1461,1443
7,3004,10,100,0.001,0.01,0.6,1513,1491
7,3104,10,100,0.001,0.01,0.608,1564,1540
7,3204,10,100,0.001,0.01,0.622,1611,1593
7,3304,10,100,0.001,0.01,0.608,1657,1647
7,3404,10,100,0.001,0.01,0.65,1712,1692
7,3504,10,100,0.001,0.01,0.606,1770,1734
7,3604,10,100,0.001,0.01,0.646,1813,1791
7,3704,10,100,0.001,0.01,0.614,1866,1838
7,3804,10,100,0.001,0.01,0.648,1918,1886
7,3904,10,100,0.001,0.01,0.638,1963,1941
7,4004,10,100,0.001,0.01,0.668,2014,1990
7,4104,10,100,0.001,0.01,0.664,2069,2035
7,4204,10,100,0.001,0.01,0.678,2121,2083
7,4304,10,100,0.001,0.01,0.668,2172,2132
7,4404,10,100,0.001,0.01,0.694,2217,2187
7,4504,10,100,0.001,0.01,0.71,2265,2239
7,4604,10,100,0.001,0.01,0.662,2319,2285
7,4704,10,100,0.001,0.01,0.696,2372,2332
7,4804,10,100,0.001,0.01,0.69,2420,2384
7,4904,10,100,0.001,0.01,0.71,2479,2425
7,5004,10,100,0.001,0.01,0.684,2533,2471
7,5104,10,100,0.001,0.01,0.7,2588,2516
7,5204,10,100,0.001,0.01,0.708,2638,2566
7,5304,10,100,0.001,0.01,0.686,2697,2607
7,5404,10,100,0.001,0.01,0.684,2750,2654
7,5504,10,100,0.001,0.01,0.718,2791,2713
7,5604,10,100,0.001,0.01,0.678,2839,2765
7,5704,10,100,0.001,0.01,0.702,2888,2816
7,5804,10,100,0.001,0.01,0.716,2929,2875
7,5904,10,100,0.001,0.01,0.704,2979,2925
7,6004,10,100,0.001,0.01,0.732,3021,2983
7,6104,10,100,0.001,0.01,0.722,3074,3030
7,6204,10,100,0.001,0.01,0.744,3124,3080
7,6304,10,100,0.001,0.01,0.746,3170,3134
7,6404,10,100,0.001,0.01,0.75,3223,3181
7,6504,10,100,0.001,0.01,0.77,3273,3231
7,6604,10,100,0.001,0.01,0.75,3328,3276
7,6704,10,100,0.001,0.01,0.738,3379,3325
7,6804,10,100,0.001,0.01,0.76,3428,3376
7,6904,10,100,0.001,0.01,0.774,3479,3425
7,7004,10,100,0.001,0.01,0.788,3532,3472
7,7104,10,100,0.001,0.01,0.766,3585,3519
7,7204,10,100,0.001,0.01,0.782,3636,3568
7,7304,10,100,0.001,0.01,0.804,3680,3624
7,7404,10,100,0.001,0.01,0.8,3730,3674
7,7504,10,100,0.001,0.01,0.812,3777,3727
7,7604,10,100,0.001,0.01,0.798,3831,3773
7,7704,10,100,0.001,0.01,0.792,3879,3825
7,7804,10,100,0.001,0.01,0.798,3928,3876
7,7904,10,100,0.001,0.01,0.826,3982,3922
7,8004,10,100,0.001,0.01,0.796,4030,3974
7,8104,10,100,0.001,0.01,0.8,4087,4017
7,8204,10,100,0.001,0.01,0.818,4140,4064
7,8304,10,100,0.001,0.01,0.796,4190,4114
7,8404,10,100,0.001,0.01,0.81,4249,4155
7,8504,10,100,0.001,0.01,0.83,4295,4209
7,8604,10,100,0.001,0.01,0.84,4340,4264
7,8704,10,100,0.001,0.01,0.8,4385,4319
7,8804,10,100,0.001,0.01,0.846,4427,4377
7,8904,10,100,0.001,0.01,0.844,4471,4433
7,9004,10,100,0.001,0.01,0.852,4519,4485
7,9104,10,100,0.001,0.01,0.846,4569,4535
7,9204,10,100,0.001,0.01,0.86,4619,4585
7,9304,10,100,0.001,0.01,0.876,4667,4637
7,9404,10,100,0.001,0.01,0.858,4720,4684
7,9504,10,100,0.001,0.01,0.854,4771,4733
7,9604,10,100,0.001,0.01,0.842,4814,4790
7,9704,10,100,0.001,0.01,0.812,4865,4839
7,9804,10,100,0.001,0.01,0.842,4912,4892
7,9904,10,100,0.001,0.01,0.876,4955,4949
7,10004,10,100,0.001,0.01,0.866,5001,5003
7,10104,10,100,0.001,0.01,0.874,5059,5045
7,10204,10,100,0.001,0.01,0.872,5109,5095
7,10304,10,100,0.001,0.01,0.884,5164,5140
7,10404,10,100,0.001,0.01,0.88,5221,5183
7,10504,10,100,0.001,0.01,0.882,5268,5236
7,10604,10,100,0.001,0.01,0.864,5320,5284
7,10704,10,100,0.001,0.01,0.868,5369,5335
7,10804,10,100,0.001,0.01,0.892,5414,5390
7,10904,10,100,0.001,0.01,0.906,5468,5436
7,11004,10,100,0.001,0.01,0.9,5513,5491
7,11104,10,100,0.001,0.01,0.924,5563,5541
7,11204,10,100,0.001,0.01,0.91,5615,5589
7,11304,10,100,0.001,0.01,0.92,5673,5631
7,11404,10,100,0.001,0.01,0.898,5722,5682
7,11504,10,100,0.001,0.01,0.908,5769,5735
7,11604,10,100,0.001,0.01,0.908,5820,5784
7,11704,10,100,0.001,0.01,0.92,5866,5838
7,11804,10,100,0.001,0.01,0.908,5905,5899
7,11904,10,100,0.001,0.01,0.93,5951,5953
7,12004,10,100,0.001,0.01,0.936,6001,6003
7,12104,10,100,0.001,0.01,0.928,6044,6060
7,12204,10,100,0.001,0.01,0.934,6091,6113
7,12304,10,100,0.001,0.01,0.926,6143,6161
7,12404,10,100,0.001,0.01,0.942,6194,6210
7,12504,10,100,0.001,0.01,0.952,6246,6258
7,12604,10,100,0.001,0.01,0.948,6294,6310
7,12704,10,100,0.001,0.01,0.954,6350,6354
7,12804,10,100,0.001,0.01,0.954,6390,6414
7,12904,10,100,0.001,0.01,0.96,6446,6458
7,13004,10,100,0.001,0.01,0.952,6493,6511
7,13104,10,100,0.001,0.01,0.956,6548,6556
7,13204,10,100,0.001,0.01,0.968,6594,6610
7,13304,10,100,0.001,0.01,0.962,6629,6675
7,13404,10,100,0.001,0.01,0.964,6675,6729
7,13504,10,100,0.001,0.01,0.968,6731,6773
7,13604,10,100,0.001,0.01,0.974,6785,6819
7,13704,10,100,0.001,0.01,0.974,6833,6871
7,13804,10,100,0.001,0.01,0.972,6877,6927
7,13904,10,100,0.001,0.01,0.966,6927,6977
7,14004,10,100,0.001,0.01,0.972,6979,7025
7,14104,10,100,0.001,0.01,0.958,7029,7075
7,14204,10,100,0.001,0.01,0.958,7085,7119
7,14304,10,100,0.001,0.01,0.964,7136,7168
7,14404,10,100,0.001,0.01,0.97,7181,7223
7,14504,10,100,0.001,0.01,0.97,7233,7271
7,14604,10,100,0.001,0.01,0.974,7291,7313
7,14704,10,100,0.001,0.01,0.98,7340,7364
7,14804,10,100,0.001,0.01,0.978,7393,7411
7,14904,10,100,0.001,0.01,0.976,7432,7472
7,15004,10,100,0.001,0.01,0.978,7492,7512
8,104,10,100,0.001,0.01,0.47,49,55
8,204,10,100,0.001,0.01,0.504,107,97
8,304,10,100,0.001,0.01,0.472,158,146
8,404,10,100,0.001,0.01,0.502,212,192
8,504,10,100,0.001,0.01,0.534,261,243
8,604,10,100,0.001,0.01,0.51,306,298
8,704,10,100,0.001,0.01,0.518,368,336
8,804,10,100,0.001,0.01,0.53,421,383
8,904,10,100,0.001,0.01,0.508,468,436
8,1004,10,100,0.001,0.01,0.48,513,491
8,1104,10,100,0.001,0.01,0.49,560,544
8,1204,10,100,0.001,0.01,0.512,612,592
8,1304,10,100,0.001,0.01,0.496,654,650
8,1404,10,100,0.001,0.01,0.528,713,691
8,1504,10,100,0.001,0.01,0.562,766,738
8,1604,10,100,0.001,0.01,0.544,820,784
8,1704,10,100,0.001,0.01,0.564,871,833
8,1804,10,100,0.001,0.01,0.556,918,886
8,1904,10,100,0.001,0.01,0.616,967,937
8,2004,10,100,0.001,0.01,0.612,1021,983
8,2104,10,100,0.001,0.01,0.648,1078,1026
8,2204,10,100,0.001,0.01,0.652,1123,1081
8,2304,10,100,0.001,0.01,0.67,1167,1137
8,2404,10,100,0.001,0.01,0.684,1216,1188
8,2504,10,100,0.001,0.01,0.692,1262,1242
8,2604,10,100,0.001,0.01,0.696,1316,1288
8,2704,10,100,0.001,0.01,0.726,1365,1339
8,2804,10,100,0.001,0.01,0.744,1422,1382
8,2904,10,100,0.001,0.01,0.76,1480,1424
8,3004,10,100,0.001,0.01,0.752,1530,1474
8,3104,10,100,0.001,0.01,0.79,1592,1512
8,3204,10,100,0.001,0.01,0.738,1645,1559
8,3304,10,100,0.001,0.01,0.784,1694,1610
8,3404,10,100,0.001,0.01,0.812,1737,1667
8,3504,10,100,0.001,0.01,0.814,1787,1717
8,3604,10,100,0.001,0.01,0.83,1841,1763
8,3704,10,100,0.001,0.01,0.842,1888,1816
8,3804,10,100,0.001,0.01,0.844,1943,1861
8,3904,10,100,0.001,0.01,0.878,1989,1915
8,4004,10,100,0.001,0.01,0.874,2031,1973
8,4104,10,100,0.001,0.01,0.872,2081,2023
8,4204,10,100,0.001,0.01,0.89,2135,2069
8,4304,10,100,0.001,0.01,0.874,2183,2121
8,4404,10,100,0.001,0.01,0.86,2225,2179
8,4504,10,100,0.001,0.01,0.902,2283,2221
8,4604,10,100,0.001,0.01,0.914,2331,2273
8,4704,10,100,0.001,0.01,0.894,2381,2323
8,4804,10,100,0.001,0.01,0.912,2433,2371
8,4904,10,100,0.001,0.01,0.924,2481,2423
8,5004,10,100,0.001,0.01,0.906,2520,2484
8,5104,10,100,0.001,0.01,0.932,2567,2537
8,5204,10,100,0.001,0.01,0.916,2612,2592
8,5304,10,100,0.001,0.01,0.93,2675,2629
8,5404,10,100,0.001,0.01,0.924,2725,2679
8,5504,10,100,0.001,0.01,0.914,2770,2734
8,5604,10,100,0.001,0.01,0.914,2817,2787
8,5704,10,100,0.001,0.01,0.932,2867,2837
8,5804,10,100,0.001,0.01,0.9,2912,2892
8,5904,10,100,0.001,0.01,0.924,2964,2940
8,6004,10,100,0.001,0.01,0.928,3017,2987
8,6104,10,100,0.001,0.01,0.934,3064,3040
8,6204,10,100,0.001,0.01,0.936,3108,3096
8,6304,10,100,0.001,0.01,0.942,3154,3150
8,6404,10,100,0.001,0.01,0.954,3208,3196
8,6504,10,100,0.001,0.01,0.94,3257,3247
8,6604,10,100,0.001,0.01,0.948,3303,3301
8,6704,10,100,0.001,0.01,0.962,3349,3355
8,6804,10,100,0.001,0.01,0.942,3392,3412
8,6904,10,100,0.001,0.01,0.942,3431,3473
8,7004,10,100,0.001,0.01,0.936,3482,3522
8,7104,10,100,0.001,0.01,0.94,3533,3571
8,7204,10,100,0.001,0.01,0.946,3581,3623
8,7304,10,100,0.001,0.01,0.96,3633,3671
8,7404,10,100,0.001,0.01,0.958,3682,3722
8,7504,10,100,0.001,0.01,0.966,3738,3766
8,7604,10,100,0.001,0.01,0.96,3787,3817
8,7704,10,100,0.001,0.01,0.974,3831,3873
8,7804,10,100,0.001,0.01,0.964,3882,3922
8,7904,10,100,0.001,0.01,0.97,3937,3967
8,8004,10,100,0.001,0.01,0.968,3989,4015
8,8104,10,100,0.001,0.01,0.946,4029,4075
8,8204,10,100,0.001,0.01,0.958,4078,4126
8,8304,10,100,0.001,0.01,0.964,4130,4174
8,8404,10,100,0.001,0.01,0.97,4179,4225
8,8504,10,100,0.001,0.01,0.978,4238,4266
8,8604,10,100,0.001,0.01,0.978,4287,4317
8,8704,10,100,0.001,0.01,0.98,4344,4360
8,8804,10,100,0.001,0.01,0.978,4399,4405
8,8904,10,100,0.001,0.01,0.978,4445,4459
8,9004,10,100,0.001,0.01,0.98,4496,4508
8,9104,10,100,0.001,0.01,0.982,4549,4555
8,9204,10,100,0.001,0.01,0.986,4592,4612
8,9304,10,100,0.001,0.01,0.978,4641,4663
8,9404,10,100,0.001,0.01,0.98,4700,4704
8,9504,10,100,0.001,0.01,0.988,4751,4753
8,9604,10,100,0.001,0.01,0.98,4796,4808
8,9704,10,100,0.001,0.01,0.964,4846,4858
8,9804,10,100,0.001,0.01,0.976,4897,4907
8,9904,10,100,0.001,0.01,0.958,4949,4955
8,10004,10,100,0.001,0.01,0.976,4993,5011
8,10104,10,100,0.001,0.01,0.986,5044,5060
8,10204,10,100,0.001,0.01,0.982,5093,5111
8,10304,10,100,0.001,0.01,0.98,5135,5169
8,10404,10,100,0.001,0.01,0.98,5180,5224
8,10504,10,100,0.001,0.01,0.972,5229,5275
8,10604,10,100,0.001,0.01,0.958,5266,5338
8,10704,10,100,0.001,0.01,0.984,5323,5381
8,10804,10,100,0.001,0.01,0.978,5378,5426
8,10904,10,100,0.001,0.01,0.988,5424,5480
8,11004,10,100,0.001,0.01,0.988,5469,5535
8,11104,10,100,0.001,0.01,0.978,5529,5575
8,11204,10,100,0.001,0.01,0.992,5580,5624
8,11304,10,100,0.001,0.01,0.986,5636,5668
8,11404,10,100,0.001,0.01,0.984,5686,5718
8,11504,10,100,0.001,0.01,0.968,5734,5770
8,11604,10,100,0.001,0.01,0.984,5786,5818
8,11704,10,100,0.001,0.01,0.984,5839,5865
8,11804,10,100,0.001,0.01,0.99,5883,5921
8,11904,10,100,0.001,0.01,0.984,5937,5967
8,12004,10,100,0.001,0.01,0.994,5984,6020
8,12104,10,100,0.001,0.01,0.988,6039,6065
8,12204,10,100,0.001,0.01,0.996,6092,6112
8,12304,10,100,0.001,0.01,0.988,6142,6162
8,12404,10,100,0.001,0.01,0.99,6195,6209
8,12504,10,100,0.001,0.01,0.99,6250,6254
8,12604,10,100,0.001,0.01,0.984,6307,6297
8,12704,10,100,0.001,0.01,0.97,6366,6338
8,12804,10,100,0.001,0.01,0.988,6409,6395
8,12904,10,100,0.001,0.01,0.986,6454,6450
8,13004,10,100,0.001,0.01,0.986,6509,6495
8,13104,10,100,0.001,0.01,0.99,6558,6546
8,13204,10,100,0.001,0.01,0.988,6610,6594
8,13304,10,100,0.001,0.01,0.986,6662,6642
8,13404,10,100,0.001,0.01,0.988,6716,6688
8,13504,10,100,0.001,0.01,0.986,6766,6738
8,13604,10,100,0.001,0.01,0.976,6811,6793
8,13704,10,100,0.001,0.01,0.988,6871,6833
8,13804,10,100,0.001,0.01,0.99,6926,6878
8,13904,10,100,0.001,0.01,0.996,6967,6937
8,14004,10,100,0.001,0.01,0.994,7019,6985
8,14104,10,100,0.001,0.01,0.992,7072,7032
8,14204,10,100,0.001,0.01,0.978,7116,7088
8,14304,10,100,0.001,0.01,0.996,7166,7138
8,14404,10,100,0.001,0.01,0.992,7218,7186
8,14504,10,100,0.001,0.01,0.996,7268,7236
8,14604,10,100,0.001,0.01,0.992,7313,7291
8,14704,10,100,0.001,0.01,0.988,7358,7346
8,14804,10,100,0.001,0.01,0.994,7409,7395
8,14904,10,100,0.001,0.01,0.984,7454,7450
8,15004,10,100,0.001,0.01,0.992,7503,7501
9,104,10,100,0.001,0.01,0.544,53,51
9,204,10,100,0.001,0.01,0.5,102,102
9,304,10,100,0.001,0.01,0.482,147,157
9,404,10,100,0.001,0.01,0.496,200,204
9,504,10,100,0.001,0.01,0.48,247,257
9,604,10,100,0.001,0.01,0.486,290,314
9,704,10,100,0.001,0.01,0.46,340,364
9,804,10,100,0.001,0.01,0.5,389,415
9,904,10,100,0.001,0.01,0.484,445,459
9,1004,10,100,0.001,0.01,0.5,498,506
9,1104,10,100,0.001,0.01,0.484,549,555
9,1204,10,100,0.001,0.01,0.512,596,608
9,1304,10,100,0.001,0.01,0.508,651,653
9,1404,10,100,0.001,0.01,0.516,705,699
9,1504,10,100,0.001,0.01,0.496,753,751
9,1604,10,100,0.001,0.01,0.51,804,800
9,1704,10,100,0.001,0.01,0.49,850,854
9,1804,10,100,0.001,0.01,0.492,907,897
9,1904,10,100,0.001,0.01,0.522,950,954
9,2004,10,100,0.001,0.01,0.518,989,1015
9,2104,10,100,0.001,0.01,0.52,1044,1060
9,2204,10,100,0.001,0.01,0.49,1093,1111
9,2304,10,100,0.001,0.01,0.508,1138,1166
9,2404,10,100,0.001,0.01,0.544,1184,1220
9,2504,10,100,0.001,0.01,0.536,1234,1270
9,2604,10,100,0.001,0.01,0.532,1284,1320
9,2704,10,100,0.001,0.01,0.558,1331,1373
9,2804,10,100,0.001,0.01,0.55,1379,1425
9,2904,10,100,0.001,0.01,0.554,1429,1475
9,3004,10,100,0.001,0.01,0.544,1478,1526
9,3104,10,100,0.001,0.01,0.546,1531,1573
9,3204,10,100,0.001,0.01,0.586,1579,1625
9,3304,10,100,0.001,0.01,0.552,1633,1671
9,3404,10,100,0.001,0.01,0.578,1691,1713
9,3504,10,100,0.001,0.01,0.572,1737,1767
9,3604,10,100,0.001,0.01,0.578,1786,1818
9,3704,10,100,0.001,0.01,0.562,1829,1875
9,3804,10,100,0.001,0.01,0.594,1878,1926
9,3904,10,100,0.001,0.01,0.598,1930,1974
9,4004,10,100,0.001,0.01,0.6,1975,2029
9,4104,10,100,0.001,0.01,0.59,2024,2080
9,4204,10,100,0.001,0.01,0.588,2086,2118
9,4304,10,100,0.001,0.01,0.624,2136,2168
9,4404,10,100,0.001,0.01,0.662,2187,2217
9,4504,10,100,0.001,0.01,0.674,2241,2263
9,4604,10,100,0.001,0.01,0.646,2289,2315
9,4704,10,100,0.001,0.01,0.666,2345,2359
9,4804,10,100,0.001,0.01,0.688,2391,2413
9,4904,10,100,0.001,0.01,0.702,2443,2461
9,5004,10,100,0.001,0.01,0.694,2500,2504
9,5104,10,100,0.001,0.01,0.71,2549,2555
9,5204,10,100,0.001,0.01,0.702,2605,2599
9,5304,10,100,0.001,0.01,0.692,2660,2644
9,5404,10,100,0.001,0.01,0.7,2707,2697
9,5504,10,100,0.001,0.01,0.704,2761,2743
9,5604,10,100,0.001,0.01,0.742,2814,2790
9,5704,10,100,0.001,0.01,0.738,2872,2832
9,5804,10,100,0.001,0.01,0.754,2921,2883
9,5904,10,100,0.001,0.01,0.732,2966,2938
9,6004,10,100,0.001,0.01,0.756,3015,2989
9,6104,10,100,0.001,0.01,0.744,3060,3044
9,6204,10,100,0.001,0.01,0.746,3122,3082
9,6304,10,100,0.001,0.01,0.73,3176,3128
9,6404,10,100,0.001,0.01,0.728,3221,3183
9,6504,10,100,0.001,0.01,0.76,3272,3232
9,6604,10,100,0.001,0.01,0.748,3311,3293
9,6704,10,100,0.001,0.01,0.764,3359,3345
9,6804,10,100,0.001,0.01,0.784,3403,3401
9,6904,10,100,0.001,0.01,0.722,3453,3451
9,7004,10,100,0.001,0.01,0.756,3501,3503
9,7104,10,100,0.001,0.01,0.746,3550,3554
9,7204,10,100,0.001,0.01,0.752,3606,3598
9,7304,10,100,0.001,0.01,0.774,3661,3643
9,7404,10,100,0.001,0.01,0.79,3711,3693
9,7504,10,100,0.001,0.01,0.8,3764,3740
9,7604,10,100,0.001,0.01,0.782,3818,3786
9,7704,10,100,0.001,0.01,0.79,3874,3830
9,7804,10,100,0.001,0.01,0.796,3928,3876
9,7904,10,100,0.001,0.01,0.79,3977,3927
9,8004,10,100,0.001,0.01,0.808,4040,3964
9,8104,10,100,0.001,0.01,0.794,4088,4016
9,8204,10,100,0.001,0.01,0.81,4134,4070
9,8304,10,100,0.001,0.01,0.786,4181,4123
9,8404,10,100,0.001,0.01,0.828,4224,4180
9,8504,10,100,0.001,0.01,0.808,4273,4231
9,8604,10,100,0.001,0.01,0.82,4317,4287
9,8704,10,100,0.001,0.01,0.82,4367,4337
9,8804,10,100,0.001,0.01,0.83,4407,4397
9,8904,10,100,0.001,0.01,0.81,4465,4439
9,9004,10,100,0.001,0.01,0.83,4512,4492
9,9104,10,100,0.001,0.01,0.832,4560,4544
9,9204,10,100,0.001,0.01,0.822,4600,4604
9,9304,10,100,0.001,0.01,0.834,4650,4654
9,9404,10,100,0.001,0.01,0.846,4702,4702
9,9504,10,100,0.001,0.01,0.854,4754,4750
9,9604,10,100,0.001,0.01,0.844,4809,4795
9,9704,10,100,0.001,0.01,0.828,4851,4853
9,9804,10,100,0.001,0.01,0.848,4896,4908
9,9904,10,100,0.001,0.01,0.84,4947,4957
9,10004,10,100,0.001,0.01,0.822,5001,5003
9,10104,10,100,0.001,0.01,0.848,5043,5061
9,10204,10,100,0.001,0.01,0.848,5100,5104
9,10304,10,100,0.001,0.01,0.856,5145,5159
9,10404,10,100,0.001,0.01,0.848,5199,5205
9,10504,10,100,0.001,0.01,0.874,5254,5250
9,10604,10,100,0.001,0.01,0.876,5305,5299
9,10704,10,100,0.001,0.01,0.86,5359,5345
9,10804,10,100,0.001,0.01,0.88,5401,5403
9,10904,10,100,0.001,0.01,0.886,5444,5460
9,11004,10,100,0.001,0.01,0.884,5496,5508
9,11104,10,100,0.001,0.01,0.864,5552,5552
9,11204,10,100,0.001,0.01,0.878,5607,5597
9,11304,10,100,0.001,0.01,0.886,5651,5653
9,11404,10,100,0.001,0.01,0.886,5704,5700
9,11504,10,100,0.001,0.01,0.902,5749,5755
9,11604,10,100,0.001,0.01,0.892,5798,5806
9,11704,10,100,0.001,0.01,0.906,5843,5861
9,11804,10,100,0.001,0.01,0.912,5893,5911
9,11904,10,100,0.001,0.01,0.916,5945,5959
9,12004,10,100,0.001,0.01,0.92,5998,6006
9,12104,10,100,0.001,0.01,0.93,6049,6055
9,12204,10,100,0.001,0.01,0.926,6098,6106
9,12304,10,100,0.001,0.01,0.91,6147,6157
9,12404,10,100,0.001,0.01,0.92,6203,6201
9,12504,10,100,0.001,0.01,0.924,6253,6251
9,12604,10,100,0.001,0.01,0.912,6304,6300
9,12704,10,100,0.001,0.01,0.93,6349,6355
9,12804,10,100,0.001,0.01,0.932,6397,6407
9,12904,10,100,0.001,0.01,0.942,6444,6460
9,13004,10,100,0.001,0.01,0.94,6491,6513
9,13104,10,100,0.001,0.01,0.94,6534,6570
9,13204,10,100,0.001,0.01,0.928,6587,6617
9,13304,10,100,0.001,0.01,0.92,6632,6672
9,13404,10,100,0.001,0.01,0.928,6681,6723
9,13504,10,100,0.001,0.01,0.95,6720,6784
9,13604,10,100,0.001,0.01,0.93,6765,6839
9,13704,10,100,0.001,0.01,0.93,6827,6877
9,13804,10,100,0.001,0.01,0.96,6877,6927
9,13904,10,100,0.001,0.01,0.95,6927,6977
9,14004,10,100,0.001,0.01,0.968,6985,7019
9,14104,10,100,0.001,0.01,0.97,7030,7074
9,14204,10,100,0.001,0.01,0.96,7072,7132
9,14304,10,100,0.001,0.01,0.956,7121,7183
9,14404,10,100,0.001,0.01,0.958,7171,7233
9,14504,10,100,0.001,0.01,0.972,7229,7275
9,14604,10,100,0.001,0.01,0.97,7276,7328
9,14704,10,100,0.001,0.01,0.96,7326,7378
9,14804,10,100,0.001,0.01,0.974,7380,7424
9,14904,10,100,0.001,0.01,0.964,7425,7479
9,15004,10,100,0.001,0.01,0.978,7480,7524
10,104,10,100,0.001,0.01,0.482,50,54
10,204,10,100,0.001,0.01,0.494,96,108
10,304,10,100,0.001,0.01,0.502,145,159
10,404,10,100,0.001,0.01,0.47,199,205
10,504,10,100,0.001,0.01,0.466,251,253
10,604,10,100,0.001,0.01,0.502,303,301
10,704,10,100,0.001,0.01,0.504,349,355
10,804,10,100,0.001,0.01,0.506,401,403
10,904,10,100,0.001,0.01,0.506,450,454
10,1004,10,100,0.001,0.01,0.51,500,504
10,1104,10,100,0.001,0.01,0.51,544,560
10,1204,10,100,0.001,0.01,0.508,594,610
10,1304,10,100,0.001,0.01,0.526,644,660
10,1404,10,100,0.001,0.01,0.526,699,705
10,1504,10,100,0.001,0.01,0.516,753,751
10,1604,10,100,0.001,0.01,0.538,794,810
10,1704,10,100,0.001,0.01,0.558,849,855
10,1804,10,100,0.001,0.01,0.53,905,899
10,1904,10,100,0.001,0.01,0.496,963,941
10,2004,10,100,0.001,0.01,0.526,1011,993
10,2104,10,100,0.001,0.01,0.562,1061,1043
10,2204,10,100,0.001,0.01,0.582,1107,1097
10,2304,10,100,0.001,0.01,0.576,1161,1143
10,2404,10,100,0.001,0.01,0.6,1211,1193
10,2504,10,100,0.001,0.01,0.598,1266,1238
10,2604,10,100,0.001,0.01,0.648,1322,1282
10,2704,10,100,0.001,0.01,0.646,1375,1329
10,2804,10,100,0.001,0.01,0.64,1422,1382
10,2904,10,100,0.001,0.01,0.67,1473,1431
10,3004,10,100,0.001,0.01,0.68,1520,1484
10,3104,10,100,0.001,0.01,0.662,1576,1528
10,3204,10,100,0.001,0.01,0.724,1630,1574
10,3304,10,100,0.001,0.01,0.744,1677,1627
10,3404,10,100,0.001,0.01,0.764,1739,1665
10,3504,10,100,0.001,0.01,0.762,1796,1708
10,3604,10,100,0.001,0.01,0.782,1841,1763
10,3704,10,100,0.001,0.01,0.758,1902,1802
10,3804,10,100,0.001,0.01,0.802,1951,1853
10,3904,10,100,0.001,0.01,0.802,2010,1894
10,4004,10,100,0.001,0.01,0.83,2065,1939
10,4104,10,100,0.001,0.01,0.826,2114,1990
10,4204,10,100,0.001,0.01,0.852,2165,2039
10,4304,10,100,0.001,0.01,0.84,2219,2085
10,4404,10,100,0.001,0.01,0.868,2269,2135
10,4504,10,100,0.001,0.01,0.834,2326,2178
10,4604,10,100,0.001,0.01,0.896,2368,2236
10,4704,10,100,0.001,0.01,0.884,2414,2290
10,4804,10,100,0.001,0.01,0.872,2463,2341
10,4904,10,100,0.001,0.01,0.908,2515,2389
10,5004,10,100,0.001,0.01,0.918,2555,2449
10,5104,10,100,0.001,0.01,0.924,2613,2491
10,5204,10,100,0.001,0.01,0.912,2672,2532
10,5304,10,100,0.001,0.01,0.912,2723,2581
10,5404,10,100,0.001,0.01,0.908,2774,2630
10,5504,10,100,0.001,0.01,0.93,2815,2689
10,5604,10,100,0.001,0.01,0.938,2861,2743
10,5704,10,100,0.001,0.01,0.936,2915,2789
10,5804,10,100,0.001,0.01,0.938,2969,2835
10,5904,10,100,0.001,0.01,0.952,3013,2891
10,6004,10,100,0.001,0.01,0.95,3062,2942
10,6104,10,100,0.001,0.01,0.94,3117,2987
10,6204,10,100,0.001,0.01,0.948,3165,3039
10,6304,10,100,0.001,0.01,0.95,3215,3089
10,6404,10,100,0.001,0.01,0.948,3257,3147
10,6504,10,100,0.001,0.01,0.956,3306,3198
10,6604,10,100,0.001,0.01,0.946,3352,3252
10,6704,10,100,0.001,0.01,0.952,3408,3296
10,6804,10,100,0.001,0.01,0.944,3465,3339
10,6904,10,100,0.001,0.01,0.942,3524,3380
10,7004,10,100,0.001,0.01,0.932,3570,3434
10,7104,10,100,0.001,0.01,0.952,3618,3486
10,7204,10,100,0.001,0.01,0.96,3660,3544
10,7304,10,100,0.001,0.01,0.97,3709,3595
10,7404,10,100,0.001,0.01,0.964,3760,3644
10,7504,10,100,0.001,0.01,0.97,3813,3691
10,7604,10,100,0.001,0.01,0.976,3866,3738
10,7704,10,100,0.001,0.01,0.972,3914,3790
10,7804,10,100,0.001,0.01,0.974,3959,3845
10,7904,10,100,0.001,0.01,0.96,4009,3895
10,8004,10,100,0.001,0.01,0.964,4053,3951
10,8104,10,100,0.001,0.01,0.96,4107,3997
10,8204,10,100,0.001,0.01,0.966,4170,4034
10,8304,10,100,0.001,0.01,0.942,4222,4082
10,8404,10,100,0.001,0.01,0.97,4268,4136
10,8504,10,100,0.001,0.01,0.972,4315,4189
10,8604,10,100,0.001,0.01,0.976,4363,4241
10,8704,10,100,0.001,0.01,0.98,4412,4292
10,8804,10,100,0.001,0.01,0.978,4470,4334
10,8904,10,100,0.001,0.01,0.984,4514,4390
10,9004,10,100,0.001,0.01,0.984,4566,4438
10,9104,10,100,0.001,0.01,0.984,4619,4485
10,9204,10,100,0.001,0.01,0.976,4665,4539
10,9304,10,100,0.001,0.01,0.96,4725,4579
10,9404,10,100,0.001,0.01,0.97,4777,4627
10,9504,10,100,0.001,0.01,0.974,4826,4678
10,9604,10,100,0.001,0.01,0.986,4877,4727
10,9704,10,100,0.001,0.01,0.984,4931,4773
10,9804,10,100,0.001,0.01,0.958,4977,4827
10,9904,10,100,0.001,0.01,0.976,5032,4872
10,10004,10,100,0.001,0.01,0.982,5080,4924
10,10104,10,100,0.001,0.01,0.986,5123,4981
10,10204,10,100,0.001,0.01,0.988,5176,5028
10,10304,10,100,0.001,0.01,0.988,5218,5086
10,10404,10,100,0.001,0.01,0.984,5271,5133
10,10504,10,100,0.001,0.01,0.986,5323,5181
10,10604,10,100,0.001,0.01,0.978,5375,5229
10,10704,10,100,0.001,0.01,0.984,5428,5276
10,10804,10,100,0.001,0.01,0.99,5475,5329
10,10904,10,100,0.001,0.01,0.988,5522,5382
10,11004,10,100,0.001,0.01,0.988,5563,5441
10,11104,10,100,0.001,0.01,0.986,5607,5497
10,11204,10,100,0.001,0.01,0.982,5660,5544
10,11304,10,100,0.001,0.01,0.988,5711,5593
10,11404,10,100,0.001,0.01,0.99,5761,5643
10,11504,10,100,0.001,0.01,0.978,5810,5694
10,11604,10,100,0.001,0.01,0.98,5854,5750
10,11704,10,100,0.001,0.01,0.99,5903,5801
10,11804,10,100,0.001,0.01,0.99,5951,5853
10,11904,10,100,0.001,0.01,0.988,5994,5910
10,12004,10,100,0.001,0.01,0.992,6042,5962
10,12104,10,100,0.001,0.01,0.982,6083,6021
10,12204,10,100,0.001,0.01,0.994,6140,6064
10,12304,10,100,0.001,0.01,0.992,6181,6123
10,12404,10,100,0.001,0.01,0.992,6224,6180
10,12504,10,100,0.001,0.01,0.988,6276,6228
10,12604,10,100,0.001,0.01,0.99,6321,6283
10,12704,10,100,0.001,0.01,0.992,6373,6331
10,12804,10,100,0.001,0.01,0.982,6417,6387
10,12904,10,100,0.001,0.01,0.986,6473,6431
10,13004,10,100,0.001,0.01,0.994,6525,6479
10,13104,10,100,0.001,0.01,0.99,6575,6529
10,13204,10,100,0.001,0.01,0.978,6625,6579
10,13304,10,100,0.001,0.01,0.992,6682,6622
10,13404,10,100,0.001,0.01,0.992,6727,6677
10,13504,10,100,0.001,0.01,0.99,6783,6721
10,13604,10,100,0.001,0.01,0.996,6833,6771
10,13704,10,100,0.001,0.01,0.988,6881,6823
10,13804,10,100,0.001,0.01,0.996,6932,6872
10,13904,10,100,0.001,0.01,0.996,6982,6922
10,14004,10,100,0.001,0.01,0.996,7028,6976
10,14104,10,100,0.001,0.01,0.994,7071,7033
10,14204,10,100,0.001,0.01,0.998,7129,7075
10,14304,10,100,0.001,0.01,0.994,7174,7130
10,14404,10,100,0.001,0.01,0.976,7223,7181
10,14504,10,100,0.001,0.01,0.986,7278,7226
10,14604,10,100,0.001,0.01,0.994,7329,7275
10,14704,10,100,0.001,0.01,0.994,7379,7325
10,14804,10,100,0.001,0.01,0.996,7413,7391
10,14904,10,100,0.001,0.01,0.994,7464,7440
10,15004,10,100,0.001,0.01,0.996,7512,7492
11,104,10,100,0.001,0.01,0.492,52,52
11,204,10,100,0.001,0.01,0.496,105,99
11,304,10,100,0.001,0.01,0.492,159,145
11,404,10,100,0.001,0.01,0.514,212,192
11,504,10,100,0.001,0.01,0.466,255,249
11,604,10,100,0.001,0.01,0.47,300,304
11,704,10,100,0.001,0.01,0.46,349,355
11,804,10,100,0.001,0.01,0.458,401,403
11,904,10,100,0.001,0.01,0.486,460,444
11,1004,10,100,0.001,0.01,0.488,518,486
11,1104,10,100,0.001,0.01,0.484,567,537
11,1204,10,100,0.001,0.01,0.458,605,599
11,1304,10,100,0.001,0.01,0.486,653,651
11,1404,10,100,0.001,0.01,0.496,706,698
11,1504,10,100,0.001,0.01,0.492,751,753
11,1604,10,100,0.001,0.01,0.51,808,796
11,1704,10,100,0.001,0.01,0.484,861,843
11,1804,10,100,0.001,0.01,0.49,902,902
11,1904,10,100,0.001,0.01,0.52,968,936
11,2004,10,100,0.001,0.01,0.516,1021,983
11,2104,10,100,0.001,0.01,0.562,1072,1032
11,2204,10,100,0.001,0.01,0.6,1134,1070
11,2304,10,100,0.001,0.01,0.604,1183,1121
11,2404,10,100,0.001,0.01,0.63,1233,1171
11,2504,10,100,0.001,0.01,0.682,1275,1229
11,2604,10,100,0.001,0.01,0.69,1323,1281
11,2704,10,100,0.001,0.01,0.72,1374,1330
11,2804,10,100,0.001,0.01,0.736,1428,1376
11,2904,10,100,0.001,0.01,0.796,1478,1426
11,3004,10,100,0.001,0.01,0.796,1534,1470
11,3104,10,100,0.001,0.01,0.838,1584,1520
11,3204,10,100,0.001,0.01,0.85,1629,1575
11,3304,10,100,0.001,0.01,0.856,1668,1636
11,3404,10,100,0.001,0.01,0.876,1721,1683
11,3504,10,100,0.001,0.01,0.87,1763,1741
11,3604,10,100,0.001,0.01,0.884,1810,1794
11,3704,10,100,0.001,0.01,0.898,1862,1842
11,3804,10,100,0.001,0.01,0.9,1917,1887
11,3904,10,100,0.001,0.01,0.916,1963,1941
11,4004,10,100,0.001,0.01,0.878,2014,1990
11,4104,10,100,0.001,0.01,0.88,2064,2040
11,4204,10,100,0.001,0.01,0.892,2113,2091
11,4304,10,100,0.001,0.01,0.932,2173,2131
11,4404,10,100,0.001,0.01,0.928,2219,2185
11,4504,10,100,0.001,0.01,0.928,2264,2240
11,4604,10,100,0.001,0.01,0.94,2312,2292
11,4704,10,100,0.001,0.01,0.926,2359,2345
11,4804,10,100,0.001,0.01,0.92,2408,2396
11,4904,10,100,0.001,0.01,0.948,2454,2450
11,5004,10,100,0.001,0.01,0.942,2497,2507
11,5104,10,100,0.001,0.01,0.958,2547,2557
11,5204,10,100,0.001,0.01,0.948,2594,2610
11,5304,10,100,0.001,0.01,0.95,2636,2668
11,5404,10,100,0.001,0.01,0.95,2690,2714
11,5504,10,100,0.001,0.01,0.95,2743,2761
11,5604,10,100,0.001,0.01,0.954,2793,2811
11,5704,10,100,0.001,0.01,0.942,2842,2862
11,5804,10,100,0.001,0.01,0.954,2899,2905
11,5904,10,100,0.001,0.01,0.968,2944,2960
11,6004,10,100,0.001,0.01,0.93,2999,3005
11,6104,10,100,0.001,0.01,0.936,3052,3052
11,6204,10,100,0.001,0.01,0.958,3110,3094
11,6304,10,100,0.001,0.01,0.956,3163,3141
11,6404,10,100,0.001,0.01,0.974,3217,3187
11,6504,10,100,0.001,0.01,0.96,3265,3239
11,6604,10,100,0.001,0.01,0.958,3314,3290
11,6704,10,100,0.001,0.01,0.958,3358,3346
11,6804,10,100,0.001,0.01,0.958,3408,3396
11,6904,10,100,0.001,0.01,0.962,3454,3450
11,7004,10,100,0.001,0.01,0.968,3502,3502
11,7104,10,100,0.001,0.01,0.962,3545,3559
11,7204,10,100,0.001,0.01,0.95,3593,3611
11,7304,10,100,0.001,0.01,0.952,3642,3662
11,7404,10,100,0.001,0.01,0.98,3696,3708
11,7504,10,100,0.001,0.01,0.978,3743,3761
11,7604,10,100,0.001,0.01,0.976,3788,3816
11,7704,10,100,0.001,0.01,0.978,3841,3863
11,7804,10,100,0.001,0.01,0.978,3888,3916
11,7904,10,100,0.001,0.01,0.984,3937,3967
11,8004,10,100,0.001,0.01,0.974,3990,4014
11,8104,10,100,0.001,0.01,0.974,4040,4064
11,8204,10,100,0.001,0.01,0.98,4095,4109
11,8304,10,100,0.001,0.01,0.984,4147,4157
11,8404,10,100,0.001,0.01,0.962,4210,4194
11,8504,10,100,0.001,0.01,0.966,4256,4248
11,8604,10,100,0.001,0.01,0.97,4308,4296
11,8704,10,100,0.001,0.01,0.972,4362,4342
11,8804,10,100,0.001,0.01,0.972,4413,4391
11,8904,10,100,0.001,0.01,0.972,4459,4445
11,9004,10,100,0.001,0.01,0.974,4511,4493
11,9104,10,100,0.001,0.01,0.982,4559,4545
11,9204,10,100,0.001,0.01,0.98,4612,4592
11,9304,10,100,0.001,0.01,0.982,4657,4647
11,9404,10,100,0.001,0.01,0.986,4708,4696
11,9504,10,100,0.001,0.01,0.984,4761,4743
11,9604,10,100,0.001,0.01,0.988,4815,4789
11,9704,10,100,0.001,0.01,0.982,4869,4835
11,9804,10,100,0.001,0.01,0.988,4920,4884
11,9904,10,100,0.001,0.01,0.988,4964,4940
11,10004,10,100,0.001,0.01,0.992,5016,4988
11,10104,10,100,0.001,0.01,0.982,5066,5038
11,10204,10,100,0.001,0.01,0.98,5114,5090
11,10304,10,100,0.001,0.01,0.982,5169,5135
11,10404,10,100,0.001,0.01,0.988,5216,5188
11,10504,10,100,0.001,0.01,0.988,5265,5239
11,10604,10,100,0.001,0.01,0.978,5313,5291
11,10704,10,100,0.001,0.01,0.992,5360,5344
11,10804,10,100,0.001,0.01,0.992,5414,5390
11,10904,10,100,0.001,0.01,0.986,5468,5436
11,11004,10,100,0.001,0.01,0.986,5514,5490
11,11104,10,100,0.001,0.01,0.994,5561,5543
11,11204,10,100,0.001,0.01,0.992,5613,5591
11,11304,10,100,0.001,0.01,0.994,5670,5634
11,11404,10,100,0.001,0.01,0.994,5723,5681
11,11504,10,100,0.001,0.01,0.994,5777,5727
11,11604,10,100,0.001,0.01,0.994,5826,5778
11,11704,10,100,0.001,0.01,0.992,5888,5816
11,11804,10,100,0.001,0.01,0.986,5942,5862
11,11904,10,100,0.001,0.01,0.992,6001,5903
11,12004,10,100,0.001,0.01,0.99,6046,5958
11,12104,10,100,0.001,0.01,0.992,6100,6004
11,12204,10,100,0.001,0.01,0.994,6143,6061
11,12304,10,100,0.001,0.01,0.994,6195,6109
11,12404,10,100,0.001,0.01,0.988,6235,6169
11,12504,10,100,0.001,0.01,0.988,6288,6216
11,12604,10,100,0.001,0.01,0.994,6341,6263
11,12704,10,100,0.001,0.01,0.988,6391,6313
11,12804,10,100,0.001,0.01,0.994,6428,6376
11,12904,10,100,0.001,0.01,0.996,6476,6428
11,13004,10,100,0.001,0.01,0.994,6528,6476
11,13104,10,100,0.001,0.01,0.994,6567,6537
11,13204,10,100,0.001,0.01,0.992,6599,6605
11,13304,10,100,0.001,0.01,0.994,6648,6656
11,13404,10,100,0.001,0.01,0.986,6696,6708
11,13504,10,100,0.001,0.01,0.994,6748,6756
11,13604,10,100,0.001,0.01,0.992,6800,6804
11,13704,10,100,0.001,0.01,0.992,6844,6860
11,13804,10,100,0.001,0.01,0.994,6891,6913
11,13904,10,100,0.001,0.01,0.996,6943,6961
11,14004,10,100,0.001,0.01,0.992,6991,7013
11,14104,10,100,0.001,0.01,0.994,7040,7064
11,14204,10,100,0.001,0.01,0.996,7087,7117
11,14304,10,100,0.001,0.01,0.996,7136,7168
11,14404,10,100,0.001,0.01,0.998,7190,7214
11,14504,10,100,0.001,0.01,0.998,7241,7263
11,14604,10,100,0.001,0.01,0.994,7294,7310
11,14704,10,100,0.001,0.01,0.996,7345,7359
11,14804,10,100,0.001,0.01,0.982,7399,7405
11,14904,10,100,0.001,0.01,0.994,7454,7450
11,15004,10,100,0.001,0.01,0.994,7498,7506
12,104,10,100,0.001,0.01,0.476,48,56
12,204,10,100,0.001,0.01,0.522,95,109
12,304,10,100,0.001,0.01,0.526,144,160
12,404,10,100,0.001,0.01,0.484,191,213
12,504,10,100,0.001,0.01,0.47,237,267
12,604,10,100,0.001,0.01,0.488,290,314
12,704,10,100,0.001,0.01,0.498,341,363
12,804,10,100,0.001,0.01,0.494,381,423
12,904,10,100,0.001,0.01,0.502,433,471
12,1004,10,100,0.001,0.01,0.478,483,521
12,1104,10,100,0.001,0.01,0.516,532,572
12,1204,10,100,0.001,0.01,0.492,580,624
12,1304,10,100,0.001,0.01,0.502,625,679
12,1404,10,100,0.001,0.01,0.532,677,727
12,1504,10,100,0.001,0.01,0.488,722,782
12,1604,10,100,0.001,0.01,0.49,778,826
12,1704,10,100,0.001,0.01,0.484,823,881
12,1804,10,100,0.001,0.01,0.482,877,927
12,1904,10,100,0.001,0.01,0.508,935,969
12,2004,10,100,0.001,0.01,0.496,987,1017
12,2104,10,100,0.001,0.01,0.506,1043,1061
12,2204,10,100,0.001,0.01,0.518,1091,1113
12,2304,10,100,0.001,0.01,0.532,1145,1159
12,2404,10,100,0.001,0.01,0.528,1190,1214
12,2504,10,100,0.001,0.01,0.536,1241,1263
12,2604,10,100,0.001,0.01,0.536,1292,1312
12,2704,10,100,0.001,0.01,0.496,1338,1366
12,2804,10,100,0.001,0.01,0.552,1392,1412
12,2904,10,100,0.001,0.01,0.546,1444,1460
12,3004,10,100,0.001,0.01,0.52,1487,1517
12,3104,10,100,0.001,0.01,0.532,1541,1563
12,3204,10,100,0.001,0.01,0.548,1586,1618
12,3304,10,100,0.001,0.01,0.536,1630,1674
12,3404,10,100,0.001,0.01,0.564,1684,1720
12,3504,10,100,0.001,0.01,0.552,1729,1775
12,3604,10,100,0.001,0.01,0.564,1780,1824
12,3704,10,100,0.001,0.01,0.578,1833,1871
12,3804,10,100,0.001,0.01,0.608,1890,1914
12,3904,10,100,0.001,0.01,0.604,1940,1964
12,4004,10,100,0.001,0.01,0.604,1987,2017
12,4104,10,100,0.001,0.01,0.616,2044,2060
12,4204,10,100,0.001,0.01,0.624,2092,2112
12,4304,10,100,0.001,0.01,0.606,2153,2151
12,4404,10,100,0.001,0.01,0.614,2196,2208
12,4504,10,100,0.001,0.01,0.656,2241,2263
12,4604,10,100,0.001,0.01,0.626,2297,2307
12,4704,10,100,0.001,0.01,0.63,2342,2362
12,4804,10,100,0.001,0.01,0.658,2396,2408
12,4904,10,100,0.001,0.01,0.66,2446,2458
12,5004,10,100,0.001,0.01,0.672,2494,2510
12,5104,10,100,0.001,0.01,0.686,2546,2558
12,5204,10,100,0.001,0.01,0.658,2595,2609
12,5304,10,100,0.001,0.01,0.682,2651,2653
12,5404,10,100,0.001,0.01,0.688,2706,2698
12,5504,10,100,0.001,0.01,0.678,2750,2754
12,5604,10,100,0.001,0.01,0.684,2803,2801
12,5704,10,100,0.001,0.01,0.714,2853,2851
12,5804,10,100,0.001,0.01,0.682,2907,2897
12,5904,10,100,0.001,0.01,0.666,2950,2954
12,6004,10,100,0.001,0.01,0.696,3003,3001
12,6104,10,100,0.001,0.01,0.714,3055,3049
12,6204,10,100,0.001,0.01,0.738,3104,3100
12,6304,10,100,0.001,0.01,0.73,3152,3152
12,6404,10,100,0.001,0.01,0.694,3206,3198
12,6504,10,100,0.001,0.01,0.718,3253,3251
12,6604,10,100,0.001,0.01,0.738,3298,3306
12,6704,10,100,0.001,0.01,0.722,3340,3364
12,6804,10,100,0.001,0.01,0.75,3383,3421
12,6904,10,100,0.001,0.01,0.76,3423,3481
12,7004,10,100,0.001,0.01,0.752,3484,3520
12,7104,10,100,0.001,0.01,0.752,3531,3573
12,7204,10,100,0.001,0.01,0.756,3584,3620
12,7304,10,100,0.001,0.01,0.772,3632,3672
12,7404,10,100,0.001,0.01,0.768,3681,3723
12,7504,10,100,0.001,0.01,0.8,3730,3774
12,7604,10,100,0.001,0.01,0.792,3788,3816
12,7704,10,100,0.001,0.01,0.756,3842,3862
12,7804,10,100,0.001,0.01,0.8,3893,3911
12,7904,10,100,0.001,0.01,0.802,3952,3952
12,8004,10,100,0.001,0.01,0.798,4009,3995
12,8104,10,100,0.001,0.01,0.788,4061,4043
12,8204,10,100,0.001,0.01,0.778,4112,4092
12,8304,10,100,0.001,0.01,0.808,4170,4134
12,8404,10,100,0.001,0.01,0.798,4221,4183
12,8504,10,100,0.001,0.01,0.808,4281,4223
12,8604,10,100,0.001,0.01,0.82,4327,4277
12,8704,10,100,0.001,0.01,0.814,4381,4323
12,8804,10,100,0.001,0.01,0.816,4425,4379
12,8904,10,100,0.001,0.01,0.824,4474,4430
12,9004,10,100,0.001,0.01,0.802,4526,4478
12,9104,10,100,0.001,0.01,0.84,4570,4534
12,9204,10,100,0.001,0.01,0.822,4610,4594
12,9304,10,100,0.001,0.01,0.848,4659,4645
12,9404,10,100,0.001,0.01,0.836,4715,4689
12,9504,10,100,0.001,0.01,0.85,4765,4739
12,9604,10,100,0.001,0.01,0.85,4811,4793
12,9704,10,100,0.001,0.01,0.848,4857,4847
12,9804,10,100,0.001,0.01,0.836,4899,4905
12,9904,10,100,0.001,0.01,0.816,4955,4949
12,10004,10,100,0.001,0.01,0.824,4997,5007
12,10104,10,100,0.001,0.01,0.844,5051,5053
12,10204,10,100,0.001,0.01,0.832,5102,5102
12,10304,10,100,0.001,0.01,0.854,5157,5147
12,10404,10,100,0.001,0.01,0.854,5203,5201
12,10504,10,100,0.001,0.01,0.796,5258,5246
12,10604,10,100,0.001,0.01,0.826,5315,5289
12,10704,10,100,0.001,0.01,0.844,5368,5336
12,10804,10,100,0.001,0.01,0.854,5422,5382
12,10904,10,100,0.001,0.01,0.844,5471,5433
12,11004,10,100,0.001,0.01,0.84,5513,5491
12,11104,10,100,0.001,0.01,0.86,5564,5540
12,11204,10,100,0.001,0.01,0.852,5609,5595
12,11304,10,100,0.001,0.01,0.872,5663,5641
12,11404,10,100,0.001,0.01,0.85,5705,5699
12,11504,10,100,0.001,0.01,0.872,5763,5741
12,11604,10,100,0.001,0.01,0.868,5805,5799
12,11704,10,100,0.001,0.01,0.878,5859,5845
12,11804,10,100,0.001,0.01,0.888,5902,5902
12,11904,10,100,0.001,0.01,0.902,5950,5954
12,12004,10,100,0.001,0.01,0.878,5992,6012
12,12104,10,100,0.001,0.01,0.904,6044,6060
12,12204,10,100,0.001,0.01,0.896,6091,6113
12,12304,10,100,0.001,0.01,0.896,6138,6166
12,12404,10,100,0.001,0.01,0.908,6185,6219
12,12504,10,100,0.001,0.01,0.898,6228,6276
12,12604,10,100,0.001,0.01,0.918,6274,6330
12,12704,10,100,0.001,0.01,0.88,6325,6379
12,12804,10,100,0.001,0.01,0.906,6370,6434
12,12904,10,100,0.001,0.01,0.924,6414,6490
12,13004,10,100,0.001,0.01,0.92,6470,6534
12,13104,10,100,0.001,0.01,0.928,6521,6583
12,13204,10,100,0.001,0.01,0.9,6577,6627
12,13304,10,100,0.001,0.01,0.934,6632,6672
12,13404,10,100,0.001,0.01,0.94,6683,6721
12,13504,10,100,0.001,0.01,0.932,6741,6763
12,13604,10,100,0.001,0.01,0.92,6791,6813
12,13704,10,100,0.001,0.01,0.916,6847,6857
12,13804,10,100,0.001,0.01,0.914,6891,6913
12,13904,10,100,0.001,0.01,0.928,6952,6952
12,14004,10,100,0.001,0.01,0.944,7012,6992
12,14104,10,100,0.001,0.01,0.942,7061,7043
12,14204,10,100,0.001,0.01,0.92,7117,7087
12,14304,10,100,0.001,0.01,0.932,7170,7134
12,14404,10,100,0.001,0.01,0.944,7214,7190
12,14504,10,100,0.001,0.01,0.944,7268,7236
12,14604,10,100,0.001,0.01,0.95,7322,7282
12,14704,10,100,0.001,0.01,0.956,7372,7332
12,14804,10,100,0.001,0.01,0.946,7415,7389
12,14904,10,100,0.001,0.01,0.954,7463,7441
12,15004,10,100,0.001,0.01,0.936,7514,7490
13,104,10,100,0.001,0.01,0.486,51,53
13,204,10,100,0.001,0.01,0.494,87,117
13,304,10,100,0.001,0.01,0.498,136,168
13,404,10,100,0.001,0.01,0.516,185,219
13,504,10,100,0.001,0.01,0.502,229,275
13,604,10,100,0.001,0.01,0.488,280,324
13,704,10,100,0.001,0.01,0.524,338,366
13,804,10,100,0.001,0.01,0.514,386,418
13,904,10,100,0.001,0.01,0.502,436,468
13,1004,10,100,0.001,0.01,0.496,488,516
13,1104,10,100,0.001,0.01,0.506,538,566
13,1204,10,100,0.001,0.01,0.52,581,623
13,1304,10,100,0.001,0.01,0.54,631,673
13,1404,10,100,0.001,0.01,0.562,676,728
13,1504,10,100,0.001,0.01,0.548,728,776
13,1604,10,100,0.001,0.01,0.576,784,820
13,1704,10,100,0.001,0.01,0.582,836,868
13,1804,10,100,0.001,0.01,0.544,881,923
13,1904,10,100,0.001,0.01,0.566,939,965
13,2004,10,100,0.001,0.01,0.576,989,1015
13,2104,10,100,0.001,0.01,0.562,1039,1065
13,2204,10,100,0.001,0.01,0.596,1095,1109
13,2304,10,100,0.001,0.01,0.608,1141,1163
13,2404,10,100,0.001,0.01,0.6,1190,1214
13,2504,10,100,0.001,0.01,0.594,1243,1261
13,2604,10,100,0.001,0.01,0.606,1283,1321
13,2704,10,100,0.001,0.01,0.64,1332,1372
13,2804,10,100,0.001,0.01,0.636,1380,1424
13,2904,10,100,0.001,0.01,0.666,1425,1479
13,3004,10,100,0.001,0.01,0.66,1476,1528
13,3104,10,100,0.001,0.01,0.662,1532,1572
13,3204,10,100,0.001,0.01,0.698,1577,1627
13,3304,10,100,0.001,0.01,0.72,1628,1676
13,3404,10,100,0.001,0.01,0.706,1669,1735
13,3504,10,100,0.001,0.01,0.702,1720,1784
13,3604,10,100,0.001,0.01,0.694,1768,1836
13,3704,10,100,0.001,0.01,0.71,1817,1887
13,3804,10,100,0.001,0.01,0.744,1858,1946
13,3904,10,100,0.001,0.01,0.744,1909,1995
13,4004,10,100,0.001,0.01,0.738,1958,2046
13,4104,10,100,0.001,0.01,0.732,2014,2090
13,4204,10,100,0.001,0.01,0.784,2059,2145
13,4304,10,100,0.001,0.01,0.784,2115,2189
13,4404,10,100,0.001,0.01,0.766,2175,2229
13,4504,10,100,0.001,0.01,0.762,2221,2283
13,4604,10,100,0.001,0.01,0.784,2280,2324
13,4704,10,100,0.001,0.01,0.792,2336,2368
13,4804,10,100,0.001,0.01,0.788,2390,2414
13,4904,10,100,0.001,0.01,0.764,2439,2465
13,5004,10,100,0.001,0.01,0.764,2483,2521
13,5104,10,100,0.001,0.01,0.814,2531,2573
13,5204,10,100,0.001,0.01,0.79,2581,2623
13,5304,10,100,0.001,0.01,0.828,2637,2667
13,5404,10,100,0.001,0.01,0.83,2693,2711
13,5504,10,100,0.001,0.01,0.842,2748,2756
13,5604,10,100,0.001,0.01,0.842,2795,2809
13,5704,10,100,0.001,0.01,0.844,2853,2851
13,5804,10,100,0.001,0.01,0.852,2898,2906
13,5904,10,100,0.001,0.01,0.86,2954,2950
13,6004,10,100,0.001,0.01,0.864,3003,3001
13,6104,10,100,0.001,0.01,0.878,3055,3049
13,6204,10,100,0.001,0.01,0.876,3105,3099
13,6304,10,100,0.001,0.01,0.856,3159,3145
13,6404,10,100,0.001,0.01,0.862,3209,3195
13,6504,10,100,0.001,0.01,0.856,3263,3241
13,6604,10,100,0.001,0.01,0.88,3308,3296
13,6704,10,100,0.001,0.01,0.836,3364,3340
13,6804,10,100,0.001,0.01,0.862,3415,3389
13,6904,10,100,0.001,0.01,0.84,3454,3450
13,7004,10,100,0.001,0.01,0.896,3502,3502
13,7104,10,100,0.001,0.01,0.894,3556,3548
13,7204,10,100,0.001,0.01,0.906,3603,3601
13,7304,10,100,0.001,0.01,0.898,3653,3651
13,7404,10,100,0.001,0.01,0.88,3709,3695
13,7504,10,100,0.001,0.01,0.906,3762,3742
13,7604,10,100,0.001,0.01,0.886,3815,3789
13,7704,10,100,0.001,0.01,0.87,3863,3841
13,7804,10,100,0.001,0.01,0.918,3908,3896
13,7904,10,100,0.001,0.01,0.906,3961,3943
13,8004,10,100,0.001,0.01,0.896,4004,4000
13,8104,10,100,0.001,0.01,0.924,4053,4051
13,8204,10,100,0.001,0.01,0.914,4100,4104
13,8304,10,100,0.001,0.01,0.918,4146,4158
13,8404,10,100,0.001,0.01,0.918,4191,4213
13,8504,10,100,0.001,0.01,0.92,4238,4266
13,8604,10,100,0.001,0.01,0.904,4299,4305
13,8704,10,100,0.001,0.01,0.926,4348,4356
13,8804,10,100,0.001,0.01,0.92,4399,4405
13,8904,10,100,0.001,0.01,0.928,4443,4461
13,9004,10,100,0.001,0.01,0.94,4491,4513
13,9104,10,100,0.001,0.01,0.94,4537,4567
13,9204,10,100,0.001,0.01,0.932,4587,4617
13,9304,10,100,0.001,0.01,0.938,4643,4661
13,9404,10,100,0.001,0.01,0.944,4683,4721
13,9504,10,100,0.001,0.01,0.946,4735,4769
13,9604,10,100,0.001,0.01,0.928,4777,4827
13,9704,10,100,0.001,0.01,0.938,4833,4871
13,9804,10,100,0.001,0.01,0.918,4874,4930
13,9904,10,100,0.001,0.01,0.954,4919,4985
13,10004,10,100,0.001,0.01,0.962,4972,5032
13,10104,10,100,0.001,0.01,0.952,5027,5077
13,10204,10,100,0.001,0.01,0.966,5076,5128
13,10304,10,100,0.001,0.01,0.976,5120,5184
13,10404,10,100,0.001,0.01,0.968,5170,5234
13,10504,10,100,0.001,0.01,0.962,5229,5275
13,10604,10,100,0.001,0.01,0.962,5281,5323
13,10704,10,100,0.001,0.01,0.928,5336,5368
13,10804,10,100,0.001,0.01,0.954,5395,5409
13,10904,10,100,0.001,0.01,0.954,5443,5461
13,11004,10,100,0.001,0.01,0.966,5490,5514
13,11104,10,100,0.001,0.01,0.966,5545,5559
13,11204,10,100,0.001,0.01,0.968,5595,5609
13,11304,10,100,0.001,0.01,0.968,5648,5656
13,11404,10,100,0.001,0.01,0.976,5692,5712
13,11504,10,100,0.001,0.01,0.974,5751,5753
13,11604,10,100,0.001,0.01,0.974,5805,5799
13,11704,10,100,0.001,0.01,0.968,5849,5855
13,11804,10,100,0.001,0.01,0.974,5901,5903
13,11904,10,100,0.001,0.01,0.978,5944,5960
13,12004,10,100,0.001,0.01,0.982,5988,6016
13,12104,10,100,0.001,0.01,0.97,6042,6062
13,12204,10,100,0.001,0.01,0.972,6087,6117
13,12304,10,100,0.001,0.01,0.97,6144,6160
13,12404,10,100,0.001,0.01,0.972,6194,6210
13,12504,10,100,0.001,0.01,0.98,6247,6257
13,12604,10,100,0.001,0.01,0.978,6300,6304
13,12704,10,100,0.001,0.01,0.97,6353,6351
13,12804,10,100,0.001,0.01,0.986,6402,6402
13,12904,10,100,0.001,0.01,0.984,6460,6444
13,13004,10,100,0.001,0.01,0.98,6507,6497
13,13104,10,100,0.001,0.01,0.99,6555,6549
13,13204,10,100,0.001,0.01,0.988,6605,6599
13,13304,10,100,0.001,0.01,0.994,6655,6649
13,13404,10,100,0.001,0.01,0.988,6705,6699
13,13504,10,100,0.001,0.01,0.982,6760,6744
13,13604,10,100,0.001,0.01,0.984,6810,6794
13,13704,10,100,0.001,0.01,0.96,6868,6836
13,13804,10,100,0.001,0.01,0.98,6921,6883
13,13904,10,100,0.001,0.01,0.982,6971,6933
13,14004,10,100,0.001,0.01,0.99,7018,6986
13,14104,10,100,0.001,0.01,0.984,7067,7037
13,14204,10,100,0.001,0.01,0.984,7114,7090
13,14304,10,100,0.001,0.01,0.99,7166,7138
13,14404,10,100,0.001,0.01,0.986,7207,7197
13,14504,10,100,0.001,0.01,0.992,7251,7253
13,14604,10,100,0.001,0.01,0.988,7296,7308
13,14704,10,100,0.001,0.01,0.988,7349,7355
13,14804,10,100,0.001,0.01,0.992,7399,7405
13,14904,10,100,0.001,0.01,0.988,7449,7455
13,15004,10,100,0.001,0.01,0.992,7500,7504
14,104,10,100,0.001,0.01,0.5,61,43
14,204,10,100,0.001,0.01,0.542,117,87
14,304,10,100,0.001,0.01,0.506,167,137
14,404,10,100,0.001,0.01,0.488,220,184
14,504,10,100,0.001,0.01,0.538,270,234
14,604,10,100,0.001,0.01,0.508,331,273
14,704,10,100,0.001,0.01,0.496,387,317
14,804,10,100,0.001,0.01,0.5,431,373
14,904,10,100,0.001,0.01,0.52,482,422
14,1004,10,100,0.001,0.01,0.504,533,471
14,1104,10,100,0.001,0.01,0.508,575,529
14,1204,10,100,0.001,0.01,0.484,628,576
14,1304,10,100,0.001,0.01,0.5,675,629
14,1404,10,100,0.001,0.01,0.532,727,677
14,1504,10,100,0.001,0.01,0.502,781,723
14,1604,10,100,0.001,0.01,0.528,823,781
14,1704,10,100,0.001,0.01,0.53,876,828
14,1804,10,100,0.001,0.01,0.55,923,881
14,1904,10,100,0.001,0.01,0.502,962,942
14,2004,10,100,0.001,0.01,0.554,1027,977
14,2104,10,100,0.001,0.01,0.58,1087,1017
14,2204,10,100,0.001,0.01,0.592,1139,1065
14,2304,10,100,0.001,0.01,0.598,1190,1114
14,2404,10,100,0.001,0.01,0.636,1240,1164
14,2504,10,100,0.001,0.01,0.654,1296,1208
14,2604,10,100,0.001,0.01,0.676,1344,1260
14,2704,10,100,0.001,0.01,0.69,1406,1298
14,2804,10,100,0.001,0.01,0.688,1459,1345
14,2904,10,100,0.001,0.01,0.724,1510,1394
14,3004,10,100,0.001,0.01,0.752,1559,1445
14,3104,10,100,0.001,0.01,0.766,1614,1490
14,3204,10,100,0.001,0.01,0.778,1659,1545
14,3304,10,100,0.001,0.01,0.78,1706,1598
14,3404,10,100,0.001,0.01,0.794,1766,1638
14,3504,10,100,0.001,0.01,0.82,1821,1683
14,3604,10,100,0.001,0.01,0.818,1874,1730
14,3704,10,100,0.001,0.01,0.822,1922,1782
14,3804,10,100,0.001,0.01,0.822,1962,1842
14,3904,10,100,0.001,0.01,0.838,2012,1892
14,4004,10,100,0.001,0.01,0.842,2059,1945
14,4104,10,100,0.001,0.01,0.856,2113,1991
14,4204,10,100,0.001,0.01,0.844,2161,2043
14,4304,10,100,0.001,0.01,0.86,2200,2104
14,4404,10,100,0.001,0.01,0.852,2253,2151
14,4504,10,100,0.001,0.01,0.834,2305,2199
14,4604,10,100,0.001,0.01,0.862,2359,2245
14,4704,10,100,0.001,0.01,0.83,2407,2297
14,4804,10,100,0.001,0.01,0.858,2460,2344
14,4904,10,100,0.001,0.01,0.89,2507,2397
14,5004,10,100,0.001,0.01,0.874,2559,2445
14,5104,10,100,0.001,0.01,0.892,2616,2488
14,5204,10,100,0.001,0.01,0.886,2669,2535
14,5304,10,100,0.001,0.01,0.876,2720,2584
14,5404,10,100,0.001,0.01,0.896,2767,2637
14,5504,10,100,0.001,0.01,0.91,2818,2686
14,5604,10,100,0.001,0.01,0.908,2872,2732
14,5704,10,100,0.001,0.01,0.9,2915,2789
14,5804,10,100,0.001,0.01,0.918,2963,2841
14,5904,10,100,0.001,0.01,0.89,3016,2888
14,6004,10,100,0.001,0.01,0.894,3068,2936
14,6104,10,100,0.001,0.01,0.916,3112,2992
14,6204,10,100,0.001,0.01,0.896,3164,3040
14,6304,10,100,0.001,0.01,0.906,3210,3094
14,6404,10,100,0.001,0.01,0.904,3252,3152
14,6504,10,100,0.001,0.01,0.91,3293,3211
14,6604,10,100,0.001,0.01,0.92,3341,3263
14,6704,10,100,0.001,0.01,0.92,3393,3311
14,6804,10,100,0.001,0.01,0.914,3446,3358
14,6904,10,100,0.001,0.01,0.92,3493,3411
14,7004,10,100,0.001,0.01,0.922,3543,3461
14,7104,10,100,0.001,0.01,0.916,3593,3511
14,7204,10,100,0.001,0.01,0.932,3631,3573
14,7304,10,100,0.001,0.01,0.916,3677,3627
14,7404,10,100,0.001,0.01,0.914,3719,3685
14,7504,10,100,0.001,0.01,0.908,3759,3745
14,7604,10,100,0.001,0.01,0.92,3812,3792
14,7704,10,100,0.001,0.01,0.926,3859,3845
14,7804,10,100,0.001,0.01,0.932,3906,3898
14,7904,10,100,0.001,0.01,0.938,3955,3949
14,8004,10,100,0.001,0.01,0.948,4006,3998
14,8104,10,100,0.001,0.01,0.948,4056,4048
14,8204,10,100,0.001,0.01,0.948,4099,4105
14,8304,10,100,0.001,0.01,0.956,4139,4165
14,8404,10,100,0.001,0.01,0.948,4186,4218
14,8504,10,100,0.001,0.01,0.946,4223,4281
14,8604,10,100,0.001,0.01,0.958,4274,4330
14,8704,10,100,0.001,0.01,0.956,4317,4387
14,8804,10,100,0.001,0.01,0.958,4360,4444
14,8904,10,100,0.001,0.01,0.962,4405,4499
14,9004,10,100,0.001,0.01,0.966,4451,4553
14,9104,10,100,0.001,0.01,0.954,4500,4604
14,9204,10,100,0.001,0.01,0.96,4564,4640
14,9304,10,100,0.001,0.01,0.952,4616,4688
14,9404,10,100,0.001,0.01,0.948,4671,4733
14,9504,10,100,0.001,0.01,0.962,4724,4780
14,9604,10,100,0.001,0.01,0.964,4777,4827
14,9704,10,100,0.001,0.01,0.96,4823,4881
14,9804,10,100,0.001,0.01,0.968,4871,4933
14,9904,10,100,0.001,0.01,0.972,4923,4981
14,10004,10,100,0.001,0.01,0.97,4970,5034
14,10104,10,100,0.001,0.01,0.97,5024,5080
14,10204,10,100,0.001,0.01,0.97,5076,5128
14,10304,10,100,0.001,0.01,0.966,5132,5172
14,10404,10,100,0.001,0.01,0.944,5184,5220
14,10504,10,100,0.001,0.01,0.964,5235,5269
14,10604,10,100,0.001,0.01,0.966,5282,5322
14,10704,10,100,0.001,0.01,0.976,5334,5370
14,10804,10,100,0.001,0.01,0.98,5387,5417
14,10904,10,100,0.001,0.01,0.98,5435,5469
14,11004,10,100,0.001,0.01,0.978,5483,5521
14,11104,10,100,0.001,0.01,0.98,5536,5568
14,11204,10,100,0.001,0.01,0.984,5591,5613
14,11304,10,100,0.001,0.01,0.988,5637,5667
14,11404,10,100,0.001,0.01,0.98,5693,5711
14,11504,10,100,0.001,0.01,0.99,5742,5762
14,11604,10,100,0.001,0.01,0.988,5795,5809
14,11704,10,100,0.001,0.01,0.988,5844,5860
14,11804,10,100,0.001,0.01,0.98,5893,5911
14,11904,10,100,0.001,0.01,0.984,5940,5964
14,12004,10,100,0.001,0.01,0.968,5979,6025
14,12104,10,100,0.001,0.01,0.986,6030,6074
14,12204,10,100,0.001,0.01,0.976,6075,6129
14,12304,10,100,0.001,0.01,0.974,6132,6172
14,12404,10,100,0.001,0.01,0.984,6182,6222
14,12504,10,100,0.001,0.01,0.98,6232,6272
14,12604,10,100,0.001,0.01,0.984,6287,6317
14,12704,10,100,0.001,0.01,0.982,6331,6373
14,12804,10,100,0.001,0.01,0.99,6378,6426
14,12904,10,100,0.001,0.01,0.994,6429,6475
14,13004,10,100,0.001,0.01,0.99,6485,6519
14,13104,10,100,0.001,0.01,0.994,6538,6566
14,13204,10,100,0.001,0.01,0.994,6593,6611
14,13304,10,100,0.001,0.01,0.992,6640,6664
14,13404,10,100,0.001,0.01,0.99,6676,6728
14,13504,10,100,0.001,0.01,0.992,6725,6779
14,13604,10,100,0.001,0.01,0.978,6779,6825
14,13704,10,100,0.001,0.01,0.992,6823,6881
14,13804,10,100,0.001,0.01,0.992,6871,6933
14,13904,10,100,0.001,0.01,0.99,6920,6984
14,14004,10,100,0.001,0.01,0.994,6976,7028
14,14104,10,100,0.001,0.01,0.972,7026,7078
14,14204,10,100,0.001,0.01,0.994,7081,7123
14,14304,10,100,0.001,0.01,0.994,7129,7175
14,14404,10,100,0.001,0.01,0.996,7185,7219
14,14504,10,100,0.001,0.01,0.996,7238,7266
14,14604,10,100,0.001,0.01,0.994,7287,7317
14,14704,10,100,0.001,0.01,0.996,7335,7369
14,14804,10,100,0.001,0.01,0.994,7387,7417
14,14904,10,100,0.001,0.01,0.982,7440,7464
14,15004,10,100,0.001,0.01,0.994,7484,7520
15,104,10,100,0.001,0.01,0.524,58,46
15,204,10,100,0.001,0.01,0.524,115,89
15,304,10,100,0.001,0.01,0.506,164,140
15,404,10,100,0.001,0.01,0.472,213,191
15,504,10,100,0.001,0.01,0.514,258,246
15,604,10,100,0.001,0.01,0.552,312,292
15,704,10,100,0.001,0.01,0.554,358,346
15,804,10,100,0.001,0.01,0.508,406,398
15,904,10,100,0.001,0.01,0.508,462,442
15,1004,10,100,0.001,0.01,0.528,518,486
15,1104,10,100,0.001,0.01,0.53,565,539
15,1204,10,100,0.001,0.01,0.546,618,586
15,1304,10,100,0.001,0.01,0.54,660,644
15,1404,10,100,0.001,0.01,0.524,711,693
15,1504,10,100,0.001,0.01,0.528,757,747
15,1604,10,100,0.001,0.01,0.528,815,789
15,1704,10,100,0.001,0.01,0.546,862,842
15,1804,10,100,0.001,0.01,0.52,907,897
15,1904,10,100,0.001,0.01,0.528,953,951
15,2004,10,100,0.001,0.01,0.53,1007,997
15,2104,10,100,0.001,0.01,0.558,1064,1040
15,2204,10,100,0.001,0.01,0.542,1115,1089
15,2304,10,100,0.001,0.01,0.554,1160,1144
15,2404,10,100,0.001,0.01,0.56,1215,1189
15,2504,10,100,0.001,0.01,0.506,1261,1243
15,2604,10,100,0.001,0.01,0.558,1306,1298
15,2704,10,100,0.001,0.01,0.558,1364,1340
15,2804,10,100,0.001,0.01,0.54,1409,1395
15,2904,10,100,0.001,0.01,0.554,1457,1447
15,3004,10,100,0.001,0.01,0.546,1501,1503
15,3104,10,100,0.001,0.01,0.56,1553,1551
15,3204,10,100,0.001,0.01,0.536,1601,1603
15,3304,10,100,0.001,0.01,0.56,1650,1654
15,3404,10,100,0.001,0.01,0.582,1701,1703
15,3504,10,100,0.001,0.01,0.586,1758,1746
15,3604,10,100,0.001,0.01,0.616,1806,1798
15,3704,10,100,0.001,0.01,0.576,1857,1847
15,3804,10,100,0.001,0.01,0.606,1904,1900
15,3904,10,100,0.001,0.01,0.622,1948,1956
15,4004,10,100,0.001,0.01,0.638,1990,2014
15,4104,10,100,0.001,0.01,0.594,2046,2058
15,4204,10,100,0.001,0.01,0.648,2099,2105
15,4304,10,100,0.001,0.01,0.65,2151,2153
15,4404,10,100,0.001,0.01,0.636,2197,2207
15,4504,10,100,0.001,0.01,0.61,2233,2271
15,4604,10,100,0.001,0.01,0.666,2289,2315
15,4704,10,100,0.001,0.01,0.662,2337,2367
15,4804,10,100,0.001,0.01,0.666,2385,2419
15,4904,10,100,0.001,0.01,0.688,2431,2473
15,5004,10,100,0.001,0.01,0.682,2479,2525
15,5104,10,100,0.001,0.01,0.698,2532,2572
15,5204,10,100,0.001,0.01,0.672,2586,2618
15,5304,10,100,0.001,0.01,0.668,2636,2668
15,5404,10,100,0.001,0.01,0.7,2691,2713
15,5504,10,100,0.001,0.01,0.708,2750,2754
15,5604,10,100,0.001,0.01,0.692,2808,2796
15,5704,10,100,0.001,0.01,0.708,2865,2839
15,5804,10,100,0.001,0.01,0.718,2915,2889
15,5904,10,100,0.001,0.01,0.702,2964,2940
15,6004,10,100,0.001,0.01,0.704,3010,2994
15,6104,10,100,0.001,0.01,0.762,3054,3050
15,6204,10,100,0.001,0.01,0.746,3101,3103
15,6304,10,100,0.001,0.01,0.75,3158,3146
15,6404,10,100,0.001,0.01,0.76,3208,3196
15,6504,10,100,0.001,0.01,0.73,3266,3238
15,6604,10,100,0.001,0.01,0.764,3315,3289
15,6704,10,100,0.001,0.01,0.764,3362,3342
15,6804,10,100,0.001,0.01,0.768,3414,3390
15,6904,10,100,0.001,0.01,0.75,3466,3438
15,7004,10,100,0.001,0.01,0.764,3523,3481
15,7104,10,100,0.001,0.01,0.776,3569,3535
15,7204,10,100,0.001,0.01,0.796,3628,3576
15,7304,10,100,0.001,0.01,0.794,3667,3637
15,7404,10,100,0.001,0.01,0.766,3718,3686
15,7504,10,100,0.001,0.01,0.784,3771,3733
15,7604,10,100,0.001,0.01,0.798,3822,3782
15,7704,10,100,0.001,0.01,0.798,3865,3839
15,7804,10,100,0.001,0.01,0.83,3917,3887
15,7904,10,100,0.001,0.01,0.81,3966,3938
15,8004,10,100,0.001,0.01,0.818,4020,3984
15,8104,10,100,0.001,0.01,0.806,4075,4029
15,8204,10,100,0.001,0.01,0.808,4122,4082
15,8304,10,100,0.001,0.01,0.838,4172,4132
15,8404,10,100,0.001,0.01,0.822,4228,4176
15,8504,10,100,0.001,0.01,0.842,4273,4231
15,8604,10,100,0.001,0.01,0.842,4320,4284
15,8704,10,100,0.001,0.01,0.862,4370,4334
15,8804,10,100,0.001,0.01,0.876,4417,4387
15,8904,10,100,0.001,0.01,0.872,4460,4444
15,9004,10,100,0.001,0.01,0.856,4510,4494
15,9104,10,100,0.001,0.01,0.884,4557,4547
15,9204,10,100,0.001,0.01,0.89,4606,4598
15,9304,10,100,0.001,0.01,0.89,4652,4652
15,9404,10,100,0.001,0.01,0.904,4706,4698
15,9504,10,100,0.001,0.01,0.912,4754,4750
15,9604,10,100,0.001,0.01,0.9,4813,4791
15,9704,10,100,0.001,0.01,0.894,4861,4843
15,9804,10,100,0.001,0.01,0.91,4912,4892
15,9904,10,100,0.001,0.01,0.908,4965,4939
15,10004,10,100,0.001,0.01,0.914,5008,4996
15,10104,10,100,0.001,0.01,0.912,5053,5051
15,10204,10,100,0.001,0.01,0.93,5103,5101
15,10304,10,100,0.001,0.01,0.934,5156,5148
15,10404,10,100,0.001,0.01,0.928,5197,5207
15,10504,10,100,0.001,0.01,0.926,5251,5253
15,10604,10,100,0.001,0.01,0.938,5296,5308
15,10704,10,100,0.001,0.01,0.926,5345,5359
15,10804,10,100,0.001,0.01,0.932,5403,5401
15,10904,10,100,0.001,0.01,0.954,5456,5448
15,11004,10,100,0.001,0.01,0.956,5502,5502
15,11104,10,100,0.001,0.01,0.942,5559,5545
15,11204,10,100,0.001,0.01,0.96,5610,5594
15,11304,10,100,0.001,0.01,0.958,5660,5644
15,11404,10,100,0.001,0.01,0.956,5712,5692
15,11504,10,100,0.001,0.01,0.97,5766,5738
15,11604,10,100,0.001,0.01,0.952,5830,5774
15,11704,10,100,0.001,0.01,0.946,5870,5834
15,11804,10,100,0.001,0.01,0.952,5920,5884
15,11904,10,100,0.001,0.01,0.966,5963,5941
15,12004,10,100,0.001,0.01,0.972,6006,5998
15,12104,10,100,0.001,0.01,0.966,6051,6053
15,12204,10,100,0.001,0.01,0.97,6089,6115
15,12304,10,100,0.001,0.01,0.972,6136,6168
15,12404,10,100,0.001,0.01,0.974,6182,6222
15,12504,10,100,0.001,0.01,0.974,6231,6273
15,12604,10,100,0.001,0.01,0.97,6285,6319
15,12704,10,100,0.001,0.01,0.984,6346,6358
15,12804,10,100,0.001,0.01,0.97,6394,6410
15,12904,10,100,0.001,0.01,0.974,6438,6466
15,13004,10,100,0.001,0.01,0.978,6488,6516
15,13104,10,100,0.001,0.01,0.976,6540,6564
15,13204,10,100,0.001,0.01,0.976,6598,6606
15,13304,10,100,0.001,0.01,0.974,6646,6658
15,13404,10,100,0.001,0.01,0.98,6690,6714
15,13504,10,100,0.001,0.01,0.974,6743,6761
15,13604,10,100,0.001,0.01,0.984,6798,6806
15,13704,10,100,0.001,0.01,0.984,6845,6859
15,13804,10,100,0.001,0.01,0.982,6886,6918
15,13904,10,100,0.001,0.01,0.984,6933,6971
15,14004,10,100,0.001,0.01,0.974,6984,7020
15,14104,10,100,0.001,0.01,0.98,7038,7066
15,14204,10,100,0.001,0.01,0.978,7093,7111
15,14304,10,100,0.001,0.01,0.958,7148,7156
15,14404,10,100,0.001,0.01,0.978,7190,7214
15,14504,10,100,0.001,0.01,0.976,7243,7261
15,14604,10,100,0.001,0.01,0.982,7296,7308
15,14704,10,100,0.001,0.01,0.986,7341,7363
15,14804,10,100,0.001,0.01,0.984,7387,7417
15,14904,10,100,0.001,0.01,0.984,7441,7463
15,15004,10,100,0.001,0.01,0.984,7490,7514
16,104,10,100,0.001,0.01,0.486,44,60
16,204,10,100,0.001,0.01,0.494,96,108
16,304,10,100,0.001,0.01,0.508,142,162
16,404,10,100,0.001,0.01,0.486,195,209
16,504,10,100,0.001,0.01,0.488,238,266
16,604,10,100,0.001,0.01,0.508,288,316
16,704,10,100,0.001,0.01,0.528,339,365
16,804,10,100,0.001,0.01,0.504,391,413
16,904,10,100,0.001,0.01,0.514,437,467
16,1004,10,100,0.001,0.01,0.506,482,522
16,1104,10,100,0.001,0.01,0.53,530,574
16,1204,10,100,0.001,0.01,0.512,585,619
16,1304,10,100,0.001,0.01,0.502,633,671
16,1404,10,100,0.001,0.01,0.514,688,716
16,1504,10,100,0.001,0.01,0.492,744,760
16,1604,10,100,0.001,0.01,0.516,795,809
16,1704,10,100,0.001,0.01,0.544,837,867
16,1804,10,100,0.001,0.01,0.564,888,916
16,1904,10,100,0.001,0.01,0.554,937,967
16,2004,10,100,0.001,0.01,0.612,983,1021
16,2104,10,100,0.001,0.01,0.648,1036,1068
16,2204,10,100,0.001,0.01,0.656,1085,1119
16,2304,10,100,0.001,0.01,0.654,1133,1171
16,2404,10,100,0.001,0.01,0.706,1188,1216
16,2504,10,100,0.001,0.01,0.688,1234,1270
16,2604,10,100,0.001,0.01,0.682,1283,1321
16,2704,10,100,0.001,0.01,0.716,1335,1369
16,2804,10,100,0.001,0.01,0.752,1384,1420
16,2904,10,100,0.001,0.01,0.772,1436,1468
16,3004,10,100,0.001,0.01,0.806,1474,1530
16,3104,10,100,0.001,0.01,0.764,1523,1581
16,3204,10,100,0.001,0.01,0.752,1578,1626
16,3304,10,100,0.001,0.01,0.798,1628,1676
16,3404,10,100,0.001,0.01,0.794,1673,1731
16,3504,10,100,0.001,0.01,0.834,1719,1785
16,3604,10,100,0.001,0.01,0.854,1764,1840
16,3704,10,100,0.001,0.01,0.844,1825,1879
16,3804,10,100,0.001,0.01,0.82,1873,1931
16,3904,10,100,0.001,0.01,0.83,1921,1983
16,4004,10,100,0.001,0.01,0.866,1967,2037
16,4104,10,100,0.001,0.01,0.894,2023,2081
16,4204,10,100,0.001,0.01,0.896,2075,2129
16,4304,10,100,0.001,0.01,0.89,2123,2181
16,4404,10,100,0.001,0.01,0.904,2163,2241
16,4504,10,100,0.001,0.01,0.886,2213,2291
16,4604,10,100,0.001,0.01,0.902,2260,2344
16,4704,10,100,0.001,0.01,0.892,2303,2401
16,4804,10,100,0.001,0.01,0.902,2355,2449
16,4904,10,100,0.001,0.01,0.9,2403,2501
16,5004,10,100,0.001,0.01,0.916,2462,2542
16,5104,10,100,0.001,0.01,0.932,2509,2595
16,5204,10,100,0.001,0.01,0.93,2560,2644
16,5304,10,100,0.001,0.01,0.928,2607,2697
16,5404,10,100,0.001,0.01,0.912,2660,2744
16,5504,10,100,0.001,0.01,0.914,2710,2794
16,5604,10,100,0.001,0.01,0.94,2757,2847
16,5704,10,100,0.001,0.01,0.934,2806,2898
16,5804,10,100,0.001,0.01,0.934,2859,2945
16,5904,10,100,0.001,0.01,0.948,2910,2994
16,6004,10,100,0.001,0.01,0.954,2975,3029
16,6104,10,100,0.001,0.01,0.954,3040,3064
16,6204,10,100,0.001,0.01,0.94,3094,3110
16,6304,10,100,0.001,0.01,0.936,3139,3165
16,6404,10,100,0.001,0.01,0.932,3188,3216
16,6504,10,100,0.001,0.01,0.95,3245,3259
16,6604,10,100,0.001,0.01,0.944,3297,3307
16,6704,10,100,0.001,0.01,0.954,3349,3355
16,6804,10,100,0.001,0.01,0.958,3405,3399
16,6904,10,100,0.001,0.01,0.958,3452,3452
16,7004,10,100,0.001,0.01,0.964,3511,3493
16,7104,10,100,0.001,0.01,0.968,3559,3545
16,7204,10,100,0.001,0.01,0.946,3614,3590
16,7304,10,100,0.001,0.01,0.956,3659,3645
16,7404,10,100,0.001,0.01,0.934,3707,3697
16,7504,10,100,0.001,0.01,0.958,3754,3750
16,7604,10,100,0.001,0.01,0.95,3803,3801
16,7704,10,100,0.001,0.01,0.952,3854,3850
16,7804,10,100,0.001,0.01,0.958,3913,3891
16,7904,10,100,0.001,0.01,0.948,3966,3938
16,8004,10,100,0.001,0.01,0.956,4012,3992
16,8104,10,100,0.001,0.01,0.968,4061,4043
16,8204,10,100,0.001,0.01,0.972,4107,4097
16,8304,10,100,0.001,0.01,0.964,4165,4139
16,8404,10,100,0.001,0.01,0.97,4209,4195
16,8504,10,100,0.001,0.01,0.958,4252,4252
16,8604,10,100,0.001,0.01,0.964,4305,4299
16,8704,10,100,0.001,0.01,0.964,4354,4350
16,8804,10,100,0.001,0.01,0.96,4411,4393
16,8904,10,100,0.001,0.01,0.944,4463,4441
16,9004,10,100,0.001,0.01,0.97,4518,4486
16,9104,10,100,0.001,0.01,0.972,4569,4535
16,9204,10,100,0.001,0.01,0.97,4620,4584
16,9304,10,100,0.001,0.01,0.98,4670,4634
16,9404,10,100,0.001,0.01,0.984,4715,4689
16,9504,10,100,0.001,0.01,0.982,4774,4730
16,9604,10,100,0.001,0.01,0.98,4826,4778
16,9704,10,100,0.001,0.01,0.982,4874,4830
16,9804,10,100,0.001,0.01,0.984,4920,4884
16,9904,10,100,0.001,0.01,0.982,4970,4934
16,10004,10,100,0.001,0.01,0.98,5021,4983
16,10104,10,100,0.001,0.01,0.976,5070,5034
16,10204,10,100,0.001,0.01,0.976,5112,5092
16,10304,10,100,0.001,0.01,0.964,5166,5138
16,10404,10,100,0.001,0.01,0.976,5223,5181
16,10504,10,100,0.001,0.01,0.982,5271,5233
16,10604,10,100,0.001,0.01,0.978,5315,5289
16,10704,10,100,0.001,0.01,0.98,5362,5342
16,10804,10,100,0.001,0.01,0.978,5417,5387
16,10904,10,100,0.001,0.01,0.99,5470,5434
16,11004,10,100,0.001,0.01,0.986,5527,5477
16,11104,10,100,0.001,0.01,0.986,5586,5518
16,11204,10,100,0.001,0.01,0.984,5632,5572
16,11304,10,100,0.001,0.01,0.986,5670,5634
16,11404,10,100,0.001,0.01,0.99,5725,5679
16,11504,10,100,0.001,0.01,0.984,5772,5732
16,11604,10,100,0.001,0.01,0.986,5820,5784
16,11704,10,100,0.001,0.01,0.932,5866,5838
16,11804,10,100,0.001,0.01,0.97,5914,5890
16,11904,10,100,0.001,0.01,0.978,5969,5935
16,12004,10,100,0.001,0.01,0.986,6031,5973
16,12104,10,100,0.001,0.01,0.984,6087,6017
16,12204,10,100,0.001,0.01,0.974,6134,6070
16,12304,10,100,0.001,0.01,0.986,6181,6123
16,12404,10,100,0.001,0.01,0.988,6223,6181
16,12504,10,100,0.001,0.01,0.976,6268,6236
16,12604,10,100,0.001,0.01,0.988,6311,6293
16,12704,10,100,0.001,0.01,0.988,6359,6345
16,12804,10,100,0.001,0.01,0.99,6406,6398
16,12904,10,100,0.001,0.01,0.99,6458,6446
16,13004,10,100,0.001,0.01,0.99,6510,6494
16,13104,10,100,0.001,0.01,0.992,6555,6549
16,13204,10,100,0.001,0.01,0.992,6601,6603
16,13304,10,100,0.001,0.01,0.992,6651,6653
16,13404,10,100,0.001,0.01,0.992,6703,6701
16,13504,10,100,0.001,0.01,0.992,6756,6748
16,13604,10,100,0.001,0.01,0.992,6810,6794
16,13704,10,100,0.001,0.01,0.994,6856,6848
16,13804,10,100,0.001,0.01,0.992,6903,6901
16,13904,10,100,0.001,0.01,0.974,6942,6962
16,14004,10,100,0.001,0.01,0.978,6985,7019
16,14104,10,100,0.001,0.01,0.986,7033,7071
16,14204,10,100,0.001,0.01,0.988,7084,7120
16,14304,10,100,0.001,0.01,0.992,7135,7169
16,14404,10,100,0.001,0.01,0.994,7189,7215
16,14504,10,100,0.001,0.01,0.994,7242,7262
16,14604,10,100,0.001,0.01,0.994,7298,7306
16,14704,10,100,0.001,0.01,0.99,7352,7352
16,14804,10,100,0.001,0.01,0.994,7395,7409
16,14904,10,100,0.001,0.01,0.992,7442,7462
16,15004,10,100,0.001,0.01,0.992,7494,7510
17,104,10,100,0.001,0.01,0.526,43,61
17,204,10,100,0.001,0.01,0.49,99,105
17,304,10,100,0.001,0.01,0.486,148,156
17,404,10,100,0.001,0.01,0.518,189,215
17,504,10,100,0.001,0.01,0.51,246,258
17,604,10,100,0.001,0.01,0.494,291,313
17,704,10,100,0.001,0.01,0.46,338,366
17,804,10,100,0.001,0.01,0.49,392,412
17,904,10,100,0.001,0.01,0.484,448,456
17,1004,10,100,0.001,0.01,0.5,493,511
17,1104,10,100,0.001,0.01,0.504,539,565
17,1204,10,100,0.001,0.01,0.5,592,612
17,1304,10,100,0.001,0.01,0.52,642,662
17,1404,10,100,0.001,0.01,0.5,694,710
17,1504,10,100,0.001,0.01,0.49,742,762
17,1604,10,100,0.001,0.01,0.536,802,802
17,1704,10,100,0.001,0.01,0.536,851,853
17,1804,10,100,0.001,0.01,0.552,902,902
17,1904,10,100,0.001,0.01,0.576,953,951
17,2004,10,100,0.001,0.01,0.596,1006,998
17,2104,10,100,0.001,0.01,0.616,1055,1049
17,2204,10,100,0.001,0.01,0.628,1112,1092
17,2304,10,100,0.001,0.01,0.688,1177,1127
17,2404,10,100,0.001,0.01,0.732,1232,1172
17,2504,10,100,0.001,0.01,0.782,1280,1224
17,2604,10,100,0.001,0.01,0.728,1328,1276
17,2704,10,100,0.001,0.01,0.744,1385,1319
17,2804,10,100,0.001,0.01,0.802,1431,1373
17,2904,10,100,0.001,0.01,0.868,1480,1424
17,3004,10,100,0.001,0.01,0.866,1532,1472
17,3104,10,100,0.001,0.01,0.882,1575,1529
17,3204,10,100,0.001,0.01,0.896,1626,1578
17,3304,10,100,0.001,0.01,0.906,1677,1627
17,3404,10,100,0.001,0.01,0.914,1719,1685
17,3504,10,100,0.001,0.01,0.912,1771,1733
17,3604,10,100,0.001,0.01,0.878,1818,1786
17,3704,10,100,0.001,0.01,0.914,1873,1831
17,3804,10,100,0.001,0.01,0.906,1928,1876
17,3904,10,100,0.001,0.01,0.938,1964,1940
17,4004,10,100,0.001,0.01,0.914,2013,1991
17,4104,10,100,0.001,0.01,0.932,2065,2039
17,4204,10,100,0.001,0.01,0.938,2113,2091
17,4304,10,100,0.001,0.01,0.956,2170,2134
17,4404,10,100,0.001,0.01,0.954,2220,2184
17,4504,10,100,0.001,0.01,0.944,2276,2228
17,4604,10,100,0.001,0.01,0.936,2328,2276
17,4704,10,100,0.001,0.01,0.95,2383,2321
17,4804,10,100,0.001,0.01,0.94,2438,2366
17,4904,10,100,0.001,0.01,0.954,2492,2412
17,5004,10,100,0.001,0.01,0.962,2549,2455
17,5104,10,100,0.001,0.01,0.96,2592,2512
17,5204,10,100,0.001,0.01,0.958,2648,2556
17,5304,10,100,0.001,0.01,0.946,2701,2603
17,5404,10,100,0.001,0.01,0.948,2748,2656
17,5504,10,100,0.001,0.01,0.962,2790,2714
17,5604,10,100,0.001,0.01,0.97,2837,2767
17,5704,10,100,0.001,0.01,0.974,2887,2817
17,5804,10,100,0.001,0.01,0.964,2934,2870
17,5904,10,100,0.001,0.01,0.984,2979,2925
17,6004,10,100,0.001,0.01,0.972,3031,2973
17,6104,10,100,0.001,0.01,0.974,3086,3018
17,6204,10,100,0.001,0.01,0.956,3147,3057
17,6304,10,100,0.001,0.01,0.974,3191,3113
17,6404,10,100,0.001,0.01,0.972,3249,3155
17,6504,10,100,0.001,0.01,0.966,3297,3207
17,6604,10,100,0.001,0.01,0.972,3359,3245
17,6704,10,100,0.001,0.01,0.97,3418,3286
17,6804,10,100,0.001,0.01,0.972,3461,3343
17,6904,10,100,0.001,0.01,0.982,3508,3396
17,7004,10,100,0.001,0.01,0.974,3565,3439
17,7104,10,100,0.001,0.01,0.978,3625,3479
17,7204,10,100,0.001,0.01,0.972,3667,3537
17,7304,10,100,0.001,0.01,0.98,3716,3588
17,7404,10,100,0.001,0.01,0.98,3765,3639
17,7504,10,100,0.001,0.01,0.986,3811,3693
17,7604,10,100,0.001,0.01,0.982,3858,3746
17,7704,10,100,0.001,0.01,0.98,3897,3807
17,7804,10,100,0.001,0.01,0.98,3945,3859
17,7904,10,100,0.001,0.01,0.948,3992,3912
17,8004,10,100,0.001,0.01,0.968,4035,3969
17,8104,10,100,0.001,0.01,0.98,4072,4032
17,8204,10,100,0.001,0.01,0.984,4117,4087
17,8304,10,100,0.001,0.01,0.972,4162,4142
17,8404,10,100,0.001,0.01,0.988,4221,4183
17,8504,10,100,0.001,0.01,0.994,4274,4230
17,8604,10,100,0.001,0.01,0.99,4325,4279
17,8704,10,100,0.001,0.01,0.994,4375,4329
17,8804,10,100,0.001,0.01,0.992,4428,4376
17,8904,10,100,0.001,0.01,0.99,4477,4427
17,9004,10,100,0.001,0.01,0.988,4536,4468
17,9104,10,100,0.001,0.01,0.994,4595,4509
17,9204,10,100,0.001,0.01,0.994,4634,4570
17,9304,10,100,0.001,0.01,0.992,4695,4609
17,9404,10,100,0.001,0.01,0.988,4746,4658
17,9504,10,100,0.001,0.01,0.996,4795,4709
17,9604,10,100,0.001,0.01,0.99,4845,4759
17,9704,10,100,0.001,0.01,0.978,4890,4814
17,9804,10,100,0.001,0.01,0.982,4933,4871
17,9904,10,100,0.001,0.01,0.982,4984,4920
17,10004,10,100,0.001,0.01,0.986,5031,4973
17,10104,10,100,0.001,0.01,0.994,5084,5020
17,10204,10,100,0.001,0.01,0.994,5131,5073
17,10304,10,100,0.001,0.01,0.978,5182,5122
17,10404,10,100,0.001,0.01,0.984,5228,5176
17,10504,10,100,0.001,0.01,0.986,5277,5227
17,10604,10,100,0.001,0.01,0.986,5323,5281
17,10704,10,100,0.001,0.01,0.986,5369,5335
17,10804,10,100,0.001,0.01,0.992,5409,5395
17,10904,10,100,0.001,0.01,1.0,5453,5451
17,11004,10,100,0.001,0.01,0.996,5503,5501
17,11104,10,100,0.001,0.01,0.998,5552,5552
17,11204,10,100,0.001,0.01,0.998,5600,5604
17,11304,10,100,0.001,0.01,0.998,5651,5653
17,11404,10,100,0.001,0.01,0.998,5700,5704
17,11504,10,100,0.001,0.01,0.996,5754,5750
17,11604,10,100,0.001,0.01,0.982,5801,5803
17,11704,10,100,0.001,0.01,0.99,5859,5845
17,11804,10,100,0.001,0.01,0.994,5922,5882
17,11904,10,100,0.001,0.01,0.986,5976,5928
17,12004,10,100,0.001,0.01,0.998,6026,5978
17,12104,10,100,0.001,0.01,0.99,6075,6029
17,12204,10,100,0.001,0.01,0.998,6124,6080
17,12304,10,100,0.001,0.01,0.998,6169,6135
17,12404,10,100,0.001,0.01,0.998,6216,6188
17,12504,10,100,0.001,0.01,0.998,6266,6238
17,12604,10,100,0.001,0.01,0.98,6315,6289
17,12704,10,100,0.001,0.01,0.994,6366,6338
17,12804,10,100,0.001,0.01,0.988,6424,6380
17,12904,10,100,0.001,0.01,0.99,6470,6434
17,13004,10,100,0.001,0.01,0.998,6517,6487
17,13104,10,100,0.001,0.01,1.0,6555,6549
17,13204,10,100,0.001,0.01,1.0,6600,6604
17,13304,10,100,0.001,0.01,1.0,6653,6651
17,13404,10,100,0.001,0.01,1.0,6704,6700
17,13504,10,100,0.001,0.01,1.0,6758,6746
17,13604,10,100,0.001,0.01,1.0,6815,6789
17,13704,10,100,0.001,0.01,0.998,6871,6833
17,13804,10,100,0.001,0.01,0.996,6921,6883
17,13904,10,100,0.001,0.01,0.978,6977,6927
17,14004,10,100,0.001,0.01,0.998,7016,6988
17,14104,10,100,0.001,0.01,0.996,7065,7039
17,14204,10,100,0.001,0.01,1.0,7108,7096
17,14304,10,100,0.001,0.01,1.0,7152,7152
17,14404,10,100,0.001,0.01,1.0,7201,7203
17,14504,10,100,0.001,0.01,1.0,7254,7250
17,14604,10,100,0.001,0.01,1.0,7302,7302
17,14704,10,100,0.001,0.01,1.0,7350,7354
17,14804,10,100,0.001,0.01,1.0,7399,7405
17,14904,10,100,0.001,0.01,1.0,7438,7466
17,15004,10,100,0.001,0.01,0.998,7489,7515
18,104,10,100,0.001,0.01,0.518,49,55
18,204,10,100,0.001,0.01,0.454,97,107
18,304,10,100,0.001,0.01,0.504,151,153
18,404,10,100,0.001,0.01,0.468,201,203
18,504,10,100,0.001,0.01,0.46,248,256
18,604,10,100,0.001,0.01,0.468,295,309
18,704,10,100,0.001,0.01,0.458,344,360
18,804,10,100,0.001,0.01,0.488,388,416
18,904,10,100,0.001,0.01,0.494,441,463
18,1004,10,100,0.001,0.01,0.504,492,512
18,1104,10,100,0.001,0.01,0.472,538,566
18,1204,10,100,0.001,0.01,0.502,600,604
18,1304,10,100,0.001,0.01,0.52,646,658
18,1404,10,100,0.001,0.01,0.512,697,707
18,1504,10,100,0.001,0.01,0.51,750,754
18,1604,10,100,0.001,0.01,0.488,794,810
18,1704,10,100,0.001,0.01,0.492,848,856
18,1804,10,100,0.001,0.01,0.524,901,903
18,1904,10,100,0.001,0.01,0.514,949,955
18,2004,10,100,0.001,0.01,0.558,1000,1004
18,2104,10,100,0.001,0.01,0.538,1054,1050
18,2204,10,100,0.001,0.01,0.564,1105,1099
18,2304,10,100,0.001,0.01,0.564,1159,1145
18,2404,10,100,0.001,0.01,0.624,1196,1208
18,2504,10,100,0.001,0.01,0.62,1233,1271
18,2604,10,100,0.001,0.01,0.648,1287,1317
18,2704,10,100,0.001,0.01,0.688,1335,1369
18,2804,10,100,0.001,0.01,0.678,1380,1424
18,2904,10,100,0.001,0.01,0.668,1435,1469
18,3004,10,100,0.001,0.01,0.712,1482,1522
18,3104,10,100,0.001,0.01,0.748,1522,1582
18,3204,10,100,0.001,0.01,0.748,1567,1637
18,3304,10,100,0.001,0.01,0.774,1612,1692
18,3404,10,100,0.001,0.01,0.814,1656,1748
18,3504,10,100,0.001,0.01,0.84,1700,1804
18,3604,10,100,0.001,0.01,0.83,1742,1862
18,3704,10,100,0.001,0.01,0.858,1795,1909
18,3804,10,100,0.001,0.01,0.822,1846,1958
18,3904,10,100,0.001,0.01,0.81,1899,2005
18,4004,10,100,0.001,0.01,0.898,1950,2054
18,4104,10,100,0.001,0.01,0.9,2005,2099
18,4204,10,100,0.001,0.01,0.902,2056,2148
18,4304,10,100,0.001,0.01,0.914,2110,2194
18,4404,10,100,0.001,0.01,0.924,2160,2244
18,4504,10,100,0.001,0.01,0.94,2207,2297
18,4604,10,100,0.001,0.01,0.912,2257,2347
18,4704,10,100,0.001,0.01,0.93,2309,2395
18,4804,10,100,0.001,0.01,0.93,2364,2440
18,4904,10,100,0.001,0.01,0.94,2415,2489
18,5004,10,100,0.001,0.01,0.934,2467,2537
18,5104,10,100,0.001,0.01,0.936,2522,2582
18,5204,10,100,0.001,0.01,0.924,2570,2634
18,5304,10,100,0.001,0.01,0.936,2620,2684
18,5404,10,100,0.001,0.01,0.946,2672,2732
18,5504,10,100,0.001,0.01,0.944,2721,2783
18,5604,10,100,0.001,0.01,0.92,2765,2839
18,5704,10,100,0.001,0.01,0.946,2810,2894
18,5804,10,100,0.001,0.01,0.952,2867,2937
18,5904,10,100,0.001,0.01,0.946,2913,2991
18,6004,10,100,0.001,0.01,0.942,2965,3039
18,6104,10,100,0.001,0.01,0.966,3013,3091
18,6204,10,100,0.001,0.01,0.962,3054,3150
18,6304,10,100,0.001,0.01,0.962,3103,3201
18,6404,10,100,0.001,0.01,0.968,3152,3252
18,6504,10,100,0.001,0.01,0.974,3207,3297
18,6604,10,100,0.001,0.01,0.968,3257,3347
18,6704,10,100,0.001,0.01,0.968,3309,3395
18,6804,10,100,0.001,0.01,0.97,3352,3452
18,6904,10,100,0.001,0.01,0.984,3410,3494
18,7004,10,100,0.001,0.01,0.98,3463,3541
18,7104,10,100,0.001,0.01,0.97,3517,3587
18,7204,10,100,0.001,0.01,0.974,3564,3640
18,7304,10,100,0.001,0.01,0.984,3613,3691
18,7404,10,100,0.001,0.01,0.982,3669,3735
18,7504,10,100,0.001,0.01,0.98,3715,3789
18,7604,10,100,0.001,0.01,0.976,3763,3841
18,7704,10,100,0.001,0.01,0.978,3818,3886
18,7804,10,100,0.001,0.01,0.976,3860,3944
18,7904,10,100,0.001,0.01,0.98,3907,3997
18,8004,10,100,0.001,0.01,0.986,3955,4049
18,8104,10,100,0.001,0.01,0.984,3996,4108
18,8204,10,100,0.001,0.01,0.98,4047,4157
18,8304,10,100,0.001,0.01,0.978,4101,4203
18,8404,10,100,0.001,0.01,0.984,4147,4257
18,8504,10,100,0.001,0.01,0.988,4194,4310
18,8604,10,100,0.001,0.01,0.986,4246,4358
18,8704,10,100,0.001,0.01,0.99,4307,4397
18,8804,10,100,0.001,0.01,0.984,4362,4442
18,8904,10,100,0.001,0.01,0.988,4416,4488
18,9004,10,100,0.001,0.01,0.988,4463,4541
18,9104,10,100,0.001,0.01,0.986,4518,4586
18,9204,10,100,0.001,0.01,0.988,4566,4638
18,9304,10,100,0.001,0.01,0.978,4618,4686
18,9404,10,100,0.001,0.01,0.982,4667,4737
18,9504,10,100,0.001,0.01,0.988,4712,4792
18,9604,10,100,0.001,0.01,0.978,4765,4839
18,9704,10,100,0.001,0.01,0.988,4815,4889
18,9804,10,100,0.001,0.01,0.984,4863,4941
18,9904,10,100,0.001,0.01,0.986,4913,4991
18,10004,10,100,0.001,0.01,0.99,4957,5047
18,10104,10,100,0.001,0.01,0.986,5011,5093
18,10204,10,100,0.001,0.01,0.986,5070,5134
18,10304,10,100,0.001,0.01,0.988,5119,5185
18,10404,10,100,0.001,0.01,0.992,5170,5234
18,10504,10,100,0.001,0.01,0.99,5215,5289
18,10604,10,100,0.001,0.01,0.974,5261,5343
18,10704,10,100,0.001,0.01,0.992,5309,5395
18,10804,10,100,0.001,0.01,0.982,5367,5437
18,10904,10,100,0.001,0.01,0.994,5419,5485
18,11004,10,100,0.001,0.01,0.996,5468,5536
18,11104,10,100,0.001,0.01,1.0,5532,5572
18,11204,10,100,0.001,0.01,0.998,5585,5619
18,11304,10,100,0.001,0.01,0.988,5634,5670
18,11404,10,100,0.001,0.01,0.994,5679,5725
18,11504,10,100,0.001,0.01,0.994,5735,5769
18,11604,10,100,0.001,0.01,0.994,5784,5820
18,11704,10,100,0.001,0.01,0.994,5834,5870
18,11804,10,100,0.001,0.01,0.996,5885,5919
18,11904,10,100,0.001,0.01,0.998,5930,5974
18,12004,10,100,0.001,0.01,0.994,5979,6025
18,12104,10,100,0.001,0.01,0.996,6029,6075
18,12204,10,100,0.001,0.01,0.99,6070,6134
18,12304,10,100,0.001,0.01,0.996,6127,6177
18,12404,10,100,0.001,0.01,0.984,6192,6212
18,12504,10,100,0.001,0.01,0.994,6249,6255
18,12604,10,100,0.001,0.01,0.988,6295,6309
18,12704,10,100,0.001,0.01,0.988,6337,6367
18,12804,10,100,0.001,0.01,0.996,6384,6420
18,12904,10,100,0.001,0.01,0.992,6439,6465
18,13004,10,100,0.001,0.01,0.996,6491,6513
18,13104,10,100,0.001,0.01,0.996,6540,6564
18,13204,10,100,0.001,0.01,0.996,6604,6600
18,13304,10,100,0.001,0.01,0.998,6653,6651
18,13404,10,100,0.001,0.01,0.998,6702,6702
18,13504,10,100,0.001,0.01,0.996,6752,6752
18,13604,10,100,0.001,0.01,0.998,6803,6801
18,13704,10,100,0.001,0.01,0.998,6844,6860
18,13804,10,100,0.001,0.01,0.998,6899,6905
18,13904,10,100,0.001,0.01,0.998,6943,6961
18,14004,10,100,0.001,0.01,0.998,7001,7003
18,14104,10,100,0.001,0.01,0.996,7071,7033
18,14204,10,100,0.001,0.01,0.996,7126,7078
18,14304,10,100,0.001,0.01,0.998,7172,7132
18,14404,10,100,0.001,0.01,0.99,7221,7183
18,14504,10,100,0.001,0.01,0.992,7266,7238
18,14604,10,100,0.001,0.01,0.996,7312,7292
18,14704,10,100,0.001,0.01,1.0,7358,7346
18,14804,10,100,0.001,0.01,0.998,7412,7392
18,14904,10,100,0.001,0.01,1.0,7464,7440
18,15004,10,100,0.001,0.01,1.0,7510,7494
19,104,10,100,0.001,0.01,0.518,54,50
19,204,10,100,0.001,0.01,0.53,112,92
19,304,10,100,0.001,0.01,0.514,163,141
19,404,10,100,0.001,0.01,0.524,211,193
19,504,10,100,0.001,0.01,0.506,255,249
19,604,10,100,0.001,0.01,0.494,301,303
19,704,10,100,0.001,0.01,0.498,357,347
19,804,10,100,0.001,0.01,0.492,409,395
19,904,10,100,0.001,0.01,0.496,458,446
19,1004,10,100,0.001,0.01,0.516,509,495
19,1104,10,100,0.001,0.01,0.51,554,550
19,1204,10,100,0.001,0.01,0.49,609,595
19,1304,10,100,0.001,0.01,0.49,665,639
19,1404,10,100,0.001,0.01,0.486,711,693
19,1504,10,100,0.001,0.01,0.492,772,732
19,1604,10,100,0.001,0.01,0.48,820,784
19,1704,10,100,0.001,0.01,0.476,870,834
19,1804,10,100,0.001,0.01,0.506,915,889
19,1904,10,100,0.001,0.01,0.492,960,944
19,2004,10,100,0.001,0.01,0.508,1012,992
19,2104,10,100,0.001,0.01,0.516,1060,1044
19,2204,10,100,0.001,0.01,0.508,1116,1088
19,2304,10,100,0.001,0.01,0.516,1170,1134
19,2404,10,100,0.001,0.01,0.564,1214,1190
19,2504,10,100,0.001,0.01,0.542,1260,1244
19,2604,10,100,0.001,0.01,0.548,1318,1286
19,2704,10,100,0.001,0.01,0.582,1363,1341
19,2804,10,100,0.001,0.01,0.622,1407,1397
19,2904,10,100,0.001,0.01,0.638,1456,1448
19,3004,10,100,0.001,0.01,0.632,1514,1490
19,3104,10,100,0.001,0.01,0.67,1567,1537
19,3204,10,100,0.001,0.01,0.702,1616,1588
19,3304,10,100,0.001,0.01,0.71,1660,1644
19,3404,10,100,0.001,0.01,0.71,1708,1696
19,3504,10,100,0.001,0.01,0.738,1756,1748
19,3604,10,100,0.001,0.01,0.746,1806,1798
19,3704,10,100,0.001,0.01,0.764,1848,1856
19,3804,10,100,0.001,0.01,0.762,1904,1900
19,3904,10,100,0.001,0.01,0.778,1962,1942
19,4004,10,100,0.001,0.01,0.796,2006,1998
19,4104,10,100,0.001,0.01,0.78,2057,2047
19,4204,10,100,0.001,0.01,0.812,2103,2101
19,4304,10,100,0.001,0.01,0.776,2150,2154
19,4404,10,100,0.001,0.01,0.832,2189,2215
19,4504,10,100,0.001,0.01,0.85,2234,2270
19,4604,10,100,0.001,0.01,0.806,2292,2312
19,4704,10,100,0.001,0.01,0.834,2340,2364
19,4804,10,100,0.001,0.01,0.842,2391,2413
19,4904,10,100,0.001,0.01,0.842,2438,2466
19,5004,10,100,0.001,0.01,0.838,2487,2517
19,5104,10,100,0.001,0.01,0.866,2535,2569
19,5204,10,100,0.001,0.01,0.852,2584,2620
19,5304,10,100,0.001,0.01,0.838,2638,2666
19,5404,10,100,0.001,0.01,0.85,2694,2710
19,5504,10,100,0.001,0.01,0.862,2745,2759
19,5604,10,100,0.001,0.01,0.89,2800,2804
19,5704,10,100,0.001,0.01,0.884,2855,2849
19,5804,10,100,0.001,0.01,0.9,2904,2900
19,5904,10,100,0.001,0.01,0.894,2947,2957
19,6004,10,100,0.001,0.01,0.892,2989,3015
19,6104,10,100,0.001,0.01,0.912,3045,3059
19,6204,10,100,0.001,0.01,0.896,3084,3120
19,6304,10,100,0.001,0.01,0.892,3130,3174
19,6404,10,100,0.001,0.01,0.894,3185,3219
19,6504,10,100,0.001,0.01,0.908,3239,3265
19,6604,10,100,0.001,0.01,0.914,3289,3315
19,6704,10,100,0.001,0.01,0.908,3340,3364
19,6804,10,100,0.001,0.01,0.926,3400,3404
19,6904,10,100,0.001,0.01,0.922,3448,3456
19,7004,10,100,0.001,0.01,0.924,3498,3506
19,7104,10,100,0.001,0.01,0.922,3552,3552
19,7204,10,100,0.001,0.01,0.908,3599,3605
19,7304,10,100,0.001,0.01,0.936,3646,3658
19,7404,10,100,0.001,0.01,0.922,3694,3710
19,7504,10,100,0.001,0.01,0.936,3742,3762
19,7604,10,100,0.001,0.01,0.926,3791,3813
19,7704,10,100,0.001,0.01,0.938,3838,3866
19,7804,10,100,0.001,0.01,0.95,3887,3917
19,7904,10,100,0.001,0.01,0.952,3934,3970
19,8004,10,100,0.001,0.01,0.94,3979,4025
19,8104,10,100,0.001,0.01,0.93,4041,4063
19,8204,10,100,0.001,0.01,0.944,4095,4109
19,8304,10,100,0.001,0.01,0.932,4141,4163
19,8404,10,100,0.001,0.01,0.924,4189,4215
19,8504,10,100,0.001,0.01,0.908,4237,4267
19,8604,10,100,0.001,0.01,0.948,4293,4311
19,8704,10,100,0.001,0.01,0.958,4348,4356
19,8804,10,100,0.001,0.01,0.952,4399,4405
19,8904,10,100,0.001,0.01,0.958,4441,4463
19,9004,10,100,0.001,0.01,0.958,4494,4510
19,9104,10,100,0.001,0.01,0.952,4539,4565
19,9204,10,100,0.001,0.01,0.956,4585,4619
19,9304,10,100,0.001,0.01,0.942,4639,4665
19,9404,10,100,0.001,0.01,0.96,4691,4713
19,9504,10,100,0.001,0.01,0.956,4747,4757
19,9604,10,100,0.001,0.01,0.958,4790,4814
19,9704,10,100,0.001,0.01,0.97,4844,4860
19,9804,10,100,0.001,0.01,0.946,4895,4909
19,9904,10,100,0.001,0.01,0.95,4943,4961
19,10004,10,100,0.001,0.01,0.96,4998,5006
19,10104,10,100,0.001,0.01,0.96,5054,5050
19,10204,10,100,0.001,0.01,0.972,5102,5102
19,10304,10,100,0.001,0.01,0.976,5153,5151
19,10404,10,100,0.001,0.01,0.978,5203,5201
19,10504,10,100,0.001,0.01,0.976,5257,5247
19,10604,10,100,0.001,0.01,0.988,5316,5288
19,10704,10,100,0.001,0.01,0.972,5368,5336
19,10804,10,100,0.001,0.01,0.982,5418,5386
19,10904,10,100,0.001,0.01,0.97,5466,5438
19,11004,10,100,0.001,0.01,0.96,5510,5494
19,11104,10,100,0.001,0.01,0.968,5561,5543
19,11204,10,100,0.001,0.01,0.974,5609,5595
19,11304,10,100,0.001,0.01,0.974,5653,5651
19,11404,10,100,0.001,0.01,0.98,5703,5701
19,11504,10,100,0.001,0.01,0.97,5762,5742
19,11604,10,100,0.001,0.01,0.976,5817,5787
19,11704,10,100,0.001,0.01,0.984,5866,5838
19,11804,10,100,0.001,0.01,0.978,5910,5894
19,11904,10,100,0.001,0.01,0.976,5963,5941
19,12004,10,100,0.001,0.01,0.976,6011,5993
19,12104,10,100,0.001,0.01,0.982,6072,6032
19,12204,10,100,0.001,0.01,0.982,6111,6093
19,12304,10,100,0.001,0.01,0.984,6158,6146
19,12404,10,100,0.001,0.01,0.946,6195,6209
19,12504,10,100,0.001,0.01,0.97,6246,6258
19,12604,10,100,0.001,0.01,0.986,6296,6308
19,12704,10,100,0.001,0.01,0.976,6337,6367
19,12804,10,100,0.001,0.01,0.99,6386,6418
19,12904,10,100,0.001,0.01,0.99,6433,6471
19,13004,10,100,0.001,0.01,0.99,6479,6525
19,13104,10,100,0.001,0.01,0.988,6533,6571
19,13204,10,100,0.001,0.01,0.988,6588,6616
19,13304,10,100,0.001,0.01,0.992,6633,6671
19,13404,10,100,0.001,0.01,0.994,6680,6724
19,13504,10,100,0.001,0.01,0.992,6736,6768
19,13604,10,100,0.001,0.01,0.988,6780,6824
19,13704,10,100,0.001,0.01,0.99,6835,6869
19,13804,10,100,0.001,0.01,0.98,6887,6917
19,13904,10,100,0.001,0.01,0.992,6935,6969
19,14004,10,100,0.001,0.01,0.976,6986,7018
19,14104,10,100,0.001,0.01,0.986,7042,7062
19,14204,10,100,0.001,0.01,0.994,7089,7115
19,14304,10,100,0.001,0.01,0.994,7146,7158
19,14404,10,100,0.001,0.01,0.994,7195,7209
19,14504,10,100,0.001,0.01,0.99,7243,7261
19,14604,10,100,0.001,0.01,0.994,7289,7315
19,14704,10,100,0.001,0.01,0.992,7340,7364
19,14804,10,100,0.001,0.01,0.994,7394,7410
19,14904,10,100,0.001,0.01,0.988,7447,7457
19,15004,10,100,0.001,0.01,0.982,7494,7510
20,104,10,100,0.001,0.01,0.47,53,51
20,204,10,100,0.001,0.01,0.508,112,92
20,304,10,100,0.001,0.01,0.48,168,136
20,404,10,100,0.001,0.01,0.48,221,183
20,504,10,100,0.001,0.01,0.506,278,226
20,604,10,100,0.001,0.01,0.51,331,273
20,704,10,100,0.001,0.01,0.512,379,325
20,804,10,100,0.001,0.01,0.512,446,358
20,904,10,100,0.001,0.01,0.5,499,405
20,1004,10,100,0.001,0.01,0.504,548,456
20,1104,10,100,0.001,0.01,0.512,607,497
20,1204,10,100,0.001,0.01,0.538,654,550
20,1304,10,100,0.001,0.01,0.516,711,593
20,1404,10,100,0.001,0.01,0.492,759,645
20,1504,10,100,0.001,0.01,0.506,800,704
20,1604,10,100,0.001,0.01,0.526,842,762
20,1704,10,100,0.001,0.01,0.522,897,807
20,1804,10,100,0.001,0.01,0.542,941,863
20,1904,10,100,0.001,0.01,0.57,995,909
20,2004,10,100,0.001,0.01,0.572,1041,963
20,2104,10,100,0.001,0.01,0.58,1090,1014
20,2204,10,100,0.001,0.01,0.61,1143,1061
20,2304,10,100,0.001,0.01,0.584,1192,1112
20,2404,10,100,0.001,0.01,0.622,1234,1170
20,2504,10,100,0.001,0.01,0.614,1280,1224
20,2604,10,100,0.001,0.01,0.662,1332,1272
20,2704,10,100,0.001,0.01,0.674,1375,1329
20,2804,10,100,0.001,0.01,0.678,1427,1377
20,2904,10,100,0.001,0.01,0.706,1476,1428
20,3004,10,100,0.001,0.01,0.672,1530,1474
20,3104,10,100,0.001,0.01,0.724,1582,1522
20,3204,10,100,0.001,0.01,0.718,1632,1572
20,3304,10,100,0.001,0.01,0.718,1687,1617
20,3404,10,100,0.001,0.01,0.75,1738,1666
20,3504,10,100,0.001,0.01,0.754,1796,1708
20,3604,10,100,0.001,0.01,0.756,1850,1754
20,3704,10,100,0.001,0.01,0.744,1894,1810
20,3804,10,100,0.001,0.01,0.774,1943,1861
20,3904,10,100,0.001,0.01,0.78,1992,1912
20,4004,10,100,0.001,0.01,0.762,2048,1956
20,4104,10,100,0.001,0.01,0.786,2100,2004
20,4204,10,100,0.001,0.01,0.752,2150,2054
20,4304,10,100,0.001,0.01,0.742,2195,2109
20,4404,10,100,0.001,0.01,0.748,2242,2162
20,4504,10,100,0.001,0.01,0.766,2297,2207
20,4604,10,100,0.001,0.01,0.792,2349,2255
20,4704,10,100,0.001,0.01,0.792,2405,2299
20,4804,10,100,0.001,0.01,0.81,2459,2345
20,4904,10,100,0.001,0.01,0.808,2503,2401
20,5004,10,100,0.001,0.01,0.81,2554,2450
20,5104,10,100,0.001,0.01,0.826,2599,2505
20,5204,10,100,0.001,0.01,0.788,2652,2552
20,5304,10,100,0.001,0.01,0.794,2699,2605
20,5404,10,100,0.001,0.01,0.804,2742,2662
20,5504,10,100,0.001,0.01,0.816,2798,2706
20,5604,10,100,0.001,0.01,0.834,2842,2762
20,5704,10,100,0.001,0.01,0.828,2894,2810
20,5804,10,100,0.001,0.01,0.828,2941,2863
20,5904,10,100,0.001,0.01,0.83,2993,2911
20,6004,10,100,0.001,0.01,0.84,3037,2967
20,6104,10,100,0.001,0.01,0.85,3092,3012
20,6204,10,100,0.001,0.01,0.828,3141,3063
20,6304,10,100,0.001,0.01,0.858,3187,3117
20,6404,10,100,0.001,0.01,0.846,3232,3172
20,6504,10,100,0.001,0.01,0.872,3288,3216
20,6604,10,100,0.001,0.01,0.862,3343,3261
20,6704,10,100,0.001,0.01,0.864,3391,3313
20,6804,10,100,0.001,0.01,0.862,3440,3364
20,6904,10,100,0.001,0.01,0.88,3484,3420
20,7004,10,100,0.001,0.01,0.868,3536,3468
20,7104,10,100,0.001,0.01,0.864,3585,3519
20,7204,10,100,0.001,0.01,0.88,3638,3566
20,7304,10,100,0.001,0.01,0.872,3687,3617
20,7404,10,100,0.001,0.01,0.852,3734,3670
20,7504,10,100,0.001,0.01,0.856,3779,3725
20,7604,10,100,0.001,0.01,0.87,3827,3777
20,7704,10,100,0.001,0.01,0.904,3884,3820
20,7804,10,100,0.001,0.01,0.88,3943,3861
20,7904,10,100,0.001,0.01,0.884,3992,3912
20,8004,10,100,0.001,0.01,0.886,4045,3959
20,8104,10,100,0.001,0.01,0.916,4089,4015
20,8204,10,100,0.001,0.01,0.88,4132,4072
20,8304,10,100,0.001,0.01,0.898,4176,4128
20,8404,10,100,0.001,0.01,0.888,4231,4173
20,8504,10,100,0.001,0.01,0.898,4280,4224
20,8604,10,100,0.001,0.01,0.894,4332,4272
20,8704,10,100,0.001,0.01,0.9,4372,4332
20,8804,10,100,0.001,0.01,0.902,4431,4373
20,8904,10,100,0.001,0.01,0.908,4485,4419
20,9004,10,100,0.001,0.01,0.918,4532,4472
20,9104,10,100,0.001,0.01,0.918,4579,4525
20,9204,10,100,0.001,0.01,0.92,4625,4579
20,9304,10,100,0.001,0.01,0.926,4671,4633
20,9404,10,100,0.001,0.01,0.898,4718,4686
20,9504,10,100,0.001,0.01,0.938,4762,4742
20,9604,10,100,0.001,0.01,0.942,4809,4795
20,9704,10,100,0.001,0.01,0.93,4859,4845
20,9804,10,100,0.001,0.01,0.926,4910,4894
20,9904,10,100,0.001,0.01,0.932,4963,4941
20,10004,10,100,0.001,0.01,0.936,5006,4998
20,10104,10,100,0.001,0.01,0.936,5049,5055
20,10204,10,100,0.001,0.01,0.94,5096,5108
20,10304,10,100,0.001,0.01,0.956,5150,5154
20,10404,10,100,0.001,0.01,0.95,5192,5212
20,10504,10,100,0.001,0.01,0.922,5238,5266
20,10604,10,100,0.001,0.01,0.916,5291,5313
20,10704,10,100,0.001,0.01,0.928,5339,5365
20,10804,10,100,0.001,0.01,0.944,5384,5420
20,10904,10,100,0.001,0.01,0.958,5427,5477
20,11004,10,100,0.001,0.01,0.954,5484,5520
20,11104,10,100,0.001,0.01,0.946,5536,5568
20,11204,10,100,0.001,0.01,0.964,5586,5618
20,11304,10,100,0.001,0.01,0.964,5630,5674
20,11404,10,100,0.001,0.01,0.948,5674,5730
20,11504,10,100,0.001,0.01,0.954,5728,5776
20,11604,10,100,0.001,0.01,0.948,5782,5822
20,11704,10,100,0.001,0.01,0.96,5836,5868
20,11804,10,100,0.001,0.01,0.958,5888,5916
20,11904,10,100,0.001,0.01,0.948,5934,5970
20,12004,10,100,0.001,0.01,0.952,5983,6021
20,12104,10,100,0.001,0.01,0.958,6036,6068
20,12204,10,100,0.001,0.01,0.96,6079,6125
20,12304,10,100,0.001,0.01,0.966,6126,6178
20,12404,10,100,0.001,0.01,0.956,6181,6223
20,12504,10,100,0.001,0.01,0.966,6228,6276
20,12604,10,100,0.001,0.01,0.962,6269,6335
20,12704,10,100,0.001,0.01,0.968,6327,6377
20,12804,10,100,0.001,0.01,0.98,6386,6418
20,12904,10,100,0.001,0.01,0.972,6427,6477
20,13004,10,100,0.001,0.01,0.974,6485,6519
20,13104,10,100,0.001,0.01,0.978,6536,6568
20,13204,10,100,0.001,0.01,0.976,6578,6626
20,13304,10,100,0.001,0.01,0.978,6617,6687
20,13404,10,100,0.001,0.01,0.976,6673,6731
20,13504,10,100,0.001,0.01,0.97,6718,6786
20,13604,10,100,0.001,0.01,0.948,6768,6836
20,13704,10,100,0.001,0.01,0.978,6824,6880
20,13804,10,100,0.001,0.01,0.978,6876,6928
20,13904,10,100,0.001,0.01,0.976,6929,6975
20,14004,10,100,0.001,0.01,0.972,6980,7024
20,14104,10,100,0.001,0.01,0.972,7026,7078
20,14204,10,100,0.001,0.01,0.984,7070,7134
20,14304,10,100,0.001,0.01,0.976,7119,7185
20,14404,10,100,0.001,0.01,0.978,7170,7234
20,14504,10,100,0.001,0.01,0.98,7224,7280
20,14604,10,100,0.001,0.01,0.978,7279,7325
20,14704,10,100,0.001,0.01,0.976,7333,7371
20,14804,10,100,0.001,0.01,0.944,7385,7419
20,14904,10,100,0.001,0.01,0.978,7429,7475
20,15004,10,100,0.001,0.01,0.976,7484,7520
