trial,train_size,embed_dim,hidden_dim,alpha,learning_rate,accuracy,batch_pos,batch_neg
1,104,10,100,1e-05,0.01,0.494,62,42
1,204,10,100,1e-05,0.01,0.534,120,84
1,304,10,100,1e-05,0.01,0.478,175,129
1,404,10,100,1e-05,0.01,0.532,233,171
1,504,10,100,1e-05,0.01,0.53,284,220
1,604,10,100,1e-05,0.01,0.506,333,271
1,704,10,100,1e-05,0.01,0.52,383,321
1,804,10,100,1e-05,0.01,0.52,426,378
1,904,10,100,1e-05,0.01,0.558,475,429
1,1004,10,100,1e-05,0.01,0.534,520,484
1,1104,10,100,1e-05,0.01,0.514,567,537
1,1204,10,100,1e-05,0.01,0.498,610,594
1,1304,10,100,1e-05,0.01,0.53,666,638
1,1404,10,100,1e-05,0.01,0.558,714,690
1,1504,10,100,1e-05,0.01,0.49,769,735
1,1604,10,100,1e-05,0.01,0.524,811,793
1,1704,10,100,1e-05,0.01,0.512,860,844
1,1804,10,100,1e-05,0.01,0.522,910,894
1,1904,10,100,1e-05,0.01,0.52,955,949
1,2004,10,100,1e-05,0.01,0.552,1007,997
1,2104,10,100,1e-05,0.01,0.56,1056,1048
1,2204,10,100,1e-05,0.01,0.564,1104,1100
1,2304,10,100,1e-05,0.01,0.522,1152,1152
1,2404,10,100,1e-05,0.01,0.626,1202,1202
1,2504,10,100,1e-05,0.01,0.596,1245,1259
1,2604,10,100,1e-05,0.01,0.612,1292,1312
1,2704,10,100,1e-05,0.01,0.642,1347,1357
1,2804,10,100,1e-05,0.01,0.634,1403,1401
1,2904,10,100,1e-05,0.01,0.656,1457,1447
1,3004,10,100,1e-05,0.01,0.664,1508,1496
1,3104,10,100,1e-05,0.01,0.682,1566,1538
1,3204,10,100,1e-05,0.01,0.69,1620,1584
1,3304,10,100,1e-05,0.01,0.702,1666,1638
1,3404,10,100,1e-05,0.01,0.712,1724,1680
1,3504,10,100,1e-05,0.01,0.742,1780,1724
1,3604,10,100,1e-05,0.01,0.724,1826,1778
1,3704,10,100,1e-05,0.01,0.72,1866,1838
1,3804,10,100,1e-05,0.01,0.736,1909,1895
1,3904,10,100,1e-05,0.01,0.754,1951,1953
1,4004,10,100,1e-05,0.01,0.726,1996,2008
1,4104,10,100,1e-05,0.01,0.78,2051,2053
1,4204,10,100,1e-05,0.01,0.79,2105,2099
1,4304,10,100,1e-05,0.01,0.754,2144,2160
1,4404,10,100,1e-05,0.01,0.782,2184,2220
1,4504,10,100,1e-05,0.01,0.79,2235,2269
1,4604,10,100,1e-05,0.01,0.778,2292,2312
1,4704,10,100,1e-05,0.01,0.786,2342,2362
1,4804,10,100,1e-05,0.01,0.802,2396,2408
1,4904,10,100,1e-05,0.01,0.804,2438,2466
1,5004,10,100,1e-05,0.01,0.796,2500,2504
1,5104,10,100,1e-05,0.01,0.806,2557,2547
1,5204,10,100,1e-05,0.01,0.834,2613,2591
1,5304,10,100,1e-05,0.01,0.822,2660,2644
1,5404,10,100,1e-05,0.01,0.81,2703,2701
1,5504,10,100,1e-05,0.01,0.844,2744,2760
1,5604,10,100,1e-05,0.01,0.83,2794,2810
1,5704,10,100,1e-05,0.01,0.826,2845,2859
1,5804,10,100,1e-05,0.01,0.836,2893,2911
1,5904,10,100,1e-05,0.01,0.848,2943,2961
1,6004,10,100,1e-05,0.01,0.828,2988,3016
1,6104,10,100,1e-05,0.01,0.846,3024,3080
1,6204,10,100,1e-05,0.01,0.824,3072,3132
1,6304,10,100,1e-05,0.01,0.832,3116,3188
1,6404,10,100,1e-05,0.01,0.844,3164,3240
1,6504,10,100,1e-05,0.01,0.838,3222,3282
1,6604,10,100,1e-05,0.01,0.864,3269,3335
1,6704,10,100,1e-05,0.01,0.852,3318,3386
1,6804,10,100,1e-05,0.01,0.85,3367,3437
1,6904,10,100,1e-05,0.01,0.876,3418,3486
1,7004,10,100,1e-05,0.01,0.868,3471,3533
1,7104,10,100,1e-05,0.01,0.82,3524,3580
1,7204,10,100,1e-05,0.01,0.854,3569,3635
1,7304,10,100,1e-05,0.01,0.88,3621,3683
1,7404,10,100,1e-05,0.01,0.886,3665,3739
1,7504,10,100,1e-05,0.01,0.876,3721,3783
1,7604,10,100,1e-05,0.01,0.878,3768,3836
1,7704,10,100,1e-05,0.01,0.882,3818,3886
1,7804,10,100,1e-05,0.01,0.876,3871,3933
1,7904,10,100,1e-05,0.01,0.87,3916,3988
1,8004,10,100,1e-05,0.01,0.888,3972,4032
1,8104,10,100,1e-05,0.01,0.882,4024,4080
1,8204,10,100,1e-05,0.01,0.868,4074,4130
1,8304,10,100,1e-05,0.01,0.878,4125,4179
1,8404,10,100,1e-05,0.01,0.87,4178,4226
1,8504,10,100,1e-05,0.01,0.89,4233,4271
1,8604,10,100,1e-05,0.01,0.894,4283,4321
1,8704,10,100,1e-05,0.01,0.906,4333,4371
1,8804,10,100,1e-05,0.01,0.89,4383,4421
1,8904,10,100,1e-05,0.01,0.89,4430,4474
1,9004,10,100,1e-05,0.01,0.898,4481,4523
1,9104,10,100,1e-05,0.01,0.906,4531,4573
1,9204,10,100,1e-05,0.01,0.91,4586,4618
1,9304,10,100,1e-05,0.01,0.896,4638,4666
1,9404,10,100,1e-05,0.01,0.914,4681,4723
1,9504,10,100,1e-05,0.01,0.904,4740,4764
1,9604,10,100,1e-05,0.01,0.91,4790,4814
1,9704,10,100,1e-05,0.01,0.916,4836,4868
1,9804,10,100,1e-05,0.01,0.916,4890,4914
1,9904,10,100,1e-05,0.01,0.854,4940,4964
1,10004,10,100,1e-05,0.01,0.91,4991,5013
1,10104,10,100,1e-05,0.01,0.916,5044,5060
1,10204,10,100,1e-05,0.01,0.914,5094,5110
1,10304,10,100,1e-05,0.01,0.922,5153,5151
1,10404,10,100,1e-05,0.01,0.914,5197,5207
1,10504,10,100,1e-05,0.01,0.912,5244,5260
1,10604,10,100,1e-05,0.01,0.938,5297,5307
1,10704,10,100,1e-05,0.01,0.934,5348,5356
1,10804,10,100,1e-05,0.01,0.918,5398,5406
1,10904,10,100,1e-05,0.01,0.924,5451,5453
1,11004,10,100,1e-05,0.01,0.924,5508,5496
1,11104,10,100,1e-05,0.01,0.924,5545,5559
1,11204,10,100,1e-05,0.01,0.928,5587,5617
1,11304,10,100,1e-05,0.01,0.938,5645,5659
1,11404,10,100,1e-05,0.01,0.93,5695,5709
1,11504,10,100,1e-05,0.01,0.946,5746,5758
1,11604,10,100,1e-05,0.01,0.938,5799,5805
1,11704,10,100,1e-05,0.01,0.932,5856,5848
1,11804,10,100,1e-05,0.01,0.936,5904,5900
1,11904,10,100,1e-05,0.01,0.928,5962,5942
1,12004,10,100,1e-05,0.01,0.932,6006,5998
1,12104,10,100,1e-05,0.01,0.948,6060,6044
1,12204,10,100,1e-05,0.01,0.95,6103,6101
1,12304,10,100,1e-05,0.01,0.948,6142,6162
1,12404,10,100,1e-05,0.01,0.942,6187,6217
1,12504,10,100,1e-05,0.01,0.94,6244,6260
1,12604,10,100,1e-05,0.01,0.944,6288,6316
1,12704,10,100,1e-05,0.01,0.95,6332,6372
1,12804,10,100,1e-05,0.01,0.944,6379,6425
1,12904,10,100,1e-05,0.01,0.952,6437,6467
1,13004,10,100,1e-05,0.01,0.952,6494,6510
1,13104,10,100,1e-05,0.01,0.958,6548,6556
1,13204,10,100,1e-05,0.01,0.962,6601,6603
1,13304,10,100,1e-05,0.01,0.952,6647,6657
1,13404,10,100,1e-05,0.01,0.96,6688,6716
1,13504,10,100,1e-05,0.01,0.958,6731,6773
1,13604,10,100,1e-05,0.01,0.942,6786,6818
1,13704,10,100,1e-05,0.01,0.958,6837,6867
1,13804,10,100,1e-05,0.01,0.948,6885,6919
1,13904,10,100,1e-05,0.01,0.944,6929,6975
1,14004,10,100,1e-05,0.01,0.956,6979,7025
1,14104,10,100,1e-05,0.01,0.96,7025,7079
1,14204,10,100,1e-05,0.01,0.974,7068,7136
1,14304,10,100,1e-05,0.01,0.958,7127,7177
1,14404,10,100,1e-05,0.01,0.968,7182,7222
1,14504,10,100,1e-05,0.01,0.96,7236,7268
1,14604,10,100,1e-05,0.01,0.974,7290,7314
1,14704,10,100,1e-05,0.01,0.972,7330,7374
1,14804,10,100,1e-05,0.01,0.968,7382,7422
1,14904,10,100,1e-05,0.01,0.974,7428,7476
1,15004,10,100,1e-05,0.01,0.968,7487,7517
2,104,10,100,1e-05,0.01,0.512,55,49
2,204,10,100,1e-05,0.01,0.5,98,106
2,304,10,100,1e-05,0.01,0.504,151,153
2,404,10,100,1e-05,0.01,0.522,197,207
2,504,10,100,1e-05,0.01,0.52,251,253
2,604,10,100,1e-05,0.01,0.52,293,311
2,704,10,100,1e-05,0.01,0.476,341,363
2,804,10,100,1e-05,0.01,0.484,392,412
2,904,10,100,1e-05,0.01,0.482,449,455
2,1004,10,100,1e-05,0.01,0.474,503,501
2,1104,10,100,1e-05,0.01,0.512,547,557
2,1204,10,100,1e-05,0.01,0.488,589,615
2,1304,10,100,1e-05,0.01,0.492,633,671
2,1404,10,100,1e-05,0.01,0.492,687,717
2,1504,10,100,1e-05,0.01,0.482,746,758
2,1604,10,100,1e-05,0.01,0.48,804,800
2,1704,10,100,1e-05,0.01,0.482,855,849
2,1804,10,100,1e-05,0.01,0.462,907,897
2,1904,10,100,1e-05,0.01,0.486,958,946
2,2004,10,100,1e-05,0.01,0.506,1021,983
2,2104,10,100,1e-05,0.01,0.508,1072,1032
2,2204,10,100,1e-05,0.01,0.516,1121,1083
2,2304,10,100,1e-05,0.01,0.542,1165,1139
2,2404,10,100,1e-05,0.01,0.544,1209,1195
2,2504,10,100,1e-05,0.01,0.54,1257,1247
2,2604,10,100,1e-05,0.01,0.558,1310,1294
2,2704,10,100,1e-05,0.01,0.596,1368,1336
2,2804,10,100,1e-05,0.01,0.602,1412,1392
2,2904,10,100,1e-05,0.01,0.616,1469,1435
2,3004,10,100,1e-05,0.01,0.646,1520,1484
2,3104,10,100,1e-05,0.01,0.646,1569,1535
2,3204,10,100,1e-05,0.01,0.702,1617,1587
2,3304,10,100,1e-05,0.01,0.726,1673,1631
2,3404,10,100,1e-05,0.01,0.726,1729,1675
2,3504,10,100,1e-05,0.01,0.734,1775,1729
2,3604,10,100,1e-05,0.01,0.766,1821,1783
2,3704,10,100,1e-05,0.01,0.778,1869,1835
2,3804,10,100,1e-05,0.01,0.784,1923,1881
2,3904,10,100,1e-05,0.01,0.812,1972,1932
2,4004,10,100,1e-05,0.01,0.79,2015,1989
2,4104,10,100,1e-05,0.01,0.836,2067,2037
2,4204,10,100,1e-05,0.01,0.818,2110,2094
2,4304,10,100,1e-05,0.01,0.834,2159,2145
2,4404,10,100,1e-05,0.01,0.852,2210,2194
2,4504,10,100,1e-05,0.01,0.844,2262,2242
2,4604,10,100,1e-05,0.01,0.846,2305,2299
2,4704,10,100,1e-05,0.01,0.878,2347,2357
2,4804,10,100,1e-05,0.01,0.89,2402,2402
2,4904,10,100,1e-05,0.01,0.898,2455,2449
2,5004,10,100,1e-05,0.01,0.888,2501,2503
2,5104,10,100,1e-05,0.01,0.902,2552,2552
2,5204,10,100,1e-05,0.01,0.886,2603,2601
2,5304,10,100,1e-05,0.01,0.898,2649,2655
2,5404,10,100,1e-05,0.01,0.888,2708,2696
2,5504,10,100,1e-05,0.01,0.908,2764,2740
2,5604,10,100,1e-05,0.01,0.912,2819,2785
2,5704,10,100,1e-05,0.01,0.896,2872,2832
2,5804,10,100,1e-05,0.01,0.906,2920,2884
2,5904,10,100,1e-05,0.01,0.892,2968,2936
2,6004,10,100,1e-05,0.01,0.908,3026,2978
2,6104,10,100,1e-05,0.01,0.922,3072,3032
2,6204,10,100,1e-05,0.01,0.922,3125,3079
2,6304,10,100,1e-05,0.01,0.926,3170,3134
2,6404,10,100,1e-05,0.01,0.922,3219,3185
2,6504,10,100,1e-05,0.01,0.934,3273,3231
2,6604,10,100,1e-05,0.01,0.934,3325,3279
2,6704,10,100,1e-05,0.01,0.938,3367,3337
2,6804,10,100,1e-05,0.01,0.934,3418,3386
2,6904,10,100,1e-05,0.01,0.918,3474,3430
2,7004,10,100,1e-05,0.01,0.956,3513,3491
2,7104,10,100,1e-05,0.01,0.958,3561,3543
2,7204,10,100,1e-05,0.01,0.96,3618,3586
2,7304,10,100,1e-05,0.01,0.962,3677,3627
2,7404,10,100,1e-05,0.01,0.948,3722,3682
2,7504,10,100,1e-05,0.01,0.932,3773,3731
2,7604,10,100,1e-05,0.01,0.936,3824,3780
2,7704,10,100,1e-05,0.01,0.95,3867,3837
2,7804,10,100,1e-05,0.01,0.942,3917,3887
2,7904,10,100,1e-05,0.01,0.942,3967,3937
2,8004,10,100,1e-05,0.01,0.958,4019,3985
2,8104,10,100,1e-05,0.01,0.962,4068,4036
2,8204,10,100,1e-05,0.01,0.96,4117,4087
2,8304,10,100,1e-05,0.01,0.968,4158,4146
2,8404,10,100,1e-05,0.01,0.958,4213,4191
2,8504,10,100,1e-05,0.01,0.97,4269,4235
2,8604,10,100,1e-05,0.01,0.966,4334,4270
2,8704,10,100,1e-05,0.01,0.962,4382,4322
2,8804,10,100,1e-05,0.01,0.968,4431,4373
2,8904,10,100,1e-05,0.01,0.968,4484,4420
2,9004,10,100,1e-05,0.01,0.972,4537,4467
2,9104,10,100,1e-05,0.01,0.966,4576,4528
2,9204,10,100,1e-05,0.01,0.972,4622,4582
2,9304,10,100,1e-05,0.01,0.964,4672,4632
2,9404,10,100,1e-05,0.01,0.952,4726,4678
2,9504,10,100,1e-05,0.01,0.962,4773,4731
2,9604,10,100,1e-05,0.01,0.966,4823,4781
2,9704,10,100,1e-05,0.01,0.968,4875,4829
2,9804,10,100,1e-05,0.01,0.966,4924,4880
2,9904,10,100,1e-05,0.01,0.952,4977,4927
2,10004,10,100,1e-05,0.01,0.962,5026,4978
2,10104,10,100,1e-05,0.01,0.974,5071,5033
2,10204,10,100,1e-05,0.01,0.97,5122,5082
2,10304,10,100,1e-05,0.01,0.98,5176,5128
2,10404,10,100,1e-05,0.01,0.98,5221,5183
2,10504,10,100,1e-05,0.01,0.984,5272,5232
2,10604,10,100,1e-05,0.01,0.982,5308,5296
2,10704,10,100,1e-05,0.01,0.984,5358,5346
2,10804,10,100,1e-05,0.01,0.982,5413,5391
2,10904,10,100,1e-05,0.01,0.986,5460,5444
2,11004,10,100,1e-05,0.01,0.984,5502,5502
2,11104,10,100,1e-05,0.01,0.986,5559,5545
2,11204,10,100,1e-05,0.01,0.986,5610,5594
2,11304,10,100,1e-05,0.01,0.982,5665,5639
2,11404,10,100,1e-05,0.01,0.986,5713,5691
2,11504,10,100,1e-05,0.01,0.984,5763,5741
2,11604,10,100,1e-05,0.01,0.988,5822,5782
2,11704,10,100,1e-05,0.01,0.988,5872,5832
2,11804,10,100,1e-05,0.01,0.992,5919,5885
2,11904,10,100,1e-05,0.01,0.994,5970,5934
2,12004,10,100,1e-05,0.01,0.994,6013,5991
2,12104,10,100,1e-05,0.01,0.994,6069,6035
2,12204,10,100,1e-05,0.01,0.95,6114,6090
2,12304,10,100,1e-05,0.01,0.974,6170,6134
2,12404,10,100,1e-05,0.01,0.98,6212,6192
2,12504,10,100,1e-05,0.01,0.986,6263,6241
2,12604,10,100,1e-05,0.01,0.988,6308,6296
2,12704,10,100,1e-05,0.01,0.994,6351,6353
2,12804,10,100,1e-05,0.01,0.994,6405,6399
2,12904,10,100,1e-05,0.01,0.992,6461,6443
2,13004,10,100,1e-05,0.01,0.992,6510,6494
2,13104,10,100,1e-05,0.01,0.996,6545,6559
2,13204,10,100,1e-05,0.01,0.996,6599,6605
2,13304,10,100,1e-05,0.01,0.994,6651,6653
2,13404,10,100,1e-05,0.01,0.992,6705,6699
2,13504,10,100,1e-05,0.01,0.984,6754,6750
2,13604,10,100,1e-05,0.01,0.99,6812,6792
2,13704,10,100,1e-05,0.01,0.992,6858,6846
2,13804,10,100,1e-05,0.01,0.99,6909,6895
2,13904,10,100,1e-05,0.01,0.98,6956,6948
2,14004,10,100,1e-05,0.01,0.994,7008,6996
2,14104,10,100,1e-05,0.01,0.99,7053,7051
2,14204,10,100,1e-05,0.01,0.992,7101,7103
2,14304,10,100,1e-05,0.01,0.99,7146,7158
2,14404,10,100,1e-05,0.01,0.99,7188,7216
2,14504,10,100,1e-05,0.01,0.988,7234,7270
2,14604,10,100,1e-05,0.01,0.988,7282,7322
2,14704,10,100,1e-05,0.01,0.994,7324,7380
2,14804,10,100,1e-05,0.01,0.992,7379,7425
2,14904,10,100,1e-05,0.01,0.992,7445,7459
2,15004,10,100,1e-05,0.01,0.998,7496,7508
3,104,10,100,1e-05,0.01,0.502,51,53
3,204,10,100,1e-05,0.01,0.51,103,101
3,304,10,100,1e-05,0.01,0.484,153,151
3,404,10,100,1e-05,0.01,0.498,208,196
3,504,10,100,1e-05,0.01,0.476,255,249
3,604,10,100,1e-05,0.01,0.5,307,297
3,704,10,100,1e-05,0.01,0.502,357,347
3,804,10,100,1e-05,0.01,0.476,405,399
3,904,10,100,1e-05,0.01,0.484,449,455
3,1004,10,100,1e-05,0.01,0.498,506,498
3,1104,10,100,1e-05,0.01,0.506,553,551
3,1204,10,100,1e-05,0.01,0.486,609,595
3,1304,10,100,1e-05,0.01,0.508,663,641
3,1404,10,100,1e-05,0.01,0.502,717,687
3,1504,10,100,1e-05,0.01,0.52,768,736
3,1604,10,100,1e-05,0.01,0.512,818,786
3,1704,10,100,1e-05,0.01,0.544,867,837
3,1804,10,100,1e-05,0.01,0.534,913,891
3,1904,10,100,1e-05,0.01,0.546,972,932
3,2004,10,100,1e-05,0.01,0.546,1017,987
3,2104,10,100,1e-05,0.01,0.562,1058,1046
3,2204,10,100,1e-05,0.01,0.548,1103,1101
3,2304,10,100,1e-05,0.01,0.54,1152,1152
3,2404,10,100,1e-05,0.01,0.53,1196,1208
3,2504,10,100,1e-05,0.01,0.586,1241,1263
3,2604,10,100,1e-05,0.01,0.59,1292,1312
3,2704,10,100,1e-05,0.01,0.596,1347,1357
3,2804,10,100,1e-05,0.01,0.628,1400,1404
3,2904,10,100,1e-05,0.01,0.61,1457,1447
3,3004,10,100,1e-05,0.01,0.604,1504,1500
3,3104,10,100,1e-05,0.01,0.606,1559,1545
3,3204,10,100,1e-05,0.01,0.636,1604,1600
3,3304,10,100,1e-05,0.01,0.664,1657,1647
3,3404,10,100,1e-05,0.01,0.656,1709,1695
3,3504,10,100,1e-05,0.01,0.658,1767,1737
3,3604,10,100,1e-05,0.01,0.638,1828,1776
3,3704,10,100,1e-05,0.01,0.652,1880,1824
3,3804,10,100,1e-05,0.01,0.658,1937,1867
3,3904,10,100,1e-05,0.01,0.644,1992,1912
3,4004,10,100,1e-05,0.01,0.646,2035,1969
3,4104,10,100,1e-05,0.01,0.648,2090,2014
3,4204,10,100,1e-05,0.01,0.684,2145,2059
3,4304,10,100,1e-05,0.01,0.692,2180,2124
3,4404,10,100,1e-05,0.01,0.678,2229,2175
3,4504,10,100,1e-05,0.01,0.698,2279,2225
3,4604,10,100,1e-05,0.01,0.694,2330,2274
3,4704,10,100,1e-05,0.01,0.706,2379,2325
3,4804,10,100,1e-05,0.01,0.696,2432,2372
3,4904,10,100,1e-05,0.01,0.694,2480,2424
3,5004,10,100,1e-05,0.01,0.69,2531,2473
3,5104,10,100,1e-05,0.01,0.698,2581,2523
3,5204,10,100,1e-05,0.01,0.716,2633,2571
3,5304,10,100,1e-05,0.01,0.746,2680,2624
3,5404,10,100,1e-05,0.01,0.724,2731,2673
3,5504,10,100,1e-05,0.01,0.732,2781,2723
3,5604,10,100,1e-05,0.01,0.736,2832,2772
3,5704,10,100,1e-05,0.01,0.704,2878,2826
3,5804,10,100,1e-05,0.01,0.716,2930,2874
3,5904,10,100,1e-05,0.01,0.728,2990,2914
3,6004,10,100,1e-05,0.01,0.724,3038,2966
3,6104,10,100,1e-05,0.01,0.768,3085,3019
3,6204,10,100,1e-05,0.01,0.74,3131,3073
3,6304,10,100,1e-05,0.01,0.766,3178,3126
3,6404,10,100,1e-05,0.01,0.73,3221,3183
3,6504,10,100,1e-05,0.01,0.754,3271,3233
3,6604,10,100,1e-05,0.01,0.762,3325,3279
3,6704,10,100,1e-05,0.01,0.758,3380,3324
3,6804,10,100,1e-05,0.01,0.75,3427,3377
3,6904,10,100,1e-05,0.01,0.78,3484,3420
3,7004,10,100,1e-05,0.01,0.762,3535,3469
3,7104,10,100,1e-05,0.01,0.774,3587,3517
3,7204,10,100,1e-05,0.01,0.782,3626,3578
3,7304,10,100,1e-05,0.01,0.788,3675,3629
3,7404,10,100,1e-05,0.01,0.766,3741,3663
3,7504,10,100,1e-05,0.01,0.786,3789,3715
3,7604,10,100,1e-05,0.01,0.792,3841,3763
3,7704,10,100,1e-05,0.01,0.806,3887,3817
3,7804,10,100,1e-05,0.01,0.818,3931,3873
3,7904,10,100,1e-05,0.01,0.778,3984,3920
3,8004,10,100,1e-05,0.01,0.766,4040,3964
3,8104,10,100,1e-05,0.01,0.79,4091,4013
3,8204,10,100,1e-05,0.01,0.794,4144,4060
3,8304,10,100,1e-05,0.01,0.816,4202,4102
3,8404,10,100,1e-05,0.01,0.816,4251,4153
3,8504,10,100,1e-05,0.01,0.836,4302,4202
3,8604,10,100,1e-05,0.01,0.826,4347,4257
3,8704,10,100,1e-05,0.01,0.82,4402,4302
3,8804,10,100,1e-05,0.01,0.828,4454,4350
3,8904,10,100,1e-05,0.01,0.844,4511,4393
3,9004,10,100,1e-05,0.01,0.832,4556,4448
3,9104,10,100,1e-05,0.01,0.82,4605,4499
3,9204,10,100,1e-05,0.01,0.852,4654,4550
3,9304,10,100,1e-05,0.01,0.826,4701,4603
3,9404,10,100,1e-05,0.01,0.828,4737,4667
3,9504,10,100,1e-05,0.01,0.836,4786,4718
3,9604,10,100,1e-05,0.01,0.834,4834,4770
3,9704,10,100,1e-05,0.01,0.82,4885,4819
3,9804,10,100,1e-05,0.01,0.878,4929,4875
3,9904,10,100,1e-05,0.01,0.864,4972,4932
3,10004,10,100,1e-05,0.01,0.87,5027,4977
3,10104,10,100,1e-05,0.01,0.848,5067,5037
3,10204,10,100,1e-05,0.01,0.85,5118,5086
3,10304,10,100,1e-05,0.01,0.878,5165,5139
3,10404,10,100,1e-05,0.01,0.884,5218,5186
3,10504,10,100,1e-05,0.01,0.892,5260,5244
3,10604,10,100,1e-05,0.01,0.882,5316,5288
3,10704,10,100,1e-05,0.01,0.866,5371,5333
3,10804,10,100,1e-05,0.01,0.864,5426,5378
3,10904,10,100,1e-05,0.01,0.892,5482,5422
3,11004,10,100,1e-05,0.01,0.912,5549,5455
3,11104,10,100,1e-05,0.01,0.918,5608,5496
3,11204,10,100,1e-05,0.01,0.898,5666,5538
3,11304,10,100,1e-05,0.01,0.902,5717,5587
3,11404,10,100,1e-05,0.01,0.888,5766,5638
3,11504,10,100,1e-05,0.01,0.858,5823,5681
3,11604,10,100,1e-05,0.01,0.906,5876,5728
3,11704,10,100,1e-05,0.01,0.906,5918,5786
3,11804,10,100,1e-05,0.01,0.914,5967,5837
3,11904,10,100,1e-05,0.01,0.934,6021,5883
3,12004,10,100,1e-05,0.01,0.912,6065,5939
3,12104,10,100,1e-05,0.01,0.916,6107,5997
3,12204,10,100,1e-05,0.01,0.93,6156,6048
3,12304,10,100,1e-05,0.01,0.932,6204,6100
3,12404,10,100,1e-05,0.01,0.924,6254,6150
3,12504,10,100,1e-05,0.01,0.924,6302,6202
3,12604,10,100,1e-05,0.01,0.928,6348,6256
3,12704,10,100,1e-05,0.01,0.924,6401,6303
3,12804,10,100,1e-05,0.01,0.944,6454,6350
3,12904,10,100,1e-05,0.01,0.942,6494,6410
3,13004,10,100,1e-05,0.01,0.936,6546,6458
3,13104,10,100,1e-05,0.01,0.956,6590,6514
3,13204,10,100,1e-05,0.01,0.936,6631,6573
3,13304,10,100,1e-05,0.01,0.946,6677,6627
3,13404,10,100,1e-05,0.01,0.948,6730,6674
3,13504,10,100,1e-05,0.01,0.954,6780,6724
3,13604,10,100,1e-05,0.01,0.952,6821,6783
3,13704,10,100,1e-05,0.01,0.954,6868,6836
3,13804,10,100,1e-05,0.01,0.95,6912,6892
3,13904,10,100,1e-05,0.01,0.946,6961,6943
3,14004,10,100,1e-05,0.01,0.958,7016,6988
3,14104,10,100,1e-05,0.01,0.96,7063,7041
3,14204,10,100,1e-05,0.01,0.956,7112,7092
3,14304,10,100,1e-05,0.01,0.956,7162,7142
3,14404,10,100,1e-05,0.01,0.962,7213,7191
3,14504,10,100,1e-05,0.01,0.964,7258,7246
3,14604,10,100,1e-05,0.01,0.96,7295,7309
3,14704,10,100,1e-05,0.01,0.954,7354,7350
3,14804,10,100,1e-05,0.01,0.972,7406,7398
3,14904,10,100,1e-05,0.01,0.976,7454,7450
3,15004,10,100,1e-05,0.01,0.98,7503,7501
4,104,10,100,1e-05,0.01,0.526,45,59
4,204,10,100,1e-05,0.01,0.49,86,118
4,304,10,100,1e-05,0.01,0.502,141,163
4,404,10,100,1e-05,0.01,0.498,193,211
4,504,10,100,1e-05,0.01,0.496,242,262
4,604,10,100,1e-05,0.01,0.508,290,314
4,704,10,100,1e-05,0.01,0.49,348,356
4,804,10,100,1e-05,0.01,0.532,408,396
4,904,10,100,1e-05,0.01,0.524,462,442
4,1004,10,100,1e-05,0.01,0.504,510,494
4,1104,10,100,1e-05,0.01,0.504,561,543
4,1204,10,100,1e-05,0.01,0.514,609,595
4,1304,10,100,1e-05,0.01,0.514,661,643
4,1404,10,100,1e-05,0.01,0.508,712,692
4,1504,10,100,1e-05,0.01,0.522,767,737
4,1604,10,100,1e-05,0.01,0.514,810,794
4,1704,10,100,1e-05,0.01,0.496,855,849
4,1804,10,100,1e-05,0.01,0.522,898,906
4,1904,10,100,1e-05,0.01,0.52,952,952
4,2004,10,100,1e-05,0.01,0.552,1005,999
4,2104,10,100,1e-05,0.01,0.562,1063,1041
4,2204,10,100,1e-05,0.01,0.594,1113,1091
4,2304,10,100,1e-05,0.01,0.598,1158,1146
4,2404,10,100,1e-05,0.01,0.618,1213,1191
4,2504,10,100,1e-05,0.01,0.626,1269,1235
4,2604,10,100,1e-05,0.01,0.64,1321,1283
4,2704,10,100,1e-05,0.01,0.682,1368,1336
4,2804,10,100,1e-05,0.01,0.682,1417,1387
4,2904,10,100,1e-05,0.01,0.686,1462,1442
4,3004,10,100,1e-05,0.01,0.666,1516,1488
4,3104,10,100,1e-05,0.01,0.694,1568,1536
4,3204,10,100,1e-05,0.01,0.712,1607,1597
4,3304,10,100,1e-05,0.01,0.682,1659,1645
4,3404,10,100,1e-05,0.01,0.71,1702,1702
4,3504,10,100,1e-05,0.01,0.716,1745,1759
4,3604,10,100,1e-05,0.01,0.746,1795,1809
4,3704,10,100,1e-05,0.01,0.756,1847,1857
4,3804,10,100,1e-05,0.01,0.742,1890,1914
4,3904,10,100,1e-05,0.01,0.742,1938,1966
4,4004,10,100,1e-05,0.01,0.76,1990,2014
4,4104,10,100,1e-05,0.01,0.784,2048,2056
4,4204,10,100,1e-05,0.01,0.714,2099,2105
4,4304,10,100,1e-05,0.01,0.752,2150,2154
4,4404,10,100,1e-05,0.01,0.746,2197,2207
4,4504,10,100,1e-05,0.01,0.794,2237,2267
4,4604,10,100,1e-05,0.01,0.768,2290,2314
4,4704,10,100,1e-05,0.01,0.786,2349,2355
4,4804,10,100,1e-05,0.01,0.796,2401,2403
4,4904,10,100,1e-05,0.01,0.798,2456,2448
4,5004,10,100,1e-05,0.01,0.794,2508,2496
4,5104,10,100,1e-05,0.01,0.8,2557,2547
4,5204,10,100,1e-05,0.01,0.768,2605,2599
4,5304,10,100,1e-05,0.01,0.81,2658,2646
4,5404,10,100,1e-05,0.01,0.818,2707,2697
4,5504,10,100,1e-05,0.01,0.818,2752,2752
4,5604,10,100,1e-05,0.01,0.808,2797,2807
4,5704,10,100,1e-05,0.01,0.83,2847,2857
4,5804,10,100,1e-05,0.01,0.788,2896,2908
4,5904,10,100,1e-05,0.01,0.818,2953,2951
4,6004,10,100,1e-05,0.01,0.81,2995,3009
4,6104,10,100,1e-05,0.01,0.836,3051,3053
4,6204,10,100,1e-05,0.01,0.812,3099,3105
4,6304,10,100,1e-05,0.01,0.83,3156,3148
4,6404,10,100,1e-05,0.01,0.83,3214,3190
4,6504,10,100,1e-05,0.01,0.868,3258,3246
4,6604,10,100,1e-05,0.01,0.828,3305,3299
4,6704,10,100,1e-05,0.01,0.824,3354,3350
4,6804,10,100,1e-05,0.01,0.834,3400,3404
4,6904,10,100,1e-05,0.01,0.828,3442,3462
4,7004,10,100,1e-05,0.01,0.83,3487,3517
4,7104,10,100,1e-05,0.01,0.832,3542,3562
4,7204,10,100,1e-05,0.01,0.872,3597,3607
4,7304,10,100,1e-05,0.01,0.884,3644,3660
4,7404,10,100,1e-05,0.01,0.858,3701,3703
4,7504,10,100,1e-05,0.01,0.87,3750,3754
4,7604,10,100,1e-05,0.01,0.884,3807,3797
4,7704,10,100,1e-05,0.01,0.866,3852,3852
4,7804,10,100,1e-05,0.01,0.87,3904,3900
4,7904,10,100,1e-05,0.01,0.862,3960,3944
4,8004,10,100,1e-05,0.01,0.874,4004,4000
4,8104,10,100,1e-05,0.01,0.876,4042,4062
4,8204,10,100,1e-05,0.01,0.896,4084,4120
4,8304,10,100,1e-05,0.01,0.906,4130,4174
4,8404,10,100,1e-05,0.01,0.908,4177,4227
4,8504,10,100,1e-05,0.01,0.902,4223,4281
4,8604,10,100,1e-05,0.01,0.902,4280,4324
4,8704,10,100,1e-05,0.01,0.904,4331,4373
4,8804,10,100,1e-05,0.01,0.88,4386,4418
4,8904,10,100,1e-05,0.01,0.9,4433,4471
4,9004,10,100,1e-05,0.01,0.894,4482,4522
4,9104,10,100,1e-05,0.01,0.912,4523,4581
4,9204,10,100,1e-05,0.01,0.892,4576,4628
4,9304,10,100,1e-05,0.01,0.892,4633,4671
4,9404,10,100,1e-05,0.01,0.898,4688,4716
4,9504,10,100,1e-05,0.01,0.898,4735,4769
4,9604,10,100,1e-05,0.01,0.914,4777,4827
4,9704,10,100,1e-05,0.01,0.89,4820,4884
4,9804,10,100,1e-05,0.01,0.898,4869,4935
4,9904,10,100,1e-05,0.01,0.894,4914,4990
4,10004,10,100,1e-05,0.01,0.918,4966,5038
4,10104,10,100,1e-05,0.01,0.928,5025,5079
4,10204,10,100,1e-05,0.01,0.898,5075,5129
4,10304,10,100,1e-05,0.01,0.918,5129,5175
4,10404,10,100,1e-05,0.01,0.92,5183,5221
4,10504,10,100,1e-05,0.01,0.922,5225,5279
4,10604,10,100,1e-05,0.01,0.914,5274,5330
4,10704,10,100,1e-05,0.01,0.926,5323,5381
4,10804,10,100,1e-05,0.01,0.93,5371,5433
4,10904,10,100,1e-05,0.01,0.926,5419,5485
4,11004,10,100,1e-05,0.01,0.926,5474,5530
4,11104,10,100,1e-05,0.01,0.934,5528,5576
4,11204,10,100,1e-05,0.01,0.928,5579,5625
4,11304,10,100,1e-05,0.01,0.91,5635,5669
4,11404,10,100,1e-05,0.01,0.922,5695,5709
4,11504,10,100,1e-05,0.01,0.924,5748,5756
4,11604,10,100,1e-05,0.01,0.912,5798,5806
4,11704,10,100,1e-05,0.01,0.938,5851,5853
4,11804,10,100,1e-05,0.01,0.946,5908,5896
4,11904,10,100,1e-05,0.01,0.906,5962,5942
4,12004,10,100,1e-05,0.01,0.932,6019,5985
4,12104,10,100,1e-05,0.01,0.91,6073,6031
4,12204,10,100,1e-05,0.01,0.924,6121,6083
4,12304,10,100,1e-05,0.01,0.936,6169,6135
4,12404,10,100,1e-05,0.01,0.936,6224,6180
4,12504,10,100,1e-05,0.01,0.926,6271,6233
4,12604,10,100,1e-05,0.01,0.94,6323,6281
4,12704,10,100,1e-05,0.01,0.948,6367,6337
4,12804,10,100,1e-05,0.01,0.94,6414,6390
4,12904,10,100,1e-05,0.01,0.918,6462,6442
4,13004,10,100,1e-05,0.01,0.932,6512,6492
4,13104,10,100,1e-05,0.01,0.938,6561,6543
4,13204,10,100,1e-05,0.01,0.948,6606,6598
4,13304,10,100,1e-05,0.01,0.962,6652,6652
4,13404,10,100,1e-05,0.01,0.934,6701,6703
4,13504,10,100,1e-05,0.01,0.964,6758,6746
4,13604,10,100,1e-05,0.01,0.968,6806,6798
4,13704,10,100,1e-05,0.01,0.946,6852,6852
4,13804,10,100,1e-05,0.01,0.942,6895,6909
4,13904,10,100,1e-05,0.01,0.95,6942,6962
4,14004,10,100,1e-05,0.01,0.942,6992,7012
4,14104,10,100,1e-05,0.01,0.952,7047,7057
4,14204,10,100,1e-05,0.01,0.956,7098,7106
4,14304,10,100,1e-05,0.01,0.948,7136,7168
4,14404,10,100,1e-05,0.01,0.96,7187,7217
4,14504,10,100,1e-05,0.01,0.956,7227,7277
4,14604,10,100,1e-05,0.01,0.946,7284,7320
4,14704,10,100,1e-05,0.01,0.948,7338,7366
4,14804,10,100,1e-05,0.01,0.948,7388,7416
4,14904,10,100,1e-05,0.01,0.952,7438,7466
4,15004,10,100,1e-05,0.01,0.958,7489,7515
5,104,10,100,1e-05,0.01,0.486,66,38
5,204,10,100,1e-05,0.01,0.51,116,88
5,304,10,100,1e-05,0.01,0.5,169,135
5,404,10,100,1e-05,0.01,0.502,221,183
5,504,10,100,1e-05,0.01,0.51,272,232
5,604,10,100,1e-05,0.01,0.46,316,288
5,704,10,100,1e-05,0.01,0.474,368,336
5,804,10,100,1e-05,0.01,0.484,418,386
5,904,10,100,1e-05,0.01,0.506,455,449
5,1004,10,100,1e-05,0.01,0.536,499,505
5,1104,10,100,1e-05,0.01,0.508,565,539
5,1204,10,100,1e-05,0.01,0.524,617,587
5,1304,10,100,1e-05,0.01,0.526,668,636
5,1404,10,100,1e-05,0.01,0.53,718,686
5,1504,10,100,1e-05,0.01,0.504,762,742
5,1604,10,100,1e-05,0.01,0.522,809,795
5,1704,10,100,1e-05,0.01,0.536,860,844
5,1804,10,100,1e-05,0.01,0.556,904,900
5,1904,10,100,1e-05,0.01,0.578,956,948
5,2004,10,100,1e-05,0.01,0.57,1004,1000
5,2104,10,100,1e-05,0.01,0.57,1050,1054
5,2204,10,100,1e-05,0.01,0.608,1096,1108
5,2304,10,100,1e-05,0.01,0.608,1146,1158
5,2404,10,100,1e-05,0.01,0.594,1193,1211
5,2504,10,100,1e-05,0.01,0.628,1238,1266
5,2604,10,100,1e-05,0.01,0.638,1284,1320
5,2704,10,100,1e-05,0.01,0.646,1335,1369
5,2804,10,100,1e-05,0.01,0.64,1385,1419
5,2904,10,100,1e-05,0.01,0.65,1444,1460
5,3004,10,100,1e-05,0.01,0.648,1501,1503
5,3104,10,100,1e-05,0.01,0.702,1558,1546
5,3204,10,100,1e-05,0.01,0.732,1609,1595
5,3304,10,100,1e-05,0.01,0.73,1664,1640
5,3404,10,100,1e-05,0.01,0.742,1713,1691
5,3504,10,100,1e-05,0.01,0.754,1756,1748
5,3604,10,100,1e-05,0.01,0.744,1809,1795
5,3704,10,100,1e-05,0.01,0.782,1866,1838
5,3804,10,100,1e-05,0.01,0.782,1921,1883
5,3904,10,100,1e-05,0.01,0.788,1959,1945
5,4004,10,100,1e-05,0.01,0.796,2013,1991
5,4104,10,100,1e-05,0.01,0.816,2058,2046
5,4204,10,100,1e-05,0.01,0.812,2100,2104
5,4304,10,100,1e-05,0.01,0.82,2147,2157
5,4404,10,100,1e-05,0.01,0.812,2193,2211
5,4504,10,100,1e-05,0.01,0.804,2235,2269
5,4604,10,100,1e-05,0.01,0.834,2293,2311
5,4704,10,100,1e-05,0.01,0.82,2343,2361
5,4804,10,100,1e-05,0.01,0.81,2393,2411
5,4904,10,100,1e-05,0.01,0.778,2437,2467
5,5004,10,100,1e-05,0.01,0.806,2489,2515
5,5104,10,100,1e-05,0.01,0.856,2536,2568
5,5204,10,100,1e-05,0.01,0.852,2575,2629
5,5304,10,100,1e-05,0.01,0.842,2627,2677
5,5404,10,100,1e-05,0.01,0.836,2673,2731
5,5504,10,100,1e-05,0.01,0.838,2721,2783
5,5604,10,100,1e-05,0.01,0.87,2776,2828
5,5704,10,100,1e-05,0.01,0.872,2826,2878
5,5804,10,100,1e-05,0.01,0.874,2867,2937
5,5904,10,100,1e-05,0.01,0.868,2917,2987
5,6004,10,100,1e-05,0.01,0.864,2959,3045
5,6104,10,100,1e-05,0.01,0.87,3005,3099
5,6204,10,100,1e-05,0.01,0.882,3053,3151
5,6304,10,100,1e-05,0.01,0.878,3109,3195
5,6404,10,100,1e-05,0.01,0.888,3162,3242
5,6504,10,100,1e-05,0.01,0.888,3211,3293
5,6604,10,100,1e-05,0.01,0.902,3255,3349
5,6704,10,100,1e-05,0.01,0.882,3307,3397
5,6804,10,100,1e-05,0.01,0.89,3358,3446
5,6904,10,100,1e-05,0.01,0.908,3413,3491
5,7004,10,100,1e-05,0.01,0.906,3460,3544
5,7104,10,100,1e-05,0.01,0.906,3515,3589
5,7204,10,100,1e-05,0.01,0.898,3564,3640
5,7304,10,100,1e-05,0.01,0.908,3619,3685
5,7404,10,100,1e-05,0.01,0.922,3667,3737
5,7504,10,100,1e-05,0.01,0.92,3718,3786
5,7604,10,100,1e-05,0.01,0.9,3769,3835
5,7704,10,100,1e-05,0.01,0.902,3821,3883
5,7804,10,100,1e-05,0.01,0.906,3874,3930
5,7904,10,100,1e-05,0.01,0.912,3926,3978
5,8004,10,100,1e-05,0.01,0.936,3982,4022
5,8104,10,100,1e-05,0.01,0.91,4033,4071
5,8204,10,100,1e-05,0.01,0.904,4082,4122
5,8304,10,100,1e-05,0.01,0.93,4135,4169
5,8404,10,100,1e-05,0.01,0.902,4182,4222
5,8504,10,100,1e-05,0.01,0.914,4235,4269
5,8604,10,100,1e-05,0.01,0.928,4274,4330
5,8704,10,100,1e-05,0.01,0.932,4323,4381
5,8804,10,100,1e-05,0.01,0.924,4378,4426
5,8904,10,100,1e-05,0.01,0.946,4426,4478
5,9004,10,100,1e-05,0.01,0.946,4467,4537
5,9104,10,100,1e-05,0.01,0.938,4513,4591
5,9204,10,100,1e-05,0.01,0.94,4560,4644
5,9304,10,100,1e-05,0.01,0.936,4607,4697
5,9404,10,100,1e-05,0.01,0.936,4652,4752
5,9504,10,100,1e-05,0.01,0.922,4707,4797
5,9604,10,100,1e-05,0.01,0.924,4771,4833
5,9704,10,100,1e-05,0.01,0.926,4827,4877
5,9804,10,100,1e-05,0.01,0.942,4884,4920
5,9904,10,100,1e-05,0.01,0.932,4924,4980
5,10004,10,100,1e-05,0.01,0.946,4977,5027
5,10104,10,100,1e-05,0.01,0.946,5019,5085
5,10204,10,100,1e-05,0.01,0.95,5069,5135
5,10304,10,100,1e-05,0.01,0.924,5120,5184
5,10404,10,100,1e-05,0.01,0.924,5179,5225
5,10504,10,100,1e-05,0.01,0.948,5230,5274
5,10604,10,100,1e-05,0.01,0.96,5273,5331
5,10704,10,100,1e-05,0.01,0.954,5317,5387
5,10804,10,100,1e-05,0.01,0.962,5380,5424
5,10904,10,100,1e-05,0.01,0.956,5427,5477
5,11004,10,100,1e-05,0.01,0.958,5475,5529
5,11104,10,100,1e-05,0.01,0.946,5523,5581
5,11204,10,100,1e-05,0.01,0.958,5567,5637
5,11304,10,100,1e-05,0.01,0.958,5627,5677
5,11404,10,100,1e-05,0.01,0.97,5675,5729
5,11504,10,100,1e-05,0.01,0.968,5719,5785
5,11604,10,100,1e-05,0.01,0.96,5779,5825
5,11704,10,100,1e-05,0.01,0.968,5838,5866
5,11804,10,100,1e-05,0.01,0.952,5890,5914
5,11904,10,100,1e-05,0.01,0.96,5939,5965
5,12004,10,100,1e-05,0.01,0.96,5989,6015
5,12104,10,100,1e-05,0.01,0.96,6036,6068
5,12204,10,100,1e-05,0.01,0.972,6088,6116
5,12304,10,100,1e-05,0.01,0.966,6140,6164
5,12404,10,100,1e-05,0.01,0.974,6190,6214
5,12504,10,100,1e-05,0.01,0.948,6247,6257
5,12604,10,100,1e-05,0.01,0.968,6305,6299
5,12704,10,100,1e-05,0.01,0.972,6365,6339
5,12804,10,100,1e-05,0.01,0.968,6410,6394
5,12904,10,100,1e-05,0.01,0.964,6456,6448
5,13004,10,100,1e-05,0.01,0.968,6516,6488
5,13104,10,100,1e-05,0.01,0.97,6569,6535
5,13204,10,100,1e-05,0.01,0.966,6622,6582
5,13304,10,100,1e-05,0.01,0.96,6679,6625
5,13404,10,100,1e-05,0.01,0.972,6722,6682
5,13504,10,100,1e-05,0.01,0.982,6771,6733
5,13604,10,100,1e-05,0.01,0.964,6826,6778
5,13704,10,100,1e-05,0.01,0.95,6871,6833
5,13804,10,100,1e-05,0.01,0.972,6922,6882
5,13904,10,100,1e-05,0.01,0.98,6973,6931
5,14004,10,100,1e-05,0.01,0.98,7024,6980
5,14104,10,100,1e-05,0.01,0.976,7073,7031
5,14204,10,100,1e-05,0.01,0.984,7105,7099
5,14304,10,100,1e-05,0.01,0.984,7161,7143
5,14404,10,100,1e-05,0.01,0.976,7212,7192
5,14504,10,100,1e-05,0.01,0.978,7255,7249
5,14604,10,100,1e-05,0.01,0.972,7302,7302
5,14704,10,100,1e-05,0.01,0.966,7349,7355
5,14804,10,100,1e-05,0.01,0.98,7396,7408
5,14904,10,100,1e-05,0.01,0.978,7453,7451
5,15004,10,100,1e-05,0.01,0.988,7506,7498
6,104,10,100,1e-05,0.01,0.48,50,54
6,204,10,100,1e-05,0.01,0.514,96,108
6,304,10,100,1e-05,0.01,0.51,137,167
6,404,10,100,1e-05,0.01,0.508,191,213
6,504,10,100,1e-05,0.01,0.496,253,251
6,604,10,100,1e-05,0.01,0.494,301,303
6,704,10,100,1e-05,0.01,0.486,352,352
6,804,10,100,1e-05,0.01,0.472,404,400
6,904,10,100,1e-05,0.01,0.456,457,447
6,1004,10,100,1e-05,0.01,0.464,500,504
6,1104,10,100,1e-05,0.01,0.464,547,557
6,1204,10,100,1e-05,0.01,0.498,602,602
6,1304,10,100,1e-05,0.01,0.496,652,652
6,1404,10,100,1e-05,0.01,0.5,705,699
6,1504,10,100,1e-05,0.01,0.498,760,744
6,1604,10,100,1e-05,0.01,0.51,808,796
6,1704,10,100,1e-05,0.01,0.492,851,853
6,1804,10,100,1e-05,0.01,0.508,894,910
6,1904,10,100,1e-05,0.01,0.516,942,962
6,2004,10,100,1e-05,0.01,0.552,995,1009
6,2104,10,100,1e-05,0.01,0.524,1038,1066
6,2204,10,100,1e-05,0.01,0.534,1098,1106
6,2304,10,100,1e-05,0.01,0.544,1151,1153
6,2404,10,100,1e-05,0.01,0.558,1203,1201
6,2504,10,100,1e-05,0.01,0.592,1256,1248
6,2604,10,100,1e-05,0.01,0.592,1309,1295
6,2704,10,100,1e-05,0.01,0.594,1363,1341
6,2804,10,100,1e-05,0.01,0.604,1414,1390
6,2904,10,100,1e-05,0.01,0.626,1463,1441
6,3004,10,100,1e-05,0.01,0.65,1515,1489
6,3104,10,100,1e-05,0.01,0.622,1563,1541
6,3204,10,100,1e-05,0.01,0.668,1606,1598
6,3304,10,100,1e-05,0.01,0.666,1653,1651
6,3404,10,100,1e-05,0.01,0.68,1700,1704
6,3504,10,100,1e-05,0.01,0.728,1746,1758
6,3604,10,100,1e-05,0.01,0.754,1791,1813
6,3704,10,100,1e-05,0.01,0.706,1843,1861
6,3804,10,100,1e-05,0.01,0.746,1892,1912
6,3904,10,100,1e-05,0.01,0.766,1948,1956
6,4004,10,100,1e-05,0.01,0.76,1998,2006
6,4104,10,100,1e-05,0.01,0.742,2049,2055
6,4204,10,100,1e-05,0.01,0.774,2099,2105
6,4304,10,100,1e-05,0.01,0.746,2144,2160
6,4404,10,100,1e-05,0.01,0.77,2194,2210
6,4504,10,100,1e-05,0.01,0.782,2247,2257
6,4604,10,100,1e-05,0.01,0.792,2293,2311
6,4704,10,100,1e-05,0.01,0.804,2341,2363
6,4804,10,100,1e-05,0.01,0.786,2390,2414
6,4904,10,100,1e-05,0.01,0.8,2436,2468
6,5004,10,100,1e-05,0.01,0.824,2486,2518
6,5104,10,100,1e-05,0.01,0.812,2522,2582
6,5204,10,100,1e-05,0.01,0.79,2574,2630
6,5304,10,100,1e-05,0.01,0.804,2628,2676
6,5404,10,100,1e-05,0.01,0.84,2670,2734
6,5504,10,100,1e-05,0.01,0.85,2721,2783
6,5604,10,100,1e-05,0.01,0.86,2771,2833
6,5704,10,100,1e-05,0.01,0.864,2826,2878
6,5804,10,100,1e-05,0.01,0.864,2880,2924
6,5904,10,100,1e-05,0.01,0.856,2935,2969
6,6004,10,100,1e-05,0.01,0.852,2987,3017
6,6104,10,100,1e-05,0.01,0.84,3038,3066
6,6204,10,100,1e-05,0.01,0.854,3090,3114
6,6304,10,100,1e-05,0.01,0.81,3143,3161
6,6404,10,100,1e-05,0.01,0.85,3182,3222
6,6504,10,100,1e-05,0.01,0.854,3227,3277
6,6604,10,100,1e-05,0.01,0.862,3283,3321
6,6704,10,100,1e-05,0.01,0.872,3329,3375
6,6804,10,100,1e-05,0.01,0.862,3379,3425
6,6904,10,100,1e-05,0.01,0.872,3427,3477
6,7004,10,100,1e-05,0.01,0.88,3482,3522
6,7104,10,100,1e-05,0.01,0.856,3532,3572
6,7204,10,100,1e-05,0.01,0.882,3579,3625
6,7304,10,100,1e-05,0.01,0.89,3636,3668
6,7404,10,100,1e-05,0.01,0.878,3692,3712
6,7504,10,100,1e-05,0.01,0.882,3744,3760
6,7604,10,100,1e-05,0.01,0.884,3795,3809
6,7704,10,100,1e-05,0.01,0.89,3844,3860
6,7804,10,100,1e-05,0.01,0.906,3891,3913
6,7904,10,100,1e-05,0.01,0.898,3943,3961
6,8004,10,100,1e-05,0.01,0.902,4004,4000
6,8104,10,100,1e-05,0.01,0.908,4057,4047
6,8204,10,100,1e-05,0.01,0.904,4110,4094
6,8304,10,100,1e-05,0.01,0.902,4162,4142
6,8404,10,100,1e-05,0.01,0.9,4210,4194
6,8504,10,100,1e-05,0.01,0.916,4262,4242
6,8604,10,100,1e-05,0.01,0.886,4314,4290
6,8704,10,100,1e-05,0.01,0.9,4362,4342
6,8804,10,100,1e-05,0.01,0.91,4407,4397
6,8904,10,100,1e-05,0.01,0.904,4455,4449
6,9004,10,100,1e-05,0.01,0.924,4503,4501
6,9104,10,100,1e-05,0.01,0.906,4548,4556
6,9204,10,100,1e-05,0.01,0.912,4594,4610
6,9304,10,100,1e-05,0.01,0.926,4639,4665
6,9404,10,100,1e-05,0.01,0.94,4681,4723
6,9504,10,100,1e-05,0.01,0.934,4734,4770
6,9604,10,100,1e-05,0.01,0.938,4793,4811
6,9704,10,100,1e-05,0.01,0.928,4845,4859
6,9804,10,100,1e-05,0.01,0.922,4900,4904
6,9904,10,100,1e-05,0.01,0.922,4955,4949
6,10004,10,100,1e-05,0.01,0.93,5000,5004
6,10104,10,100,1e-05,0.01,0.94,5044,5060
6,10204,10,100,1e-05,0.01,0.942,5097,5107
6,10304,10,100,1e-05,0.01,0.94,5143,5161
6,10404,10,100,1e-05,0.01,0.948,5198,5206
6,10504,10,100,1e-05,0.01,0.934,5242,5262
6,10604,10,100,1e-05,0.01,0.944,5294,5310
6,10704,10,100,1e-05,0.01,0.95,5345,5359
6,10804,10,100,1e-05,0.01,0.954,5395,5409
6,10904,10,100,1e-05,0.01,0.956,5443,5461
6,11004,10,100,1e-05,0.01,0.96,5497,5507
6,11104,10,100,1e-05,0.01,0.964,5548,5556
6,11204,10,100,1e-05,0.01,0.958,5592,5612
6,11304,10,100,1e-05,0.01,0.954,5651,5653
6,11404,10,100,1e-05,0.01,0.956,5704,5700
6,11504,10,100,1e-05,0.01,0.966,5750,5754
6,11604,10,100,1e-05,0.01,0.936,5801,5803
6,11704,10,100,1e-05,0.01,0.964,5856,5848
6,11804,10,100,1e-05,0.01,0.968,5903,5901
6,11904,10,100,1e-05,0.01,0.956,5952,5952
6,12004,10,100,1e-05,0.01,0.966,5996,6008
6,12104,10,100,1e-05,0.01,0.96,6054,6050
6,12204,10,100,1e-05,0.01,0.968,6111,6093
6,12304,10,100,1e-05,0.01,0.97,6160,6144
6,12404,10,100,1e-05,0.01,0.972,6212,6192
6,12504,10,100,1e-05,0.01,0.974,6268,6236
6,12604,10,100,1e-05,0.01,0.968,6316,6288
6,12704,10,100,1e-05,0.01,0.96,6368,6336
6,12804,10,100,1e-05,0.01,0.958,6414,6390
6,12904,10,100,1e-05,0.01,0.97,6464,6440
6,13004,10,100,1e-05,0.01,0.962,6516,6488
6,13104,10,100,1e-05,0.01,0.962,6567,6537
6,13204,10,100,1e-05,0.01,0.954,6616,6588
6,13304,10,100,1e-05,0.01,0.958,6655,6649
6,13404,10,100,1e-05,0.01,0.95,6709,6695
6,13504,10,100,1e-05,0.01,0.962,6758,6746
6,13604,10,100,1e-05,0.01,0.966,6805,6799
6,13704,10,100,1e-05,0.01,0.974,6858,6846
6,13804,10,100,1e-05,0.01,0.978,6909,6895
6,13904,10,100,1e-05,0.01,0.974,6951,6953
6,14004,10,100,1e-05,0.01,0.968,6998,7006
6,14104,10,100,1e-05,0.01,0.97,7044,7060
6,14204,10,100,1e-05,0.01,0.976,7096,7108
6,14304,10,100,1e-05,0.01,0.982,7148,7156
6,14404,10,100,1e-05,0.01,0.966,7197,7207
6,14504,10,100,1e-05,0.01,0.978,7251,7253
6,14604,10,100,1e-05,0.01,0.978,7303,7301
6,14704,10,100,1e-05,0.01,0.956,7355,7349
6,14804,10,100,1e-05,0.01,0.972,7404,7400
6,14904,10,100,1e-05,0.01,0.968,7459,7445
6,15004,10,100,1e-05,0.01,0.976,7512,7492
7,104,10,100,1e-05,0.01,0.52,41,63
7,204,10,100,1e-05,0.01,0.526,87,117
7,304,10,100,1e-05,0.01,0.474,137,167
7,404,10,100,1e-05,0.01,0.486,182,222
7,504,10,100,1e-05,0.01,0.49,233,271
7,604,10,100,1e-05,0.01,0.518,292,312
7,704,10,100,1e-05,0.01,0.536,343,361
7,804,10,100,1e-05,0.01,0.538,392,412
7,904,10,100,1e-05,0.01,0.528,436,468
7,1004,10,100,1e-05,0.01,0.49,484,520
7,1104,10,100,1e-05,0.01,0.48,541,563
7,1204,10,100,1e-05,0.01,0.506,584,620
7,1304,10,100,1e-05,0.01,0.536,637,667
7,1404,10,100,1e-05,0.01,0.506,685,719
7,1504,10,100,1e-05,0.01,0.492,745,759
7,1604,10,100,1e-05,0.01,0.524,800,804
7,1704,10,100,1e-05,0.01,0.51,844,860
7,1804,10,100,1e-05,0.01,0.534,886,918
7,1904,10,100,1e-05,0.01,0.554,935,969
7,2004,10,100,1e-05,0.01,0.564,981,1023
7,2104,10,100,1e-05,0.01,0.53,1027,1077
7,2204,10,100,1e-05,0.01,0.526,1087,1117
7,2304,10,100,1e-05,0.01,0.536,1137,1167
7,2404,10,100,1e-05,0.01,0.572,1187,1217
7,2504,10,100,1e-05,0.01,0.568,1238,1266
7,2604,10,100,1e-05,0.01,0.54,1290,1314
7,2704,10,100,1e-05,0.01,0.576,1338,1366
7,2804,10,100,1e-05,0.01,0.59,1380,1424
7,2904,10,100,1e-05,0.01,0.592,1438,1466
7,3004,10,100,1e-05,0.01,0.564,1489,1515
7,3104,10,100,1e-05,0.01,0.564,1533,1571
7,3204,10,100,1e-05,0.01,0.576,1576,1628
7,3304,10,100,1e-05,0.01,0.59,1627,1677
7,3404,10,100,1e-05,0.01,0.59,1673,1731
7,3504,10,100,1e-05,0.01,0.586,1725,1779
7,3604,10,100,1e-05,0.01,0.6,1769,1835
7,3704,10,100,1e-05,0.01,0.584,1826,1878
7,3804,10,100,1e-05,0.01,0.596,1875,1929
7,3904,10,100,1e-05,0.01,0.588,1929,1975
7,4004,10,100,1e-05,0.01,0.592,1991,2013
7,4104,10,100,1e-05,0.01,0.602,2043,2061
7,4204,10,100,1e-05,0.01,0.596,2095,2109
7,4304,10,100,1e-05,0.01,0.584,2138,2166
7,4404,10,100,1e-05,0.01,0.608,2195,2209
7,4504,10,100,1e-05,0.01,0.592,2239,2265
7,4604,10,100,1e-05,0.01,0.632,2297,2307
7,4704,10,100,1e-05,0.01,0.596,2351,2353
7,4804,10,100,1e-05,0.01,0.628,2400,2404
7,4904,10,100,1e-05,0.01,0.62,2450,2454
7,5004,10,100,1e-05,0.01,0.638,2503,2501
7,5104,10,100,1e-05,0.01,0.624,2561,2543
7,5204,10,100,1e-05,0.01,0.626,2611,2593
7,5304,10,100,1e-05,0.01,0.622,2669,2635
7,5404,10,100,1e-05,0.01,0.642,2720,2684
7,5504,10,100,1e-05,0.01,0.646,2771,2733
7,5604,10,100,1e-05,0.01,0.648,2805,2799
7,5704,10,100,1e-05,0.01,0.63,2849,2855
7,5804,10,100,1e-05,0.01,0.602,2897,2907
7,5904,10,100,1e-05,0.01,0.65,2956,2948
7,6004,10,100,1e-05,0.01,0.654,3009,2995
7,6104,10,100,1e-05,0.01,0.65,3062,3042
7,6204,10,100,1e-05,0.01,0.644,3111,3093
7,6304,10,100,1e-05,0.01,0.66,3170,3134
7,6404,10,100,1e-05,0.01,0.636,3215,3189
7,6504,10,100,1e-05,0.01,0.65,3270,3234
7,6604,10,100,1e-05,0.01,0.654,3314,3290
7,6704,10,100,1e-05,0.01,0.638,3357,3347
7,6804,10,100,1e-05,0.01,0.672,3401,3403
7,6904,10,100,1e-05,0.01,0.672,3458,3446
7,7004,10,100,1e-05,0.01,0.652,3505,3499
7,7104,10,100,1e-05,0.01,0.664,3549,3555
7,7204,10,100,1e-05,0.01,0.654,3599,3605
7,7304,10,100,1e-05,0.01,0.682,3644,3660
7,7404,10,100,1e-05,0.01,0.646,3693,3711
7,7504,10,100,1e-05,0.01,0.668,3743,3761
7,7604,10,100,1e-05,0.01,0.676,3795,3809
7,7704,10,100,1e-05,0.01,0.664,3840,3864
7,7804,10,100,1e-05,0.01,0.672,3891,3913
7,7904,10,100,1e-05,0.01,0.664,3944,3960
7,8004,10,100,1e-05,0.01,0.664,3983,4021
7,8104,10,100,1e-05,0.01,0.688,4031,4073
7,8204,10,100,1e-05,0.01,0.674,4075,4129
7,8304,10,100,1e-05,0.01,0.68,4123,4181
7,8404,10,100,1e-05,0.01,0.7,4168,4236
7,8504,10,100,1e-05,0.01,0.658,4215,4289
7,8604,10,100,1e-05,0.01,0.69,4261,4343
7,8704,10,100,1e-05,0.01,0.68,4314,4390
7,8804,10,100,1e-05,0.01,0.68,4366,4438
7,8904,10,100,1e-05,0.01,0.698,4412,4492
7,9004,10,100,1e-05,0.01,0.694,4463,4541
7,9104,10,100,1e-05,0.01,0.702,4516,4588
7,9204,10,100,1e-05,0.01,0.714,4556,4648
7,9304,10,100,1e-05,0.01,0.664,4600,4704
7,9404,10,100,1e-05,0.01,0.696,4659,4745
7,9504,10,100,1e-05,0.01,0.7,4709,4795
7,9604,10,100,1e-05,0.01,0.706,4761,4843
7,9704,10,100,1e-05,0.01,0.68,4812,4892
7,9804,10,100,1e-05,0.01,0.712,4876,4928
7,9904,10,100,1e-05,0.01,0.692,4921,4983
7,10004,10,100,1e-05,0.01,0.694,4969,5035
7,10104,10,100,1e-05,0.01,0.704,5017,5087
7,10204,10,100,1e-05,0.01,0.716,5058,5146
7,10304,10,100,1e-05,0.01,0.718,5105,5199
7,10404,10,100,1e-05,0.01,0.71,5158,5246
7,10504,10,100,1e-05,0.01,0.728,5213,5291
7,10604,10,100,1e-05,0.01,0.744,5271,5333
7,10704,10,100,1e-05,0.01,0.72,5322,5382
7,10804,10,100,1e-05,0.01,0.722,5369,5435
7,10904,10,100,1e-05,0.01,0.692,5424,5480
7,11004,10,100,1e-05,0.01,0.734,5471,5533
7,11104,10,100,1e-05,0.01,0.75,5528,5576
7,11204,10,100,1e-05,0.01,0.726,5573,5631
7,11304,10,100,1e-05,0.01,0.748,5622,5682
7,11404,10,100,1e-05,0.01,0.764,5679,5725
7,11504,10,100,1e-05,0.01,0.746,5728,5776
7,11604,10,100,1e-05,0.01,0.762,5784,5820
7,11704,10,100,1e-05,0.01,0.758,5839,5865
7,11804,10,100,1e-05,0.01,0.774,5895,5909
7,11904,10,100,1e-05,0.01,0.776,5950,5954
7,12004,10,100,1e-05,0.01,0.766,5993,6011
7,12104,10,100,1e-05,0.01,0.774,6051,6053
7,12204,10,100,1e-05,0.01,0.772,6100,6104
7,12304,10,100,1e-05,0.01,0.764,6152,6152
7,12404,10,100,1e-05,0.01,0.76,6208,6196
7,12504,10,100,1e-05,0.01,0.788,6257,6247
7,12604,10,100,1e-05,0.01,0.76,6308,6296
7,12704,10,100,1e-05,0.01,0.774,6358,6346
7,12804,10,100,1e-05,0.01,0.76,6404,6400
7,12904,10,100,1e-05,0.01,0.784,6452,6452
7,13004,10,100,1e-05,0.01,0.802,6507,6497
7,13104,10,100,1e-05,0.01,0.786,6554,6550
7,13204,10,100,1e-05,0.01,0.804,6607,6597
7,13304,10,100,1e-05,0.01,0.788,6659,6645
7,13404,10,100,1e-05,0.01,0.792,6708,6696
7,13504,10,100,1e-05,0.01,0.806,6761,6743
7,13604,10,100,1e-05,0.01,0.8,6805,6799
7,13704,10,100,1e-05,0.01,0.786,6853,6851
7,13804,10,100,1e-05,0.01,0.796,6911,6893
7,13904,10,100,1e-05,0.01,0.8,6956,6948
7,14004,10,100,1e-05,0.01,0.804,7002,7002
7,14104,10,100,1e-05,0.01,0.786,7050,7054
7,14204,10,100,1e-05,0.01,0.798,7098,7106
7,14304,10,100,1e-05,0.01,0.798,7144,7160
7,14404,10,100,1e-05,0.01,0.804,7197,7207
7,14504,10,100,1e-05,0.01,0.794,7252,7252
7,14604,10,100,1e-05,0.01,0.81,7299,7305
7,14704,10,100,1e-05,0.01,0.798,7352,7352
7,14804,10,100,1e-05,0.01,0.802,7399,7405
7,14904,10,100,1e-05,0.01,0.796,7457,7447
7,15004,10,100,1e-05,0.01,0.802,7512,7492
8,104,10,100,1e-05,0.01,0.506,50,54
8,204,10,100,1e-05,0.01,0.5,102,102
8,304,10,100,1e-05,0.01,0.508,152,152
8,404,10,100,1e-05,0.01,0.486,201,203
8,504,10,100,1e-05,0.01,0.486,255,249
8,604,10,100,1e-05,0.01,0.494,301,303
8,704,10,100,1e-05,0.01,0.52,346,358
8,804,10,100,1e-05,0.01,0.516,395,409
8,904,10,100,1e-05,0.01,0.508,439,465
8,1004,10,100,1e-05,0.01,0.518,484,520
8,1104,10,100,1e-05,0.01,0.51,531,573
8,1204,10,100,1e-05,0.01,0.534,571,633
8,1304,10,100,1e-05,0.01,0.528,619,685
8,1404,10,100,1e-05,0.01,0.542,674,730
8,1504,10,100,1e-05,0.01,0.534,724,780
8,1604,10,100,1e-05,0.01,0.524,778,826
8,1704,10,100,1e-05,0.01,0.528,824,880
8,1804,10,100,1e-05,0.01,0.548,874,930
8,1904,10,100,1e-05,0.01,0.556,923,981
8,2004,10,100,1e-05,0.01,0.578,969,1035
8,2104,10,100,1e-05,0.01,0.526,1015,1089
8,2204,10,100,1e-05,0.01,0.584,1071,1133
8,2304,10,100,1e-05,0.01,0.548,1132,1172
8,2404,10,100,1e-05,0.01,0.548,1180,1224
8,2504,10,100,1e-05,0.01,0.548,1231,1273
8,2604,10,100,1e-05,0.01,0.558,1287,1317
8,2704,10,100,1e-05,0.01,0.558,1334,1370
8,2804,10,100,1e-05,0.01,0.534,1390,1414
8,2904,10,100,1e-05,0.01,0.604,1442,1462
8,3004,10,100,1e-05,0.01,0.604,1499,1505
8,3104,10,100,1e-05,0.01,0.598,1546,1558
8,3204,10,100,1e-05,0.01,0.62,1581,1623
8,3304,10,100,1e-05,0.01,0.62,1631,1673
8,3404,10,100,1e-05,0.01,0.65,1689,1715
8,3504,10,100,1e-05,0.01,0.598,1733,1771
8,3604,10,100,1e-05,0.01,0.586,1785,1819
8,3704,10,100,1e-05,0.01,0.626,1844,1860
8,3804,10,100,1e-05,0.01,0.654,1889,1915
8,3904,10,100,1e-05,0.01,0.608,1941,1963
8,4004,10,100,1e-05,0.01,0.62,1994,2010
8,4104,10,100,1e-05,0.01,0.624,2043,2061
8,4204,10,100,1e-05,0.01,0.648,2097,2107
8,4304,10,100,1e-05,0.01,0.632,2149,2155
8,4404,10,100,1e-05,0.01,0.668,2187,2217
8,4504,10,100,1e-05,0.01,0.636,2245,2259
8,4604,10,100,1e-05,0.01,0.634,2299,2305
8,4704,10,100,1e-05,0.01,0.652,2346,2358
8,4804,10,100,1e-05,0.01,0.67,2395,2409
8,4904,10,100,1e-05,0.01,0.666,2447,2457
8,5004,10,100,1e-05,0.01,0.676,2503,2501
8,5104,10,100,1e-05,0.01,0.708,2553,2551
8,5204,10,100,1e-05,0.01,0.714,2599,2605
8,5304,10,100,1e-05,0.01,0.672,2650,2654
8,5404,10,100,1e-05,0.01,0.696,2707,2697
8,5504,10,100,1e-05,0.01,0.694,2752,2752
8,5604,10,100,1e-05,0.01,0.7,2803,2801
8,5704,10,100,1e-05,0.01,0.706,2851,2853
8,5804,10,100,1e-05,0.01,0.714,2897,2907
8,5904,10,100,1e-05,0.01,0.694,2945,2959
8,6004,10,100,1e-05,0.01,0.728,2992,3012
8,6104,10,100,1e-05,0.01,0.726,3043,3061
8,6204,10,100,1e-05,0.01,0.734,3088,3116
8,6304,10,100,1e-05,0.01,0.716,3140,3164
8,6404,10,100,1e-05,0.01,0.746,3187,3217
8,6504,10,100,1e-05,0.01,0.704,3228,3276
8,6604,10,100,1e-05,0.01,0.74,3279,3325
8,6704,10,100,1e-05,0.01,0.734,3325,3379
8,6804,10,100,1e-05,0.01,0.738,3380,3424
8,6904,10,100,1e-05,0.01,0.758,3429,3475
8,7004,10,100,1e-05,0.01,0.746,3478,3526
8,7104,10,100,1e-05,0.01,0.704,3521,3583
8,7204,10,100,1e-05,0.01,0.75,3576,3628
8,7304,10,100,1e-05,0.01,0.746,3627,3677
8,7404,10,100,1e-05,0.01,0.758,3685,3719
8,7504,10,100,1e-05,0.01,0.764,3735,3769
8,7604,10,100,1e-05,0.01,0.75,3786,3818
8,7704,10,100,1e-05,0.01,0.756,3831,3873
8,7804,10,100,1e-05,0.01,0.77,3880,3924
8,7904,10,100,1e-05,0.01,0.752,3921,3983
8,8004,10,100,1e-05,0.01,0.766,3971,4033
8,8104,10,100,1e-05,0.01,0.762,4021,4083
8,8204,10,100,1e-05,0.01,0.772,4067,4137
8,8304,10,100,1e-05,0.01,0.786,4115,4189
8,8404,10,100,1e-05,0.01,0.786,4167,4237
8,8504,10,100,1e-05,0.01,0.772,4213,4291
8,8604,10,100,1e-05,0.01,0.782,4266,4338
8,8704,10,100,1e-05,0.01,0.8,4313,4391
8,8804,10,100,1e-05,0.01,0.798,4360,4444
8,8904,10,100,1e-05,0.01,0.786,4403,4501
8,9004,10,100,1e-05,0.01,0.794,4456,4548
8,9104,10,100,1e-05,0.01,0.802,4511,4593
8,9204,10,100,1e-05,0.01,0.822,4563,4641
8,9304,10,100,1e-05,0.01,0.82,4611,4693
8,9404,10,100,1e-05,0.01,0.828,4668,4736
8,9504,10,100,1e-05,0.01,0.82,4726,4778
8,9604,10,100,1e-05,0.01,0.806,4777,4827
8,9704,10,100,1e-05,0.01,0.828,4828,4876
8,9804,10,100,1e-05,0.01,0.828,4875,4929
8,9904,10,100,1e-05,0.01,0.832,4931,4973
8,10004,10,100,1e-05,0.01,0.82,4984,5020
8,10104,10,100,1e-05,0.01,0.834,5029,5075
8,10204,10,100,1e-05,0.01,0.84,5077,5127
8,10304,10,100,1e-05,0.01,0.86,5137,5167
8,10404,10,100,1e-05,0.01,0.852,5192,5212
8,10504,10,100,1e-05,0.01,0.856,5245,5259
8,10604,10,100,1e-05,0.01,0.842,5295,5309
8,10704,10,100,1e-05,0.01,0.838,5352,5352
8,10804,10,100,1e-05,0.01,0.834,5400,5404
8,10904,10,100,1e-05,0.01,0.826,5462,5442
8,11004,10,100,1e-05,0.01,0.862,5510,5494
8,11104,10,100,1e-05,0.01,0.844,5562,5542
8,11204,10,100,1e-05,0.01,0.866,5608,5596
8,11304,10,100,1e-05,0.01,0.874,5657,5647
8,11404,10,100,1e-05,0.01,0.88,5706,5698
8,11504,10,100,1e-05,0.01,0.87,5746,5758
8,11604,10,100,1e-05,0.01,0.868,5801,5803
8,11704,10,100,1e-05,0.01,0.864,5854,5850
8,11804,10,100,1e-05,0.01,0.882,5903,5901
8,11904,10,100,1e-05,0.01,0.876,5955,5949
8,12004,10,100,1e-05,0.01,0.892,6010,5994
8,12104,10,100,1e-05,0.01,0.91,6061,6043
8,12204,10,100,1e-05,0.01,0.896,6112,6092
8,12304,10,100,1e-05,0.01,0.892,6159,6145
8,12404,10,100,1e-05,0.01,0.888,6215,6189
8,12504,10,100,1e-05,0.01,0.89,6261,6243
8,12604,10,100,1e-05,0.01,0.9,6317,6287
8,12704,10,100,1e-05,0.01,0.898,6375,6329
8,12804,10,100,1e-05,0.01,0.922,6421,6383
8,12904,10,100,1e-05,0.01,0.936,6467,6437
8,13004,10,100,1e-05,0.01,0.93,6517,6487
8,13104,10,100,1e-05,0.01,0.914,6568,6536
8,13204,10,100,1e-05,0.01,0.92,6618,6586
8,13304,10,100,1e-05,0.01,0.93,6666,6638
8,13404,10,100,1e-05,0.01,0.94,6710,6694
8,13504,10,100,1e-05,0.01,0.936,6758,6746
8,13604,10,100,1e-05,0.01,0.944,6808,6796
8,13704,10,100,1e-05,0.01,0.932,6869,6835
8,13804,10,100,1e-05,0.01,0.928,6919,6885
8,13904,10,100,1e-05,0.01,0.942,6966,6938
8,14004,10,100,1e-05,0.01,0.93,7014,6990
8,14104,10,100,1e-05,0.01,0.946,7072,7032
8,14204,10,100,1e-05,0.01,0.942,7119,7085
8,14304,10,100,1e-05,0.01,0.942,7175,7129
8,14404,10,100,1e-05,0.01,0.956,7228,7176
8,14504,10,100,1e-05,0.01,0.948,7284,7220
8,14604,10,100,1e-05,0.01,0.934,7324,7280
8,14704,10,100,1e-05,0.01,0.95,7370,7334
8,14804,10,100,1e-05,0.01,0.952,7414,7390
8,14904,10,100,1e-05,0.01,0.97,7455,7449
8,15004,10,100,1e-05,0.01,0.964,7507,7497
9,104,10,100,1e-05,0.01,0.48,51,53
9,204,10,100,1e-05,0.01,0.504,110,94
9,304,10,100,1e-05,0.01,0.522,162,142
9,404,10,100,1e-05,0.01,0.508,201,203
9,504,10,100,1e-05,0.01,0.486,252,252
9,604,10,100,1e-05,0.01,0.518,302,302
9,704,10,100,1e-05,0.01,0.502,350,354
9,804,10,100,1e-05,0.01,0.488,402,402
9,904,10,100,1e-05,0.01,0.5,457,447
9,1004,10,100,1e-05,0.01,0.514,510,494
9,1104,10,100,1e-05,0.01,0.538,558,546
9,1204,10,100,1e-05,0.01,0.51,609,595
9,1304,10,100,1e-05,0.01,0.5,663,641
9,1404,10,100,1e-05,0.01,0.482,711,693
9,1504,10,100,1e-05,0.01,0.496,756,748
9,1604,10,100,1e-05,0.01,0.504,810,794
9,1704,10,100,1e-05,0.01,0.512,859,845
9,1804,10,100,1e-05,0.01,0.508,921,883
9,1904,10,100,1e-05,0.01,0.51,967,937
9,2004,10,100,1e-05,0.01,0.524,1019,985
9,2104,10,100,1e-05,0.01,0.524,1074,1030
9,2204,10,100,1e-05,0.01,0.518,1129,1075
9,2304,10,100,1e-05,0.01,0.508,1182,1122
9,2404,10,100,1e-05,0.01,0.51,1228,1176
9,2504,10,100,1e-05,0.01,0.524,1279,1225
9,2604,10,100,1e-05,0.01,0.552,1330,1274
9,2704,10,100,1e-05,0.01,0.546,1385,1319
9,2804,10,100,1e-05,0.01,0.528,1434,1370
9,2904,10,100,1e-05,0.01,0.534,1483,1421
9,3004,10,100,1e-05,0.01,0.55,1533,1471
9,3104,10,100,1e-05,0.01,0.53,1583,1521
9,3204,10,100,1e-05,0.01,0.514,1625,1579
9,3304,10,100,1e-05,0.01,0.512,1677,1627
9,3404,10,100,1e-05,0.01,0.526,1733,1671
9,3504,10,100,1e-05,0.01,0.546,1788,1716
9,3604,10,100,1e-05,0.01,0.544,1834,1770
9,3704,10,100,1e-05,0.01,0.52,1879,1825
9,3804,10,100,1e-05,0.01,0.558,1931,1873
9,3904,10,100,1e-05,0.01,0.554,1981,1923
9,4004,10,100,1e-05,0.01,0.562,2047,1957
9,4104,10,100,1e-05,0.01,0.564,2097,2007
9,4204,10,100,1e-05,0.01,0.578,2148,2056
9,4304,10,100,1e-05,0.01,0.588,2196,2108
9,4404,10,100,1e-05,0.01,0.556,2240,2164
9,4504,10,100,1e-05,0.01,0.572,2294,2210
9,4604,10,100,1e-05,0.01,0.57,2339,2265
9,4704,10,100,1e-05,0.01,0.576,2388,2316
9,4804,10,100,1e-05,0.01,0.572,2440,2364
9,4904,10,100,1e-05,0.01,0.566,2493,2411
9,5004,10,100,1e-05,0.01,0.55,2540,2464
9,5104,10,100,1e-05,0.01,0.578,2597,2507
9,5204,10,100,1e-05,0.01,0.606,2647,2557
9,5304,10,100,1e-05,0.01,0.584,2695,2609
9,5404,10,100,1e-05,0.01,0.604,2744,2660
9,5504,10,100,1e-05,0.01,0.59,2792,2712
9,5604,10,100,1e-05,0.01,0.58,2846,2758
9,5704,10,100,1e-05,0.01,0.596,2886,2818
9,5804,10,100,1e-05,0.01,0.592,2939,2865
9,5904,10,100,1e-05,0.01,0.624,2993,2911
9,6004,10,100,1e-05,0.01,0.61,3040,2964
9,6104,10,100,1e-05,0.01,0.62,3101,3003
9,6204,10,100,1e-05,0.01,0.588,3152,3052
9,6304,10,100,1e-05,0.01,0.614,3201,3103
9,6404,10,100,1e-05,0.01,0.622,3245,3159
9,6504,10,100,1e-05,0.01,0.608,3299,3205
9,6604,10,100,1e-05,0.01,0.638,3343,3261
9,6704,10,100,1e-05,0.01,0.632,3393,3311
9,6804,10,100,1e-05,0.01,0.65,3446,3358
9,6904,10,100,1e-05,0.01,0.624,3489,3415
9,7004,10,100,1e-05,0.01,0.612,3539,3465
9,7104,10,100,1e-05,0.01,0.624,3587,3517
9,7204,10,100,1e-05,0.01,0.62,3633,3571
9,7304,10,100,1e-05,0.01,0.652,3682,3622
9,7404,10,100,1e-05,0.01,0.646,3718,3686
9,7504,10,100,1e-05,0.01,0.636,3764,3740
9,7604,10,100,1e-05,0.01,0.664,3819,3785
9,7704,10,100,1e-05,0.01,0.628,3877,3827
9,7804,10,100,1e-05,0.01,0.664,3921,3883
9,7904,10,100,1e-05,0.01,0.646,3970,3934
9,8004,10,100,1e-05,0.01,0.68,4020,3984
9,8104,10,100,1e-05,0.01,0.678,4073,4031
9,8204,10,100,1e-05,0.01,0.674,4125,4079
9,8304,10,100,1e-05,0.01,0.68,4170,4134
9,8404,10,100,1e-05,0.01,0.688,4217,4187
9,8504,10,100,1e-05,0.01,0.68,4273,4231
9,8604,10,100,1e-05,0.01,0.724,4325,4279
9,8704,10,100,1e-05,0.01,0.714,4373,4331
9,8804,10,100,1e-05,0.01,0.704,4418,4386
9,8904,10,100,1e-05,0.01,0.698,4462,4442
9,9004,10,100,1e-05,0.01,0.688,4511,4493
9,9104,10,100,1e-05,0.01,0.692,4560,4544
9,9204,10,100,1e-05,0.01,0.706,4609,4595
9,9304,10,100,1e-05,0.01,0.708,4656,4648
9,9404,10,100,1e-05,0.01,0.754,4717,4687
9,9504,10,100,1e-05,0.01,0.714,4770,4734
9,9604,10,100,1e-05,0.01,0.756,4819,4785
9,9704,10,100,1e-05,0.01,0.748,4869,4835
9,9804,10,100,1e-05,0.01,0.746,4909,4895
9,9904,10,100,1e-05,0.01,0.742,4969,4935
9,10004,10,100,1e-05,0.01,0.762,5028,4976
9,10104,10,100,1e-05,0.01,0.75,5087,5017
9,10204,10,100,1e-05,0.01,0.77,5138,5066
9,10304,10,100,1e-05,0.01,0.746,5183,5121
9,10404,10,100,1e-05,0.01,0.754,5233,5171
9,10504,10,100,1e-05,0.01,0.768,5280,5224
9,10604,10,100,1e-05,0.01,0.774,5324,5280
9,10704,10,100,1e-05,0.01,0.79,5375,5329
9,10804,10,100,1e-05,0.01,0.768,5415,5389
9,10904,10,100,1e-05,0.01,0.768,5464,5440
9,11004,10,100,1e-05,0.01,0.778,5516,5488
9,11104,10,100,1e-05,0.01,0.778,5566,5538
9,11204,10,100,1e-05,0.01,0.786,5626,5578
9,11304,10,100,1e-05,0.01,0.794,5679,5625
9,11404,10,100,1e-05,0.01,0.772,5728,5676
9,11504,10,100,1e-05,0.01,0.784,5771,5733
9,11604,10,100,1e-05,0.01,0.796,5813,5791
9,11704,10,100,1e-05,0.01,0.802,5860,5844
9,11804,10,100,1e-05,0.01,0.792,5911,5893
9,11904,10,100,1e-05,0.01,0.816,5961,5943
9,12004,10,100,1e-05,0.01,0.804,6013,5991
9,12104,10,100,1e-05,0.01,0.786,6067,6037
9,12204,10,100,1e-05,0.01,0.806,6120,6084
9,12304,10,100,1e-05,0.01,0.828,6173,6131
9,12404,10,100,1e-05,0.01,0.822,6226,6178
9,12504,10,100,1e-05,0.01,0.832,6268,6236
9,12604,10,100,1e-05,0.01,0.848,6322,6282
9,12704,10,100,1e-05,0.01,0.838,6369,6335
9,12804,10,100,1e-05,0.01,0.818,6415,6389
9,12904,10,100,1e-05,0.01,0.836,6471,6433
9,13004,10,100,1e-05,0.01,0.832,6520,6484
9,13104,10,100,1e-05,0.01,0.842,6565,6539
9,13204,10,100,1e-05,0.01,0.842,6610,6594
9,13304,10,100,1e-05,0.01,0.844,6654,6650
9,13404,10,100,1e-05,0.01,0.842,6699,6705
9,13504,10,100,1e-05,0.01,0.838,6748,6756
9,13604,10,100,1e-05,0.01,0.852,6794,6810
9,13704,10,100,1e-05,0.01,0.85,6845,6859
9,13804,10,100,1e-05,0.01,0.856,6898,6906
9,13904,10,100,1e-05,0.01,0.844,6954,6950
9,14004,10,100,1e-05,0.01,0.844,7002,7002
9,14104,10,100,1e-05,0.01,0.844,7051,7053
9,14204,10,100,1e-05,0.01,0.848,7103,7101
9,14304,10,100,1e-05,0.01,0.854,7157,7147
9,14404,10,100,1e-05,0.01,0.868,7207,7197
9,14504,10,100,1e-05,0.01,0.864,7261,7243
9,14604,10,100,1e-05,0.01,0.87,7306,7298
9,14704,10,100,1e-05,0.01,0.852,7354,7350
9,14804,10,100,1e-05,0.01,0.852,7405,7399
9,14904,10,100,1e-05,0.01,0.87,7462,7442
9,15004,10,100,1e-05,0.01,0.882,7512,7492
10,104,10,100,1e-05,0.01,0.482,51,53
10,204,10,100,1e-05,0.01,0.5,102,102
10,304,10,100,1e-05,0.01,0.518,153,151
10,404,10,100,1e-05,0.01,0.526,209,195
10,504,10,100,1e-05,0.01,0.486,257,247
10,604,10,100,1e-05,0.01,0.462,302,302
10,704,10,100,1e-05,0.01,0.486,358,346
10,804,10,100,1e-05,0.01,0.5,411,393
10,904,10,100,1e-05,0.01,0.488,455,449
10,1004,10,100,1e-05,0.01,0.498,503,501
10,1104,10,100,1e-05,0.01,0.52,553,551
10,1204,10,100,1e-05,0.01,0.512,607,597
10,1304,10,100,1e-05,0.01,0.51,657,647
10,1404,10,100,1e-05,0.01,0.512,704,700
10,1504,10,100,1e-05,0.01,0.536,752,752
10,1604,10,100,1e-05,0.01,0.508,805,799
10,1704,10,100,1e-05,0.01,0.534,855,849
10,1804,10,100,1e-05,0.01,0.536,908,896
10,1904,10,100,1e-05,0.01,0.506,959,945
10,2004,10,100,1e-05,0.01,0.504,1006,998
10,2104,10,100,1e-05,0.01,0.518,1051,1053
10,2204,10,100,1e-05,0.01,0.486,1100,1104
10,2304,10,100,1e-05,0.01,0.492,1144,1160
10,2404,10,100,1e-05,0.01,0.494,1198,1206
10,2504,10,100,1e-05,0.01,0.516,1250,1254
10,2604,10,100,1e-05,0.01,0.51,1294,1310
10,2704,10,100,1e-05,0.01,0.514,1351,1353
10,2804,10,100,1e-05,0.01,0.516,1402,1402
10,2904,10,100,1e-05,0.01,0.484,1461,1443
10,3004,10,100,1e-05,0.01,0.482,1507,1497
10,3104,10,100,1e-05,0.01,0.49,1568,1536
10,3204,10,100,1e-05,0.01,0.494,1616,1588
10,3304,10,100,1e-05,0.01,0.504,1664,1640
10,3404,10,100,1e-05,0.01,0.49,1716,1688
10,3504,10,100,1e-05,0.01,0.52,1770,1734
10,3604,10,100,1e-05,0.01,0.488,1826,1778
10,3704,10,100,1e-05,0.01,0.486,1878,1826
10,3804,10,100,1e-05,0.01,0.496,1931,1873
10,3904,10,100,1e-05,0.01,0.462,1982,1922
10,4004,10,100,1e-05,0.01,0.488,2033,1971
10,4104,10,100,1e-05,0.01,0.504,2081,2023
10,4204,10,100,1e-05,0.01,0.484,2127,2077
10,4304,10,100,1e-05,0.01,0.482,2168,2136
10,4404,10,100,1e-05,0.01,0.484,2208,2196
10,4504,10,100,1e-05,0.01,0.488,2260,2244
10,4604,10,100,1e-05,0.01,0.478,2307,2297
10,4704,10,100,1e-05,0.01,0.504,2358,2346
10,4804,10,100,1e-05,0.01,0.514,2410,2394
10,4904,10,100,1e-05,0.01,0.506,2461,2443
10,5004,10,100,1e-05,0.01,0.512,2522,2482
10,5104,10,100,1e-05,0.01,0.552,2568,2536
10,5204,10,100,1e-05,0.01,0.528,2612,2592
10,5304,10,100,1e-05,0.01,0.528,2669,2635
10,5404,10,100,1e-05,0.01,0.532,2721,2683
10,5504,10,100,1e-05,0.01,0.532,2768,2736
10,5604,10,100,1e-05,0.01,0.528,2817,2787
10,5704,10,100,1e-05,0.01,0.522,2867,2837
10,5804,10,100,1e-05,0.01,0.516,2911,2893
10,5904,10,100,1e-05,0.01,0.528,2952,2952
10,6004,10,100,1e-05,0.01,0.554,2995,3009
10,6104,10,100,1e-05,0.01,0.536,3043,3061
10,6204,10,100,1e-05,0.01,0.528,3097,3107
10,6304,10,100,1e-05,0.01,0.54,3144,3160
10,6404,10,100,1e-05,0.01,0.536,3196,3208
10,6504,10,100,1e-05,0.01,0.518,3246,3258
10,6604,10,100,1e-05,0.01,0.57,3280,3324
10,6704,10,100,1e-05,0.01,0.56,3322,3382
10,6804,10,100,1e-05,0.01,0.554,3377,3427
10,6904,10,100,1e-05,0.01,0.552,3427,3477
10,7004,10,100,1e-05,0.01,0.578,3470,3534
10,7104,10,100,1e-05,0.01,0.548,3521,3583
10,7204,10,100,1e-05,0.01,0.552,3562,3642
10,7304,10,100,1e-05,0.01,0.56,3617,3687
10,7404,10,100,1e-05,0.01,0.578,3663,3741
10,7504,10,100,1e-05,0.01,0.57,3714,3790
10,7604,10,100,1e-05,0.01,0.582,3770,3834
10,7704,10,100,1e-05,0.01,0.59,3817,3887
10,7804,10,100,1e-05,0.01,0.576,3867,3937
10,7904,10,100,1e-05,0.01,0.61,3922,3982
10,8004,10,100,1e-05,0.01,0.592,3973,4031
10,8104,10,100,1e-05,0.01,0.6,4023,4081
10,8204,10,100,1e-05,0.01,0.574,4068,4136
10,8304,10,100,1e-05,0.01,0.592,4124,4180
10,8404,10,100,1e-05,0.01,0.6,4168,4236
10,8504,10,100,1e-05,0.01,0.598,4212,4292
10,8604,10,100,1e-05,0.01,0.61,4261,4343
10,8704,10,100,1e-05,0.01,0.616,4302,4402
10,8804,10,100,1e-05,0.01,0.606,4347,4457
10,8904,10,100,1e-05,0.01,0.586,4400,4504
10,9004,10,100,1e-05,0.01,0.58,4445,4559
10,9104,10,100,1e-05,0.01,0.61,4497,4607
10,9204,10,100,1e-05,0.01,0.616,4545,4659
10,9304,10,100,1e-05,0.01,0.592,4595,4709
10,9404,10,100,1e-05,0.01,0.638,4647,4757
10,9504,10,100,1e-05,0.01,0.614,4705,4799
10,9604,10,100,1e-05,0.01,0.604,4747,4857
10,9704,10,100,1e-05,0.01,0.6,4802,4902
10,9804,10,100,1e-05,0.01,0.592,4849,4955
10,9904,10,100,1e-05,0.01,0.608,4900,5004
10,10004,10,100,1e-05,0.01,0.618,4951,5053
10,10104,10,100,1e-05,0.01,0.624,4999,5105
10,10204,10,100,1e-05,0.01,0.642,5053,5151
10,10304,10,100,1e-05,0.01,0.64,5108,5196
10,10404,10,100,1e-05,0.01,0.604,5154,5250
10,10504,10,100,1e-05,0.01,0.636,5208,5296
10,10604,10,100,1e-05,0.01,0.634,5254,5350
10,10704,10,100,1e-05,0.01,0.662,5307,5397
10,10804,10,100,1e-05,0.01,0.672,5352,5452
10,10904,10,100,1e-05,0.01,0.664,5415,5489
10,11004,10,100,1e-05,0.01,0.664,5460,5544
10,11104,10,100,1e-05,0.01,0.674,5515,5589
10,11204,10,100,1e-05,0.01,0.67,5563,5641
10,11304,10,100,1e-05,0.01,0.67,5617,5687
10,11404,10,100,1e-05,0.01,0.69,5667,5737
10,11504,10,100,1e-05,0.01,0.674,5725,5779
10,11604,10,100,1e-05,0.01,0.686,5767,5837
10,11704,10,100,1e-05,0.01,0.686,5822,5882
10,11804,10,100,1e-05,0.01,0.658,5870,5934
10,11904,10,100,1e-05,0.01,0.654,5928,5976
10,12004,10,100,1e-05,0.01,0.672,5977,6027
10,12104,10,100,1e-05,0.01,0.674,6023,6081
10,12204,10,100,1e-05,0.01,0.678,6074,6130
10,12304,10,100,1e-05,0.01,0.69,6123,6181
10,12404,10,100,1e-05,0.01,0.664,6173,6231
10,12504,10,100,1e-05,0.01,0.654,6234,6270
10,12604,10,100,1e-05,0.01,0.694,6281,6323
10,12704,10,100,1e-05,0.01,0.67,6329,6375
10,12804,10,100,1e-05,0.01,0.684,6384,6420
10,12904,10,100,1e-05,0.01,0.702,6433,6471
10,13004,10,100,1e-05,0.01,0.712,6483,6521
10,13104,10,100,1e-05,0.01,0.662,6533,6571
10,13204,10,100,1e-05,0.01,0.672,6585,6619
10,13304,10,100,1e-05,0.01,0.71,6635,6669
10,13404,10,100,1e-05,0.01,0.714,6679,6725
10,13504,10,100,1e-05,0.01,0.756,6729,6775
10,13604,10,100,1e-05,0.01,0.732,6777,6827
10,13704,10,100,1e-05,0.01,0.736,6825,6879
10,13804,10,100,1e-05,0.01,0.742,6869,6935
10,13904,10,100,1e-05,0.01,0.738,6919,6985
10,14004,10,100,1e-05,0.01,0.732,6973,7031
10,14104,10,100,1e-05,0.01,0.748,7021,7083
10,14204,10,100,1e-05,0.01,0.724,7071,7133
10,14304,10,100,1e-05,0.01,0.752,7127,7177
10,14404,10,100,1e-05,0.01,0.758,7185,7219
10,14504,10,100,1e-05,0.01,0.754,7243,7261
10,14604,10,100,1e-05,0.01,0.74,7293,7311
10,14704,10,100,1e-05,0.01,0.752,7336,7368
10,14804,10,100,1e-05,0.01,0.758,7387,7417
10,14904,10,100,1e-05,0.01,0.75,7441,7463
10,15004,10,100,1e-05,0.01,0.774,7492,7512
11,104,10,100,1e-05,0.01,0.49,48,56
11,204,10,100,1e-05,0.01,0.514,98,106
11,304,10,100,1e-05,0.01,0.506,144,160
11,404,10,100,1e-05,0.01,0.512,195,209
11,504,10,100,1e-05,0.01,0.514,256,248
11,604,10,100,1e-05,0.01,0.542,314,290
11,704,10,100,1e-05,0.01,0.54,364,340
11,804,10,100,1e-05,0.01,0.516,422,382
11,904,10,100,1e-05,0.01,0.504,468,436
11,1004,10,100,1e-05,0.01,0.502,516,488
11,1104,10,100,1e-05,0.01,0.526,569,535
11,1204,10,100,1e-05,0.01,0.498,630,574
11,1304,10,100,1e-05,0.01,0.508,683,621
11,1404,10,100,1e-05,0.01,0.546,727,677
11,1504,10,100,1e-05,0.01,0.514,771,733
11,1604,10,100,1e-05,0.01,0.522,819,785
11,1704,10,100,1e-05,0.01,0.532,861,843
11,1804,10,100,1e-05,0.01,0.516,908,896
11,1904,10,100,1e-05,0.01,0.53,954,950
11,2004,10,100,1e-05,0.01,0.566,990,1014
11,2104,10,100,1e-05,0.01,0.56,1032,1072
11,2204,10,100,1e-05,0.01,0.53,1078,1126
11,2304,10,100,1e-05,0.01,0.538,1130,1174
11,2404,10,100,1e-05,0.01,0.532,1173,1231
11,2504,10,100,1e-05,0.01,0.53,1225,1279
11,2604,10,100,1e-05,0.01,0.558,1268,1336
11,2704,10,100,1e-05,0.01,0.56,1324,1380
11,2804,10,100,1e-05,0.01,0.55,1382,1422
11,2904,10,100,1e-05,0.01,0.516,1429,1475
11,3004,10,100,1e-05,0.01,0.542,1475,1529
11,3104,10,100,1e-05,0.01,0.546,1525,1579
11,3204,10,100,1e-05,0.01,0.574,1585,1619
11,3304,10,100,1e-05,0.01,0.574,1633,1671
11,3404,10,100,1e-05,0.01,0.598,1675,1729
11,3504,10,100,1e-05,0.01,0.608,1722,1782
11,3604,10,100,1e-05,0.01,0.64,1768,1836
11,3704,10,100,1e-05,0.01,0.644,1822,1882
11,3804,10,100,1e-05,0.01,0.656,1869,1935
11,3904,10,100,1e-05,0.01,0.682,1917,1987
11,4004,10,100,1e-05,0.01,0.67,1963,2041
11,4104,10,100,1e-05,0.01,0.698,2025,2079
11,4204,10,100,1e-05,0.01,0.684,2068,2136
11,4304,10,100,1e-05,0.01,0.71,2109,2195
11,4404,10,100,1e-05,0.01,0.726,2164,2240
11,4504,10,100,1e-05,0.01,0.674,2216,2288
11,4604,10,100,1e-05,0.01,0.718,2263,2341
11,4704,10,100,1e-05,0.01,0.73,2312,2392
11,4804,10,100,1e-05,0.01,0.746,2363,2441
11,4904,10,100,1e-05,0.01,0.76,2405,2499
11,5004,10,100,1e-05,0.01,0.766,2454,2550
11,5104,10,100,1e-05,0.01,0.752,2504,2600
11,5204,10,100,1e-05,0.01,0.74,2561,2643
11,5304,10,100,1e-05,0.01,0.76,2612,2692
11,5404,10,100,1e-05,0.01,0.792,2665,2739
11,5504,10,100,1e-05,0.01,0.77,2710,2794
11,5604,10,100,1e-05,0.01,0.792,2762,2842
11,5704,10,100,1e-05,0.01,0.786,2810,2894
11,5804,10,100,1e-05,0.01,0.786,2861,2943
11,5904,10,100,1e-05,0.01,0.802,2911,2993
11,6004,10,100,1e-05,0.01,0.8,2957,3047
11,6104,10,100,1e-05,0.01,0.796,3014,3090
11,6204,10,100,1e-05,0.01,0.796,3061,3143
11,6304,10,100,1e-05,0.01,0.802,3121,3183
11,6404,10,100,1e-05,0.01,0.814,3170,3234
11,6504,10,100,1e-05,0.01,0.82,3227,3277
11,6604,10,100,1e-05,0.01,0.816,3282,3322
11,6704,10,100,1e-05,0.01,0.79,3332,3372
11,6804,10,100,1e-05,0.01,0.828,3374,3430
11,6904,10,100,1e-05,0.01,0.842,3415,3489
11,7004,10,100,1e-05,0.01,0.868,3462,3542
11,7104,10,100,1e-05,0.01,0.862,3517,3587
11,7204,10,100,1e-05,0.01,0.85,3573,3631
11,7304,10,100,1e-05,0.01,0.842,3621,3683
11,7404,10,100,1e-05,0.01,0.836,3672,3732
11,7504,10,100,1e-05,0.01,0.848,3722,3782
11,7604,10,100,1e-05,0.01,0.84,3769,3835
11,7704,10,100,1e-05,0.01,0.854,3819,3885
11,7804,10,100,1e-05,0.01,0.858,3869,3935
11,7904,10,100,1e-05,0.01,0.858,3918,3986
11,8004,10,100,1e-05,0.01,0.872,3960,4044
11,8104,10,100,1e-05,0.01,0.858,4009,4095
11,8204,10,100,1e-05,0.01,0.858,4052,4152
11,8304,10,100,1e-05,0.01,0.814,4109,4195
11,8404,10,100,1e-05,0.01,0.87,4160,4244
11,8504,10,100,1e-05,0.01,0.832,4203,4301
11,8604,10,100,1e-05,0.01,0.844,4259,4345
11,8704,10,100,1e-05,0.01,0.85,4320,4384
11,8804,10,100,1e-05,0.01,0.858,4367,4437
11,8904,10,100,1e-05,0.01,0.878,4412,4492
11,9004,10,100,1e-05,0.01,0.88,4455,4549
11,9104,10,100,1e-05,0.01,0.886,4506,4598
11,9204,10,100,1e-05,0.01,0.868,4551,4653
11,9304,10,100,1e-05,0.01,0.878,4602,4702
11,9404,10,100,1e-05,0.01,0.874,4654,4750
11,9504,10,100,1e-05,0.01,0.864,4697,4807
11,9604,10,100,1e-05,0.01,0.878,4746,4858
11,9704,10,100,1e-05,0.01,0.876,4797,4907
11,9804,10,100,1e-05,0.01,0.88,4848,4956
11,9904,10,100,1e-05,0.01,0.862,4904,5000
11,10004,10,100,1e-05,0.01,0.876,4954,5050
11,10104,10,100,1e-05,0.01,0.894,5013,5091
11,10204,10,100,1e-05,0.01,0.892,5062,5142
11,10304,10,100,1e-05,0.01,0.888,5100,5204
11,10404,10,100,1e-05,0.01,0.892,5151,5253
11,10504,10,100,1e-05,0.01,0.884,5207,5297
11,10604,10,100,1e-05,0.01,0.904,5252,5352
11,10704,10,100,1e-05,0.01,0.906,5305,5399
11,10804,10,100,1e-05,0.01,0.908,5363,5441
11,10904,10,100,1e-05,0.01,0.898,5421,5483
11,11004,10,100,1e-05,0.01,0.864,5480,5524
11,11104,10,100,1e-05,0.01,0.86,5533,5571
11,11204,10,100,1e-05,0.01,0.896,5587,5617
11,11304,10,100,1e-05,0.01,0.9,5644,5660
11,11404,10,100,1e-05,0.01,0.91,5698,5706
11,11504,10,100,1e-05,0.01,0.914,5747,5757
11,11604,10,100,1e-05,0.01,0.902,5799,5805
11,11704,10,100,1e-05,0.01,0.912,5856,5848
11,11804,10,100,1e-05,0.01,0.91,5902,5902
11,11904,10,100,1e-05,0.01,0.912,5950,5954
11,12004,10,100,1e-05,0.01,0.908,5994,6010
11,12104,10,100,1e-05,0.01,0.916,6039,6065
11,12204,10,100,1e-05,0.01,0.918,6096,6108
11,12304,10,100,1e-05,0.01,0.914,6151,6153
11,12404,10,100,1e-05,0.01,0.93,6200,6204
11,12504,10,100,1e-05,0.01,0.914,6241,6263
11,12604,10,100,1e-05,0.01,0.922,6292,6312
11,12704,10,100,1e-05,0.01,0.908,6334,6370
11,12804,10,100,1e-05,0.01,0.932,6378,6426
11,12904,10,100,1e-05,0.01,0.924,6424,6480
11,13004,10,100,1e-05,0.01,0.916,6479,6525
11,13104,10,100,1e-05,0.01,0.916,6529,6575
11,13204,10,100,1e-05,0.01,0.918,6580,6624
11,13304,10,100,1e-05,0.01,0.92,6630,6674
11,13404,10,100,1e-05,0.01,0.94,6680,6724
11,13504,10,100,1e-05,0.01,0.924,6736,6768
11,13604,10,100,1e-05,0.01,0.94,6780,6824
11,13704,10,100,1e-05,0.01,0.938,6828,6876
11,13804,10,100,1e-05,0.01,0.932,6878,6926
11,13904,10,100,1e-05,0.01,0.938,6923,6981
11,14004,10,100,1e-05,0.01,0.932,6976,7028
11,14104,10,100,1e-05,0.01,0.932,7026,7078
11,14204,10,100,1e-05,0.01,0.94,7077,7127
11,14304,10,100,1e-05,0.01,0.932,7133,7171
11,14404,10,100,1e-05,0.01,0.94,7181,7223
11,14504,10,100,1e-05,0.01,0.946,7239,7265
11,14604,10,100,1e-05,0.01,0.956,7285,7319
11,14704,10,100,1e-05,0.01,0.944,7343,7361
11,14804,10,100,1e-05,0.01,0.944,7398,7406
11,14904,10,100,1e-05,0.01,0.944,7443,7461
11,15004,10,100,1e-05,0.01,0.934,7499,7505
12,104,10,100,1e-05,0.01,0.524,47,57
12,204,10,100,1e-05,0.01,0.472,102,102
12,304,10,100,1e-05,0.01,0.464,158,146
12,404,10,100,1e-05,0.01,0.482,206,198
12,504,10,100,1e-05,0.01,0.486,257,247
12,604,10,100,1e-05,0.01,0.466,316,288
12,704,10,100,1e-05,0.01,0.482,363,341
12,804,10,100,1e-05,0.01,0.498,403,401
12,904,10,100,1e-05,0.01,0.492,451,453
12,1004,10,100,1e-05,0.01,0.508,499,505
12,1104,10,100,1e-05,0.01,0.522,549,555
12,1204,10,100,1e-05,0.01,0.524,600,604
12,1304,10,100,1e-05,0.01,0.506,646,658
12,1404,10,100,1e-05,0.01,0.536,696,708
12,1504,10,100,1e-05,0.01,0.504,755,749
12,1604,10,100,1e-05,0.01,0.48,806,798
12,1704,10,100,1e-05,0.01,0.496,849,855
12,1804,10,100,1e-05,0.01,0.484,901,903
12,1904,10,100,1e-05,0.01,0.516,946,958
12,2004,10,100,1e-05,0.01,0.51,990,1014
12,2104,10,100,1e-05,0.01,0.534,1038,1066
12,2204,10,100,1e-05,0.01,0.524,1081,1123
12,2304,10,100,1e-05,0.01,0.53,1129,1175
12,2404,10,100,1e-05,0.01,0.542,1178,1226
12,2504,10,100,1e-05,0.01,0.552,1234,1270
12,2604,10,100,1e-05,0.01,0.506,1291,1313
12,2704,10,100,1e-05,0.01,0.576,1341,1363
12,2804,10,100,1e-05,0.01,0.54,1391,1413
12,2904,10,100,1e-05,0.01,0.554,1446,1458
12,3004,10,100,1e-05,0.01,0.55,1501,1503
12,3104,10,100,1e-05,0.01,0.554,1542,1562
12,3204,10,100,1e-05,0.01,0.542,1593,1611
12,3304,10,100,1e-05,0.01,0.568,1653,1651
12,3404,10,100,1e-05,0.01,0.552,1710,1694
12,3504,10,100,1e-05,0.01,0.546,1765,1739
12,3604,10,100,1e-05,0.01,0.528,1808,1796
12,3704,10,100,1e-05,0.01,0.562,1856,1848
12,3804,10,100,1e-05,0.01,0.55,1899,1905
12,3904,10,100,1e-05,0.01,0.562,1939,1965
12,4004,10,100,1e-05,0.01,0.558,1990,2014
12,4104,10,100,1e-05,0.01,0.542,2032,2072
12,4204,10,100,1e-05,0.01,0.586,2078,2126
12,4304,10,100,1e-05,0.01,0.558,2129,2175
12,4404,10,100,1e-05,0.01,0.584,2179,2225
12,4504,10,100,1e-05,0.01,0.594,2227,2277
12,4604,10,100,1e-05,0.01,0.608,2270,2334
12,4704,10,100,1e-05,0.01,0.58,2328,2376
12,4804,10,100,1e-05,0.01,0.612,2374,2430
12,4904,10,100,1e-05,0.01,0.622,2422,2482
12,5004,10,100,1e-05,0.01,0.596,2477,2527
12,5104,10,100,1e-05,0.01,0.588,2529,2575
12,5204,10,100,1e-05,0.01,0.596,2589,2615
12,5304,10,100,1e-05,0.01,0.624,2640,2664
12,5404,10,100,1e-05,0.01,0.616,2697,2707
12,5504,10,100,1e-05,0.01,0.67,2742,2762
12,5604,10,100,1e-05,0.01,0.628,2797,2807
12,5704,10,100,1e-05,0.01,0.642,2842,2862
12,5804,10,100,1e-05,0.01,0.622,2889,2915
12,5904,10,100,1e-05,0.01,0.626,2943,2961
12,6004,10,100,1e-05,0.01,0.682,2998,3006
12,6104,10,100,1e-05,0.01,0.666,3046,3058
12,6204,10,100,1e-05,0.01,0.676,3092,3112
12,6304,10,100,1e-05,0.01,0.664,3145,3159
12,6404,10,100,1e-05,0.01,0.682,3193,3211
12,6504,10,100,1e-05,0.01,0.686,3239,3265
12,6604,10,100,1e-05,0.01,0.686,3297,3307
12,6704,10,100,1e-05,0.01,0.666,3349,3355
12,6804,10,100,1e-05,0.01,0.676,3394,3410
12,6904,10,100,1e-05,0.01,0.674,3451,3453
12,7004,10,100,1e-05,0.01,0.666,3496,3508
12,7104,10,100,1e-05,0.01,0.696,3544,3560
12,7204,10,100,1e-05,0.01,0.664,3588,3616
12,7304,10,100,1e-05,0.01,0.676,3644,3660
12,7404,10,100,1e-05,0.01,0.666,3694,3710
12,7504,10,100,1e-05,0.01,0.67,3750,3754
12,7604,10,100,1e-05,0.01,0.7,3800,3804
12,7704,10,100,1e-05,0.01,0.682,3850,3854
12,7804,10,100,1e-05,0.01,0.702,3904,3900
12,7904,10,100,1e-05,0.01,0.714,3952,3952
12,8004,10,100,1e-05,0.01,0.692,4009,3995
12,8104,10,100,1e-05,0.01,0.69,4067,4037
12,8204,10,100,1e-05,0.01,0.702,4116,4088
12,8304,10,100,1e-05,0.01,0.72,4165,4139
12,8404,10,100,1e-05,0.01,0.7,4211,4193
12,8504,10,100,1e-05,0.01,0.724,4256,4248
12,8604,10,100,1e-05,0.01,0.728,4303,4301
12,8704,10,100,1e-05,0.01,0.722,4353,4351
12,8804,10,100,1e-05,0.01,0.724,4396,4408
12,8904,10,100,1e-05,0.01,0.728,4448,4456
12,9004,10,100,1e-05,0.01,0.736,4495,4509
12,9104,10,100,1e-05,0.01,0.75,4539,4565
12,9204,10,100,1e-05,0.01,0.738,4586,4618
12,9304,10,100,1e-05,0.01,0.72,4642,4662
12,9404,10,100,1e-05,0.01,0.758,4692,4712
12,9504,10,100,1e-05,0.01,0.774,4743,4761
12,9604,10,100,1e-05,0.01,0.752,4803,4801
12,9704,10,100,1e-05,0.01,0.766,4853,4851
12,9804,10,100,1e-05,0.01,0.758,4909,4895
12,9904,10,100,1e-05,0.01,0.748,4966,4938
12,10004,10,100,1e-05,0.01,0.762,5014,4990
12,10104,10,100,1e-05,0.01,0.756,5062,5042
12,10204,10,100,1e-05,0.01,0.78,5120,5084
12,10304,10,100,1e-05,0.01,0.758,5173,5131
12,10404,10,100,1e-05,0.01,0.786,5210,5194
12,10504,10,100,1e-05,0.01,0.758,5255,5249
12,10604,10,100,1e-05,0.01,0.782,5306,5298
12,10704,10,100,1e-05,0.01,0.776,5357,5347
12,10804,10,100,1e-05,0.01,0.804,5409,5395
12,10904,10,100,1e-05,0.01,0.786,5459,5445
12,11004,10,100,1e-05,0.01,0.78,5507,5497
12,11104,10,100,1e-05,0.01,0.8,5555,5549
12,11204,10,100,1e-05,0.01,0.804,5603,5601
12,11304,10,100,1e-05,0.01,0.734,5652,5652
12,11404,10,100,1e-05,0.01,0.762,5700,5704
12,11504,10,100,1e-05,0.01,0.756,5740,5764
12,11604,10,100,1e-05,0.01,0.774,5792,5812
12,11704,10,100,1e-05,0.01,0.82,5846,5858
12,11804,10,100,1e-05,0.01,0.822,5901,5903
12,11904,10,100,1e-05,0.01,0.8,5953,5951
12,12004,10,100,1e-05,0.01,0.822,6005,5999
12,12104,10,100,1e-05,0.01,0.806,6052,6052
12,12204,10,100,1e-05,0.01,0.85,6100,6104
12,12304,10,100,1e-05,0.01,0.844,6155,6149
12,12404,10,100,1e-05,0.01,0.838,6206,6198
12,12504,10,100,1e-05,0.01,0.84,6260,6244
12,12604,10,100,1e-05,0.01,0.876,6318,6286
12,12704,10,100,1e-05,0.01,0.872,6371,6333
12,12804,10,100,1e-05,0.01,0.88,6419,6385
12,12904,10,100,1e-05,0.01,0.872,6467,6437
12,13004,10,100,1e-05,0.01,0.87,6510,6494
12,13104,10,100,1e-05,0.01,0.882,6558,6546
12,13204,10,100,1e-05,0.01,0.896,6606,6598
12,13304,10,100,1e-05,0.01,0.904,6657,6647
12,13404,10,100,1e-05,0.01,0.868,6717,6687
12,13504,10,100,1e-05,0.01,0.886,6768,6736
12,13604,10,100,1e-05,0.01,0.912,6828,6776
12,13704,10,100,1e-05,0.01,0.924,6876,6828
12,13804,10,100,1e-05,0.01,0.922,6931,6873
12,13904,10,100,1e-05,0.01,0.912,6977,6927
12,14004,10,100,1e-05,0.01,0.924,7030,6974
12,14104,10,100,1e-05,0.01,0.918,7075,7029
12,14204,10,100,1e-05,0.01,0.916,7130,7074
12,14304,10,100,1e-05,0.01,0.894,7179,7125
12,14404,10,100,1e-05,0.01,0.916,7225,7179
12,14504,10,100,1e-05,0.01,0.882,7278,7226
12,14604,10,100,1e-05,0.01,0.928,7328,7276
12,14704,10,100,1e-05,0.01,0.912,7373,7331
12,14804,10,100,1e-05,0.01,0.942,7415,7389
12,14904,10,100,1e-05,0.01,0.936,7461,7443
12,15004,10,100,1e-05,0.01,0.944,7514,7490
13,104,10,100,1e-05,0.01,0.5,44,60
13,204,10,100,1e-05,0.01,0.512,92,112
13,304,10,100,1e-05,0.01,0.502,143,161
13,404,10,100,1e-05,0.01,0.516,199,205
13,504,10,100,1e-05,0.01,0.504,246,258
13,604,10,100,1e-05,0.01,0.536,305,299
13,704,10,100,1e-05,0.01,0.542,348,356
13,804,10,100,1e-05,0.01,0.538,391,413
13,904,10,100,1e-05,0.01,0.512,447,457
13,1004,10,100,1e-05,0.01,0.504,500,504
13,1104,10,100,1e-05,0.01,0.5,542,562
13,1204,10,100,1e-05,0.01,0.538,597,607
13,1304,10,100,1e-05,0.01,0.524,638,666
13,1404,10,100,1e-05,0.01,0.496,690,714
13,1504,10,100,1e-05,0.01,0.518,739,765
13,1604,10,100,1e-05,0.01,0.486,794,810
13,1704,10,100,1e-05,0.01,0.488,842,862
13,1804,10,100,1e-05,0.01,0.528,901,903
13,1904,10,100,1e-05,0.01,0.492,952,952
13,2004,10,100,1e-05,0.01,0.53,996,1008
13,2104,10,100,1e-05,0.01,0.55,1048,1056
13,2204,10,100,1e-05,0.01,0.514,1097,1107
13,2304,10,100,1e-05,0.01,0.508,1146,1158
13,2404,10,100,1e-05,0.01,0.524,1191,1213
13,2504,10,100,1e-05,0.01,0.536,1239,1265
13,2604,10,100,1e-05,0.01,0.518,1292,1312
13,2704,10,100,1e-05,0.01,0.508,1339,1365
13,2804,10,100,1e-05,0.01,0.526,1392,1412
13,2904,10,100,1e-05,0.01,0.502,1437,1467
13,3004,10,100,1e-05,0.01,0.498,1485,1519
13,3104,10,100,1e-05,0.01,0.512,1533,1571
13,3204,10,100,1e-05,0.01,0.496,1580,1624
13,3304,10,100,1e-05,0.01,0.522,1631,1673
13,3404,10,100,1e-05,0.01,0.498,1690,1714
13,3504,10,100,1e-05,0.01,0.512,1741,1763
13,3604,10,100,1e-05,0.01,0.526,1783,1821
13,3704,10,100,1e-05,0.01,0.498,1841,1863
13,3804,10,100,1e-05,0.01,0.502,1888,1916
13,3904,10,100,1e-05,0.01,0.484,1937,1967
13,4004,10,100,1e-05,0.01,0.49,1992,2012
13,4104,10,100,1e-05,0.01,0.51,2045,2059
13,4204,10,100,1e-05,0.01,0.5,2095,2109
13,4304,10,100,1e-05,0.01,0.512,2141,2163
13,4404,10,100,1e-05,0.01,0.51,2190,2214
13,4504,10,100,1e-05,0.01,0.514,2238,2266
13,4604,10,100,1e-05,0.01,0.498,2287,2317
13,4704,10,100,1e-05,0.01,0.514,2332,2372
13,4804,10,100,1e-05,0.01,0.54,2385,2419
13,4904,10,100,1e-05,0.01,0.542,2442,2462
13,5004,10,100,1e-05,0.01,0.52,2491,2513
13,5104,10,100,1e-05,0.01,0.518,2541,2563
13,5204,10,100,1e-05,0.01,0.526,2583,2621
13,5304,10,100,1e-05,0.01,0.544,2629,2675
13,5404,10,100,1e-05,0.01,0.538,2671,2733
13,5504,10,100,1e-05,0.01,0.558,2719,2785
13,5604,10,100,1e-05,0.01,0.552,2757,2847
13,5704,10,100,1e-05,0.01,0.576,2812,2892
13,5804,10,100,1e-05,0.01,0.596,2861,2943
13,5904,10,100,1e-05,0.01,0.62,2912,2992
13,6004,10,100,1e-05,0.01,0.594,2964,3040
13,6104,10,100,1e-05,0.01,0.604,3006,3098
13,6204,10,100,1e-05,0.01,0.608,3052,3152
13,6304,10,100,1e-05,0.01,0.592,3097,3207
13,6404,10,100,1e-05,0.01,0.618,3146,3258
13,6504,10,100,1e-05,0.01,0.602,3190,3314
13,6604,10,100,1e-05,0.01,0.634,3239,3365
13,6704,10,100,1e-05,0.01,0.63,3282,3422
13,6804,10,100,1e-05,0.01,0.622,3330,3474
13,6904,10,100,1e-05,0.01,0.614,3381,3523
13,7004,10,100,1e-05,0.01,0.648,3431,3573
13,7104,10,100,1e-05,0.01,0.628,3485,3619
13,7204,10,100,1e-05,0.01,0.648,3542,3662
13,7304,10,100,1e-05,0.01,0.614,3587,3717
13,7404,10,100,1e-05,0.01,0.666,3642,3762
13,7504,10,100,1e-05,0.01,0.654,3692,3812
13,7604,10,100,1e-05,0.01,0.67,3736,3868
13,7704,10,100,1e-05,0.01,0.646,3791,3913
13,7804,10,100,1e-05,0.01,0.68,3843,3961
13,7904,10,100,1e-05,0.01,0.66,3897,4007
13,8004,10,100,1e-05,0.01,0.66,3945,4059
13,8104,10,100,1e-05,0.01,0.67,3990,4114
13,8204,10,100,1e-05,0.01,0.676,4052,4152
13,8304,10,100,1e-05,0.01,0.704,4098,4206
13,8404,10,100,1e-05,0.01,0.66,4151,4253
13,8504,10,100,1e-05,0.01,0.712,4201,4303
13,8604,10,100,1e-05,0.01,0.694,4254,4350
13,8704,10,100,1e-05,0.01,0.686,4303,4401
13,8804,10,100,1e-05,0.01,0.71,4358,4446
13,8904,10,100,1e-05,0.01,0.696,4409,4495
13,9004,10,100,1e-05,0.01,0.712,4463,4541
13,9104,10,100,1e-05,0.01,0.69,4509,4595
13,9204,10,100,1e-05,0.01,0.716,4561,4643
13,9304,10,100,1e-05,0.01,0.734,4609,4695
13,9404,10,100,1e-05,0.01,0.698,4652,4752
13,9504,10,100,1e-05,0.01,0.716,4701,4803
13,9604,10,100,1e-05,0.01,0.734,4751,4853
13,9704,10,100,1e-05,0.01,0.716,4807,4897
13,9804,10,100,1e-05,0.01,0.728,4847,4957
13,9904,10,100,1e-05,0.01,0.714,4899,5005
13,10004,10,100,1e-05,0.01,0.724,4944,5060
13,10104,10,100,1e-05,0.01,0.714,4995,5109
13,10204,10,100,1e-05,0.01,0.718,5050,5154
13,10304,10,100,1e-05,0.01,0.728,5098,5206
13,10404,10,100,1e-05,0.01,0.716,5152,5252
13,10504,10,100,1e-05,0.01,0.708,5207,5297
13,10604,10,100,1e-05,0.01,0.71,5259,5345
13,10704,10,100,1e-05,0.01,0.722,5308,5396
13,10804,10,100,1e-05,0.01,0.736,5362,5442
13,10904,10,100,1e-05,0.01,0.726,5409,5495
13,11004,10,100,1e-05,0.01,0.736,5472,5532
13,11104,10,100,1e-05,0.01,0.74,5524,5580
13,11204,10,100,1e-05,0.01,0.746,5564,5640
13,11304,10,100,1e-05,0.01,0.74,5620,5684
13,11404,10,100,1e-05,0.01,0.74,5679,5725
13,11504,10,100,1e-05,0.01,0.76,5733,5771
13,11604,10,100,1e-05,0.01,0.732,5785,5819
13,11704,10,100,1e-05,0.01,0.776,5841,5863
13,11804,10,100,1e-05,0.01,0.752,5885,5919
13,11904,10,100,1e-05,0.01,0.744,5932,5972
13,12004,10,100,1e-05,0.01,0.762,5984,6020
13,12104,10,100,1e-05,0.01,0.762,6036,6068
13,12204,10,100,1e-05,0.01,0.78,6085,6119
13,12304,10,100,1e-05,0.01,0.76,6129,6175
13,12404,10,100,1e-05,0.01,0.766,6187,6217
13,12504,10,100,1e-05,0.01,0.76,6241,6263
13,12604,10,100,1e-05,0.01,0.79,6285,6319
13,12704,10,100,1e-05,0.01,0.794,6336,6368
13,12804,10,100,1e-05,0.01,0.784,6374,6430
13,12904,10,100,1e-05,0.01,0.78,6426,6478
13,13004,10,100,1e-05,0.01,0.8,6470,6534
13,13104,10,100,1e-05,0.01,0.8,6521,6583
13,13204,10,100,1e-05,0.01,0.81,6581,6623
13,13304,10,100,1e-05,0.01,0.814,6624,6680
13,13404,10,100,1e-05,0.01,0.814,6676,6728
13,13504,10,100,1e-05,0.01,0.816,6732,6772
13,13604,10,100,1e-05,0.01,0.822,6786,6818
13,13704,10,100,1e-05,0.01,0.828,6836,6868
13,13804,10,100,1e-05,0.01,0.838,6890,6914
13,13904,10,100,1e-05,0.01,0.846,6945,6959
13,14004,10,100,1e-05,0.01,0.836,6998,7006
13,14104,10,100,1e-05,0.01,0.838,7047,7057
13,14204,10,100,1e-05,0.01,0.854,7096,7108
13,14304,10,100,1e-05,0.01,0.836,7142,7162
13,14404,10,100,1e-05,0.01,0.844,7199,7205
13,14504,10,100,1e-05,0.01,0.85,7248,7256
13,14604,10,100,1e-05,0.01,0.838,7302,7302
13,14704,10,100,1e-05,0.01,0.862,7342,7362
13,14804,10,100,1e-05,0.01,0.85,7392,7412
13,14904,10,100,1e-05,0.01,0.856,7446,7458
13,15004,10,100,1e-05,0.01,0.846,7501,7503
14,104,10,100,1e-05,0.01,0.528,55,49
14,204,10,100,1e-05,0.01,0.482,103,101
14,304,10,100,1e-05,0.01,0.472,151,153
14,404,10,100,1e-05,0.01,0.504,206,198
14,504,10,100,1e-05,0.01,0.488,251,253
14,604,10,100,1e-05,0.01,0.51,305,299
14,704,10,100,1e-05,0.01,0.532,362,342
14,804,10,100,1e-05,0.01,0.524,412,392
14,904,10,100,1e-05,0.01,0.528,460,444
14,1004,10,100,1e-05,0.01,0.55,505,499
14,1104,10,100,1e-05,0.01,0.55,551,553
14,1204,10,100,1e-05,0.01,0.544,608,596
14,1304,10,100,1e-05,0.01,0.54,658,646
14,1404,10,100,1e-05,0.01,0.55,707,697
14,1504,10,100,1e-05,0.01,0.554,753,751
14,1604,10,100,1e-05,0.01,0.542,806,798
14,1704,10,100,1e-05,0.01,0.55,866,838
14,1804,10,100,1e-05,0.01,0.556,920,884
14,1904,10,100,1e-05,0.01,0.534,970,934
14,2004,10,100,1e-05,0.01,0.554,1026,978
14,2104,10,100,1e-05,0.01,0.564,1075,1029
14,2204,10,100,1e-05,0.01,0.57,1136,1068
14,2304,10,100,1e-05,0.01,0.542,1186,1118
14,2404,10,100,1e-05,0.01,0.576,1229,1175
14,2504,10,100,1e-05,0.01,0.578,1272,1232
14,2604,10,100,1e-05,0.01,0.6,1324,1280
14,2704,10,100,1e-05,0.01,0.606,1376,1328
14,2804,10,100,1e-05,0.01,0.588,1425,1379
14,2904,10,100,1e-05,0.01,0.6,1477,1427
14,3004,10,100,1e-05,0.01,0.612,1531,1473
14,3104,10,100,1e-05,0.01,0.642,1579,1525
14,3204,10,100,1e-05,0.01,0.668,1630,1574
14,3304,10,100,1e-05,0.01,0.678,1673,1631
14,3404,10,100,1e-05,0.01,0.712,1728,1676
14,3504,10,100,1e-05,0.01,0.706,1776,1728
14,3604,10,100,1e-05,0.01,0.692,1826,1778
14,3704,10,100,1e-05,0.01,0.692,1879,1825
14,3804,10,100,1e-05,0.01,0.672,1932,1872
14,3904,10,100,1e-05,0.01,0.724,1982,1922
14,4004,10,100,1e-05,0.01,0.72,2031,1973
14,4104,10,100,1e-05,0.01,0.716,2075,2029
14,4204,10,100,1e-05,0.01,0.708,2122,2082
14,4304,10,100,1e-05,0.01,0.728,2172,2132
14,4404,10,100,1e-05,0.01,0.722,2223,2181
14,4504,10,100,1e-05,0.01,0.716,2268,2236
14,4604,10,100,1e-05,0.01,0.738,2317,2287
14,4704,10,100,1e-05,0.01,0.726,2366,2338
14,4804,10,100,1e-05,0.01,0.732,2420,2384
14,4904,10,100,1e-05,0.01,0.742,2468,2436
14,5004,10,100,1e-05,0.01,0.778,2519,2485
14,5104,10,100,1e-05,0.01,0.762,2574,2530
14,5204,10,100,1e-05,0.01,0.716,2624,2580
14,5304,10,100,1e-05,0.01,0.774,2677,2627
14,5404,10,100,1e-05,0.01,0.756,2724,2680
14,5504,10,100,1e-05,0.01,0.74,2771,2733
14,5604,10,100,1e-05,0.01,0.792,2826,2778
14,5704,10,100,1e-05,0.01,0.79,2875,2829
14,5804,10,100,1e-05,0.01,0.818,2928,2876
14,5904,10,100,1e-05,0.01,0.808,2971,2933
14,6004,10,100,1e-05,0.01,0.818,3011,2993
14,6104,10,100,1e-05,0.01,0.82,3063,3041
14,6204,10,100,1e-05,0.01,0.82,3107,3097
14,6304,10,100,1e-05,0.01,0.808,3157,3147
14,6404,10,100,1e-05,0.01,0.81,3202,3202
14,6504,10,100,1e-05,0.01,0.786,3248,3256
14,6604,10,100,1e-05,0.01,0.822,3305,3299
14,6704,10,100,1e-05,0.01,0.842,3357,3347
14,6804,10,100,1e-05,0.01,0.812,3404,3400
14,6904,10,100,1e-05,0.01,0.822,3452,3452
14,7004,10,100,1e-05,0.01,0.82,3502,3502
14,7104,10,100,1e-05,0.01,0.784,3547,3557
14,7204,10,100,1e-05,0.01,0.802,3599,3605
14,7304,10,100,1e-05,0.01,0.818,3654,3650
14,7404,10,100,1e-05,0.01,0.808,3707,3697
14,7504,10,100,1e-05,0.01,0.834,3752,3752
14,7604,10,100,1e-05,0.01,0.804,3806,3798
14,7704,10,100,1e-05,0.01,0.784,3852,3852
14,7804,10,100,1e-05,0.01,0.836,3903,3901
14,7904,10,100,1e-05,0.01,0.85,3945,3959
14,8004,10,100,1e-05,0.01,0.852,3994,4010
14,8104,10,100,1e-05,0.01,0.856,4041,4063
14,8204,10,100,1e-05,0.01,0.848,4093,4111
14,8304,10,100,1e-05,0.01,0.838,4137,4167
14,8404,10,100,1e-05,0.01,0.856,4186,4218
14,8504,10,100,1e-05,0.01,0.848,4230,4274
14,8604,10,100,1e-05,0.01,0.862,4276,4328
14,8704,10,100,1e-05,0.01,0.864,4327,4377
14,8804,10,100,1e-05,0.01,0.858,4374,4430
14,8904,10,100,1e-05,0.01,0.864,4421,4483
14,9004,10,100,1e-05,0.01,0.882,4473,4531
14,9104,10,100,1e-05,0.01,0.862,4527,4577
14,9204,10,100,1e-05,0.01,0.874,4571,4633
14,9304,10,100,1e-05,0.01,0.848,4619,4685
14,9404,10,100,1e-05,0.01,0.85,4657,4747
14,9504,10,100,1e-05,0.01,0.868,4705,4799
14,9604,10,100,1e-05,0.01,0.854,4751,4853
14,9704,10,100,1e-05,0.01,0.864,4794,4910
14,9804,10,100,1e-05,0.01,0.866,4855,4949
14,9904,10,100,1e-05,0.01,0.874,4912,4992
14,10004,10,100,1e-05,0.01,0.866,4969,5035
14,10104,10,100,1e-05,0.01,0.894,5015,5089
14,10204,10,100,1e-05,0.01,0.876,5059,5145
14,10304,10,100,1e-05,0.01,0.89,5109,5195
14,10404,10,100,1e-05,0.01,0.886,5161,5243
14,10504,10,100,1e-05,0.01,0.862,5214,5290
14,10604,10,100,1e-05,0.01,0.906,5264,5340
14,10704,10,100,1e-05,0.01,0.904,5314,5390
14,10804,10,100,1e-05,0.01,0.882,5365,5439
14,10904,10,100,1e-05,0.01,0.892,5415,5489
14,11004,10,100,1e-05,0.01,0.904,5471,5533
14,11104,10,100,1e-05,0.01,0.902,5518,5586
14,11204,10,100,1e-05,0.01,0.884,5574,5630
14,11304,10,100,1e-05,0.01,0.912,5624,5680
14,11404,10,100,1e-05,0.01,0.906,5676,5728
14,11504,10,100,1e-05,0.01,0.912,5720,5784
14,11604,10,100,1e-05,0.01,0.898,5777,5827
14,11704,10,100,1e-05,0.01,0.9,5834,5870
14,11804,10,100,1e-05,0.01,0.912,5888,5916
14,11904,10,100,1e-05,0.01,0.922,5935,5969
14,12004,10,100,1e-05,0.01,0.912,5981,6023
14,12104,10,100,1e-05,0.01,0.906,6029,6075
14,12204,10,100,1e-05,0.01,0.916,6077,6127
14,12304,10,100,1e-05,0.01,0.918,6129,6175
14,12404,10,100,1e-05,0.01,0.922,6179,6225
14,12504,10,100,1e-05,0.01,0.926,6223,6281
14,12604,10,100,1e-05,0.01,0.916,6277,6327
14,12704,10,100,1e-05,0.01,0.948,6326,6378
14,12804,10,100,1e-05,0.01,0.926,6379,6425
14,12904,10,100,1e-05,0.01,0.918,6430,6474
14,13004,10,100,1e-05,0.01,0.93,6485,6519
14,13104,10,100,1e-05,0.01,0.934,6546,6558
14,13204,10,100,1e-05,0.01,0.924,6593,6611
14,13304,10,100,1e-05,0.01,0.938,6647,6657
14,13404,10,100,1e-05,0.01,0.94,6701,6703
14,13504,10,100,1e-05,0.01,0.956,6758,6746
14,13604,10,100,1e-05,0.01,0.936,6805,6799
14,13704,10,100,1e-05,0.01,0.946,6858,6846
14,13804,10,100,1e-05,0.01,0.934,6912,6892
14,13904,10,100,1e-05,0.01,0.946,6956,6948
14,14004,10,100,1e-05,0.01,0.946,6995,7009
14,14104,10,100,1e-05,0.01,0.944,7049,7055
14,14204,10,100,1e-05,0.01,0.936,7090,7114
14,14304,10,100,1e-05,0.01,0.954,7141,7163
14,14404,10,100,1e-05,0.01,0.948,7192,7212
14,14504,10,100,1e-05,0.01,0.95,7244,7260
14,14604,10,100,1e-05,0.01,0.964,7296,7308
14,14704,10,100,1e-05,0.01,0.964,7344,7360
14,14804,10,100,1e-05,0.01,0.962,7399,7405
14,14904,10,100,1e-05,0.01,0.956,7443,7461
14,15004,10,100,1e-05,0.01,0.954,7489,7515
15,104,10,100,1e-05,0.01,0.498,49,55
15,204,10,100,1e-05,0.01,0.506,109,95
15,304,10,100,1e-05,0.01,0.508,166,138
15,404,10,100,1e-05,0.01,0.52,213,191
15,504,10,100,1e-05,0.01,0.52,255,249
15,604,10,100,1e-05,0.01,0.482,303,301
15,704,10,100,1e-05,0.01,0.516,349,355
15,804,10,100,1e-05,0.01,0.506,394,410
15,904,10,100,1e-05,0.01,0.518,442,462
15,1004,10,100,1e-05,0.01,0.53,489,515
15,1104,10,100,1e-05,0.01,0.52,538,566
15,1204,10,100,1e-05,0.01,0.508,584,620
15,1304,10,100,1e-05,0.01,0.516,629,675
15,1404,10,100,1e-05,0.01,0.518,685,719
15,1504,10,100,1e-05,0.01,0.534,737,767
15,1604,10,100,1e-05,0.01,0.544,781,823
15,1704,10,100,1e-05,0.01,0.536,832,872
15,1804,10,100,1e-05,0.01,0.534,881,923
15,1904,10,100,1e-05,0.01,0.54,938,966
15,2004,10,100,1e-05,0.01,0.542,985,1019
15,2104,10,100,1e-05,0.01,0.554,1032,1072
15,2204,10,100,1e-05,0.01,0.58,1079,1125
15,2304,10,100,1e-05,0.01,0.578,1138,1166
15,2404,10,100,1e-05,0.01,0.612,1194,1210
15,2504,10,100,1e-05,0.01,0.626,1238,1266
15,2604,10,100,1e-05,0.01,0.65,1282,1322
15,2704,10,100,1e-05,0.01,0.636,1328,1376
15,2804,10,100,1e-05,0.01,0.664,1387,1417
15,2904,10,100,1e-05,0.01,0.67,1445,1459
15,3004,10,100,1e-05,0.01,0.696,1489,1515
15,3104,10,100,1e-05,0.01,0.744,1539,1565
15,3204,10,100,1e-05,0.01,0.748,1589,1615
15,3304,10,100,1e-05,0.01,0.758,1645,1659
15,3404,10,100,1e-05,0.01,0.764,1694,1710
15,3504,10,100,1e-05,0.01,0.764,1741,1763
15,3604,10,100,1e-05,0.01,0.76,1797,1807
15,3704,10,100,1e-05,0.01,0.772,1842,1862
15,3804,10,100,1e-05,0.01,0.804,1895,1909
15,3904,10,100,1e-05,0.01,0.808,1945,1959
15,4004,10,100,1e-05,0.01,0.84,1988,2016
15,4104,10,100,1e-05,0.01,0.858,2035,2069
15,4204,10,100,1e-05,0.01,0.834,2080,2124
15,4304,10,100,1e-05,0.01,0.826,2131,2173
15,4404,10,100,1e-05,0.01,0.844,2177,2227
15,4504,10,100,1e-05,0.01,0.85,2223,2281
15,4604,10,100,1e-05,0.01,0.864,2266,2338
15,4704,10,100,1e-05,0.01,0.878,2312,2392
15,4804,10,100,1e-05,0.01,0.88,2363,2441
15,4904,10,100,1e-05,0.01,0.884,2411,2493
15,5004,10,100,1e-05,0.01,0.89,2459,2545
15,5104,10,100,1e-05,0.01,0.898,2514,2590
15,5204,10,100,1e-05,0.01,0.898,2566,2638
15,5304,10,100,1e-05,0.01,0.908,2616,2688
15,5404,10,100,1e-05,0.01,0.906,2664,2740
15,5504,10,100,1e-05,0.01,0.908,2702,2802
15,5604,10,100,1e-05,0.01,0.924,2760,2844
15,5704,10,100,1e-05,0.01,0.914,2814,2890
15,5804,10,100,1e-05,0.01,0.928,2863,2941
15,5904,10,100,1e-05,0.01,0.908,2914,2990
15,6004,10,100,1e-05,0.01,0.912,2967,3037
15,6104,10,100,1e-05,0.01,0.916,3018,3086
15,6204,10,100,1e-05,0.01,0.908,3067,3137
15,6304,10,100,1e-05,0.01,0.936,3113,3191
15,6404,10,100,1e-05,0.01,0.928,3159,3245
15,6504,10,100,1e-05,0.01,0.932,3204,3300
15,6604,10,100,1e-05,0.01,0.94,3252,3352
15,6704,10,100,1e-05,0.01,0.94,3304,3400
15,6804,10,100,1e-05,0.01,0.934,3354,3450
15,6904,10,100,1e-05,0.01,0.936,3409,3495
15,7004,10,100,1e-05,0.01,0.932,3457,3547
15,7104,10,100,1e-05,0.01,0.938,3510,3594
15,7204,10,100,1e-05,0.01,0.938,3565,3639
15,7304,10,100,1e-05,0.01,0.934,3609,3695
15,7404,10,100,1e-05,0.01,0.944,3661,3743
15,7504,10,100,1e-05,0.01,0.936,3710,3794
15,7604,10,100,1e-05,0.01,0.948,3762,3842
15,7704,10,100,1e-05,0.01,0.944,3805,3899
15,7804,10,100,1e-05,0.01,0.95,3855,3949
15,7904,10,100,1e-05,0.01,0.936,3908,3996
15,8004,10,100,1e-05,0.01,0.946,3955,4049
15,8104,10,100,1e-05,0.01,0.924,4008,4096
15,8204,10,100,1e-05,0.01,0.94,4060,4144
15,8304,10,100,1e-05,0.01,0.944,4114,4190
15,8404,10,100,1e-05,0.01,0.952,4162,4242
15,8504,10,100,1e-05,0.01,0.96,4214,4290
15,8604,10,100,1e-05,0.01,0.956,4268,4336
15,8704,10,100,1e-05,0.01,0.962,4323,4381
15,8804,10,100,1e-05,0.01,0.954,4378,4426
15,8904,10,100,1e-05,0.01,0.944,4422,4482
15,9004,10,100,1e-05,0.01,0.96,4476,4528
15,9104,10,100,1e-05,0.01,0.96,4525,4579
15,9204,10,100,1e-05,0.01,0.962,4569,4635
15,9304,10,100,1e-05,0.01,0.968,4612,4692
15,9404,10,100,1e-05,0.01,0.976,4665,4739
15,9504,10,100,1e-05,0.01,0.964,4713,4791
15,9604,10,100,1e-05,0.01,0.964,4759,4845
15,9704,10,100,1e-05,0.01,0.96,4810,4894
15,9804,10,100,1e-05,0.01,0.964,4866,4938
15,9904,10,100,1e-05,0.01,0.972,4922,4982
15,10004,10,100,1e-05,0.01,0.96,4976,5028
15,10104,10,100,1e-05,0.01,0.968,5022,5082
15,10204,10,100,1e-05,0.01,0.964,5075,5129
15,10304,10,100,1e-05,0.01,0.974,5117,5187
15,10404,10,100,1e-05,0.01,0.964,5162,5242
15,10504,10,100,1e-05,0.01,0.966,5210,5294
15,10604,10,100,1e-05,0.01,0.974,5255,5349
15,10704,10,100,1e-05,0.01,0.98,5309,5395
15,10804,10,100,1e-05,0.01,0.98,5358,5446
15,10904,10,100,1e-05,0.01,0.982,5412,5492
15,11004,10,100,1e-05,0.01,0.986,5472,5532
15,11104,10,100,1e-05,0.01,0.986,5526,5578
15,11204,10,100,1e-05,0.01,0.988,5582,5622
15,11304,10,100,1e-05,0.01,0.978,5627,5677
15,11404,10,100,1e-05,0.01,0.98,5672,5732
15,11504,10,100,1e-05,0.01,0.984,5715,5789
15,11604,10,100,1e-05,0.01,0.986,5761,5843
15,11704,10,100,1e-05,0.01,0.978,5815,5889
15,11804,10,100,1e-05,0.01,0.966,5873,5931
15,11904,10,100,1e-05,0.01,0.974,5919,5985
15,12004,10,100,1e-05,0.01,0.986,5981,6023
15,12104,10,100,1e-05,0.01,0.982,6031,6073
15,12204,10,100,1e-05,0.01,0.986,6079,6125
15,12304,10,100,1e-05,0.01,0.986,6123,6181
15,12404,10,100,1e-05,0.01,0.982,6172,6232
15,12504,10,100,1e-05,0.01,0.99,6224,6280
15,12604,10,100,1e-05,0.01,0.984,6279,6325
15,12704,10,100,1e-05,0.01,0.98,6340,6364
15,12804,10,100,1e-05,0.01,0.988,6392,6412
15,12904,10,100,1e-05,0.01,0.98,6442,6462
15,13004,10,100,1e-05,0.01,0.984,6490,6514
15,13104,10,100,1e-05,0.01,0.984,6539,6565
15,13204,10,100,1e-05,0.01,0.986,6594,6610
15,13304,10,100,1e-05,0.01,0.99,6647,6657
15,13404,10,100,1e-05,0.01,0.988,6695,6709
15,13504,10,100,1e-05,0.01,0.994,6749,6755
15,13604,10,100,1e-05,0.01,0.98,6792,6812
15,13704,10,100,1e-05,0.01,0.978,6841,6863
15,13804,10,100,1e-05,0.01,0.98,6893,6911
15,13904,10,100,1e-05,0.01,0.98,6947,6957
15,14004,10,100,1e-05,0.01,0.986,6996,7008
15,14104,10,100,1e-05,0.01,0.984,7044,7060
15,14204,10,100,1e-05,0.01,0.988,7099,7105
15,14304,10,100,1e-05,0.01,0.982,7147,7157
15,14404,10,100,1e-05,0.01,0.986,7199,7205
15,14504,10,100,1e-05,0.01,0.984,7260,7244
15,14604,10,100,1e-05,0.01,0.98,7310,7294
15,14704,10,100,1e-05,0.01,0.988,7355,7349
15,14804,10,100,1e-05,0.01,0.99,7398,7406
15,14904,10,100,1e-05,0.01,0.994,7447,7457
15,15004,10,100,1e-05,0.01,0.992,7503,7501
16,104,10,100,1e-05,0.01,0.53,54,50
16,204,10,100,1e-05,0.01,0.452,106,98
16,304,10,100,1e-05,0.01,0.476,158,146
16,404,10,100,1e-05,0.01,0.512,205,199
16,504,10,100,1e-05,0.01,0.48,261,243
16,604,10,100,1e-05,0.01,0.482,308,296
16,704,10,100,1e-05,0.01,0.46,365,339
16,804,10,100,1e-05,0.01,0.478,414,390
16,904,10,100,1e-05,0.01,0.496,462,442
16,1004,10,100,1e-05,0.01,0.478,510,494
16,1104,10,100,1e-05,0.01,0.478,557,547
16,1204,10,100,1e-05,0.01,0.478,608,596
16,1304,10,100,1e-05,0.01,0.456,660,644
16,1404,10,100,1e-05,0.01,0.468,716,688
16,1504,10,100,1e-05,0.01,0.45,768,736
16,1604,10,100,1e-05,0.01,0.474,818,786
16,1704,10,100,1e-05,0.01,0.476,863,841
16,1804,10,100,1e-05,0.01,0.506,911,893
16,1904,10,100,1e-05,0.01,0.498,952,952
16,2004,10,100,1e-05,0.01,0.526,997,1007
16,2104,10,100,1e-05,0.01,0.516,1043,1061
16,2204,10,100,1e-05,0.01,0.538,1095,1109
16,2304,10,100,1e-05,0.01,0.542,1145,1159
16,2404,10,100,1e-05,0.01,0.582,1196,1208
16,2504,10,100,1e-05,0.01,0.614,1250,1254
16,2604,10,100,1e-05,0.01,0.61,1294,1310
16,2704,10,100,1e-05,0.01,0.636,1327,1377
16,2804,10,100,1e-05,0.01,0.65,1374,1430
16,2904,10,100,1e-05,0.01,0.664,1424,1480
16,3004,10,100,1e-05,0.01,0.706,1484,1520
16,3104,10,100,1e-05,0.01,0.73,1532,1572
16,3204,10,100,1e-05,0.01,0.784,1580,1624
16,3304,10,100,1e-05,0.01,0.766,1630,1674
16,3404,10,100,1e-05,0.01,0.792,1676,1728
16,3504,10,100,1e-05,0.01,0.81,1719,1785
16,3604,10,100,1e-05,0.01,0.824,1769,1835
16,3704,10,100,1e-05,0.01,0.808,1824,1880
16,3804,10,100,1e-05,0.01,0.86,1873,1931
16,3904,10,100,1e-05,0.01,0.882,1925,1979
16,4004,10,100,1e-05,0.01,0.904,1976,2028
16,4104,10,100,1e-05,0.01,0.922,2024,2080
16,4204,10,100,1e-05,0.01,0.92,2076,2128
16,4304,10,100,1e-05,0.01,0.932,2131,2173
16,4404,10,100,1e-05,0.01,0.942,2181,2223
16,4504,10,100,1e-05,0.01,0.928,2228,2276
16,4604,10,100,1e-05,0.01,0.922,2281,2323
16,4704,10,100,1e-05,0.01,0.956,2326,2378
16,4804,10,100,1e-05,0.01,0.932,2369,2435
16,4904,10,100,1e-05,0.01,0.938,2418,2486
16,5004,10,100,1e-05,0.01,0.944,2467,2537
16,5104,10,100,1e-05,0.01,0.926,2525,2579
16,5204,10,100,1e-05,0.01,0.944,2573,2631
16,5304,10,100,1e-05,0.01,0.928,2627,2677
16,5404,10,100,1e-05,0.01,0.964,2672,2732
16,5504,10,100,1e-05,0.01,0.952,2721,2783
16,5604,10,100,1e-05,0.01,0.934,2763,2841
16,5704,10,100,1e-05,0.01,0.964,2817,2887
16,5804,10,100,1e-05,0.01,0.966,2872,2932
16,5904,10,100,1e-05,0.01,0.946,2928,2976
16,6004,10,100,1e-05,0.01,0.966,2979,3025
16,6104,10,100,1e-05,0.01,0.95,3032,3072
16,6204,10,100,1e-05,0.01,0.94,3079,3125
16,6304,10,100,1e-05,0.01,0.97,3119,3185
16,6404,10,100,1e-05,0.01,0.982,3176,3228
16,6504,10,100,1e-05,0.01,0.982,3232,3272
16,6604,10,100,1e-05,0.01,0.97,3284,3320
16,6704,10,100,1e-05,0.01,0.98,3341,3363
16,6804,10,100,1e-05,0.01,0.974,3389,3415
16,6904,10,100,1e-05,0.01,0.972,3441,3463
16,7004,10,100,1e-05,0.01,0.964,3490,3514
16,7104,10,100,1e-05,0.01,0.964,3532,3572
16,7204,10,100,1e-05,0.01,0.978,3574,3630
16,7304,10,100,1e-05,0.01,0.97,3629,3675
16,7404,10,100,1e-05,0.01,0.972,3678,3726
16,7504,10,100,1e-05,0.01,0.974,3734,3770
16,7604,10,100,1e-05,0.01,0.974,3788,3816
16,7704,10,100,1e-05,0.01,0.978,3848,3856
16,7804,10,100,1e-05,0.01,0.966,3898,3906
16,7904,10,100,1e-05,0.01,0.982,3946,3958
16,8004,10,100,1e-05,0.01,0.982,3996,4008
16,8104,10,100,1e-05,0.01,0.984,4044,4060
16,8204,10,100,1e-05,0.01,0.984,4102,4102
16,8304,10,100,1e-05,0.01,0.984,4155,4149
16,8404,10,100,1e-05,0.01,0.978,4206,4198
16,8504,10,100,1e-05,0.01,0.972,4252,4252
16,8604,10,100,1e-05,0.01,0.974,4297,4307
16,8704,10,100,1e-05,0.01,0.988,4346,4358
16,8804,10,100,1e-05,0.01,0.982,4394,4410
16,8904,10,100,1e-05,0.01,0.99,4438,4466
16,9004,10,100,1e-05,0.01,0.978,4487,4517
16,9104,10,100,1e-05,0.01,0.98,4543,4561
16,9204,10,100,1e-05,0.01,0.984,4602,4602
16,9304,10,100,1e-05,0.01,0.99,4659,4645
16,9404,10,100,1e-05,0.01,0.984,4717,4687
16,9504,10,100,1e-05,0.01,0.984,4768,4736
16,9604,10,100,1e-05,0.01,0.988,4821,4783
16,9704,10,100,1e-05,0.01,0.988,4859,4845
16,9804,10,100,1e-05,0.01,0.976,4904,4900
16,9904,10,100,1e-05,0.01,0.99,4944,4960
16,10004,10,100,1e-05,0.01,0.986,4999,5005
16,10104,10,100,1e-05,0.01,0.994,5047,5057
16,10204,10,100,1e-05,0.01,0.988,5093,5111
16,10304,10,100,1e-05,0.01,0.984,5143,5161
16,10404,10,100,1e-05,0.01,0.992,5192,5212
16,10504,10,100,1e-05,0.01,0.986,5233,5271
16,10604,10,100,1e-05,0.01,0.978,5283,5321
16,10704,10,100,1e-05,0.01,0.984,5336,5368
16,10804,10,100,1e-05,0.01,0.982,5387,5417
16,10904,10,100,1e-05,0.01,0.976,5432,5472
16,11004,10,100,1e-05,0.01,0.988,5478,5526
16,11104,10,100,1e-05,0.01,0.992,5528,5576
16,11204,10,100,1e-05,0.01,0.988,5578,5626
16,11304,10,100,1e-05,0.01,0.992,5627,5677
16,11404,10,100,1e-05,0.01,0.992,5667,5737
16,11504,10,100,1e-05,0.01,0.99,5716,5788
16,11604,10,100,1e-05,0.01,0.994,5765,5839
16,11704,10,100,1e-05,0.01,0.976,5812,5892
16,11804,10,100,1e-05,0.01,0.982,5861,5943
16,11904,10,100,1e-05,0.01,0.992,5924,5980
16,12004,10,100,1e-05,0.01,0.986,5975,6029
16,12104,10,100,1e-05,0.01,0.994,6025,6079
16,12204,10,100,1e-05,0.01,0.992,6069,6135
16,12304,10,100,1e-05,0.01,0.99,6126,6178
16,12404,10,100,1e-05,0.01,0.994,6174,6230
16,12504,10,100,1e-05,0.01,0.99,6219,6285
16,12604,10,100,1e-05,0.01,0.984,6265,6339
16,12704,10,100,1e-05,0.01,0.992,6324,6380
16,12804,10,100,1e-05,0.01,0.992,6373,6431
16,12904,10,100,1e-05,0.01,0.996,6419,6485
16,13004,10,100,1e-05,0.01,0.988,6477,6527
16,13104,10,100,1e-05,0.01,0.99,6530,6574
16,13204,10,100,1e-05,0.01,0.99,6585,6619
16,13304,10,100,1e-05,0.01,0.98,6637,6667
16,13404,10,100,1e-05,0.01,0.982,6696,6708
16,13504,10,100,1e-05,0.01,0.99,6742,6762
16,13604,10,100,1e-05,0.01,0.992,6795,6809
16,13704,10,100,1e-05,0.01,0.992,6844,6860
16,13804,10,100,1e-05,0.01,0.988,6893,6911
16,13904,10,100,1e-05,0.01,0.992,6941,6963
16,14004,10,100,1e-05,0.01,0.992,6993,7011
16,14104,10,100,1e-05,0.01,0.996,7046,7058
16,14204,10,100,1e-05,0.01,0.994,7105,7099
16,14304,10,100,1e-05,0.01,0.996,7146,7158
16,14404,10,100,1e-05,0.01,0.988,7195,7209
16,14504,10,100,1e-05,0.01,0.99,7240,7264
16,14604,10,100,1e-05,0.01,0.996,7290,7314
16,14704,10,100,1e-05,0.01,0.996,7342,7362
16,14804,10,100,1e-05,0.01,0.994,7386,7418
16,14904,10,100,1e-05,0.01,0.996,7444,7460
16,15004,10,100,1e-05,0.01,0.994,7487,7517
17,104,10,100,1e-05,0.01,0.494,53,51
17,204,10,100,1e-05,0.01,0.516,102,102
17,304,10,100,1e-05,0.01,0.534,142,162
17,404,10,100,1e-05,0.01,0.496,193,211
17,504,10,100,1e-05,0.01,0.502,244,260
17,604,10,100,1e-05,0.01,0.516,301,303
17,704,10,100,1e-05,0.01,0.498,357,347
17,804,10,100,1e-05,0.01,0.48,398,406
17,904,10,100,1e-05,0.01,0.482,441,463
17,1004,10,100,1e-05,0.01,0.478,480,524
17,1104,10,100,1e-05,0.01,0.478,524,580
17,1204,10,100,1e-05,0.01,0.474,579,625
17,1304,10,100,1e-05,0.01,0.486,629,675
17,1404,10,100,1e-05,0.01,0.486,687,717
17,1504,10,100,1e-05,0.01,0.508,737,767
17,1604,10,100,1e-05,0.01,0.518,790,814
17,1704,10,100,1e-05,0.01,0.48,837,867
17,1804,10,100,1e-05,0.01,0.498,888,916
17,1904,10,100,1e-05,0.01,0.508,941,963
17,2004,10,100,1e-05,0.01,0.482,989,1015
17,2104,10,100,1e-05,0.01,0.488,1043,1061
17,2204,10,100,1e-05,0.01,0.504,1092,1112
17,2304,10,100,1e-05,0.01,0.5,1138,1166
17,2404,10,100,1e-05,0.01,0.526,1192,1212
17,2504,10,100,1e-05,0.01,0.496,1245,1259
17,2604,10,100,1e-05,0.01,0.506,1291,1313
17,2704,10,100,1e-05,0.01,0.518,1346,1358
17,2804,10,100,1e-05,0.01,0.528,1397,1407
17,2904,10,100,1e-05,0.01,0.51,1450,1454
17,3004,10,100,1e-05,0.01,0.526,1488,1516
17,3104,10,100,1e-05,0.01,0.548,1536,1568
17,3204,10,100,1e-05,0.01,0.532,1586,1618
17,3304,10,100,1e-05,0.01,0.566,1621,1683
17,3404,10,100,1e-05,0.01,0.538,1677,1727
17,3504,10,100,1e-05,0.01,0.568,1727,1777
17,3604,10,100,1e-05,0.01,0.552,1779,1825
17,3704,10,100,1e-05,0.01,0.564,1828,1876
17,3804,10,100,1e-05,0.01,0.578,1875,1929
17,3904,10,100,1e-05,0.01,0.558,1932,1972
17,4004,10,100,1e-05,0.01,0.556,1981,2023
17,4104,10,100,1e-05,0.01,0.562,2037,2067
17,4204,10,100,1e-05,0.01,0.588,2088,2116
17,4304,10,100,1e-05,0.01,0.578,2147,2157
17,4404,10,100,1e-05,0.01,0.574,2200,2204
17,4504,10,100,1e-05,0.01,0.594,2256,2248
17,4604,10,100,1e-05,0.01,0.598,2306,2298
17,4704,10,100,1e-05,0.01,0.602,2351,2353
17,4804,10,100,1e-05,0.01,0.618,2402,2402
17,4904,10,100,1e-05,0.01,0.618,2442,2462
17,5004,10,100,1e-05,0.01,0.576,2490,2514
17,5104,10,100,1e-05,0.01,0.624,2537,2567
17,5204,10,100,1e-05,0.01,0.63,2587,2617
17,5304,10,100,1e-05,0.01,0.662,2636,2668
17,5404,10,100,1e-05,0.01,0.632,2680,2724
17,5504,10,100,1e-05,0.01,0.628,2723,2781
17,5604,10,100,1e-05,0.01,0.65,2770,2834
17,5704,10,100,1e-05,0.01,0.622,2817,2887
17,5804,10,100,1e-05,0.01,0.65,2866,2938
17,5904,10,100,1e-05,0.01,0.64,2921,2983
17,6004,10,100,1e-05,0.01,0.674,2974,3030
17,6104,10,100,1e-05,0.01,0.648,3021,3083
17,6204,10,100,1e-05,0.01,0.66,3064,3140
17,6304,10,100,1e-05,0.01,0.666,3112,3192
17,6404,10,100,1e-05,0.01,0.68,3159,3245
17,6504,10,100,1e-05,0.01,0.658,3201,3303
17,6604,10,100,1e-05,0.01,0.664,3249,3355
17,6704,10,100,1e-05,0.01,0.674,3299,3405
17,6804,10,100,1e-05,0.01,0.672,3353,3451
17,6904,10,100,1e-05,0.01,0.664,3406,3498
17,7004,10,100,1e-05,0.01,0.696,3459,3545
17,7104,10,100,1e-05,0.01,0.652,3509,3595
17,7204,10,100,1e-05,0.01,0.684,3553,3651
17,7304,10,100,1e-05,0.01,0.668,3612,3692
17,7404,10,100,1e-05,0.01,0.682,3663,3741
17,7504,10,100,1e-05,0.01,0.674,3706,3798
17,7604,10,100,1e-05,0.01,0.686,3755,3849
17,7704,10,100,1e-05,0.01,0.68,3806,3898
17,7804,10,100,1e-05,0.01,0.698,3858,3946
17,7904,10,100,1e-05,0.01,0.7,3914,3990
17,8004,10,100,1e-05,0.01,0.702,3959,4045
17,8104,10,100,1e-05,0.01,0.724,4012,4092
17,8204,10,100,1e-05,0.01,0.726,4059,4145
17,8304,10,100,1e-05,0.01,0.708,4107,4197
17,8404,10,100,1e-05,0.01,0.702,4150,4254
17,8504,10,100,1e-05,0.01,0.72,4200,4304
17,8604,10,100,1e-05,0.01,0.696,4250,4354
17,8704,10,100,1e-05,0.01,0.706,4306,4398
17,8804,10,100,1e-05,0.01,0.686,4357,4447
17,8904,10,100,1e-05,0.01,0.736,4410,4494
17,9004,10,100,1e-05,0.01,0.732,4458,4546
17,9104,10,100,1e-05,0.01,0.738,4502,4602
17,9204,10,100,1e-05,0.01,0.748,4544,4660
17,9304,10,100,1e-05,0.01,0.752,4595,4709
17,9404,10,100,1e-05,0.01,0.738,4651,4753
17,9504,10,100,1e-05,0.01,0.728,4690,4814
17,9604,10,100,1e-05,0.01,0.752,4743,4861
17,9704,10,100,1e-05,0.01,0.774,4795,4909
17,9804,10,100,1e-05,0.01,0.778,4847,4957
17,9904,10,100,1e-05,0.01,0.744,4898,5006
17,10004,10,100,1e-05,0.01,0.752,4943,5061
17,10104,10,100,1e-05,0.01,0.784,5004,5100
17,10204,10,100,1e-05,0.01,0.8,5052,5152
17,10304,10,100,1e-05,0.01,0.77,5102,5202
17,10404,10,100,1e-05,0.01,0.78,5157,5247
17,10504,10,100,1e-05,0.01,0.804,5208,5296
17,10604,10,100,1e-05,0.01,0.816,5261,5343
17,10704,10,100,1e-05,0.01,0.788,5309,5395
17,10804,10,100,1e-05,0.01,0.784,5357,5447
17,10904,10,100,1e-05,0.01,0.808,5409,5495
17,11004,10,100,1e-05,0.01,0.798,5455,5549
17,11104,10,100,1e-05,0.01,0.808,5504,5600
17,11204,10,100,1e-05,0.01,0.832,5554,5650
17,11304,10,100,1e-05,0.01,0.814,5599,5705
17,11404,10,100,1e-05,0.01,0.806,5647,5757
17,11504,10,100,1e-05,0.01,0.826,5700,5804
17,11604,10,100,1e-05,0.01,0.83,5754,5850
17,11704,10,100,1e-05,0.01,0.834,5808,5896
17,11804,10,100,1e-05,0.01,0.85,5856,5948
17,11904,10,100,1e-05,0.01,0.836,5907,5997
17,12004,10,100,1e-05,0.01,0.838,5953,6051
17,12104,10,100,1e-05,0.01,0.874,5998,6106
17,12204,10,100,1e-05,0.01,0.812,6050,6154
17,12304,10,100,1e-05,0.01,0.844,6099,6205
17,12404,10,100,1e-05,0.01,0.872,6149,6255
17,12504,10,100,1e-05,0.01,0.872,6191,6313
17,12604,10,100,1e-05,0.01,0.856,6246,6358
17,12704,10,100,1e-05,0.01,0.876,6300,6404
17,12804,10,100,1e-05,0.01,0.894,6360,6444
17,12904,10,100,1e-05,0.01,0.862,6413,6491
17,13004,10,100,1e-05,0.01,0.876,6465,6539
17,13104,10,100,1e-05,0.01,0.894,6507,6597
17,13204,10,100,1e-05,0.01,0.902,6563,6641
17,13304,10,100,1e-05,0.01,0.888,6616,6688
17,13404,10,100,1e-05,0.01,0.896,6663,6741
17,13504,10,100,1e-05,0.01,0.91,6713,6791
17,13604,10,100,1e-05,0.01,0.924,6758,6846
17,13704,10,100,1e-05,0.01,0.916,6810,6894
17,13804,10,100,1e-05,0.01,0.922,6861,6943
17,13904,10,100,1e-05,0.01,0.938,6913,6991
17,14004,10,100,1e-05,0.01,0.934,6972,7032
17,14104,10,100,1e-05,0.01,0.944,7031,7073
17,14204,10,100,1e-05,0.01,0.932,7077,7127
17,14304,10,100,1e-05,0.01,0.94,7132,7172
17,14404,10,100,1e-05,0.01,0.958,7184,7220
17,14504,10,100,1e-05,0.01,0.964,7236,7268
17,14604,10,100,1e-05,0.01,0.954,7287,7317
17,14704,10,100,1e-05,0.01,0.958,7337,7367
17,14804,10,100,1e-05,0.01,0.96,7388,7416
17,14904,10,100,1e-05,0.01,0.954,7447,7457
17,15004,10,100,1e-05,0.01,0.96,7494,7510
18,104,10,100,1e-05,0.01,0.538,50,54
18,204,10,100,1e-05,0.01,0.512,100,104
18,304,10,100,1e-05,0.01,0.482,160,144
18,404,10,100,1e-05,0.01,0.54,204,200
18,504,10,100,1e-05,0.01,0.53,255,249
18,604,10,100,1e-05,0.01,0.548,307,297
18,704,10,100,1e-05,0.01,0.542,349,355
18,804,10,100,1e-05,0.01,0.528,400,404
18,904,10,100,1e-05,0.01,0.508,449,455
18,1004,10,100,1e-05,0.01,0.534,498,506
18,1104,10,100,1e-05,0.01,0.482,548,556
18,1204,10,100,1e-05,0.01,0.508,600,604
18,1304,10,100,1e-05,0.01,0.484,651,653
18,1404,10,100,1e-05,0.01,0.504,699,705
18,1504,10,100,1e-05,0.01,0.47,746,758
18,1604,10,100,1e-05,0.01,0.488,802,802
18,1704,10,100,1e-05,0.01,0.5,841,863
18,1804,10,100,1e-05,0.01,0.484,898,906
18,1904,10,100,1e-05,0.01,0.498,940,964
18,2004,10,100,1e-05,0.01,0.492,994,1010
18,2104,10,100,1e-05,0.01,0.478,1045,1059
18,2204,10,100,1e-05,0.01,0.496,1103,1101
18,2304,10,100,1e-05,0.01,0.498,1150,1154
18,2404,10,100,1e-05,0.01,0.518,1201,1203
18,2504,10,100,1e-05,0.01,0.494,1253,1251
18,2604,10,100,1e-05,0.01,0.524,1302,1302
18,2704,10,100,1e-05,0.01,0.478,1356,1348
18,2804,10,100,1e-05,0.01,0.47,1400,1404
18,2904,10,100,1e-05,0.01,0.472,1444,1460
18,3004,10,100,1e-05,0.01,0.518,1495,1509
18,3104,10,100,1e-05,0.01,0.492,1545,1559
18,3204,10,100,1e-05,0.01,0.486,1594,1610
18,3304,10,100,1e-05,0.01,0.526,1644,1660
18,3404,10,100,1e-05,0.01,0.486,1696,1708
18,3504,10,100,1e-05,0.01,0.494,1751,1753
18,3604,10,100,1e-05,0.01,0.522,1800,1804
18,3704,10,100,1e-05,0.01,0.514,1852,1852
18,3804,10,100,1e-05,0.01,0.524,1905,1899
18,3904,10,100,1e-05,0.01,0.506,1946,1958
18,4004,10,100,1e-05,0.01,0.516,1992,2012
18,4104,10,100,1e-05,0.01,0.51,2043,2061
18,4204,10,100,1e-05,0.01,0.51,2089,2115
18,4304,10,100,1e-05,0.01,0.522,2144,2160
18,4404,10,100,1e-05,0.01,0.496,2201,2203
18,4504,10,100,1e-05,0.01,0.516,2251,2253
18,4604,10,100,1e-05,0.01,0.512,2298,2306
18,4704,10,100,1e-05,0.01,0.532,2353,2351
18,4804,10,100,1e-05,0.01,0.546,2395,2409
18,4904,10,100,1e-05,0.01,0.546,2442,2462
18,5004,10,100,1e-05,0.01,0.55,2494,2510
18,5104,10,100,1e-05,0.01,0.564,2537,2567
18,5204,10,100,1e-05,0.01,0.534,2592,2612
18,5304,10,100,1e-05,0.01,0.552,2634,2670
18,5404,10,100,1e-05,0.01,0.558,2685,2719
18,5504,10,100,1e-05,0.01,0.542,2740,2764
18,5604,10,100,1e-05,0.01,0.552,2789,2815
18,5704,10,100,1e-05,0.01,0.564,2833,2871
18,5804,10,100,1e-05,0.01,0.582,2885,2919
18,5904,10,100,1e-05,0.01,0.58,2935,2969
18,6004,10,100,1e-05,0.01,0.572,2996,3008
18,6104,10,100,1e-05,0.01,0.57,3053,3051
18,6204,10,100,1e-05,0.01,0.562,3103,3101
18,6304,10,100,1e-05,0.01,0.586,3149,3155
18,6404,10,100,1e-05,0.01,0.54,3199,3205
18,6504,10,100,1e-05,0.01,0.582,3247,3257
18,6604,10,100,1e-05,0.01,0.558,3289,3315
18,6704,10,100,1e-05,0.01,0.558,3340,3364
18,6804,10,100,1e-05,0.01,0.564,3392,3412
18,6904,10,100,1e-05,0.01,0.572,3449,3455
18,7004,10,100,1e-05,0.01,0.568,3496,3508
18,7104,10,100,1e-05,0.01,0.558,3543,3561
18,7204,10,100,1e-05,0.01,0.56,3598,3606
18,7304,10,100,1e-05,0.01,0.584,3647,3657
18,7404,10,100,1e-05,0.01,0.584,3692,3712
18,7504,10,100,1e-05,0.01,0.576,3742,3762
18,7604,10,100,1e-05,0.01,0.594,3788,3816
18,7704,10,100,1e-05,0.01,0.576,3837,3867
18,7804,10,100,1e-05,0.01,0.594,3884,3920
18,7904,10,100,1e-05,0.01,0.57,3932,3972
18,8004,10,100,1e-05,0.01,0.59,3979,4025
18,8104,10,100,1e-05,0.01,0.606,4038,4066
18,8204,10,100,1e-05,0.01,0.608,4101,4103
18,8304,10,100,1e-05,0.01,0.612,4153,4151
18,8404,10,100,1e-05,0.01,0.608,4208,4196
18,8504,10,100,1e-05,0.01,0.608,4263,4241
18,8604,10,100,1e-05,0.01,0.626,4307,4297
18,8704,10,100,1e-05,0.01,0.624,4353,4351
18,8804,10,100,1e-05,0.01,0.632,4402,4402
18,8904,10,100,1e-05,0.01,0.636,4452,4452
18,9004,10,100,1e-05,0.01,0.63,4514,4490
18,9104,10,100,1e-05,0.01,0.622,4553,4551
18,9204,10,100,1e-05,0.01,0.646,4607,4597
18,9304,10,100,1e-05,0.01,0.626,4652,4652
18,9404,10,100,1e-05,0.01,0.652,4694,4710
18,9504,10,100,1e-05,0.01,0.652,4745,4759
18,9604,10,100,1e-05,0.01,0.642,4804,4800
18,9704,10,100,1e-05,0.01,0.654,4852,4852
18,9804,10,100,1e-05,0.01,0.66,4908,4896
18,9904,10,100,1e-05,0.01,0.65,4954,4950
18,10004,10,100,1e-05,0.01,0.63,5000,5004
18,10104,10,100,1e-05,0.01,0.672,5048,5056
18,10204,10,100,1e-05,0.01,0.64,5096,5108
18,10304,10,100,1e-05,0.01,0.65,5141,5163
18,10404,10,100,1e-05,0.01,0.678,5200,5204
18,10504,10,100,1e-05,0.01,0.668,5253,5251
18,10604,10,100,1e-05,0.01,0.702,5302,5302
18,10704,10,100,1e-05,0.01,0.648,5357,5347
18,10804,10,100,1e-05,0.01,0.678,5399,5405
18,10904,10,100,1e-05,0.01,0.688,5453,5451
18,11004,10,100,1e-05,0.01,0.704,5502,5502
18,11104,10,100,1e-05,0.01,0.708,5554,5550
18,11204,10,100,1e-05,0.01,0.696,5604,5600
18,11304,10,100,1e-05,0.01,0.688,5658,5646
18,11404,10,100,1e-05,0.01,0.708,5710,5694
18,11504,10,100,1e-05,0.01,0.73,5758,5746
18,11604,10,100,1e-05,0.01,0.704,5819,5785
18,11704,10,100,1e-05,0.01,0.708,5868,5836
18,11804,10,100,1e-05,0.01,0.72,5912,5892
18,11904,10,100,1e-05,0.01,0.698,5958,5946
18,12004,10,100,1e-05,0.01,0.694,6006,5998
18,12104,10,100,1e-05,0.01,0.716,6046,6058
18,12204,10,100,1e-05,0.01,0.716,6092,6112
18,12304,10,100,1e-05,0.01,0.722,6152,6152
18,12404,10,100,1e-05,0.01,0.734,6197,6207
18,12504,10,100,1e-05,0.01,0.732,6244,6260
18,12604,10,100,1e-05,0.01,0.724,6295,6309
18,12704,10,100,1e-05,0.01,0.742,6349,6355
18,12804,10,100,1e-05,0.01,0.736,6399,6405
18,12904,10,100,1e-05,0.01,0.738,6450,6454
18,13004,10,100,1e-05,0.01,0.734,6497,6507
18,13104,10,100,1e-05,0.01,0.744,6543,6561
18,13204,10,100,1e-05,0.01,0.714,6592,6612
18,13304,10,100,1e-05,0.01,0.738,6653,6651
18,13404,10,100,1e-05,0.01,0.738,6703,6701
18,13504,10,100,1e-05,0.01,0.716,6760,6744
18,13604,10,100,1e-05,0.01,0.73,6808,6796
18,13704,10,100,1e-05,0.01,0.728,6861,6843
18,13804,10,100,1e-05,0.01,0.724,6913,6891
18,13904,10,100,1e-05,0.01,0.758,6962,6942
18,14004,10,100,1e-05,0.01,0.738,7017,6987
18,14104,10,100,1e-05,0.01,0.722,7069,7035
18,14204,10,100,1e-05,0.01,0.742,7113,7091
18,14304,10,100,1e-05,0.01,0.752,7168,7136
18,14404,10,100,1e-05,0.01,0.742,7214,7190
18,14504,10,100,1e-05,0.01,0.746,7262,7242
18,14604,10,100,1e-05,0.01,0.722,7310,7294
18,14704,10,100,1e-05,0.01,0.742,7364,7340
18,14804,10,100,1e-05,0.01,0.74,7418,7386
18,14904,10,100,1e-05,0.01,0.738,7468,7436
18,15004,10,100,1e-05,0.01,0.746,7521,7483
19,104,10,100,1e-05,0.01,0.462,52,52
19,204,10,100,1e-05,0.01,0.458,106,98
19,304,10,100,1e-05,0.01,0.482,153,151
19,404,10,100,1e-05,0.01,0.52,212,192
19,504,10,100,1e-05,0.01,0.536,266,238
19,604,10,100,1e-05,0.01,0.46,317,287
19,704,10,100,1e-05,0.01,0.504,360,344
19,804,10,100,1e-05,0.01,0.528,410,394
19,904,10,100,1e-05,0.01,0.494,454,450
19,1004,10,100,1e-05,0.01,0.506,503,501
19,1104,10,100,1e-05,0.01,0.514,550,554
19,1204,10,100,1e-05,0.01,0.524,597,607
19,1304,10,100,1e-05,0.01,0.5,644,660
19,1404,10,100,1e-05,0.01,0.546,701,703
19,1504,10,100,1e-05,0.01,0.476,748,756
19,1604,10,100,1e-05,0.01,0.51,795,809
19,1704,10,100,1e-05,0.01,0.468,849,855
19,1804,10,100,1e-05,0.01,0.498,899,905
19,1904,10,100,1e-05,0.01,0.514,956,948
19,2004,10,100,1e-05,0.01,0.49,1008,996
19,2104,10,100,1e-05,0.01,0.516,1059,1045
19,2204,10,100,1e-05,0.01,0.48,1115,1089
19,2304,10,100,1e-05,0.01,0.538,1168,1136
19,2404,10,100,1e-05,0.01,0.53,1216,1188
19,2504,10,100,1e-05,0.01,0.544,1259,1245
19,2604,10,100,1e-05,0.01,0.556,1308,1296
19,2704,10,100,1e-05,0.01,0.594,1365,1339
19,2804,10,100,1e-05,0.01,0.574,1410,1394
19,2904,10,100,1e-05,0.01,0.566,1460,1444
19,3004,10,100,1e-05,0.01,0.602,1514,1490
19,3104,10,100,1e-05,0.01,0.596,1567,1537
19,3204,10,100,1e-05,0.01,0.61,1611,1593
19,3304,10,100,1e-05,0.01,0.602,1663,1641
19,3404,10,100,1e-05,0.01,0.636,1712,1692
19,3504,10,100,1e-05,0.01,0.65,1763,1741
19,3604,10,100,1e-05,0.01,0.602,1812,1792
19,3704,10,100,1e-05,0.01,0.624,1859,1845
19,3804,10,100,1e-05,0.01,0.654,1909,1895
19,3904,10,100,1e-05,0.01,0.622,1964,1940
19,4004,10,100,1e-05,0.01,0.656,2009,1995
19,4104,10,100,1e-05,0.01,0.658,2060,2044
19,4204,10,100,1e-05,0.01,0.646,2111,2093
19,4304,10,100,1e-05,0.01,0.65,2160,2144
19,4404,10,100,1e-05,0.01,0.664,2218,2186
19,4504,10,100,1e-05,0.01,0.63,2268,2236
19,4604,10,100,1e-05,0.01,0.644,2312,2292
19,4704,10,100,1e-05,0.01,0.648,2362,2342
19,4804,10,100,1e-05,0.01,0.652,2413,2391
19,4904,10,100,1e-05,0.01,0.632,2461,2443
19,5004,10,100,1e-05,0.01,0.67,2508,2496
19,5104,10,100,1e-05,0.01,0.658,2559,2545
19,5204,10,100,1e-05,0.01,0.67,2623,2581
19,5304,10,100,1e-05,0.01,0.68,2673,2631
19,5404,10,100,1e-05,0.01,0.658,2721,2683
19,5504,10,100,1e-05,0.01,0.668,2774,2730
19,5604,10,100,1e-05,0.01,0.686,2824,2780
19,5704,10,100,1e-05,0.01,0.696,2882,2822
19,5804,10,100,1e-05,0.01,0.668,2935,2869
19,5904,10,100,1e-05,0.01,0.712,2987,2917
19,6004,10,100,1e-05,0.01,0.698,3039,2965
19,6104,10,100,1e-05,0.01,0.702,3093,3011
19,6204,10,100,1e-05,0.01,0.68,3139,3065
19,6304,10,100,1e-05,0.01,0.718,3189,3115
19,6404,10,100,1e-05,0.01,0.77,3242,3162
19,6504,10,100,1e-05,0.01,0.756,3294,3210
19,6604,10,100,1e-05,0.01,0.712,3344,3260
19,6704,10,100,1e-05,0.01,0.728,3395,3309
19,6804,10,100,1e-05,0.01,0.734,3439,3365
19,6904,10,100,1e-05,0.01,0.758,3478,3426
19,7004,10,100,1e-05,0.01,0.782,3527,3477
19,7104,10,100,1e-05,0.01,0.784,3586,3518
19,7204,10,100,1e-05,0.01,0.784,3627,3577
19,7304,10,100,1e-05,0.01,0.742,3674,3630
19,7404,10,100,1e-05,0.01,0.782,3720,3684
19,7504,10,100,1e-05,0.01,0.756,3769,3735
19,7604,10,100,1e-05,0.01,0.772,3819,3785
19,7704,10,100,1e-05,0.01,0.784,3862,3842
19,7804,10,100,1e-05,0.01,0.814,3913,3891
19,7904,10,100,1e-05,0.01,0.838,3969,3935
19,8004,10,100,1e-05,0.01,0.814,4025,3979
19,8104,10,100,1e-05,0.01,0.776,4070,4034
19,8204,10,100,1e-05,0.01,0.81,4119,4085
19,8304,10,100,1e-05,0.01,0.834,4163,4141
19,8404,10,100,1e-05,0.01,0.836,4217,4187
19,8504,10,100,1e-05,0.01,0.82,4272,4232
19,8604,10,100,1e-05,0.01,0.848,4328,4276
19,8704,10,100,1e-05,0.01,0.854,4375,4329
19,8804,10,100,1e-05,0.01,0.814,4416,4388
19,8904,10,100,1e-05,0.01,0.802,4466,4438
19,9004,10,100,1e-05,0.01,0.876,4521,4483
19,9104,10,100,1e-05,0.01,0.858,4568,4536
19,9204,10,100,1e-05,0.01,0.834,4620,4584
19,9304,10,100,1e-05,0.01,0.87,4671,4633
19,9404,10,100,1e-05,0.01,0.878,4722,4682
19,9504,10,100,1e-05,0.01,0.878,4767,4737
19,9604,10,100,1e-05,0.01,0.896,4821,4783
19,9704,10,100,1e-05,0.01,0.882,4873,4831
19,9804,10,100,1e-05,0.01,0.866,4924,4880
19,9904,10,100,1e-05,0.01,0.89,4980,4924
19,10004,10,100,1e-05,0.01,0.892,5028,4976
19,10104,10,100,1e-05,0.01,0.904,5081,5023
19,10204,10,100,1e-05,0.01,0.896,5134,5070
19,10304,10,100,1e-05,0.01,0.914,5188,5116
19,10404,10,100,1e-05,0.01,0.918,5241,5163
19,10504,10,100,1e-05,0.01,0.892,5290,5214
19,10604,10,100,1e-05,0.01,0.908,5341,5263
19,10704,10,100,1e-05,0.01,0.886,5390,5314
19,10804,10,100,1e-05,0.01,0.906,5442,5362
19,10904,10,100,1e-05,0.01,0.912,5498,5406
19,11004,10,100,1e-05,0.01,0.924,5551,5453
19,11104,10,100,1e-05,0.01,0.926,5601,5503
19,11204,10,100,1e-05,0.01,0.928,5654,5550
19,11304,10,100,1e-05,0.01,0.926,5708,5596
19,11404,10,100,1e-05,0.01,0.926,5766,5638
19,11504,10,100,1e-05,0.01,0.932,5808,5696
19,11604,10,100,1e-05,0.01,0.936,5867,5737
19,11704,10,100,1e-05,0.01,0.928,5917,5787
19,11804,10,100,1e-05,0.01,0.958,5955,5849
19,11904,10,100,1e-05,0.01,0.932,5999,5905
19,12004,10,100,1e-05,0.01,0.956,6049,5955
19,12104,10,100,1e-05,0.01,0.952,6093,6011
19,12204,10,100,1e-05,0.01,0.964,6136,6068
19,12304,10,100,1e-05,0.01,0.96,6199,6105
19,12404,10,100,1e-05,0.01,0.95,6245,6159
19,12504,10,100,1e-05,0.01,0.958,6290,6214
19,12604,10,100,1e-05,0.01,0.946,6337,6267
19,12704,10,100,1e-05,0.01,0.946,6384,6320
19,12804,10,100,1e-05,0.01,0.974,6432,6372
19,12904,10,100,1e-05,0.01,0.96,6483,6421
19,13004,10,100,1e-05,0.01,0.954,6539,6465
19,13104,10,100,1e-05,0.01,0.938,6590,6514
19,13204,10,100,1e-05,0.01,0.954,6639,6565
19,13304,10,100,1e-05,0.01,0.952,6682,6622
19,13404,10,100,1e-05,0.01,0.954,6740,6664
19,13504,10,100,1e-05,0.01,0.918,6783,6721
19,13604,10,100,1e-05,0.01,0.96,6840,6764
19,13704,10,100,1e-05,0.01,0.962,6881,6823
19,13804,10,100,1e-05,0.01,0.956,6931,6873
19,13904,10,100,1e-05,0.01,0.956,6985,6919
19,14004,10,100,1e-05,0.01,0.962,7030,6974
19,14104,10,100,1e-05,0.01,0.968,7074,7030
19,14204,10,100,1e-05,0.01,0.974,7118,7086
19,14304,10,100,1e-05,0.01,0.954,7173,7131
19,14404,10,100,1e-05,0.01,0.956,7223,7181
19,14504,10,100,1e-05,0.01,0.978,7275,7229
19,14604,10,100,1e-05,0.01,0.976,7331,7273
19,14704,10,100,1e-05,0.01,0.974,7376,7328
19,14804,10,100,1e-05,0.01,0.978,7425,7379
19,14904,10,100,1e-05,0.01,0.98,7468,7436
19,15004,10,100,1e-05,0.01,0.976,7515,7489
20,104,10,100,1e-05,0.01,0.504,54,50
20,204,10,100,1e-05,0.01,0.518,99,105
20,304,10,100,1e-05,0.01,0.524,154,150
20,404,10,100,1e-05,0.01,0.508,211,193
20,504,10,100,1e-05,0.01,0.494,261,243
20,604,10,100,1e-05,0.01,0.488,311,293
20,704,10,100,1e-05,0.01,0.486,369,335
20,804,10,100,1e-05,0.01,0.498,422,382
20,904,10,100,1e-05,0.01,0.52,467,437
20,1004,10,100,1e-05,0.01,0.516,518,486
20,1104,10,100,1e-05,0.01,0.536,566,538
20,1204,10,100,1e-05,0.01,0.492,616,588
20,1304,10,100,1e-05,0.01,0.504,662,642
20,1404,10,100,1e-05,0.01,0.502,721,683
20,1504,10,100,1e-05,0.01,0.514,763,741
20,1604,10,100,1e-05,0.01,0.504,818,786
20,1704,10,100,1e-05,0.01,0.514,864,840
20,1804,10,100,1e-05,0.01,0.518,912,892
20,1904,10,100,1e-05,0.01,0.504,961,943
20,2004,10,100,1e-05,0.01,0.518,1010,994
20,2104,10,100,1e-05,0.01,0.5,1068,1036
20,2204,10,100,1e-05,0.01,0.474,1120,1084
20,2304,10,100,1e-05,0.01,0.492,1173,1131
20,2404,10,100,1e-05,0.01,0.526,1216,1188
20,2504,10,100,1e-05,0.01,0.53,1272,1232
20,2604,10,100,1e-05,0.01,0.542,1326,1278
20,2704,10,100,1e-05,0.01,0.544,1374,1330
20,2804,10,100,1e-05,0.01,0.518,1419,1385
20,2904,10,100,1e-05,0.01,0.514,1473,1431
20,3004,10,100,1e-05,0.01,0.534,1522,1482
20,3104,10,100,1e-05,0.01,0.526,1565,1539
20,3204,10,100,1e-05,0.01,0.552,1609,1595
20,3304,10,100,1e-05,0.01,0.57,1661,1643
20,3404,10,100,1e-05,0.01,0.582,1712,1692
20,3504,10,100,1e-05,0.01,0.572,1760,1744
20,3604,10,100,1e-05,0.01,0.598,1813,1791
20,3704,10,100,1e-05,0.01,0.582,1862,1842
20,3804,10,100,1e-05,0.01,0.574,1910,1894
20,3904,10,100,1e-05,0.01,0.598,1967,1937
20,4004,10,100,1e-05,0.01,0.58,2029,1975
20,4104,10,100,1e-05,0.01,0.576,2083,2021
20,4204,10,100,1e-05,0.01,0.592,2134,2070
20,4304,10,100,1e-05,0.01,0.596,2178,2126
20,4404,10,100,1e-05,0.01,0.61,2235,2169
20,4504,10,100,1e-05,0.01,0.59,2282,2222
20,4604,10,100,1e-05,0.01,0.6,2322,2282
20,4704,10,100,1e-05,0.01,0.604,2378,2326
20,4804,10,100,1e-05,0.01,0.61,2426,2378
20,4904,10,100,1e-05,0.01,0.626,2472,2432
20,5004,10,100,1e-05,0.01,0.622,2527,2477
20,5104,10,100,1e-05,0.01,0.588,2574,2530
20,5204,10,100,1e-05,0.01,0.626,2616,2588
20,5304,10,100,1e-05,0.01,0.59,2669,2635
20,5404,10,100,1e-05,0.01,0.61,2717,2687
20,5504,10,100,1e-05,0.01,0.642,2770,2734
20,5604,10,100,1e-05,0.01,0.622,2817,2787
20,5704,10,100,1e-05,0.01,0.648,2863,2841
20,5804,10,100,1e-05,0.01,0.66,2912,2892
20,5904,10,100,1e-05,0.01,0.654,2954,2950
20,6004,10,100,1e-05,0.01,0.668,3001,3003
20,6104,10,100,1e-05,0.01,0.644,3053,3051
20,6204,10,100,1e-05,0.01,0.67,3102,3102
20,6304,10,100,1e-05,0.01,0.666,3146,3158
20,6404,10,100,1e-05,0.01,0.67,3201,3203
20,6504,10,100,1e-05,0.01,0.692,3247,3257
20,6604,10,100,1e-05,0.01,0.688,3299,3305
20,6704,10,100,1e-05,0.01,0.668,3349,3355
20,6804,10,100,1e-05,0.01,0.708,3399,3405
20,6904,10,100,1e-05,0.01,0.704,3437,3467
20,7004,10,100,1e-05,0.01,0.718,3493,3511
20,7104,10,100,1e-05,0.01,0.74,3549,3555
20,7204,10,100,1e-05,0.01,0.73,3596,3608
20,7304,10,100,1e-05,0.01,0.736,3644,3660
20,7404,10,100,1e-05,0.01,0.734,3694,3710
20,7504,10,100,1e-05,0.01,0.74,3743,3761
20,7604,10,100,1e-05,0.01,0.734,3801,3803
20,7704,10,100,1e-05,0.01,0.74,3844,3860
20,7804,10,100,1e-05,0.01,0.74,3892,3912
20,7904,10,100,1e-05,0.01,0.756,3939,3965
20,8004,10,100,1e-05,0.01,0.768,3989,4015
20,8104,10,100,1e-05,0.01,0.748,4029,4075
20,8204,10,100,1e-05,0.01,0.768,4077,4127
20,8304,10,100,1e-05,0.01,0.802,4126,4178
20,8404,10,100,1e-05,0.01,0.808,4178,4226
20,8504,10,100,1e-05,0.01,0.828,4225,4279
20,8604,10,100,1e-05,0.01,0.812,4281,4323
20,8704,10,100,1e-05,0.01,0.824,4335,4369
20,8804,10,100,1e-05,0.01,0.818,4388,4416
20,8904,10,100,1e-05,0.01,0.81,4435,4469
20,9004,10,100,1e-05,0.01,0.826,4486,4518
20,9104,10,100,1e-05,0.01,0.806,4537,4567
20,9204,10,100,1e-05,0.01,0.844,4586,4618
20,9304,10,100,1e-05,0.01,0.858,4638,4666
20,9404,10,100,1e-05,0.01,0.846,4683,4721
20,9504,10,100,1e-05,0.01,0.878,4737,4767
20,9604,10,100,1e-05,0.01,0.88,4791,4813
20,9704,10,100,1e-05,0.01,0.884,4841,4863
20,9804,10,100,1e-05,0.01,0.884,4890,4914
20,9904,10,100,1e-05,0.01,0.896,4947,4957
20,10004,10,100,1e-05,0.01,0.91,4999,5005
20,10104,10,100,1e-05,0.01,0.912,5046,5058
20,10204,10,100,1e-05,0.01,0.908,5090,5114
20,10304,10,100,1e-05,0.01,0.9,5137,5167
20,10404,10,100,1e-05,0.01,0.89,5190,5214
20,10504,10,100,1e-05,0.01,0.904,5248,5256
20,10604,10,100,1e-05,0.01,0.9,5309,5295
20,10704,10,100,1e-05,0.01,0.894,5362,5342
20,10804,10,100,1e-05,0.01,0.938,5410,5394
20,10904,10,100,1e-05,0.01,0.91,5460,5444
20,11004,10,100,1e-05,0.01,0.944,5505,5499
20,11104,10,100,1e-05,0.01,0.944,5556,5548
20,11204,10,100,1e-05,0.01,0.924,5604,5600
20,11304,10,100,1e-05,0.01,0.952,5656,5648
20,11404,10,100,1e-05,0.01,0.948,5706,5698
20,11504,10,100,1e-05,0.01,0.94,5757,5747
20,11604,10,100,1e-05,0.01,0.934,5805,5799
20,11704,10,100,1e-05,0.01,0.95,5859,5845
20,11804,10,100,1e-05,0.01,0.954,5902,5902
20,11904,10,100,1e-05,0.01,0.954,5968,5936
20,12004,10,100,1e-05,0.01,0.95,6016,5988
20,12104,10,100,1e-05,0.01,0.944,6062,6042
20,12204,10,100,1e-05,0.01,0.954,6115,6089
20,12304,10,100,1e-05,0.01,0.946,6161,6143
20,12404,10,100,1e-05,0.01,0.96,6208,6196
20,12504,10,100,1e-05,0.01,0.96,6258,6246
20,12604,10,100,1e-05,0.01,0.966,6311,6293
20,12704,10,100,1e-05,0.01,0.97,6356,6348
20,12804,10,100,1e-05,0.01,0.968,6401,6403
20,12904,10,100,1e-05,0.01,0.972,6441,6463
20,13004,10,100,1e-05,0.01,0.97,6489,6515
20,13104,10,100,1e-05,0.01,0.962,6531,6573
20,13204,10,100,1e-05,0.01,0.952,6592,6612
20,13304,10,100,1e-05,0.01,0.97,6641,6663
20,13404,10,100,1e-05,0.01,0.966,6693,6711
20,13504,10,100,1e-05,0.01,0.968,6744,6760
20,13604,10,100,1e-05,0.01,0.976,6792,6812
20,13704,10,100,1e-05,0.01,0.97,6841,6863
20,13804,10,100,1e-05,0.01,0.946,6891,6913
20,13904,10,100,1e-05,0.01,0.948,6946,6958
20,14004,10,100,1e-05,0.01,0.964,6991,7013
20,14104,10,100,1e-05,0.01,0.976,7046,7058
20,14204,10,100,1e-05,0.01,0.984,7093,7111
20,14304,10,100,1e-05,0.01,0.982,7141,7163
20,14404,10,100,1e-05,0.01,0.978,7196,7208
20,14504,10,100,1e-05,0.01,0.982,7243,7261
20,14604,10,100,1e-05,0.01,0.986,7299,7305
20,14704,10,100,1e-05,0.01,0.984,7344,7360
20,14804,10,100,1e-05,0.01,0.958,7394,7410
20,14904,10,100,1e-05,0.01,0.946,7449,7455
20,15004,10,100,1e-05,0.01,0.978,7502,7502
1,104,10,100,0.0001,0.01,0.502,57,47
1,204,10,100,0.0001,0.01,0.552,100,104
1,304,10,100,0.0001,0.01,0.496,145,159
1,404,10,100,0.0001,0.01,0.556,189,215
1,504,10,100,0.0001,0.01,0.516,240,264
1,604,10,100,0.0001,0.01,0.55,288,316
1,704,10,100,0.0001,0.01,0.54,333,371
1,804,10,100,0.0001,0.01,0.528,390,414
1,904,10,100,0.0001,0.01,0.51,445,459
1,1004,10,100,0.0001,0.01,0.534,494,510
1,1104,10,100,0.0001,0.01,0.526,535,569
1,1204,10,100,0.0001,0.01,0.536,586,618
1,1304,10,100,0.0001,0.01,0.49,631,673
1,1404,10,100,0.0001,0.01,0.502,680,724
1,1504,10,100,0.0001,0.01,0.518,726,778
1,1604,10,100,0.0001,0.01,0.486,781,823
1,1704,10,100,0.0001,0.01,0.494,824,880
1,1804,10,100,0.0001,0.01,0.492,873,931
1,1904,10,100,0.0001,0.01,0.51,924,980
1,2004,10,100,0.0001,0.01,0.492,977,1027
1,2104,10,100,0.0001,0.01,0.54,1034,1070
1,2204,10,100,0.0001,0.01,0.534,1086,1118
1,2304,10,100,0.0001,0.01,0.54,1142,1162
1,2404,10,100,0.0001,0.01,0.532,1186,1218
1,2504,10,100,0.0001,0.01,0.55,1237,1267
1,2604,10,100,0.0001,0.01,0.538,1283,1321
1,2704,10,100,0.0001,0.01,0.55,1332,1372
1,2804,10,100,0.0001,0.01,0.562,1378,1426
1,2904,10,100,0.0001,0.01,0.536,1424,1480
1,3004,10,100,0.0001,0.01,0.52,1474,1530
1,3104,10,100,0.0001,0.01,0.55,1527,1577
1,3204,10,100,0.0001,0.01,0.568,1576,1628
1,3304,10,100,0.0001,0.01,0.564,1625,1679
1,3404,10,100,0.0001,0.01,0.554,1679,1725
1,3504,10,100,0.0001,0.01,0.532,1743,1761
1,3604,10,100,0.0001,0.01,0.546,1796,1808
1,3704,10,100,0.0001,0.01,0.536,1850,1854
1,3804,10,100,0.0001,0.01,0.54,1900,1904
1,3904,10,100,0.0001,0.01,0.572,1946,1958
1,4004,10,100,0.0001,0.01,0.56,2005,1999
1,4104,10,100,0.0001,0.01,0.56,2051,2053
1,4204,10,100,0.0001,0.01,0.572,2104,2100
1,4304,10,100,0.0001,0.01,0.548,2145,2159
1,4404,10,100,0.0001,0.01,0.57,2193,2211
1,4504,10,100,0.0001,0.01,0.57,2244,2260
1,4604,10,100,0.0001,0.01,0.608,2294,2310
1,4704,10,100,0.0001,0.01,0.576,2346,2358
1,4804,10,100,0.0001,0.01,0.58,2401,2403
1,4904,10,100,0.0001,0.01,0.598,2451,2453
1,5004,10,100,0.0001,0.01,0.61,2494,2510
1,5104,10,100,0.0001,0.01,0.6,2551,2553
1,5204,10,100,0.0001,0.01,0.6,2608,2596
1,5304,10,100,0.0001,0.01,0.59,2662,2642
1,5404,10,100,0.0001,0.01,0.606,2714,2690
1,5504,10,100,0.0001,0.01,0.594,2763,2741
1,5604,10,100,0.0001,0.01,0.616,2813,2791
1,5704,10,100,0.0001,0.01,0.612,2862,2842
1,5804,10,100,0.0001,0.01,0.59,2908,2896
1,5904,10,100,0.0001,0.01,0.612,2957,2947
1,6004,10,100,0.0001,0.01,0.594,3012,2992
1,6104,10,100,0.0001,0.01,0.608,3054,3050
1,6204,10,100,0.0001,0.01,0.596,3105,3099
1,6304,10,100,0.0001,0.01,0.622,3145,3159
1,6404,10,100,0.0001,0.01,0.622,3196,3208
1,6504,10,100,0.0001,0.01,0.594,3248,3256
1,6604,10,100,0.0001,0.01,0.612,3302,3302
1,6704,10,100,0.0001,0.01,0.622,3352,3352
1,6804,10,100,0.0001,0.01,0.624,3406,3398
1,6904,10,100,0.0001,0.01,0.616,3457,3447
1,7004,10,100,0.0001,0.01,0.622,3507,3497
1,7104,10,100,0.0001,0.01,0.648,3556,3548
1,7204,10,100,0.0001,0.01,0.646,3604,3600
1,7304,10,100,0.0001,0.01,0.63,3652,3652
1,7404,10,100,0.0001,0.01,0.636,3709,3695
1,7504,10,100,0.0001,0.01,0.648,3758,3746
1,7604,10,100,0.0001,0.01,0.65,3813,3791
1,7704,10,100,0.0001,0.01,0.648,3861,3843
1,7804,10,100,0.0001,0.01,0.65,3913,3891
1,7904,10,100,0.0001,0.01,0.652,3964,3940
1,8004,10,100,0.0001,0.01,0.64,4016,3988
1,8104,10,100,0.0001,0.01,0.646,4068,4036
1,8204,10,100,0.0001,0.01,0.656,4119,4085
1,8304,10,100,0.0001,0.01,0.684,4173,4131
1,8404,10,100,0.0001,0.01,0.672,4223,4181
1,8504,10,100,0.0001,0.01,0.64,4274,4230
1,8604,10,100,0.0001,0.01,0.664,4326,4278
1,8704,10,100,0.0001,0.01,0.67,4374,4330
1,8804,10,100,0.0001,0.01,0.688,4424,4380
1,8904,10,100,0.0001,0.01,0.684,4471,4433
1,9004,10,100,0.0001,0.01,0.708,4520,4484
1,9104,10,100,0.0001,0.01,0.67,4574,4530
1,9204,10,100,0.0001,0.01,0.682,4623,4581
1,9304,10,100,0.0001,0.01,0.69,4671,4633
1,9404,10,100,0.0001,0.01,0.698,4725,4679
1,9504,10,100,0.0001,0.01,0.71,4769,4735
1,9604,10,100,0.0001,0.01,0.696,4818,4786
1,9704,10,100,0.0001,0.01,0.706,4864,4840
1,9804,10,100,0.0001,0.01,0.714,4913,4891
1,9904,10,100,0.0001,0.01,0.74,4963,4941
1,10004,10,100,0.0001,0.01,0.692,5017,4987
1,10104,10,100,0.0001,0.01,0.71,5068,5036
1,10204,10,100,0.0001,0.01,0.706,5121,5083
1,10304,10,100,0.0001,0.01,0.706,5168,5136
1,10404,10,100,0.0001,0.01,0.698,5219,5185
1,10504,10,100,0.0001,0.01,0.698,5265,5239
1,10604,10,100,0.0001,0.01,0.706,5309,5295
1,10704,10,100,0.0001,0.01,0.674,5352,5352
1,10804,10,100,0.0001,0.01,0.688,5387,5417
1,10904,10,100,0.0001,0.01,0.706,5435,5469
1,11004,10,100,0.0001,0.01,0.698,5483,5521
1,11104,10,100,0.0001,0.01,0.728,5529,5575
1,11204,10,100,0.0001,0.01,0.736,5587,5617
1,11304,10,100,0.0001,0.01,0.73,5642,5662
1,11404,10,100,0.0001,0.01,0.722,5694,5710
1,11504,10,100,0.0001,0.01,0.736,5751,5753
1,11604,10,100,0.0001,0.01,0.706,5799,5805
1,11704,10,100,0.0001,0.01,0.712,5848,5856
1,11804,10,100,0.0001,0.01,0.714,5906,5898
1,11904,10,100,0.0001,0.01,0.738,5955,5949
1,12004,10,100,0.0001,0.01,0.706,5996,6008
1,12104,10,100,0.0001,0.01,0.702,6048,6056
1,12204,10,100,0.0001,0.01,0.71,6094,6110
1,12304,10,100,0.0001,0.01,0.75,6149,6155
1,12404,10,100,0.0001,0.01,0.736,6199,6205
1,12504,10,100,0.0001,0.01,0.74,6253,6251
1,12604,10,100,0.0001,0.01,0.718,6311,6293
1,12704,10,100,0.0001,0.01,0.726,6368,6336
1,12804,10,100,0.0001,0.01,0.746,6420,6384
1,12904,10,100,0.0001,0.01,0.742,6473,6431
1,13004,10,100,0.0001,0.01,0.74,6514,6490
1,13104,10,100,0.0001,0.01,0.744,6566,6538
1,13204,10,100,0.0001,0.01,0.778,6618,6586
1,13304,10,100,0.0001,0.01,0.762,6663,6641
1,13404,10,100,0.0001,0.01,0.748,6709,6695
1,13504,10,100,0.0001,0.01,0.764,6750,6754
1,13604,10,100,0.0001,0.01,0.746,6806,6798
1,13704,10,100,0.0001,0.01,0.78,6857,6847
1,13804,10,100,0.0001,0.01,0.766,6904,6900
1,13904,10,100,0.0001,0.01,0.77,6948,6956
1,14004,10,100,0.0001,0.01,0.778,6989,7015
1,14104,10,100,0.0001,0.01,0.764,7037,7067
1,14204,10,100,0.0001,0.01,0.772,7089,7115
1,14304,10,100,0.0001,0.01,0.78,7137,7167
1,14404,10,100,0.0001,0.01,0.786,7191,7213
1,14504,10,100,0.0001,0.01,0.76,7245,7259
1,14604,10,100,0.0001,0.01,0.76,7296,7308
1,14704,10,100,0.0001,0.01,0.758,7349,7355
1,14804,10,100,0.0001,0.01,0.768,7391,7413
1,14904,10,100,0.0001,0.01,0.778,7447,7457
1,15004,10,100,0.0001,0.01,0.792,7501,7503
2,104,10,100,0.0001,0.01,0.504,48,56
2,204,10,100,0.0001,0.01,0.47,97,107
2,304,10,100,0.0001,0.01,0.51,145,159
2,404,10,100,0.0001,0.01,0.546,201,203
2,504,10,100,0.0001,0.01,0.524,254,250
2,604,10,100,0.0001,0.01,0.502,292,312
2,704,10,100,0.0001,0.01,0.49,346,358
2,804,10,100,0.0001,0.01,0.5,402,402
2,904,10,100,0.0001,0.01,0.484,446,458
2,1004,10,100,0.0001,0.01,0.528,494,510
2,1104,10,100,0.0001,0.01,0.528,554,550
2,1204,10,100,0.0001,0.01,0.512,604,600
2,1304,10,100,0.0001,0.01,0.522,644,660
2,1404,10,100,0.0001,0.01,0.516,689,715
2,1504,10,100,0.0001,0.01,0.508,737,767
2,1604,10,100,0.0001,0.01,0.478,793,811
2,1704,10,100,0.0001,0.01,0.492,843,861
2,1804,10,100,0.0001,0.01,0.524,890,914
2,1904,10,100,0.0001,0.01,0.514,945,959
2,2004,10,100,0.0001,0.01,0.496,993,1011
2,2104,10,100,0.0001,0.01,0.524,1042,1062
2,2204,10,100,0.0001,0.01,0.558,1097,1107
2,2304,10,100,0.0001,0.01,0.554,1147,1157
2,2404,10,100,0.0001,0.01,0.562,1192,1212
2,2504,10,100,0.0001,0.01,0.572,1243,1261
2,2604,10,100,0.0001,0.01,0.606,1302,1302
2,2704,10,100,0.0001,0.01,0.612,1354,1350
2,2804,10,100,0.0001,0.01,0.608,1398,1406
2,2904,10,100,0.0001,0.01,0.584,1452,1452
2,3004,10,100,0.0001,0.01,0.626,1494,1510
2,3104,10,100,0.0001,0.01,0.62,1543,1561
2,3204,10,100,0.0001,0.01,0.64,1586,1618
2,3304,10,100,0.0001,0.01,0.662,1629,1675
2,3404,10,100,0.0001,0.01,0.674,1675,1729
2,3504,10,100,0.0001,0.01,0.694,1730,1774
2,3604,10,100,0.0001,0.01,0.722,1783,1821
2,3704,10,100,0.0001,0.01,0.704,1829,1875
2,3804,10,100,0.0001,0.01,0.718,1881,1923
2,3904,10,100,0.0001,0.01,0.728,1931,1973
2,4004,10,100,0.0001,0.01,0.722,1984,2020
2,4104,10,100,0.0001,0.01,0.744,2029,2075
2,4204,10,100,0.0001,0.01,0.738,2081,2123
2,4304,10,100,0.0001,0.01,0.764,2136,2168
2,4404,10,100,0.0001,0.01,0.762,2197,2207
2,4504,10,100,0.0001,0.01,0.778,2242,2262
2,4604,10,100,0.0001,0.01,0.784,2288,2316
2,4704,10,100,0.0001,0.01,0.784,2342,2362
2,4804,10,100,0.0001,0.01,0.768,2385,2419
2,4904,10,100,0.0001,0.01,0.736,2432,2472
2,5004,10,100,0.0001,0.01,0.782,2479,2525
2,5104,10,100,0.0001,0.01,0.778,2533,2571
2,5204,10,100,0.0001,0.01,0.79,2581,2623
2,5304,10,100,0.0001,0.01,0.794,2629,2675
2,5404,10,100,0.0001,0.01,0.8,2677,2727
2,5504,10,100,0.0001,0.01,0.814,2722,2782
2,5604,10,100,0.0001,0.01,0.824,2772,2832
2,5704,10,100,0.0001,0.01,0.838,2828,2876
2,5804,10,100,0.0001,0.01,0.838,2877,2927
2,5904,10,100,0.0001,0.01,0.842,2928,2976
2,6004,10,100,0.0001,0.01,0.834,2981,3023
2,6104,10,100,0.0001,0.01,0.834,3024,3080
2,6204,10,100,0.0001,0.01,0.86,3075,3129
2,6304,10,100,0.0001,0.01,0.866,3129,3175
2,6404,10,100,0.0001,0.01,0.852,3180,3224
2,6504,10,100,0.0001,0.01,0.822,3227,3277
2,6604,10,100,0.0001,0.01,0.822,3275,3329
2,6704,10,100,0.0001,0.01,0.854,3316,3388
2,6804,10,100,0.0001,0.01,0.874,3367,3437
2,6904,10,100,0.0001,0.01,0.9,3420,3484
2,7004,10,100,0.0001,0.01,0.89,3473,3531
2,7104,10,100,0.0001,0.01,0.89,3522,3582
2,7204,10,100,0.0001,0.01,0.886,3571,3633
2,7304,10,100,0.0001,0.01,0.87,3624,3680
2,7404,10,100,0.0001,0.01,0.902,3668,3736
2,7504,10,100,0.0001,0.01,0.824,3711,3793
2,7604,10,100,0.0001,0.01,0.866,3760,3844
2,7704,10,100,0.0001,0.01,0.856,3813,3891
2,7804,10,100,0.0001,0.01,0.888,3865,3939
2,7904,10,100,0.0001,0.01,0.898,3916,3988
2,8004,10,100,0.0001,0.01,0.894,3973,4031
2,8104,10,100,0.0001,0.01,0.912,4013,4091
2,8204,10,100,0.0001,0.01,0.894,4063,4141
2,8304,10,100,0.0001,0.01,0.896,4119,4185
2,8404,10,100,0.0001,0.01,0.912,4180,4224
2,8504,10,100,0.0001,0.01,0.892,4235,4269
2,8604,10,100,0.0001,0.01,0.912,4289,4315
2,8704,10,100,0.0001,0.01,0.916,4328,4376
2,8804,10,100,0.0001,0.01,0.912,4384,4420
2,8904,10,100,0.0001,0.01,0.926,4425,4479
2,9004,10,100,0.0001,0.01,0.912,4484,4520
2,9104,10,100,0.0001,0.01,0.916,4530,4574
2,9204,10,100,0.0001,0.01,0.904,4577,4627
2,9304,10,100,0.0001,0.01,0.916,4625,4679
2,9404,10,100,0.0001,0.01,0.922,4669,4735
2,9504,10,100,0.0001,0.01,0.932,4725,4779
2,9604,10,100,0.0001,0.01,0.934,4782,4822
2,9704,10,100,0.0001,0.01,0.952,4824,4880
2,9804,10,100,0.0001,0.01,0.94,4873,4931
2,9904,10,100,0.0001,0.01,0.942,4922,4982
2,10004,10,100,0.0001,0.01,0.948,4969,5035
2,10104,10,100,0.0001,0.01,0.956,5022,5082
2,10204,10,100,0.0001,0.01,0.948,5072,5132
2,10304,10,100,0.0001,0.01,0.944,5126,5178
2,10404,10,100,0.0001,0.01,0.936,5179,5225
2,10504,10,100,0.0001,0.01,0.942,5235,5269
2,10604,10,100,0.0001,0.01,0.926,5292,5312
2,10704,10,100,0.0001,0.01,0.954,5340,5364
2,10804,10,100,0.0001,0.01,0.96,5391,5413
2,10904,10,100,0.0001,0.01,0.97,5445,5459
2,11004,10,100,0.0001,0.01,0.964,5492,5512
2,11104,10,100,0.0001,0.01,0.958,5549,5555
2,11204,10,100,0.0001,0.01,0.954,5600,5604
2,11304,10,100,0.0001,0.01,0.958,5651,5653
2,11404,10,100,0.0001,0.01,0.958,5709,5695
2,11504,10,100,0.0001,0.01,0.96,5751,5753
2,11604,10,100,0.0001,0.01,0.964,5802,5802
2,11704,10,100,0.0001,0.01,0.966,5862,5842
2,11804,10,100,0.0001,0.01,0.97,5923,5881
2,11904,10,100,0.0001,0.01,0.968,5974,5930
2,12004,10,100,0.0001,0.01,0.966,6020,5984
2,12104,10,100,0.0001,0.01,0.954,6063,6041
2,12204,10,100,0.0001,0.01,0.964,6114,6090
2,12304,10,100,0.0001,0.01,0.972,6158,6146
2,12404,10,100,0.0001,0.01,0.974,6212,6192
2,12504,10,100,0.0001,0.01,0.984,6258,6246
2,12604,10,100,0.0001,0.01,0.98,6312,6292
2,12704,10,100,0.0001,0.01,0.98,6363,6341
2,12804,10,100,0.0001,0.01,0.984,6409,6395
2,12904,10,100,0.0001,0.01,0.986,6464,6440
2,13004,10,100,0.0001,0.01,0.984,6511,6493
2,13104,10,100,0.0001,0.01,0.97,6566,6538
2,13204,10,100,0.0001,0.01,0.98,6618,6586
2,13304,10,100,0.0001,0.01,0.978,6660,6644
2,13404,10,100,0.0001,0.01,0.976,6702,6702
2,13504,10,100,0.0001,0.01,0.978,6758,6746
2,13604,10,100,0.0001,0.01,0.972,6812,6792
2,13704,10,100,0.0001,0.01,0.986,6854,6850
2,13804,10,100,0.0001,0.01,0.974,6909,6895
2,13904,10,100,0.0001,0.01,0.986,6968,6936
2,14004,10,100,0.0001,0.01,0.978,7021,6983
2,14104,10,100,0.0001,0.01,0.982,7072,7032
2,14204,10,100,0.0001,0.01,0.986,7113,7091
2,14304,10,100,0.0001,0.01,0.984,7159,7145
2,14404,10,100,0.0001,0.01,0.978,7206,7198
2,14504,10,100,0.0001,0.01,0.982,7257,7247
2,14604,10,100,0.0001,0.01,0.974,7312,7292
2,14704,10,100,0.0001,0.01,0.98,7361,7343
2,14804,10,100,0.0001,0.01,0.98,7407,7397
2,14904,10,100,0.0001,0.01,0.976,7456,7448
2,15004,10,100,0.0001,0.01,0.98,7504,7500
3,104,10,100,0.0001,0.01,0.532,60,44
3,204,10,100,0.0001,0.01,0.498,108,96
3,304,10,100,0.0001,0.01,0.512,167,137
3,404,10,100,0.0001,0.01,0.506,206,198
3,504,10,100,0.0001,0.01,0.508,260,244
3,604,10,100,0.0001,0.01,0.508,315,289
3,704,10,100,0.0001,0.01,0.492,370,334
3,804,10,100,0.0001,0.01,0.528,423,381
3,904,10,100,0.0001,0.01,0.506,483,421
3,1004,10,100,0.0001,0.01,0.5,529,475
3,1104,10,100,0.0001,0.01,0.482,582,522
3,1204,10,100,0.0001,0.01,0.492,630,574
3,1304,10,100,0.0001,0.01,0.512,690,614
3,1404,10,100,0.0001,0.01,0.496,745,659
3,1504,10,100,0.0001,0.01,0.486,793,711
3,1604,10,100,0.0001,0.01,0.496,843,761
3,1704,10,100,0.0001,0.01,0.502,897,807
3,1804,10,100,0.0001,0.01,0.518,948,856
3,1904,10,100,0.0001,0.01,0.514,992,912
3,2004,10,100,0.0001,0.01,0.518,1042,962
3,2104,10,100,0.0001,0.01,0.528,1087,1017
3,2204,10,100,0.0001,0.01,0.534,1140,1064
3,2304,10,100,0.0001,0.01,0.546,1195,1109
3,2404,10,100,0.0001,0.01,0.562,1249,1155
3,2504,10,100,0.0001,0.01,0.57,1297,1207
3,2604,10,100,0.0001,0.01,0.578,1350,1254
3,2704,10,100,0.0001,0.01,0.62,1403,1301
3,2804,10,100,0.0001,0.01,0.592,1460,1344
3,2904,10,100,0.0001,0.01,0.684,1519,1385
3,3004,10,100,0.0001,0.01,0.698,1566,1438
3,3104,10,100,0.0001,0.01,0.702,1609,1495
3,3204,10,100,0.0001,0.01,0.698,1655,1549
3,3304,10,100,0.0001,0.01,0.716,1699,1605
3,3404,10,100,0.0001,0.01,0.732,1752,1652
3,3504,10,100,0.0001,0.01,0.722,1804,1700
3,3604,10,100,0.0001,0.01,0.732,1849,1755
3,3704,10,100,0.0001,0.01,0.706,1906,1798
3,3804,10,100,0.0001,0.01,0.752,1960,1844
3,3904,10,100,0.0001,0.01,0.794,2008,1896
3,4004,10,100,0.0001,0.01,0.786,2056,1948
3,4104,10,100,0.0001,0.01,0.744,2101,2003
3,4204,10,100,0.0001,0.01,0.796,2151,2053
3,4304,10,100,0.0001,0.01,0.808,2196,2108
3,4404,10,100,0.0001,0.01,0.84,2250,2154
3,4504,10,100,0.0001,0.01,0.846,2307,2197
3,4604,10,100,0.0001,0.01,0.832,2365,2239
3,4704,10,100,0.0001,0.01,0.848,2420,2284
3,4804,10,100,0.0001,0.01,0.866,2458,2346
3,4904,10,100,0.0001,0.01,0.852,2515,2389
3,5004,10,100,0.0001,0.01,0.854,2569,2435
3,5104,10,100,0.0001,0.01,0.862,2617,2487
3,5204,10,100,0.0001,0.01,0.866,2668,2536
3,5304,10,100,0.0001,0.01,0.85,2722,2582
3,5404,10,100,0.0001,0.01,0.83,2769,2635
3,5504,10,100,0.0001,0.01,0.844,2812,2692
3,5604,10,100,0.0001,0.01,0.872,2859,2745
3,5704,10,100,0.0001,0.01,0.916,2910,2794
3,5804,10,100,0.0001,0.01,0.904,2960,2844
3,5904,10,100,0.0001,0.01,0.912,3006,2898
3,6004,10,100,0.0001,0.01,0.916,3058,2946
3,6104,10,100,0.0001,0.01,0.93,3105,2999
3,6204,10,100,0.0001,0.01,0.92,3147,3057
3,6304,10,100,0.0001,0.01,0.914,3207,3097
3,6404,10,100,0.0001,0.01,0.906,3253,3151
3,6504,10,100,0.0001,0.01,0.904,3294,3210
3,6604,10,100,0.0001,0.01,0.892,3345,3259
3,6704,10,100,0.0001,0.01,0.91,3388,3316
3,6804,10,100,0.0001,0.01,0.92,3440,3364
3,6904,10,100,0.0001,0.01,0.93,3491,3413
3,7004,10,100,0.0001,0.01,0.932,3544,3460
3,7104,10,100,0.0001,0.01,0.93,3589,3515
3,7204,10,100,0.0001,0.01,0.926,3652,3552
3,7304,10,100,0.0001,0.01,0.924,3695,3609
3,7404,10,100,0.0001,0.01,0.934,3750,3654
3,7504,10,100,0.0001,0.01,0.936,3798,3706
3,7604,10,100,0.0001,0.01,0.906,3850,3754
3,7704,10,100,0.0001,0.01,0.922,3895,3809
3,7804,10,100,0.0001,0.01,0.954,3938,3866
3,7904,10,100,0.0001,0.01,0.956,3985,3919
3,8004,10,100,0.0001,0.01,0.956,4042,3962
3,8104,10,100,0.0001,0.01,0.962,4098,4006
3,8204,10,100,0.0001,0.01,0.954,4144,4060
3,8304,10,100,0.0001,0.01,0.956,4182,4122
3,8404,10,100,0.0001,0.01,0.96,4240,4164
3,8504,10,100,0.0001,0.01,0.962,4288,4216
3,8604,10,100,0.0001,0.01,0.96,4333,4271
3,8704,10,100,0.0001,0.01,0.954,4384,4320
3,8804,10,100,0.0001,0.01,0.958,4429,4375
3,8904,10,100,0.0001,0.01,0.968,4474,4430
3,9004,10,100,0.0001,0.01,0.956,4522,4482
3,9104,10,100,0.0001,0.01,0.928,4571,4533
3,9204,10,100,0.0001,0.01,0.96,4622,4582
3,9304,10,100,0.0001,0.01,0.96,4674,4630
3,9404,10,100,0.0001,0.01,0.97,4722,4682
3,9504,10,100,0.0001,0.01,0.972,4774,4730
3,9604,10,100,0.0001,0.01,0.972,4823,4781
3,9704,10,100,0.0001,0.01,0.976,4865,4839
3,9804,10,100,0.0001,0.01,0.968,4922,4882
3,9904,10,100,0.0001,0.01,0.974,4964,4940
3,10004,10,100,0.0001,0.01,0.976,5014,4990
3,10104,10,100,0.0001,0.01,0.976,5059,5045
3,10204,10,100,0.0001,0.01,0.974,5103,5101
3,10304,10,100,0.0001,0.01,0.976,5153,5151
3,10404,10,100,0.0001,0.01,0.974,5203,5201
3,10504,10,100,0.0001,0.01,0.976,5260,5244
3,10604,10,100,0.0001,0.01,0.98,5313,5291
3,10704,10,100,0.0001,0.01,0.964,5353,5351
3,10804,10,100,0.0001,0.01,0.954,5412,5392
3,10904,10,100,0.0001,0.01,0.962,5453,5451
3,11004,10,100,0.0001,0.01,0.958,5498,5506
3,11104,10,100,0.0001,0.01,0.97,5540,5564
3,11204,10,100,0.0001,0.01,0.97,5595,5609
3,11304,10,100,0.0001,0.01,0.982,5653,5651
3,11404,10,100,0.0001,0.01,0.978,5701,5703
3,11504,10,100,0.0001,0.01,0.958,5745,5759
3,11604,10,100,0.0001,0.01,0.978,5792,5812
3,11704,10,100,0.0001,0.01,0.978,5847,5857
3,11804,10,100,0.0001,0.01,0.982,5887,5917
3,11904,10,100,0.0001,0.01,0.982,5946,5958
3,12004,10,100,0.0001,0.01,0.982,5997,6007
3,12104,10,100,0.0001,0.01,0.982,6051,6053
3,12204,10,100,0.0001,0.01,0.982,6107,6097
3,12304,10,100,0.0001,0.01,0.982,6152,6152
3,12404,10,100,0.0001,0.01,0.974,6197,6207
3,12504,10,100,0.0001,0.01,0.978,6249,6255
3,12604,10,100,0.0001,0.01,0.982,6305,6299
3,12704,10,100,0.0001,0.01,0.98,6361,6343
3,12804,10,100,0.0001,0.01,0.982,6414,6390
3,12904,10,100,0.0001,0.01,0.984,6457,6447
3,13004,10,100,0.0001,0.01,0.992,6507,6497
3,13104,10,100,0.0001,0.01,0.988,6549,6555
3,13204,10,100,0.0001,0.01,0.988,6596,6608
3,13304,10,100,0.0001,0.01,0.984,6649,6655
3,13404,10,100,0.0001,0.01,0.988,6695,6709
3,13504,10,100,0.0001,0.01,0.984,6750,6754
3,13604,10,100,0.0001,0.01,0.986,6792,6812
3,13704,10,100,0.0001,0.01,0.99,6843,6861
3,13804,10,100,0.0001,0.01,0.972,6894,6910
3,13904,10,100,0.0001,0.01,0.99,6936,6968
3,14004,10,100,0.0001,0.01,0.99,6988,7016
3,14104,10,100,0.0001,0.01,0.99,7037,7067
3,14204,10,100,0.0001,0.01,0.988,7101,7103
3,14304,10,100,0.0001,0.01,0.984,7153,7151
3,14404,10,100,0.0001,0.01,0.984,7201,7203
3,14504,10,100,0.0001,0.01,0.982,7250,7254
3,14604,10,100,0.0001,0.01,0.988,7303,7301
3,14704,10,100,0.0001,0.01,0.988,7352,7352
3,14804,10,100,0.0001,0.01,0.992,7400,7404
3,14904,10,100,0.0001,0.01,0.994,7450,7454
3,15004,10,100,0.0001,0.01,0.996,7498,7506
4,104,10,100,0.0001,0.01,0.51,60,44
4,204,10,100,0.0001,0.01,0.516,114,90
4,304,10,100,0.0001,0.01,0.488,161,143
4,404,10,100,0.0001,0.01,0.456,212,192
4,504,10,100,0.0001,0.01,0.434,265,239
4,604,10,100,0.0001,0.01,0.458,322,282
4,704,10,100,0.0001,0.01,0.474,373,331
4,804,10,100,0.0001,0.01,0.498,427,377
4,904,10,100,0.0001,0.01,0.478,480,424
4,1004,10,100,0.0001,0.01,0.474,526,478
4,1104,10,100,0.0001,0.01,0.466,574,530
4,1204,10,100,0.0001,0.01,0.49,627,577
4,1304,10,100,0.0001,0.01,0.5,678,626
4,1404,10,100,0.0001,0.01,0.5,733,671
4,1504,10,100,0.0001,0.01,0.492,788,716
4,1604,10,100,0.0001,0.01,0.504,829,775
4,1704,10,100,0.0001,0.01,0.52,880,824
4,1804,10,100,0.0001,0.01,0.502,933,871
4,1904,10,100,0.0001,0.01,0.528,984,920
4,2004,10,100,0.0001,0.01,0.52,1032,972
4,2104,10,100,0.0001,0.01,0.494,1082,1022
4,2204,10,100,0.0001,0.01,0.526,1136,1068
4,2304,10,100,0.0001,0.01,0.534,1181,1123
4,2404,10,100,0.0001,0.01,0.504,1233,1171
4,2504,10,100,0.0001,0.01,0.524,1290,1214
4,2604,10,100,0.0001,0.01,0.514,1340,1264
4,2704,10,100,0.0001,0.01,0.52,1391,1313
4,2804,10,100,0.0001,0.01,0.516,1437,1367
4,2904,10,100,0.0001,0.01,0.538,1479,1425
4,3004,10,100,0.0001,0.01,0.512,1533,1471
4,3104,10,100,0.0001,0.01,0.508,1578,1526
4,3204,10,100,0.0001,0.01,0.518,1628,1576
4,3304,10,100,0.0001,0.01,0.51,1681,1623
4,3404,10,100,0.0001,0.01,0.546,1735,1669
4,3504,10,100,0.0001,0.01,0.55,1786,1718
4,3604,10,100,0.0001,0.01,0.564,1835,1769
4,3704,10,100,0.0001,0.01,0.564,1886,1818
4,3804,10,100,0.0001,0.01,0.548,1933,1871
4,3904,10,100,0.0001,0.01,0.57,1993,1911
4,4004,10,100,0.0001,0.01,0.55,2039,1965
4,4104,10,100,0.0001,0.01,0.55,2087,2017
4,4204,10,100,0.0001,0.01,0.54,2132,2072
4,4304,10,100,0.0001,0.01,0.57,2176,2128
4,4404,10,100,0.0001,0.01,0.576,2220,2184
4,4504,10,100,0.0001,0.01,0.56,2272,2232
4,4604,10,100,0.0001,0.01,0.588,2317,2287
4,4704,10,100,0.0001,0.01,0.592,2361,2343
4,4804,10,100,0.0001,0.01,0.588,2423,2381
4,4904,10,100,0.0001,0.01,0.592,2482,2422
4,5004,10,100,0.0001,0.01,0.582,2534,2470
4,5104,10,100,0.0001,0.01,0.582,2586,2518
4,5204,10,100,0.0001,0.01,0.586,2629,2575
4,5304,10,100,0.0001,0.01,0.59,2678,2626
4,5404,10,100,0.0001,0.01,0.582,2730,2674
4,5504,10,100,0.0001,0.01,0.586,2780,2724
4,5604,10,100,0.0001,0.01,0.632,2831,2773
4,5704,10,100,0.0001,0.01,0.602,2885,2819
4,5804,10,100,0.0001,0.01,0.602,2933,2871
4,5904,10,100,0.0001,0.01,0.62,2979,2925
4,6004,10,100,0.0001,0.01,0.622,3030,2974
4,6104,10,100,0.0001,0.01,0.594,3083,3021
4,6204,10,100,0.0001,0.01,0.624,3136,3068
4,6304,10,100,0.0001,0.01,0.636,3187,3117
4,6404,10,100,0.0001,0.01,0.64,3244,3160
4,6504,10,100,0.0001,0.01,0.616,3296,3208
4,6604,10,100,0.0001,0.01,0.616,3348,3256
4,6704,10,100,0.0001,0.01,0.638,3396,3308
4,6804,10,100,0.0001,0.01,0.65,3454,3350
4,6904,10,100,0.0001,0.01,0.646,3504,3400
4,7004,10,100,0.0001,0.01,0.674,3555,3449
4,7104,10,100,0.0001,0.01,0.612,3609,3495
4,7204,10,100,0.0001,0.01,0.662,3663,3541
4,7304,10,100,0.0001,0.01,0.634,3713,3591
4,7404,10,100,0.0001,0.01,0.642,3765,3639
4,7504,10,100,0.0001,0.01,0.666,3813,3691
4,7604,10,100,0.0001,0.01,0.68,3865,3739
4,7704,10,100,0.0001,0.01,0.662,3911,3793
4,7804,10,100,0.0001,0.01,0.674,3962,3842
4,7904,10,100,0.0001,0.01,0.682,4009,3895
4,8004,10,100,0.0001,0.01,0.698,4063,3941
4,8104,10,100,0.0001,0.01,0.692,4114,3990
4,8204,10,100,0.0001,0.01,0.7,4170,4034
4,8304,10,100,0.0001,0.01,0.712,4218,4086
4,8404,10,100,0.0001,0.01,0.718,4264,4140
4,8504,10,100,0.0001,0.01,0.72,4313,4191
4,8604,10,100,0.0001,0.01,0.684,4358,4246
4,8704,10,100,0.0001,0.01,0.67,4409,4295
4,8804,10,100,0.0001,0.01,0.702,4453,4351
4,8904,10,100,0.0001,0.01,0.702,4499,4405
4,9004,10,100,0.0001,0.01,0.714,4547,4457
4,9104,10,100,0.0001,0.01,0.716,4601,4503
4,9204,10,100,0.0001,0.01,0.722,4648,4556
4,9304,10,100,0.0001,0.01,0.73,4695,4609
4,9404,10,100,0.0001,0.01,0.71,4743,4661
4,9504,10,100,0.0001,0.01,0.702,4786,4718
4,9604,10,100,0.0001,0.01,0.716,4834,4770
4,9704,10,100,0.0001,0.01,0.702,4878,4826
4,9804,10,100,0.0001,0.01,0.7,4932,4872
4,9904,10,100,0.0001,0.01,0.722,4980,4924
4,10004,10,100,0.0001,0.01,0.702,5035,4969
4,10104,10,100,0.0001,0.01,0.712,5081,5023
4,10204,10,100,0.0001,0.01,0.726,5135,5069
4,10304,10,100,0.0001,0.01,0.756,5185,5119
4,10404,10,100,0.0001,0.01,0.748,5234,5170
4,10504,10,100,0.0001,0.01,0.738,5280,5224
4,10604,10,100,0.0001,0.01,0.738,5321,5283
4,10704,10,100,0.0001,0.01,0.74,5364,5340
4,10804,10,100,0.0001,0.01,0.74,5418,5386
4,10904,10,100,0.0001,0.01,0.734,5457,5447
4,11004,10,100,0.0001,0.01,0.754,5504,5500
4,11104,10,100,0.0001,0.01,0.75,5556,5548
4,11204,10,100,0.0001,0.01,0.724,5604,5600
4,11304,10,100,0.0001,0.01,0.736,5654,5650
4,11404,10,100,0.0001,0.01,0.762,5705,5699
4,11504,10,100,0.0001,0.01,0.762,5750,5754
4,11604,10,100,0.0001,0.01,0.766,5790,5814
4,11704,10,100,0.0001,0.01,0.762,5840,5864
4,11804,10,100,0.0001,0.01,0.76,5888,5916
4,11904,10,100,0.0001,0.01,0.744,5935,5969
4,12004,10,100,0.0001,0.01,0.756,5988,6016
4,12104,10,100,0.0001,0.01,0.762,6038,6066
4,12204,10,100,0.0001,0.01,0.75,6086,6118
4,12304,10,100,0.0001,0.01,0.776,6135,6169
4,12404,10,100,0.0001,0.01,0.766,6190,6214
4,12504,10,100,0.0001,0.01,0.778,6249,6255
4,12604,10,100,0.0001,0.01,0.776,6298,6306
4,12704,10,100,0.0001,0.01,0.76,6348,6356
4,12804,10,100,0.0001,0.01,0.756,6399,6405
4,12904,10,100,0.0001,0.01,0.77,6448,6456
4,13004,10,100,0.0001,0.01,0.76,6496,6508
4,13104,10,100,0.0001,0.01,0.79,6559,6545
4,13204,10,100,0.0001,0.01,0.77,6604,6600
4,13304,10,100,0.0001,0.01,0.792,6651,6653
4,13404,10,100,0.0001,0.01,0.796,6703,6701
4,13504,10,100,0.0001,0.01,0.814,6755,6749
4,13604,10,100,0.0001,0.01,0.772,6811,6793
4,13704,10,100,0.0001,0.01,0.78,6862,6842
4,13804,10,100,0.0001,0.01,0.802,6917,6887
4,13904,10,100,0.0001,0.01,0.814,6964,6940
4,14004,10,100,0.0001,0.01,0.806,7016,6988
4,14104,10,100,0.0001,0.01,0.782,7067,7037
4,14204,10,100,0.0001,0.01,0.786,7107,7097
4,14304,10,100,0.0001,0.01,0.8,7145,7159
4,14404,10,100,0.0001,0.01,0.824,7198,7206
4,14504,10,100,0.0001,0.01,0.804,7238,7266
4,14604,10,100,0.0001,0.01,0.812,7288,7316
4,14704,10,100,0.0001,0.01,0.816,7355,7349
4,14804,10,100,0.0001,0.01,0.826,7401,7403
4,14904,10,100,0.0001,0.01,0.806,7454,7450
4,15004,10,100,0.0001,0.01,0.844,7497,7507
5,104,10,100,0.0001,0.01,0.512,52,52
5,204,10,100,0.0001,0.01,0.48,101,103
5,304,10,100,0.0001,0.01,0.48,152,152
5,404,10,100,0.0001,0.01,0.502,194,210
5,504,10,100,0.0001,0.01,0.488,244,260
5,604,10,100,0.0001,0.01,0.504,292,312
5,704,10,100,0.0001,0.01,0.498,345,359
5,804,10,100,0.0001,0.01,0.526,398,406
5,904,10,100,0.0001,0.01,0.544,451,453
5,1004,10,100,0.0001,0.01,0.516,502,502
5,1104,10,100,0.0001,0.01,0.536,558,546
5,1204,10,100,0.0001,0.01,0.514,606,598
5,1304,10,100,0.0001,0.01,0.524,659,645
5,1404,10,100,0.0001,0.01,0.538,712,692
5,1504,10,100,0.0001,0.01,0.532,763,741
5,1604,10,100,0.0001,0.01,0.494,817,787
5,1704,10,100,0.0001,0.01,0.516,869,835
5,1804,10,100,0.0001,0.01,0.544,920,884
5,1904,10,100,0.0001,0.01,0.52,975,929
5,2004,10,100,0.0001,0.01,0.51,1028,976
5,2104,10,100,0.0001,0.01,0.484,1078,1026
5,2204,10,100,0.0001,0.01,0.52,1131,1073
5,2304,10,100,0.0001,0.01,0.522,1187,1117
5,2404,10,100,0.0001,0.01,0.512,1239,1165
5,2504,10,100,0.0001,0.01,0.506,1286,1218
5,2604,10,100,0.0001,0.01,0.544,1338,1266
5,2704,10,100,0.0001,0.01,0.532,1389,1315
5,2804,10,100,0.0001,0.01,0.538,1444,1360
5,2904,10,100,0.0001,0.01,0.558,1495,1409
5,3004,10,100,0.0001,0.01,0.528,1552,1452
5,3104,10,100,0.0001,0.01,0.548,1606,1498
5,3204,10,100,0.0001,0.01,0.534,1653,1551
5,3304,10,100,0.0001,0.01,0.52,1703,1601
5,3404,10,100,0.0001,0.01,0.536,1746,1658
5,3504,10,100,0.0001,0.01,0.556,1794,1710
5,3604,10,100,0.0001,0.01,0.588,1836,1768
5,3704,10,100,0.0001,0.01,0.574,1887,1817
5,3804,10,100,0.0001,0.01,0.554,1938,1866
5,3904,10,100,0.0001,0.01,0.558,1986,1918
5,4004,10,100,0.0001,0.01,0.606,2041,1963
5,4104,10,100,0.0001,0.01,0.59,2091,2013
5,4204,10,100,0.0001,0.01,0.596,2139,2065
5,4304,10,100,0.0001,0.01,0.576,2180,2124
5,4404,10,100,0.0001,0.01,0.6,2230,2174
5,4504,10,100,0.0001,0.01,0.634,2281,2223
5,4604,10,100,0.0001,0.01,0.62,2328,2276
5,4704,10,100,0.0001,0.01,0.622,2379,2325
5,4804,10,100,0.0001,0.01,0.662,2439,2365
5,4904,10,100,0.0001,0.01,0.678,2488,2416
5,5004,10,100,0.0001,0.01,0.654,2543,2461
5,5104,10,100,0.0001,0.01,0.68,2600,2504
5,5204,10,100,0.0001,0.01,0.674,2643,2561
5,5304,10,100,0.0001,0.01,0.666,2695,2609
5,5404,10,100,0.0001,0.01,0.672,2745,2659
5,5504,10,100,0.0001,0.01,0.682,2801,2703
5,5604,10,100,0.0001,0.01,0.698,2851,2753
5,5704,10,100,0.0001,0.01,0.71,2899,2805
5,5804,10,100,0.0001,0.01,0.702,2951,2853
5,5904,10,100,0.0001,0.01,0.68,2994,2910
5,6004,10,100,0.0001,0.01,0.688,3040,2964
5,6104,10,100,0.0001,0.01,0.692,3088,3016
5,6204,10,100,0.0001,0.01,0.704,3141,3063
5,6304,10,100,0.0001,0.01,0.714,3184,3120
5,6404,10,100,0.0001,0.01,0.742,3236,3168
5,6504,10,100,0.0001,0.01,0.732,3280,3224
5,6604,10,100,0.0001,0.01,0.742,3341,3263
5,6704,10,100,0.0001,0.01,0.758,3396,3308
5,6804,10,100,0.0001,0.01,0.762,3445,3359
5,6904,10,100,0.0001,0.01,0.736,3501,3403
5,7004,10,100,0.0001,0.01,0.758,3540,3464
5,7104,10,100,0.0001,0.01,0.77,3584,3520
5,7204,10,100,0.0001,0.01,0.796,3630,3574
5,7304,10,100,0.0001,0.01,0.796,3677,3627
5,7404,10,100,0.0001,0.01,0.782,3726,3678
5,7504,10,100,0.0001,0.01,0.786,3779,3725
5,7604,10,100,0.0001,0.01,0.788,3830,3774
5,7704,10,100,0.0001,0.01,0.82,3879,3825
5,7804,10,100,0.0001,0.01,0.8,3921,3883
5,7904,10,100,0.0001,0.01,0.814,3969,3935
5,8004,10,100,0.0001,0.01,0.814,4027,3977
5,8104,10,100,0.0001,0.01,0.81,4077,4027
5,8204,10,100,0.0001,0.01,0.816,4126,4078
5,8304,10,100,0.0001,0.01,0.81,4177,4127
5,8404,10,100,0.0001,0.01,0.818,4219,4185
5,8504,10,100,0.0001,0.01,0.812,4267,4237
5,8604,10,100,0.0001,0.01,0.828,4319,4285
5,8704,10,100,0.0001,0.01,0.784,4370,4334
5,8804,10,100,0.0001,0.01,0.828,4423,4381
5,8904,10,100,0.0001,0.01,0.832,4471,4433
5,9004,10,100,0.0001,0.01,0.852,4524,4480
5,9104,10,100,0.0001,0.01,0.848,4572,4532
5,9204,10,100,0.0001,0.01,0.834,4625,4579
5,9304,10,100,0.0001,0.01,0.858,4667,4637
5,9404,10,100,0.0001,0.01,0.856,4716,4688
5,9504,10,100,0.0001,0.01,0.854,4772,4732
5,9604,10,100,0.0001,0.01,0.84,4827,4777
5,9704,10,100,0.0001,0.01,0.842,4876,4828
5,9804,10,100,0.0001,0.01,0.854,4926,4878
5,9904,10,100,0.0001,0.01,0.824,4977,4927
5,10004,10,100,0.0001,0.01,0.848,5029,4975
5,10104,10,100,0.0001,0.01,0.808,5082,5022
5,10204,10,100,0.0001,0.01,0.86,5133,5071
5,10304,10,100,0.0001,0.01,0.858,5190,5114
5,10404,10,100,0.0001,0.01,0.846,5236,5168
5,10504,10,100,0.0001,0.01,0.864,5280,5224
5,10604,10,100,0.0001,0.01,0.862,5328,5276
5,10704,10,100,0.0001,0.01,0.854,5378,5326
5,10804,10,100,0.0001,0.01,0.89,5431,5373
5,10904,10,100,0.0001,0.01,0.892,5479,5425
5,11004,10,100,0.0001,0.01,0.9,5531,5473
5,11104,10,100,0.0001,0.01,0.876,5580,5524
5,11204,10,100,0.0001,0.01,0.868,5632,5572
5,11304,10,100,0.0001,0.01,0.904,5682,5622
5,11404,10,100,0.0001,0.01,0.884,5735,5669
5,11504,10,100,0.0001,0.01,0.868,5794,5710
5,11604,10,100,0.0001,0.01,0.886,5848,5756
5,11704,10,100,0.0001,0.01,0.894,5893,5811
5,11804,10,100,0.0001,0.01,0.904,5943,5861
5,11904,10,100,0.0001,0.01,0.904,5994,5910
5,12004,10,100,0.0001,0.01,0.898,6036,5968
5,12104,10,100,0.0001,0.01,0.89,6089,6015
5,12204,10,100,0.0001,0.01,0.914,6129,6075
5,12304,10,100,0.0001,0.01,0.912,6173,6131
5,12404,10,100,0.0001,0.01,0.92,6215,6189
5,12504,10,100,0.0001,0.01,0.914,6258,6246
5,12604,10,100,0.0001,0.01,0.924,6307,6297
5,12704,10,100,0.0001,0.01,0.91,6356,6348
5,12804,10,100,0.0001,0.01,0.904,6404,6400
5,12904,10,100,0.0001,0.01,0.922,6453,6451
5,13004,10,100,0.0001,0.01,0.914,6507,6497
5,13104,10,100,0.0001,0.01,0.92,6562,6542
5,13204,10,100,0.0001,0.01,0.934,6612,6592
5,13304,10,100,0.0001,0.01,0.922,6655,6649
5,13404,10,100,0.0001,0.01,0.928,6704,6700
5,13504,10,100,0.0001,0.01,0.93,6753,6751
5,13604,10,100,0.0001,0.01,0.938,6799,6805
5,13704,10,100,0.0001,0.01,0.934,6854,6850
5,13804,10,100,0.0001,0.01,0.932,6903,6901
5,13904,10,100,0.0001,0.01,0.938,6958,6946
5,14004,10,100,0.0001,0.01,0.94,7003,7001
5,14104,10,100,0.0001,0.01,0.952,7056,7048
5,14204,10,100,0.0001,0.01,0.95,7103,7101
5,14304,10,100,0.0001,0.01,0.946,7156,7148
5,14404,10,100,0.0001,0.01,0.944,7201,7203
5,14504,10,100,0.0001,0.01,0.946,7259,7245
5,14604,10,100,0.0001,0.01,0.954,7311,7293
5,14704,10,100,0.0001,0.01,0.958,7361,7343
5,14804,10,100,0.0001,0.01,0.972,7410,7394
5,14904,10,100,0.0001,0.01,0.956,7464,7440
5,15004,10,100,0.0001,0.01,0.97,7508,7496
6,104,10,100,0.0001,0.01,0.494,53,51
6,204,10,100,0.0001,0.01,0.524,100,104
6,304,10,100,0.0001,0.01,0.504,156,148
6,404,10,100,0.0001,0.01,0.494,211,193
6,504,10,100,0.0001,0.01,0.504,259,245
6,604,10,100,0.0001,0.01,0.516,309,295
6,704,10,100,0.0001,0.01,0.53,359,345
6,804,10,100,0.0001,0.01,0.54,410,394
6,904,10,100,0.0001,0.01,0.558,457,447
6,1004,10,100,0.0001,0.01,0.544,503,501
6,1104,10,100,0.0001,0.01,0.522,545,559
6,1204,10,100,0.0001,0.01,0.542,590,614
6,1304,10,100,0.0001,0.01,0.518,631,673
6,1404,10,100,0.0001,0.01,0.496,685,719
6,1504,10,100,0.0001,0.01,0.538,739,765
6,1604,10,100,0.0001,0.01,0.532,789,815
6,1704,10,100,0.0001,0.01,0.512,838,866
6,1804,10,100,0.0001,0.01,0.536,900,904
6,1904,10,100,0.0001,0.01,0.516,951,953
6,2004,10,100,0.0001,0.01,0.508,995,1009
6,2104,10,100,0.0001,0.01,0.516,1049,1055
6,2204,10,100,0.0001,0.01,0.54,1087,1117
6,2304,10,100,0.0001,0.01,0.552,1140,1164
6,2404,10,100,0.0001,0.01,0.548,1197,1207
6,2504,10,100,0.0001,0.01,0.538,1242,1262
6,2604,10,100,0.0001,0.01,0.496,1285,1319
6,2704,10,100,0.0001,0.01,0.506,1344,1360
6,2804,10,100,0.0001,0.01,0.484,1388,1416
6,2904,10,100,0.0001,0.01,0.516,1436,1468
6,3004,10,100,0.0001,0.01,0.47,1476,1528
6,3104,10,100,0.0001,0.01,0.51,1520,1584
6,3204,10,100,0.0001,0.01,0.522,1573,1631
6,3304,10,100,0.0001,0.01,0.5,1628,1676
6,3404,10,100,0.0001,0.01,0.522,1674,1730
6,3504,10,100,0.0001,0.01,0.486,1729,1775
6,3604,10,100,0.0001,0.01,0.516,1775,1829
6,3704,10,100,0.0001,0.01,0.528,1831,1873
6,3804,10,100,0.0001,0.01,0.528,1887,1917
6,3904,10,100,0.0001,0.01,0.484,1932,1972
6,4004,10,100,0.0001,0.01,0.538,1983,2021
6,4104,10,100,0.0001,0.01,0.498,2037,2067
6,4204,10,100,0.0001,0.01,0.514,2080,2124
6,4304,10,100,0.0001,0.01,0.518,2129,2175
6,4404,10,100,0.0001,0.01,0.504,2171,2233
6,4504,10,100,0.0001,0.01,0.506,2226,2278
6,4604,10,100,0.0001,0.01,0.532,2274,2330
6,4704,10,100,0.0001,0.01,0.484,2326,2378
6,4804,10,100,0.0001,0.01,0.524,2385,2419
6,4904,10,100,0.0001,0.01,0.498,2429,2475
6,5004,10,100,0.0001,0.01,0.52,2479,2525
6,5104,10,100,0.0001,0.01,0.526,2527,2577
6,5204,10,100,0.0001,0.01,0.484,2577,2627
6,5304,10,100,0.0001,0.01,0.528,2627,2677
6,5404,10,100,0.0001,0.01,0.506,2680,2724
6,5504,10,100,0.0001,0.01,0.53,2731,2773
6,5604,10,100,0.0001,0.01,0.502,2782,2822
6,5704,10,100,0.0001,0.01,0.556,2828,2876
6,5804,10,100,0.0001,0.01,0.524,2878,2926
6,5904,10,100,0.0001,0.01,0.508,2930,2974
6,6004,10,100,0.0001,0.01,0.548,2986,3018
6,6104,10,100,0.0001,0.01,0.536,3040,3064
6,6204,10,100,0.0001,0.01,0.552,3098,3106
6,6304,10,100,0.0001,0.01,0.532,3153,3151
6,6404,10,100,0.0001,0.01,0.536,3203,3201
6,6504,10,100,0.0001,0.01,0.568,3252,3252
6,6604,10,100,0.0001,0.01,0.56,3297,3307
6,6704,10,100,0.0001,0.01,0.544,3349,3355
6,6804,10,100,0.0001,0.01,0.564,3403,3401
6,6904,10,100,0.0001,0.01,0.578,3443,3461
6,7004,10,100,0.0001,0.01,0.578,3495,3509
6,7104,10,100,0.0001,0.01,0.594,3543,3561
6,7204,10,100,0.0001,0.01,0.63,3590,3614
6,7304,10,100,0.0001,0.01,0.592,3643,3661
6,7404,10,100,0.0001,0.01,0.614,3691,3713
6,7504,10,100,0.0001,0.01,0.6,3728,3776
6,7604,10,100,0.0001,0.01,0.626,3774,3830
6,7704,10,100,0.0001,0.01,0.624,3826,3878
6,7804,10,100,0.0001,0.01,0.616,3878,3926
6,7904,10,100,0.0001,0.01,0.6,3927,3977
6,8004,10,100,0.0001,0.01,0.632,3963,4041
6,8104,10,100,0.0001,0.01,0.614,4009,4095
6,8204,10,100,0.0001,0.01,0.636,4069,4135
6,8304,10,100,0.0001,0.01,0.648,4123,4181
6,8404,10,100,0.0001,0.01,0.668,4177,4227
6,8504,10,100,0.0001,0.01,0.638,4225,4279
6,8604,10,100,0.0001,0.01,0.662,4276,4328
6,8704,10,100,0.0001,0.01,0.684,4327,4377
6,8804,10,100,0.0001,0.01,0.68,4378,4426
6,8904,10,100,0.0001,0.01,0.678,4423,4481
6,9004,10,100,0.0001,0.01,0.694,4478,4526
6,9104,10,100,0.0001,0.01,0.678,4535,4569
6,9204,10,100,0.0001,0.01,0.696,4587,4617
6,9304,10,100,0.0001,0.01,0.682,4633,4671
6,9404,10,100,0.0001,0.01,0.69,4683,4721
6,9504,10,100,0.0001,0.01,0.656,4738,4766
6,9604,10,100,0.0001,0.01,0.696,4787,4817
6,9704,10,100,0.0001,0.01,0.692,4830,4874
6,9804,10,100,0.0001,0.01,0.69,4892,4912
6,9904,10,100,0.0001,0.01,0.71,4944,4960
6,10004,10,100,0.0001,0.01,0.726,4985,5019
6,10104,10,100,0.0001,0.01,0.702,5035,5069
6,10204,10,100,0.0001,0.01,0.706,5082,5122
6,10304,10,100,0.0001,0.01,0.698,5138,5166
6,10404,10,100,0.0001,0.01,0.688,5193,5211
6,10504,10,100,0.0001,0.01,0.71,5235,5269
6,10604,10,100,0.0001,0.01,0.718,5281,5323
6,10704,10,100,0.0001,0.01,0.71,5333,5371
6,10804,10,100,0.0001,0.01,0.72,5390,5414
6,10904,10,100,0.0001,0.01,0.72,5439,5465
6,11004,10,100,0.0001,0.01,0.722,5496,5508
6,11104,10,100,0.0001,0.01,0.712,5550,5554
6,11204,10,100,0.0001,0.01,0.752,5594,5610
6,11304,10,100,0.0001,0.01,0.732,5646,5658
6,11404,10,100,0.0001,0.01,0.736,5693,5711
6,11504,10,100,0.0001,0.01,0.734,5736,5768
6,11604,10,100,0.0001,0.01,0.74,5787,5817
6,11704,10,100,0.0001,0.01,0.756,5847,5857
6,11804,10,100,0.0001,0.01,0.728,5898,5906
6,11904,10,100,0.0001,0.01,0.746,5942,5962
6,12004,10,100,0.0001,0.01,0.76,5994,6010
6,12104,10,100,0.0001,0.01,0.746,6041,6063
6,12204,10,100,0.0001,0.01,0.758,6094,6110
6,12304,10,100,0.0001,0.01,0.776,6143,6161
6,12404,10,100,0.0001,0.01,0.78,6197,6207
6,12504,10,100,0.0001,0.01,0.77,6246,6258
6,12604,10,100,0.0001,0.01,0.774,6297,6307
6,12704,10,100,0.0001,0.01,0.774,6337,6367
6,12804,10,100,0.0001,0.01,0.756,6387,6417
6,12904,10,100,0.0001,0.01,0.796,6439,6465
6,13004,10,100,0.0001,0.01,0.8,6494,6510
6,13104,10,100,0.0001,0.01,0.798,6548,6556
6,13204,10,100,0.0001,0.01,0.802,6606,6598
6,13304,10,100,0.0001,0.01,0.776,6660,6644
6,13404,10,100,0.0001,0.01,0.794,6703,6701
6,13504,10,100,0.0001,0.01,0.808,6756,6748
6,13604,10,100,0.0001,0.01,0.788,6814,6790
6,13704,10,100,0.0001,0.01,0.796,6863,6841
6,13804,10,100,0.0001,0.01,0.82,6906,6898
6,13904,10,100,0.0001,0.01,0.808,6955,6949
6,14004,10,100,0.0001,0.01,0.812,7010,6994
6,14104,10,100,0.0001,0.01,0.794,7059,7045
6,14204,10,100,0.0001,0.01,0.798,7106,7098
6,14304,10,100,0.0001,0.01,0.778,7156,7148
6,14404,10,100,0.0001,0.01,0.812,7212,7192
6,14504,10,100,0.0001,0.01,0.798,7269,7235
6,14604,10,100,0.0001,0.01,0.802,7313,7291
6,14704,10,100,0.0001,0.01,0.814,7363,7341
6,14804,10,100,0.0001,0.01,0.804,7412,7392
6,14904,10,100,0.0001,0.01,0.814,7460,7444
6,15004,10,100,0.0001,0.01,0.826,7505,7499
7,104,10,100,0.0001,0.01,0.542,52,52
7,204,10,100,0.0001,0.01,0.522,95,109
7,304,10,100,0.0001,0.01,0.534,140,164
7,404,10,100,0.0001,0.01,0.516,193,211
7,504,10,100,0.0001,0.01,0.51,242,262
7,604,10,100,0.0001,0.01,0.52,295,309
7,704,10,100,0.0001,0.01,0.516,346,358
7,804,10,100,0.0001,0.01,0.536,389,415
7,904,10,100,0.0001,0.01,0.52,441,463
7,1004,10,100,0.0001,0.01,0.506,492,512
7,1104,10,100,0.0001,0.01,0.49,537,567
7,1204,10,100,0.0001,0.01,0.482,580,624
7,1304,10,100,0.0001,0.01,0.5,634,670
7,1404,10,100,0.0001,0.01,0.528,693,711
7,1504,10,100,0.0001,0.01,0.484,745,759
7,1604,10,100,0.0001,0.01,0.492,799,805
7,1704,10,100,0.0001,0.01,0.492,847,857
7,1804,10,100,0.0001,0.01,0.474,895,909
7,1904,10,100,0.0001,0.01,0.53,944,960
7,2004,10,100,0.0001,0.01,0.508,992,1012
7,2104,10,100,0.0001,0.01,0.508,1037,1067
7,2204,10,100,0.0001,0.01,0.496,1083,1121
7,2304,10,100,0.0001,0.01,0.49,1131,1173
7,2404,10,100,0.0001,0.01,0.484,1187,1217
7,2504,10,100,0.0001,0.01,0.504,1250,1254
7,2604,10,100,0.0001,0.01,0.502,1302,1302
7,2704,10,100,0.0001,0.01,0.49,1346,1358
7,2804,10,100,0.0001,0.01,0.524,1396,1408
7,2904,10,100,0.0001,0.01,0.502,1439,1465
7,3004,10,100,0.0001,0.01,0.53,1485,1519
7,3104,10,100,0.0001,0.01,0.55,1548,1556
7,3204,10,100,0.0001,0.01,0.502,1594,1610
7,3304,10,100,0.0001,0.01,0.534,1643,1661
7,3404,10,100,0.0001,0.01,0.524,1693,1711
7,3504,10,100,0.0001,0.01,0.548,1738,1766
7,3604,10,100,0.0001,0.01,0.502,1786,1818
7,3704,10,100,0.0001,0.01,0.504,1844,1860
7,3804,10,100,0.0001,0.01,0.548,1899,1905
7,3904,10,100,0.0001,0.01,0.53,1944,1960
7,4004,10,100,0.0001,0.01,0.518,1993,2011
7,4104,10,100,0.0001,0.01,0.516,2049,2055
7,4204,10,100,0.0001,0.01,0.538,2100,2104
7,4304,10,100,0.0001,0.01,0.516,2159,2145
7,4404,10,100,0.0001,0.01,0.512,2210,2194
7,4504,10,100,0.0001,0.01,0.526,2257,2247
7,4604,10,100,0.0001,0.01,0.514,2306,2298
7,4704,10,100,0.0001,0.01,0.506,2356,2348
7,4804,10,100,0.0001,0.01,0.52,2413,2391
7,4904,10,100,0.0001,0.01,0.516,2465,2439
7,5004,10,100,0.0001,0.01,0.516,2508,2496
7,5104,10,100,0.0001,0.01,0.514,2552,2552
7,5204,10,100,0.0001,0.01,0.556,2607,2597
7,5304,10,100,0.0001,0.01,0.526,2661,2643
7,5404,10,100,0.0001,0.01,0.534,2716,2688
7,5504,10,100,0.0001,0.01,0.518,2775,2729
7,5604,10,100,0.0001,0.01,0.526,2815,2789
7,5704,10,100,0.0001,0.01,0.546,2868,2836
7,5804,10,100,0.0001,0.01,0.508,2913,2891
7,5904,10,100,0.0001,0.01,0.524,2966,2938
7,6004,10,100,0.0001,0.01,0.54,3011,2993
7,6104,10,100,0.0001,0.01,0.526,3057,3047
7,6204,10,100,0.0001,0.01,0.518,3099,3105
7,6304,10,100,0.0001,0.01,0.55,3137,3167
7,6404,10,100,0.0001,0.01,0.546,3187,3217
7,6504,10,100,0.0001,0.01,0.534,3235,3269
7,6604,10,100,0.0001,0.01,0.55,3287,3317
7,6704,10,100,0.0001,0.01,0.542,3347,3357
7,6804,10,100,0.0001,0.01,0.54,3400,3404
7,6904,10,100,0.0001,0.01,0.534,3448,3456
7,7004,10,100,0.0001,0.01,0.546,3501,3503
7,7104,10,100,0.0001,0.01,0.55,3557,3547
7,7204,10,100,0.0001,0.01,0.53,3611,3593
7,7304,10,100,0.0001,0.01,0.554,3662,3642
7,7404,10,100,0.0001,0.01,0.558,3717,3687
7,7504,10,100,0.0001,0.01,0.546,3762,3742
7,7604,10,100,0.0001,0.01,0.544,3805,3799
7,7704,10,100,0.0001,0.01,0.578,3855,3849
7,7804,10,100,0.0001,0.01,0.566,3900,3904
7,7904,10,100,0.0001,0.01,0.592,3957,3947
7,8004,10,100,0.0001,0.01,0.596,4012,3992
7,8104,10,100,0.0001,0.01,0.596,4065,4039
7,8204,10,100,0.0001,0.01,0.606,4114,4090
7,8304,10,100,0.0001,0.01,0.574,4165,4139
7,8404,10,100,0.0001,0.01,0.604,4212,4192
7,8504,10,100,0.0001,0.01,0.59,4265,4239
7,8604,10,100,0.0001,0.01,0.622,4320,4284
7,8704,10,100,0.0001,0.01,0.592,4367,4337
7,8804,10,100,0.0001,0.01,0.592,4421,4383
7,8904,10,100,0.0001,0.01,0.602,4467,4437
7,9004,10,100,0.0001,0.01,0.6,4515,4489
7,9104,10,100,0.0001,0.01,0.592,4559,4545
7,9204,10,100,0.0001,0.01,0.606,4607,4597
7,9304,10,100,0.0001,0.01,0.59,4662,4642
7,9404,10,100,0.0001,0.01,0.636,4722,4682
7,9504,10,100,0.0001,0.01,0.614,4770,4734
7,9604,10,100,0.0001,0.01,0.642,4815,4789
7,9704,10,100,0.0001,0.01,0.592,4859,4845
7,9804,10,100,0.0001,0.01,0.614,4913,4891
7,9904,10,100,0.0001,0.01,0.65,4971,4933
7,10004,10,100,0.0001,0.01,0.59,5025,4979
7,10104,10,100,0.0001,0.01,0.616,5080,5024
7,10204,10,100,0.0001,0.01,0.64,5130,5074
7,10304,10,100,0.0001,0.01,0.624,5167,5137
7,10404,10,100,0.0001,0.01,0.632,5215,5189
7,10504,10,100,0.0001,0.01,0.634,5273,5231
7,10604,10,100,0.0001,0.01,0.634,5330,5274
7,10704,10,100,0.0001,0.01,0.66,5382,5322
7,10804,10,100,0.0001,0.01,0.638,5432,5372
7,10904,10,100,0.0001,0.01,0.644,5484,5420
7,11004,10,100,0.0001,0.01,0.666,5537,5467
7,11104,10,100,0.0001,0.01,0.654,5586,5518
7,11204,10,100,0.0001,0.01,0.644,5636,5568
7,11304,10,100,0.0001,0.01,0.652,5685,5619
7,11404,10,100,0.0001,0.01,0.66,5735,5669
7,11504,10,100,0.0001,0.01,0.658,5793,5711
7,11604,10,100,0.0001,0.01,0.64,5842,5762
7,11704,10,100,0.0001,0.01,0.64,5891,5813
7,11804,10,100,0.0001,0.01,0.674,5944,5860
7,11904,10,100,0.0001,0.01,0.652,5991,5913
7,12004,10,100,0.0001,0.01,0.668,6045,5959
7,12104,10,100,0.0001,0.01,0.676,6086,6018
7,12204,10,100,0.0001,0.01,0.664,6137,6067
7,12304,10,100,0.0001,0.01,0.642,6180,6124
7,12404,10,100,0.0001,0.01,0.682,6230,6174
7,12504,10,100,0.0001,0.01,0.668,6283,6221
7,12604,10,100,0.0001,0.01,0.694,6336,6268
7,12704,10,100,0.0001,0.01,0.702,6387,6317
7,12804,10,100,0.0001,0.01,0.686,6427,6377
7,12904,10,100,0.0001,0.01,0.686,6475,6429
7,13004,10,100,0.0001,0.01,0.724,6531,6473
7,13104,10,100,0.0001,0.01,0.696,6581,6523
7,13204,10,100,0.0001,0.01,0.7,6641,6563
7,13304,10,100,0.0001,0.01,0.688,6686,6618
7,13404,10,100,0.0001,0.01,0.692,6740,6664
7,13504,10,100,0.0001,0.01,0.694,6783,6721
7,13604,10,100,0.0001,0.01,0.712,6832,6772
7,13704,10,100,0.0001,0.01,0.718,6881,6823
7,13804,10,100,0.0001,0.01,0.712,6930,6874
7,13904,10,100,0.0001,0.01,0.696,6983,6921
7,14004,10,100,0.0001,0.01,0.716,7034,6970
7,14104,10,100,0.0001,0.01,0.702,7078,7026
7,14204,10,100,0.0001,0.01,0.716,7132,7072
7,14304,10,100,0.0001,0.01,0.736,7180,7124
7,14404,10,100,0.0001,0.01,0.73,7225,7179
7,14504,10,100,0.0001,0.01,0.738,7275,7229
7,14604,10,100,0.0001,0.01,0.714,7326,7278
7,14704,10,100,0.0001,0.01,0.716,7375,7329
7,14804,10,100,0.0001,0.01,0.736,7425,7379
7,14904,10,100,0.0001,0.01,0.734,7466,7438
7,15004,10,100,0.0001,0.01,0.746,7520,7484
8,104,10,100,0.0001,0.01,0.48,52,52
8,204,10,100,0.0001,0.01,0.536,103,101
8,304,10,100,0.0001,0.01,0.536,161,143
8,404,10,100,0.0001,0.01,0.492,211,193
8,504,10,100,0.0001,0.01,0.49,260,244
8,604,10,100,0.0001,0.01,0.492,304,300
8,704,10,100,0.0001,0.01,0.518,359,345
8,804,10,100,0.0001,0.01,0.518,406,398
8,904,10,100,0.0001,0.01,0.502,455,449
8,1004,10,100,0.0001,0.01,0.522,504,500
8,1104,10,100,0.0001,0.01,0.522,561,543
8,1204,10,100,0.0001,0.01,0.516,619,585
8,1304,10,100,0.0001,0.01,0.524,669,635
8,1404,10,100,0.0001,0.01,0.502,722,682
8,1504,10,100,0.0001,0.01,0.538,761,743
8,1604,10,100,0.0001,0.01,0.536,818,786
8,1704,10,100,0.0001,0.01,0.52,871,833
8,1804,10,100,0.0001,0.01,0.526,925,879
8,1904,10,100,0.0001,0.01,0.5,976,928
8,2004,10,100,0.0001,0.01,0.552,1027,977
8,2104,10,100,0.0001,0.01,0.572,1067,1037
8,2204,10,100,0.0001,0.01,0.564,1118,1086
8,2304,10,100,0.0001,0.01,0.544,1179,1125
8,2404,10,100,0.0001,0.01,0.568,1227,1177
8,2504,10,100,0.0001,0.01,0.562,1273,1231
8,2604,10,100,0.0001,0.01,0.568,1318,1286
8,2704,10,100,0.0001,0.01,0.568,1365,1339
8,2804,10,100,0.0001,0.01,0.602,1408,1396
8,2904,10,100,0.0001,0.01,0.534,1460,1444
8,3004,10,100,0.0001,0.01,0.606,1501,1503
8,3104,10,100,0.0001,0.01,0.574,1541,1563
8,3204,10,100,0.0001,0.01,0.582,1587,1617
8,3304,10,100,0.0001,0.01,0.598,1648,1656
8,3404,10,100,0.0001,0.01,0.594,1699,1705
8,3504,10,100,0.0001,0.01,0.62,1744,1760
8,3604,10,100,0.0001,0.01,0.644,1791,1813
8,3704,10,100,0.0001,0.01,0.648,1835,1869
8,3804,10,100,0.0001,0.01,0.674,1884,1920
8,3904,10,100,0.0001,0.01,0.644,1920,1984
8,4004,10,100,0.0001,0.01,0.65,1971,2033
8,4104,10,100,0.0001,0.01,0.694,2026,2078
8,4204,10,100,0.0001,0.01,0.666,2075,2129
8,4304,10,100,0.0001,0.01,0.67,2127,2177
8,4404,10,100,0.0001,0.01,0.662,2181,2223
8,4504,10,100,0.0001,0.01,0.69,2232,2272
8,4604,10,100,0.0001,0.01,0.7,2283,2321
8,4704,10,100,0.0001,0.01,0.714,2335,2369
8,4804,10,100,0.0001,0.01,0.726,2384,2420
8,4904,10,100,0.0001,0.01,0.712,2431,2473
8,5004,10,100,0.0001,0.01,0.728,2484,2520
8,5104,10,100,0.0001,0.01,0.752,2539,2565
8,5204,10,100,0.0001,0.01,0.776,2579,2625
8,5304,10,100,0.0001,0.01,0.774,2615,2689
8,5404,10,100,0.0001,0.01,0.762,2659,2745
8,5504,10,100,0.0001,0.01,0.772,2709,2795
8,5604,10,100,0.0001,0.01,0.786,2756,2848
8,5704,10,100,0.0001,0.01,0.782,2802,2902
8,5804,10,100,0.0001,0.01,0.8,2854,2950
8,5904,10,100,0.0001,0.01,0.778,2905,2999
8,6004,10,100,0.0001,0.01,0.792,2955,3049
8,6104,10,100,0.0001,0.01,0.82,3008,3096
8,6204,10,100,0.0001,0.01,0.82,3055,3149
8,6304,10,100,0.0001,0.01,0.836,3100,3204
8,6404,10,100,0.0001,0.01,0.82,3149,3255
8,6504,10,100,0.0001,0.01,0.852,3210,3294
8,6604,10,100,0.0001,0.01,0.836,3270,3334
8,6704,10,100,0.0001,0.01,0.84,3328,3376
8,6804,10,100,0.0001,0.01,0.828,3372,3432
8,6904,10,100,0.0001,0.01,0.874,3423,3481
8,7004,10,100,0.0001,0.01,0.852,3475,3529
8,7104,10,100,0.0001,0.01,0.862,3530,3574
8,7204,10,100,0.0001,0.01,0.876,3580,3624
8,7304,10,100,0.0001,0.01,0.87,3625,3679
8,7404,10,100,0.0001,0.01,0.884,3667,3737
8,7504,10,100,0.0001,0.01,0.89,3719,3785
8,7604,10,100,0.0001,0.01,0.888,3777,3827
8,7704,10,100,0.0001,0.01,0.886,3833,3871
8,7804,10,100,0.0001,0.01,0.874,3882,3922
8,7904,10,100,0.0001,0.01,0.872,3922,3982
8,8004,10,100,0.0001,0.01,0.886,3980,4024
8,8104,10,100,0.0001,0.01,0.9,4028,4076
8,8204,10,100,0.0001,0.01,0.9,4085,4119
8,8304,10,100,0.0001,0.01,0.878,4140,4164
8,8404,10,100,0.0001,0.01,0.898,4182,4222
8,8504,10,100,0.0001,0.01,0.886,4232,4272
8,8604,10,100,0.0001,0.01,0.908,4287,4317
8,8704,10,100,0.0001,0.01,0.906,4336,4368
8,8804,10,100,0.0001,0.01,0.918,4391,4413
8,8904,10,100,0.0001,0.01,0.88,4450,4454
8,9004,10,100,0.0001,0.01,0.924,4494,4510
8,9104,10,100,0.0001,0.01,0.914,4546,4558
8,9204,10,100,0.0001,0.01,0.92,4595,4609
8,9304,10,100,0.0001,0.01,0.926,4641,4663
8,9404,10,100,0.0001,0.01,0.936,4692,4712
8,9504,10,100,0.0001,0.01,0.936,4749,4755
8,9604,10,100,0.0001,0.01,0.93,4795,4809
8,9704,10,100,0.0001,0.01,0.922,4840,4864
8,9804,10,100,0.0001,0.01,0.934,4891,4913
8,9904,10,100,0.0001,0.01,0.93,4942,4962
8,10004,10,100,0.0001,0.01,0.938,4991,5013
8,10104,10,100,0.0001,0.01,0.942,5044,5060
8,10204,10,100,0.0001,0.01,0.942,5086,5118
8,10304,10,100,0.0001,0.01,0.936,5139,5165
8,10404,10,100,0.0001,0.01,0.948,5188,5216
8,10504,10,100,0.0001,0.01,0.946,5235,5269
8,10604,10,100,0.0001,0.01,0.938,5284,5320
8,10704,10,100,0.0001,0.01,0.942,5325,5379
8,10804,10,100,0.0001,0.01,0.952,5372,5432
8,10904,10,100,0.0001,0.01,0.928,5428,5476
8,11004,10,100,0.0001,0.01,0.946,5468,5536
8,11104,10,100,0.0001,0.01,0.948,5518,5586
8,11204,10,100,0.0001,0.01,0.952,5579,5625
8,11304,10,100,0.0001,0.01,0.966,5633,5671
8,11404,10,100,0.0001,0.01,0.956,5682,5722
8,11504,10,100,0.0001,0.01,0.966,5740,5764
8,11604,10,100,0.0001,0.01,0.96,5785,5819
8,11704,10,100,0.0001,0.01,0.956,5843,5861
8,11804,10,100,0.0001,0.01,0.954,5898,5906
8,11904,10,100,0.0001,0.01,0.95,5950,5954
8,12004,10,100,0.0001,0.01,0.944,6003,6001
8,12104,10,100,0.0001,0.01,0.952,6052,6052
8,12204,10,100,0.0001,0.01,0.968,6100,6104
8,12304,10,100,0.0001,0.01,0.952,6152,6152
8,12404,10,100,0.0001,0.01,0.96,6212,6192
8,12504,10,100,0.0001,0.01,0.972,6251,6253
8,12604,10,100,0.0001,0.01,0.974,6309,6295
8,12704,10,100,0.0001,0.01,0.976,6363,6341
8,12804,10,100,0.0001,0.01,0.974,6414,6390
8,12904,10,100,0.0001,0.01,0.978,6455,6449
8,13004,10,100,0.0001,0.01,0.976,6509,6495
8,13104,10,100,0.0001,0.01,0.966,6551,6553
8,13204,10,100,0.0001,0.01,0.956,6605,6599
8,13304,10,100,0.0001,0.01,0.964,6653,6651
8,13404,10,100,0.0001,0.01,0.954,6702,6702
8,13504,10,100,0.0001,0.01,0.968,6742,6762
8,13604,10,100,0.0001,0.01,0.974,6787,6817
8,13704,10,100,0.0001,0.01,0.978,6838,6866
8,13804,10,100,0.0001,0.01,0.98,6886,6918
8,13904,10,100,0.0001,0.01,0.978,6935,6969
8,14004,10,100,0.0001,0.01,0.98,6983,7021
8,14104,10,100,0.0001,0.01,0.982,7030,7074
8,14204,10,100,0.0001,0.01,0.978,7071,7133
8,14304,10,100,0.0001,0.01,0.978,7126,7178
8,14404,10,100,0.0001,0.01,0.95,7177,7227
8,14504,10,100,0.0001,0.01,0.964,7231,7273
8,14604,10,100,0.0001,0.01,0.972,7278,7326
8,14704,10,100,0.0001,0.01,0.978,7330,7374
8,14804,10,100,0.0001,0.01,0.982,7381,7423
8,14904,10,100,0.0001,0.01,0.98,7427,7477
8,15004,10,100,0.0001,0.01,0.99,7484,7520
9,104,10,100,0.0001,0.01,0.51,52,52
9,204,10,100,0.0001,0.01,0.508,93,111
9,304,10,100,0.0001,0.01,0.514,135,169
9,404,10,100,0.0001,0.01,0.508,180,224
9,504,10,100,0.0001,0.01,0.516,236,268
9,604,10,100,0.0001,0.01,0.496,283,321
9,704,10,100,0.0001,0.01,0.536,331,373
9,804,10,100,0.0001,0.01,0.528,390,414
9,904,10,100,0.0001,0.01,0.524,440,464
9,1004,10,100,0.0001,0.01,0.53,489,515
9,1104,10,100,0.0001,0.01,0.53,541,563
9,1204,10,100,0.0001,0.01,0.554,597,607
9,1304,10,100,0.0001,0.01,0.552,642,662
9,1404,10,100,0.0001,0.01,0.526,689,715
9,1504,10,100,0.0001,0.01,0.52,729,775
9,1604,10,100,0.0001,0.01,0.522,783,821
9,1704,10,100,0.0001,0.01,0.52,829,875
9,1804,10,100,0.0001,0.01,0.534,873,931
9,1904,10,100,0.0001,0.01,0.56,921,983
9,2004,10,100,0.0001,0.01,0.556,974,1030
9,2104,10,100,0.0001,0.01,0.568,1040,1064
9,2204,10,100,0.0001,0.01,0.542,1093,1111
9,2304,10,100,0.0001,0.01,0.58,1136,1168
9,2404,10,100,0.0001,0.01,0.6,1195,1209
9,2504,10,100,0.0001,0.01,0.63,1241,1263
9,2604,10,100,0.0001,0.01,0.626,1290,1314
9,2704,10,100,0.0001,0.01,0.636,1339,1365
9,2804,10,100,0.0001,0.01,0.654,1378,1426
9,2904,10,100,0.0001,0.01,0.656,1433,1471
9,3004,10,100,0.0001,0.01,0.678,1481,1523
9,3104,10,100,0.0001,0.01,0.708,1528,1576
9,3204,10,100,0.0001,0.01,0.692,1584,1620
9,3304,10,100,0.0001,0.01,0.712,1628,1676
9,3404,10,100,0.0001,0.01,0.708,1679,1725
9,3504,10,100,0.0001,0.01,0.764,1730,1774
9,3604,10,100,0.0001,0.01,0.76,1786,1818
9,3704,10,100,0.0001,0.01,0.768,1844,1860
9,3804,10,100,0.0001,0.01,0.786,1898,1906
9,3904,10,100,0.0001,0.01,0.786,1957,1947
9,4004,10,100,0.0001,0.01,0.79,2017,1987
9,4104,10,100,0.0001,0.01,0.808,2063,2041
9,4204,10,100,0.0001,0.01,0.802,2113,2091
9,4304,10,100,0.0001,0.01,0.816,2168,2136
9,4404,10,100,0.0001,0.01,0.82,2220,2184
9,4504,10,100,0.0001,0.01,0.806,2269,2235
9,4604,10,100,0.0001,0.01,0.81,2324,2280
9,4704,10,100,0.0001,0.01,0.802,2381,2323
9,4804,10,100,0.0001,0.01,0.804,2428,2376
9,4904,10,100,0.0001,0.01,0.846,2477,2427
9,5004,10,100,0.0001,0.01,0.86,2536,2468
9,5104,10,100,0.0001,0.01,0.868,2581,2523
9,5204,10,100,0.0001,0.01,0.874,2629,2575
9,5304,10,100,0.0001,0.01,0.858,2692,2612
9,5404,10,100,0.0001,0.01,0.876,2744,2660
9,5504,10,100,0.0001,0.01,0.87,2789,2715
9,5604,10,100,0.0001,0.01,0.882,2843,2761
9,5704,10,100,0.0001,0.01,0.868,2882,2822
9,5804,10,100,0.0001,0.01,0.876,2934,2870
9,5904,10,100,0.0001,0.01,0.858,2986,2918
9,6004,10,100,0.0001,0.01,0.874,3039,2965
9,6104,10,100,0.0001,0.01,0.862,3087,3017
9,6204,10,100,0.0001,0.01,0.87,3138,3066
9,6304,10,100,0.0001,0.01,0.89,3183,3121
9,6404,10,100,0.0001,0.01,0.884,3235,3169
9,6504,10,100,0.0001,0.01,0.9,3282,3222
9,6604,10,100,0.0001,0.01,0.878,3344,3260
9,6704,10,100,0.0001,0.01,0.888,3389,3315
9,6804,10,100,0.0001,0.01,0.904,3437,3367
9,6904,10,100,0.0001,0.01,0.89,3487,3417
9,7004,10,100,0.0001,0.01,0.892,3530,3474
9,7104,10,100,0.0001,0.01,0.906,3582,3522
9,7204,10,100,0.0001,0.01,0.886,3621,3583
9,7304,10,100,0.0001,0.01,0.888,3666,3638
9,7404,10,100,0.0001,0.01,0.888,3715,3689
9,7504,10,100,0.0001,0.01,0.896,3771,3733
9,7604,10,100,0.0001,0.01,0.922,3823,3781
9,7704,10,100,0.0001,0.01,0.912,3866,3838
9,7804,10,100,0.0001,0.01,0.93,3918,3886
9,7904,10,100,0.0001,0.01,0.934,3981,3923
9,8004,10,100,0.0001,0.01,0.926,4030,3974
9,8104,10,100,0.0001,0.01,0.938,4082,4022
9,8204,10,100,0.0001,0.01,0.944,4127,4077
9,8304,10,100,0.0001,0.01,0.928,4179,4125
9,8404,10,100,0.0001,0.01,0.942,4237,4167
9,8504,10,100,0.0001,0.01,0.938,4296,4208
9,8604,10,100,0.0001,0.01,0.934,4342,4262
9,8704,10,100,0.0001,0.01,0.946,4393,4311
9,8804,10,100,0.0001,0.01,0.948,4447,4357
9,8904,10,100,0.0001,0.01,0.932,4495,4409
9,9004,10,100,0.0001,0.01,0.938,4554,4450
9,9104,10,100,0.0001,0.01,0.928,4599,4505
9,9204,10,100,0.0001,0.01,0.942,4648,4556
9,9304,10,100,0.0001,0.01,0.93,4700,4604
9,9404,10,100,0.0001,0.01,0.954,4746,4658
9,9504,10,100,0.0001,0.01,0.936,4794,4710
9,9604,10,100,0.0001,0.01,0.942,4842,4762
9,9704,10,100,0.0001,0.01,0.948,4887,4817
9,9804,10,100,0.0001,0.01,0.95,4928,4876
9,9904,10,100,0.0001,0.01,0.95,4980,4924
9,10004,10,100,0.0001,0.01,0.96,5027,4977
9,10104,10,100,0.0001,0.01,0.95,5077,5027
9,10204,10,100,0.0001,0.01,0.958,5130,5074
9,10304,10,100,0.0001,0.01,0.96,5175,5129
9,10404,10,100,0.0001,0.01,0.958,5215,5189
9,10504,10,100,0.0001,0.01,0.948,5268,5236
9,10604,10,100,0.0001,0.01,0.956,5311,5293
9,10704,10,100,0.0001,0.01,0.962,5355,5349
9,10804,10,100,0.0001,0.01,0.964,5407,5397
9,10904,10,100,0.0001,0.01,0.946,5451,5453
9,11004,10,100,0.0001,0.01,0.946,5504,5500
9,11104,10,100,0.0001,0.01,0.96,5556,5548
9,11204,10,100,0.0001,0.01,0.956,5602,5602
9,11304,10,100,0.0001,0.01,0.96,5653,5651
9,11404,10,100,0.0001,0.01,0.968,5709,5695
9,11504,10,100,0.0001,0.01,0.958,5751,5753
9,11604,10,100,0.0001,0.01,0.954,5799,5805
9,11704,10,100,0.0001,0.01,0.962,5847,5857
9,11804,10,100,0.0001,0.01,0.952,5891,5913
9,11904,10,100,0.0001,0.01,0.954,5928,5976
9,12004,10,100,0.0001,0.01,0.954,5975,6029
9,12104,10,100,0.0001,0.01,0.964,6025,6079
9,12204,10,100,0.0001,0.01,0.964,6079,6125
9,12304,10,100,0.0001,0.01,0.96,6126,6178
9,12404,10,100,0.0001,0.01,0.968,6183,6221
9,12504,10,100,0.0001,0.01,0.96,6232,6272
9,12604,10,100,0.0001,0.01,0.964,6287,6317
9,12704,10,100,0.0001,0.01,0.952,6339,6365
9,12804,10,100,0.0001,0.01,0.958,6397,6407
9,12904,10,100,0.0001,0.01,0.962,6445,6459
9,13004,10,100,0.0001,0.01,0.968,6495,6509
9,13104,10,100,0.0001,0.01,0.978,6547,6557
9,13204,10,100,0.0001,0.01,0.972,6601,6603
9,13304,10,100,0.0001,0.01,0.982,6651,6653
9,13404,10,100,0.0001,0.01,0.972,6704,6700
9,13504,10,100,0.0001,0.01,0.958,6759,6745
9,13604,10,100,0.0001,0.01,0.962,6808,6796
9,13704,10,100,0.0001,0.01,0.972,6855,6849
9,13804,10,100,0.0001,0.01,0.97,6904,6900
9,13904,10,100,0.0001,0.01,0.972,6954,6950
9,14004,10,100,0.0001,0.01,0.964,7002,7002
9,14104,10,100,0.0001,0.01,0.962,7052,7052
9,14204,10,100,0.0001,0.01,0.97,7105,7099
9,14304,10,100,0.0001,0.01,0.978,7150,7154
9,14404,10,100,0.0001,0.01,0.978,7209,7195
9,14504,10,100,0.0001,0.01,0.98,7258,7246
9,14604,10,100,0.0001,0.01,0.988,7312,7292
9,14704,10,100,0.0001,0.01,0.974,7369,7335
9,14804,10,100,0.0001,0.01,0.972,7411,7393
9,14904,10,100,0.0001,0.01,0.978,7462,7442
9,15004,10,100,0.0001,0.01,0.982,7507,7497
10,104,10,100,0.0001,0.01,0.494,53,51
10,204,10,100,0.0001,0.01,0.504,97,107
10,304,10,100,0.0001,0.01,0.472,145,159
10,404,10,100,0.0001,0.01,0.488,199,205
10,504,10,100,0.0001,0.01,0.514,248,256
10,604,10,100,0.0001,0.01,0.486,301,303
10,704,10,100,0.0001,0.01,0.504,356,348
10,804,10,100,0.0001,0.01,0.522,402,402
10,904,10,100,0.0001,0.01,0.492,451,453
10,1004,10,100,0.0001,0.01,0.51,502,502
10,1104,10,100,0.0001,0.01,0.536,558,546
10,1204,10,100,0.0001,0.01,0.494,615,589
10,1304,10,100,0.0001,0.01,0.498,655,649
10,1404,10,100,0.0001,0.01,0.514,702,702
10,1504,10,100,0.0001,0.01,0.53,760,744
10,1604,10,100,0.0001,0.01,0.544,820,784
10,1704,10,100,0.0001,0.01,0.544,880,824
10,1804,10,100,0.0001,0.01,0.538,937,867
10,1904,10,100,0.0001,0.01,0.528,978,926
10,2004,10,100,0.0001,0.01,0.544,1030,974
10,2104,10,100,0.0001,0.01,0.532,1080,1024
10,2204,10,100,0.0001,0.01,0.566,1126,1078
10,2304,10,100,0.0001,0.01,0.54,1177,1127
10,2404,10,100,0.0001,0.01,0.592,1225,1179
10,2504,10,100,0.0001,0.01,0.562,1275,1229
10,2604,10,100,0.0001,0.01,0.582,1327,1277
10,2704,10,100,0.0001,0.01,0.584,1376,1328
10,2804,10,100,0.0001,0.01,0.604,1434,1370
10,2904,10,100,0.0001,0.01,0.6,1482,1422
10,3004,10,100,0.0001,0.01,0.622,1528,1476
10,3104,10,100,0.0001,0.01,0.668,1576,1528
10,3204,10,100,0.0001,0.01,0.658,1623,1581
10,3304,10,100,0.0001,0.01,0.69,1678,1626
10,3404,10,100,0.0001,0.01,0.694,1731,1673
10,3504,10,100,0.0001,0.01,0.684,1789,1715
10,3604,10,100,0.0001,0.01,0.684,1845,1759
10,3704,10,100,0.0001,0.01,0.728,1898,1806
10,3804,10,100,0.0001,0.01,0.746,1943,1861
10,3904,10,100,0.0001,0.01,0.716,1990,1914
10,4004,10,100,0.0001,0.01,0.75,2043,1961
10,4104,10,100,0.0001,0.01,0.756,2092,2012
10,4204,10,100,0.0001,0.01,0.722,2148,2056
10,4304,10,100,0.0001,0.01,0.722,2204,2100
10,4404,10,100,0.0001,0.01,0.772,2255,2149
10,4504,10,100,0.0001,0.01,0.728,2306,2198
10,4604,10,100,0.0001,0.01,0.764,2358,2246
10,4704,10,100,0.0001,0.01,0.77,2415,2289
10,4804,10,100,0.0001,0.01,0.794,2462,2342
10,4904,10,100,0.0001,0.01,0.792,2509,2395
10,5004,10,100,0.0001,0.01,0.812,2561,2443
10,5104,10,100,0.0001,0.01,0.81,2615,2489
10,5204,10,100,0.0001,0.01,0.822,2676,2528
10,5304,10,100,0.0001,0.01,0.814,2724,2580
10,5404,10,100,0.0001,0.01,0.828,2767,2637
10,5504,10,100,0.0001,0.01,0.82,2822,2682
10,5604,10,100,0.0001,0.01,0.812,2870,2734
10,5704,10,100,0.0001,0.01,0.83,2922,2782
10,5804,10,100,0.0001,0.01,0.812,2977,2827
10,5904,10,100,0.0001,0.01,0.84,3020,2884
10,6004,10,100,0.0001,0.01,0.82,3071,2933
10,6104,10,100,0.0001,0.01,0.858,3115,2989
10,6204,10,100,0.0001,0.01,0.834,3164,3040
10,6304,10,100,0.0001,0.01,0.842,3210,3094
10,6404,10,100,0.0001,0.01,0.842,3268,3136
10,6504,10,100,0.0001,0.01,0.864,3315,3189
10,6604,10,100,0.0001,0.01,0.868,3364,3240
10,6704,10,100,0.0001,0.01,0.868,3421,3283
10,6804,10,100,0.0001,0.01,0.89,3459,3345
10,6904,10,100,0.0001,0.01,0.882,3514,3390
10,7004,10,100,0.0001,0.01,0.882,3560,3444
10,7104,10,100,0.0001,0.01,0.884,3608,3496
10,7204,10,100,0.0001,0.01,0.886,3656,3548
10,7304,10,100,0.0001,0.01,0.904,3713,3591
10,7404,10,100,0.0001,0.01,0.914,3766,3638
10,7504,10,100,0.0001,0.01,0.9,3814,3690
10,7604,10,100,0.0001,0.01,0.918,3862,3742
10,7704,10,100,0.0001,0.01,0.904,3910,3794
10,7804,10,100,0.0001,0.01,0.896,3957,3847
10,7904,10,100,0.0001,0.01,0.894,4006,3898
10,8004,10,100,0.0001,0.01,0.92,4057,3947
10,8104,10,100,0.0001,0.01,0.908,4097,4007
10,8204,10,100,0.0001,0.01,0.916,4146,4058
10,8304,10,100,0.0001,0.01,0.928,4199,4105
10,8404,10,100,0.0001,0.01,0.942,4248,4156
10,8504,10,100,0.0001,0.01,0.914,4291,4213
10,8604,10,100,0.0001,0.01,0.924,4340,4264
10,8704,10,100,0.0001,0.01,0.91,4396,4308
10,8804,10,100,0.0001,0.01,0.918,4444,4360
10,8904,10,100,0.0001,0.01,0.932,4494,4410
10,9004,10,100,0.0001,0.01,0.944,4538,4466
10,9104,10,100,0.0001,0.01,0.934,4582,4522
10,9204,10,100,0.0001,0.01,0.928,4626,4578
10,9304,10,100,0.0001,0.01,0.91,4671,4633
10,9404,10,100,0.0001,0.01,0.936,4715,4689
10,9504,10,100,0.0001,0.01,0.94,4763,4741
10,9604,10,100,0.0001,0.01,0.952,4817,4787
10,9704,10,100,0.0001,0.01,0.956,4871,4833
10,9804,10,100,0.0001,0.01,0.958,4924,4880
10,9904,10,100,0.0001,0.01,0.954,4970,4934
10,10004,10,100,0.0001,0.01,0.946,5024,4980
10,10104,10,100,0.0001,0.01,0.96,5077,5027
10,10204,10,100,0.0001,0.01,0.958,5126,5078
10,10304,10,100,0.0001,0.01,0.95,5178,5126
10,10404,10,100,0.0001,0.01,0.954,5222,5182
10,10504,10,100,0.0001,0.01,0.968,5275,5229
10,10604,10,100,0.0001,0.01,0.954,5328,5276
10,10704,10,100,0.0001,0.01,0.962,5370,5334
10,10804,10,100,0.0001,0.01,0.964,5423,5381
10,10904,10,100,0.0001,0.01,0.942,5479,5425
10,11004,10,100,0.0001,0.01,0.962,5526,5478
10,11104,10,100,0.0001,0.01,0.942,5566,5538
10,11204,10,100,0.0001,0.01,0.964,5618,5586
10,11304,10,100,0.0001,0.01,0.964,5671,5633
10,11404,10,100,0.0001,0.01,0.978,5720,5684
10,11504,10,100,0.0001,0.01,0.974,5762,5742
10,11604,10,100,0.0001,0.01,0.988,5822,5782
10,11704,10,100,0.0001,0.01,0.978,5861,5843
10,11804,10,100,0.0001,0.01,0.984,5916,5888
10,11904,10,100,0.0001,0.01,0.982,5952,5952
10,12004,10,100,0.0001,0.01,0.98,5995,6009
10,12104,10,100,0.0001,0.01,0.952,6045,6059
10,12204,10,100,0.0001,0.01,0.958,6096,6108
10,12304,10,100,0.0001,0.01,0.97,6139,6165
10,12404,10,100,0.0001,0.01,0.966,6188,6216
10,12504,10,100,0.0001,0.01,0.978,6238,6266
10,12604,10,100,0.0001,0.01,0.962,6296,6308
10,12704,10,100,0.0001,0.01,0.984,6343,6361
10,12804,10,100,0.0001,0.01,0.978,6397,6407
10,12904,10,100,0.0001,0.01,0.988,6454,6450
10,13004,10,100,0.0001,0.01,0.982,6500,6504
10,13104,10,100,0.0001,0.01,0.98,6541,6563
10,13204,10,100,0.0001,0.01,0.99,6588,6616
10,13304,10,100,0.0001,0.01,0.99,6636,6668
10,13404,10,100,0.0001,0.01,0.986,6686,6718
10,13504,10,100,0.0001,0.01,0.98,6736,6768
10,13604,10,100,0.0001,0.01,0.964,6796,6808
10,13704,10,100,0.0001,0.01,0.96,6842,6862
10,13804,10,100,0.0001,0.01,0.974,6887,6917
10,13904,10,100,0.0001,0.01,0.976,6933,6971
10,14004,10,100,0.0001,0.01,0.986,6984,7020
10,14104,10,100,0.0001,0.01,0.988,7042,7062
10,14204,10,100,0.0001,0.01,0.988,7091,7113
10,14304,10,100,0.0001,0.01,0.986,7139,7165
10,14404,10,100,0.0001,0.01,0.984,7188,7216
10,14504,10,100,0.0001,0.01,0.976,7235,7269
10,14604,10,100,0.0001,0.01,0.976,7295,7309
10,14704,10,100,0.0001,0.01,0.978,7342,7362
10,14804,10,100,0.0001,0.01,0.986,7391,7413
10,14904,10,100,0.0001,0.01,0.98,7444,7460
10,15004,10,100,0.0001,0.01,0.982,7501,7503
11,104,10,100,0.0001,0.01,0.484,45,59
11,204,10,100,0.0001,0.01,0.476,99,105
11,304,10,100,0.0001,0.01,0.492,156,148
11,404,10,100,0.0001,0.01,0.518,209,195
11,504,10,100,0.0001,0.01,0.534,259,245
11,604,10,100,0.0001,0.01,0.482,318,286
11,704,10,100,0.0001,0.01,0.488,367,337
11,804,10,100,0.0001,0.01,0.512,421,383
11,904,10,100,0.0001,0.01,0.512,473,431
11,1004,10,100,0.0001,0.01,0.512,524,480
11,1104,10,100,0.0001,0.01,0.516,575,529
11,1204,10,100,0.0001,0.01,0.5,626,578
11,1304,10,100,0.0001,0.01,0.494,679,625
11,1404,10,100,0.0001,0.01,0.53,722,682
11,1504,10,100,0.0001,0.01,0.524,774,730
11,1604,10,100,0.0001,0.01,0.518,816,788
11,1704,10,100,0.0001,0.01,0.536,863,841
11,1804,10,100,0.0001,0.01,0.55,915,889
11,1904,10,100,0.0001,0.01,0.586,973,931
11,2004,10,100,0.0001,0.01,0.552,1018,986
11,2104,10,100,0.0001,0.01,0.582,1058,1046
11,2204,10,100,0.0001,0.01,0.556,1105,1099
11,2304,10,100,0.0001,0.01,0.582,1161,1143
11,2404,10,100,0.0001,0.01,0.578,1210,1194
11,2504,10,100,0.0001,0.01,0.594,1259,1245
11,2604,10,100,0.0001,0.01,0.586,1299,1305
11,2704,10,100,0.0001,0.01,0.596,1351,1353
11,2804,10,100,0.0001,0.01,0.596,1397,1407
11,2904,10,100,0.0001,0.01,0.606,1448,1456
11,3004,10,100,0.0001,0.01,0.606,1499,1505
11,3104,10,100,0.0001,0.01,0.61,1542,1562
11,3204,10,100,0.0001,0.01,0.618,1592,1612
11,3304,10,100,0.0001,0.01,0.634,1644,1660
11,3404,10,100,0.0001,0.01,0.63,1686,1718
11,3504,10,100,0.0001,0.01,0.65,1737,1767
11,3604,10,100,0.0001,0.01,0.628,1783,1821
11,3704,10,100,0.0001,0.01,0.636,1836,1868
11,3804,10,100,0.0001,0.01,0.656,1885,1919
11,3904,10,100,0.0001,0.01,0.692,1939,1965
11,4004,10,100,0.0001,0.01,0.678,1985,2019
11,4104,10,100,0.0001,0.01,0.702,2026,2078
11,4204,10,100,0.0001,0.01,0.724,2072,2132
11,4304,10,100,0.0001,0.01,0.714,2130,2174
11,4404,10,100,0.0001,0.01,0.712,2173,2231
11,4504,10,100,0.0001,0.01,0.734,2229,2275
11,4604,10,100,0.0001,0.01,0.742,2284,2320
11,4704,10,100,0.0001,0.01,0.736,2334,2370
11,4804,10,100,0.0001,0.01,0.738,2387,2417
11,4904,10,100,0.0001,0.01,0.714,2448,2456
11,5004,10,100,0.0001,0.01,0.746,2484,2520
11,5104,10,100,0.0001,0.01,0.742,2530,2574
11,5204,10,100,0.0001,0.01,0.766,2575,2629
11,5304,10,100,0.0001,0.01,0.758,2622,2682
11,5404,10,100,0.0001,0.01,0.756,2676,2728
11,5504,10,100,0.0001,0.01,0.77,2730,2774
11,5604,10,100,0.0001,0.01,0.75,2778,2826
11,5704,10,100,0.0001,0.01,0.766,2834,2870
11,5804,10,100,0.0001,0.01,0.748,2880,2924
11,5904,10,100,0.0001,0.01,0.79,2937,2967
11,6004,10,100,0.0001,0.01,0.782,2983,3021
11,6104,10,100,0.0001,0.01,0.776,3035,3069
11,6204,10,100,0.0001,0.01,0.784,3080,3124
11,6304,10,100,0.0001,0.01,0.792,3130,3174
11,6404,10,100,0.0001,0.01,0.8,3175,3229
11,6504,10,100,0.0001,0.01,0.784,3231,3273
11,6604,10,100,0.0001,0.01,0.788,3280,3324
11,6704,10,100,0.0001,0.01,0.796,3333,3371
11,6804,10,100,0.0001,0.01,0.79,3377,3427
11,6904,10,100,0.0001,0.01,0.802,3426,3478
11,7004,10,100,0.0001,0.01,0.778,3464,3540
11,7104,10,100,0.0001,0.01,0.79,3510,3594
11,7204,10,100,0.0001,0.01,0.782,3563,3641
11,7304,10,100,0.0001,0.01,0.822,3615,3689
11,7404,10,100,0.0001,0.01,0.832,3664,3740
11,7504,10,100,0.0001,0.01,0.82,3709,3795
11,7604,10,100,0.0001,0.01,0.802,3765,3839
11,7704,10,100,0.0001,0.01,0.832,3814,3890
11,7804,10,100,0.0001,0.01,0.834,3870,3934
11,7904,10,100,0.0001,0.01,0.82,3918,3986
11,8004,10,100,0.0001,0.01,0.814,3964,4040
11,8104,10,100,0.0001,0.01,0.818,4016,4088
11,8204,10,100,0.0001,0.01,0.828,4062,4142
11,8304,10,100,0.0001,0.01,0.836,4116,4188
11,8404,10,100,0.0001,0.01,0.846,4167,4237
11,8504,10,100,0.0001,0.01,0.842,4220,4284
11,8604,10,100,0.0001,0.01,0.838,4264,4340
11,8704,10,100,0.0001,0.01,0.856,4319,4385
11,8804,10,100,0.0001,0.01,0.85,4373,4431
11,8904,10,100,0.0001,0.01,0.852,4426,4478
11,9004,10,100,0.0001,0.01,0.842,4475,4529
11,9104,10,100,0.0001,0.01,0.852,4523,4581
11,9204,10,100,0.0001,0.01,0.852,4575,4629
11,9304,10,100,0.0001,0.01,0.844,4622,4682
11,9404,10,100,0.0001,0.01,0.832,4671,4733
11,9504,10,100,0.0001,0.01,0.806,4720,4784
11,9604,10,100,0.0001,0.01,0.836,4775,4829
11,9704,10,100,0.0001,0.01,0.83,4826,4878
11,9804,10,100,0.0001,0.01,0.868,4882,4922
11,9904,10,100,0.0001,0.01,0.854,4940,4964
11,10004,10,100,0.0001,0.01,0.856,4990,5014
11,10104,10,100,0.0001,0.01,0.836,5045,5059
11,10204,10,100,0.0001,0.01,0.864,5095,5109
11,10304,10,100,0.0001,0.01,0.862,5142,5162
11,10404,10,100,0.0001,0.01,0.874,5198,5206
11,10504,10,100,0.0001,0.01,0.876,5251,5253
11,10604,10,100,0.0001,0.01,0.866,5301,5303
11,10704,10,100,0.0001,0.01,0.862,5351,5353
11,10804,10,100,0.0001,0.01,0.888,5404,5400
11,10904,10,100,0.0001,0.01,0.868,5458,5446
11,11004,10,100,0.0001,0.01,0.884,5505,5499
11,11104,10,100,0.0001,0.01,0.884,5561,5543
11,11204,10,100,0.0001,0.01,0.888,5605,5599
11,11304,10,100,0.0001,0.01,0.86,5652,5652
11,11404,10,100,0.0001,0.01,0.91,5705,5699
11,11504,10,100,0.0001,0.01,0.892,5759,5745
11,11604,10,100,0.0001,0.01,0.89,5807,5797
11,11704,10,100,0.0001,0.01,0.896,5849,5855
11,11804,10,100,0.0001,0.01,0.886,5900,5904
11,11904,10,100,0.0001,0.01,0.866,5953,5951
11,12004,10,100,0.0001,0.01,0.882,6003,6001
11,12104,10,100,0.0001,0.01,0.894,6051,6053
11,12204,10,100,0.0001,0.01,0.89,6098,6106
11,12304,10,100,0.0001,0.01,0.882,6148,6156
11,12404,10,100,0.0001,0.01,0.89,6199,6205
11,12504,10,100,0.0001,0.01,0.888,6247,6257
11,12604,10,100,0.0001,0.01,0.902,6306,6298
11,12704,10,100,0.0001,0.01,0.902,6351,6353
11,12804,10,100,0.0001,0.01,0.904,6407,6397
11,12904,10,100,0.0001,0.01,0.882,6450,6454
11,13004,10,100,0.0001,0.01,0.892,6496,6508
11,13104,10,100,0.0001,0.01,0.898,6535,6569
11,13204,10,100,0.0001,0.01,0.906,6582,6622
11,13304,10,100,0.0001,0.01,0.904,6637,6667
11,13404,10,100,0.0001,0.01,0.914,6688,6716
11,13504,10,100,0.0001,0.01,0.89,6732,6772
11,13604,10,100,0.0001,0.01,0.894,6769,6835
11,13704,10,100,0.0001,0.01,0.906,6815,6889
11,13804,10,100,0.0001,0.01,0.89,6870,6934
11,13904,10,100,0.0001,0.01,0.902,6920,6984
11,14004,10,100,0.0001,0.01,0.914,6970,7034
11,14104,10,100,0.0001,0.01,0.918,7016,7088
11,14204,10,100,0.0001,0.01,0.912,7075,7129
11,14304,10,100,0.0001,0.01,0.922,7122,7182
11,14404,10,100,0.0001,0.01,0.93,7180,7224
11,14504,10,100,0.0001,0.01,0.93,7228,7276
11,14604,10,100,0.0001,0.01,0.92,7283,7321
11,14704,10,100,0.0001,0.01,0.922,7332,7372
11,14804,10,100,0.0001,0.01,0.92,7382,7422
11,14904,10,100,0.0001,0.01,0.928,7439,7465
11,15004,10,100,0.0001,0.01,0.92,7494,7510
12,104,10,100,0.0001,0.01,0.53,55,49
12,204,10,100,0.0001,0.01,0.492,112,92
12,304,10,100,0.0001,0.01,0.49,171,133
12,404,10,100,0.0001,0.01,0.508,220,184
12,504,10,100,0.0001,0.01,0.51,271,233
12,604,10,100,0.0001,0.01,0.516,324,280
12,704,10,100,0.0001,0.01,0.48,373,331
12,804,10,100,0.0001,0.01,0.498,417,387
12,904,10,100,0.0001,0.01,0.504,467,437
12,1004,10,100,0.0001,0.01,0.516,517,487
12,1104,10,100,0.0001,0.01,0.508,569,535
12,1204,10,100,0.0001,0.01,0.492,629,575
12,1304,10,100,0.0001,0.01,0.488,681,623
12,1404,10,100,0.0001,0.01,0.506,727,677
12,1504,10,100,0.0001,0.01,0.496,771,733
12,1604,10,100,0.0001,0.01,0.498,819,785
12,1704,10,100,0.0001,0.01,0.53,877,827
12,1804,10,100,0.0001,0.01,0.536,927,877
12,1904,10,100,0.0001,0.01,0.538,970,934
12,2004,10,100,0.0001,0.01,0.534,1017,987
12,2104,10,100,0.0001,0.01,0.518,1063,1041
12,2204,10,100,0.0001,0.01,0.562,1113,1091
12,2304,10,100,0.0001,0.01,0.57,1160,1144
12,2404,10,100,0.0001,0.01,0.578,1211,1193
12,2504,10,100,0.0001,0.01,0.622,1260,1244
12,2604,10,100,0.0001,0.01,0.654,1314,1290
12,2704,10,100,0.0001,0.01,0.67,1362,1342
12,2804,10,100,0.0001,0.01,0.682,1421,1383
12,2904,10,100,0.0001,0.01,0.706,1463,1441
12,3004,10,100,0.0001,0.01,0.754,1508,1496
12,3104,10,100,0.0001,0.01,0.79,1554,1550
12,3204,10,100,0.0001,0.01,0.796,1597,1607
12,3304,10,100,0.0001,0.01,0.828,1639,1665
12,3404,10,100,0.0001,0.01,0.834,1689,1715
12,3504,10,100,0.0001,0.01,0.828,1739,1765
12,3604,10,100,0.0001,0.01,0.858,1796,1808
12,3704,10,100,0.0001,0.01,0.87,1847,1857
12,3804,10,100,0.0001,0.01,0.88,1894,1910
12,3904,10,100,0.0001,0.01,0.888,1941,1963
12,4004,10,100,0.0001,0.01,0.902,1986,2018
12,4104,10,100,0.0001,0.01,0.87,2032,2072
12,4204,10,100,0.0001,0.01,0.908,2074,2130
12,4304,10,100,0.0001,0.01,0.914,2125,2179
12,4404,10,100,0.0001,0.01,0.92,2175,2229
12,4504,10,100,0.0001,0.01,0.92,2215,2289
12,4604,10,100,0.0001,0.01,0.926,2255,2349
12,4704,10,100,0.0001,0.01,0.93,2310,2394
12,4804,10,100,0.0001,0.01,0.94,2355,2449
12,4904,10,100,0.0001,0.01,0.944,2402,2502
12,5004,10,100,0.0001,0.01,0.944,2451,2553
12,5104,10,100,0.0001,0.01,0.956,2508,2596
12,5204,10,100,0.0001,0.01,0.958,2558,2646
12,5304,10,100,0.0001,0.01,0.964,2607,2697
12,5404,10,100,0.0001,0.01,0.972,2655,2749
12,5504,10,100,0.0001,0.01,0.964,2705,2799
12,5604,10,100,0.0001,0.01,0.966,2752,2852
12,5704,10,100,0.0001,0.01,0.964,2803,2901
12,5804,10,100,0.0001,0.01,0.974,2849,2955
12,5904,10,100,0.0001,0.01,0.974,2892,3012
12,6004,10,100,0.0001,0.01,0.972,2946,3058
12,6104,10,100,0.0001,0.01,0.978,2998,3106
12,6204,10,100,0.0001,0.01,0.964,3046,3158
12,6304,10,100,0.0001,0.01,0.956,3105,3199
12,6404,10,100,0.0001,0.01,0.968,3157,3247
12,6504,10,100,0.0001,0.01,0.952,3213,3291
12,6604,10,100,0.0001,0.01,0.952,3256,3348
12,6704,10,100,0.0001,0.01,0.964,3310,3394
12,6804,10,100,0.0001,0.01,0.954,3370,3434
12,6904,10,100,0.0001,0.01,0.962,3424,3480
12,7004,10,100,0.0001,0.01,0.97,3467,3537
12,7104,10,100,0.0001,0.01,0.968,3509,3595
12,7204,10,100,0.0001,0.01,0.97,3561,3643
12,7304,10,100,0.0001,0.01,0.972,3618,3686
12,7404,10,100,0.0001,0.01,0.976,3668,3736
12,7504,10,100,0.0001,0.01,0.976,3721,3783
12,7604,10,100,0.0001,0.01,0.976,3766,3838
12,7704,10,100,0.0001,0.01,0.978,3815,3889
12,7804,10,100,0.0001,0.01,0.982,3862,3942
12,7904,10,100,0.0001,0.01,0.978,3921,3983
12,8004,10,100,0.0001,0.01,0.976,3972,4032
12,8104,10,100,0.0001,0.01,0.982,4022,4082
12,8204,10,100,0.0001,0.01,0.964,4078,4126
12,8304,10,100,0.0001,0.01,0.976,4122,4182
12,8404,10,100,0.0001,0.01,0.972,4171,4233
12,8504,10,100,0.0001,0.01,0.96,4216,4288
12,8604,10,100,0.0001,0.01,0.976,4268,4336
12,8704,10,100,0.0001,0.01,0.976,4323,4381
12,8804,10,100,0.0001,0.01,0.976,4357,4447
12,8904,10,100,0.0001,0.01,0.978,4409,4495
12,9004,10,100,0.0001,0.01,0.98,4459,4545
12,9104,10,100,0.0001,0.01,0.98,4508,4596
12,9204,10,100,0.0001,0.01,0.978,4553,4651
12,9304,10,100,0.0001,0.01,0.982,4606,4698
12,9404,10,100,0.0001,0.01,0.986,4649,4755
12,9504,10,100,0.0001,0.01,0.982,4701,4803
12,9604,10,100,0.0001,0.01,0.98,4755,4849
12,9704,10,100,0.0001,0.01,0.988,4807,4897
12,9804,10,100,0.0001,0.01,0.984,4854,4950
12,9904,10,100,0.0001,0.01,0.982,4906,4998
12,10004,10,100,0.0001,0.01,0.986,4950,5054
12,10104,10,100,0.0001,0.01,0.984,5007,5097
12,10204,10,100,0.0001,0.01,0.99,5063,5141
12,10304,10,100,0.0001,0.01,0.986,5113,5191
12,10404,10,100,0.0001,0.01,0.982,5162,5242
12,10504,10,100,0.0001,0.01,0.984,5218,5286
12,10604,10,100,0.0001,0.01,0.986,5271,5333
12,10704,10,100,0.0001,0.01,0.986,5325,5379
12,10804,10,100,0.0001,0.01,0.984,5370,5434
12,10904,10,100,0.0001,0.01,0.982,5425,5479
12,11004,10,100,0.0001,0.01,0.98,5480,5524
12,11104,10,100,0.0001,0.01,0.984,5536,5568
12,11204,10,100,0.0001,0.01,0.964,5581,5623
12,11304,10,100,0.0001,0.01,0.982,5631,5673
12,11404,10,100,0.0001,0.01,0.984,5678,5726
12,11504,10,100,0.0001,0.01,0.978,5723,5781
12,11604,10,100,0.0001,0.01,0.984,5766,5838
12,11704,10,100,0.0001,0.01,0.986,5809,5895
12,11804,10,100,0.0001,0.01,0.984,5866,5938
12,11904,10,100,0.0001,0.01,0.986,5917,5987
12,12004,10,100,0.0001,0.01,0.984,5970,6034
12,12104,10,100,0.0001,0.01,0.986,6018,6086
12,12204,10,100,0.0001,0.01,0.986,6071,6133
12,12304,10,100,0.0001,0.01,0.986,6121,6183
12,12404,10,100,0.0001,0.01,0.986,6161,6243
12,12504,10,100,0.0001,0.01,0.984,6208,6296
12,12604,10,100,0.0001,0.01,0.986,6259,6345
12,12704,10,100,0.0001,0.01,0.986,6307,6397
12,12804,10,100,0.0001,0.01,0.98,6358,6446
12,12904,10,100,0.0001,0.01,0.986,6414,6490
12,13004,10,100,0.0001,0.01,0.99,6465,6539
12,13104,10,100,0.0001,0.01,0.992,6521,6583
12,13204,10,100,0.0001,0.01,0.996,6569,6635
12,13304,10,100,0.0001,0.01,0.994,6620,6684
12,13404,10,100,0.0001,0.01,0.994,6670,6734
12,13504,10,100,0.0001,0.01,0.994,6716,6788
12,13604,10,100,0.0001,0.01,0.994,6770,6834
12,13704,10,100,0.0001,0.01,0.994,6818,6886
12,13804,10,100,0.0001,0.01,0.996,6867,6937
12,13904,10,100,0.0001,0.01,0.998,6916,6988
12,14004,10,100,0.0001,0.01,0.994,6969,7035
12,14104,10,100,0.0001,0.01,0.992,7026,7078
12,14204,10,100,0.0001,0.01,0.998,7081,7123
12,14304,10,100,0.0001,0.01,0.99,7137,7167
12,14404,10,100,0.0001,0.01,0.988,7188,7216
12,14504,10,100,0.0001,0.01,0.988,7242,7262
12,14604,10,100,0.0001,0.01,0.992,7287,7317
12,14704,10,100,0.0001,0.01,0.99,7332,7372
12,14804,10,100,0.0001,0.01,0.994,7388,7416
12,14904,10,100,0.0001,0.01,0.998,7446,7458
12,15004,10,100,0.0001,0.01,0.992,7505,7499
13,104,10,100,0.0001,0.01,0.5,47,57
13,204,10,100,0.0001,0.01,0.52,108,96
13,304,10,100,0.0001,0.01,0.528,157,147
13,404,10,100,0.0001,0.01,0.49,208,196
13,504,10,100,0.0001,0.01,0.486,259,245
13,604,10,100,0.0001,0.01,0.486,311,293
13,704,10,100,0.0001,0.01,0.478,369,335
13,804,10,100,0.0001,0.01,0.486,418,386
13,904,10,100,0.0001,0.01,0.494,470,434
13,1004,10,100,0.0001,0.01,0.51,523,481
13,1104,10,100,0.0001,0.01,0.488,571,533
13,1204,10,100,0.0001,0.01,0.474,616,588
13,1304,10,100,0.0001,0.01,0.488,656,648
13,1404,10,100,0.0001,0.01,0.496,703,701
13,1504,10,100,0.0001,0.01,0.512,749,755
13,1604,10,100,0.0001,0.01,0.52,806,798
13,1704,10,100,0.0001,0.01,0.496,856,848
13,1804,10,100,0.0001,0.01,0.502,911,893
13,1904,10,100,0.0001,0.01,0.462,960,944
13,2004,10,100,0.0001,0.01,0.498,1020,984
13,2104,10,100,0.0001,0.01,0.498,1068,1036
13,2204,10,100,0.0001,0.01,0.518,1120,1084
13,2304,10,100,0.0001,0.01,0.5,1173,1131
13,2404,10,100,0.0001,0.01,0.502,1225,1179
13,2504,10,100,0.0001,0.01,0.492,1278,1226
13,2604,10,100,0.0001,0.01,0.48,1328,1276
13,2704,10,100,0.0001,0.01,0.478,1381,1323
13,2804,10,100,0.0001,0.01,0.496,1428,1376
13,2904,10,100,0.0001,0.01,0.504,1484,1420
13,3004,10,100,0.0001,0.01,0.506,1531,1473
13,3104,10,100,0.0001,0.01,0.5,1589,1515
13,3204,10,100,0.0001,0.01,0.502,1632,1572
13,3304,10,100,0.0001,0.01,0.476,1685,1619
13,3404,10,100,0.0001,0.01,0.508,1736,1668
13,3504,10,100,0.0001,0.01,0.508,1780,1724
13,3604,10,100,0.0001,0.01,0.518,1830,1774
13,3704,10,100,0.0001,0.01,0.53,1883,1821
13,3804,10,100,0.0001,0.01,0.498,1932,1872
13,3904,10,100,0.0001,0.01,0.494,1982,1922
13,4004,10,100,0.0001,0.01,0.514,2025,1979
13,4104,10,100,0.0001,0.01,0.518,2084,2020
13,4204,10,100,0.0001,0.01,0.486,2140,2064
13,4304,10,100,0.0001,0.01,0.498,2187,2117
13,4404,10,100,0.0001,0.01,0.492,2246,2158
13,4504,10,100,0.0001,0.01,0.52,2296,2208
13,4604,10,100,0.0001,0.01,0.508,2348,2256
13,4704,10,100,0.0001,0.01,0.512,2399,2305
13,4804,10,100,0.0001,0.01,0.48,2446,2358
13,4904,10,100,0.0001,0.01,0.522,2487,2417
13,5004,10,100,0.0001,0.01,0.518,2531,2473
13,5104,10,100,0.0001,0.01,0.52,2586,2518
13,5204,10,100,0.0001,0.01,0.534,2623,2581
13,5304,10,100,0.0001,0.01,0.516,2673,2631
13,5404,10,100,0.0001,0.01,0.52,2730,2674
13,5504,10,100,0.0001,0.01,0.51,2773,2731
13,5604,10,100,0.0001,0.01,0.528,2835,2769
13,5704,10,100,0.0001,0.01,0.52,2890,2814
13,5804,10,100,0.0001,0.01,0.556,2934,2870
13,5904,10,100,0.0001,0.01,0.55,2990,2914
13,6004,10,100,0.0001,0.01,0.542,3043,2961
13,6104,10,100,0.0001,0.01,0.56,3091,3013
13,6204,10,100,0.0001,0.01,0.554,3144,3060
13,6304,10,100,0.0001,0.01,0.58,3194,3110
13,6404,10,100,0.0001,0.01,0.58,3247,3157
13,6504,10,100,0.0001,0.01,0.59,3304,3200
13,6604,10,100,0.0001,0.01,0.582,3352,3252
13,6704,10,100,0.0001,0.01,0.592,3395,3309
13,6804,10,100,0.0001,0.01,0.594,3433,3371
13,6904,10,100,0.0001,0.01,0.578,3481,3423
13,7004,10,100,0.0001,0.01,0.554,3519,3485
13,7104,10,100,0.0001,0.01,0.582,3570,3534
13,7204,10,100,0.0001,0.01,0.584,3611,3593
13,7304,10,100,0.0001,0.01,0.59,3651,3653
13,7404,10,100,0.0001,0.01,0.566,3692,3712
13,7504,10,100,0.0001,0.01,0.564,3741,3763
13,7604,10,100,0.0001,0.01,0.602,3789,3815
13,7704,10,100,0.0001,0.01,0.572,3840,3864
13,7804,10,100,0.0001,0.01,0.598,3898,3906
13,7904,10,100,0.0001,0.01,0.59,3943,3961
13,8004,10,100,0.0001,0.01,0.604,3990,4014
13,8104,10,100,0.0001,0.01,0.6,4040,4064
13,8204,10,100,0.0001,0.01,0.582,4093,4111
13,8304,10,100,0.0001,0.01,0.584,4146,4158
13,8404,10,100,0.0001,0.01,0.584,4195,4209
13,8504,10,100,0.0001,0.01,0.582,4249,4255
13,8604,10,100,0.0001,0.01,0.58,4286,4318
13,8704,10,100,0.0001,0.01,0.61,4333,4371
13,8804,10,100,0.0001,0.01,0.608,4378,4426
13,8904,10,100,0.0001,0.01,0.608,4425,4479
13,9004,10,100,0.0001,0.01,0.578,4480,4524
13,9104,10,100,0.0001,0.01,0.602,4525,4579
13,9204,10,100,0.0001,0.01,0.602,4571,4633
13,9304,10,100,0.0001,0.01,0.608,4617,4687
13,9404,10,100,0.0001,0.01,0.618,4673,4731
13,9504,10,100,0.0001,0.01,0.596,4725,4779
13,9604,10,100,0.0001,0.01,0.602,4784,4820
13,9704,10,100,0.0001,0.01,0.61,4849,4855
13,9804,10,100,0.0001,0.01,0.628,4893,4911
13,9904,10,100,0.0001,0.01,0.638,4943,4961
13,10004,10,100,0.0001,0.01,0.648,4993,5011
13,10104,10,100,0.0001,0.01,0.642,5035,5069
13,10204,10,100,0.0001,0.01,0.66,5078,5126
13,10304,10,100,0.0001,0.01,0.654,5120,5184
13,10404,10,100,0.0001,0.01,0.652,5169,5235
13,10504,10,100,0.0001,0.01,0.676,5212,5292
13,10604,10,100,0.0001,0.01,0.652,5257,5347
13,10704,10,100,0.0001,0.01,0.656,5308,5396
13,10804,10,100,0.0001,0.01,0.658,5359,5445
13,10904,10,100,0.0001,0.01,0.666,5405,5499
13,11004,10,100,0.0001,0.01,0.668,5453,5551
13,11104,10,100,0.0001,0.01,0.676,5501,5603
13,11204,10,100,0.0001,0.01,0.646,5561,5643
13,11304,10,100,0.0001,0.01,0.682,5622,5682
13,11404,10,100,0.0001,0.01,0.678,5667,5737
13,11504,10,100,0.0001,0.01,0.678,5712,5792
13,11604,10,100,0.0001,0.01,0.68,5764,5840
13,11704,10,100,0.0001,0.01,0.67,5812,5892
13,11804,10,100,0.0001,0.01,0.7,5866,5938
13,11904,10,100,0.0001,0.01,0.698,5912,5992
13,12004,10,100,0.0001,0.01,0.696,5958,6046
13,12104,10,100,0.0001,0.01,0.708,6007,6097
13,12204,10,100,0.0001,0.01,0.724,6067,6137
13,12304,10,100,0.0001,0.01,0.722,6120,6184
13,12404,10,100,0.0001,0.01,0.702,6170,6234
13,12504,10,100,0.0001,0.01,0.724,6211,6293
13,12604,10,100,0.0001,0.01,0.72,6259,6345
13,12704,10,100,0.0001,0.01,0.706,6317,6387
13,12804,10,100,0.0001,0.01,0.708,6365,6439
13,12904,10,100,0.0001,0.01,0.71,6416,6488
13,13004,10,100,0.0001,0.01,0.734,6469,6535
13,13104,10,100,0.0001,0.01,0.732,6525,6579
13,13204,10,100,0.0001,0.01,0.738,6565,6639
13,13304,10,100,0.0001,0.01,0.74,6624,6680
13,13404,10,100,0.0001,0.01,0.768,6677,6727
13,13504,10,100,0.0001,0.01,0.756,6732,6772
13,13604,10,100,0.0001,0.01,0.76,6780,6824
13,13704,10,100,0.0001,0.01,0.782,6828,6876
13,13804,10,100,0.0001,0.01,0.774,6881,6923
13,13904,10,100,0.0001,0.01,0.78,6933,6971
13,14004,10,100,0.0001,0.01,0.792,6979,7025
13,14104,10,100,0.0001,0.01,0.79,7030,7074
13,14204,10,100,0.0001,0.01,0.778,7078,7126
13,14304,10,100,0.0001,0.01,0.796,7142,7162
13,14404,10,100,0.0001,0.01,0.796,7197,7207
13,14504,10,100,0.0001,0.01,0.808,7253,7251
13,14604,10,100,0.0001,0.01,0.804,7298,7306
13,14704,10,100,0.0001,0.01,0.816,7349,7355
13,14804,10,100,0.0001,0.01,0.83,7398,7406
13,14904,10,100,0.0001,0.01,0.824,7454,7450
13,15004,10,100,0.0001,0.01,0.838,7504,7500
14,104,10,100,0.0001,0.01,0.484,52,52
14,204,10,100,0.0001,0.01,0.468,102,102
14,304,10,100,0.0001,0.01,0.506,152,152
14,404,10,100,0.0001,0.01,0.488,206,198
14,504,10,100,0.0001,0.01,0.486,252,252
14,604,10,100,0.0001,0.01,0.51,306,298
14,704,10,100,0.0001,0.01,0.516,348,356
14,804,10,100,0.0001,0.01,0.52,390,414
14,904,10,100,0.0001,0.01,0.514,443,461
14,1004,10,100,0.0001,0.01,0.516,490,514
14,1104,10,100,0.0001,0.01,0.506,541,563
14,1204,10,100,0.0001,0.01,0.48,587,617
14,1304,10,100,0.0001,0.01,0.538,640,664
14,1404,10,100,0.0001,0.01,0.492,687,717
14,1504,10,100,0.0001,0.01,0.516,740,764
14,1604,10,100,0.0001,0.01,0.514,794,810
14,1704,10,100,0.0001,0.01,0.494,845,859
14,1804,10,100,0.0001,0.01,0.528,893,911
14,1904,10,100,0.0001,0.01,0.494,942,962
14,2004,10,100,0.0001,0.01,0.538,992,1012
14,2104,10,100,0.0001,0.01,0.54,1034,1070
14,2204,10,100,0.0001,0.01,0.558,1084,1120
14,2304,10,100,0.0001,0.01,0.522,1132,1172
14,2404,10,100,0.0001,0.01,0.542,1182,1222
14,2504,10,100,0.0001,0.01,0.55,1234,1270
14,2604,10,100,0.0001,0.01,0.548,1274,1330
14,2704,10,100,0.0001,0.01,0.562,1330,1374
14,2804,10,100,0.0001,0.01,0.554,1378,1426
14,2904,10,100,0.0001,0.01,0.55,1423,1481
14,3004,10,100,0.0001,0.01,0.566,1469,1535
14,3104,10,100,0.0001,0.01,0.54,1516,1588
14,3204,10,100,0.0001,0.01,0.548,1567,1637
14,3304,10,100,0.0001,0.01,0.56,1616,1688
14,3404,10,100,0.0001,0.01,0.562,1666,1738
14,3504,10,100,0.0001,0.01,0.584,1711,1793
14,3604,10,100,0.0001,0.01,0.616,1760,1844
14,3704,10,100,0.0001,0.01,0.566,1810,1894
14,3804,10,100,0.0001,0.01,0.59,1861,1943
14,3904,10,100,0.0001,0.01,0.63,1919,1985
14,4004,10,100,0.0001,0.01,0.628,1966,2038
14,4104,10,100,0.0001,0.01,0.616,2018,2086
14,4204,10,100,0.0001,0.01,0.62,2071,2133
14,4304,10,100,0.0001,0.01,0.63,2118,2186
14,4404,10,100,0.0001,0.01,0.636,2161,2243
14,4504,10,100,0.0001,0.01,0.646,2211,2293
14,4604,10,100,0.0001,0.01,0.662,2265,2339
14,4704,10,100,0.0001,0.01,0.67,2318,2386
14,4804,10,100,0.0001,0.01,0.674,2365,2439
14,4904,10,100,0.0001,0.01,0.644,2417,2487
14,5004,10,100,0.0001,0.01,0.666,2455,2549
14,5104,10,100,0.0001,0.01,0.664,2506,2598
14,5204,10,100,0.0001,0.01,0.684,2551,2653
14,5304,10,100,0.0001,0.01,0.69,2595,2709
14,5404,10,100,0.0001,0.01,0.694,2646,2758
14,5504,10,100,0.0001,0.01,0.702,2695,2809
14,5604,10,100,0.0001,0.01,0.714,2740,2864
14,5704,10,100,0.0001,0.01,0.726,2786,2918
14,5804,10,100,0.0001,0.01,0.744,2838,2966
14,5904,10,100,0.0001,0.01,0.754,2887,3017
14,6004,10,100,0.0001,0.01,0.748,2943,3061
14,6104,10,100,0.0001,0.01,0.76,2996,3108
14,6204,10,100,0.0001,0.01,0.746,3039,3165
14,6304,10,100,0.0001,0.01,0.77,3089,3215
14,6404,10,100,0.0001,0.01,0.772,3139,3265
14,6504,10,100,0.0001,0.01,0.786,3192,3312
14,6604,10,100,0.0001,0.01,0.758,3246,3358
14,6704,10,100,0.0001,0.01,0.81,3293,3411
14,6804,10,100,0.0001,0.01,0.796,3343,3461
14,6904,10,100,0.0001,0.01,0.792,3393,3511
14,7004,10,100,0.0001,0.01,0.792,3450,3554
14,7104,10,100,0.0001,0.01,0.802,3497,3607
14,7204,10,100,0.0001,0.01,0.8,3548,3656
14,7304,10,100,0.0001,0.01,0.782,3598,3706
14,7404,10,100,0.0001,0.01,0.806,3653,3751
14,7504,10,100,0.0001,0.01,0.816,3703,3801
14,7604,10,100,0.0001,0.01,0.824,3747,3857
14,7704,10,100,0.0001,0.01,0.838,3796,3908
14,7804,10,100,0.0001,0.01,0.84,3845,3959
14,7904,10,100,0.0001,0.01,0.86,3900,4004
14,8004,10,100,0.0001,0.01,0.852,3957,4047
14,8104,10,100,0.0001,0.01,0.848,4009,4095
14,8204,10,100,0.0001,0.01,0.876,4062,4142
14,8304,10,100,0.0001,0.01,0.866,4117,4187
14,8404,10,100,0.0001,0.01,0.844,4173,4231
14,8504,10,100,0.0001,0.01,0.87,4223,4281
14,8604,10,100,0.0001,0.01,0.888,4272,4332
14,8704,10,100,0.0001,0.01,0.87,4318,4386
14,8804,10,100,0.0001,0.01,0.878,4374,4430
14,8904,10,100,0.0001,0.01,0.882,4419,4485
14,9004,10,100,0.0001,0.01,0.894,4468,4536
14,9104,10,100,0.0001,0.01,0.882,4523,4581
14,9204,10,100,0.0001,0.01,0.886,4581,4623
14,9304,10,100,0.0001,0.01,0.9,4631,4673
14,9404,10,100,0.0001,0.01,0.836,4671,4733
14,9504,10,100,0.0001,0.01,0.88,4719,4785
14,9604,10,100,0.0001,0.01,0.9,4776,4828
14,9704,10,100,0.0001,0.01,0.916,4833,4871
14,9804,10,100,0.0001,0.01,0.922,4876,4928
14,9904,10,100,0.0001,0.01,0.93,4929,4975
14,10004,10,100,0.0001,0.01,0.932,4985,5019
14,10104,10,100,0.0001,0.01,0.936,5035,5069
14,10204,10,100,0.0001,0.01,0.924,5090,5114
14,10304,10,100,0.0001,0.01,0.938,5147,5157
14,10404,10,100,0.0001,0.01,0.92,5202,5202
14,10504,10,100,0.0001,0.01,0.922,5258,5246
14,10604,10,100,0.0001,0.01,0.918,5315,5289
14,10704,10,100,0.0001,0.01,0.922,5368,5336
14,10804,10,100,0.0001,0.01,0.936,5419,5385
14,10904,10,100,0.0001,0.01,0.944,5468,5436
14,11004,10,100,0.0001,0.01,0.95,5518,5486
14,11104,10,100,0.0001,0.01,0.95,5569,5535
14,11204,10,100,0.0001,0.01,0.956,5616,5588
14,11304,10,100,0.0001,0.01,0.95,5666,5638
14,11404,10,100,0.0001,0.01,0.964,5713,5691
14,11504,10,100,0.0001,0.01,0.934,5760,5744
14,11604,10,100,0.0001,0.01,0.944,5808,5796
14,11704,10,100,0.0001,0.01,0.96,5852,5852
14,11804,10,100,0.0001,0.01,0.938,5905,5899
14,11904,10,100,0.0001,0.01,0.954,5957,5947
14,12004,10,100,0.0001,0.01,0.968,6008,5996
14,12104,10,100,0.0001,0.01,0.972,6055,6049
14,12204,10,100,0.0001,0.01,0.968,6109,6095
14,12304,10,100,0.0001,0.01,0.96,6158,6146
14,12404,10,100,0.0001,0.01,0.96,6204,6200
14,12504,10,100,0.0001,0.01,0.952,6252,6252
14,12604,10,100,0.0001,0.01,0.968,6305,6299
14,12704,10,100,0.0001,0.01,0.966,6354,6350
14,12804,10,100,0.0001,0.01,0.948,6402,6402
14,12904,10,100,0.0001,0.01,0.966,6455,6449
14,13004,10,100,0.0001,0.01,0.964,6503,6501
14,13104,10,100,0.0001,0.01,0.974,6557,6547
14,13204,10,100,0.0001,0.01,0.98,6600,6604
14,13304,10,100,0.0001,0.01,0.964,6653,6651
14,13404,10,100,0.0001,0.01,0.974,6700,6704
14,13504,10,100,0.0001,0.01,0.984,6761,6743
14,13604,10,100,0.0001,0.01,0.968,6813,6791
14,13704,10,100,0.0001,0.01,0.976,6862,6842
14,13804,10,100,0.0001,0.01,0.982,6909,6895
14,13904,10,100,0.0001,0.01,0.986,6961,6943
14,14004,10,100,0.0001,0.01,0.988,7007,6997
14,14104,10,100,0.0001,0.01,0.988,7057,7047
14,14204,10,100,0.0001,0.01,0.988,7102,7102
14,14304,10,100,0.0001,0.01,0.972,7152,7152
14,14404,10,100,0.0001,0.01,0.966,7203,7201
14,14504,10,100,0.0001,0.01,0.974,7256,7248
14,14604,10,100,0.0001,0.01,0.982,7303,7301
14,14704,10,100,0.0001,0.01,0.988,7349,7355
14,14804,10,100,0.0001,0.01,0.992,7405,7399
14,14904,10,100,0.0001,0.01,0.992,7457,7447
14,15004,10,100,0.0001,0.01,0.99,7510,7494
15,104,10,100,0.0001,0.01,0.508,53,51
15,204,10,100,0.0001,0.01,0.516,106,98
15,304,10,100,0.0001,0.01,0.504,159,145
15,404,10,100,0.0001,0.01,0.508,210,194
15,504,10,100,0.0001,0.01,0.506,259,245
15,604,10,100,0.0001,0.01,0.49,309,295
15,704,10,100,0.0001,0.01,0.468,359,345
15,804,10,100,0.0001,0.01,0.468,407,397
15,904,10,100,0.0001,0.01,0.484,455,449
15,1004,10,100,0.0001,0.01,0.486,501,503
15,1104,10,100,0.0001,0.01,0.518,546,558
15,1204,10,100,0.0001,0.01,0.522,597,607
15,1304,10,100,0.0001,0.01,0.52,645,659
15,1404,10,100,0.0001,0.01,0.482,694,710
15,1504,10,100,0.0001,0.01,0.524,748,756
15,1604,10,100,0.0001,0.01,0.52,794,810
15,1704,10,100,0.0001,0.01,0.55,842,862
15,1804,10,100,0.0001,0.01,0.536,886,918
15,1904,10,100,0.0001,0.01,0.586,937,967
15,2004,10,100,0.0001,0.01,0.544,994,1010
15,2104,10,100,0.0001,0.01,0.556,1042,1062
15,2204,10,100,0.0001,0.01,0.55,1090,1114
15,2304,10,100,0.0001,0.01,0.602,1145,1159
15,2404,10,100,0.0001,0.01,0.574,1186,1218
15,2504,10,100,0.0001,0.01,0.594,1245,1259
15,2604,10,100,0.0001,0.01,0.592,1290,1314
15,2704,10,100,0.0001,0.01,0.61,1339,1365
15,2804,10,100,0.0001,0.01,0.638,1385,1419
15,2904,10,100,0.0001,0.01,0.636,1437,1467
15,3004,10,100,0.0001,0.01,0.674,1491,1513
15,3104,10,100,0.0001,0.01,0.692,1547,1557
15,3204,10,100,0.0001,0.01,0.704,1595,1609
15,3304,10,100,0.0001,0.01,0.724,1654,1650
15,3404,10,100,0.0001,0.01,0.742,1706,1698
15,3504,10,100,0.0001,0.01,0.742,1754,1750
15,3604,10,100,0.0001,0.01,0.744,1798,1806
15,3704,10,100,0.0001,0.01,0.774,1847,1857
15,3804,10,100,0.0001,0.01,0.766,1893,1911
15,3904,10,100,0.0001,0.01,0.798,1938,1966
15,4004,10,100,0.0001,0.01,0.796,1990,2014
15,4104,10,100,0.0001,0.01,0.822,2043,2061
15,4204,10,100,0.0001,0.01,0.768,2094,2110
15,4304,10,100,0.0001,0.01,0.778,2139,2165
15,4404,10,100,0.0001,0.01,0.812,2186,2218
15,4504,10,100,0.0001,0.01,0.808,2247,2257
15,4604,10,100,0.0001,0.01,0.824,2299,2305
15,4704,10,100,0.0001,0.01,0.832,2346,2358
15,4804,10,100,0.0001,0.01,0.826,2393,2411
15,4904,10,100,0.0001,0.01,0.832,2448,2456
15,5004,10,100,0.0001,0.01,0.848,2493,2511
15,5104,10,100,0.0001,0.01,0.832,2548,2556
15,5204,10,100,0.0001,0.01,0.826,2597,2607
15,5304,10,100,0.0001,0.01,0.838,2649,2655
15,5404,10,100,0.0001,0.01,0.852,2697,2707
15,5504,10,100,0.0001,0.01,0.832,2746,2758
15,5604,10,100,0.0001,0.01,0.822,2801,2803
15,5704,10,100,0.0001,0.01,0.852,2849,2855
15,5804,10,100,0.0001,0.01,0.862,2897,2907
15,5904,10,100,0.0001,0.01,0.852,2956,2948
15,6004,10,100,0.0001,0.01,0.866,2998,3006
15,6104,10,100,0.0001,0.01,0.854,3042,3062
15,6204,10,100,0.0001,0.01,0.838,3091,3113
15,6304,10,100,0.0001,0.01,0.844,3142,3162
15,6404,10,100,0.0001,0.01,0.85,3191,3213
15,6504,10,100,0.0001,0.01,0.862,3240,3264
15,6604,10,100,0.0001,0.01,0.868,3293,3311
15,6704,10,100,0.0001,0.01,0.87,3334,3370
15,6804,10,100,0.0001,0.01,0.874,3386,3418
15,6904,10,100,0.0001,0.01,0.876,3438,3466
15,7004,10,100,0.0001,0.01,0.87,3486,3518
15,7104,10,100,0.0001,0.01,0.882,3548,3556
15,7204,10,100,0.0001,0.01,0.878,3604,3600
15,7304,10,100,0.0001,0.01,0.878,3642,3662
15,7404,10,100,0.0001,0.01,0.88,3683,3721
15,7504,10,100,0.0001,0.01,0.872,3736,3768
15,7604,10,100,0.0001,0.01,0.89,3795,3809
15,7704,10,100,0.0001,0.01,0.882,3840,3864
15,7804,10,100,0.0001,0.01,0.902,3888,3916
15,7904,10,100,0.0001,0.01,0.882,3939,3965
15,8004,10,100,0.0001,0.01,0.884,3989,4015
15,8104,10,100,0.0001,0.01,0.9,4033,4071
15,8204,10,100,0.0001,0.01,0.872,4084,4120
15,8304,10,100,0.0001,0.01,0.876,4137,4167
15,8404,10,100,0.0001,0.01,0.89,4181,4223
15,8504,10,100,0.0001,0.01,0.896,4235,4269
15,8604,10,100,0.0001,0.01,0.91,4287,4317
15,8704,10,100,0.0001,0.01,0.916,4335,4369
15,8804,10,100,0.0001,0.01,0.91,4388,4416
15,8904,10,100,0.0001,0.01,0.9,4442,4462
15,9004,10,100,0.0001,0.01,0.918,4490,4514
15,9104,10,100,0.0001,0.01,0.906,4539,4565
15,9204,10,100,0.0001,0.01,0.908,4585,4619
15,9304,10,100,0.0001,0.01,0.91,4637,4667
15,9404,10,100,0.0001,0.01,0.91,4675,4729
15,9504,10,100,0.0001,0.01,0.92,4728,4776
15,9604,10,100,0.0001,0.01,0.916,4780,4824
15,9704,10,100,0.0001,0.01,0.922,4832,4872
15,9804,10,100,0.0001,0.01,0.91,4882,4922
15,9904,10,100,0.0001,0.01,0.904,4932,4972
15,10004,10,100,0.0001,0.01,0.91,4976,5028
15,10104,10,100,0.0001,0.01,0.91,5023,5081
15,10204,10,100,0.0001,0.01,0.918,5071,5133
15,10304,10,100,0.0001,0.01,0.918,5121,5183
15,10404,10,100,0.0001,0.01,0.938,5172,5232
15,10504,10,100,0.0001,0.01,0.914,5219,5285
15,10604,10,100,0.0001,0.01,0.924,5266,5338
15,10704,10,100,0.0001,0.01,0.924,5309,5395
15,10804,10,100,0.0001,0.01,0.924,5365,5439
15,10904,10,100,0.0001,0.01,0.938,5427,5477
15,11004,10,100,0.0001,0.01,0.93,5473,5531
15,11104,10,100,0.0001,0.01,0.928,5533,5571
15,11204,10,100,0.0001,0.01,0.938,5580,5624
15,11304,10,100,0.0001,0.01,0.934,5621,5683
15,11404,10,100,0.0001,0.01,0.918,5669,5735
15,11504,10,100,0.0001,0.01,0.92,5728,5776
15,11604,10,100,0.0001,0.01,0.938,5789,5815
15,11704,10,100,0.0001,0.01,0.928,5833,5871
15,11804,10,100,0.0001,0.01,0.934,5882,5922
15,11904,10,100,0.0001,0.01,0.93,5940,5964
15,12004,10,100,0.0001,0.01,0.944,5989,6015
15,12104,10,100,0.0001,0.01,0.946,6042,6062
15,12204,10,100,0.0001,0.01,0.938,6092,6112
15,12304,10,100,0.0001,0.01,0.914,6146,6158
15,12404,10,100,0.0001,0.01,0.932,6197,6207
15,12504,10,100,0.0001,0.01,0.952,6237,6267
15,12604,10,100,0.0001,0.01,0.956,6293,6311
15,12704,10,100,0.0001,0.01,0.97,6347,6357
15,12804,10,100,0.0001,0.01,0.964,6397,6407
15,12904,10,100,0.0001,0.01,0.958,6445,6459
15,13004,10,100,0.0001,0.01,0.972,6492,6512
15,13104,10,100,0.0001,0.01,0.968,6541,6563
15,13204,10,100,0.0001,0.01,0.948,6592,6612
15,13304,10,100,0.0001,0.01,0.958,6638,6666
15,13404,10,100,0.0001,0.01,0.958,6689,6715
15,13504,10,100,0.0001,0.01,0.966,6739,6765
15,13604,10,100,0.0001,0.01,0.962,6795,6809
15,13704,10,100,0.0001,0.01,0.966,6844,6860
15,13804,10,100,0.0001,0.01,0.968,6891,6913
15,13904,10,100,0.0001,0.01,0.962,6943,6961
15,14004,10,100,0.0001,0.01,0.96,6995,7009
15,14104,10,100,0.0001,0.01,0.964,7052,7052
15,14204,10,100,0.0001,0.01,0.97,7097,7107
15,14304,10,100,0.0001,0.01,0.918,7148,7156
15,14404,10,100,0.0001,0.01,0.96,7199,7205
15,14504,10,100,0.0001,0.01,0.972,7260,7244
15,14604,10,100,0.0001,0.01,0.976,7313,7291
15,14704,10,100,0.0001,0.01,0.966,7364,7340
15,14804,10,100,0.0001,0.01,0.972,7416,7388
15,14904,10,100,0.0001,0.01,0.974,7459,7445
15,15004,10,100,0.0001,0.01,0.976,7506,7498
16,104,10,100,0.0001,0.01,0.482,50,54
16,204,10,100,0.0001,0.01,0.538,99,105
16,304,10,100,0.0001,0.01,0.514,156,148
16,404,10,100,0.0001,0.01,0.506,202,202
16,504,10,100,0.0001,0.01,0.52,248,256
16,604,10,100,0.0001,0.01,0.508,299,305
16,704,10,100,0.0001,0.01,0.51,346,358
16,804,10,100,0.0001,0.01,0.498,396,408
16,904,10,100,0.0001,0.01,0.524,442,462
16,1004,10,100,0.0001,0.01,0.534,487,517
16,1104,10,100,0.0001,0.01,0.496,541,563
16,1204,10,100,0.0001,0.01,0.548,587,617
16,1304,10,100,0.0001,0.01,0.512,636,668
16,1404,10,100,0.0001,0.01,0.498,683,721
16,1504,10,100,0.0001,0.01,0.514,734,770
16,1604,10,100,0.0001,0.01,0.512,779,825
16,1704,10,100,0.0001,0.01,0.5,831,873
16,1804,10,100,0.0001,0.01,0.538,889,915
16,1904,10,100,0.0001,0.01,0.498,937,967
16,2004,10,100,0.0001,0.01,0.542,982,1022
16,2104,10,100,0.0001,0.01,0.492,1037,1067
16,2204,10,100,0.0001,0.01,0.528,1082,1122
16,2304,10,100,0.0001,0.01,0.52,1129,1175
16,2404,10,100,0.0001,0.01,0.514,1180,1224
16,2504,10,100,0.0001,0.01,0.51,1226,1278
16,2604,10,100,0.0001,0.01,0.516,1279,1325
16,2704,10,100,0.0001,0.01,0.528,1333,1371
16,2804,10,100,0.0001,0.01,0.512,1377,1427
16,2904,10,100,0.0001,0.01,0.524,1423,1481
16,3004,10,100,0.0001,0.01,0.54,1478,1526
16,3104,10,100,0.0001,0.01,0.518,1520,1584
16,3204,10,100,0.0001,0.01,0.518,1580,1624
16,3304,10,100,0.0001,0.01,0.524,1630,1674
16,3404,10,100,0.0001,0.01,0.52,1675,1729
16,3504,10,100,0.0001,0.01,0.54,1725,1779
16,3604,10,100,0.0001,0.01,0.544,1779,1825
16,3704,10,100,0.0001,0.01,0.548,1832,1872
16,3804,10,100,0.0001,0.01,0.538,1887,1917
16,3904,10,100,0.0001,0.01,0.556,1929,1975
16,4004,10,100,0.0001,0.01,0.564,1977,2027
16,4104,10,100,0.0001,0.01,0.534,2024,2080
16,4204,10,100,0.0001,0.01,0.566,2075,2129
16,4304,10,100,0.0001,0.01,0.586,2123,2181
16,4404,10,100,0.0001,0.01,0.556,2175,2229
16,4504,10,100,0.0001,0.01,0.564,2227,2277
16,4604,10,100,0.0001,0.01,0.57,2280,2324
16,4704,10,100,0.0001,0.01,0.562,2327,2377
16,4804,10,100,0.0001,0.01,0.576,2387,2417
16,4904,10,100,0.0001,0.01,0.608,2437,2467
16,5004,10,100,0.0001,0.01,0.584,2485,2519
16,5104,10,100,0.0001,0.01,0.594,2543,2561
16,5204,10,100,0.0001,0.01,0.59,2598,2606
16,5304,10,100,0.0001,0.01,0.624,2650,2654
16,5404,10,100,0.0001,0.01,0.594,2705,2699
16,5504,10,100,0.0001,0.01,0.568,2755,2749
16,5604,10,100,0.0001,0.01,0.574,2810,2794
16,5704,10,100,0.0001,0.01,0.61,2856,2848
16,5804,10,100,0.0001,0.01,0.59,2907,2897
16,5904,10,100,0.0001,0.01,0.628,2954,2950
16,6004,10,100,0.0001,0.01,0.62,3010,2994
16,6104,10,100,0.0001,0.01,0.62,3065,3039
16,6204,10,100,0.0001,0.01,0.626,3117,3087
16,6304,10,100,0.0001,0.01,0.63,3166,3138
16,6404,10,100,0.0001,0.01,0.652,3213,3191
16,6504,10,100,0.0001,0.01,0.608,3263,3241
16,6604,10,100,0.0001,0.01,0.614,3313,3291
16,6704,10,100,0.0001,0.01,0.606,3364,3340
16,6804,10,100,0.0001,0.01,0.614,3414,3390
16,6904,10,100,0.0001,0.01,0.624,3458,3446
16,7004,10,100,0.0001,0.01,0.604,3511,3493
16,7104,10,100,0.0001,0.01,0.612,3565,3539
16,7204,10,100,0.0001,0.01,0.622,3623,3581
16,7304,10,100,0.0001,0.01,0.622,3674,3630
16,7404,10,100,0.0001,0.01,0.62,3720,3684
16,7504,10,100,0.0001,0.01,0.65,3770,3734
16,7604,10,100,0.0001,0.01,0.628,3817,3787
16,7704,10,100,0.0001,0.01,0.626,3863,3841
16,7804,10,100,0.0001,0.01,0.646,3913,3891
16,7904,10,100,0.0001,0.01,0.626,3966,3938
16,8004,10,100,0.0001,0.01,0.628,4017,3987
16,8104,10,100,0.0001,0.01,0.644,4062,4042
16,8204,10,100,0.0001,0.01,0.634,4113,4091
16,8304,10,100,0.0001,0.01,0.644,4158,4146
16,8404,10,100,0.0001,0.01,0.636,4211,4193
16,8504,10,100,0.0001,0.01,0.64,4255,4249
16,8604,10,100,0.0001,0.01,0.648,4303,4301
16,8704,10,100,0.0001,0.01,0.632,4352,4352
16,8804,10,100,0.0001,0.01,0.64,4404,4400
16,8904,10,100,0.0001,0.01,0.664,4456,4448
16,9004,10,100,0.0001,0.01,0.662,4509,4495
16,9104,10,100,0.0001,0.01,0.664,4556,4548
16,9204,10,100,0.0001,0.01,0.662,4599,4605
16,9304,10,100,0.0001,0.01,0.664,4639,4665
16,9404,10,100,0.0001,0.01,0.666,4680,4724
16,9504,10,100,0.0001,0.01,0.642,4721,4783
16,9604,10,100,0.0001,0.01,0.67,4769,4835
16,9704,10,100,0.0001,0.01,0.674,4817,4887
16,9804,10,100,0.0001,0.01,0.682,4867,4937
16,9904,10,100,0.0001,0.01,0.692,4914,4990
16,10004,10,100,0.0001,0.01,0.678,4953,5051
16,10104,10,100,0.0001,0.01,0.686,5008,5096
16,10204,10,100,0.0001,0.01,0.704,5060,5144
16,10304,10,100,0.0001,0.01,0.678,5116,5188
16,10404,10,100,0.0001,0.01,0.698,5169,5235
16,10504,10,100,0.0001,0.01,0.7,5221,5283
16,10604,10,100,0.0001,0.01,0.706,5265,5339
16,10704,10,100,0.0001,0.01,0.69,5316,5388
16,10804,10,100,0.0001,0.01,0.728,5371,5433
16,10904,10,100,0.0001,0.01,0.708,5418,5486
16,11004,10,100,0.0001,0.01,0.712,5470,5534
16,11104,10,100,0.0001,0.01,0.722,5517,5587
16,11204,10,100,0.0001,0.01,0.736,5569,5635
16,11304,10,100,0.0001,0.01,0.728,5622,5682
16,11404,10,100,0.0001,0.01,0.736,5673,5731
16,11504,10,100,0.0001,0.01,0.74,5725,5779
16,11604,10,100,0.0001,0.01,0.752,5779,5825
16,11704,10,100,0.0001,0.01,0.782,5823,5881
16,11804,10,100,0.0001,0.01,0.764,5872,5932
16,11904,10,100,0.0001,0.01,0.76,5922,5982
16,12004,10,100,0.0001,0.01,0.778,5977,6027
16,12104,10,100,0.0001,0.01,0.796,6030,6074
16,12204,10,100,0.0001,0.01,0.788,6077,6127
16,12304,10,100,0.0001,0.01,0.802,6132,6172
16,12404,10,100,0.0001,0.01,0.808,6178,6226
16,12504,10,100,0.0001,0.01,0.792,6226,6278
16,12604,10,100,0.0001,0.01,0.788,6276,6328
16,12704,10,100,0.0001,0.01,0.822,6328,6376
16,12804,10,100,0.0001,0.01,0.816,6376,6428
16,12904,10,100,0.0001,0.01,0.822,6423,6481
16,13004,10,100,0.0001,0.01,0.816,6483,6521
16,13104,10,100,0.0001,0.01,0.848,6535,6569
16,13204,10,100,0.0001,0.01,0.836,6583,6621
16,13304,10,100,0.0001,0.01,0.852,6626,6678
16,13404,10,100,0.0001,0.01,0.854,6679,6725
16,13504,10,100,0.0001,0.01,0.874,6732,6772
16,13604,10,100,0.0001,0.01,0.866,6786,6818
16,13704,10,100,0.0001,0.01,0.88,6844,6860
16,13804,10,100,0.0001,0.01,0.866,6902,6902
16,13904,10,100,0.0001,0.01,0.882,6953,6951
16,14004,10,100,0.0001,0.01,0.878,6999,7005
16,14104,10,100,0.0001,0.01,0.89,7048,7056
16,14204,10,100,0.0001,0.01,0.882,7102,7102
16,14304,10,100,0.0001,0.01,0.88,7158,7146
16,14404,10,100,0.0001,0.01,0.888,7209,7195
16,14504,10,100,0.0001,0.01,0.888,7254,7250
16,14604,10,100,0.0001,0.01,0.894,7308,7296
16,14704,10,100,0.0001,0.01,0.904,7366,7338
16,14804,10,100,0.0001,0.01,0.908,7411,7393
16,14904,10,100,0.0001,0.01,0.894,7458,7446
16,15004,10,100,0.0001,0.01,0.91,7511,7493
17,104,10,100,0.0001,0.01,0.5,47,57
17,204,10,100,0.0001,0.01,0.456,90,114
17,304,10,100,0.0001,0.01,0.486,150,154
17,404,10,100,0.0001,0.01,0.458,193,211
17,504,10,100,0.0001,0.01,0.478,248,256
17,604,10,100,0.0001,0.01,0.478,296,308
17,704,10,100,0.0001,0.01,0.456,348,356
17,804,10,100,0.0001,0.01,0.484,403,401
17,904,10,100,0.0001,0.01,0.474,453,451
17,1004,10,100,0.0001,0.01,0.516,503,501
17,1104,10,100,0.0001,0.01,0.494,555,549
17,1204,10,100,0.0001,0.01,0.496,605,599
17,1304,10,100,0.0001,0.01,0.488,653,651
17,1404,10,100,0.0001,0.01,0.472,698,706
17,1504,10,100,0.0001,0.01,0.482,748,756
17,1604,10,100,0.0001,0.01,0.522,799,805
17,1704,10,100,0.0001,0.01,0.494,846,858
17,1804,10,100,0.0001,0.01,0.48,894,910
17,1904,10,100,0.0001,0.01,0.504,935,969
17,2004,10,100,0.0001,0.01,0.5,989,1015
17,2104,10,100,0.0001,0.01,0.506,1049,1055
17,2204,10,100,0.0001,0.01,0.552,1107,1097
17,2304,10,100,0.0001,0.01,0.504,1154,1150
17,2404,10,100,0.0001,0.01,0.556,1211,1193
17,2504,10,100,0.0001,0.01,0.548,1262,1242
17,2604,10,100,0.0001,0.01,0.556,1309,1295
17,2704,10,100,0.0001,0.01,0.578,1366,1338
17,2804,10,100,0.0001,0.01,0.6,1405,1399
17,2904,10,100,0.0001,0.01,0.608,1450,1454
17,3004,10,100,0.0001,0.01,0.614,1493,1511
17,3104,10,100,0.0001,0.01,0.604,1536,1568
17,3204,10,100,0.0001,0.01,0.612,1587,1617
17,3304,10,100,0.0001,0.01,0.648,1635,1669
17,3404,10,100,0.0001,0.01,0.652,1690,1714
17,3504,10,100,0.0001,0.01,0.664,1745,1759
17,3604,10,100,0.0001,0.01,0.692,1787,1817
17,3704,10,100,0.0001,0.01,0.676,1842,1862
17,3804,10,100,0.0001,0.01,0.698,1895,1909
17,3904,10,100,0.0001,0.01,0.744,1935,1969
17,4004,10,100,0.0001,0.01,0.736,1981,2023
17,4104,10,100,0.0001,0.01,0.712,2032,2072
17,4204,10,100,0.0001,0.01,0.742,2084,2120
17,4304,10,100,0.0001,0.01,0.756,2130,2174
17,4404,10,100,0.0001,0.01,0.736,2185,2219
17,4504,10,100,0.0001,0.01,0.734,2242,2262
17,4604,10,100,0.0001,0.01,0.784,2297,2307
17,4704,10,100,0.0001,0.01,0.808,2345,2359
17,4804,10,100,0.0001,0.01,0.792,2384,2420
17,4904,10,100,0.0001,0.01,0.772,2429,2475
17,5004,10,100,0.0001,0.01,0.794,2471,2533
17,5104,10,100,0.0001,0.01,0.73,2525,2579
17,5204,10,100,0.0001,0.01,0.766,2575,2629
17,5304,10,100,0.0001,0.01,0.76,2628,2676
17,5404,10,100,0.0001,0.01,0.81,2671,2733
17,5504,10,100,0.0001,0.01,0.76,2730,2774
17,5604,10,100,0.0001,0.01,0.798,2791,2813
17,5704,10,100,0.0001,0.01,0.812,2838,2866
17,5804,10,100,0.0001,0.01,0.826,2890,2914
17,5904,10,100,0.0001,0.01,0.81,2941,2963
17,6004,10,100,0.0001,0.01,0.826,2991,3013
17,6104,10,100,0.0001,0.01,0.826,3044,3060
17,6204,10,100,0.0001,0.01,0.83,3106,3098
17,6304,10,100,0.0001,0.01,0.836,3156,3148
17,6404,10,100,0.0001,0.01,0.842,3213,3191
17,6504,10,100,0.0001,0.01,0.862,3262,3242
17,6604,10,100,0.0001,0.01,0.87,3313,3291
17,6704,10,100,0.0001,0.01,0.884,3368,3336
17,6804,10,100,0.0001,0.01,0.88,3412,3392
17,6904,10,100,0.0001,0.01,0.894,3461,3443
17,7004,10,100,0.0001,0.01,0.87,3511,3493
17,7104,10,100,0.0001,0.01,0.868,3555,3549
17,7204,10,100,0.0001,0.01,0.88,3601,3603
17,7304,10,100,0.0001,0.01,0.902,3660,3644
17,7404,10,100,0.0001,0.01,0.892,3712,3692
17,7504,10,100,0.0001,0.01,0.908,3769,3735
17,7604,10,100,0.0001,0.01,0.91,3821,3783
17,7704,10,100,0.0001,0.01,0.91,3868,3836
17,7804,10,100,0.0001,0.01,0.938,3920,3884
17,7904,10,100,0.0001,0.01,0.93,3965,3939
17,8004,10,100,0.0001,0.01,0.932,4013,3991
17,8104,10,100,0.0001,0.01,0.946,4056,4048
17,8204,10,100,0.0001,0.01,0.936,4110,4094
17,8304,10,100,0.0001,0.01,0.954,4164,4140
17,8404,10,100,0.0001,0.01,0.938,4208,4196
17,8504,10,100,0.0001,0.01,0.92,4261,4243
17,8604,10,100,0.0001,0.01,0.916,4314,4290
17,8704,10,100,0.0001,0.01,0.932,4362,4342
17,8804,10,100,0.0001,0.01,0.93,4406,4398
17,8904,10,100,0.0001,0.01,0.954,4455,4449
17,9004,10,100,0.0001,0.01,0.962,4506,4498
17,9104,10,100,0.0001,0.01,0.96,4562,4542
17,9204,10,100,0.0001,0.01,0.956,4617,4587
17,9304,10,100,0.0001,0.01,0.962,4664,4640
17,9404,10,100,0.0001,0.01,0.958,4719,4685
17,9504,10,100,0.0001,0.01,0.942,4760,4744
17,9604,10,100,0.0001,0.01,0.95,4813,4791
17,9704,10,100,0.0001,0.01,0.952,4863,4841
17,9804,10,100,0.0001,0.01,0.956,4917,4887
17,9904,10,100,0.0001,0.01,0.954,4969,4935
17,10004,10,100,0.0001,0.01,0.96,5006,4998
17,10104,10,100,0.0001,0.01,0.97,5062,5042
17,10204,10,100,0.0001,0.01,0.952,5116,5088
17,10304,10,100,0.0001,0.01,0.966,5165,5139
17,10404,10,100,0.0001,0.01,0.954,5222,5182
17,10504,10,100,0.0001,0.01,0.966,5273,5231
17,10604,10,100,0.0001,0.01,0.954,5312,5292
17,10704,10,100,0.0001,0.01,0.962,5358,5346
17,10804,10,100,0.0001,0.01,0.97,5414,5390
17,10904,10,100,0.0001,0.01,0.978,5466,5438
17,11004,10,100,0.0001,0.01,0.948,5518,5486
17,11104,10,100,0.0001,0.01,0.97,5568,5536
17,11204,10,100,0.0001,0.01,0.966,5609,5595
17,11304,10,100,0.0001,0.01,0.958,5660,5644
17,11404,10,100,0.0001,0.01,0.97,5708,5696
17,11504,10,100,0.0001,0.01,0.976,5752,5752
17,11604,10,100,0.0001,0.01,0.978,5807,5797
17,11704,10,100,0.0001,0.01,0.982,5853,5851
17,11804,10,100,0.0001,0.01,0.968,5896,5908
17,11904,10,100,0.0001,0.01,0.98,5942,5962
17,12004,10,100,0.0001,0.01,0.978,5999,6005
17,12104,10,100,0.0001,0.01,0.972,6050,6054
17,12204,10,100,0.0001,0.01,0.968,6102,6102
17,12304,10,100,0.0001,0.01,0.958,6158,6146
17,12404,10,100,0.0001,0.01,0.976,6209,6195
17,12504,10,100,0.0001,0.01,0.976,6258,6246
17,12604,10,100,0.0001,0.01,0.986,6305,6299
17,12704,10,100,0.0001,0.01,0.99,6353,6351
17,12804,10,100,0.0001,0.01,0.99,6410,6394
17,12904,10,100,0.0001,0.01,0.99,6463,6441
17,13004,10,100,0.0001,0.01,0.982,6517,6487
17,13104,10,100,0.0001,0.01,0.986,6569,6535
17,13204,10,100,0.0001,0.01,0.976,6621,6583
17,13304,10,100,0.0001,0.01,0.978,6665,6639
17,13404,10,100,0.0001,0.01,0.982,6712,6692
17,13504,10,100,0.0001,0.01,0.978,6764,6740
17,13604,10,100,0.0001,0.01,0.988,6819,6785
17,13704,10,100,0.0001,0.01,0.992,6868,6836
17,13804,10,100,0.0001,0.01,0.986,6919,6885
17,13904,10,100,0.0001,0.01,0.992,6968,6936
17,14004,10,100,0.0001,0.01,0.984,7015,6989
17,14104,10,100,0.0001,0.01,0.99,7062,7042
17,14204,10,100,0.0001,0.01,0.986,7121,7083
17,14304,10,100,0.0001,0.01,0.978,7164,7140
17,14404,10,100,0.0001,0.01,0.982,7207,7197
17,14504,10,100,0.0001,0.01,0.972,7262,7242
17,14604,10,100,0.0001,0.01,0.964,7313,7291
17,14704,10,100,0.0001,0.01,0.976,7363,7341
17,14804,10,100,0.0001,0.01,0.99,7412,7392
17,14904,10,100,0.0001,0.01,0.99,7458,7446
17,15004,10,100,0.0001,0.01,0.99,7505,7499
18,104,10,100,0.0001,0.01,0.51,54,50
18,204,10,100,0.0001,0.01,0.522,100,104
18,304,10,100,0.0001,0.01,0.55,147,157
18,404,10,100,0.0001,0.01,0.514,203,201
18,504,10,100,0.0001,0.01,0.502,242,262
18,604,10,100,0.0001,0.01,0.494,304,300
18,704,10,100,0.0001,0.01,0.538,360,344
18,804,10,100,0.0001,0.01,0.574,413,391
18,904,10,100,0.0001,0.01,0.542,463,441
18,1004,10,100,0.0001,0.01,0.566,518,486
18,1104,10,100,0.0001,0.01,0.534,573,531
18,1204,10,100,0.0001,0.01,0.6,626,578
18,1304,10,100,0.0001,0.01,0.544,669,635
18,1404,10,100,0.0001,0.01,0.58,719,685
18,1504,10,100,0.0001,0.01,0.584,769,735
18,1604,10,100,0.0001,0.01,0.59,816,788
18,1704,10,100,0.0001,0.01,0.616,862,842
18,1804,10,100,0.0001,0.01,0.662,912,892
18,1904,10,100,0.0001,0.01,0.672,963,941
18,2004,10,100,0.0001,0.01,0.694,1008,996
18,2104,10,100,0.0001,0.01,0.73,1049,1055
18,2204,10,100,0.0001,0.01,0.736,1098,1106
18,2304,10,100,0.0001,0.01,0.75,1144,1160
18,2404,10,100,0.0001,0.01,0.758,1189,1215
18,2504,10,100,0.0001,0.01,0.792,1246,1258
18,2604,10,100,0.0001,0.01,0.794,1295,1309
18,2704,10,100,0.0001,0.01,0.816,1343,1361
18,2804,10,100,0.0001,0.01,0.828,1391,1413
18,2904,10,100,0.0001,0.01,0.842,1435,1469
18,3004,10,100,0.0001,0.01,0.772,1488,1516
18,3104,10,100,0.0001,0.01,0.808,1539,1565
18,3204,10,100,0.0001,0.01,0.804,1589,1615
18,3304,10,100,0.0001,0.01,0.83,1631,1673
18,3404,10,100,0.0001,0.01,0.854,1681,1723
18,3504,10,100,0.0001,0.01,0.832,1722,1782
18,3604,10,100,0.0001,0.01,0.848,1777,1827
18,3704,10,100,0.0001,0.01,0.826,1832,1872
18,3804,10,100,0.0001,0.01,0.826,1882,1922
18,3904,10,100,0.0001,0.01,0.872,1925,1979
18,4004,10,100,0.0001,0.01,0.872,1982,2022
18,4104,10,100,0.0001,0.01,0.88,2035,2069
18,4204,10,100,0.0001,0.01,0.79,2090,2114
18,4304,10,100,0.0001,0.01,0.866,2135,2169
18,4404,10,100,0.0001,0.01,0.894,2182,2222
18,4504,10,100,0.0001,0.01,0.894,2237,2267
18,4604,10,100,0.0001,0.01,0.908,2286,2318
18,4704,10,100,0.0001,0.01,0.896,2337,2367
18,4804,10,100,0.0001,0.01,0.838,2382,2422
18,4904,10,100,0.0001,0.01,0.782,2435,2469
18,5004,10,100,0.0001,0.01,0.878,2486,2518
18,5104,10,100,0.0001,0.01,0.894,2545,2559
18,5204,10,100,0.0001,0.01,0.878,2599,2605
18,5304,10,100,0.0001,0.01,0.876,2644,2660
18,5404,10,100,0.0001,0.01,0.888,2691,2713
18,5504,10,100,0.0001,0.01,0.856,2735,2769
18,5604,10,100,0.0001,0.01,0.898,2780,2824
18,5704,10,100,0.0001,0.01,0.882,2833,2871
18,5804,10,100,0.0001,0.01,0.906,2891,2913
18,5904,10,100,0.0001,0.01,0.9,2941,2963
18,6004,10,100,0.0001,0.01,0.904,2990,3014
18,6104,10,100,0.0001,0.01,0.908,3041,3063
18,6204,10,100,0.0001,0.01,0.838,3090,3114
18,6304,10,100,0.0001,0.01,0.868,3139,3165
18,6404,10,100,0.0001,0.01,0.836,3194,3210
18,6504,10,100,0.0001,0.01,0.846,3246,3258
18,6604,10,100,0.0001,0.01,0.894,3298,3306
18,6704,10,100,0.0001,0.01,0.884,3351,3353
18,6804,10,100,0.0001,0.01,0.812,3402,3402
18,6904,10,100,0.0001,0.01,0.912,3454,3450
18,7004,10,100,0.0001,0.01,0.906,3501,3503
18,7104,10,100,0.0001,0.01,0.904,3545,3559
18,7204,10,100,0.0001,0.01,0.88,3589,3615
18,7304,10,100,0.0001,0.01,0.908,3631,3673
18,7404,10,100,0.0001,0.01,0.888,3671,3733
18,7504,10,100,0.0001,0.01,0.908,3720,3784
18,7604,10,100,0.0001,0.01,0.928,3771,3833
18,7704,10,100,0.0001,0.01,0.924,3828,3876
18,7804,10,100,0.0001,0.01,0.9,3883,3921
18,7904,10,100,0.0001,0.01,0.922,3930,3974
18,8004,10,100,0.0001,0.01,0.936,3978,4026
18,8104,10,100,0.0001,0.01,0.94,4026,4078
18,8204,10,100,0.0001,0.01,0.936,4080,4124
18,8304,10,100,0.0001,0.01,0.908,4132,4172
18,8404,10,100,0.0001,0.01,0.906,4175,4229
18,8504,10,100,0.0001,0.01,0.93,4235,4269
18,8604,10,100,0.0001,0.01,0.938,4284,4320
18,8704,10,100,0.0001,0.01,0.934,4331,4373
18,8804,10,100,0.0001,0.01,0.872,4374,4430
18,8904,10,100,0.0001,0.01,0.874,4420,4484
18,9004,10,100,0.0001,0.01,0.88,4467,4537
18,9104,10,100,0.0001,0.01,0.898,4525,4579
18,9204,10,100,0.0001,0.01,0.924,4579,4625
18,9304,10,100,0.0001,0.01,0.936,4636,4668
18,9404,10,100,0.0001,0.01,0.928,4684,4720
18,9504,10,100,0.0001,0.01,0.93,4732,4772
18,9604,10,100,0.0001,0.01,0.95,4782,4822
18,9704,10,100,0.0001,0.01,0.946,4826,4878
18,9804,10,100,0.0001,0.01,0.948,4873,4931
18,9904,10,100,0.0001,0.01,0.936,4917,4987
18,10004,10,100,0.0001,0.01,0.948,4970,5034
18,10104,10,100,0.0001,0.01,0.954,5024,5080
18,10204,10,100,0.0001,0.01,0.96,5076,5128
18,10304,10,100,0.0001,0.01,0.956,5125,5179
18,10404,10,100,0.0001,0.01,0.94,5171,5233
18,10504,10,100,0.0001,0.01,0.954,5219,5285
18,10604,10,100,0.0001,0.01,0.968,5266,5338
18,10704,10,100,0.0001,0.01,0.952,5321,5383
18,10804,10,100,0.0001,0.01,0.952,5364,5440
18,10904,10,100,0.0001,0.01,0.974,5411,5493
18,11004,10,100,0.0001,0.01,0.946,5458,5546
18,11104,10,100,0.0001,0.01,0.968,5509,5595
18,11204,10,100,0.0001,0.01,0.956,5563,5641
18,11304,10,100,0.0001,0.01,0.948,5620,5684
18,11404,10,100,0.0001,0.01,0.956,5671,5733
18,11504,10,100,0.0001,0.01,0.972,5730,5774
18,11604,10,100,0.0001,0.01,0.964,5776,5828
18,11704,10,100,0.0001,0.01,0.97,5829,5875
18,11804,10,100,0.0001,0.01,0.966,5874,5930
18,11904,10,100,0.0001,0.01,0.972,5926,5978
18,12004,10,100,0.0001,0.01,0.98,5980,6024
18,12104,10,100,0.0001,0.01,0.97,6029,6075
18,12204,10,100,0.0001,0.01,0.964,6068,6136
18,12304,10,100,0.0001,0.01,0.962,6118,6186
18,12404,10,100,0.0001,0.01,0.98,6165,6239
18,12504,10,100,0.0001,0.01,0.97,6211,6293
18,12604,10,100,0.0001,0.01,0.98,6258,6346
18,12704,10,100,0.0001,0.01,0.968,6307,6397
18,12804,10,100,0.0001,0.01,0.978,6355,6449
18,12904,10,100,0.0001,0.01,0.972,6405,6499
18,13004,10,100,0.0001,0.01,0.978,6457,6547
18,13104,10,100,0.0001,0.01,0.976,6506,6598
18,13204,10,100,0.0001,0.01,0.986,6564,6640
18,13304,10,100,0.0001,0.01,0.98,6617,6687
18,13404,10,100,0.0001,0.01,0.98,6666,6738
18,13504,10,100,0.0001,0.01,0.976,6715,6789
18,13604,10,100,0.0001,0.01,0.982,6768,6836
18,13704,10,100,0.0001,0.01,0.986,6830,6874
18,13804,10,100,0.0001,0.01,0.98,6881,6923
18,13904,10,100,0.0001,0.01,0.988,6918,6986
18,14004,10,100,0.0001,0.01,0.986,6965,7039
18,14104,10,100,0.0001,0.01,0.982,7025,7079
18,14204,10,100,0.0001,0.01,0.99,7074,7130
18,14304,10,100,0.0001,0.01,0.99,7130,7174
18,14404,10,100,0.0001,0.01,0.99,7181,7223
18,14504,10,100,0.0001,0.01,0.984,7234,7270
18,14604,10,100,0.0001,0.01,0.968,7288,7316
18,14704,10,100,0.0001,0.01,0.978,7346,7358
18,14804,10,100,0.0001,0.01,0.99,7393,7411
18,14904,10,100,0.0001,0.01,0.99,7450,7454
18,15004,10,100,0.0001,0.01,0.992,7499,7505
19,104,10,100,0.0001,0.01,0.532,56,48
19,204,10,100,0.0001,0.01,0.462,101,103
19,304,10,100,0.0001,0.01,0.456,156,148
19,404,10,100,0.0001,0.01,0.504,207,197
19,504,10,100,0.0001,0.01,0.516,248,256
19,604,10,100,0.0001,0.01,0.498,303,301
19,704,10,100,0.0001,0.01,0.51,353,351
19,804,10,100,0.0001,0.01,0.488,405,399
19,904,10,100,0.0001,0.01,0.49,448,456
19,1004,10,100,0.0001,0.01,0.51,496,508
19,1104,10,100,0.0001,0.01,0.5,547,557
19,1204,10,100,0.0001,0.01,0.532,597,607
19,1304,10,100,0.0001,0.01,0.518,649,655
19,1404,10,100,0.0001,0.01,0.54,696,708
19,1504,10,100,0.0001,0.01,0.514,742,762
19,1604,10,100,0.0001,0.01,0.53,788,816
19,1704,10,100,0.0001,0.01,0.512,836,868
19,1804,10,100,0.0001,0.01,0.506,887,917
19,1904,10,100,0.0001,0.01,0.516,939,965
19,2004,10,100,0.0001,0.01,0.526,988,1016
19,2104,10,100,0.0001,0.01,0.53,1042,1062
19,2204,10,100,0.0001,0.01,0.534,1087,1117
19,2304,10,100,0.0001,0.01,0.52,1138,1166
19,2404,10,100,0.0001,0.01,0.496,1184,1220
19,2504,10,100,0.0001,0.01,0.502,1241,1263
19,2604,10,100,0.0001,0.01,0.514,1291,1313
19,2704,10,100,0.0001,0.01,0.544,1341,1363
19,2804,10,100,0.0001,0.01,0.538,1396,1408
19,2904,10,100,0.0001,0.01,0.516,1443,1461
19,3004,10,100,0.0001,0.01,0.552,1495,1509
19,3104,10,100,0.0001,0.01,0.5,1540,1564
19,3204,10,100,0.0001,0.01,0.53,1592,1612
19,3304,10,100,0.0001,0.01,0.496,1643,1661
19,3404,10,100,0.0001,0.01,0.496,1690,1714
19,3504,10,100,0.0001,0.01,0.544,1745,1759
19,3604,10,100,0.0001,0.01,0.51,1798,1806
19,3704,10,100,0.0001,0.01,0.534,1856,1848
19,3804,10,100,0.0001,0.01,0.494,1903,1901
19,3904,10,100,0.0001,0.01,0.508,1949,1955
19,4004,10,100,0.0001,0.01,0.486,1991,2013
19,4104,10,100,0.0001,0.01,0.524,2050,2054
19,4204,10,100,0.0001,0.01,0.53,2101,2103
19,4304,10,100,0.0001,0.01,0.516,2150,2154
19,4404,10,100,0.0001,0.01,0.524,2199,2205
19,4504,10,100,0.0001,0.01,0.552,2251,2253
19,4604,10,100,0.0001,0.01,0.534,2299,2305
19,4704,10,100,0.0001,0.01,0.516,2352,2352
19,4804,10,100,0.0001,0.01,0.512,2396,2408
19,4904,10,100,0.0001,0.01,0.566,2442,2462
19,5004,10,100,0.0001,0.01,0.522,2489,2515
19,5104,10,100,0.0001,0.01,0.548,2545,2559
19,5204,10,100,0.0001,0.01,0.546,2588,2616
19,5304,10,100,0.0001,0.01,0.554,2645,2659
19,5404,10,100,0.0001,0.01,0.554,2697,2707
19,5504,10,100,0.0001,0.01,0.578,2754,2750
19,5604,10,100,0.0001,0.01,0.582,2801,2803
19,5704,10,100,0.0001,0.01,0.56,2852,2852
19,5804,10,100,0.0001,0.01,0.58,2904,2900
19,5904,10,100,0.0001,0.01,0.574,2965,2939
19,6004,10,100,0.0001,0.01,0.58,3015,2989
19,6104,10,100,0.0001,0.01,0.552,3072,3032
19,6204,10,100,0.0001,0.01,0.544,3124,3080
19,6304,10,100,0.0001,0.01,0.566,3175,3129
19,6404,10,100,0.0001,0.01,0.582,3213,3191
19,6504,10,100,0.0001,0.01,0.594,3264,3240
19,6604,10,100,0.0001,0.01,0.6,3322,3282
19,6704,10,100,0.0001,0.01,0.568,3368,3336
19,6804,10,100,0.0001,0.01,0.61,3417,3387
19,6904,10,100,0.0001,0.01,0.594,3475,3429
19,7004,10,100,0.0001,0.01,0.59,3523,3481
19,7104,10,100,0.0001,0.01,0.582,3569,3535
19,7204,10,100,0.0001,0.01,0.578,3622,3582
19,7304,10,100,0.0001,0.01,0.586,3674,3630
19,7404,10,100,0.0001,0.01,0.584,3726,3678
19,7504,10,100,0.0001,0.01,0.59,3775,3729
19,7604,10,100,0.0001,0.01,0.594,3830,3774
19,7704,10,100,0.0001,0.01,0.604,3885,3819
19,7804,10,100,0.0001,0.01,0.6,3929,3875
19,7904,10,100,0.0001,0.01,0.6,3977,3927
19,8004,10,100,0.0001,0.01,0.596,4026,3978
19,8104,10,100,0.0001,0.01,0.59,4076,4028
19,8204,10,100,0.0001,0.01,0.636,4118,4086
19,8304,10,100,0.0001,0.01,0.612,4162,4142
19,8404,10,100,0.0001,0.01,0.606,4221,4183
19,8504,10,100,0.0001,0.01,0.612,4270,4234
19,8604,10,100,0.0001,0.01,0.596,4318,4286
19,8704,10,100,0.0001,0.01,0.624,4367,4337
19,8804,10,100,0.0001,0.01,0.648,4419,4385
19,8904,10,100,0.0001,0.01,0.62,4463,4441
19,9004,10,100,0.0001,0.01,0.648,4513,4491
19,9104,10,100,0.0001,0.01,0.648,4570,4534
19,9204,10,100,0.0001,0.01,0.654,4615,4589
19,9304,10,100,0.0001,0.01,0.646,4661,4643
19,9404,10,100,0.0001,0.01,0.644,4706,4698
19,9504,10,100,0.0001,0.01,0.666,4752,4752
19,9604,10,100,0.0001,0.01,0.658,4808,4796
19,9704,10,100,0.0001,0.01,0.608,4858,4846
19,9804,10,100,0.0001,0.01,0.65,4905,4899
19,9904,10,100,0.0001,0.01,0.662,4955,4949
19,10004,10,100,0.0001,0.01,0.66,5009,4995
19,10104,10,100,0.0001,0.01,0.682,5051,5053
19,10204,10,100,0.0001,0.01,0.678,5100,5104
19,10304,10,100,0.0001,0.01,0.688,5154,5150
19,10404,10,100,0.0001,0.01,0.69,5200,5204
19,10504,10,100,0.0001,0.01,0.706,5253,5251
19,10604,10,100,0.0001,0.01,0.674,5304,5300
19,10704,10,100,0.0001,0.01,0.694,5352,5352
19,10804,10,100,0.0001,0.01,0.688,5402,5402
19,10904,10,100,0.0001,0.01,0.68,5454,5450
19,11004,10,100,0.0001,0.01,0.686,5509,5495
19,11104,10,100,0.0001,0.01,0.678,5562,5542
19,11204,10,100,0.0001,0.01,0.716,5614,5590
19,11304,10,100,0.0001,0.01,0.714,5650,5654
19,11404,10,100,0.0001,0.01,0.72,5698,5706
19,11504,10,100,0.0001,0.01,0.72,5749,5755
19,11604,10,100,0.0001,0.01,0.726,5804,5800
19,11704,10,100,0.0001,0.01,0.718,5856,5848
19,11804,10,100,0.0001,0.01,0.706,5918,5886
19,11904,10,100,0.0001,0.01,0.744,5971,5933
19,12004,10,100,0.0001,0.01,0.754,6017,5987
19,12104,10,100,0.0001,0.01,0.754,6061,6043
19,12204,10,100,0.0001,0.01,0.73,6106,6098
19,12304,10,100,0.0001,0.01,0.752,6159,6145
19,12404,10,100,0.0001,0.01,0.726,6205,6199
19,12504,10,100,0.0001,0.01,0.736,6253,6251
19,12604,10,100,0.0001,0.01,0.748,6306,6298
19,12704,10,100,0.0001,0.01,0.768,6359,6345
19,12804,10,100,0.0001,0.01,0.776,6409,6395
19,12904,10,100,0.0001,0.01,0.764,6467,6437
19,13004,10,100,0.0001,0.01,0.788,6511,6493
19,13104,10,100,0.0001,0.01,0.774,6556,6548
19,13204,10,100,0.0001,0.01,0.79,6605,6599
19,13304,10,100,0.0001,0.01,0.772,6664,6640
19,13404,10,100,0.0001,0.01,0.806,6717,6687
19,13504,10,100,0.0001,0.01,0.782,6765,6739
19,13604,10,100,0.0001,0.01,0.798,6806,6798
19,13704,10,100,0.0001,0.01,0.796,6859,6845
19,13804,10,100,0.0001,0.01,0.826,6907,6897
19,13904,10,100,0.0001,0.01,0.806,6963,6941
19,14004,10,100,0.0001,0.01,0.81,7006,6998
19,14104,10,100,0.0001,0.01,0.836,7056,7048
19,14204,10,100,0.0001,0.01,0.832,7105,7099
19,14304,10,100,0.0001,0.01,0.858,7150,7154
19,14404,10,100,0.0001,0.01,0.836,7190,7214
19,14504,10,100,0.0001,0.01,0.83,7238,7266
19,14604,10,100,0.0001,0.01,0.856,7292,7312
19,14704,10,100,0.0001,0.01,0.858,7339,7365
19,14804,10,100,0.0001,0.01,0.854,7388,7416
19,14904,10,100,0.0001,0.01,0.828,7439,7465
19,15004,10,100,0.0001,0.01,0.858,7486,7518
20,104,10,100,0.0001,0.01,0.468,53,51
20,204,10,100,0.0001,0.01,0.496,101,103
20,304,10,100,0.0001,0.01,0.53,153,151
20,404,10,100,0.0001,0.01,0.52,217,187
20,504,10,100,0.0001,0.01,0.524,263,241
20,604,10,100,0.0001,0.01,0.53,314,290
20,704,10,100,0.0001,0.01,0.528,358,346
20,804,10,100,0.0001,0.01,0.508,402,402
20,904,10,100,0.0001,0.01,0.528,451,453
20,1004,10,100,0.0001,0.01,0.502,504,500
20,1104,10,100,0.0001,0.01,0.52,554,550
20,1204,10,100,0.0001,0.01,0.512,596,608
20,1304,10,100,0.0001,0.01,0.504,643,661
20,1404,10,100,0.0001,0.01,0.526,688,716
20,1504,10,100,0.0001,0.01,0.486,725,779
20,1604,10,100,0.0001,0.01,0.512,776,828
20,1704,10,100,0.0001,0.01,0.536,830,874
20,1804,10,100,0.0001,0.01,0.552,877,927
20,1904,10,100,0.0001,0.01,0.528,926,978
20,2004,10,100,0.0001,0.01,0.56,974,1030
20,2104,10,100,0.0001,0.01,0.57,1029,1075
20,2204,10,100,0.0001,0.01,0.576,1074,1130
20,2304,10,100,0.0001,0.01,0.616,1119,1185
20,2404,10,100,0.0001,0.01,0.63,1173,1231
20,2504,10,100,0.0001,0.01,0.632,1228,1276
20,2604,10,100,0.0001,0.01,0.656,1282,1322
20,2704,10,100,0.0001,0.01,0.714,1333,1371
20,2804,10,100,0.0001,0.01,0.718,1381,1423
20,2904,10,100,0.0001,0.01,0.718,1432,1472
20,3004,10,100,0.0001,0.01,0.78,1484,1520
20,3104,10,100,0.0001,0.01,0.806,1530,1574
20,3204,10,100,0.0001,0.01,0.814,1588,1616
20,3304,10,100,0.0001,0.01,0.83,1637,1667
20,3404,10,100,0.0001,0.01,0.812,1696,1708
20,3504,10,100,0.0001,0.01,0.866,1745,1759
20,3604,10,100,0.0001,0.01,0.84,1797,1807
20,3704,10,100,0.0001,0.01,0.814,1848,1856
20,3804,10,100,0.0001,0.01,0.868,1893,1911
20,3904,10,100,0.0001,0.01,0.886,1942,1962
20,4004,10,100,0.0001,0.01,0.9,1991,2013
20,4104,10,100,0.0001,0.01,0.908,2038,2066
20,4204,10,100,0.0001,0.01,0.918,2087,2117
20,4304,10,100,0.0001,0.01,0.922,2138,2166
20,4404,10,100,0.0001,0.01,0.918,2190,2214
20,4504,10,100,0.0001,0.01,0.928,2241,2263
20,4604,10,100,0.0001,0.01,0.926,2295,2309
20,4704,10,100,0.0001,0.01,0.926,2343,2361
20,4804,10,100,0.0001,0.01,0.94,2390,2414
20,4904,10,100,0.0001,0.01,0.916,2439,2465
20,5004,10,100,0.0001,0.01,0.942,2487,2517
20,5104,10,100,0.0001,0.01,0.948,2541,2563
20,5204,10,100,0.0001,0.01,0.928,2583,2621
20,5304,10,100,0.0001,0.01,0.936,2632,2672
20,5404,10,100,0.0001,0.01,0.952,2688,2716
20,5504,10,100,0.0001,0.01,0.942,2738,2766
20,5604,10,100,0.0001,0.01,0.952,2794,2810
20,5704,10,100,0.0001,0.01,0.952,2848,2856
20,5804,10,100,0.0001,0.01,0.954,2901,2903
20,5904,10,100,0.0001,0.01,0.964,2959,2945
20,6004,10,100,0.0001,0.01,0.946,3007,2997
20,6104,10,100,0.0001,0.01,0.96,3053,3051
20,6204,10,100,0.0001,0.01,0.948,3097,3107
20,6304,10,100,0.0001,0.01,0.954,3146,3158
20,6404,10,100,0.0001,0.01,0.95,3202,3202
20,6504,10,100,0.0001,0.01,0.962,3250,3254
20,6604,10,100,0.0001,0.01,0.962,3299,3305
20,6704,10,100,0.0001,0.01,0.974,3350,3354
20,6804,10,100,0.0001,0.01,0.976,3410,3394
20,6904,10,100,0.0001,0.01,0.974,3451,3453
20,7004,10,100,0.0001,0.01,0.97,3496,3508
20,7104,10,100,0.0001,0.01,0.97,3548,3556
20,7204,10,100,0.0001,0.01,0.968,3594,3610
20,7304,10,100,0.0001,0.01,0.968,3643,3661
20,7404,10,100,0.0001,0.01,0.972,3688,3716
20,7504,10,100,0.0001,0.01,0.966,3739,3765
20,7604,10,100,0.0001,0.01,0.93,3800,3804
20,7704,10,100,0.0001,0.01,0.958,3859,3845
20,7804,10,100,0.0001,0.01,0.972,3902,3902
20,7904,10,100,0.0001,0.01,0.974,3961,3943
20,8004,10,100,0.0001,0.01,0.98,4014,3990
20,8104,10,100,0.0001,0.01,0.982,4063,4041
20,8204,10,100,0.0001,0.01,0.988,4107,4097
20,8304,10,100,0.0001,0.01,0.982,4149,4155
20,8404,10,100,0.0001,0.01,0.988,4196,4208
20,8504,10,100,0.0001,0.01,0.988,4246,4258
20,8604,10,100,0.0001,0.01,0.978,4297,4307
20,8704,10,100,0.0001,0.01,0.984,4347,4357
20,8804,10,100,0.0001,0.01,0.984,4398,4406
20,8904,10,100,0.0001,0.01,0.986,4456,4448
20,9004,10,100,0.0001,0.01,0.982,4499,4505
20,9104,10,100,0.0001,0.01,0.988,4551,4553
20,9204,10,100,0.0001,0.01,0.976,4614,4590
20,9304,10,100,0.0001,0.01,0.98,4663,4641
20,9404,10,100,0.0001,0.01,0.964,4713,4691
20,9504,10,100,0.0001,0.01,0.978,4765,4739
20,9604,10,100,0.0001,0.01,0.986,4811,4793
20,9704,10,100,0.0001,0.01,0.976,4864,4840
20,9804,10,100,0.0001,0.01,0.992,4907,4897
20,9904,10,100,0.0001,0.01,0.99,4953,4951
20,10004,10,100,0.0001,0.01,0.982,5011,4993
20,10104,10,100,0.0001,0.01,0.982,5052,5052
20,10204,10,100,0.0001,0.01,0.984,5098,5106
20,10304,10,100,0.0001,0.01,0.976,5146,5158
20,10404,10,100,0.0001,0.01,0.986,5200,5204
20,10504,10,100,0.0001,0.01,0.98,5251,5253
20,10604,10,100,0.0001,0.01,0.988,5297,5307
20,10704,10,100,0.0001,0.01,0.984,5349,5355
20,10804,10,100,0.0001,0.01,0.982,5402,5402
20,10904,10,100,0.0001,0.01,0.984,5450,5454
20,11004,10,100,0.0001,0.01,0.986,5495,5509
20,11104,10,100,0.0001,0.01,0.988,5543,5561
20,11204,10,100,0.0001,0.01,0.992,5590,5614
20,11304,10,100,0.0001,0.01,0.988,5642,5662
20,11404,10,100,0.0001,0.01,0.986,5692,5712
20,11504,10,100,0.0001,0.01,0.988,5757,5747
20,11604,10,100,0.0001,0.01,0.99,5808,5796
20,11704,10,100,0.0001,0.01,0.99,5857,5847
20,11804,10,100,0.0001,0.01,0.994,5909,5895
20,11904,10,100,0.0001,0.01,0.982,5961,5943
20,12004,10,100,0.0001,0.01,0.986,6008,5996
20,12104,10,100,0.0001,0.01,0.984,6066,6038
20,12204,10,100,0.0001,0.01,0.99,6112,6092
20,12304,10,100,0.0001,0.01,0.986,6161,6143
20,12404,10,100,0.0001,0.01,0.99,6216,6188
20,12504,10,100,0.0001,0.01,0.992,6267,6237
20,12604,10,100,0.0001,0.01,0.988,6317,6287
20,12704,10,100,0.0001,0.01,0.988,6368,6336
20,12804,10,100,0.0001,0.01,0.986,6415,6389
20,12904,10,100,0.0001,0.01,0.99,6469,6435
20,13004,10,100,0.0001,0.01,0.988,6517,6487
20,13104,10,100,0.0001,0.01,0.992,6570,6534
20,13204,10,100,0.0001,0.01,0.988,6622,6582
20,13304,10,100,0.0001,0.01,0.994,6669,6635
20,13404,10,100,0.0001,0.01,0.978,6720,6684
20,13504,10,100,0.0001,0.01,0.988,6766,6738
20,13604,10,100,0.0001,0.01,0.99,6812,6792
20,13704,10,100,0.0001,0.01,0.988,6856,6848
20,13804,10,100,0.0001,0.01,0.992,6907,6897
20,13904,10,100,0.0001,0.01,0.986,6961,6943
20,14004,10,100,0.0001,0.01,0.99,7008,6996
20,14104,10,100,0.0001,0.01,0.992,7058,7046
20,14204,10,100,0.0001,0.01,0.988,7106,7098
20,14304,10,100,0.0001,0.01,0.994,7161,7143
20,14404,10,100,0.0001,0.01,0.992,7205,7199
20,14504,10,100,0.0001,0.01,0.986,7262,7242
20,14604,10,100,0.0001,0.01,0.986,7313,7291
20,14704,10,100,0.0001,0.01,0.986,7369,7335
20,14804,10,100,0.0001,0.01,0.992,7417,7387
20,14904,10,100,0.0001,0.01,0.99,7467,7437
20,15004,10,100,0.0001,0.01,0.992,7518,7486
1,104,10,100,0.001,0.01,0.506,47,57
1,204,10,100,0.001,0.01,0.506,100,104
1,304,10,100,0.001,0.01,0.532,146,158
1,404,10,100,0.001,0.01,0.496,202,202
1,504,10,100,0.001,0.01,0.5,258,246
1,604,10,100,0.001,0.01,0.532,305,299
1,704,10,100,0.001,0.01,0.498,357,347
1,804,10,100,0.001,0.01,0.508,411,393
1,904,10,100,0.001,0.01,0.502,466,438
1,1004,10,100,0.001,0.01,0.518,518,486
1,1104,10,100,0.001,0.01,0.534,570,534
1,1204,10,100,0.001,0.01,0.516,617,587
1,1304,10,100,0.001,0.01,0.528,670,634
1,1404,10,100,0.001,0.01,0.516,717,687
1,1504,10,100,0.001,0.01,0.538,779,725
1,1604,10,100,0.001,0.01,0.526,833,771
1,1704,10,100,0.001,0.01,0.506,881,823
1,1804,10,100,0.001,0.01,0.502,927,877
1,1904,10,100,0.001,0.01,0.484,978,926
1,2004,10,100,0.001,0.01,0.52,1016,988
1,2104,10,100,0.001,0.01,0.516,1063,1041
1,2204,10,100,0.001,0.01,0.486,1117,1087
1,2304,10,100,0.001,0.01,0.496,1177,1127
1,2404,10,100,0.001,0.01,0.51,1232,1172
1,2504,10,100,0.001,0.01,0.512,1286,1218
1,2604,10,100,0.001,0.01,0.504,1341,1263
1,2704,10,100,0.001,0.01,0.54,1395,1309
1,2804,10,100,0.001,0.01,0.536,1438,1366
1,2904,10,100,0.001,0.01,0.524,1490,1414
1,3004,10,100,0.001,0.01,0.514,1538,1466
1,3104,10,100,0.001,0.01,0.526,1580,1524
1,3204,10,100,0.001,0.01,0.522,1626,1578
1,3304,10,100,0.001,0.01,0.512,1668,1636
1,3404,10,100,0.001,0.01,0.51,1724,1680
1,3504,10,100,0.001,0.01,0.494,1775,1729
1,3604,10,100,0.001,0.01,0.494,1824,1780
1,3704,10,100,0.001,0.01,0.506,1874,1830
1,3804,10,100,0.001,0.01,0.516,1927,1877
1,3904,10,100,0.001,0.01,0.532,1979,1925
1,4004,10,100,0.001,0.01,0.532,2034,1970
1,4104,10,100,0.001,0.01,0.552,2084,2020
1,4204,10,100,0.001,0.01,0.54,2137,2067
1,4304,10,100,0.001,0.01,0.538,2185,2119
1,4404,10,100,0.001,0.01,0.54,2237,2167
1,4504,10,100,0.001,0.01,0.554,2276,2228
1,4604,10,100,0.001,0.01,0.54,2319,2285
1,4704,10,100,0.001,0.01,0.562,2370,2334
1,4804,10,100,0.001,0.01,0.572,2408,2396
1,4904,10,100,0.001,0.01,0.542,2453,2451
1,5004,10,100,0.001,0.01,0.566,2507,2497
1,5104,10,100,0.001,0.01,0.59,2562,2542
1,5204,10,100,0.001,0.01,0.59,2611,2593
1,5304,10,100,0.001,0.01,0.61,2667,2637
1,5404,10,100,0.001,0.01,0.596,2702,2702
1,5504,10,100,0.001,0.01,0.618,2753,2751
1,5604,10,100,0.001,0.01,0.608,2800,2804
1,5704,10,100,0.001,0.01,0.644,2851,2853
1,5804,10,100,0.001,0.01,0.638,2909,2895
1,5904,10,100,0.001,0.01,0.654,2959,2945
1,6004,10,100,0.001,0.01,0.642,3011,2993
1,6104,10,100,0.001,0.01,0.646,3057,3047
1,6204,10,100,0.001,0.01,0.666,3106,3098
1,6304,10,100,0.001,0.01,0.642,3163,3141
1,6404,10,100,0.001,0.01,0.656,3216,3188
1,6504,10,100,0.001,0.01,0.662,3271,3233
1,6604,10,100,0.001,0.01,0.672,3321,3283
1,6704,10,100,0.001,0.01,0.646,3372,3332
1,6804,10,100,0.001,0.01,0.664,3426,3378
1,6904,10,100,0.001,0.01,0.682,3476,3428
1,7004,10,100,0.001,0.01,0.702,3524,3480
1,7104,10,100,0.001,0.01,0.67,3556,3548
1,7204,10,100,0.001,0.01,0.696,3605,3599
1,7304,10,100,0.001,0.01,0.69,3650,3654
1,7404,10,100,0.001,0.01,0.688,3697,3707
1,7504,10,100,0.001,0.01,0.706,3751,3753
1,7604,10,100,0.001,0.01,0.72,3807,3797
1,7704,10,100,0.001,0.01,0.722,3860,3844
1,7804,10,100,0.001,0.01,0.722,3908,3896
1,7904,10,100,0.001,0.01,0.726,3965,3939
1,8004,10,100,0.001,0.01,0.726,4008,3996
1,8104,10,100,0.001,0.01,0.738,4067,4037
1,8204,10,100,0.001,0.01,0.738,4110,4094
1,8304,10,100,0.001,0.01,0.746,4162,4142
1,8404,10,100,0.001,0.01,0.734,4211,4193
1,8504,10,100,0.001,0.01,0.734,4258,4246
1,8604,10,100,0.001,0.01,0.718,4309,4295
1,8704,10,100,0.001,0.01,0.76,4363,4341
1,8804,10,100,0.001,0.01,0.74,4415,4389
1,8904,10,100,0.001,0.01,0.766,4471,4433
1,9004,10,100,0.001,0.01,0.76,4518,4486
1,9104,10,100,0.001,0.01,0.754,4571,4533
1,9204,10,100,0.001,0.01,0.752,4620,4584
1,9304,10,100,0.001,0.01,0.778,4672,4632
1,9404,10,100,0.001,0.01,0.79,4729,4675
1,9504,10,100,0.001,0.01,0.772,4777,4727
1,9604,10,100,0.001,0.01,0.786,4836,4768
1,9704,10,100,0.001,0.01,0.794,4878,4826
1,9804,10,100,0.001,0.01,0.778,4917,4887
1,9904,10,100,0.001,0.01,0.758,4965,4939
1,10004,10,100,0.001,0.01,0.776,5018,4986
1,10104,10,100,0.001,0.01,0.782,5066,5038
1,10204,10,100,0.001,0.01,0.772,5105,5099
1,10304,10,100,0.001,0.01,0.778,5149,5155
1,10404,10,100,0.001,0.01,0.764,5197,5207
1,10504,10,100,0.001,0.01,0.804,5249,5255
1,10604,10,100,0.001,0.01,0.8,5297,5307
1,10704,10,100,0.001,0.01,0.788,5354,5350
1,10804,10,100,0.001,0.01,0.8,5403,5401
1,10904,10,100,0.001,0.01,0.794,5461,5443
1,11004,10,100,0.001,0.01,0.788,5504,5500
1,11104,10,100,0.001,0.01,0.808,5550,5554
1,11204,10,100,0.001,0.01,0.802,5600,5604
1,11304,10,100,0.001,0.01,0.8,5652,5652
1,11404,10,100,0.001,0.01,0.822,5706,5698
1,11504,10,100,0.001,0.01,0.832,5749,5755
1,11604,10,100,0.001,0.01,0.838,5794,5810
1,11704,10,100,0.001,0.01,0.832,5844,5860
1,11804,10,100,0.001,0.01,0.826,5891,5913
1,11904,10,100,0.001,0.01,0.826,5941,5963
1,12004,10,100,0.001,0.01,0.826,5994,6010
1,12104,10,100,0.001,0.01,0.844,6051,6053
1,12204,10,100,0.001,0.01,0.828,6099,6105
1,12304,10,100,0.001,0.01,0.86,6139,6165
1,12404,10,100,0.001,0.01,0.846,6181,6223
1,12504,10,100,0.001,0.01,0.84,6239,6265
1,12604,10,100,0.001,0.01,0.854,6295,6309
1,12704,10,100,0.001,0.01,0.854,6353,6351
1,12804,10,100,0.001,0.01,0.856,6410,6394
1,12904,10,100,0.001,0.01,0.838,6461,6443
1,13004,10,100,0.001,0.01,0.838,6504,6500
1,13104,10,100,0.001,0.01,0.838,6550,6554
1,13204,10,100,0.001,0.01,0.862,6603,6601
1,13304,10,100,0.001,0.01,0.866,6657,6647
1,13404,10,100,0.001,0.01,0.868,6706,6698
1,13504,10,100,0.001,0.01,0.876,6759,6745
1,13604,10,100,0.001,0.01,0.898,6816,6788
1,13704,10,100,0.001,0.01,0.892,6870,6834
1,13804,10,100,0.001,0.01,0.896,6909,6895
1,13904,10,100,0.001,0.01,0.904,6952,6952
1,14004,10,100,0.001,0.01,0.898,7004,7000
1,14104,10,100,0.001,0.01,0.878,7054,7050
1,14204,10,100,0.001,0.01,0.894,7102,7102
1,14304,10,100,0.001,0.01,0.9,7156,7148
1,14404,10,100,0.001,0.01,0.91,7199,7205
1,14504,10,100,0.001,0.01,0.922,7243,7261
1,14604,10,100,0.001,0.01,0.922,7295,7309
1,14704,10,100,0.001,0.01,0.912,7344,7360
1,14804,10,100,0.001,0.01,0.914,7399,7405
1,14904,10,100,0.001,0.01,0.924,7445,7459
1,15004,10,100,0.001,0.01,0.916,7499,7505
2,104,10,100,0.001,0.01,0.456,60,44
2,204,10,100,0.001,0.01,0.468,110,94
2,304,10,100,0.001,0.01,0.544,160,144
2,404,10,100,0.001,0.01,0.532,207,197
2,504,10,100,0.001,0.01,0.498,266,238
2,604,10,100,0.001,0.01,0.466,314,290
2,704,10,100,0.001,0.01,0.466,362,342
2,804,10,100,0.001,0.01,0.5,418,386
2,904,10,100,0.001,0.01,0.484,468,436
2,1004,10,100,0.001,0.01,0.47,520,484
2,1104,10,100,0.001,0.01,0.48,565,539
2,1204,10,100,0.001,0.01,0.474,620,584
2,1304,10,100,0.001,0.01,0.464,669,635
2,1404,10,100,0.001,0.01,0.488,718,686
2,1504,10,100,0.001,0.01,0.478,767,737
2,1604,10,100,0.001,0.01,0.518,818,786
2,1704,10,100,0.001,0.01,0.506,868,836
2,1804,10,100,0.001,0.01,0.52,924,880
2,1904,10,100,0.001,0.01,0.524,971,933
2,2004,10,100,0.001,0.01,0.526,1027,977
2,2104,10,100,0.001,0.01,0.538,1084,1020
2,2204,10,100,0.001,0.01,0.556,1136,1068
2,2304,10,100,0.001,0.01,0.578,1189,1115
2,2404,10,100,0.001,0.01,0.562,1238,1166
2,2504,10,100,0.001,0.01,0.572,1287,1217
2,2604,10,100,0.001,0.01,0.59,1342,1262
2,2704,10,100,0.001,0.01,0.594,1384,1320
2,2804,10,100,0.001,0.01,0.588,1428,1376
2,2904,10,100,0.001,0.01,0.63,1475,1429
2,3004,10,100,0.001,0.01,0.626,1524,1480
2,3104,10,100,0.001,0.01,0.624,1574,1530
2,3204,10,100,0.001,0.01,0.636,1624,1580
2,3304,10,100,0.001,0.01,0.688,1673,1631
2,3404,10,100,0.001,0.01,0.68,1728,1676
2,3504,10,100,0.001,0.01,0.696,1776,1728
2,3604,10,100,0.001,0.01,0.726,1814,1790
2,3704,10,100,0.001,0.01,0.726,1859,1845
2,3804,10,100,0.001,0.01,0.754,1907,1897
2,3904,10,100,0.001,0.01,0.772,1965,1939
2,4004,10,100,0.001,0.01,0.748,2024,1980
2,4104,10,100,0.001,0.01,0.8,2075,2029
2,4204,10,100,0.001,0.01,0.82,2133,2071
2,4304,10,100,0.001,0.01,0.802,2174,2130
2,4404,10,100,0.001,0.01,0.832,2224,2180
2,4504,10,100,0.001,0.01,0.834,2276,2228
2,4604,10,100,0.001,0.01,0.826,2321,2283
2,4704,10,100,0.001,0.01,0.796,2364,2340
2,4804,10,100,0.001,0.01,0.814,2411,2393
2,4904,10,100,0.001,0.01,0.824,2465,2439
2,5004,10,100,0.001,0.01,0.81,2508,2496
2,5104,10,100,0.001,0.01,0.856,2557,2547
2,5204,10,100,0.001,0.01,0.806,2605,2599
2,5304,10,100,0.001,0.01,0.82,2661,2643
2,5404,10,100,0.001,0.01,0.812,2711,2693
2,5504,10,100,0.001,0.01,0.832,2750,2754
2,5604,10,100,0.001,0.01,0.834,2799,2805
2,5704,10,100,0.001,0.01,0.866,2845,2859
2,5804,10,100,0.001,0.01,0.862,2901,2903
2,5904,10,100,0.001,0.01,0.854,2949,2955
2,6004,10,100,0.001,0.01,0.882,3000,3004
2,6104,10,100,0.001,0.01,0.88,3048,3056
2,6204,10,100,0.001,0.01,0.87,3105,3099
2,6304,10,100,0.001,0.01,0.894,3158,3146
2,6404,10,100,0.001,0.01,0.88,3211,3193
2,6504,10,100,0.001,0.01,0.894,3260,3244
2,6604,10,100,0.001,0.01,0.872,3304,3300
2,6704,10,100,0.001,0.01,0.84,3355,3349
2,6804,10,100,0.001,0.01,0.868,3403,3401
2,6904,10,100,0.001,0.01,0.874,3449,3455
2,7004,10,100,0.001,0.01,0.902,3505,3499
2,7104,10,100,0.001,0.01,0.896,3552,3552
2,7204,10,100,0.001,0.01,0.91,3593,3611
2,7304,10,100,0.001,0.01,0.92,3646,3658
2,7404,10,100,0.001,0.01,0.918,3698,3706
2,7504,10,100,0.001,0.01,0.912,3756,3748
2,7604,10,100,0.001,0.01,0.902,3803,3801
2,7704,10,100,0.001,0.01,0.924,3851,3853
2,7804,10,100,0.001,0.01,0.91,3896,3908
2,7904,10,100,0.001,0.01,0.934,3945,3959
2,8004,10,100,0.001,0.01,0.926,3992,4012
2,8104,10,100,0.001,0.01,0.93,4036,4068
2,8204,10,100,0.001,0.01,0.916,4090,4114
2,8304,10,100,0.001,0.01,0.93,4149,4155
2,8404,10,100,0.001,0.01,0.934,4204,4200
2,8504,10,100,0.001,0.01,0.946,4259,4245
2,8604,10,100,0.001,0.01,0.93,4317,4287
2,8704,10,100,0.001,0.01,0.924,4364,4340
2,8804,10,100,0.001,0.01,0.924,4415,4389
2,8904,10,100,0.001,0.01,0.942,4465,4439
2,9004,10,100,0.001,0.01,0.948,4526,4478
2,9104,10,100,0.001,0.01,0.944,4577,4527
2,9204,10,100,0.001,0.01,0.91,4629,4575
2,9304,10,100,0.001,0.01,0.916,4676,4628
2,9404,10,100,0.001,0.01,0.944,4730,4674
2,9504,10,100,0.001,0.01,0.944,4791,4713
2,9604,10,100,0.001,0.01,0.956,4848,4756
2,9704,10,100,0.001,0.01,0.956,4893,4811
2,9804,10,100,0.001,0.01,0.956,4944,4860
2,9904,10,100,0.001,0.01,0.96,5006,4898
2,10004,10,100,0.001,0.01,0.968,5060,4944
2,10104,10,100,0.001,0.01,0.962,5104,5000
2,10204,10,100,0.001,0.01,0.942,5145,5059
2,10304,10,100,0.001,0.01,0.95,5195,5109
2,10404,10,100,0.001,0.01,0.954,5251,5153
2,10504,10,100,0.001,0.01,0.95,5303,5201
2,10604,10,100,0.001,0.01,0.956,5357,5247
2,10704,10,100,0.001,0.01,0.968,5405,5299
2,10804,10,100,0.001,0.01,0.968,5445,5359
2,10904,10,100,0.001,0.01,0.944,5494,5410
2,11004,10,100,0.001,0.01,0.938,5542,5462
2,11104,10,100,0.001,0.01,0.956,5582,5522
2,11204,10,100,0.001,0.01,0.976,5626,5578
2,11304,10,100,0.001,0.01,0.972,5676,5628
2,11404,10,100,0.001,0.01,0.978,5723,5681
2,11504,10,100,0.001,0.01,0.974,5766,5738
2,11604,10,100,0.001,0.01,0.948,5816,5788
2,11704,10,100,0.001,0.01,0.962,5859,5845
2,11804,10,100,0.001,0.01,0.974,5918,5886
2,11904,10,100,0.001,0.01,0.97,5969,5935
2,12004,10,100,0.001,0.01,0.972,6025,5979
2,12104,10,100,0.001,0.01,0.982,6081,6023
2,12204,10,100,0.001,0.01,0.978,6128,6076
2,12304,10,100,0.001,0.01,0.982,6179,6125
2,12404,10,100,0.001,0.01,0.978,6235,6169
2,12504,10,100,0.001,0.01,0.974,6289,6215
2,12604,10,100,0.001,0.01,0.974,6346,6258
2,12704,10,100,0.001,0.01,0.966,6385,6319
2,12804,10,100,0.001,0.01,0.99,6432,6372
2,12904,10,100,0.001,0.01,0.97,6477,6427
2,13004,10,100,0.001,0.01,0.964,6528,6476
2,13104,10,100,0.001,0.01,0.982,6581,6523
2,13204,10,100,0.001,0.01,0.98,6623,6581
2,13304,10,100,0.001,0.01,0.984,6673,6631
2,13404,10,100,0.001,0.01,0.984,6726,6678
2,13504,10,100,0.001,0.01,0.976,6785,6719
2,13604,10,100,0.001,0.01,0.98,6826,6778
2,13704,10,100,0.001,0.01,0.976,6875,6829
2,13804,10,100,0.001,0.01,0.974,6936,6868
2,13904,10,100,0.001,0.01,0.98,6988,6916
2,14004,10,100,0.001,0.01,0.984,7044,6960
2,14104,10,100,0.001,0.01,0.992,7098,7006
2,14204,10,100,0.001,0.01,0.984,7149,7055
2,14304,10,100,0.001,0.01,0.99,7198,7106
2,14404,10,100,0.001,0.01,0.988,7243,7161
2,14504,10,100,0.001,0.01,0.974,7281,7223
2,14604,10,100,0.001,0.01,0.982,7333,7271
2,14704,10,100,0.001,0.01,0.992,7382,7322
2,14804,10,100,0.001,0.01,0.988,7430,7374
2,14904,10,100,0.001,0.01,0.99,7485,7419
2,15004,10,100,0.001,0.01,0.99,7524,7480
3,104,10,100,0.001,0.01,0.522,45,59
3,204,10,100,0.001,0.01,0.454,98,106
3,304,10,100,0.001,0.01,0.486,141,163
3,404,10,100,0.001,0.01,0.506,187,217
3,504,10,100,0.001,0.01,0.5,240,264
3,604,10,100,0.001,0.01,0.464,291,313
3,704,10,100,0.001,0.01,0.48,341,363
3,804,10,100,0.001,0.01,0.516,385,419
3,904,10,100,0.001,0.01,0.458,442,462
3,1004,10,100,0.001,0.01,0.468,493,511
3,1104,10,100,0.001,0.01,0.472,543,561
3,1204,10,100,0.001,0.01,0.456,588,616
3,1304,10,100,0.001,0.01,0.466,644,660
3,1404,10,100,0.001,0.01,0.48,691,713
3,1504,10,100,0.001,0.01,0.488,742,762
3,1604,10,100,0.001,0.01,0.482,793,811
3,1704,10,100,0.001,0.01,0.494,850,854
3,1804,10,100,0.001,0.01,0.52,904,900
3,1904,10,100,0.001,0.01,0.504,951,953
3,2004,10,100,0.001,0.01,0.514,995,1009
3,2104,10,100,0.001,0.01,0.528,1042,1062
3,2204,10,100,0.001,0.01,0.512,1088,1116
3,2304,10,100,0.001,0.01,0.546,1135,1169
3,2404,10,100,0.001,0.01,0.528,1188,1216
3,2504,10,100,0.001,0.01,0.542,1239,1265
3,2604,10,100,0.001,0.01,0.534,1284,1320
3,2704,10,100,0.001,0.01,0.552,1333,1371
3,2804,10,100,0.001,0.01,0.548,1388,1416
3,2904,10,100,0.001,0.01,0.566,1436,1468
3,3004,10,100,0.001,0.01,0.562,1477,1527
3,3104,10,100,0.001,0.01,0.6,1530,1574
3,3204,10,100,0.001,0.01,0.59,1573,1631
3,3304,10,100,0.001,0.01,0.614,1622,1682
3,3404,10,100,0.001,0.01,0.628,1664,1740
3,3504,10,100,0.001,0.01,0.622,1720,1784
3,3604,10,100,0.001,0.01,0.638,1772,1832
3,3704,10,100,0.001,0.01,0.648,1820,1884
3,3804,10,100,0.001,0.01,0.666,1871,1933
3,3904,10,100,0.001,0.01,0.704,1920,1984
3,4004,10,100,0.001,0.01,0.714,1974,2030
3,4104,10,100,0.001,0.01,0.73,2018,2086
3,4204,10,100,0.001,0.01,0.756,2073,2131
3,4304,10,100,0.001,0.01,0.732,2125,2179
3,4404,10,100,0.001,0.01,0.754,2178,2226
3,4504,10,100,0.001,0.01,0.79,2225,2279
3,4604,10,100,0.001,0.01,0.796,2280,2324
3,4704,10,100,0.001,0.01,0.788,2323,2381
3,4804,10,100,0.001,0.01,0.826,2377,2427
3,4904,10,100,0.001,0.01,0.83,2434,2470
3,5004,10,100,0.001,0.01,0.838,2487,2517
3,5104,10,100,0.001,0.01,0.858,2544,2560
3,5204,10,100,0.001,0.01,0.866,2590,2614
3,5304,10,100,0.001,0.01,0.846,2633,2671
3,5404,10,100,0.001,0.01,0.87,2682,2722
3,5504,10,100,0.001,0.01,0.85,2738,2766
3,5604,10,100,0.001,0.01,0.864,2784,2820
3,5704,10,100,0.001,0.01,0.912,2841,2863
3,5804,10,100,0.001,0.01,0.876,2888,2916
3,5904,10,100,0.001,0.01,0.902,2946,2958
3,6004,10,100,0.001,0.01,0.892,2995,3009
3,6104,10,100,0.001,0.01,0.898,3052,3052
3,6204,10,100,0.001,0.01,0.908,3105,3099
3,6304,10,100,0.001,0.01,0.906,3143,3161
3,6404,10,100,0.001,0.01,0.898,3193,3211
3,6504,10,100,0.001,0.01,0.908,3233,3271
3,6604,10,100,0.001,0.01,0.896,3289,3315
3,6704,10,100,0.001,0.01,0.926,3332,3372
3,6804,10,100,0.001,0.01,0.904,3377,3427
3,6904,10,100,0.001,0.01,0.926,3419,3485
3,7004,10,100,0.001,0.01,0.92,3465,3539
3,7104,10,100,0.001,0.01,0.934,3524,3580
3,7204,10,100,0.001,0.01,0.942,3585,3619
3,7304,10,100,0.001,0.01,0.918,3633,3671
3,7404,10,100,0.001,0.01,0.91,3690,3714
3,7504,10,100,0.001,0.01,0.916,3734,3770
3,7604,10,100,0.001,0.01,0.93,3782,3822
3,7704,10,100,0.001,0.01,0.942,3836,3868
3,7804,10,100,0.001,0.01,0.948,3882,3922
3,7904,10,100,0.001,0.01,0.948,3938,3966
3,8004,10,100,0.001,0.01,0.952,3987,4017
3,8104,10,100,0.001,0.01,0.962,4033,4071
3,8204,10,100,0.001,0.01,0.966,4086,4118
3,8304,10,100,0.001,0.01,0.92,4138,4166
3,8404,10,100,0.001,0.01,0.952,4194,4210
3,8504,10,100,0.001,0.01,0.94,4242,4262
3,8604,10,100,0.001,0.01,0.972,4287,4317
3,8704,10,100,0.001,0.01,0.968,4336,4368
3,8804,10,100,0.001,0.01,0.956,4385,4419
3,8904,10,100,0.001,0.01,0.958,4437,4467
3,9004,10,100,0.001,0.01,0.958,4494,4510
3,9104,10,100,0.001,0.01,0.956,4548,4556
3,9204,10,100,0.001,0.01,0.966,4596,4608
3,9304,10,100,0.001,0.01,0.962,4651,4653
3,9404,10,100,0.001,0.01,0.948,4696,4708
3,9504,10,100,0.001,0.01,0.968,4750,4754
3,9604,10,100,0.001,0.01,0.962,4804,4800
3,9704,10,100,0.001,0.01,0.946,4855,4849
3,9804,10,100,0.001,0.01,0.968,4906,4898
3,9904,10,100,0.001,0.01,0.966,4959,4945
3,10004,10,100,0.001,0.01,0.976,5009,4995
3,10104,10,100,0.001,0.01,0.976,5061,5043
3,10204,10,100,0.001,0.01,0.962,5111,5093
3,10304,10,100,0.001,0.01,0.95,5159,5145
3,10404,10,100,0.001,0.01,0.976,5213,5191
3,10504,10,100,0.001,0.01,0.972,5253,5251
3,10604,10,100,0.001,0.01,0.98,5304,5300
3,10704,10,100,0.001,0.01,0.978,5344,5360
3,10804,10,100,0.001,0.01,0.974,5394,5410
3,10904,10,100,0.001,0.01,0.962,5449,5455
3,11004,10,100,0.001,0.01,0.98,5492,5512
3,11104,10,100,0.001,0.01,0.976,5545,5559
3,11204,10,100,0.001,0.01,0.97,5598,5606
3,11304,10,100,0.001,0.01,0.974,5648,5656
3,11404,10,100,0.001,0.01,0.976,5694,5710
3,11504,10,100,0.001,0.01,0.976,5746,5758
3,11604,10,100,0.001,0.01,0.98,5785,5819
3,11704,10,100,0.001,0.01,0.978,5836,5868
3,11804,10,100,0.001,0.01,0.974,5884,5920
3,11904,10,100,0.001,0.01,0.978,5927,5977
3,12004,10,100,0.001,0.01,0.978,5966,6038
3,12104,10,100,0.001,0.01,0.976,6022,6082
3,12204,10,100,0.001,0.01,0.974,6076,6128
3,12304,10,100,0.001,0.01,0.976,6129,6175
3,12404,10,100,0.001,0.01,0.978,6184,6220
3,12504,10,100,0.001,0.01,0.98,6238,6266
3,12604,10,100,0.001,0.01,0.976,6297,6307
3,12704,10,100,0.001,0.01,0.974,6334,6370
3,12804,10,100,0.001,0.01,0.974,6384,6420
3,12904,10,100,0.001,0.01,0.978,6443,6461
3,13004,10,100,0.001,0.01,0.982,6486,6518
3,13104,10,100,0.001,0.01,0.982,6534,6570
3,13204,10,100,0.001,0.01,0.974,6579,6625
3,13304,10,100,0.001,0.01,0.964,6635,6669
3,13404,10,100,0.001,0.01,0.972,6683,6721
3,13504,10,100,0.001,0.01,0.982,6731,6773
3,13604,10,100,0.001,0.01,0.982,6780,6824
3,13704,10,100,0.001,0.01,0.984,6830,6874
3,13804,10,100,0.001,0.01,0.978,6884,6920
3,13904,10,100,0.001,0.01,0.986,6937,6967
3,14004,10,100,0.001,0.01,0.984,6987,7017
3,14104,10,100,0.001,0.01,0.98,7042,7062
3,14204,10,100,0.001,0.01,0.984,7089,7115
3,14304,10,100,0.001,0.01,0.986,7141,7163
3,14404,10,100,0.001,0.01,0.974,7197,7207
3,14504,10,100,0.001,0.01,0.98,7243,7261
3,14604,10,100,0.001,0.01,0.982,7302,7302
3,14704,10,100,0.001,0.01,0.988,7358,7346
3,14804,10,100,0.001,0.01,0.988,7411,7393
3,14904,10,100,0.001,0.01,0.988,7464,7440
3,15004,10,100,0.001,0.01,0.988,7513,7491
4,104,10,100,0.001,0.01,0.498,45,59
4,204,10,100,0.001,0.01,0.512,104,100
4,304,10,100,0.001,0.01,0.492,160,144
4,404,10,100,0.001,0.01,0.468,207,197
4,504,10,100,0.001,0.01,0.474,258,246
4,604,10,100,0.001,0.01,0.466,305,299
4,704,10,100,0.001,0.01,0.464,359,345
4,804,10,100,0.001,0.01,0.462,411,393
4,904,10,100,0.001,0.01,0.46,465,439
4,1004,10,100,0.001,0.01,0.498,509,495
4,1104,10,100,0.001,0.01,0.502,560,544
4,1204,10,100,0.001,0.01,0.49,607,597
4,1304,10,100,0.001,0.01,0.49,654,650
4,1404,10,100,0.001,0.01,0.46,704,700
4,1504,10,100,0.001,0.01,0.478,752,752
4,1604,10,100,0.001,0.01,0.478,804,800
4,1704,10,100,0.001,0.01,0.484,856,848
4,1804,10,100,0.001,0.01,0.482,909,895
4,1904,10,100,0.001,0.01,0.48,962,942
4,2004,10,100,0.001,0.01,0.502,1013,991
4,2104,10,100,0.001,0.01,0.51,1062,1042
4,2204,10,100,0.001,0.01,0.52,1114,1090
4,2304,10,100,0.001,0.01,0.556,1165,1139
4,2404,10,100,0.001,0.01,0.56,1210,1194
4,2504,10,100,0.001,0.01,0.588,1250,1254
4,2604,10,100,0.001,0.01,0.6,1299,1305
4,2704,10,100,0.001,0.01,0.664,1346,1358
4,2804,10,100,0.001,0.01,0.686,1392,1412
4,2904,10,100,0.001,0.01,0.676,1443,1461
4,3004,10,100,0.001,0.01,0.716,1496,1508
4,3104,10,100,0.001,0.01,0.73,1551,1553
4,3204,10,100,0.001,0.01,0.756,1603,1601
4,3304,10,100,0.001,0.01,0.792,1654,1650
4,3404,10,100,0.001,0.01,0.778,1704,1700
4,3504,10,100,0.001,0.01,0.78,1753,1751
4,3604,10,100,0.001,0.01,0.808,1806,1798
4,3704,10,100,0.001,0.01,0.83,1850,1854
4,3804,10,100,0.001,0.01,0.844,1910,1894
4,3904,10,100,0.001,0.01,0.85,1955,1949
4,4004,10,100,0.001,0.01,0.836,2002,2002
4,4104,10,100,0.001,0.01,0.86,2052,2052
4,4204,10,100,0.001,0.01,0.888,2103,2101
4,4304,10,100,0.001,0.01,0.884,2157,2147
4,4404,10,100,0.001,0.01,0.872,2215,2189
4,4504,10,100,0.001,0.01,0.888,2262,2242
4,4604,10,100,0.001,0.01,0.88,2319,2285
4,4704,10,100,0.001,0.01,0.89,2367,2337
4,4804,10,100,0.001,0.01,0.888,2416,2388
4,4904,10,100,0.001,0.01,0.912,2464,2440
4,5004,10,100,0.001,0.01,0.922,2514,2490
4,5104,10,100,0.001,0.01,0.924,2565,2539
4,5204,10,100,0.001,0.01,0.936,2610,2594
4,5304,10,100,0.001,0.01,0.938,2657,2647
4,5404,10,100,0.001,0.01,0.932,2707,2697
4,5504,10,100,0.001,0.01,0.948,2757,2747
4,5604,10,100,0.001,0.01,0.94,2810,2794
4,5704,10,100,0.001,0.01,0.938,2852,2852
4,5804,10,100,0.001,0.01,0.932,2901,2903
4,5904,10,100,0.001,0.01,0.95,2946,2958
4,6004,10,100,0.001,0.01,0.958,2989,3015
4,6104,10,100,0.001,0.01,0.96,3039,3065
4,6204,10,100,0.001,0.01,0.964,3093,3111
4,6304,10,100,0.001,0.01,0.962,3142,3162
4,6404,10,100,0.001,0.01,0.96,3195,3209
4,6504,10,100,0.001,0.01,0.97,3256,3248
4,6604,10,100,0.001,0.01,0.97,3306,3298
4,6704,10,100,0.001,0.01,0.97,3360,3344
4,6804,10,100,0.001,0.01,0.974,3402,3402
4,6904,10,100,0.001,0.01,0.966,3460,3444
4,7004,10,100,0.001,0.01,0.976,3506,3498
4,7104,10,100,0.001,0.01,0.98,3555,3549
4,7204,10,100,0.001,0.01,0.978,3607,3597
4,7304,10,100,0.001,0.01,0.968,3667,3637
4,7404,10,100,0.001,0.01,0.968,3719,3685
4,7504,10,100,0.001,0.01,0.956,3778,3726
4,7604,10,100,0.001,0.01,0.96,3820,3784
4,7704,10,100,0.001,0.01,0.98,3862,3842
4,7804,10,100,0.001,0.01,0.976,3915,3889
4,7904,10,100,0.001,0.01,0.978,3959,3945
4,8004,10,100,0.001,0.01,0.978,4001,4003
4,8104,10,100,0.001,0.01,0.986,4054,4050
4,8204,10,100,0.001,0.01,0.98,4113,4091
4,8304,10,100,0.001,0.01,0.99,4171,4133
4,8404,10,100,0.001,0.01,0.99,4214,4190
4,8504,10,100,0.001,0.01,0.978,4263,4241
4,8604,10,100,0.001,0.01,0.976,4316,4288
4,8704,10,100,0.001,0.01,0.986,4370,4334
4,8804,10,100,0.001,0.01,0.986,4416,4388
4,8904,10,100,0.001,0.01,0.982,4463,4441
4,9004,10,100,0.001,0.01,0.98,4513,4491
4,9104,10,100,0.001,0.01,0.978,4569,4535
4,9204,10,100,0.001,0.01,0.99,4620,4584
4,9304,10,100,0.001,0.01,0.99,4661,4643
4,9404,10,100,0.001,0.01,0.98,4715,4689
4,9504,10,100,0.001,0.01,0.988,4769,4735
4,9604,10,100,0.001,0.01,0.98,4822,4782
4,9704,10,100,0.001,0.01,0.978,4868,4836
4,9804,10,100,0.001,0.01,0.982,4915,4889
4,9904,10,100,0.001,0.01,0.984,4960,4944
4,10004,10,100,0.001,0.01,0.986,5016,4988
4,10104,10,100,0.001,0.01,0.986,5065,5039
4,10204,10,100,0.001,0.01,0.988,5114,5090
4,10304,10,100,0.001,0.01,0.986,5163,5141
4,10404,10,100,0.001,0.01,0.988,5218,5186
4,10504,10,100,0.001,0.01,0.988,5268,5236
4,10604,10,100,0.001,0.01,0.988,5320,5284
4,10704,10,100,0.001,0.01,0.988,5372,5332
4,10804,10,100,0.001,0.01,0.988,5419,5385
4,10904,10,100,0.001,0.01,0.99,5468,5436
4,11004,10,100,0.001,0.01,0.992,5511,5493
4,11104,10,100,0.001,0.01,0.992,5556,5548
4,11204,10,100,0.001,0.01,0.994,5601,5603
4,11304,10,100,0.001,0.01,0.992,5648,5656
4,11404,10,100,0.001,0.01,0.988,5697,5707
4,11504,10,100,0.001,0.01,0.994,5746,5758
4,11604,10,100,0.001,0.01,0.994,5801,5803
4,11704,10,100,0.001,0.01,0.994,5846,5858
4,11804,10,100,0.001,0.01,0.99,5892,5912
4,11904,10,100,0.001,0.01,0.994,5938,5966
4,12004,10,100,0.001,0.01,0.986,5989,6015
4,12104,10,100,0.001,0.01,0.992,6033,6071
4,12204,10,100,0.001,0.01,0.992,6081,6123
4,12304,10,100,0.001,0.01,0.99,6135,6169
4,12404,10,100,0.001,0.01,0.992,6186,6218
4,12504,10,100,0.001,0.01,0.988,6233,6271
4,12604,10,100,0.001,0.01,0.98,6278,6326
4,12704,10,100,0.001,0.01,0.988,6323,6381
4,12804,10,100,0.001,0.01,0.988,6371,6433
4,12904,10,100,0.001,0.01,0.992,6427,6477
4,13004,10,100,0.001,0.01,0.992,6474,6530
4,13104,10,100,0.001,0.01,0.986,6528,6576
4,13204,10,100,0.001,0.01,0.99,6582,6622
4,13304,10,100,0.001,0.01,0.992,6630,6674
4,13404,10,100,0.001,0.01,0.994,6690,6714
4,13504,10,100,0.001,0.01,0.994,6746,6758
4,13604,10,100,0.001,0.01,0.994,6795,6809
4,13704,10,100,0.001,0.01,0.992,6846,6858
4,13804,10,100,0.001,0.01,0.994,6893,6911
4,13904,10,100,0.001,0.01,0.994,6943,6961
4,14004,10,100,0.001,0.01,0.994,6996,7008
4,14104,10,100,0.001,0.01,0.994,7048,7056
4,14204,10,100,0.001,0.01,0.994,7098,7106
4,14304,10,100,0.001,0.01,0.976,7146,7158
4,14404,10,100,0.001,0.01,0.99,7190,7214
4,14504,10,100,0.001,0.01,0.99,7235,7269
4,14604,10,100,0.001,0.01,0.992,7289,7315
4,14704,10,100,0.001,0.01,0.992,7335,7369
4,14804,10,100,0.001,0.01,0.996,7388,7416
4,14904,10,100,0.001,0.01,0.994,7452,7452
4,15004,10,100,0.001,0.01,0.994,7501,7503
5,104,10,100,0.001,0.01,0.496,50,54
5,204,10,100,0.001,0.01,0.508,88,116
5,304,10,100,0.001,0.01,0.504,143,161
5,404,10,100,0.001,0.01,0.506,196,208
5,504,10,100,0.001,0.01,0.484,246,258
5,604,10,100,0.001,0.01,0.462,302,302
5,704,10,100,0.001,0.01,0.466,362,342
5,804,10,100,0.001,0.01,0.498,409,395
5,904,10,100,0.001,0.01,0.524,454,450
5,1004,10,100,0.001,0.01,0.512,502,502
5,1104,10,100,0.001,0.01,0.496,541,563
5,1204,10,100,0.001,0.01,0.476,586,618
5,1304,10,100,0.001,0.01,0.492,637,667
5,1404,10,100,0.001,0.01,0.472,687,717
5,1504,10,100,0.001,0.01,0.486,734,770
5,1604,10,100,0.001,0.01,0.504,780,824
5,1704,10,100,0.001,0.01,0.51,823,881
5,1804,10,100,0.001,0.01,0.494,868,936
5,1904,10,100,0.001,0.01,0.522,916,988
5,2004,10,100,0.001,0.01,0.502,962,1042
5,2104,10,100,0.001,0.01,0.516,1010,1094
5,2204,10,100,0.001,0.01,0.506,1060,1144
5,2304,10,100,0.001,0.01,0.49,1102,1202
5,2404,10,100,0.001,0.01,0.478,1154,1250
5,2504,10,100,0.001,0.01,0.512,1210,1294
5,2604,10,100,0.001,0.01,0.498,1266,1338
5,2704,10,100,0.001,0.01,0.504,1319,1385
5,2804,10,100,0.001,0.01,0.524,1372,1432
5,2904,10,100,0.001,0.01,0.506,1422,1482
5,3004,10,100,0.001,0.01,0.532,1478,1526
5,3104,10,100,0.001,0.01,0.492,1531,1573
5,3204,10,100,0.001,0.01,0.538,1581,1623
5,3304,10,100,0.001,0.01,0.498,1617,1687
5,3404,10,100,0.001,0.01,0.506,1668,1736
5,3504,10,100,0.001,0.01,0.492,1721,1783
5,3604,10,100,0.001,0.01,0.494,1773,1831
5,3704,10,100,0.001,0.01,0.518,1823,1881
5,3804,10,100,0.001,0.01,0.53,1865,1939
5,3904,10,100,0.001,0.01,0.524,1918,1986
5,4004,10,100,0.001,0.01,0.53,1969,2035
5,4104,10,100,0.001,0.01,0.508,2022,2082
5,4204,10,100,0.001,0.01,0.532,2071,2133
5,4304,10,100,0.001,0.01,0.534,2118,2186
5,4404,10,100,0.001,0.01,0.552,2184,2220
5,4504,10,100,0.001,0.01,0.544,2244,2260
5,4604,10,100,0.001,0.01,0.562,2295,2309
5,4704,10,100,0.001,0.01,0.562,2349,2355
5,4804,10,100,0.001,0.01,0.562,2390,2414
5,4904,10,100,0.001,0.01,0.556,2441,2463
5,5004,10,100,0.001,0.01,0.55,2494,2510
5,5104,10,100,0.001,0.01,0.55,2550,2554
5,5204,10,100,0.001,0.01,0.564,2600,2604
5,5304,10,100,0.001,0.01,0.57,2644,2660
5,5404,10,100,0.001,0.01,0.574,2687,2717
5,5504,10,100,0.001,0.01,0.548,2735,2769
5,5604,10,100,0.001,0.01,0.568,2784,2820
5,5704,10,100,0.001,0.01,0.576,2833,2871
5,5804,10,100,0.001,0.01,0.586,2888,2916
5,5904,10,100,0.001,0.01,0.576,2946,2958
5,6004,10,100,0.001,0.01,0.588,3001,3003
5,6104,10,100,0.001,0.01,0.58,3057,3047
5,6204,10,100,0.001,0.01,0.582,3113,3091
5,6304,10,100,0.001,0.01,0.574,3168,3136
5,6404,10,100,0.001,0.01,0.596,3212,3192
5,6504,10,100,0.001,0.01,0.596,3258,3246
5,6604,10,100,0.001,0.01,0.572,3308,3296
5,6704,10,100,0.001,0.01,0.616,3359,3345
5,6804,10,100,0.001,0.01,0.608,3408,3396
5,6904,10,100,0.001,0.01,0.586,3458,3446
5,7004,10,100,0.001,0.01,0.618,3507,3497
5,7104,10,100,0.001,0.01,0.628,3554,3550
5,7204,10,100,0.001,0.01,0.612,3597,3607
5,7304,10,100,0.001,0.01,0.624,3648,3656
5,7404,10,100,0.001,0.01,0.61,3693,3711
5,7504,10,100,0.001,0.01,0.6,3750,3754
5,7604,10,100,0.001,0.01,0.616,3795,3809
5,7704,10,100,0.001,0.01,0.622,3842,3862
5,7804,10,100,0.001,0.01,0.644,3894,3910
5,7904,10,100,0.001,0.01,0.644,3940,3964
5,8004,10,100,0.001,0.01,0.632,3985,4019
5,8104,10,100,0.001,0.01,0.654,4025,4079
5,8204,10,100,0.001,0.01,0.64,4069,4135
5,8304,10,100,0.001,0.01,0.652,4123,4181
5,8404,10,100,0.001,0.01,0.656,4175,4229
5,8504,10,100,0.001,0.01,0.652,4224,4280
5,8604,10,100,0.001,0.01,0.66,4274,4330
5,8704,10,100,0.001,0.01,0.616,4320,4384
5,8804,10,100,0.001,0.01,0.648,4371,4433
5,8904,10,100,0.001,0.01,0.65,4420,4484
5,9004,10,100,0.001,0.01,0.67,4471,4533
5,9104,10,100,0.001,0.01,0.678,4521,4583
5,9204,10,100,0.001,0.01,0.678,4573,4631
5,9304,10,100,0.001,0.01,0.644,4630,4674
5,9404,10,100,0.001,0.01,0.682,4679,4725
5,9504,10,100,0.001,0.01,0.688,4715,4789
5,9604,10,100,0.001,0.01,0.694,4775,4829
5,9704,10,100,0.001,0.01,0.692,4828,4876
5,9804,10,100,0.001,0.01,0.702,4876,4928
5,9904,10,100,0.001,0.01,0.704,4916,4988
5,10004,10,100,0.001,0.01,0.712,4971,5033
5,10104,10,100,0.001,0.01,0.68,5017,5087
5,10204,10,100,0.001,0.01,0.726,5072,5132
5,10304,10,100,0.001,0.01,0.712,5122,5182
5,10404,10,100,0.001,0.01,0.738,5176,5228
5,10504,10,100,0.001,0.01,0.724,5220,5284
5,10604,10,100,0.001,0.01,0.718,5278,5326
5,10704,10,100,0.001,0.01,0.704,5329,5375
5,10804,10,100,0.001,0.01,0.716,5385,5419
5,10904,10,100,0.001,0.01,0.736,5437,5467
5,11004,10,100,0.001,0.01,0.732,5486,5518
5,11104,10,100,0.001,0.01,0.724,5537,5567
5,11204,10,100,0.001,0.01,0.724,5588,5616
5,11304,10,100,0.001,0.01,0.74,5635,5669
5,11404,10,100,0.001,0.01,0.742,5683,5721
5,11504,10,100,0.001,0.01,0.722,5732,5772
5,11604,10,100,0.001,0.01,0.742,5786,5818
5,11704,10,100,0.001,0.01,0.76,5828,5876
5,11804,10,100,0.001,0.01,0.752,5872,5932
5,11904,10,100,0.001,0.01,0.736,5927,5977
5,12004,10,100,0.001,0.01,0.744,5975,6029
5,12104,10,100,0.001,0.01,0.75,6017,6087
5,12204,10,100,0.001,0.01,0.732,6064,6140
5,12304,10,100,0.001,0.01,0.728,6110,6194
5,12404,10,100,0.001,0.01,0.734,6161,6243
5,12504,10,100,0.001,0.01,0.756,6213,6291
5,12604,10,100,0.001,0.01,0.748,6265,6339
5,12704,10,100,0.001,0.01,0.754,6310,6394
5,12804,10,100,0.001,0.01,0.774,6375,6429
5,12904,10,100,0.001,0.01,0.77,6425,6479
5,13004,10,100,0.001,0.01,0.77,6484,6520
5,13104,10,100,0.001,0.01,0.79,6534,6570
5,13204,10,100,0.001,0.01,0.78,6589,6615
5,13304,10,100,0.001,0.01,0.78,6641,6663
5,13404,10,100,0.001,0.01,0.776,6702,6702
5,13504,10,100,0.001,0.01,0.79,6752,6752
5,13604,10,100,0.001,0.01,0.784,6803,6801
5,13704,10,100,0.001,0.01,0.81,6850,6854
5,13804,10,100,0.001,0.01,0.784,6896,6908
5,13904,10,100,0.001,0.01,0.828,6938,6966
5,14004,10,100,0.001,0.01,0.82,6996,7008
5,14104,10,100,0.001,0.01,0.812,7051,7053
5,14204,10,100,0.001,0.01,0.816,7103,7101
5,14304,10,100,0.001,0.01,0.792,7160,7144
5,14404,10,100,0.001,0.01,0.818,7213,7191
5,14504,10,100,0.001,0.01,0.834,7266,7238
5,14604,10,100,0.001,0.01,0.848,7316,7288
5,14704,10,100,0.001,0.01,0.848,7365,7339
5,14804,10,100,0.001,0.01,0.854,7412,7392
5,14904,10,100,0.001,0.01,0.85,7458,7446
5,15004,10,100,0.001,0.01,0.862,7504,7500
6,104,10,100,0.001,0.01,0.486,45,59
6,204,10,100,0.001,0.01,0.494,94,110
6,304,10,100,0.001,0.01,0.53,149,155
6,404,10,100,0.001,0.01,0.528,198,206
6,504,10,100,0.001,0.01,0.564,241,263
6,604,10,100,0.001,0.01,0.51,295,309
6,704,10,100,0.001,0.01,0.514,352,352
6,804,10,100,0.001,0.01,0.542,408,396
6,904,10,100,0.001,0.01,0.552,456,448
6,1004,10,100,0.001,0.01,0.536,506,498
6,1104,10,100,0.001,0.01,0.508,565,539
6,1204,10,100,0.001,0.01,0.518,623,581
6,1304,10,100,0.001,0.01,0.528,674,630
6,1404,10,100,0.001,0.01,0.508,723,681
6,1504,10,100,0.001,0.01,0.524,772,732
6,1604,10,100,0.001,0.01,0.532,818,786
6,1704,10,100,0.001,0.01,0.528,871,833
6,1804,10,100,0.001,0.01,0.536,926,878
6,1904,10,100,0.001,0.01,0.544,976,928
6,2004,10,100,0.001,0.01,0.524,1028,976
6,2104,10,100,0.001,0.01,0.5,1078,1026
6,2204,10,100,0.001,0.01,0.506,1124,1080
6,2304,10,100,0.001,0.01,0.528,1181,1123
6,2404,10,100,0.001,0.01,0.498,1227,1177
6,2504,10,100,0.001,0.01,0.5,1269,1235
6,2604,10,100,0.001,0.01,0.518,1323,1281
6,2704,10,100,0.001,0.01,0.516,1379,1325
6,2804,10,100,0.001,0.01,0.51,1424,1380
6,2904,10,100,0.001,0.01,0.536,1481,1423
6,3004,10,100,0.001,0.01,0.51,1531,1473
6,3104,10,100,0.001,0.01,0.54,1579,1525
6,3204,10,100,0.001,0.01,0.52,1622,1582
6,3304,10,100,0.001,0.01,0.522,1670,1634
6,3404,10,100,0.001,0.01,0.534,1719,1685
6,3504,10,100,0.001,0.01,0.534,1768,1736
6,3604,10,100,0.001,0.01,0.54,1824,1780
6,3704,10,100,0.001,0.01,0.548,1880,1824
6,3804,10,100,0.001,0.01,0.554,1940,1864
6,3904,10,100,0.001,0.01,0.538,1986,1918
6,4004,10,100,0.001,0.01,0.584,2030,1974
6,4104,10,100,0.001,0.01,0.552,2074,2030
6,4204,10,100,0.001,0.01,0.566,2122,2082
6,4304,10,100,0.001,0.01,0.56,2166,2138
6,4404,10,100,0.001,0.01,0.568,2217,2187
6,4504,10,100,0.001,0.01,0.586,2263,2241
6,4604,10,100,0.001,0.01,0.578,2307,2297
6,4704,10,100,0.001,0.01,0.59,2362,2342
6,4804,10,100,0.001,0.01,0.576,2421,2383
6,4904,10,100,0.001,0.01,0.568,2472,2432
6,5004,10,100,0.001,0.01,0.584,2531,2473
6,5104,10,100,0.001,0.01,0.61,2578,2526
6,5204,10,100,0.001,0.01,0.584,2624,2580
6,5304,10,100,0.001,0.01,0.588,2666,2638
6,5404,10,100,0.001,0.01,0.586,2718,2686
6,5504,10,100,0.001,0.01,0.59,2769,2735
6,5604,10,100,0.001,0.01,0.616,2818,2786
6,5704,10,100,0.001,0.01,0.59,2868,2836
6,5804,10,100,0.001,0.01,0.616,2918,2886
6,5904,10,100,0.001,0.01,0.598,2969,2935
6,6004,10,100,0.001,0.01,0.618,3021,2983
6,6104,10,100,0.001,0.01,0.6,3075,3029
6,6204,10,100,0.001,0.01,0.63,3129,3075
6,6304,10,100,0.001,0.01,0.604,3179,3125
6,6404,10,100,0.001,0.01,0.618,3228,3176
6,6504,10,100,0.001,0.01,0.594,3266,3238
6,6604,10,100,0.001,0.01,0.618,3314,3290
6,6704,10,100,0.001,0.01,0.618,3366,3338
6,6804,10,100,0.001,0.01,0.638,3421,3383
6,6904,10,100,0.001,0.01,0.632,3477,3427
6,7004,10,100,0.001,0.01,0.624,3529,3475
6,7104,10,100,0.001,0.01,0.644,3576,3528
6,7204,10,100,0.001,0.01,0.628,3634,3570
6,7304,10,100,0.001,0.01,0.636,3680,3624
6,7404,10,100,0.001,0.01,0.64,3731,3673
6,7504,10,100,0.001,0.01,0.662,3779,3725
6,7604,10,100,0.001,0.01,0.672,3826,3778
6,7704,10,100,0.001,0.01,0.662,3880,3824
6,7804,10,100,0.001,0.01,0.63,3925,3879
6,7904,10,100,0.001,0.01,0.65,3979,3925
6,8004,10,100,0.001,0.01,0.66,4028,3976
6,8104,10,100,0.001,0.01,0.67,4077,4027
6,8204,10,100,0.001,0.01,0.65,4127,4077
6,8304,10,100,0.001,0.01,0.668,4180,4124
6,8404,10,100,0.001,0.01,0.712,4229,4175
6,8504,10,100,0.001,0.01,0.7,4277,4227
6,8604,10,100,0.001,0.01,0.67,4324,4280
6,8704,10,100,0.001,0.01,0.708,4370,4334
6,8804,10,100,0.001,0.01,0.71,4425,4379
6,8904,10,100,0.001,0.01,0.712,4477,4427
6,9004,10,100,0.001,0.01,0.714,4524,4480
6,9104,10,100,0.001,0.01,0.72,4576,4528
6,9204,10,100,0.001,0.01,0.728,4618,4586
6,9304,10,100,0.001,0.01,0.732,4664,4640
6,9404,10,100,0.001,0.01,0.75,4716,4688
6,9504,10,100,0.001,0.01,0.728,4763,4741
6,9604,10,100,0.001,0.01,0.746,4815,4789
6,9704,10,100,0.001,0.01,0.748,4868,4836
6,9804,10,100,0.001,0.01,0.748,4919,4885
6,9904,10,100,0.001,0.01,0.748,4971,4933
6,10004,10,100,0.001,0.01,0.764,5018,4986
6,10104,10,100,0.001,0.01,0.756,5059,5045
6,10204,10,100,0.001,0.01,0.764,5113,5091
6,10304,10,100,0.001,0.01,0.748,5164,5140
6,10404,10,100,0.001,0.01,0.772,5222,5182
6,10504,10,100,0.001,0.01,0.772,5273,5231
6,10604,10,100,0.001,0.01,0.808,5322,5282
6,10704,10,100,0.001,0.01,0.798,5376,5328
6,10804,10,100,0.001,0.01,0.794,5424,5380
6,10904,10,100,0.001,0.01,0.78,5469,5435
6,11004,10,100,0.001,0.01,0.804,5519,5485
6,11104,10,100,0.001,0.01,0.786,5574,5530
6,11204,10,100,0.001,0.01,0.832,5622,5582
6,11304,10,100,0.001,0.01,0.852,5673,5631
6,11404,10,100,0.001,0.01,0.83,5718,5686
6,11504,10,100,0.001,0.01,0.832,5772,5732
6,11604,10,100,0.001,0.01,0.838,5827,5777
6,11704,10,100,0.001,0.01,0.862,5880,5824
6,11804,10,100,0.001,0.01,0.856,5929,5875
6,11904,10,100,0.001,0.01,0.864,5980,5924
6,12004,10,100,0.001,0.01,0.852,6027,5977
6,12104,10,100,0.001,0.01,0.866,6076,6028
6,12204,10,100,0.001,0.01,0.886,6124,6080
6,12304,10,100,0.001,0.01,0.868,6175,6129
6,12404,10,100,0.001,0.01,0.878,6224,6180
6,12504,10,100,0.001,0.01,0.898,6275,6229
6,12604,10,100,0.001,0.01,0.892,6319,6285
6,12704,10,100,0.001,0.01,0.876,6360,6344
6,12804,10,100,0.001,0.01,0.898,6411,6393
6,12904,10,100,0.001,0.01,0.898,6457,6447
6,13004,10,100,0.001,0.01,0.91,6507,6497
6,13104,10,100,0.001,0.01,0.896,6551,6553
6,13204,10,100,0.001,0.01,0.904,6593,6611
6,13304,10,100,0.001,0.01,0.936,6647,6657
6,13404,10,100,0.001,0.01,0.898,6702,6702
6,13504,10,100,0.001,0.01,0.89,6751,6753
6,13604,10,100,0.001,0.01,0.924,6801,6803
6,13704,10,100,0.001,0.01,0.938,6843,6861
6,13804,10,100,0.001,0.01,0.93,6895,6909
6,13904,10,100,0.001,0.01,0.936,6944,6960
6,14004,10,100,0.001,0.01,0.93,7005,6999
6,14104,10,100,0.001,0.01,0.932,7051,7053
6,14204,10,100,0.001,0.01,0.918,7102,7102
6,14304,10,100,0.001,0.01,0.866,7151,7153
6,14404,10,100,0.001,0.01,0.924,7196,7208
6,14504,10,100,0.001,0.01,0.94,7247,7257
6,14604,10,100,0.001,0.01,0.936,7292,7312
6,14704,10,100,0.001,0.01,0.956,7335,7369
6,14804,10,100,0.001,0.01,0.968,7382,7422
6,14904,10,100,0.001,0.01,0.962,7435,7469
6,15004,10,100,0.001,0.01,0.962,7495,7509
7,104,10,100,0.001,0.01,0.542,51,53
7,204,10,100,0.001,0.01,0.542,101,103
7,304,10,100,0.001,0.01,0.54,146,158
7,404,10,100,0.001,0.01,0.482,200,204
7,504,10,100,0.001,0.01,0.486,257,247
7,604,10,100,0.001,0.01,0.508,306,298
7,704,10,100,0.001,0.01,0.52,366,338
7,804,10,100,0.001,0.01,0.476,413,391
7,904,10,100,0.001,0.01,0.468,464,440
7,1004,10,100,0.001,0.01,0.502,514,490
7,1104,10,100,0.001,0.01,0.534,561,543
7,1204,10,100,0.001,0.01,0.49,610,594
7,1304,10,100,0.001,0.01,0.512,656,648
7,1404,10,100,0.001,0.01,0.496,703,701
7,1504,10,100,0.001,0.01,0.484,759,745
7,1604,10,100,0.001,0.01,0.496,802,802
7,1704,10,100,0.001,0.01,0.484,848,856
7,1804,10,100,0.001,0.01,0.476,898,906
7,1904,10,100,0.001,0.01,0.512,946,958
7,2004,10,100,0.001,0.01,0.482,996,1008
7,2104,10,100,0.001,0.01,0.494,1047,1057
7,2204,10,100,0.001,0.01,0.502,1086,1118
7,2304,10,100,0.001,0.01,0.488,1131,1173
7,2404,10,100,0.001,0.01,0.496,1181,1223
7,2504,10,100,0.001,0.01,0.508,1222,1282
7,2604,10,100,0.001,0.01,0.504,1267,1337
7,2704,10,100,0.001,0.01,0.502,1326,1378
7,2804,10,100,0.001,0.01,0.52,1379,1425
7,2904,10,100,0.001,0.01,0.514,1427,1477
7,3004,10,100,0.001,0.01,0.53,1471,1533
7,3104,10,100,0.001,0.01,0.508,1521,1583
7,3204,10,100,0.001,0.01,0.534,1568,1636
7,3304,10,100,0.001,0.01,0.504,1620,1684
7,3404,10,100,0.001,0.01,0.502,1669,1735
7,3504,10,100,0.001,0.01,0.534,1728,1776
7,3604,10,100,0.001,0.01,0.544,1774,1830
7,3704,10,100,0.001,0.01,0.556,1825,1879
7,3804,10,100,0.001,0.01,0.534,1877,1927
7,3904,10,100,0.001,0.01,0.554,1931,1973
7,4004,10,100,0.001,0.01,0.544,1984,2020
7,4104,10,100,0.001,0.01,0.53,2035,2069
7,4204,10,100,0.001,0.01,0.554,2084,2120
7,4304,10,100,0.001,0.01,0.578,2136,2168
7,4404,10,100,0.001,0.01,0.552,2192,2212
7,4504,10,100,0.001,0.01,0.546,2242,2262
7,4604,10,100,0.001,0.01,0.546,2295,2309
7,4704,10,100,0.001,0.01,0.532,2344,2360
7,4804,10,100,0.001,0.01,0.56,2402,2402
7,4904,10,100,0.001,0.01,0.56,2448,2456
7,5004,10,100,0.001,0.01,0.566,2504,2500
7,5104,10,100,0.001,0.01,0.566,2550,2554
7,5204,10,100,0.001,0.01,0.572,2597,2607
7,5304,10,100,0.001,0.01,0.576,2644,2660
7,5404,10,100,0.001,0.01,0.534,2687,2717
7,5504,10,100,0.001,0.01,0.586,2731,2773
7,5604,10,100,0.001,0.01,0.59,2780,2824
7,5704,10,100,0.001,0.01,0.57,2839,2865
7,5804,10,100,0.001,0.01,0.61,2895,2909
7,5904,10,100,0.001,0.01,0.594,2946,2958
7,6004,10,100,0.001,0.01,0.61,2999,3005
7,6104,10,100,0.001,0.01,0.568,3058,3046
7,6204,10,100,0.001,0.01,0.604,3107,3097
7,6304,10,100,0.001,0.01,0.578,3157,3147
7,6404,10,100,0.001,0.01,0.574,3212,3192
7,6504,10,100,0.001,0.01,0.608,3267,3237
7,6604,10,100,0.001,0.01,0.594,3323,3281
7,6704,10,100,0.001,0.01,0.592,3377,3327
7,6804,10,100,0.001,0.01,0.6,3421,3383
7,6904,10,100,0.001,0.01,0.612,3475,3429
7,7004,10,100,0.001,0.01,0.622,3521,3483
7,7104,10,100,0.001,0.01,0.618,3582,3522
7,7204,10,100,0.001,0.01,0.616,3641,3563
7,7304,10,100,0.001,0.01,0.602,3689,3615
7,7404,10,100,0.001,0.01,0.626,3744,3660
7,7504,10,100,0.001,0.01,0.632,3796,3708
7,7604,10,100,0.001,0.01,0.624,3835,3769
7,7704,10,100,0.001,0.01,0.622,3882,3822
7,7804,10,100,0.001,0.01,0.644,3934,3870
7,7904,10,100,0.001,0.01,0.648,3992,3912
7,8004,10,100,0.001,0.01,0.656,4046,3958
7,8104,10,100,0.001,0.01,0.654,4094,4010
7,8204,10,100,0.001,0.01,0.654,4148,4056
7,8304,10,100,0.001,0.01,0.638,4190,4114
7,8404,10,100,0.001,0.01,0.654,4245,4159
7,8504,10,100,0.001,0.01,0.658,4299,4205
7,8604,10,100,0.001,0.01,0.654,4349,4255
7,8704,10,100,0.001,0.01,0.636,4402,4302
7,8804,10,100,0.001,0.01,0.658,4454,4350
7,8904,10,100,0.001,0.01,0.69,4499,4405
7,9004,10,100,0.001,0.01,0.65,4556,4448
7,9104,10,100,0.001,0.01,0.672,4610,4494
7,9204,10,100,0.001,0.01,0.67,4653,4551
7,9304,10,100,0.001,0.01,0.68,4706,4598
7,9404,10,100,0.001,0.01,0.672,4759,4645
7,9504,10,100,0.001,0.01,0.662,4804,4700
7,9604,10,100,0.001,0.01,0.688,4858,4746
7,9704,10,100,0.001,0.01,0.682,4906,4798
7,9804,10,100,0.001,0.01,0.69,4951,4853
7,9904,10,100,0.001,0.01,0.692,4991,4913
7,10004,10,100,0.001,0.01,0.708,5047,4957
7,10104,10,100,0.001,0.01,0.702,5105,4999
7,10204,10,100,0.001,0.01,0.716,5156,5048
7,10304,10,100,0.001,0.01,0.718,5204,5100
7,10404,10,100,0.001,0.01,0.7,5254,5150
7,10504,10,100,0.001,0.01,0.7,5302,5202
7,10604,10,100,0.001,0.01,0.72,5360,5244
7,10704,10,100,0.001,0.01,0.708,5408,5296
7,10804,10,100,0.001,0.01,0.708,5461,5343
7,10904,10,100,0.001,0.01,0.73,5504,5400
7,11004,10,100,0.001,0.01,0.726,5552,5452
7,11104,10,100,0.001,0.01,0.732,5606,5498
7,11204,10,100,0.001,0.01,0.716,5662,5542
7,11304,10,100,0.001,0.01,0.744,5708,5596
7,11404,10,100,0.001,0.01,0.742,5754,5650
7,11504,10,100,0.001,0.01,0.732,5792,5712
7,11604,10,100,0.001,0.01,0.738,5840,5764
7,11704,10,100,0.001,0.01,0.738,5901,5803
7,11804,10,100,0.001,0.01,0.736,5947,5857
7,11904,10,100,0.001,0.01,0.804,5989,5915
7,12004,10,100,0.001,0.01,0.758,6034,5970
7,12104,10,100,0.001,0.01,0.722,6079,6025
7,12204,10,100,0.001,0.01,0.77,6128,6076
7,12304,10,100,0.001,0.01,0.772,6187,6117
7,12404,10,100,0.001,0.01,0.77,6238,6166
7,12504,10,100,0.001,0.01,0.75,6281,6223
7,12604,10,100,0.001,0.01,0.788,6327,6277
7,12704,10,100,0.001,0.01,0.77,6367,6337
7,12804,10,100,0.001,0.01,0.764,6425,6379
7,12904,10,100,0.001,0.01,0.776,6478,6426
7,13004,10,100,0.001,0.01,0.802,6520,6484
7,13104,10,100,0.001,0.01,0.782,6571,6533
7,13204,10,100,0.001,0.01,0.766,6624,6580
7,13304,10,100,0.001,0.01,0.776,6671,6633
7,13404,10,100,0.001,0.01,0.784,6719,6685
7,13504,10,100,0.001,0.01,0.752,6765,6739
7,13604,10,100,0.001,0.01,0.76,6812,6792
7,13704,10,100,0.001,0.01,0.762,6861,6843
7,13804,10,100,0.001,0.01,0.804,6903,6901
7,13904,10,100,0.001,0.01,0.774,6955,6949
7,14004,10,100,0.001,0.01,0.786,6997,7007
7,14104,10,100,0.001,0.01,0.786,7054,7050
7,14204,10,100,0.001,0.01,0.79,7107,7097
7,14304,10,100,0.001,0.01,0.806,7167,7137
7,14404,10,100,0.001,0.01,0.808,7215,7189
7,14504,10,100,0.001,0.01,0.818,7267,7237
7,14604,10,100,0.001,0.01,0.816,7324,7280
7,14704,10,100,0.001,0.01,0.852,7374,7330
7,14804,10,100,0.001,0.01,0.822,7431,7373
7,14904,10,100,0.001,0.01,0.85,7477,7427
7,15004,10,100,0.001,0.01,0.812,7523,7481
8,104,10,100,0.001,0.01,0.508,46,58
8,204,10,100,0.001,0.01,0.508,103,101
8,304,10,100,0.001,0.01,0.526,152,152
8,404,10,100,0.001,0.01,0.504,199,205
8,504,10,100,0.001,0.01,0.506,238,266
8,604,10,100,0.001,0.01,0.506,290,314
8,704,10,100,0.001,0.01,0.49,345,359
8,804,10,100,0.001,0.01,0.464,394,410
8,904,10,100,0.001,0.01,0.484,447,457
8,1004,10,100,0.001,0.01,0.496,495,509
8,1104,10,100,0.001,0.01,0.514,549,555
8,1204,10,100,0.001,0.01,0.518,599,605
8,1304,10,100,0.001,0.01,0.518,645,659
8,1404,10,100,0.001,0.01,0.516,701,703
8,1504,10,100,0.001,0.01,0.51,752,752
8,1604,10,100,0.001,0.01,0.504,789,815
8,1704,10,100,0.001,0.01,0.484,843,861
8,1804,10,100,0.001,0.01,0.504,892,912
8,1904,10,100,0.001,0.01,0.522,950,954
8,2004,10,100,0.001,0.01,0.518,1009,995
8,2104,10,100,0.001,0.01,0.532,1058,1046
8,2204,10,100,0.001,0.01,0.516,1113,1091
8,2304,10,100,0.001,0.01,0.504,1164,1140
8,2404,10,100,0.001,0.01,0.53,1210,1194
8,2504,10,100,0.001,0.01,0.538,1262,1242
8,2604,10,100,0.001,0.01,0.562,1308,1296
8,2704,10,100,0.001,0.01,0.564,1363,1341
8,2804,10,100,0.001,0.01,0.566,1407,1397
8,2904,10,100,0.001,0.01,0.624,1452,1452
8,3004,10,100,0.001,0.01,0.596,1506,1498
8,3104,10,100,0.001,0.01,0.582,1557,1547
8,3204,10,100,0.001,0.01,0.626,1601,1603
8,3304,10,100,0.001,0.01,0.644,1652,1652
8,3404,10,100,0.001,0.01,0.678,1702,1702
8,3504,10,100,0.001,0.01,0.698,1754,1750
8,3604,10,100,0.001,0.01,0.704,1806,1798
8,3704,10,100,0.001,0.01,0.684,1864,1840
8,3804,10,100,0.001,0.01,0.704,1912,1892
8,3904,10,100,0.001,0.01,0.766,1962,1942
8,4004,10,100,0.001,0.01,0.768,2011,1993
8,4104,10,100,0.001,0.01,0.746,2056,2048
8,4204,10,100,0.001,0.01,0.77,2107,2097
8,4304,10,100,0.001,0.01,0.792,2153,2151
8,4404,10,100,0.001,0.01,0.778,2205,2199
8,4504,10,100,0.001,0.01,0.798,2263,2241
8,4604,10,100,0.001,0.01,0.758,2318,2286
8,4704,10,100,0.001,0.01,0.794,2367,2337
8,4804,10,100,0.001,0.01,0.786,2421,2383
8,4904,10,100,0.001,0.01,0.8,2457,2447
8,5004,10,100,0.001,0.01,0.788,2506,2498
8,5104,10,100,0.001,0.01,0.794,2552,2552
8,5204,10,100,0.001,0.01,0.808,2607,2597
8,5304,10,100,0.001,0.01,0.804,2654,2650
8,5404,10,100,0.001,0.01,0.8,2697,2707
8,5504,10,100,0.001,0.01,0.83,2743,2761
8,5604,10,100,0.001,0.01,0.838,2793,2811
8,5704,10,100,0.001,0.01,0.832,2854,2850
8,5804,10,100,0.001,0.01,0.834,2899,2905
8,5904,10,100,0.001,0.01,0.838,2948,2956
8,6004,10,100,0.001,0.01,0.84,3001,3003
8,6104,10,100,0.001,0.01,0.856,3055,3049
8,6204,10,100,0.001,0.01,0.854,3106,3098
8,6304,10,100,0.001,0.01,0.854,3157,3147
8,6404,10,100,0.001,0.01,0.862,3206,3198
8,6504,10,100,0.001,0.01,0.856,3247,3257
8,6604,10,100,0.001,0.01,0.88,3294,3310
8,6704,10,100,0.001,0.01,0.868,3335,3369
8,6804,10,100,0.001,0.01,0.854,3389,3415
8,6904,10,100,0.001,0.01,0.878,3437,3467
8,7004,10,100,0.001,0.01,0.87,3493,3511
8,7104,10,100,0.001,0.01,0.882,3538,3566
8,7204,10,100,0.001,0.01,0.882,3590,3614
8,7304,10,100,0.001,0.01,0.872,3638,3666
8,7404,10,100,0.001,0.01,0.884,3687,3717
8,7504,10,100,0.001,0.01,0.896,3731,3773
8,7604,10,100,0.001,0.01,0.908,3780,3824
8,7704,10,100,0.001,0.01,0.91,3832,3872
8,7804,10,100,0.001,0.01,0.91,3875,3929
8,7904,10,100,0.001,0.01,0.904,3915,3989
8,8004,10,100,0.001,0.01,0.894,3967,4037
8,8104,10,100,0.001,0.01,0.912,4026,4078
8,8204,10,100,0.001,0.01,0.906,4089,4115
8,8304,10,100,0.001,0.01,0.922,4140,4164
8,8404,10,100,0.001,0.01,0.914,4189,4215
8,8504,10,100,0.001,0.01,0.916,4247,4257
8,8604,10,100,0.001,0.01,0.912,4302,4302
8,8704,10,100,0.001,0.01,0.918,4352,4352
8,8804,10,100,0.001,0.01,0.922,4408,4396
8,8904,10,100,0.001,0.01,0.922,4458,4446
8,9004,10,100,0.001,0.01,0.918,4515,4489
8,9104,10,100,0.001,0.01,0.926,4564,4540
8,9204,10,100,0.001,0.01,0.93,4612,4592
8,9304,10,100,0.001,0.01,0.938,4663,4641
8,9404,10,100,0.001,0.01,0.924,4720,4684
8,9504,10,100,0.001,0.01,0.91,4766,4738
8,9604,10,100,0.001,0.01,0.932,4814,4790
8,9704,10,100,0.001,0.01,0.928,4871,4833
8,9804,10,100,0.001,0.01,0.924,4920,4884
8,9904,10,100,0.001,0.01,0.934,4972,4932
8,10004,10,100,0.001,0.01,0.938,5025,4979
8,10104,10,100,0.001,0.01,0.94,5075,5029
8,10204,10,100,0.001,0.01,0.934,5126,5078
8,10304,10,100,0.001,0.01,0.946,5163,5141
8,10404,10,100,0.001,0.01,0.942,5211,5193
8,10504,10,100,0.001,0.01,0.944,5256,5248
8,10604,10,100,0.001,0.01,0.958,5305,5299
8,10704,10,100,0.001,0.01,0.94,5351,5353
8,10804,10,100,0.001,0.01,0.946,5409,5395
8,10904,10,100,0.001,0.01,0.948,5439,5465
8,11004,10,100,0.001,0.01,0.936,5494,5510
8,11104,10,100,0.001,0.01,0.944,5548,5556
8,11204,10,100,0.001,0.01,0.95,5603,5601
8,11304,10,100,0.001,0.01,0.948,5652,5652
8,11404,10,100,0.001,0.01,0.95,5702,5702
8,11504,10,100,0.001,0.01,0.954,5749,5755
8,11604,10,100,0.001,0.01,0.946,5804,5800
8,11704,10,100,0.001,0.01,0.954,5847,5857
8,11804,10,100,0.001,0.01,0.956,5895,5909
8,11904,10,100,0.001,0.01,0.946,5942,5962
8,12004,10,100,0.001,0.01,0.96,5989,6015
8,12104,10,100,0.001,0.01,0.95,6043,6061
8,12204,10,100,0.001,0.01,0.958,6104,6100
8,12304,10,100,0.001,0.01,0.96,6154,6150
8,12404,10,100,0.001,0.01,0.968,6203,6201
8,12504,10,100,0.001,0.01,0.958,6253,6251
8,12604,10,100,0.001,0.01,0.96,6300,6304
8,12704,10,100,0.001,0.01,0.962,6357,6347
8,12804,10,100,0.001,0.01,0.97,6413,6391
8,12904,10,100,0.001,0.01,0.96,6465,6439
8,13004,10,100,0.001,0.01,0.97,6514,6490
8,13104,10,100,0.001,0.01,0.97,6563,6541
8,13204,10,100,0.001,0.01,0.964,6609,6595
8,13304,10,100,0.001,0.01,0.96,6658,6646
8,13404,10,100,0.001,0.01,0.96,6713,6691
8,13504,10,100,0.001,0.01,0.974,6779,6725
8,13604,10,100,0.001,0.01,0.976,6829,6775
8,13704,10,100,0.001,0.01,0.97,6876,6828
8,13804,10,100,0.001,0.01,0.97,6929,6875
8,13904,10,100,0.001,0.01,0.976,6978,6926
8,14004,10,100,0.001,0.01,0.97,7033,6971
8,14104,10,100,0.001,0.01,0.974,7081,7023
8,14204,10,100,0.001,0.01,0.956,7128,7076
8,14304,10,100,0.001,0.01,0.96,7177,7127
8,14404,10,100,0.001,0.01,0.97,7219,7185
8,14504,10,100,0.001,0.01,0.98,7267,7237
8,14604,10,100,0.001,0.01,0.97,7307,7297
8,14704,10,100,0.001,0.01,0.976,7358,7346
8,14804,10,100,0.001,0.01,0.974,7409,7395
8,14904,10,100,0.001,0.01,0.976,7455,7449
8,15004,10,100,0.001,0.01,0.974,7499,7505
9,104,10,100,0.001,0.01,0.532,48,56
9,204,10,100,0.001,0.01,0.474,104,100
9,304,10,100,0.001,0.01,0.47,141,163
9,404,10,100,0.001,0.01,0.48,191,213
9,504,10,100,0.001,0.01,0.498,251,253
9,604,10,100,0.001,0.01,0.49,305,299
9,704,10,100,0.001,0.01,0.482,341,363
9,804,10,100,0.001,0.01,0.472,386,418
9,904,10,100,0.001,0.01,0.472,431,473
9,1004,10,100,0.001,0.01,0.48,484,520
9,1104,10,100,0.001,0.01,0.492,533,571
9,1204,10,100,0.001,0.01,0.472,581,623
9,1304,10,100,0.001,0.01,0.452,634,670
9,1404,10,100,0.001,0.01,0.49,691,713
9,1504,10,100,0.001,0.01,0.512,743,761
9,1604,10,100,0.001,0.01,0.48,791,813
9,1704,10,100,0.001,0.01,0.506,841,863
9,1804,10,100,0.001,0.01,0.524,892,912
9,1904,10,100,0.001,0.01,0.546,934,970
9,2004,10,100,0.001,0.01,0.538,977,1027
9,2104,10,100,0.001,0.01,0.546,1024,1080
9,2204,10,100,0.001,0.01,0.58,1074,1130
9,2304,10,100,0.001,0.01,0.582,1128,1176
9,2404,10,100,0.001,0.01,0.578,1190,1214
9,2504,10,100,0.001,0.01,0.61,1236,1268
9,2604,10,100,0.001,0.01,0.606,1284,1320
9,2704,10,100,0.001,0.01,0.602,1331,1373
9,2804,10,100,0.001,0.01,0.672,1389,1415
9,2904,10,100,0.001,0.01,0.668,1435,1469
9,3004,10,100,0.001,0.01,0.69,1488,1516
9,3104,10,100,0.001,0.01,0.72,1540,1564
9,3204,10,100,0.001,0.01,0.704,1587,1617
9,3304,10,100,0.001,0.01,0.736,1636,1668
9,3404,10,100,0.001,0.01,0.72,1687,1717
9,3504,10,100,0.001,0.01,0.796,1738,1766
9,3604,10,100,0.001,0.01,0.814,1787,1817
9,3704,10,100,0.001,0.01,0.818,1833,1871
9,3804,10,100,0.001,0.01,0.822,1883,1921
9,3904,10,100,0.001,0.01,0.844,1931,1973
9,4004,10,100,0.001,0.01,0.846,1982,2022
9,4104,10,100,0.001,0.01,0.862,2025,2079
9,4204,10,100,0.001,0.01,0.868,2083,2121
9,4304,10,100,0.001,0.01,0.882,2140,2164
9,4404,10,100,0.001,0.01,0.888,2194,2210
9,4504,10,100,0.001,0.01,0.9,2240,2264
9,4604,10,100,0.001,0.01,0.858,2292,2312
9,4704,10,100,0.001,0.01,0.88,2342,2362
9,4804,10,100,0.001,0.01,0.888,2383,2421
9,4904,10,100,0.001,0.01,0.892,2435,2469
9,5004,10,100,0.001,0.01,0.912,2486,2518
9,5104,10,100,0.001,0.01,0.918,2534,2570
9,5204,10,100,0.001,0.01,0.916,2593,2611
9,5304,10,100,0.001,0.01,0.926,2648,2656
9,5404,10,100,0.001,0.01,0.92,2697,2707
9,5504,10,100,0.001,0.01,0.91,2746,2758
9,5604,10,100,0.001,0.01,0.904,2790,2814
9,5704,10,100,0.001,0.01,0.914,2843,2861
9,5804,10,100,0.001,0.01,0.926,2890,2914
9,5904,10,100,0.001,0.01,0.948,2932,2972
9,6004,10,100,0.001,0.01,0.946,2984,3020
9,6104,10,100,0.001,0.01,0.952,3042,3062
9,6204,10,100,0.001,0.01,0.952,3088,3116
9,6304,10,100,0.001,0.01,0.96,3137,3167
9,6404,10,100,0.001,0.01,0.956,3196,3208
9,6504,10,100,0.001,0.01,0.962,3243,3261
9,6604,10,100,0.001,0.01,0.966,3300,3304
9,6704,10,100,0.001,0.01,0.964,3352,3352
9,6804,10,100,0.001,0.01,0.952,3394,3410
9,6904,10,100,0.001,0.01,0.952,3440,3464
9,7004,10,100,0.001,0.01,0.964,3493,3511
9,7104,10,100,0.001,0.01,0.962,3551,3553
9,7204,10,100,0.001,0.01,0.96,3604,3600
9,7304,10,100,0.001,0.01,0.948,3648,3656
9,7404,10,100,0.001,0.01,0.96,3696,3708
9,7504,10,100,0.001,0.01,0.958,3745,3759
9,7604,10,100,0.001,0.01,0.976,3795,3809
9,7704,10,100,0.001,0.01,0.968,3837,3867
9,7804,10,100,0.001,0.01,0.974,3885,3919
9,7904,10,100,0.001,0.01,0.976,3943,3961
9,8004,10,100,0.001,0.01,0.972,3993,4011
9,8104,10,100,0.001,0.01,0.972,4046,4058
9,8204,10,100,0.001,0.01,0.982,4094,4110
9,8304,10,100,0.001,0.01,0.974,4140,4164
9,8404,10,100,0.001,0.01,0.98,4192,4212
9,8504,10,100,0.001,0.01,0.98,4241,4263
9,8604,10,100,0.001,0.01,0.952,4296,4308
9,8704,10,100,0.001,0.01,0.95,4347,4357
9,8804,10,100,0.001,0.01,0.964,4397,4407
9,8904,10,100,0.001,0.01,0.974,4446,4458
9,9004,10,100,0.001,0.01,0.98,4499,4505
9,9104,10,100,0.001,0.01,0.97,4558,4546
9,9204,10,100,0.001,0.01,0.974,4599,4605
9,9304,10,100,0.001,0.01,0.978,4650,4654
9,9404,10,100,0.001,0.01,0.982,4700,4704
9,9504,10,100,0.001,0.01,0.988,4745,4759
9,9604,10,100,0.001,0.01,0.984,4793,4811
9,9704,10,100,0.001,0.01,0.986,4842,4862
9,9804,10,100,0.001,0.01,0.982,4899,4905
9,9904,10,100,0.001,0.01,0.988,4956,4948
9,10004,10,100,0.001,0.01,0.978,5016,4988
9,10104,10,100,0.001,0.01,0.974,5065,5039
9,10204,10,100,0.001,0.01,0.982,5116,5088
9,10304,10,100,0.001,0.01,0.986,5156,5148
9,10404,10,100,0.001,0.01,0.98,5200,5204
9,10504,10,100,0.001,0.01,0.98,5253,5251
9,10604,10,100,0.001,0.01,0.978,5308,5296
9,10704,10,100,0.001,0.01,0.98,5355,5349
9,10804,10,100,0.001,0.01,0.982,5403,5401
9,10904,10,100,0.001,0.01,0.976,5455,5449
9,11004,10,100,0.001,0.01,0.986,5503,5501
9,11104,10,100,0.001,0.01,0.98,5556,5548
9,11204,10,100,0.001,0.01,0.954,5607,5597
9,11304,10,100,0.001,0.01,0.974,5656,5648
9,11404,10,100,0.001,0.01,0.984,5710,5694
9,11504,10,100,0.001,0.01,0.986,5761,5743
9,11604,10,100,0.001,0.01,0.986,5800,5804
9,11704,10,100,0.001,0.01,0.992,5848,5856
9,11804,10,100,0.001,0.01,0.992,5895,5909
9,11904,10,100,0.001,0.01,0.992,5929,5975
9,12004,10,100,0.001,0.01,0.992,5980,6024
9,12104,10,100,0.001,0.01,0.986,6030,6074
9,12204,10,100,0.001,0.01,0.986,6079,6125
9,12304,10,100,0.001,0.01,0.984,6131,6173
9,12404,10,100,0.001,0.01,0.992,6191,6213
9,12504,10,100,0.001,0.01,0.984,6240,6264
9,12604,10,100,0.001,0.01,0.99,6292,6312
9,12704,10,100,0.001,0.01,0.992,6343,6361
9,12804,10,100,0.001,0.01,0.99,6386,6418
9,12904,10,100,0.001,0.01,0.984,6438,6466
9,13004,10,100,0.001,0.01,0.994,6493,6511
9,13104,10,100,0.001,0.01,0.988,6538,6566
9,13204,10,100,0.001,0.01,0.99,6579,6625
9,13304,10,100,0.001,0.01,0.992,6629,6675
9,13404,10,100,0.001,0.01,0.99,6682,6722
9,13504,10,100,0.001,0.01,0.99,6735,6769
9,13604,10,100,0.001,0.01,0.994,6783,6821
9,13704,10,100,0.001,0.01,0.988,6822,6882
9,13804,10,100,0.001,0.01,0.988,6873,6931
9,13904,10,100,0.001,0.01,0.99,6925,6979
9,14004,10,100,0.001,0.01,0.992,6971,7033
9,14104,10,100,0.001,0.01,0.992,7023,7081
9,14204,10,100,0.001,0.01,0.99,7075,7129
9,14304,10,100,0.001,0.01,0.994,7130,7174
9,14404,10,100,0.001,0.01,0.992,7185,7219
9,14504,10,100,0.001,0.01,0.99,7236,7268
9,14604,10,100,0.001,0.01,0.992,7283,7321
9,14704,10,100,0.001,0.01,0.994,7335,7369
9,14804,10,100,0.001,0.01,0.994,7385,7419
9,14904,10,100,0.001,0.01,0.992,7435,7469
9,15004,10,100,0.001,0.01,0.98,7486,7518
10,104,10,100,0.001,0.01,0.522,51,53
10,204,10,100,0.001,0.01,0.522,109,95
10,304,10,100,0.001,0.01,0.502,157,147
10,404,10,100,0.001,0.01,0.496,204,200
10,504,10,100,0.001,0.01,0.484,255,249
10,604,10,100,0.001,0.01,0.482,300,304
10,704,10,100,0.001,0.01,0.488,353,351
10,804,10,100,0.001,0.01,0.488,404,400
10,904,10,100,0.001,0.01,0.51,453,451
10,1004,10,100,0.001,0.01,0.472,497,507
10,1104,10,100,0.001,0.01,0.502,545,559
10,1204,10,100,0.001,0.01,0.492,601,603
10,1304,10,100,0.001,0.01,0.518,652,652
10,1404,10,100,0.001,0.01,0.488,702,702
10,1504,10,100,0.001,0.01,0.494,752,752
10,1604,10,100,0.001,0.01,0.476,803,801
10,1704,10,100,0.001,0.01,0.49,848,856
10,1804,10,100,0.001,0.01,0.482,898,906
10,1904,10,100,0.001,0.01,0.47,940,964
10,2004,10,100,0.001,0.01,0.51,998,1006
10,2104,10,100,0.001,0.01,0.49,1051,1053
10,2204,10,100,0.001,0.01,0.514,1103,1101
10,2304,10,100,0.001,0.01,0.532,1162,1142
10,2404,10,100,0.001,0.01,0.508,1218,1186
10,2504,10,100,0.001,0.01,0.502,1270,1234
10,2604,10,100,0.001,0.01,0.498,1324,1280
10,2704,10,100,0.001,0.01,0.484,1365,1339
10,2804,10,100,0.001,0.01,0.494,1417,1387
10,2904,10,100,0.001,0.01,0.504,1462,1442
10,3004,10,100,0.001,0.01,0.504,1516,1488
10,3104,10,100,0.001,0.01,0.496,1575,1529
10,3204,10,100,0.001,0.01,0.488,1623,1581
10,3304,10,100,0.001,0.01,0.492,1677,1627
10,3404,10,100,0.001,0.01,0.51,1720,1684
10,3504,10,100,0.001,0.01,0.502,1766,1738
10,3604,10,100,0.001,0.01,0.548,1814,1790
10,3704,10,100,0.001,0.01,0.51,1857,1847
10,3804,10,100,0.001,0.01,0.524,1904,1900
10,3904,10,100,0.001,0.01,0.534,1950,1954
10,4004,10,100,0.001,0.01,0.53,1999,2005
10,4104,10,100,0.001,0.01,0.524,2051,2053
10,4204,10,100,0.001,0.01,0.518,2109,2095
10,4304,10,100,0.001,0.01,0.522,2153,2151
10,4404,10,100,0.001,0.01,0.508,2201,2203
10,4504,10,100,0.001,0.01,0.518,2253,2251
10,4604,10,100,0.001,0.01,0.522,2301,2303
10,4704,10,100,0.001,0.01,0.538,2348,2356
10,4804,10,100,0.001,0.01,0.51,2399,2405
10,4904,10,100,0.001,0.01,0.5,2452,2452
10,5004,10,100,0.001,0.01,0.51,2502,2502
10,5104,10,100,0.001,0.01,0.492,2550,2554
10,5204,10,100,0.001,0.01,0.514,2596,2608
10,5304,10,100,0.001,0.01,0.54,2654,2650
10,5404,10,100,0.001,0.01,0.512,2706,2698
10,5504,10,100,0.001,0.01,0.534,2752,2752
10,5604,10,100,0.001,0.01,0.54,2805,2799
10,5704,10,100,0.001,0.01,0.532,2860,2844
10,5804,10,100,0.001,0.01,0.55,2911,2893
10,5904,10,100,0.001,0.01,0.55,2957,2947
10,6004,10,100,0.001,0.01,0.542,3014,2990
10,6104,10,100,0.001,0.01,0.556,3066,3038
10,6204,10,100,0.001,0.01,0.546,3118,3086
10,6304,10,100,0.001,0.01,0.53,3176,3128
10,6404,10,100,0.001,0.01,0.528,3232,3172
10,6504,10,100,0.001,0.01,0.516,3280,3224
10,6604,10,100,0.001,0.01,0.548,3324,3280
10,6704,10,100,0.001,0.01,0.56,3367,3337
10,6804,10,100,0.001,0.01,0.542,3415,3389
10,6904,10,100,0.001,0.01,0.544,3468,3436
10,7004,10,100,0.001,0.01,0.56,3522,3482
10,7104,10,100,0.001,0.01,0.548,3572,3532
10,7204,10,100,0.001,0.01,0.57,3619,3585
10,7304,10,100,0.001,0.01,0.598,3668,3636
10,7404,10,100,0.001,0.01,0.572,3720,3684
10,7504,10,100,0.001,0.01,0.6,3769,3735
10,7604,10,100,0.001,0.01,0.598,3815,3789
10,7704,10,100,0.001,0.01,0.584,3864,3840
10,7804,10,100,0.001,0.01,0.592,3918,3886
10,7904,10,100,0.001,0.01,0.6,3962,3942
10,8004,10,100,0.001,0.01,0.588,4010,3994
10,8104,10,100,0.001,0.01,0.598,4061,4043
10,8204,10,100,0.001,0.01,0.61,4111,4093
10,8304,10,100,0.001,0.01,0.646,4159,4145
10,8404,10,100,0.001,0.01,0.646,4215,4189
10,8504,10,100,0.001,0.01,0.616,4261,4243
10,8604,10,100,0.001,0.01,0.658,4303,4301
10,8704,10,100,0.001,0.01,0.656,4358,4346
10,8804,10,100,0.001,0.01,0.656,4410,4394
10,8904,10,100,0.001,0.01,0.68,4467,4437
10,9004,10,100,0.001,0.01,0.672,4510,4494
10,9104,10,100,0.001,0.01,0.68,4561,4543
10,9204,10,100,0.001,0.01,0.694,4616,4588
10,9304,10,100,0.001,0.01,0.682,4665,4639
10,9404,10,100,0.001,0.01,0.668,4705,4699
10,9504,10,100,0.001,0.01,0.666,4761,4743
10,9604,10,100,0.001,0.01,0.666,4815,4789
10,9704,10,100,0.001,0.01,0.682,4868,4836
10,9804,10,100,0.001,0.01,0.674,4916,4888
10,9904,10,100,0.001,0.01,0.708,4971,4933
10,10004,10,100,0.001,0.01,0.696,5029,4975
10,10104,10,100,0.001,0.01,0.66,5065,5039
10,10204,10,100,0.001,0.01,0.728,5112,5092
10,10304,10,100,0.001,0.01,0.72,5154,5150
10,10404,10,100,0.001,0.01,0.698,5204,5200
10,10504,10,100,0.001,0.01,0.706,5247,5257
10,10604,10,100,0.001,0.01,0.704,5296,5308
10,10704,10,100,0.001,0.01,0.718,5336,5368
10,10804,10,100,0.001,0.01,0.702,5387,5417
10,10904,10,100,0.001,0.01,0.724,5438,5466
10,11004,10,100,0.001,0.01,0.742,5482,5522
10,11104,10,100,0.001,0.01,0.746,5534,5570
10,11204,10,100,0.001,0.01,0.75,5589,5615
10,11304,10,100,0.001,0.01,0.768,5646,5658
10,11404,10,100,0.001,0.01,0.74,5697,5707
10,11504,10,100,0.001,0.01,0.762,5753,5751
10,11604,10,100,0.001,0.01,0.776,5803,5801
10,11704,10,100,0.001,0.01,0.766,5844,5860
10,11804,10,100,0.001,0.01,0.736,5897,5907
10,11904,10,100,0.001,0.01,0.744,5939,5965
10,12004,10,100,0.001,0.01,0.77,5997,6007
10,12104,10,100,0.001,0.01,0.772,6047,6057
10,12204,10,100,0.001,0.01,0.778,6096,6108
10,12304,10,100,0.001,0.01,0.772,6145,6159
10,12404,10,100,0.001,0.01,0.77,6194,6210
10,12504,10,100,0.001,0.01,0.77,6251,6253
10,12604,10,100,0.001,0.01,0.762,6303,6301
10,12704,10,100,0.001,0.01,0.78,6357,6347
10,12804,10,100,0.001,0.01,0.778,6398,6406
10,12904,10,100,0.001,0.01,0.784,6439,6465
10,13004,10,100,0.001,0.01,0.786,6487,6517
10,13104,10,100,0.001,0.01,0.78,6534,6570
10,13204,10,100,0.001,0.01,0.784,6579,6625
10,13304,10,100,0.001,0.01,0.816,6635,6669
10,13404,10,100,0.001,0.01,0.796,6679,6725
10,13504,10,100,0.001,0.01,0.774,6727,6777
10,13604,10,100,0.001,0.01,0.814,6778,6826
10,13704,10,100,0.001,0.01,0.818,6829,6875
10,13804,10,100,0.001,0.01,0.8,6886,6918
10,13904,10,100,0.001,0.01,0.806,6937,6967
10,14004,10,100,0.001,0.01,0.838,6989,7015
10,14104,10,100,0.001,0.01,0.812,7037,7067
10,14204,10,100,0.001,0.01,0.828,7082,7122
10,14304,10,100,0.001,0.01,0.812,7132,7172
10,14404,10,100,0.001,0.01,0.826,7186,7218
10,14504,10,100,0.001,0.01,0.824,7233,7271
10,14604,10,100,0.001,0.01,0.838,7282,7322
10,14704,10,100,0.001,0.01,0.836,7327,7377
10,14804,10,100,0.001,0.01,0.804,7381,7423
10,14904,10,100,0.001,0.01,0.854,7440,7464
10,15004,10,100,0.001,0.01,0.836,7491,7513
11,104,10,100,0.001,0.01,0.52,54,50
11,204,10,100,0.001,0.01,0.48,107,97
11,304,10,100,0.001,0.01,0.478,153,151
11,404,10,100,0.001,0.01,0.52,207,197
11,504,10,100,0.001,0.01,0.536,263,241
11,604,10,100,0.001,0.01,0.506,315,289
11,704,10,100,0.001,0.01,0.476,372,332
11,804,10,100,0.001,0.01,0.5,415,389
11,904,10,100,0.001,0.01,0.502,467,437
11,1004,10,100,0.001,0.01,0.476,509,495
11,1104,10,100,0.001,0.01,0.518,559,545
11,1204,10,100,0.001,0.01,0.48,608,596
11,1304,10,100,0.001,0.01,0.48,658,646
11,1404,10,100,0.001,0.01,0.47,710,694
11,1504,10,100,0.001,0.01,0.49,762,742
11,1604,10,100,0.001,0.01,0.502,811,793
11,1704,10,100,0.001,0.01,0.51,864,840
11,1804,10,100,0.001,0.01,0.508,913,891
11,1904,10,100,0.001,0.01,0.524,967,937
11,2004,10,100,0.001,0.01,0.532,1011,993
11,2104,10,100,0.001,0.01,0.516,1065,1039
11,2204,10,100,0.001,0.01,0.496,1117,1087
11,2304,10,100,0.001,0.01,0.56,1170,1134
11,2404,10,100,0.001,0.01,0.538,1225,1179
11,2504,10,100,0.001,0.01,0.516,1270,1234
11,2604,10,100,0.001,0.01,0.532,1322,1282
11,2704,10,100,0.001,0.01,0.526,1374,1330
11,2804,10,100,0.001,0.01,0.536,1427,1377
11,2904,10,100,0.001,0.01,0.542,1469,1435
11,3004,10,100,0.001,0.01,0.532,1519,1485
11,3104,10,100,0.001,0.01,0.536,1568,1536
11,3204,10,100,0.001,0.01,0.534,1627,1577
11,3304,10,100,0.001,0.01,0.562,1676,1628
11,3404,10,100,0.001,0.01,0.552,1726,1678
11,3504,10,100,0.001,0.01,0.592,1770,1734
11,3604,10,100,0.001,0.01,0.554,1820,1784
11,3704,10,100,0.001,0.01,0.57,1866,1838
11,3804,10,100,0.001,0.01,0.584,1920,1884
11,3904,10,100,0.001,0.01,0.554,1966,1938
11,4004,10,100,0.001,0.01,0.56,2008,1996
11,4104,10,100,0.001,0.01,0.536,2061,2043
11,4204,10,100,0.001,0.01,0.52,2103,2101
11,4304,10,100,0.001,0.01,0.552,2150,2154
11,4404,10,100,0.001,0.01,0.596,2204,2200
11,4504,10,100,0.001,0.01,0.558,2257,2247
11,4604,10,100,0.001,0.01,0.574,2310,2294
11,4704,10,100,0.001,0.01,0.578,2361,2343
11,4804,10,100,0.001,0.01,0.58,2404,2400
11,4904,10,100,0.001,0.01,0.56,2457,2447
11,5004,10,100,0.001,0.01,0.592,2515,2489
11,5104,10,100,0.001,0.01,0.57,2569,2535
11,5204,10,100,0.001,0.01,0.6,2616,2588
11,5304,10,100,0.001,0.01,0.574,2670,2634
11,5404,10,100,0.001,0.01,0.58,2726,2678
11,5504,10,100,0.001,0.01,0.594,2784,2720
11,5604,10,100,0.001,0.01,0.602,2831,2773
11,5704,10,100,0.001,0.01,0.626,2885,2819
11,5804,10,100,0.001,0.01,0.628,2937,2867
11,5904,10,100,0.001,0.01,0.604,2985,2919
11,6004,10,100,0.001,0.01,0.614,3035,2969
11,6104,10,100,0.001,0.01,0.616,3083,3021
11,6204,10,100,0.001,0.01,0.624,3127,3077
11,6304,10,100,0.001,0.01,0.634,3176,3128
11,6404,10,100,0.001,0.01,0.646,3228,3176
11,6504,10,100,0.001,0.01,0.658,3284,3220
11,6604,10,100,0.001,0.01,0.664,3326,3278
11,6704,10,100,0.001,0.01,0.642,3370,3334
11,6804,10,100,0.001,0.01,0.686,3422,3382
11,6904,10,100,0.001,0.01,0.664,3470,3434
11,7004,10,100,0.001,0.01,0.656,3519,3485
11,7104,10,100,0.001,0.01,0.662,3571,3533
11,7204,10,100,0.001,0.01,0.68,3618,3586
11,7304,10,100,0.001,0.01,0.668,3672,3632
11,7404,10,100,0.001,0.01,0.678,3728,3676
11,7504,10,100,0.001,0.01,0.68,3774,3730
11,7604,10,100,0.001,0.01,0.692,3827,3777
11,7704,10,100,0.001,0.01,0.7,3869,3835
11,7804,10,100,0.001,0.01,0.678,3917,3887
11,7904,10,100,0.001,0.01,0.684,3970,3934
11,8004,10,100,0.001,0.01,0.69,4021,3983
11,8104,10,100,0.001,0.01,0.716,4071,4033
11,8204,10,100,0.001,0.01,0.72,4117,4087
11,8304,10,100,0.001,0.01,0.722,4173,4131
11,8404,10,100,0.001,0.01,0.708,4217,4187
11,8504,10,100,0.001,0.01,0.704,4266,4238
11,8604,10,100,0.001,0.01,0.712,4319,4285
11,8704,10,100,0.001,0.01,0.71,4365,4339
11,8804,10,100,0.001,0.01,0.708,4411,4393
11,8904,10,100,0.001,0.01,0.726,4464,4440
11,9004,10,100,0.001,0.01,0.714,4518,4486
11,9104,10,100,0.001,0.01,0.734,4569,4535
11,9204,10,100,0.001,0.01,0.72,4624,4580
11,9304,10,100,0.001,0.01,0.748,4671,4633
11,9404,10,100,0.001,0.01,0.75,4715,4689
11,9504,10,100,0.001,0.01,0.734,4758,4746
11,9604,10,100,0.001,0.01,0.756,4804,4800
11,9704,10,100,0.001,0.01,0.762,4853,4851
11,9804,10,100,0.001,0.01,0.766,4899,4905
11,9904,10,100,0.001,0.01,0.756,4941,4963
11,10004,10,100,0.001,0.01,0.736,4989,5015
11,10104,10,100,0.001,0.01,0.746,5039,5065
11,10204,10,100,0.001,0.01,0.77,5094,5110
11,10304,10,100,0.001,0.01,0.79,5146,5158
11,10404,10,100,0.001,0.01,0.768,5184,5220
11,10504,10,100,0.001,0.01,0.804,5230,5274
11,10604,10,100,0.001,0.01,0.79,5283,5321
11,10704,10,100,0.001,0.01,0.81,5327,5377
11,10804,10,100,0.001,0.01,0.806,5380,5424
11,10904,10,100,0.001,0.01,0.82,5438,5466
11,11004,10,100,0.001,0.01,0.814,5478,5526
11,11104,10,100,0.001,0.01,0.814,5528,5576
11,11204,10,100,0.001,0.01,0.828,5581,5623
11,11304,10,100,0.001,0.01,0.84,5639,5665
11,11404,10,100,0.001,0.01,0.82,5703,5701
11,11504,10,100,0.001,0.01,0.8,5743,5761
11,11604,10,100,0.001,0.01,0.84,5793,5811
11,11704,10,100,0.001,0.01,0.818,5846,5858
11,11804,10,100,0.001,0.01,0.854,5902,5902
11,11904,10,100,0.001,0.01,0.854,5946,5958
11,12004,10,100,0.001,0.01,0.854,5993,6011
11,12104,10,100,0.001,0.01,0.854,6048,6056
11,12204,10,100,0.001,0.01,0.848,6102,6102
11,12304,10,100,0.001,0.01,0.846,6154,6150
11,12404,10,100,0.001,0.01,0.866,6197,6207
11,12504,10,100,0.001,0.01,0.886,6252,6252
11,12604,10,100,0.001,0.01,0.862,6305,6299
11,12704,10,100,0.001,0.01,0.862,6357,6347
11,12804,10,100,0.001,0.01,0.866,6401,6403
11,12904,10,100,0.001,0.01,0.866,6446,6458
11,13004,10,100,0.001,0.01,0.886,6492,6512
11,13104,10,100,0.001,0.01,0.89,6537,6567
11,13204,10,100,0.001,0.01,0.896,6586,6618
11,13304,10,100,0.001,0.01,0.888,6646,6658
11,13404,10,100,0.001,0.01,0.908,6693,6711
11,13504,10,100,0.001,0.01,0.89,6748,6756
11,13604,10,100,0.001,0.01,0.912,6795,6809
11,13704,10,100,0.001,0.01,0.912,6855,6849
11,13804,10,100,0.001,0.01,0.906,6899,6905
11,13904,10,100,0.001,0.01,0.89,6941,6963
11,14004,10,100,0.001,0.01,0.902,6986,7018
11,14104,10,100,0.001,0.01,0.91,7036,7068
11,14204,10,100,0.001,0.01,0.912,7086,7118
11,14304,10,100,0.001,0.01,0.91,7144,7160
11,14404,10,100,0.001,0.01,0.914,7201,7203
11,14504,10,100,0.001,0.01,0.916,7253,7251
11,14604,10,100,0.001,0.01,0.922,7302,7302
11,14704,10,100,0.001,0.01,0.928,7351,7353
11,14804,10,100,0.001,0.01,0.918,7398,7406
11,14904,10,100,0.001,0.01,0.932,7457,7447
11,15004,10,100,0.001,0.01,0.932,7512,7492
12,104,10,100,0.001,0.01,0.48,52,52
12,204,10,100,0.001,0.01,0.524,106,98
12,304,10,100,0.001,0.01,0.516,156,148
12,404,10,100,0.001,0.01,0.52,207,197
12,504,10,100,0.001,0.01,0.528,256,248
12,604,10,100,0.001,0.01,0.566,306,298
12,704,10,100,0.001,0.01,0.562,357,347
12,804,10,100,0.001,0.01,0.534,407,397
12,904,10,100,0.001,0.01,0.508,455,449
12,1004,10,100,0.001,0.01,0.528,506,498
12,1104,10,100,0.001,0.01,0.508,547,557
12,1204,10,100,0.001,0.01,0.548,594,610
12,1304,10,100,0.001,0.01,0.536,647,657
12,1404,10,100,0.001,0.01,0.494,705,699
12,1504,10,100,0.001,0.01,0.532,756,748
12,1604,10,100,0.001,0.01,0.54,805,799
12,1704,10,100,0.001,0.01,0.538,854,850
12,1804,10,100,0.001,0.01,0.556,906,898
12,1904,10,100,0.001,0.01,0.52,957,947
12,2004,10,100,0.001,0.01,0.534,1009,995
12,2104,10,100,0.001,0.01,0.514,1055,1049
12,2204,10,100,0.001,0.01,0.522,1103,1101
12,2304,10,100,0.001,0.01,0.53,1144,1160
12,2404,10,100,0.001,0.01,0.528,1192,1212
12,2504,10,100,0.001,0.01,0.564,1237,1267
12,2604,10,100,0.001,0.01,0.536,1289,1315
12,2704,10,100,0.001,0.01,0.524,1338,1366
12,2804,10,100,0.001,0.01,0.54,1391,1413
12,2904,10,100,0.001,0.01,0.5,1436,1468
12,3004,10,100,0.001,0.01,0.54,1483,1521
12,3104,10,100,0.001,0.01,0.522,1527,1577
12,3204,10,100,0.001,0.01,0.544,1582,1622
12,3304,10,100,0.001,0.01,0.542,1634,1670
12,3404,10,100,0.001,0.01,0.538,1681,1723
12,3504,10,100,0.001,0.01,0.532,1730,1774
12,3604,10,100,0.001,0.01,0.514,1780,1824
12,3704,10,100,0.001,0.01,0.56,1832,1872
12,3804,10,100,0.001,0.01,0.544,1881,1923
12,3904,10,100,0.001,0.01,0.55,1929,1975
12,4004,10,100,0.001,0.01,0.576,1979,2025
12,4104,10,100,0.001,0.01,0.566,2034,2070
12,4204,10,100,0.001,0.01,0.604,2086,2118
12,4304,10,100,0.001,0.01,0.618,2140,2164
12,4404,10,100,0.001,0.01,0.608,2186,2218
12,4504,10,100,0.001,0.01,0.592,2234,2270
12,4604,10,100,0.001,0.01,0.596,2283,2321
12,4704,10,100,0.001,0.01,0.632,2332,2372
12,4804,10,100,0.001,0.01,0.638,2385,2419
12,4904,10,100,0.001,0.01,0.62,2428,2476
12,5004,10,100,0.001,0.01,0.632,2484,2520
12,5104,10,100,0.001,0.01,0.654,2536,2568
12,5204,10,100,0.001,0.01,0.69,2582,2622
12,5304,10,100,0.001,0.01,0.69,2639,2665
12,5404,10,100,0.001,0.01,0.67,2684,2720
12,5504,10,100,0.001,0.01,0.658,2733,2771
12,5604,10,100,0.001,0.01,0.69,2782,2822
12,5704,10,100,0.001,0.01,0.676,2831,2873
12,5804,10,100,0.001,0.01,0.69,2889,2915
12,5904,10,100,0.001,0.01,0.656,2938,2966
12,6004,10,100,0.001,0.01,0.652,2983,3021
12,6104,10,100,0.001,0.01,0.676,3033,3071
12,6204,10,100,0.001,0.01,0.716,3084,3120
12,6304,10,100,0.001,0.01,0.684,3130,3174
12,6404,10,100,0.001,0.01,0.664,3190,3214
12,6504,10,100,0.001,0.01,0.684,3230,3274
12,6604,10,100,0.001,0.01,0.69,3284,3320
12,6704,10,100,0.001,0.01,0.698,3339,3365
12,6804,10,100,0.001,0.01,0.692,3396,3408
12,6904,10,100,0.001,0.01,0.69,3440,3464
12,7004,10,100,0.001,0.01,0.698,3491,3513
12,7104,10,100,0.001,0.01,0.7,3544,3560
12,7204,10,100,0.001,0.01,0.702,3599,3605
12,7304,10,100,0.001,0.01,0.718,3639,3665
12,7404,10,100,0.001,0.01,0.716,3689,3715
12,7504,10,100,0.001,0.01,0.7,3738,3766
12,7604,10,100,0.001,0.01,0.698,3783,3821
12,7704,10,100,0.001,0.01,0.734,3840,3864
12,7804,10,100,0.001,0.01,0.728,3894,3910
12,7904,10,100,0.001,0.01,0.73,3947,3957
12,8004,10,100,0.001,0.01,0.728,3998,4006
12,8104,10,100,0.001,0.01,0.714,4049,4055
12,8204,10,100,0.001,0.01,0.722,4099,4105
12,8304,10,100,0.001,0.01,0.738,4146,4158
12,8404,10,100,0.001,0.01,0.736,4192,4212
12,8504,10,100,0.001,0.01,0.726,4239,4265
12,8604,10,100,0.001,0.01,0.732,4288,4316
12,8704,10,100,0.001,0.01,0.72,4335,4369
12,8804,10,100,0.001,0.01,0.746,4381,4423
12,8904,10,100,0.001,0.01,0.726,4431,4473
12,9004,10,100,0.001,0.01,0.742,4475,4529
12,9104,10,100,0.001,0.01,0.738,4523,4581
12,9204,10,100,0.001,0.01,0.742,4573,4631
12,9304,10,100,0.001,0.01,0.72,4611,4693
12,9404,10,100,0.001,0.01,0.712,4661,4743
12,9504,10,100,0.001,0.01,0.718,4710,4794
12,9604,10,100,0.001,0.01,0.712,4766,4838
12,9704,10,100,0.001,0.01,0.754,4817,4887
12,9804,10,100,0.001,0.01,0.752,4862,4942
12,9904,10,100,0.001,0.01,0.748,4909,4995
12,10004,10,100,0.001,0.01,0.748,4967,5037
12,10104,10,100,0.001,0.01,0.754,5016,5088
12,10204,10,100,0.001,0.01,0.754,5074,5130
12,10304,10,100,0.001,0.01,0.758,5126,5178
12,10404,10,100,0.001,0.01,0.744,5172,5232
12,10504,10,100,0.001,0.01,0.764,5226,5278
12,10604,10,100,0.001,0.01,0.77,5276,5328
12,10704,10,100,0.001,0.01,0.76,5328,5376
12,10804,10,100,0.001,0.01,0.764,5379,5425
12,10904,10,100,0.001,0.01,0.756,5434,5470
12,11004,10,100,0.001,0.01,0.744,5493,5511
12,11104,10,100,0.001,0.01,0.776,5538,5566
12,11204,10,100,0.001,0.01,0.764,5584,5620
12,11304,10,100,0.001,0.01,0.782,5637,5667
12,11404,10,100,0.001,0.01,0.772,5691,5713
12,11504,10,100,0.001,0.01,0.778,5743,5761
12,11604,10,100,0.001,0.01,0.752,5795,5809
12,11704,10,100,0.001,0.01,0.766,5844,5860
12,11804,10,100,0.001,0.01,0.75,5898,5906
12,11904,10,100,0.001,0.01,0.788,5950,5954
12,12004,10,100,0.001,0.01,0.772,5991,6013
12,12104,10,100,0.001,0.01,0.78,6036,6068
12,12204,10,100,0.001,0.01,0.812,6090,6114
12,12304,10,100,0.001,0.01,0.792,6138,6166
12,12404,10,100,0.001,0.01,0.79,6186,6218
12,12504,10,100,0.001,0.01,0.784,6241,6263
12,12604,10,100,0.001,0.01,0.816,6290,6314
12,12704,10,100,0.001,0.01,0.818,6334,6370
12,12804,10,100,0.001,0.01,0.81,6385,6419
12,12904,10,100,0.001,0.01,0.808,6432,6472
12,13004,10,100,0.001,0.01,0.82,6486,6518
12,13104,10,100,0.001,0.01,0.802,6531,6573
12,13204,10,100,0.001,0.01,0.802,6585,6619
12,13304,10,100,0.001,0.01,0.804,6633,6671
12,13404,10,100,0.001,0.01,0.814,6681,6723
12,13504,10,100,0.001,0.01,0.814,6734,6770
12,13604,10,100,0.001,0.01,0.83,6779,6825
12,13704,10,100,0.001,0.01,0.836,6833,6871
12,13804,10,100,0.001,0.01,0.84,6886,6918
12,13904,10,100,0.001,0.01,0.812,6937,6967
12,14004,10,100,0.001,0.01,0.832,6996,7008
12,14104,10,100,0.001,0.01,0.828,7048,7056
12,14204,10,100,0.001,0.01,0.834,7098,7106
12,14304,10,100,0.001,0.01,0.844,7148,7156
12,14404,10,100,0.001,0.01,0.848,7189,7215
12,14504,10,100,0.001,0.01,0.838,7245,7259
12,14604,10,100,0.001,0.01,0.848,7286,7318
12,14704,10,100,0.001,0.01,0.852,7331,7373
12,14804,10,100,0.001,0.01,0.858,7386,7418
12,14904,10,100,0.001,0.01,0.848,7439,7465
12,15004,10,100,0.001,0.01,0.864,7492,7512
13,104,10,100,0.001,0.01,0.504,47,57
13,204,10,100,0.001,0.01,0.51,91,113
13,304,10,100,0.001,0.01,0.47,149,155
13,404,10,100,0.001,0.01,0.484,197,207
13,504,10,100,0.001,0.01,0.47,250,254
13,604,10,100,0.001,0.01,0.486,300,304
13,704,10,100,0.001,0.01,0.476,356,348
13,804,10,100,0.001,0.01,0.508,404,400
13,904,10,100,0.001,0.01,0.532,444,460
13,1004,10,100,0.001,0.01,0.52,498,506
13,1104,10,100,0.001,0.01,0.51,552,552
13,1204,10,100,0.001,0.01,0.516,606,598
13,1304,10,100,0.001,0.01,0.516,654,650
13,1404,10,100,0.001,0.01,0.532,710,694
13,1504,10,100,0.001,0.01,0.514,765,739
13,1604,10,100,0.001,0.01,0.5,807,797
13,1704,10,100,0.001,0.01,0.506,850,854
13,1804,10,100,0.001,0.01,0.48,902,902
13,1904,10,100,0.001,0.01,0.498,944,960
13,2004,10,100,0.001,0.01,0.524,991,1013
13,2104,10,100,0.001,0.01,0.498,1034,1070
13,2204,10,100,0.001,0.01,0.516,1086,1118
13,2304,10,100,0.001,0.01,0.53,1143,1161
13,2404,10,100,0.001,0.01,0.532,1190,1214
13,2504,10,100,0.001,0.01,0.538,1235,1269
13,2604,10,100,0.001,0.01,0.524,1278,1326
13,2704,10,100,0.001,0.01,0.5,1333,1371
13,2804,10,100,0.001,0.01,0.516,1380,1424
13,2904,10,100,0.001,0.01,0.514,1431,1473
13,3004,10,100,0.001,0.01,0.528,1474,1530
13,3104,10,100,0.001,0.01,0.476,1529,1575
13,3204,10,100,0.001,0.01,0.498,1575,1629
13,3304,10,100,0.001,0.01,0.486,1621,1683
13,3404,10,100,0.001,0.01,0.522,1675,1729
13,3504,10,100,0.001,0.01,0.452,1730,1774
13,3604,10,100,0.001,0.01,0.468,1787,1817
13,3704,10,100,0.001,0.01,0.492,1840,1864
13,3804,10,100,0.001,0.01,0.476,1895,1909
13,3904,10,100,0.001,0.01,0.5,1951,1953
13,4004,10,100,0.001,0.01,0.492,2007,1997
13,4104,10,100,0.001,0.01,0.514,2058,2046
13,4204,10,100,0.001,0.01,0.506,2095,2109
13,4304,10,100,0.001,0.01,0.492,2141,2163
13,4404,10,100,0.001,0.01,0.51,2193,2211
13,4504,10,100,0.001,0.01,0.51,2239,2265
13,4604,10,100,0.001,0.01,0.498,2293,2311
13,4704,10,100,0.001,0.01,0.528,2347,2357
13,4804,10,100,0.001,0.01,0.516,2401,2403
13,4904,10,100,0.001,0.01,0.504,2449,2455
13,5004,10,100,0.001,0.01,0.506,2501,2503
13,5104,10,100,0.001,0.01,0.52,2543,2561
13,5204,10,100,0.001,0.01,0.492,2582,2622
13,5304,10,100,0.001,0.01,0.506,2637,2667
13,5404,10,100,0.001,0.01,0.516,2682,2722
13,5504,10,100,0.001,0.01,0.532,2725,2779
13,5604,10,100,0.001,0.01,0.504,2780,2824
13,5704,10,100,0.001,0.01,0.496,2831,2873
13,5804,10,100,0.001,0.01,0.5,2883,2921
13,5904,10,100,0.001,0.01,0.508,2948,2956
13,6004,10,100,0.001,0.01,0.514,2992,3012
13,6104,10,100,0.001,0.01,0.51,3044,3060
13,6204,10,100,0.001,0.01,0.504,3092,3112
13,6304,10,100,0.001,0.01,0.522,3144,3160
13,6404,10,100,0.001,0.01,0.518,3199,3205
13,6504,10,100,0.001,0.01,0.53,3250,3254
13,6604,10,100,0.001,0.01,0.518,3304,3300
13,6704,10,100,0.001,0.01,0.536,3354,3350
13,6804,10,100,0.001,0.01,0.536,3406,3398
13,6904,10,100,0.001,0.01,0.542,3457,3447
13,7004,10,100,0.001,0.01,0.534,3502,3502
13,7104,10,100,0.001,0.01,0.516,3551,3553
13,7204,10,100,0.001,0.01,0.556,3595,3609
13,7304,10,100,0.001,0.01,0.554,3657,3647
13,7404,10,100,0.001,0.01,0.57,3715,3689
13,7504,10,100,0.001,0.01,0.57,3773,3731
13,7604,10,100,0.001,0.01,0.56,3834,3770
13,7704,10,100,0.001,0.01,0.57,3893,3811
13,7804,10,100,0.001,0.01,0.562,3942,3862
13,7904,10,100,0.001,0.01,0.56,3991,3913
13,8004,10,100,0.001,0.01,0.566,4039,3965
13,8104,10,100,0.001,0.01,0.568,4096,4008
13,8204,10,100,0.001,0.01,0.574,4135,4069
13,8304,10,100,0.001,0.01,0.59,4177,4127
13,8404,10,100,0.001,0.01,0.588,4222,4182
13,8504,10,100,0.001,0.01,0.58,4268,4236
13,8604,10,100,0.001,0.01,0.598,4312,4292
13,8704,10,100,0.001,0.01,0.594,4356,4348
13,8804,10,100,0.001,0.01,0.596,4407,4397
13,8904,10,100,0.001,0.01,0.598,4471,4433
13,9004,10,100,0.001,0.01,0.612,4521,4483
13,9104,10,100,0.001,0.01,0.61,4573,4531
13,9204,10,100,0.001,0.01,0.602,4623,4581
13,9304,10,100,0.001,0.01,0.598,4674,4630
13,9404,10,100,0.001,0.01,0.594,4717,4687
13,9504,10,100,0.001,0.01,0.63,4762,4742
13,9604,10,100,0.001,0.01,0.616,4811,4793
13,9704,10,100,0.001,0.01,0.626,4862,4842
13,9804,10,100,0.001,0.01,0.666,4911,4893
13,9904,10,100,0.001,0.01,0.66,4957,4947
13,10004,10,100,0.001,0.01,0.628,5011,4993
13,10104,10,100,0.001,0.01,0.668,5061,5043
13,10204,10,100,0.001,0.01,0.666,5109,5095
13,10304,10,100,0.001,0.01,0.638,5159,5145
13,10404,10,100,0.001,0.01,0.638,5209,5195
13,10504,10,100,0.001,0.01,0.662,5262,5242
13,10604,10,100,0.001,0.01,0.666,5312,5292
13,10704,10,100,0.001,0.01,0.63,5360,5344
13,10804,10,100,0.001,0.01,0.682,5404,5400
13,10904,10,100,0.001,0.01,0.672,5456,5448
13,11004,10,100,0.001,0.01,0.686,5508,5496
13,11104,10,100,0.001,0.01,0.666,5564,5540
13,11204,10,100,0.001,0.01,0.694,5609,5595
13,11304,10,100,0.001,0.01,0.678,5666,5638
13,11404,10,100,0.001,0.01,0.706,5712,5692
13,11504,10,100,0.001,0.01,0.686,5765,5739
13,11604,10,100,0.001,0.01,0.688,5817,5787
13,11704,10,100,0.001,0.01,0.698,5862,5842
13,11804,10,100,0.001,0.01,0.694,5907,5897
13,11904,10,100,0.001,0.01,0.722,5950,5954
13,12004,10,100,0.001,0.01,0.708,5998,6006
13,12104,10,100,0.001,0.01,0.722,6050,6054
13,12204,10,100,0.001,0.01,0.73,6102,6102
13,12304,10,100,0.001,0.01,0.708,6155,6149
13,12404,10,100,0.001,0.01,0.75,6204,6200
13,12504,10,100,0.001,0.01,0.752,6247,6257
13,12604,10,100,0.001,0.01,0.74,6297,6307
13,12704,10,100,0.001,0.01,0.752,6336,6368
13,12804,10,100,0.001,0.01,0.756,6386,6418
13,12904,10,100,0.001,0.01,0.73,6438,6466
13,13004,10,100,0.001,0.01,0.744,6499,6505
13,13104,10,100,0.001,0.01,0.738,6546,6558
13,13204,10,100,0.001,0.01,0.754,6594,6610
13,13304,10,100,0.001,0.01,0.766,6647,6657
13,13404,10,100,0.001,0.01,0.776,6693,6711
13,13504,10,100,0.001,0.01,0.778,6742,6762
13,13604,10,100,0.001,0.01,0.752,6792,6812
13,13704,10,100,0.001,0.01,0.774,6837,6867
13,13804,10,100,0.001,0.01,0.78,6881,6923
13,13904,10,100,0.001,0.01,0.776,6930,6974
13,14004,10,100,0.001,0.01,0.774,6980,7024
13,14104,10,100,0.001,0.01,0.786,7032,7072
13,14204,10,100,0.001,0.01,0.81,7090,7114
13,14304,10,100,0.001,0.01,0.8,7149,7155
13,14404,10,100,0.001,0.01,0.79,7199,7205
13,14504,10,100,0.001,0.01,0.812,7252,7252
13,14604,10,100,0.001,0.01,0.818,7307,7297
13,14704,10,100,0.001,0.01,0.838,7356,7348
13,14804,10,100,0.001,0.01,0.832,7406,7398
13,14904,10,100,0.001,0.01,0.824,7454,7450
13,15004,10,100,0.001,0.01,0.81,7501,7503
14,104,10,100,0.001,0.01,0.534,53,51
14,204,10,100,0.001,0.01,0.47,98,106
14,304,10,100,0.001,0.01,0.554,147,157
14,404,10,100,0.001,0.01,0.55,210,194
14,504,10,100,0.001,0.01,0.536,265,239
14,604,10,100,0.001,0.01,0.482,313,291
14,704,10,100,0.001,0.01,0.496,363,341
14,804,10,100,0.001,0.01,0.548,416,388
14,904,10,100,0.001,0.01,0.542,469,435
14,1004,10,100,0.001,0.01,0.49,516,488
14,1104,10,100,0.001,0.01,0.536,565,539
14,1204,10,100,0.001,0.01,0.544,618,586
14,1304,10,100,0.001,0.01,0.524,666,638
14,1404,10,100,0.001,0.01,0.562,713,691
14,1504,10,100,0.001,0.01,0.536,761,743
14,1604,10,100,0.001,0.01,0.566,815,789
14,1704,10,100,0.001,0.01,0.6,865,839
14,1804,10,100,0.001,0.01,0.554,911,893
14,1904,10,100,0.001,0.01,0.59,958,946
14,2004,10,100,0.001,0.01,0.566,1004,1000
14,2104,10,100,0.001,0.01,0.604,1052,1052
14,2204,10,100,0.001,0.01,0.624,1097,1107
14,2304,10,100,0.001,0.01,0.61,1151,1153
14,2404,10,100,0.001,0.01,0.644,1203,1201
14,2504,10,100,0.001,0.01,0.664,1259,1245
14,2604,10,100,0.001,0.01,0.634,1306,1298
14,2704,10,100,0.001,0.01,0.634,1353,1351
14,2804,10,100,0.001,0.01,0.634,1400,1404
14,2904,10,100,0.001,0.01,0.668,1450,1454
14,3004,10,100,0.001,0.01,0.684,1510,1494
14,3104,10,100,0.001,0.01,0.658,1556,1548
14,3204,10,100,0.001,0.01,0.686,1613,1591
14,3304,10,100,0.001,0.01,0.698,1664,1640
14,3404,10,100,0.001,0.01,0.696,1709,1695
14,3504,10,100,0.001,0.01,0.74,1762,1742
14,3604,10,100,0.001,0.01,0.742,1815,1789
14,3704,10,100,0.001,0.01,0.712,1862,1842
14,3804,10,100,0.001,0.01,0.706,1907,1897
14,3904,10,100,0.001,0.01,0.724,1957,1947
14,4004,10,100,0.001,0.01,0.746,2009,1995
14,4104,10,100,0.001,0.01,0.754,2052,2052
14,4204,10,100,0.001,0.01,0.75,2104,2100
14,4304,10,100,0.001,0.01,0.77,2153,2151
14,4404,10,100,0.001,0.01,0.734,2199,2205
14,4504,10,100,0.001,0.01,0.754,2248,2256
14,4604,10,100,0.001,0.01,0.75,2306,2298
14,4704,10,100,0.001,0.01,0.784,2353,2351
14,4804,10,100,0.001,0.01,0.77,2394,2410
14,4904,10,100,0.001,0.01,0.784,2450,2454
14,5004,10,100,0.001,0.01,0.77,2490,2514
14,5104,10,100,0.001,0.01,0.752,2543,2561
14,5204,10,100,0.001,0.01,0.748,2593,2611
14,5304,10,100,0.001,0.01,0.774,2643,2661
14,5404,10,100,0.001,0.01,0.768,2693,2711
14,5504,10,100,0.001,0.01,0.786,2745,2759
14,5604,10,100,0.001,0.01,0.794,2804,2800
14,5704,10,100,0.001,0.01,0.808,2858,2846
14,5804,10,100,0.001,0.01,0.786,2906,2898
14,5904,10,100,0.001,0.01,0.818,2954,2950
14,6004,10,100,0.001,0.01,0.818,2999,3005
14,6104,10,100,0.001,0.01,0.804,3055,3049
14,6204,10,100,0.001,0.01,0.836,3102,3102
14,6304,10,100,0.001,0.01,0.8,3153,3151
14,6404,10,100,0.001,0.01,0.804,3203,3201
14,6504,10,100,0.001,0.01,0.796,3253,3251
14,6604,10,100,0.001,0.01,0.82,3307,3297
14,6704,10,100,0.001,0.01,0.826,3350,3354
14,6804,10,100,0.001,0.01,0.822,3403,3401
14,6904,10,100,0.001,0.01,0.802,3449,3455
14,7004,10,100,0.001,0.01,0.836,3491,3513
14,7104,10,100,0.001,0.01,0.844,3538,3566
14,7204,10,100,0.001,0.01,0.812,3596,3608
14,7304,10,100,0.001,0.01,0.834,3640,3664
14,7404,10,100,0.001,0.01,0.834,3692,3712
14,7504,10,100,0.001,0.01,0.844,3741,3763
14,7604,10,100,0.001,0.01,0.84,3793,3811
14,7704,10,100,0.001,0.01,0.846,3831,3873
14,7804,10,100,0.001,0.01,0.834,3892,3912
14,7904,10,100,0.001,0.01,0.852,3942,3962
14,8004,10,100,0.001,0.01,0.854,3993,4011
14,8104,10,100,0.001,0.01,0.884,4055,4049
14,8204,10,100,0.001,0.01,0.858,4105,4099
14,8304,10,100,0.001,0.01,0.872,4147,4157
14,8404,10,100,0.001,0.01,0.866,4198,4206
14,8504,10,100,0.001,0.01,0.864,4244,4260
14,8604,10,100,0.001,0.01,0.864,4296,4308
14,8704,10,100,0.001,0.01,0.856,4343,4361
14,8804,10,100,0.001,0.01,0.862,4395,4409
14,8904,10,100,0.001,0.01,0.854,4449,4455
14,9004,10,100,0.001,0.01,0.842,4502,4502
14,9104,10,100,0.001,0.01,0.868,4551,4553
14,9204,10,100,0.001,0.01,0.874,4602,4602
14,9304,10,100,0.001,0.01,0.868,4649,4655
14,9404,10,100,0.001,0.01,0.876,4703,4701
14,9504,10,100,0.001,0.01,0.884,4754,4750
14,9604,10,100,0.001,0.01,0.862,4806,4798
14,9704,10,100,0.001,0.01,0.884,4858,4846
14,9804,10,100,0.001,0.01,0.876,4896,4908
14,9904,10,100,0.001,0.01,0.892,4951,4953
14,10004,10,100,0.001,0.01,0.87,5004,5000
14,10104,10,100,0.001,0.01,0.908,5050,5054
14,10204,10,100,0.001,0.01,0.874,5089,5115
14,10304,10,100,0.001,0.01,0.894,5137,5167
14,10404,10,100,0.001,0.01,0.906,5189,5215
14,10504,10,100,0.001,0.01,0.914,5235,5269
14,10604,10,100,0.001,0.01,0.878,5288,5316
14,10704,10,100,0.001,0.01,0.852,5346,5358
14,10804,10,100,0.001,0.01,0.882,5390,5414
14,10904,10,100,0.001,0.01,0.896,5435,5469
14,11004,10,100,0.001,0.01,0.898,5482,5522
14,11104,10,100,0.001,0.01,0.896,5541,5563
14,11204,10,100,0.001,0.01,0.902,5591,5613
14,11304,10,100,0.001,0.01,0.91,5631,5673
14,11404,10,100,0.001,0.01,0.902,5683,5721
14,11504,10,100,0.001,0.01,0.918,5734,5770
14,11604,10,100,0.001,0.01,0.924,5777,5827
14,11704,10,100,0.001,0.01,0.92,5829,5875
14,11804,10,100,0.001,0.01,0.902,5868,5936
14,11904,10,100,0.001,0.01,0.922,5920,5984
14,12004,10,100,0.001,0.01,0.912,5972,6032
14,12104,10,100,0.001,0.01,0.902,6026,6078
14,12204,10,100,0.001,0.01,0.924,6077,6127
14,12304,10,100,0.001,0.01,0.932,6132,6172
14,12404,10,100,0.001,0.01,0.928,6189,6215
14,12504,10,100,0.001,0.01,0.912,6243,6261
14,12604,10,100,0.001,0.01,0.896,6289,6315
14,12704,10,100,0.001,0.01,0.93,6338,6366
14,12804,10,100,0.001,0.01,0.928,6389,6415
14,12904,10,100,0.001,0.01,0.932,6436,6468
14,13004,10,100,0.001,0.01,0.938,6485,6519
14,13104,10,100,0.001,0.01,0.92,6545,6559
14,13204,10,100,0.001,0.01,0.922,6601,6603
14,13304,10,100,0.001,0.01,0.932,6649,6655
14,13404,10,100,0.001,0.01,0.926,6700,6704
14,13504,10,100,0.001,0.01,0.944,6751,6753
14,13604,10,100,0.001,0.01,0.934,6805,6799
14,13704,10,100,0.001,0.01,0.95,6861,6843
14,13804,10,100,0.001,0.01,0.936,6903,6901
14,13904,10,100,0.001,0.01,0.93,6955,6949
14,14004,10,100,0.001,0.01,0.936,7004,7000
14,14104,10,100,0.001,0.01,0.942,7054,7050
14,14204,10,100,0.001,0.01,0.932,7106,7098
14,14304,10,100,0.001,0.01,0.922,7163,7141
14,14404,10,100,0.001,0.01,0.94,7213,7191
14,14504,10,100,0.001,0.01,0.946,7265,7239
14,14604,10,100,0.001,0.01,0.95,7311,7293
14,14704,10,100,0.001,0.01,0.96,7367,7337
14,14804,10,100,0.001,0.01,0.932,7414,7390
14,14904,10,100,0.001,0.01,0.95,7463,7441
14,15004,10,100,0.001,0.01,0.934,7518,7486
15,104,10,100,0.001,0.01,0.522,61,43
15,204,10,100,0.001,0.01,0.488,113,91
15,304,10,100,0.001,0.01,0.506,163,141
15,404,10,100,0.001,0.01,0.512,218,186
15,504,10,100,0.001,0.01,0.494,270,234
15,604,10,100,0.001,0.01,0.52,324,280
15,704,10,100,0.001,0.01,0.532,381,323
15,804,10,100,0.001,0.01,0.504,431,373
15,904,10,100,0.001,0.01,0.46,474,430
15,1004,10,100,0.001,0.01,0.49,524,480
15,1104,10,100,0.001,0.01,0.496,580,524
15,1204,10,100,0.001,0.01,0.52,619,585
15,1304,10,100,0.001,0.01,0.514,666,638
15,1404,10,100,0.001,0.01,0.534,718,686
15,1504,10,100,0.001,0.01,0.52,759,745
15,1604,10,100,0.001,0.01,0.498,813,791
15,1704,10,100,0.001,0.01,0.5,860,844
15,1804,10,100,0.001,0.01,0.514,909,895
15,1904,10,100,0.001,0.01,0.534,956,948
15,2004,10,100,0.001,0.01,0.512,997,1007
15,2104,10,100,0.001,0.01,0.516,1050,1054
15,2204,10,100,0.001,0.01,0.52,1104,1100
15,2304,10,100,0.001,0.01,0.524,1157,1147
15,2404,10,100,0.001,0.01,0.544,1213,1191
15,2504,10,100,0.001,0.01,0.53,1268,1236
15,2604,10,100,0.001,0.01,0.53,1318,1286
15,2704,10,100,0.001,0.01,0.512,1370,1334
15,2804,10,100,0.001,0.01,0.544,1418,1386
15,2904,10,100,0.001,0.01,0.542,1475,1429
15,3004,10,100,0.001,0.01,0.514,1533,1471
15,3104,10,100,0.001,0.01,0.51,1578,1526
15,3204,10,100,0.001,0.01,0.528,1622,1582
15,3304,10,100,0.001,0.01,0.53,1665,1639
15,3404,10,100,0.001,0.01,0.508,1714,1690
15,3504,10,100,0.001,0.01,0.558,1760,1744
15,3604,10,100,0.001,0.01,0.538,1816,1788
15,3704,10,100,0.001,0.01,0.572,1863,1841
15,3804,10,100,0.001,0.01,0.57,1906,1898
15,3904,10,100,0.001,0.01,0.564,1963,1941
15,4004,10,100,0.001,0.01,0.598,2014,1990
15,4104,10,100,0.001,0.01,0.564,2072,2032
15,4204,10,100,0.001,0.01,0.558,2131,2073
15,4304,10,100,0.001,0.01,0.572,2180,2124
15,4404,10,100,0.001,0.01,0.568,2230,2174
15,4504,10,100,0.001,0.01,0.614,2282,2222
15,4604,10,100,0.001,0.01,0.61,2330,2274
15,4704,10,100,0.001,0.01,0.63,2383,2321
15,4804,10,100,0.001,0.01,0.592,2440,2364
15,4904,10,100,0.001,0.01,0.632,2493,2411
15,5004,10,100,0.001,0.01,0.624,2532,2472
15,5104,10,100,0.001,0.01,0.648,2590,2514
15,5204,10,100,0.001,0.01,0.664,2632,2572
15,5304,10,100,0.001,0.01,0.694,2688,2616
15,5404,10,100,0.001,0.01,0.674,2738,2666
15,5504,10,100,0.001,0.01,0.654,2784,2720
15,5604,10,100,0.001,0.01,0.702,2828,2776
15,5704,10,100,0.001,0.01,0.674,2879,2825
15,5804,10,100,0.001,0.01,0.71,2936,2868
15,5904,10,100,0.001,0.01,0.706,2982,2922
15,6004,10,100,0.001,0.01,0.696,3038,2966
15,6104,10,100,0.001,0.01,0.71,3089,3015
15,6204,10,100,0.001,0.01,0.72,3141,3063
15,6304,10,100,0.001,0.01,0.72,3197,3107
15,6404,10,100,0.001,0.01,0.75,3250,3154
15,6504,10,100,0.001,0.01,0.746,3301,3203
15,6604,10,100,0.001,0.01,0.76,3353,3251
15,6704,10,100,0.001,0.01,0.732,3401,3303
15,6804,10,100,0.001,0.01,0.754,3455,3349
15,6904,10,100,0.001,0.01,0.766,3500,3404
15,7004,10,100,0.001,0.01,0.752,3558,3446
15,7104,10,100,0.001,0.01,0.754,3613,3491
15,7204,10,100,0.001,0.01,0.756,3660,3544
15,7304,10,100,0.001,0.01,0.762,3709,3595
15,7404,10,100,0.001,0.01,0.776,3763,3641
15,7504,10,100,0.001,0.01,0.788,3812,3692
15,7604,10,100,0.001,0.01,0.784,3862,3742
15,7704,10,100,0.001,0.01,0.804,3916,3788
15,7804,10,100,0.001,0.01,0.8,3965,3839
15,7904,10,100,0.001,0.01,0.814,4015,3889
15,8004,10,100,0.001,0.01,0.806,4055,3949
15,8104,10,100,0.001,0.01,0.81,4109,3995
15,8204,10,100,0.001,0.01,0.812,4161,4043
15,8304,10,100,0.001,0.01,0.804,4213,4091
15,8404,10,100,0.001,0.01,0.828,4267,4137
15,8504,10,100,0.001,0.01,0.836,4314,4190
15,8604,10,100,0.001,0.01,0.842,4351,4253
15,8704,10,100,0.001,0.01,0.844,4405,4299
15,8804,10,100,0.001,0.01,0.846,4447,4357
15,8904,10,100,0.001,0.01,0.852,4499,4405
15,9004,10,100,0.001,0.01,0.838,4543,4461
15,9104,10,100,0.001,0.01,0.852,4601,4503
15,9204,10,100,0.001,0.01,0.858,4649,4555
15,9304,10,100,0.001,0.01,0.886,4700,4604
15,9404,10,100,0.001,0.01,0.86,4750,4654
15,9504,10,100,0.001,0.01,0.89,4799,4705
15,9604,10,100,0.001,0.01,0.9,4846,4758
15,9704,10,100,0.001,0.01,0.892,4900,4804
15,9804,10,100,0.001,0.01,0.906,4955,4849
15,9904,10,100,0.001,0.01,0.878,4998,4906
15,10004,10,100,0.001,0.01,0.894,5046,4958
15,10104,10,100,0.001,0.01,0.892,5090,5014
15,10204,10,100,0.001,0.01,0.892,5136,5068
15,10304,10,100,0.001,0.01,0.912,5196,5108
15,10404,10,100,0.001,0.01,0.912,5239,5165
15,10504,10,100,0.001,0.01,0.918,5295,5209
15,10604,10,100,0.001,0.01,0.922,5342,5262
15,10704,10,100,0.001,0.01,0.922,5392,5312
15,10804,10,100,0.001,0.01,0.926,5446,5358
15,10904,10,100,0.001,0.01,0.926,5504,5400
15,11004,10,100,0.001,0.01,0.918,5553,5451
15,11104,10,100,0.001,0.01,0.92,5613,5491
15,11204,10,100,0.001,0.01,0.918,5659,5545
15,11304,10,100,0.001,0.01,0.86,5711,5593
15,11404,10,100,0.001,0.01,0.9,5762,5642
15,11504,10,100,0.001,0.01,0.918,5814,5690
15,11604,10,100,0.001,0.01,0.91,5862,5742
15,11704,10,100,0.001,0.01,0.924,5908,5796
15,11804,10,100,0.001,0.01,0.926,5943,5861
15,11904,10,100,0.001,0.01,0.938,5994,5910
15,12004,10,100,0.001,0.01,0.932,6047,5957
15,12104,10,100,0.001,0.01,0.946,6101,6003
15,12204,10,100,0.001,0.01,0.95,6158,6046
15,12304,10,100,0.001,0.01,0.946,6219,6085
15,12404,10,100,0.001,0.01,0.944,6264,6140
15,12504,10,100,0.001,0.01,0.93,6310,6194
15,12604,10,100,0.001,0.01,0.948,6363,6241
15,12704,10,100,0.001,0.01,0.944,6415,6289
15,12804,10,100,0.001,0.01,0.954,6462,6342
15,12904,10,100,0.001,0.01,0.952,6498,6406
15,13004,10,100,0.001,0.01,0.958,6543,6461
15,13104,10,100,0.001,0.01,0.952,6587,6517
15,13204,10,100,0.001,0.01,0.94,6638,6566
15,13304,10,100,0.001,0.01,0.948,6688,6616
15,13404,10,100,0.001,0.01,0.954,6740,6664
15,13504,10,100,0.001,0.01,0.964,6781,6723
15,13604,10,100,0.001,0.01,0.964,6828,6776
15,13704,10,100,0.001,0.01,0.966,6882,6822
15,13804,10,100,0.001,0.01,0.956,6931,6873
15,13904,10,100,0.001,0.01,0.966,6978,6926
15,14004,10,100,0.001,0.01,0.968,7022,6982
15,14104,10,100,0.001,0.01,0.976,7066,7038
15,14204,10,100,0.001,0.01,0.978,7114,7090
15,14304,10,100,0.001,0.01,0.98,7159,7145
15,14404,10,100,0.001,0.01,0.972,7207,7197
15,14504,10,100,0.001,0.01,0.972,7259,7245
15,14604,10,100,0.001,0.01,0.972,7320,7284
15,14704,10,100,0.001,0.01,0.962,7370,7334
15,14804,10,100,0.001,0.01,0.974,7433,7371
15,14904,10,100,0.001,0.01,0.966,7479,7425
15,15004,10,100,0.001,0.01,0.968,7524,7480
16,104,10,100,0.001,0.01,0.518,45,59
16,204,10,100,0.001,0.01,0.48,96,108
16,304,10,100,0.001,0.01,0.492,146,158
16,404,10,100,0.001,0.01,0.502,211,193
16,504,10,100,0.001,0.01,0.516,264,240
16,604,10,100,0.001,0.01,0.506,311,293
16,704,10,100,0.001,0.01,0.492,352,352
16,804,10,100,0.001,0.01,0.498,402,402
16,904,10,100,0.001,0.01,0.506,442,462
16,1004,10,100,0.001,0.01,0.498,491,513
16,1104,10,100,0.001,0.01,0.49,538,566
16,1204,10,100,0.001,0.01,0.494,580,624
16,1304,10,100,0.001,0.01,0.502,626,678
16,1404,10,100,0.001,0.01,0.5,686,718
16,1504,10,100,0.001,0.01,0.528,728,776
16,1604,10,100,0.001,0.01,0.54,775,829
16,1704,10,100,0.001,0.01,0.532,821,883
16,1804,10,100,0.001,0.01,0.522,863,941
16,1904,10,100,0.001,0.01,0.538,913,991
16,2004,10,100,0.001,0.01,0.562,965,1039
16,2104,10,100,0.001,0.01,0.568,1017,1087
16,2204,10,100,0.001,0.01,0.584,1071,1133
16,2304,10,100,0.001,0.01,0.596,1131,1173
16,2404,10,100,0.001,0.01,0.602,1184,1220
16,2504,10,100,0.001,0.01,0.586,1231,1273
16,2604,10,100,0.001,0.01,0.654,1281,1323
16,2704,10,100,0.001,0.01,0.704,1333,1371
16,2804,10,100,0.001,0.01,0.732,1381,1423
16,2904,10,100,0.001,0.01,0.73,1428,1476
16,3004,10,100,0.001,0.01,0.774,1485,1519
16,3104,10,100,0.001,0.01,0.8,1529,1575
16,3204,10,100,0.001,0.01,0.838,1586,1618
16,3304,10,100,0.001,0.01,0.858,1631,1673
16,3404,10,100,0.001,0.01,0.87,1688,1716
16,3504,10,100,0.001,0.01,0.872,1742,1762
16,3604,10,100,0.001,0.01,0.886,1785,1819
16,3704,10,100,0.001,0.01,0.882,1829,1875
16,3804,10,100,0.001,0.01,0.878,1880,1924
16,3904,10,100,0.001,0.01,0.882,1940,1964
16,4004,10,100,0.001,0.01,0.906,1996,2008
16,4104,10,100,0.001,0.01,0.904,2046,2058
16,4204,10,100,0.001,0.01,0.918,2104,2100
16,4304,10,100,0.001,0.01,0.908,2152,2152
16,4404,10,100,0.001,0.01,0.928,2195,2209
16,4504,10,100,0.001,0.01,0.928,2242,2262
16,4604,10,100,0.001,0.01,0.928,2284,2320
16,4704,10,100,0.001,0.01,0.932,2324,2380
16,4804,10,100,0.001,0.01,0.93,2377,2427
16,4904,10,100,0.001,0.01,0.924,2417,2487
16,5004,10,100,0.001,0.01,0.944,2464,2540
16,5104,10,100,0.001,0.01,0.942,2508,2596
16,5204,10,100,0.001,0.01,0.93,2556,2648
16,5304,10,100,0.001,0.01,0.894,2605,2699
16,5404,10,100,0.001,0.01,0.93,2655,2749
16,5504,10,100,0.001,0.01,0.952,2705,2799
16,5604,10,100,0.001,0.01,0.954,2752,2852
16,5704,10,100,0.001,0.01,0.954,2798,2906
16,5804,10,100,0.001,0.01,0.946,2845,2959
16,5904,10,100,0.001,0.01,0.946,2903,3001
16,6004,10,100,0.001,0.01,0.95,2953,3051
16,6104,10,100,0.001,0.01,0.95,3008,3096
16,6204,10,100,0.001,0.01,0.964,3060,3144
16,6304,10,100,0.001,0.01,0.954,3109,3195
16,6404,10,100,0.001,0.01,0.964,3159,3245
16,6504,10,100,0.001,0.01,0.96,3208,3296
16,6604,10,100,0.001,0.01,0.958,3258,3346
16,6704,10,100,0.001,0.01,0.956,3304,3400
16,6804,10,100,0.001,0.01,0.966,3359,3445
16,6904,10,100,0.001,0.01,0.95,3412,3492
16,7004,10,100,0.001,0.01,0.962,3464,3540
16,7104,10,100,0.001,0.01,0.956,3513,3591
16,7204,10,100,0.001,0.01,0.954,3570,3634
16,7304,10,100,0.001,0.01,0.96,3618,3686
16,7404,10,100,0.001,0.01,0.97,3668,3736
16,7504,10,100,0.001,0.01,0.946,3721,3783
16,7604,10,100,0.001,0.01,0.956,3770,3834
16,7704,10,100,0.001,0.01,0.96,3814,3890
16,7804,10,100,0.001,0.01,0.964,3865,3939
16,7904,10,100,0.001,0.01,0.96,3914,3990
16,8004,10,100,0.001,0.01,0.96,3962,4042
16,8104,10,100,0.001,0.01,0.968,4004,4100
16,8204,10,100,0.001,0.01,0.974,4056,4148
16,8304,10,100,0.001,0.01,0.97,4111,4193
16,8404,10,100,0.001,0.01,0.97,4163,4241
16,8504,10,100,0.001,0.01,0.95,4217,4287
16,8604,10,100,0.001,0.01,0.954,4267,4337
16,8704,10,100,0.001,0.01,0.968,4323,4381
16,8804,10,100,0.001,0.01,0.972,4379,4425
16,8904,10,100,0.001,0.01,0.972,4426,4478
16,9004,10,100,0.001,0.01,0.96,4474,4530
16,9104,10,100,0.001,0.01,0.972,4513,4591
16,9204,10,100,0.001,0.01,0.956,4566,4638
16,9304,10,100,0.001,0.01,0.954,4616,4688
16,9404,10,100,0.001,0.01,0.964,4674,4730
16,9504,10,100,0.001,0.01,0.978,4723,4781
16,9604,10,100,0.001,0.01,0.974,4776,4828
16,9704,10,100,0.001,0.01,0.974,4821,4883
16,9804,10,100,0.001,0.01,0.972,4880,4924
16,9904,10,100,0.001,0.01,0.98,4930,4974
16,10004,10,100,0.001,0.01,0.966,4976,5028
16,10104,10,100,0.001,0.01,0.95,5028,5076
16,10204,10,100,0.001,0.01,0.956,5079,5125
16,10304,10,100,0.001,0.01,0.968,5132,5172
16,10404,10,100,0.001,0.01,0.968,5175,5229
16,10504,10,100,0.001,0.01,0.972,5219,5285
16,10604,10,100,0.001,0.01,0.97,5263,5341
16,10704,10,100,0.001,0.01,0.966,5313,5391
16,10804,10,100,0.001,0.01,0.972,5363,5441
16,10904,10,100,0.001,0.01,0.976,5417,5487
16,11004,10,100,0.001,0.01,0.978,5468,5536
16,11104,10,100,0.001,0.01,0.978,5522,5582
16,11204,10,100,0.001,0.01,0.974,5575,5629
16,11304,10,100,0.001,0.01,0.974,5622,5682
16,11404,10,100,0.001,0.01,0.97,5663,5741
16,11504,10,100,0.001,0.01,0.966,5718,5786
16,11604,10,100,0.001,0.01,0.972,5766,5838
16,11704,10,100,0.001,0.01,0.97,5818,5886
16,11804,10,100,0.001,0.01,0.976,5872,5932
16,11904,10,100,0.001,0.01,0.982,5918,5986
16,12004,10,100,0.001,0.01,0.98,5974,6030
16,12104,10,100,0.001,0.01,0.974,6027,6077
16,12204,10,100,0.001,0.01,0.982,6069,6135
16,12304,10,100,0.001,0.01,0.974,6117,6187
16,12404,10,100,0.001,0.01,0.984,6160,6244
16,12504,10,100,0.001,0.01,0.986,6211,6293
16,12604,10,100,0.001,0.01,0.98,6257,6347
16,12704,10,100,0.001,0.01,0.976,6305,6399
16,12804,10,100,0.001,0.01,0.982,6345,6459
16,12904,10,100,0.001,0.01,0.98,6402,6502
16,13004,10,100,0.001,0.01,0.98,6453,6551
16,13104,10,100,0.001,0.01,0.978,6504,6600
16,13204,10,100,0.001,0.01,0.98,6556,6648
16,13304,10,100,0.001,0.01,0.986,6602,6702
16,13404,10,100,0.001,0.01,0.976,6653,6751
16,13504,10,100,0.001,0.01,0.978,6694,6810
16,13604,10,100,0.001,0.01,0.98,6756,6848
16,13704,10,100,0.001,0.01,0.986,6810,6894
16,13804,10,100,0.001,0.01,0.982,6862,6942
16,13904,10,100,0.001,0.01,0.986,6912,6992
16,14004,10,100,0.001,0.01,0.984,6959,7045
16,14104,10,100,0.001,0.01,0.978,7012,7092
16,14204,10,100,0.001,0.01,0.984,7064,7140
16,14304,10,100,0.001,0.01,0.982,7116,7188
16,14404,10,100,0.001,0.01,0.986,7168,7236
16,14504,10,100,0.001,0.01,0.982,7224,7280
16,14604,10,100,0.001,0.01,0.978,7277,7327
16,14704,10,100,0.001,0.01,0.982,7327,7377
16,14804,10,100,0.001,0.01,0.986,7378,7426
16,14904,10,100,0.001,0.01,0.984,7434,7470
16,15004,10,100,0.001,0.01,0.982,7494,7510
17,104,10,100,0.001,0.01,0.51,56,48
17,204,10,100,0.001,0.01,0.532,116,88
17,304,10,100,0.001,0.01,0.524,173,131
17,404,10,100,0.001,0.01,0.524,221,183
17,504,10,100,0.001,0.01,0.502,269,235
17,604,10,100,0.001,0.01,0.54,318,286
17,704,10,100,0.001,0.01,0.536,372,332
17,804,10,100,0.001,0.01,0.574,423,381
17,904,10,100,0.001,0.01,0.53,472,432
17,1004,10,100,0.001,0.01,0.524,526,478
17,1104,10,100,0.001,0.01,0.538,568,536
17,1204,10,100,0.001,0.01,0.53,616,588
17,1304,10,100,0.001,0.01,0.516,660,644
17,1404,10,100,0.001,0.01,0.53,708,696
17,1504,10,100,0.001,0.01,0.534,759,745
17,1604,10,100,0.001,0.01,0.516,810,794
17,1704,10,100,0.001,0.01,0.53,857,847
17,1804,10,100,0.001,0.01,0.54,915,889
17,1904,10,100,0.001,0.01,0.56,965,939
17,2004,10,100,0.001,0.01,0.532,1012,992
17,2104,10,100,0.001,0.01,0.534,1058,1046
17,2204,10,100,0.001,0.01,0.552,1114,1090
17,2304,10,100,0.001,0.01,0.558,1161,1143
17,2404,10,100,0.001,0.01,0.538,1218,1186
17,2504,10,100,0.001,0.01,0.536,1264,1240
17,2604,10,100,0.001,0.01,0.576,1310,1294
17,2704,10,100,0.001,0.01,0.566,1365,1339
17,2804,10,100,0.001,0.01,0.554,1413,1391
17,2904,10,100,0.001,0.01,0.57,1467,1437
17,3004,10,100,0.001,0.01,0.582,1519,1485
17,3104,10,100,0.001,0.01,0.608,1572,1532
17,3204,10,100,0.001,0.01,0.61,1617,1587
17,3304,10,100,0.001,0.01,0.61,1662,1642
17,3404,10,100,0.001,0.01,0.604,1712,1692
17,3504,10,100,0.001,0.01,0.568,1771,1733
17,3604,10,100,0.001,0.01,0.628,1822,1782
17,3704,10,100,0.001,0.01,0.622,1876,1828
17,3804,10,100,0.001,0.01,0.636,1924,1880
17,3904,10,100,0.001,0.01,0.624,1977,1927
17,4004,10,100,0.001,0.01,0.628,2026,1978
17,4104,10,100,0.001,0.01,0.62,2081,2023
17,4204,10,100,0.001,0.01,0.628,2131,2073
17,4304,10,100,0.001,0.01,0.64,2172,2132
17,4404,10,100,0.001,0.01,0.664,2220,2184
17,4504,10,100,0.001,0.01,0.664,2268,2236
17,4604,10,100,0.001,0.01,0.708,2317,2287
17,4704,10,100,0.001,0.01,0.7,2372,2332
17,4804,10,100,0.001,0.01,0.712,2412,2392
17,4904,10,100,0.001,0.01,0.732,2460,2444
17,5004,10,100,0.001,0.01,0.712,2503,2501
17,5104,10,100,0.001,0.01,0.722,2549,2555
17,5204,10,100,0.001,0.01,0.724,2598,2606
17,5304,10,100,0.001,0.01,0.728,2641,2663
17,5404,10,100,0.001,0.01,0.724,2683,2721
17,5504,10,100,0.001,0.01,0.708,2729,2775
17,5604,10,100,0.001,0.01,0.718,2784,2820
17,5704,10,100,0.001,0.01,0.746,2828,2876
17,5804,10,100,0.001,0.01,0.75,2877,2927
17,5904,10,100,0.001,0.01,0.754,2933,2971
17,6004,10,100,0.001,0.01,0.74,2981,3023
17,6104,10,100,0.001,0.01,0.732,3033,3071
17,6204,10,100,0.001,0.01,0.746,3089,3115
17,6304,10,100,0.001,0.01,0.728,3142,3162
17,6404,10,100,0.001,0.01,0.76,3194,3210
17,6504,10,100,0.001,0.01,0.762,3234,3270
17,6604,10,100,0.001,0.01,0.778,3290,3314
17,6704,10,100,0.001,0.01,0.768,3336,3368
17,6804,10,100,0.001,0.01,0.764,3387,3417
17,6904,10,100,0.001,0.01,0.77,3432,3472
17,7004,10,100,0.001,0.01,0.78,3468,3536
17,7104,10,100,0.001,0.01,0.766,3521,3583
17,7204,10,100,0.001,0.01,0.766,3579,3625
17,7304,10,100,0.001,0.01,0.774,3628,3676
17,7404,10,100,0.001,0.01,0.768,3680,3724
17,7504,10,100,0.001,0.01,0.778,3724,3780
17,7604,10,100,0.001,0.01,0.79,3774,3830
17,7704,10,100,0.001,0.01,0.786,3825,3879
17,7804,10,100,0.001,0.01,0.782,3882,3922
17,7904,10,100,0.001,0.01,0.782,3938,3966
17,8004,10,100,0.001,0.01,0.796,3981,4023
17,8104,10,100,0.001,0.01,0.796,4031,4073
17,8204,10,100,0.001,0.01,0.81,4083,4121
17,8304,10,100,0.001,0.01,0.766,4131,4173
17,8404,10,100,0.001,0.01,0.774,4179,4225
17,8504,10,100,0.001,0.01,0.802,4234,4270
17,8604,10,100,0.001,0.01,0.804,4279,4325
17,8704,10,100,0.001,0.01,0.826,4336,4368
17,8804,10,100,0.001,0.01,0.83,4389,4415
17,8904,10,100,0.001,0.01,0.802,4437,4467
17,9004,10,100,0.001,0.01,0.804,4490,4514
17,9104,10,100,0.001,0.01,0.83,4540,4564
17,9204,10,100,0.001,0.01,0.822,4594,4610
17,9304,10,100,0.001,0.01,0.81,4644,4660
17,9404,10,100,0.001,0.01,0.832,4705,4699
17,9504,10,100,0.001,0.01,0.812,4747,4757
17,9604,10,100,0.001,0.01,0.846,4792,4812
17,9704,10,100,0.001,0.01,0.84,4841,4863
17,9804,10,100,0.001,0.01,0.836,4894,4910
17,9904,10,100,0.001,0.01,0.854,4940,4964
17,10004,10,100,0.001,0.01,0.85,4997,5007
17,10104,10,100,0.001,0.01,0.85,5048,5056
17,10204,10,100,0.001,0.01,0.846,5098,5106
17,10304,10,100,0.001,0.01,0.834,5141,5163
17,10404,10,100,0.001,0.01,0.844,5190,5214
17,10504,10,100,0.001,0.01,0.816,5243,5261
17,10604,10,100,0.001,0.01,0.832,5297,5307
17,10704,10,100,0.001,0.01,0.844,5342,5362
17,10804,10,100,0.001,0.01,0.858,5393,5411
17,10904,10,100,0.001,0.01,0.858,5437,5467
17,11004,10,100,0.001,0.01,0.854,5490,5514
17,11104,10,100,0.001,0.01,0.872,5541,5563
17,11204,10,100,0.001,0.01,0.876,5594,5610
17,11304,10,100,0.001,0.01,0.866,5651,5653
17,11404,10,100,0.001,0.01,0.854,5702,5702
17,11504,10,100,0.001,0.01,0.858,5748,5756
17,11604,10,100,0.001,0.01,0.864,5804,5800
17,11704,10,100,0.001,0.01,0.86,5854,5850
17,11804,10,100,0.001,0.01,0.864,5897,5907
17,11904,10,100,0.001,0.01,0.87,5946,5958
17,12004,10,100,0.001,0.01,0.874,5997,6007
17,12104,10,100,0.001,0.01,0.87,6044,6060
17,12204,10,100,0.001,0.01,0.878,6100,6104
17,12304,10,100,0.001,0.01,0.884,6145,6159
17,12404,10,100,0.001,0.01,0.884,6199,6205
17,12504,10,100,0.001,0.01,0.876,6253,6251
17,12604,10,100,0.001,0.01,0.864,6310,6294
17,12704,10,100,0.001,0.01,0.884,6364,6340
17,12804,10,100,0.001,0.01,0.894,6413,6391
17,12904,10,100,0.001,0.01,0.872,6463,6441
17,13004,10,100,0.001,0.01,0.89,6518,6486
17,13104,10,100,0.001,0.01,0.908,6568,6536
17,13204,10,100,0.001,0.01,0.892,6613,6591
17,13304,10,100,0.001,0.01,0.906,6662,6642
17,13404,10,100,0.001,0.01,0.892,6710,6694
17,13504,10,100,0.001,0.01,0.904,6761,6743
17,13604,10,100,0.001,0.01,0.894,6804,6800
17,13704,10,100,0.001,0.01,0.886,6855,6849
17,13804,10,100,0.001,0.01,0.922,6903,6901
17,13904,10,100,0.001,0.01,0.916,6950,6954
17,14004,10,100,0.001,0.01,0.908,6999,7005
17,14104,10,100,0.001,0.01,0.904,7046,7058
17,14204,10,100,0.001,0.01,0.924,7095,7109
17,14304,10,100,0.001,0.01,0.91,7141,7163
17,14404,10,100,0.001,0.01,0.924,7190,7214
17,14504,10,100,0.001,0.01,0.93,7242,7262
17,14604,10,100,0.001,0.01,0.918,7296,7308
17,14704,10,100,0.001,0.01,0.912,7347,7357
17,14804,10,100,0.001,0.01,0.918,7390,7414
17,14904,10,100,0.001,0.01,0.918,7443,7461
17,15004,10,100,0.001,0.01,0.928,7497,7507
18,104,10,100,0.001,0.01,0.492,45,59
18,204,10,100,0.001,0.01,0.526,96,108
18,304,10,100,0.001,0.01,0.518,138,166
18,404,10,100,0.001,0.01,0.49,191,213
18,504,10,100,0.001,0.01,0.534,242,262
18,604,10,100,0.001,0.01,0.524,295,309
18,704,10,100,0.001,0.01,0.524,348,356
18,804,10,100,0.001,0.01,0.504,399,405
18,904,10,100,0.001,0.01,0.498,450,454
18,1004,10,100,0.001,0.01,0.486,495,509
18,1104,10,100,0.001,0.01,0.536,547,557
18,1204,10,100,0.001,0.01,0.53,591,613
18,1304,10,100,0.001,0.01,0.524,631,673
18,1404,10,100,0.001,0.01,0.518,683,721
18,1504,10,100,0.001,0.01,0.534,728,776
18,1604,10,100,0.001,0.01,0.55,783,821
18,1704,10,100,0.001,0.01,0.574,835,869
18,1804,10,100,0.001,0.01,0.576,881,923
18,1904,10,100,0.001,0.01,0.604,924,980
18,2004,10,100,0.001,0.01,0.642,971,1033
18,2104,10,100,0.001,0.01,0.646,1024,1080
18,2204,10,100,0.001,0.01,0.694,1084,1120
18,2304,10,100,0.001,0.01,0.708,1135,1169
18,2404,10,100,0.001,0.01,0.768,1185,1219
18,2504,10,100,0.001,0.01,0.742,1233,1271
18,2604,10,100,0.001,0.01,0.766,1286,1318
18,2704,10,100,0.001,0.01,0.732,1342,1362
18,2804,10,100,0.001,0.01,0.75,1384,1420
18,2904,10,100,0.001,0.01,0.73,1442,1462
18,3004,10,100,0.001,0.01,0.76,1488,1516
18,3104,10,100,0.001,0.01,0.74,1539,1565
18,3204,10,100,0.001,0.01,0.764,1593,1611
18,3304,10,100,0.001,0.01,0.794,1651,1653
18,3404,10,100,0.001,0.01,0.808,1711,1693
18,3504,10,100,0.001,0.01,0.792,1757,1747
18,3604,10,100,0.001,0.01,0.802,1808,1796
18,3704,10,100,0.001,0.01,0.816,1864,1840
18,3804,10,100,0.001,0.01,0.788,1917,1887
18,3904,10,100,0.001,0.01,0.824,1964,1940
18,4004,10,100,0.001,0.01,0.776,2008,1996
18,4104,10,100,0.001,0.01,0.794,2052,2052
18,4204,10,100,0.001,0.01,0.832,2099,2105
18,4304,10,100,0.001,0.01,0.82,2161,2143
18,4404,10,100,0.001,0.01,0.86,2214,2190
18,4504,10,100,0.001,0.01,0.852,2253,2251
18,4604,10,100,0.001,0.01,0.826,2301,2303
18,4704,10,100,0.001,0.01,0.8,2364,2340
18,4804,10,100,0.001,0.01,0.844,2409,2395
18,4904,10,100,0.001,0.01,0.856,2456,2448
18,5004,10,100,0.001,0.01,0.86,2503,2501
18,5104,10,100,0.001,0.01,0.876,2565,2539
18,5204,10,100,0.001,0.01,0.876,2615,2589
18,5304,10,100,0.001,0.01,0.864,2671,2633
18,5404,10,100,0.001,0.01,0.87,2725,2679
18,5504,10,100,0.001,0.01,0.888,2773,2731
18,5604,10,100,0.001,0.01,0.868,2831,2773
18,5704,10,100,0.001,0.01,0.844,2882,2822
18,5804,10,100,0.001,0.01,0.888,2927,2877
18,5904,10,100,0.001,0.01,0.898,2977,2927
18,6004,10,100,0.001,0.01,0.872,3023,2981
18,6104,10,100,0.001,0.01,0.874,3073,3031
18,6204,10,100,0.001,0.01,0.898,3121,3083
18,6304,10,100,0.001,0.01,0.882,3167,3137
18,6404,10,100,0.001,0.01,0.904,3227,3177
18,6504,10,100,0.001,0.01,0.894,3281,3223
18,6604,10,100,0.001,0.01,0.888,3334,3270
18,6704,10,100,0.001,0.01,0.894,3388,3316
18,6804,10,100,0.001,0.01,0.9,3433,3371
18,6904,10,100,0.001,0.01,0.888,3480,3424
18,7004,10,100,0.001,0.01,0.904,3526,3478
18,7104,10,100,0.001,0.01,0.892,3572,3532
18,7204,10,100,0.001,0.01,0.846,3629,3575
18,7304,10,100,0.001,0.01,0.84,3676,3628
18,7404,10,100,0.001,0.01,0.874,3721,3683
18,7504,10,100,0.001,0.01,0.89,3775,3729
18,7604,10,100,0.001,0.01,0.882,3829,3775
18,7704,10,100,0.001,0.01,0.904,3870,3834
18,7804,10,100,0.001,0.01,0.89,3917,3887
18,7904,10,100,0.001,0.01,0.906,3972,3932
18,8004,10,100,0.001,0.01,0.908,4025,3979
18,8104,10,100,0.001,0.01,0.906,4078,4026
18,8204,10,100,0.001,0.01,0.926,4134,4070
18,8304,10,100,0.001,0.01,0.92,4188,4116
18,8404,10,100,0.001,0.01,0.914,4240,4164
18,8504,10,100,0.001,0.01,0.924,4293,4211
18,8604,10,100,0.001,0.01,0.928,4347,4257
18,8704,10,100,0.001,0.01,0.92,4386,4318
18,8804,10,100,0.001,0.01,0.924,4443,4361
18,8904,10,100,0.001,0.01,0.916,4488,4416
18,9004,10,100,0.001,0.01,0.912,4538,4466
18,9104,10,100,0.001,0.01,0.9,4581,4523
18,9204,10,100,0.001,0.01,0.92,4622,4582
18,9304,10,100,0.001,0.01,0.928,4680,4624
18,9404,10,100,0.001,0.01,0.914,4733,4671
18,9504,10,100,0.001,0.01,0.922,4785,4719
18,9604,10,100,0.001,0.01,0.908,4832,4772
18,9704,10,100,0.001,0.01,0.916,4887,4817
18,9804,10,100,0.001,0.01,0.926,4935,4869
18,9904,10,100,0.001,0.01,0.926,4985,4919
18,10004,10,100,0.001,0.01,0.926,5031,4973
18,10104,10,100,0.001,0.01,0.938,5084,5020
18,10204,10,100,0.001,0.01,0.93,5140,5064
18,10304,10,100,0.001,0.01,0.924,5190,5114
18,10404,10,100,0.001,0.01,0.94,5237,5167
18,10504,10,100,0.001,0.01,0.936,5287,5217
18,10604,10,100,0.001,0.01,0.938,5333,5271
18,10704,10,100,0.001,0.01,0.936,5386,5318
18,10804,10,100,0.001,0.01,0.93,5436,5368
18,10904,10,100,0.001,0.01,0.948,5484,5420
18,11004,10,100,0.001,0.01,0.926,5537,5467
18,11104,10,100,0.001,0.01,0.938,5583,5521
18,11204,10,100,0.001,0.01,0.932,5625,5579
18,11304,10,100,0.001,0.01,0.934,5673,5631
18,11404,10,100,0.001,0.01,0.94,5724,5680
18,11504,10,100,0.001,0.01,0.916,5775,5729
18,11604,10,100,0.001,0.01,0.942,5822,5782
18,11704,10,100,0.001,0.01,0.948,5863,5841
18,11804,10,100,0.001,0.01,0.942,5904,5900
18,11904,10,100,0.001,0.01,0.948,5952,5952
18,12004,10,100,0.001,0.01,0.942,5994,6010
18,12104,10,100,0.001,0.01,0.946,6043,6061
18,12204,10,100,0.001,0.01,0.946,6085,6119
18,12304,10,100,0.001,0.01,0.96,6139,6165
18,12404,10,100,0.001,0.01,0.96,6191,6213
18,12504,10,100,0.001,0.01,0.95,6240,6264
18,12604,10,100,0.001,0.01,0.958,6287,6317
18,12704,10,100,0.001,0.01,0.952,6335,6369
18,12804,10,100,0.001,0.01,0.95,6392,6412
18,12904,10,100,0.001,0.01,0.956,6439,6465
18,13004,10,100,0.001,0.01,0.932,6492,6512
18,13104,10,100,0.001,0.01,0.958,6539,6565
18,13204,10,100,0.001,0.01,0.95,6597,6607
18,13304,10,100,0.001,0.01,0.952,6647,6657
18,13404,10,100,0.001,0.01,0.956,6691,6713
18,13504,10,100,0.001,0.01,0.95,6750,6754
18,13604,10,100,0.001,0.01,0.952,6798,6806
18,13704,10,100,0.001,0.01,0.942,6856,6848
18,13804,10,100,0.001,0.01,0.954,6906,6898
18,13904,10,100,0.001,0.01,0.958,6946,6958
18,14004,10,100,0.001,0.01,0.942,7005,6999
18,14104,10,100,0.001,0.01,0.964,7052,7052
18,14204,10,100,0.001,0.01,0.96,7096,7108
18,14304,10,100,0.001,0.01,0.95,7143,7161
18,14404,10,100,0.001,0.01,0.954,7193,7211
18,14504,10,100,0.001,0.01,0.95,7256,7248
18,14604,10,100,0.001,0.01,0.962,7310,7294
18,14704,10,100,0.001,0.01,0.938,7355,7349
18,14804,10,100,0.001,0.01,0.954,7401,7403
18,14904,10,100,0.001,0.01,0.962,7449,7455
18,15004,10,100,0.001,0.01,0.966,7506,7498
19,104,10,100,0.001,0.01,0.478,52,52
19,204,10,100,0.001,0.01,0.492,104,100
19,304,10,100,0.001,0.01,0.516,160,144
19,404,10,100,0.001,0.01,0.478,207,197
19,504,10,100,0.001,0.01,0.456,257,247
19,604,10,100,0.001,0.01,0.476,303,301
19,704,10,100,0.001,0.01,0.47,357,347
19,804,10,100,0.001,0.01,0.508,401,403
19,904,10,100,0.001,0.01,0.474,449,455
19,1004,10,100,0.001,0.01,0.464,500,504
19,1104,10,100,0.001,0.01,0.472,547,557
19,1204,10,100,0.001,0.01,0.464,605,599
19,1304,10,100,0.001,0.01,0.484,665,639
19,1404,10,100,0.001,0.01,0.446,714,690
19,1504,10,100,0.001,0.01,0.492,770,734
19,1604,10,100,0.001,0.01,0.526,810,794
19,1704,10,100,0.001,0.01,0.48,866,838
19,1804,10,100,0.001,0.01,0.494,917,887
19,1904,10,100,0.001,0.01,0.484,962,942
19,2004,10,100,0.001,0.01,0.488,1010,994
19,2104,10,100,0.001,0.01,0.496,1068,1036
19,2204,10,100,0.001,0.01,0.51,1116,1088
19,2304,10,100,0.001,0.01,0.548,1167,1137
19,2404,10,100,0.001,0.01,0.552,1213,1191
19,2504,10,100,0.001,0.01,0.582,1252,1252
19,2604,10,100,0.001,0.01,0.56,1303,1301
19,2704,10,100,0.001,0.01,0.572,1352,1352
19,2804,10,100,0.001,0.01,0.588,1405,1399
19,2904,10,100,0.001,0.01,0.586,1448,1456
19,3004,10,100,0.001,0.01,0.616,1497,1507
19,3104,10,100,0.001,0.01,0.626,1538,1566
19,3204,10,100,0.001,0.01,0.628,1591,1613
19,3304,10,100,0.001,0.01,0.628,1639,1665
19,3404,10,100,0.001,0.01,0.652,1677,1727
19,3504,10,100,0.001,0.01,0.636,1726,1778
19,3604,10,100,0.001,0.01,0.698,1778,1826
19,3704,10,100,0.001,0.01,0.686,1830,1874
19,3804,10,100,0.001,0.01,0.694,1883,1921
19,3904,10,100,0.001,0.01,0.704,1930,1974
19,4004,10,100,0.001,0.01,0.708,1979,2025
19,4104,10,100,0.001,0.01,0.7,2025,2079
19,4204,10,100,0.001,0.01,0.726,2075,2129
19,4304,10,100,0.001,0.01,0.736,2119,2185
19,4404,10,100,0.001,0.01,0.726,2164,2240
19,4504,10,100,0.001,0.01,0.726,2221,2283
19,4604,10,100,0.001,0.01,0.76,2268,2336
19,4704,10,100,0.001,0.01,0.726,2316,2388
19,4804,10,100,0.001,0.01,0.748,2371,2433
19,4904,10,100,0.001,0.01,0.704,2422,2482
19,5004,10,100,0.001,0.01,0.722,2468,2536
19,5104,10,100,0.001,0.01,0.768,2515,2589
19,5204,10,100,0.001,0.01,0.774,2566,2638
19,5304,10,100,0.001,0.01,0.792,2613,2691
19,5404,10,100,0.001,0.01,0.768,2665,2739
19,5504,10,100,0.001,0.01,0.786,2731,2773
19,5604,10,100,0.001,0.01,0.814,2782,2822
19,5704,10,100,0.001,0.01,0.806,2833,2871
19,5804,10,100,0.001,0.01,0.82,2883,2921
19,5904,10,100,0.001,0.01,0.816,2918,2986
19,6004,10,100,0.001,0.01,0.83,2966,3038
19,6104,10,100,0.001,0.01,0.796,3016,3088
19,6204,10,100,0.001,0.01,0.828,3070,3134
19,6304,10,100,0.001,0.01,0.858,3122,3182
19,6404,10,100,0.001,0.01,0.856,3172,3232
19,6504,10,100,0.001,0.01,0.842,3222,3282
19,6604,10,100,0.001,0.01,0.854,3265,3339
19,6704,10,100,0.001,0.01,0.85,3322,3382
19,6804,10,100,0.001,0.01,0.852,3372,3432
19,6904,10,100,0.001,0.01,0.864,3425,3479
19,7004,10,100,0.001,0.01,0.85,3476,3528
19,7104,10,100,0.001,0.01,0.864,3538,3566
19,7204,10,100,0.001,0.01,0.896,3589,3615
19,7304,10,100,0.001,0.01,0.894,3642,3662
19,7404,10,100,0.001,0.01,0.894,3696,3708
19,7504,10,100,0.001,0.01,0.88,3740,3764
19,7604,10,100,0.001,0.01,0.896,3787,3817
19,7704,10,100,0.001,0.01,0.894,3843,3861
19,7804,10,100,0.001,0.01,0.898,3897,3907
19,7904,10,100,0.001,0.01,0.912,3957,3947
19,8004,10,100,0.001,0.01,0.908,4010,3994
19,8104,10,100,0.001,0.01,0.916,4064,4040
19,8204,10,100,0.001,0.01,0.89,4120,4084
19,8304,10,100,0.001,0.01,0.896,4172,4132
19,8404,10,100,0.001,0.01,0.924,4219,4185
19,8504,10,100,0.001,0.01,0.906,4278,4226
19,8604,10,100,0.001,0.01,0.926,4325,4279
19,8704,10,100,0.001,0.01,0.93,4376,4328
19,8804,10,100,0.001,0.01,0.934,4418,4386
19,8904,10,100,0.001,0.01,0.928,4460,4444
19,9004,10,100,0.001,0.01,0.928,4518,4486
19,9104,10,100,0.001,0.01,0.94,4565,4539
19,9204,10,100,0.001,0.01,0.916,4616,4588
19,9304,10,100,0.001,0.01,0.934,4663,4641
19,9404,10,100,0.001,0.01,0.93,4710,4694
19,9504,10,100,0.001,0.01,0.924,4767,4737
19,9604,10,100,0.001,0.01,0.942,4817,4787
19,9704,10,100,0.001,0.01,0.956,4865,4839
19,9804,10,100,0.001,0.01,0.946,4911,4893
19,9904,10,100,0.001,0.01,0.948,4951,4953
19,10004,10,100,0.001,0.01,0.952,5005,4999
19,10104,10,100,0.001,0.01,0.956,5048,5056
19,10204,10,100,0.001,0.01,0.95,5093,5111
19,10304,10,100,0.001,0.01,0.964,5144,5160
19,10404,10,100,0.001,0.01,0.944,5195,5209
19,10504,10,100,0.001,0.01,0.956,5249,5255
19,10604,10,100,0.001,0.01,0.942,5300,5304
19,10704,10,100,0.001,0.01,0.94,5343,5361
19,10804,10,100,0.001,0.01,0.952,5388,5416
19,10904,10,100,0.001,0.01,0.952,5445,5459
19,11004,10,100,0.001,0.01,0.952,5500,5504
19,11104,10,100,0.001,0.01,0.968,5547,5557
19,11204,10,100,0.001,0.01,0.966,5589,5615
19,11304,10,100,0.001,0.01,0.964,5641,5663
19,11404,10,100,0.001,0.01,0.958,5694,5710
19,11504,10,100,0.001,0.01,0.958,5744,5760
19,11604,10,100,0.001,0.01,0.97,5797,5807
19,11704,10,100,0.001,0.01,0.962,5847,5857
19,11804,10,100,0.001,0.01,0.976,5899,5905
19,11904,10,100,0.001,0.01,0.974,5946,5958
19,12004,10,100,0.001,0.01,0.968,6004,6000
19,12104,10,100,0.001,0.01,0.98,6042,6062
19,12204,10,100,0.001,0.01,0.972,6093,6111
19,12304,10,100,0.001,0.01,0.972,6132,6172
19,12404,10,100,0.001,0.01,0.978,6185,6219
19,12504,10,100,0.001,0.01,0.972,6234,6270
19,12604,10,100,0.001,0.01,0.98,6286,6318
19,12704,10,100,0.001,0.01,0.976,6333,6371
19,12804,10,100,0.001,0.01,0.978,6384,6420
19,12904,10,100,0.001,0.01,0.978,6429,6475
19,13004,10,100,0.001,0.01,0.958,6476,6528
19,13104,10,100,0.001,0.01,0.962,6523,6581
19,13204,10,100,0.001,0.01,0.976,6573,6631
19,13304,10,100,0.001,0.01,0.976,6626,6678
19,13404,10,100,0.001,0.01,0.982,6669,6735
19,13504,10,100,0.001,0.01,0.98,6717,6787
19,13604,10,100,0.001,0.01,0.976,6767,6837
19,13704,10,100,0.001,0.01,0.966,6821,6883
19,13804,10,100,0.001,0.01,0.976,6882,6922
19,13904,10,100,0.001,0.01,0.98,6932,6972
19,14004,10,100,0.001,0.01,0.98,6981,7023
19,14104,10,100,0.001,0.01,0.982,7031,7073
19,14204,10,100,0.001,0.01,0.988,7079,7125
19,14304,10,100,0.001,0.01,0.98,7126,7178
19,14404,10,100,0.001,0.01,0.986,7175,7229
19,14504,10,100,0.001,0.01,0.98,7228,7276
19,14604,10,100,0.001,0.01,0.99,7281,7323
19,14704,10,100,0.001,0.01,0.974,7336,7368
19,14804,10,100,0.001,0.01,0.972,7390,7414
19,14904,10,100,0.001,0.01,0.982,7437,7467
19,15004,10,100,0.001,0.01,0.974,7491,7513
20,104,10,100,0.001,0.01,0.528,49,55
20,204,10,100,0.001,0.01,0.472,93,111
20,304,10,100,0.001,0.01,0.534,134,170
20,404,10,100,0.001,0.01,0.522,178,226
20,504,10,100,0.001,0.01,0.514,227,277
20,604,10,100,0.001,0.01,0.492,271,333
20,704,10,100,0.001,0.01,0.512,319,385
20,804,10,100,0.001,0.01,0.506,362,442
20,904,10,100,0.001,0.01,0.492,413,491
20,1004,10,100,0.001,0.01,0.48,465,539
20,1104,10,100,0.001,0.01,0.5,516,588
20,1204,10,100,0.001,0.01,0.522,565,639
20,1304,10,100,0.001,0.01,0.504,618,686
20,1404,10,100,0.001,0.01,0.508,660,744
20,1504,10,100,0.001,0.01,0.49,707,797
20,1604,10,100,0.001,0.01,0.524,754,850
20,1704,10,100,0.001,0.01,0.546,812,892
20,1804,10,100,0.001,0.01,0.542,860,944
20,1904,10,100,0.001,0.01,0.522,907,997
20,2004,10,100,0.001,0.01,0.546,956,1048
20,2104,10,100,0.001,0.01,0.514,1002,1102
20,2204,10,100,0.001,0.01,0.524,1050,1154
20,2304,10,100,0.001,0.01,0.506,1093,1211
20,2404,10,100,0.001,0.01,0.506,1140,1264
20,2504,10,100,0.001,0.01,0.54,1186,1318
20,2604,10,100,0.001,0.01,0.512,1243,1361
20,2704,10,100,0.001,0.01,0.496,1293,1411
20,2804,10,100,0.001,0.01,0.5,1351,1453
20,2904,10,100,0.001,0.01,0.464,1399,1505
20,3004,10,100,0.001,0.01,0.506,1443,1561
20,3104,10,100,0.001,0.01,0.5,1492,1612
20,3204,10,100,0.001,0.01,0.524,1549,1655
20,3304,10,100,0.001,0.01,0.492,1598,1706
20,3404,10,100,0.001,0.01,0.498,1649,1755
20,3504,10,100,0.001,0.01,0.524,1704,1800
20,3604,10,100,0.001,0.01,0.504,1758,1846
20,3704,10,100,0.001,0.01,0.506,1819,1885
20,3804,10,100,0.001,0.01,0.5,1875,1929
20,3904,10,100,0.001,0.01,0.518,1922,1982
20,4004,10,100,0.001,0.01,0.51,1969,2035
20,4104,10,100,0.001,0.01,0.506,2009,2095
20,4204,10,100,0.001,0.01,0.494,2068,2136
20,4304,10,100,0.001,0.01,0.536,2114,2190
20,4404,10,100,0.001,0.01,0.514,2165,2239
20,4504,10,100,0.001,0.01,0.51,2214,2290
20,4604,10,100,0.001,0.01,0.528,2266,2338
20,4704,10,100,0.001,0.01,0.512,2324,2380
20,4804,10,100,0.001,0.01,0.53,2373,2431
20,4904,10,100,0.001,0.01,0.506,2421,2483
20,5004,10,100,0.001,0.01,0.526,2474,2530
20,5104,10,100,0.001,0.01,0.498,2520,2584
20,5204,10,100,0.001,0.01,0.524,2576,2628
20,5304,10,100,0.001,0.01,0.556,2629,2675
20,5404,10,100,0.001,0.01,0.522,2684,2720
20,5504,10,100,0.001,0.01,0.514,2735,2769
20,5604,10,100,0.001,0.01,0.552,2781,2823
20,5704,10,100,0.001,0.01,0.55,2828,2876
20,5804,10,100,0.001,0.01,0.548,2874,2930
20,5904,10,100,0.001,0.01,0.504,2926,2978
20,6004,10,100,0.001,0.01,0.53,2972,3032
20,6104,10,100,0.001,0.01,0.544,3021,3083
20,6204,10,100,0.001,0.01,0.55,3071,3133
20,6304,10,100,0.001,0.01,0.556,3125,3179
20,6404,10,100,0.001,0.01,0.566,3174,3230
20,6504,10,100,0.001,0.01,0.57,3224,3280
20,6604,10,100,0.001,0.01,0.58,3281,3323
20,6704,10,100,0.001,0.01,0.568,3337,3367
20,6804,10,100,0.001,0.01,0.57,3391,3413
20,6904,10,100,0.001,0.01,0.584,3439,3465
20,7004,10,100,0.001,0.01,0.578,3483,3521
20,7104,10,100,0.001,0.01,0.592,3537,3567
20,7204,10,100,0.001,0.01,0.576,3593,3611
20,7304,10,100,0.001,0.01,0.612,3646,3658
20,7404,10,100,0.001,0.01,0.606,3694,3710
20,7504,10,100,0.001,0.01,0.604,3743,3761
20,7604,10,100,0.001,0.01,0.602,3791,3813
20,7704,10,100,0.001,0.01,0.634,3842,3862
20,7804,10,100,0.001,0.01,0.614,3894,3910
20,7904,10,100,0.001,0.01,0.596,3942,3962
20,8004,10,100,0.001,0.01,0.632,3997,4007
20,8104,10,100,0.001,0.01,0.624,4049,4055
20,8204,10,100,0.001,0.01,0.626,4105,4099
20,8304,10,100,0.001,0.01,0.628,4157,4147
20,8404,10,100,0.001,0.01,0.618,4204,4200
20,8504,10,100,0.001,0.01,0.626,4250,4254
20,8604,10,100,0.001,0.01,0.628,4296,4308
20,8704,10,100,0.001,0.01,0.636,4350,4354
20,8804,10,100,0.001,0.01,0.638,4395,4409
20,8904,10,100,0.001,0.01,0.628,4452,4452
20,9004,10,100,0.001,0.01,0.646,4503,4501
20,9104,10,100,0.001,0.01,0.648,4552,4552
20,9204,10,100,0.001,0.01,0.656,4606,4598
20,9304,10,100,0.001,0.01,0.664,4656,4648
20,9404,10,100,0.001,0.01,0.678,4701,4703
20,9504,10,100,0.001,0.01,0.664,4754,4750
20,9604,10,100,0.001,0.01,0.68,4799,4805
20,9704,10,100,0.001,0.01,0.674,4851,4853
20,9804,10,100,0.001,0.01,0.68,4902,4902
20,9904,10,100,0.001,0.01,0.668,4953,4951
20,10004,10,100,0.001,0.01,0.692,4996,5008
20,10104,10,100,0.001,0.01,0.66,5046,5058
20,10204,10,100,0.001,0.01,0.678,5097,5107
20,10304,10,100,0.001,0.01,0.666,5148,5156
20,10404,10,100,0.001,0.01,0.662,5191,5213
20,10504,10,100,0.001,0.01,0.672,5248,5256
20,10604,10,100,0.001,0.01,0.682,5292,5312
20,10704,10,100,0.001,0.01,0.692,5342,5362
20,10804,10,100,0.001,0.01,0.702,5393,5411
20,10904,10,100,0.001,0.01,0.698,5434,5470
20,11004,10,100,0.001,0.01,0.708,5481,5523
20,11104,10,100,0.001,0.01,0.712,5523,5581
20,11204,10,100,0.001,0.01,0.702,5572,5632
20,11304,10,100,0.001,0.01,0.728,5621,5683
20,11404,10,100,0.001,0.01,0.702,5662,5742
20,11504,10,100,0.001,0.01,0.716,5714,5790
20,11604,10,100,0.001,0.01,0.704,5767,5837
20,11704,10,100,0.001,0.01,0.736,5814,5890
20,11804,10,100,0.001,0.01,0.716,5861,5943
20,11904,10,100,0.001,0.01,0.71,5911,5993
20,12004,10,100,0.001,0.01,0.742,5959,6045
20,12104,10,100,0.001,0.01,0.742,6011,6093
20,12204,10,100,0.001,0.01,0.734,6059,6145
20,12304,10,100,0.001,0.01,0.756,6117,6187
20,12404,10,100,0.001,0.01,0.73,6166,6238
20,12504,10,100,0.001,0.01,0.756,6221,6283
20,12604,10,100,0.001,0.01,0.754,6270,6334
20,12704,10,100,0.001,0.01,0.708,6321,6383
20,12804,10,100,0.001,0.01,0.752,6369,6435
20,12904,10,100,0.001,0.01,0.766,6418,6486
20,13004,10,100,0.001,0.01,0.764,6474,6530
20,13104,10,100,0.001,0.01,0.774,6518,6586
20,13204,10,100,0.001,0.01,0.748,6567,6637
20,13304,10,100,0.001,0.01,0.764,6620,6684
20,13404,10,100,0.001,0.01,0.758,6673,6731
20,13504,10,100,0.001,0.01,0.76,6733,6771
20,13604,10,100,0.001,0.01,0.756,6785,6819
20,13704,10,100,0.001,0.01,0.776,6837,6867
20,13804,10,100,0.001,0.01,0.79,6884,6920
20,13904,10,100,0.001,0.01,0.8,6939,6965
20,14004,10,100,0.001,0.01,0.772,6989,7015
20,14104,10,100,0.001,0.01,0.786,7041,7063
20,14204,10,100,0.001,0.01,0.806,7091,7113
20,14304,10,100,0.001,0.01,0.782,7145,7159
20,14404,10,100,0.001,0.01,0.802,7199,7205
20,14504,10,100,0.001,0.01,0.808,7254,7250
20,14604,10,100,0.001,0.01,0.808,7309,7295
20,14704,10,100,0.001,0.01,0.812,7358,7346
20,14804,10,100,0.001,0.01,0.796,7410,7394
20,14904,10,100,0.001,0.01,0.836,7462,7442
20,15004,10,100,0.001,0.01,0.824,7510,7494
