trial,train_size,embed_dim,hidden_dim,alpha,learning_rate,accuracy,batch_pos,batch_neg
1,0,2,0,1e-05,0.0001,0.5,0,0
1,104,2,0,1e-05,0.0001,0.5,44,60
1,204,2,0,1e-05,0.0001,0.5,96,108
1,304,2,0,1e-05,0.0001,0.5,145,159
1,404,2,0,1e-05,0.0001,0.5,190,214
1,504,2,0,1e-05,0.0001,0.5,245,259
1,604,2,0,1e-05,0.0001,0.5,297,307
1,704,2,0,1e-05,0.0001,0.5,344,360
1,804,2,0,1e-05,0.0001,0.5,397,407
1,904,2,0,1e-05,0.0001,0.5,451,453
1,1004,2,0,1e-05,0.0001,0.5,504,500
1,1104,2,0,1e-05,0.0001,0.5,541,563
1,1204,2,0,1e-05,0.0001,0.5,590,614
1,1304,2,0,1e-05,0.0001,0.5,633,671
1,1404,2,0,1e-05,0.0001,0.5,683,721
1,1504,2,0,1e-05,0.0001,0.5,738,766
1,1604,2,0,1e-05,0.0001,0.5,791,813
1,1704,2,0,1e-05,0.0001,0.5,847,857
1,1804,2,0,1e-05,0.0001,0.5,906,898
1,1904,2,0,1e-05,0.0001,0.5,952,952
2,0,2,0,1e-05,0.0001,0.5,0,0
2,104,2,0,1e-05,0.0001,0.5,50,54
2,204,2,0,1e-05,0.0001,0.5,97,107
2,304,2,0,1e-05,0.0001,0.5,152,152
2,404,2,0,1e-05,0.0001,0.5,201,203
2,504,2,0,1e-05,0.0001,0.5,240,264
2,604,2,0,1e-05,0.0001,0.5,300,304
2,704,2,0,1e-05,0.0001,0.5,349,355
2,804,2,0,1e-05,0.0001,0.5,399,405
2,904,2,0,1e-05,0.0001,0.5,456,448
2,1004,2,0,1e-05,0.0001,0.5,499,505
2,1104,2,0,1e-05,0.0001,0.5,548,556
2,1204,2,0,1e-05,0.0001,0.5,600,604
2,1304,2,0,1e-05,0.0001,0.5,654,650
2,1404,2,0,1e-05,0.0001,0.5,706,698
2,1504,2,0,1e-05,0.0001,0.5,762,742
2,1604,2,0,1e-05,0.0001,0.5,809,795
2,1704,2,0,1e-05,0.0001,0.5,864,840
2,1804,2,0,1e-05,0.0001,0.5,909,895
2,1904,2,0,1e-05,0.0001,0.5,952,952
3,0,2,0,1e-05,0.0001,0.5,0,0
3,104,2,0,1e-05,0.0001,0.5,49,55
3,204,2,0,1e-05,0.0001,0.5,102,102
3,304,2,0,1e-05,0.0001,0.5,153,151
3,404,2,0,1e-05,0.0001,0.5,201,203
3,504,2,0,1e-05,0.0001,0.5,252,252
3,604,2,0,1e-05,0.0001,0.5,296,308
3,704,2,0,1e-05,0.0001,0.5,345,359
3,804,2,0,1e-05,0.0001,0.5,389,415
3,904,2,0,1e-05,0.0001,0.5,436,468
3,1004,2,0,1e-05,0.0001,0.5,501,503
3,1104,2,0,1e-05,0.0001,0.5,546,558
3,1204,2,0,1e-05,0.0001,0.5,598,606
3,1304,2,0,1e-05,0.0001,0.5,645,659
3,1404,2,0,1e-05,0.0001,0.5,694,710
3,1504,2,0,1e-05,0.0001,0.5,748,756
3,1604,2,0,1e-05,0.0001,0.5,807,797
3,1704,2,0,1e-05,0.0001,0.5,856,848
3,1804,2,0,1e-05,0.0001,0.5,910,894
3,1904,2,0,1e-05,0.0001,0.5,952,952
4,0,2,0,1e-05,0.0001,0.496,0,0
4,104,2,0,1e-05,0.0001,0.496,54,50
4,204,2,0,1e-05,0.0001,0.496,110,94
4,304,2,0,1e-05,0.0001,0.496,159,145
4,404,2,0,1e-05,0.0001,0.496,213,191
4,504,2,0,1e-05,0.0001,0.496,272,232
4,604,2,0,1e-05,0.0001,0.496,326,278
4,704,2,0,1e-05,0.0001,0.496,375,329
4,804,2,0,1e-05,0.0001,0.496,417,387
4,904,2,0,1e-05,0.0001,0.496,456,448
4,1004,2,0,1e-05,0.0001,0.494,499,505
4,1104,2,0,1e-05,0.0001,0.494,545,559
4,1204,2,0,1e-05,0.0001,0.494,597,607
4,1304,2,0,1e-05,0.0001,0.492,642,662
4,1404,2,0,1e-05,0.0001,0.492,691,713
4,1504,2,0,1e-05,0.0001,0.492,746,758
4,1604,2,0,1e-05,0.0001,0.49,804,800
4,1704,2,0,1e-05,0.0001,0.49,857,847
4,1804,2,0,1e-05,0.0001,0.49,900,904
4,1904,2,0,1e-05,0.0001,0.49,952,952
5,0,2,0,1e-05,0.0001,0.5,0,0
5,104,2,0,1e-05,0.0001,0.5,52,52
5,204,2,0,1e-05,0.0001,0.5,104,100
5,304,2,0,1e-05,0.0001,0.5,150,154
5,404,2,0,1e-05,0.0001,0.5,202,202
5,504,2,0,1e-05,0.0001,0.5,258,246
5,604,2,0,1e-05,0.0001,0.5,300,304
5,704,2,0,1e-05,0.0001,0.5,348,356
5,804,2,0,1e-05,0.0001,0.5,396,408
5,904,2,0,1e-05,0.0001,0.5,446,458
5,1004,2,0,1e-05,0.0001,0.498,494,510
5,1104,2,0,1e-05,0.0001,0.498,543,561
5,1204,2,0,1e-05,0.0001,0.498,593,611
5,1304,2,0,1e-05,0.0001,0.498,648,656
5,1404,2,0,1e-05,0.0001,0.5,692,712
5,1504,2,0,1e-05,0.0001,0.5,751,753
5,1604,2,0,1e-05,0.0001,0.5,797,807
5,1704,2,0,1e-05,0.0001,0.498,851,853
5,1804,2,0,1e-05,0.0001,0.492,909,895
5,1904,2,0,1e-05,0.0001,0.492,952,952
6,0,2,0,1e-05,0.0001,0.5,0,0
6,104,2,0,1e-05,0.0001,0.5,63,41
6,204,2,0,1e-05,0.0001,0.5,114,90
6,304,2,0,1e-05,0.0001,0.5,154,150
6,404,2,0,1e-05,0.0001,0.5,199,205
6,504,2,0,1e-05,0.0001,0.5,251,253
6,604,2,0,1e-05,0.0001,0.5,310,294
6,704,2,0,1e-05,0.0001,0.5,355,349
6,804,2,0,1e-05,0.0001,0.5,410,394
6,904,2,0,1e-05,0.0001,0.5,448,456
6,1004,2,0,1e-05,0.0001,0.5,496,508
6,1104,2,0,1e-05,0.0001,0.5,546,558
6,1204,2,0,1e-05,0.0001,0.5,591,613
6,1304,2,0,1e-05,0.0001,0.5,642,662
6,1404,2,0,1e-05,0.0001,0.5,694,710
6,1504,2,0,1e-05,0.0001,0.5,742,762
6,1604,2,0,1e-05,0.0001,0.5,789,815
6,1704,2,0,1e-05,0.0001,0.5,842,862
6,1804,2,0,1e-05,0.0001,0.5,900,904
6,1904,2,0,1e-05,0.0001,0.5,952,952
7,0,2,0,1e-05,0.0001,0.5,0,0
7,104,2,0,1e-05,0.0001,0.5,41,63
7,204,2,0,1e-05,0.0001,0.5,93,111
7,304,2,0,1e-05,0.0001,0.5,134,170
7,404,2,0,1e-05,0.0001,0.5,183,221
7,504,2,0,1e-05,0.0001,0.5,235,269
7,604,2,0,1e-05,0.0001,0.5,288,316
7,704,2,0,1e-05,0.0001,0.5,334,370
7,804,2,0,1e-05,0.0001,0.5,387,417
7,904,2,0,1e-05,0.0001,0.5,442,462
7,1004,2,0,1e-05,0.0001,0.5,495,509
7,1104,2,0,1e-05,0.0001,0.5,544,560
7,1204,2,0,1e-05,0.0001,0.5,599,605
7,1304,2,0,1e-05,0.0001,0.5,654,650
7,1404,2,0,1e-05,0.0001,0.5,700,704
7,1504,2,0,1e-05,0.0001,0.5,754,750
7,1604,2,0,1e-05,0.0001,0.5,799,805
7,1704,2,0,1e-05,0.0001,0.5,854,850
7,1804,2,0,1e-05,0.0001,0.5,899,905
7,1904,2,0,1e-05,0.0001,0.5,952,952
8,0,2,0,1e-05,0.0001,0.5,0,0
8,104,2,0,1e-05,0.0001,0.5,51,53
8,204,2,0,1e-05,0.0001,0.5,97,107
8,304,2,0,1e-05,0.0001,0.5,147,157
8,404,2,0,1e-05,0.0001,0.5,198,206
8,504,2,0,1e-05,0.0001,0.5,241,263
8,604,2,0,1e-05,0.0001,0.5,290,314
8,704,2,0,1e-05,0.0001,0.5,350,354
8,804,2,0,1e-05,0.0001,0.5,398,406
8,904,2,0,1e-05,0.0001,0.5,449,455
8,1004,2,0,1e-05,0.0001,0.5,495,509
8,1104,2,0,1e-05,0.0001,0.5,540,564
8,1204,2,0,1e-05,0.0001,0.5,591,613
8,1304,2,0,1e-05,0.0001,0.5,638,666
8,1404,2,0,1e-05,0.0001,0.5,689,715
8,1504,2,0,1e-05,0.0001,0.5,739,765
8,1604,2,0,1e-05,0.0001,0.5,795,809
8,1704,2,0,1e-05,0.0001,0.5,850,854
8,1804,2,0,1e-05,0.0001,0.5,905,899
8,1904,2,0,1e-05,0.0001,0.5,952,952
9,0,2,0,1e-05,0.0001,0.5,0,0
9,104,2,0,1e-05,0.0001,0.5,53,51
9,204,2,0,1e-05,0.0001,0.5,105,99
9,304,2,0,1e-05,0.0001,0.5,157,147
9,404,2,0,1e-05,0.0001,0.5,211,193
9,504,2,0,1e-05,0.0001,0.5,271,233
9,604,2,0,1e-05,0.0001,0.5,318,286
9,704,2,0,1e-05,0.0001,0.5,377,327
9,804,2,0,1e-05,0.0001,0.5,421,383
9,904,2,0,1e-05,0.0001,0.5,475,429
9,1004,2,0,1e-05,0.0001,0.5,518,486
9,1104,2,0,1e-05,0.0001,0.5,572,532
9,1204,2,0,1e-05,0.0001,0.5,619,585
9,1304,2,0,1e-05,0.0001,0.5,669,635
9,1404,2,0,1e-05,0.0001,0.5,716,688
9,1504,2,0,1e-05,0.0001,0.5,768,736
9,1604,2,0,1e-05,0.0001,0.5,816,788
9,1704,2,0,1e-05,0.0001,0.5,860,844
9,1804,2,0,1e-05,0.0001,0.5,901,903
9,1904,2,0,1e-05,0.0001,0.5,952,952
10,0,2,0,1e-05,0.0001,0.522,0,0
10,104,2,0,1e-05,0.0001,0.522,55,49
10,204,2,0,1e-05,0.0001,0.522,114,90
10,304,2,0,1e-05,0.0001,0.522,156,148
10,404,2,0,1e-05,0.0001,0.522,197,207
10,504,2,0,1e-05,0.0001,0.52,246,258
10,604,2,0,1e-05,0.0001,0.516,297,307
10,704,2,0,1e-05,0.0001,0.52,344,360
10,804,2,0,1e-05,0.0001,0.522,395,409
10,904,2,0,1e-05,0.0001,0.522,442,462
10,1004,2,0,1e-05,0.0001,0.522,489,515
10,1104,2,0,1e-05,0.0001,0.522,531,573
10,1204,2,0,1e-05,0.0001,0.518,579,625
10,1304,2,0,1e-05,0.0001,0.504,632,672
10,1404,2,0,1e-05,0.0001,0.498,683,721
10,1504,2,0,1e-05,0.0001,0.488,738,766
10,1604,2,0,1e-05,0.0001,0.48,795,809
10,1704,2,0,1e-05,0.0001,0.482,853,851
10,1804,2,0,1e-05,0.0001,0.486,905,899
10,1904,2,0,1e-05,0.0001,0.486,952,952
11,0,2,0,1e-05,0.0001,0.508,0,0
11,104,2,0,1e-05,0.0001,0.508,48,56
11,204,2,0,1e-05,0.0001,0.508,92,112
11,304,2,0,1e-05,0.0001,0.508,145,159
11,404,2,0,1e-05,0.0001,0.506,199,205
11,504,2,0,1e-05,0.0001,0.506,252,252
11,604,2,0,1e-05,0.0001,0.508,302,302
11,704,2,0,1e-05,0.0001,0.51,357,347
11,804,2,0,1e-05,0.0001,0.508,403,401
11,904,2,0,1e-05,0.0001,0.51,458,446
11,1004,2,0,1e-05,0.0001,0.506,504,500
11,1104,2,0,1e-05,0.0001,0.504,551,553
11,1204,2,0,1e-05,0.0001,0.504,604,600
11,1304,2,0,1e-05,0.0001,0.504,659,645
11,1404,2,0,1e-05,0.0001,0.508,709,695
11,1504,2,0,1e-05,0.0001,0.51,759,745
11,1604,2,0,1e-05,0.0001,0.51,813,791
11,1704,2,0,1e-05,0.0001,0.51,863,841
11,1804,2,0,1e-05,0.0001,0.51,910,894
11,1904,2,0,1e-05,0.0001,0.512,952,952
12,0,2,0,1e-05,0.0001,0.5,0,0
12,104,2,0,1e-05,0.0001,0.5,56,48
12,204,2,0,1e-05,0.0001,0.5,106,98
12,304,2,0,1e-05,0.0001,0.5,158,146
12,404,2,0,1e-05,0.0001,0.5,214,190
12,504,2,0,1e-05,0.0001,0.5,256,248
12,604,2,0,1e-05,0.0001,0.5,311,293
12,704,2,0,1e-05,0.0001,0.5,360,344
12,804,2,0,1e-05,0.0001,0.5,405,399
12,904,2,0,1e-05,0.0001,0.5,454,450
12,1004,2,0,1e-05,0.0001,0.5,504,500
12,1104,2,0,1e-05,0.0001,0.5,557,547
12,1204,2,0,1e-05,0.0001,0.5,608,596
12,1304,2,0,1e-05,0.0001,0.5,654,650
12,1404,2,0,1e-05,0.0001,0.5,706,698
12,1504,2,0,1e-05,0.0001,0.5,754,750
12,1604,2,0,1e-05,0.0001,0.5,808,796
12,1704,2,0,1e-05,0.0001,0.5,856,848
12,1804,2,0,1e-05,0.0001,0.5,904,900
12,1904,2,0,1e-05,0.0001,0.5,952,952
13,0,2,0,1e-05,0.0001,0.5,0,0
13,104,2,0,1e-05,0.0001,0.5,59,45
13,204,2,0,1e-05,0.0001,0.5,104,100
13,304,2,0,1e-05,0.0001,0.5,157,147
13,404,2,0,1e-05,0.0001,0.5,201,203
13,504,2,0,1e-05,0.0001,0.5,249,255
13,604,2,0,1e-05,0.0001,0.5,296,308
13,704,2,0,1e-05,0.0001,0.5,355,349
13,804,2,0,1e-05,0.0001,0.5,400,404
13,904,2,0,1e-05,0.0001,0.5,452,452
13,1004,2,0,1e-05,0.0001,0.5,496,508
13,1104,2,0,1e-05,0.0001,0.5,545,559
13,1204,2,0,1e-05,0.0001,0.5,599,605
13,1304,2,0,1e-05,0.0001,0.5,649,655
13,1404,2,0,1e-05,0.0001,0.5,696,708
13,1504,2,0,1e-05,0.0001,0.5,739,765
13,1604,2,0,1e-05,0.0001,0.5,789,815
13,1704,2,0,1e-05,0.0001,0.5,840,864
13,1804,2,0,1e-05,0.0001,0.5,898,906
13,1904,2,0,1e-05,0.0001,0.5,952,952
14,0,2,0,1e-05,0.0001,0.5,0,0
14,104,2,0,1e-05,0.0001,0.5,51,53
14,204,2,0,1e-05,0.0001,0.5,103,101
14,304,2,0,1e-05,0.0001,0.5,154,150
14,404,2,0,1e-05,0.0001,0.5,206,198
14,504,2,0,1e-05,0.0001,0.5,261,243
14,604,2,0,1e-05,0.0001,0.5,307,297
14,704,2,0,1e-05,0.0001,0.5,357,347
14,804,2,0,1e-05,0.0001,0.5,404,400
14,904,2,0,1e-05,0.0001,0.5,455,449
14,1004,2,0,1e-05,0.0001,0.5,504,500
14,1104,2,0,1e-05,0.0001,0.5,559,545
14,1204,2,0,1e-05,0.0001,0.5,620,584
14,1304,2,0,1e-05,0.0001,0.5,668,636
14,1404,2,0,1e-05,0.0001,0.5,720,684
14,1504,2,0,1e-05,0.0001,0.5,770,734
14,1604,2,0,1e-05,0.0001,0.5,812,792
14,1704,2,0,1e-05,0.0001,0.5,864,840
14,1804,2,0,1e-05,0.0001,0.5,902,902
14,1904,2,0,1e-05,0.0001,0.5,952,952
15,0,2,0,1e-05,0.0001,0.5,0,0
15,104,2,0,1e-05,0.0001,0.5,44,60
15,204,2,0,1e-05,0.0001,0.5,90,114
15,304,2,0,1e-05,0.0001,0.5,146,158
15,404,2,0,1e-05,0.0001,0.5,192,212
15,504,2,0,1e-05,0.0001,0.5,242,262
15,604,2,0,1e-05,0.0001,0.5,290,314
15,704,2,0,1e-05,0.0001,0.5,334,370
15,804,2,0,1e-05,0.0001,0.5,391,413
15,904,2,0,1e-05,0.0001,0.5,437,467
15,1004,2,0,1e-05,0.0001,0.5,481,523
15,1104,2,0,1e-05,0.0001,0.5,529,575
15,1204,2,0,1e-05,0.0001,0.5,580,624
15,1304,2,0,1e-05,0.0001,0.5,632,672
15,1404,2,0,1e-05,0.0001,0.5,684,720
15,1504,2,0,1e-05,0.0001,0.5,742,762
15,1604,2,0,1e-05,0.0001,0.5,792,812
15,1704,2,0,1e-05,0.0001,0.5,849,855
15,1804,2,0,1e-05,0.0001,0.5,908,896
15,1904,2,0,1e-05,0.0001,0.5,952,952
16,0,2,0,1e-05,0.0001,0.5,0,0
16,104,2,0,1e-05,0.0001,0.5,47,57
16,204,2,0,1e-05,0.0001,0.5,95,109
16,304,2,0,1e-05,0.0001,0.5,153,151
16,404,2,0,1e-05,0.0001,0.5,209,195
16,504,2,0,1e-05,0.0001,0.5,264,240
16,604,2,0,1e-05,0.0001,0.5,318,286
16,704,2,0,1e-05,0.0001,0.5,370,334
16,804,2,0,1e-05,0.0001,0.5,420,384
16,904,2,0,1e-05,0.0001,0.5,468,436
16,1004,2,0,1e-05,0.0001,0.5,527,477
16,1104,2,0,1e-05,0.0001,0.5,574,530
16,1204,2,0,1e-05,0.0001,0.5,618,586
16,1304,2,0,1e-05,0.0001,0.5,666,638
16,1404,2,0,1e-05,0.0001,0.5,706,698
16,1504,2,0,1e-05,0.0001,0.5,747,757
16,1604,2,0,1e-05,0.0001,0.5,804,800
16,1704,2,0,1e-05,0.0001,0.5,856,848
16,1804,2,0,1e-05,0.0001,0.5,900,904
16,1904,2,0,1e-05,0.0001,0.5,952,952
17,0,2,0,1e-05,0.0001,0.5,0,0
17,104,2,0,1e-05,0.0001,0.5,49,55
17,204,2,0,1e-05,0.0001,0.5,100,104
17,304,2,0,1e-05,0.0001,0.5,156,148
17,404,2,0,1e-05,0.0001,0.5,208,196
17,504,2,0,1e-05,0.0001,0.5,260,244
17,604,2,0,1e-05,0.0001,0.5,303,301
17,704,2,0,1e-05,0.0001,0.5,360,344
17,804,2,0,1e-05,0.0001,0.5,408,396
17,904,2,0,1e-05,0.0001,0.5,468,436
17,1004,2,0,1e-05,0.0001,0.5,517,487
17,1104,2,0,1e-05,0.0001,0.5,564,540
17,1204,2,0,1e-05,0.0001,0.5,606,598
17,1304,2,0,1e-05,0.0001,0.5,665,639
17,1404,2,0,1e-05,0.0001,0.5,714,690
17,1504,2,0,1e-05,0.0001,0.5,769,735
17,1604,2,0,1e-05,0.0001,0.5,822,782
17,1704,2,0,1e-05,0.0001,0.5,864,840
17,1804,2,0,1e-05,0.0001,0.5,909,895
17,1904,2,0,1e-05,0.0001,0.5,952,952
18,0,2,0,1e-05,0.0001,0.5,0,0
18,104,2,0,1e-05,0.0001,0.5,60,44
18,204,2,0,1e-05,0.0001,0.5,114,90
18,304,2,0,1e-05,0.0001,0.5,172,132
18,404,2,0,1e-05,0.0001,0.5,223,181
18,504,2,0,1e-05,0.0001,0.5,278,226
18,604,2,0,1e-05,0.0001,0.5,322,282
18,704,2,0,1e-05,0.0001,0.5,374,330
18,804,2,0,1e-05,0.0001,0.5,429,375
18,904,2,0,1e-05,0.0001,0.5,476,428
18,1004,2,0,1e-05,0.0001,0.5,518,486
18,1104,2,0,1e-05,0.0001,0.5,565,539
18,1204,2,0,1e-05,0.0001,0.5,614,590
18,1304,2,0,1e-05,0.0001,0.5,668,636
18,1404,2,0,1e-05,0.0001,0.5,721,683
18,1504,2,0,1e-05,0.0001,0.5,764,740
18,1604,2,0,1e-05,0.0001,0.5,806,798
18,1704,2,0,1e-05,0.0001,0.5,860,844
18,1804,2,0,1e-05,0.0001,0.5,905,899
18,1904,2,0,1e-05,0.0001,0.5,952,952
19,0,2,0,1e-05,0.0001,0.5,0,0
19,104,2,0,1e-05,0.0001,0.5,44,60
19,204,2,0,1e-05,0.0001,0.5,97,107
19,304,2,0,1e-05,0.0001,0.5,146,158
19,404,2,0,1e-05,0.0001,0.5,190,214
19,504,2,0,1e-05,0.0001,0.5,243,261
19,604,2,0,1e-05,0.0001,0.5,293,311
19,704,2,0,1e-05,0.0001,0.5,348,356
19,804,2,0,1e-05,0.0001,0.5,410,394
19,904,2,0,1e-05,0.0001,0.5,465,439
19,1004,2,0,1e-05,0.0001,0.5,508,496
19,1104,2,0,1e-05,0.0001,0.5,554,550
19,1204,2,0,1e-05,0.0001,0.5,612,592
19,1304,2,0,1e-05,0.0001,0.5,662,642
19,1404,2,0,1e-05,0.0001,0.5,717,687
19,1504,2,0,1e-05,0.0001,0.5,763,741
19,1604,2,0,1e-05,0.0001,0.5,806,798
19,1704,2,0,1e-05,0.0001,0.5,854,850
19,1804,2,0,1e-05,0.0001,0.5,904,900
19,1904,2,0,1e-05,0.0001,0.5,952,952
20,0,2,0,1e-05,0.0001,0.5,0,0
20,104,2,0,1e-05,0.0001,0.5,49,55
20,204,2,0,1e-05,0.0001,0.5,106,98
20,304,2,0,1e-05,0.0001,0.5,148,156
20,404,2,0,1e-05,0.0001,0.5,195,209
20,504,2,0,1e-05,0.0001,0.5,248,256
20,604,2,0,1e-05,0.0001,0.5,297,307
20,704,2,0,1e-05,0.0001,0.5,349,355
20,804,2,0,1e-05,0.0001,0.5,397,407
20,904,2,0,1e-05,0.0001,0.5,452,452
20,1004,2,0,1e-05,0.0001,0.5,497,507
20,1104,2,0,1e-05,0.0001,0.5,540,564
20,1204,2,0,1e-05,0.0001,0.5,591,613
20,1304,2,0,1e-05,0.0001,0.5,640,664
20,1404,2,0,1e-05,0.0001,0.5,698,706
20,1504,2,0,1e-05,0.0001,0.5,748,756
20,1604,2,0,1e-05,0.0001,0.5,796,808
20,1704,2,0,1e-05,0.0001,0.5,843,861
20,1804,2,0,1e-05,0.0001,0.5,901,903
20,1904,2,0,1e-05,0.0001,0.5,952,952
1,0,2,0,1e-05,0.001,0.5,0,0
1,104,2,0,1e-05,0.001,0.5,51,53
1,204,2,0,1e-05,0.001,0.5,98,106
1,304,2,0,1e-05,0.001,0.5,143,161
1,404,2,0,1e-05,0.001,0.5,200,204
1,504,2,0,1e-05,0.001,0.5,241,263
1,604,2,0,1e-05,0.001,0.5,293,311
1,704,2,0,1e-05,0.001,0.5,346,358
1,804,2,0,1e-05,0.001,0.5,393,411
1,904,2,0,1e-05,0.001,0.5,443,461
1,1004,2,0,1e-05,0.001,0.5,501,503
1,1104,2,0,1e-05,0.001,0.5,554,550
1,1204,2,0,1e-05,0.001,0.5,596,608
1,1304,2,0,1e-05,0.001,0.5,646,658
1,1404,2,0,1e-05,0.001,0.5,698,706
1,1504,2,0,1e-05,0.001,0.5,747,757
1,1604,2,0,1e-05,0.001,0.5,801,803
1,1704,2,0,1e-05,0.001,0.5,851,853
1,1804,2,0,1e-05,0.001,0.5,895,909
1,1904,2,0,1e-05,0.001,0.5,952,952
2,0,2,0,1e-05,0.001,0.512,0,0
2,104,2,0,1e-05,0.001,0.512,51,53
2,204,2,0,1e-05,0.001,0.51,94,110
2,304,2,0,1e-05,0.001,0.51,143,161
2,404,2,0,1e-05,0.001,0.512,197,207
2,504,2,0,1e-05,0.001,0.51,249,255
2,604,2,0,1e-05,0.001,0.51,305,299
2,704,2,0,1e-05,0.001,0.518,361,343
2,804,2,0,1e-05,0.001,0.518,405,399
2,904,2,0,1e-05,0.001,0.52,446,458
2,1004,2,0,1e-05,0.001,0.522,503,501
2,1104,2,0,1e-05,0.001,0.524,560,544
2,1204,2,0,1e-05,0.001,0.522,613,591
2,1304,2,0,1e-05,0.001,0.51,659,645
2,1404,2,0,1e-05,0.001,0.514,714,690
2,1504,2,0,1e-05,0.001,0.502,766,738
2,1604,2,0,1e-05,0.001,0.514,813,791
2,1704,2,0,1e-05,0.001,0.508,863,841
2,1804,2,0,1e-05,0.001,0.508,907,897
2,1904,2,0,1e-05,0.001,0.502,952,952
3,0,2,0,1e-05,0.001,0.544,0,0
3,104,2,0,1e-05,0.001,0.542,54,50
3,204,2,0,1e-05,0.001,0.542,111,93
3,304,2,0,1e-05,0.001,0.55,165,139
3,404,2,0,1e-05,0.001,0.548,211,193
3,504,2,0,1e-05,0.001,0.552,261,243
3,604,2,0,1e-05,0.001,0.55,310,294
3,704,2,0,1e-05,0.001,0.534,360,344
3,804,2,0,1e-05,0.001,0.54,401,403
3,904,2,0,1e-05,0.001,0.53,443,461
3,1004,2,0,1e-05,0.001,0.536,492,512
3,1104,2,0,1e-05,0.001,0.546,542,562
3,1204,2,0,1e-05,0.001,0.542,590,614
3,1304,2,0,1e-05,0.001,0.544,646,658
3,1404,2,0,1e-05,0.001,0.54,702,702
3,1504,2,0,1e-05,0.001,0.542,743,761
3,1604,2,0,1e-05,0.001,0.538,792,812
3,1704,2,0,1e-05,0.001,0.532,845,859
3,1804,2,0,1e-05,0.001,0.524,898,906
3,1904,2,0,1e-05,0.001,0.528,952,952
4,0,2,0,1e-05,0.001,0.516,0,0
4,104,2,0,1e-05,0.001,0.516,59,45
4,204,2,0,1e-05,0.001,0.51,108,96
4,304,2,0,1e-05,0.001,0.514,162,142
4,404,2,0,1e-05,0.001,0.514,209,195
4,504,2,0,1e-05,0.001,0.514,255,249
4,604,2,0,1e-05,0.001,0.508,302,302
4,704,2,0,1e-05,0.001,0.502,353,351
4,804,2,0,1e-05,0.001,0.504,405,399
4,904,2,0,1e-05,0.001,0.498,453,451
4,1004,2,0,1e-05,0.001,0.508,502,502
4,1104,2,0,1e-05,0.001,0.51,546,558
4,1204,2,0,1e-05,0.001,0.5,594,610
4,1304,2,0,1e-05,0.001,0.496,645,659
4,1404,2,0,1e-05,0.001,0.502,687,717
4,1504,2,0,1e-05,0.001,0.51,737,767
4,1604,2,0,1e-05,0.001,0.502,779,825
4,1704,2,0,1e-05,0.001,0.508,840,864
4,1804,2,0,1e-05,0.001,0.486,897,907
4,1904,2,0,1e-05,0.001,0.484,952,952
5,0,2,0,1e-05,0.001,0.488,0,0
5,104,2,0,1e-05,0.001,0.488,50,54
5,204,2,0,1e-05,0.001,0.486,94,110
5,304,2,0,1e-05,0.001,0.484,141,163
5,404,2,0,1e-05,0.001,0.476,193,211
5,504,2,0,1e-05,0.001,0.476,240,264
5,604,2,0,1e-05,0.001,0.474,296,308
5,704,2,0,1e-05,0.001,0.464,341,363
5,804,2,0,1e-05,0.001,0.474,398,406
5,904,2,0,1e-05,0.001,0.474,454,450
5,1004,2,0,1e-05,0.001,0.474,507,497
5,1104,2,0,1e-05,0.001,0.482,560,544
5,1204,2,0,1e-05,0.001,0.48,611,593
5,1304,2,0,1e-05,0.001,0.458,665,639
5,1404,2,0,1e-05,0.001,0.456,702,702
5,1504,2,0,1e-05,0.001,0.454,751,753
5,1604,2,0,1e-05,0.001,0.472,802,802
5,1704,2,0,1e-05,0.001,0.48,851,853
5,1804,2,0,1e-05,0.001,0.474,899,905
5,1904,2,0,1e-05,0.001,0.472,952,952
6,0,2,0,1e-05,0.001,0.5,0,0
6,104,2,0,1e-05,0.001,0.5,49,55
6,204,2,0,1e-05,0.001,0.5,99,105
6,304,2,0,1e-05,0.001,0.494,149,155
6,404,2,0,1e-05,0.001,0.494,195,209
6,504,2,0,1e-05,0.001,0.492,248,256
6,604,2,0,1e-05,0.001,0.492,303,301
6,704,2,0,1e-05,0.001,0.488,350,354
6,804,2,0,1e-05,0.001,0.506,401,403
6,904,2,0,1e-05,0.001,0.458,446,458
6,1004,2,0,1e-05,0.001,0.516,503,501
6,1104,2,0,1e-05,0.001,0.51,549,555
6,1204,2,0,1e-05,0.001,0.512,601,603
6,1304,2,0,1e-05,0.001,0.486,651,653
6,1404,2,0,1e-05,0.001,0.5,701,703
6,1504,2,0,1e-05,0.001,0.502,748,756
6,1604,2,0,1e-05,0.001,0.458,803,801
6,1704,2,0,1e-05,0.001,0.478,847,857
6,1804,2,0,1e-05,0.001,0.552,906,898
6,1904,2,0,1e-05,0.001,0.436,952,952
7,0,2,0,1e-05,0.001,0.524,0,0
7,104,2,0,1e-05,0.001,0.524,50,54
7,204,2,0,1e-05,0.001,0.524,104,100
7,304,2,0,1e-05,0.001,0.524,152,152
7,404,2,0,1e-05,0.001,0.524,194,210
7,504,2,0,1e-05,0.001,0.526,245,259
7,604,2,0,1e-05,0.001,0.526,297,307
7,704,2,0,1e-05,0.001,0.526,349,355
7,804,2,0,1e-05,0.001,0.524,401,403
7,904,2,0,1e-05,0.001,0.528,453,451
7,1004,2,0,1e-05,0.001,0.528,500,504
7,1104,2,0,1e-05,0.001,0.528,556,548
7,1204,2,0,1e-05,0.001,0.524,610,594
7,1304,2,0,1e-05,0.001,0.524,662,642
7,1404,2,0,1e-05,0.001,0.526,710,694
7,1504,2,0,1e-05,0.001,0.524,759,745
7,1604,2,0,1e-05,0.001,0.524,810,794
7,1704,2,0,1e-05,0.001,0.522,859,845
7,1804,2,0,1e-05,0.001,0.528,901,903
7,1904,2,0,1e-05,0.001,0.526,952,952
8,0,2,0,1e-05,0.001,0.604,0,0
8,104,2,0,1e-05,0.001,0.604,48,56
8,204,2,0,1e-05,0.001,0.604,98,106
8,304,2,0,1e-05,0.001,0.604,150,154
8,404,2,0,1e-05,0.001,0.6,201,203
8,504,2,0,1e-05,0.001,0.598,252,252
8,604,2,0,1e-05,0.001,0.598,299,305
8,704,2,0,1e-05,0.001,0.6,350,354
8,804,2,0,1e-05,0.001,0.598,404,400
8,904,2,0,1e-05,0.001,0.596,453,451
8,1004,2,0,1e-05,0.001,0.604,505,499
8,1104,2,0,1e-05,0.001,0.608,558,546
8,1204,2,0,1e-05,0.001,0.61,608,596
8,1304,2,0,1e-05,0.001,0.608,658,646
8,1404,2,0,1e-05,0.001,0.61,713,691
8,1504,2,0,1e-05,0.001,0.602,759,745
8,1604,2,0,1e-05,0.001,0.606,798,806
8,1704,2,0,1e-05,0.001,0.604,849,855
8,1804,2,0,1e-05,0.001,0.604,899,905
8,1904,2,0,1e-05,0.001,0.604,952,952
9,0,2,0,1e-05,0.001,0.528,0,0
9,104,2,0,1e-05,0.001,0.528,53,51
9,204,2,0,1e-05,0.001,0.528,104,100
9,304,2,0,1e-05,0.001,0.528,149,155
9,404,2,0,1e-05,0.001,0.526,201,203
9,504,2,0,1e-05,0.001,0.528,247,257
9,604,2,0,1e-05,0.001,0.532,304,300
9,704,2,0,1e-05,0.001,0.53,363,341
9,804,2,0,1e-05,0.001,0.532,419,385
9,904,2,0,1e-05,0.001,0.526,471,433
9,1004,2,0,1e-05,0.001,0.526,520,484
9,1104,2,0,1e-05,0.001,0.528,567,537
9,1204,2,0,1e-05,0.001,0.528,610,594
9,1304,2,0,1e-05,0.001,0.524,659,645
9,1404,2,0,1e-05,0.001,0.522,705,699
9,1504,2,0,1e-05,0.001,0.522,751,753
9,1604,2,0,1e-05,0.001,0.522,798,806
9,1704,2,0,1e-05,0.001,0.522,851,853
9,1804,2,0,1e-05,0.001,0.524,903,901
9,1904,2,0,1e-05,0.001,0.524,952,952
10,0,2,0,1e-05,0.001,0.5,0,0
10,104,2,0,1e-05,0.001,0.5,52,52
10,204,2,0,1e-05,0.001,0.5,110,94
10,304,2,0,1e-05,0.001,0.5,162,142
10,404,2,0,1e-05,0.001,0.5,205,199
10,504,2,0,1e-05,0.001,0.5,259,245
10,604,2,0,1e-05,0.001,0.5,310,294
10,704,2,0,1e-05,0.001,0.5,360,344
10,804,2,0,1e-05,0.001,0.5,418,386
10,904,2,0,1e-05,0.001,0.5,467,437
10,1004,2,0,1e-05,0.001,0.502,516,488
10,1104,2,0,1e-05,0.001,0.51,556,548
10,1204,2,0,1e-05,0.001,0.52,608,596
10,1304,2,0,1e-05,0.001,0.508,661,643
10,1404,2,0,1e-05,0.001,0.518,707,697
10,1504,2,0,1e-05,0.001,0.496,760,744
10,1604,2,0,1e-05,0.001,0.496,807,797
10,1704,2,0,1e-05,0.001,0.49,853,851
10,1804,2,0,1e-05,0.001,0.492,901,903
10,1904,2,0,1e-05,0.001,0.488,952,952
11,0,2,0,1e-05,0.001,0.498,0,0
11,104,2,0,1e-05,0.001,0.498,57,47
11,204,2,0,1e-05,0.001,0.494,117,87
11,304,2,0,1e-05,0.001,0.492,167,137
11,404,2,0,1e-05,0.001,0.482,217,187
11,504,2,0,1e-05,0.001,0.482,272,232
11,604,2,0,1e-05,0.001,0.486,323,281
11,704,2,0,1e-05,0.001,0.488,372,332
11,804,2,0,1e-05,0.001,0.49,429,375
11,904,2,0,1e-05,0.001,0.484,474,430
11,1004,2,0,1e-05,0.001,0.476,525,479
11,1104,2,0,1e-05,0.001,0.468,567,537
11,1204,2,0,1e-05,0.001,0.474,620,584
11,1304,2,0,1e-05,0.001,0.462,668,636
11,1404,2,0,1e-05,0.001,0.458,719,685
11,1504,2,0,1e-05,0.001,0.46,773,731
11,1604,2,0,1e-05,0.001,0.474,817,787
11,1704,2,0,1e-05,0.001,0.476,857,847
11,1804,2,0,1e-05,0.001,0.484,902,902
11,1904,2,0,1e-05,0.001,0.484,952,952
12,0,2,0,1e-05,0.001,0.5,0,0
12,104,2,0,1e-05,0.001,0.5,56,48
12,204,2,0,1e-05,0.001,0.5,115,89
12,304,2,0,1e-05,0.001,0.5,161,143
12,404,2,0,1e-05,0.001,0.5,209,195
12,504,2,0,1e-05,0.001,0.5,252,252
12,604,2,0,1e-05,0.001,0.5,309,295
12,704,2,0,1e-05,0.001,0.5,349,355
12,804,2,0,1e-05,0.001,0.5,398,406
12,904,2,0,1e-05,0.001,0.5,445,459
12,1004,2,0,1e-05,0.001,0.5,494,510
12,1104,2,0,1e-05,0.001,0.5,539,565
12,1204,2,0,1e-05,0.001,0.5,587,617
12,1304,2,0,1e-05,0.001,0.5,646,658
12,1404,2,0,1e-05,0.001,0.498,700,704
12,1504,2,0,1e-05,0.001,0.494,750,754
12,1604,2,0,1e-05,0.001,0.494,801,803
12,1704,2,0,1e-05,0.001,0.5,844,860
12,1804,2,0,1e-05,0.001,0.492,899,905
12,1904,2,0,1e-05,0.001,0.542,952,952
13,0,2,0,1e-05,0.001,0.502,0,0
13,104,2,0,1e-05,0.001,0.5,57,47
13,204,2,0,1e-05,0.001,0.5,115,89
13,304,2,0,1e-05,0.001,0.504,163,141
13,404,2,0,1e-05,0.001,0.504,212,192
13,504,2,0,1e-05,0.001,0.506,258,246
13,604,2,0,1e-05,0.001,0.506,308,296
13,704,2,0,1e-05,0.001,0.506,353,351
13,804,2,0,1e-05,0.001,0.506,407,397
13,904,2,0,1e-05,0.001,0.508,454,450
13,1004,2,0,1e-05,0.001,0.508,501,503
13,1104,2,0,1e-05,0.001,0.508,544,560
13,1204,2,0,1e-05,0.001,0.508,598,606
13,1304,2,0,1e-05,0.001,0.504,654,650
13,1404,2,0,1e-05,0.001,0.504,706,698
13,1504,2,0,1e-05,0.001,0.504,753,751
13,1604,2,0,1e-05,0.001,0.504,810,794
13,1704,2,0,1e-05,0.001,0.504,858,846
13,1804,2,0,1e-05,0.001,0.504,903,901
13,1904,2,0,1e-05,0.001,0.506,952,952
14,0,2,0,1e-05,0.001,0.628,0,0
14,104,2,0,1e-05,0.001,0.626,50,54
14,204,2,0,1e-05,0.001,0.624,103,101
14,304,2,0,1e-05,0.001,0.624,148,156
14,404,2,0,1e-05,0.001,0.62,186,218
14,504,2,0,1e-05,0.001,0.628,232,272
14,604,2,0,1e-05,0.001,0.632,285,319
14,704,2,0,1e-05,0.001,0.636,339,365
14,804,2,0,1e-05,0.001,0.64,388,416
14,904,2,0,1e-05,0.001,0.642,429,475
14,1004,2,0,1e-05,0.001,0.634,474,530
14,1104,2,0,1e-05,0.001,0.638,524,580
14,1204,2,0,1e-05,0.001,0.642,571,633
14,1304,2,0,1e-05,0.001,0.642,620,684
14,1404,2,0,1e-05,0.001,0.638,679,725
14,1504,2,0,1e-05,0.001,0.636,735,769
14,1604,2,0,1e-05,0.001,0.63,785,819
14,1704,2,0,1e-05,0.001,0.624,837,867
14,1804,2,0,1e-05,0.001,0.622,901,903
14,1904,2,0,1e-05,0.001,0.618,952,952
15,0,2,0,1e-05,0.001,0.516,0,0
15,104,2,0,1e-05,0.001,0.516,50,54
15,204,2,0,1e-05,0.001,0.518,96,108
15,304,2,0,1e-05,0.001,0.518,143,161
15,404,2,0,1e-05,0.001,0.514,191,213
15,504,2,0,1e-05,0.001,0.504,235,269
15,604,2,0,1e-05,0.001,0.53,276,328
15,704,2,0,1e-05,0.001,0.512,327,377
15,804,2,0,1e-05,0.001,0.514,383,421
15,904,2,0,1e-05,0.001,0.52,442,462
15,1004,2,0,1e-05,0.001,0.504,491,513
15,1104,2,0,1e-05,0.001,0.506,552,552
15,1204,2,0,1e-05,0.001,0.514,609,595
15,1304,2,0,1e-05,0.001,0.528,656,648
15,1404,2,0,1e-05,0.001,0.532,699,705
15,1504,2,0,1e-05,0.001,0.538,747,757
15,1604,2,0,1e-05,0.001,0.54,790,814
15,1704,2,0,1e-05,0.001,0.538,848,856
15,1804,2,0,1e-05,0.001,0.552,902,902
15,1904,2,0,1e-05,0.001,0.552,952,952
16,0,2,0,1e-05,0.001,0.53,0,0
16,104,2,0,1e-05,0.001,0.53,49,55
16,204,2,0,1e-05,0.001,0.53,99,105
16,304,2,0,1e-05,0.001,0.534,152,152
16,404,2,0,1e-05,0.001,0.534,204,200
16,504,2,0,1e-05,0.001,0.532,262,242
16,604,2,0,1e-05,0.001,0.532,314,290
16,704,2,0,1e-05,0.001,0.534,366,338
16,804,2,0,1e-05,0.001,0.534,424,380
16,904,2,0,1e-05,0.001,0.534,471,433
16,1004,2,0,1e-05,0.001,0.532,524,480
16,1104,2,0,1e-05,0.001,0.532,577,527
16,1204,2,0,1e-05,0.001,0.532,622,582
16,1304,2,0,1e-05,0.001,0.532,675,629
16,1404,2,0,1e-05,0.001,0.532,720,684
16,1504,2,0,1e-05,0.001,0.532,765,739
16,1604,2,0,1e-05,0.001,0.528,806,798
16,1704,2,0,1e-05,0.001,0.528,858,846
16,1804,2,0,1e-05,0.001,0.53,908,896
16,1904,2,0,1e-05,0.001,0.532,952,952
17,0,2,0,1e-05,0.001,0.564,0,0
17,104,2,0,1e-05,0.001,0.564,60,44
17,204,2,0,1e-05,0.001,0.564,108,96
17,304,2,0,1e-05,0.001,0.564,150,154
17,404,2,0,1e-05,0.001,0.564,202,202
17,504,2,0,1e-05,0.001,0.564,254,250
17,604,2,0,1e-05,0.001,0.568,311,293
17,704,2,0,1e-05,0.001,0.566,351,353
17,804,2,0,1e-05,0.001,0.576,403,401
17,904,2,0,1e-05,0.001,0.586,450,454
17,1004,2,0,1e-05,0.001,0.584,499,505
17,1104,2,0,1e-05,0.001,0.586,549,555
17,1204,2,0,1e-05,0.001,0.588,602,602
17,1304,2,0,1e-05,0.001,0.592,654,650
17,1404,2,0,1e-05,0.001,0.598,706,698
17,1504,2,0,1e-05,0.001,0.608,752,752
17,1604,2,0,1e-05,0.001,0.61,800,804
17,1704,2,0,1e-05,0.001,0.614,853,851
17,1804,2,0,1e-05,0.001,0.618,902,902
17,1904,2,0,1e-05,0.001,0.624,952,952
18,0,2,0,1e-05,0.001,0.5,0,0
18,104,2,0,1e-05,0.001,0.502,59,45
18,204,2,0,1e-05,0.001,0.508,108,96
18,304,2,0,1e-05,0.001,0.504,168,136
18,404,2,0,1e-05,0.001,0.512,219,185
18,504,2,0,1e-05,0.001,0.508,269,235
18,604,2,0,1e-05,0.001,0.508,309,295
18,704,2,0,1e-05,0.001,0.508,354,350
18,804,2,0,1e-05,0.001,0.512,403,401
18,904,2,0,1e-05,0.001,0.512,453,451
18,1004,2,0,1e-05,0.001,0.51,497,507
18,1104,2,0,1e-05,0.001,0.508,549,555
18,1204,2,0,1e-05,0.001,0.508,606,598
18,1304,2,0,1e-05,0.001,0.508,659,645
18,1404,2,0,1e-05,0.001,0.508,710,694
18,1504,2,0,1e-05,0.001,0.506,757,747
18,1604,2,0,1e-05,0.001,0.506,806,798
18,1704,2,0,1e-05,0.001,0.506,861,843
18,1804,2,0,1e-05,0.001,0.504,909,895
18,1904,2,0,1e-05,0.001,0.504,952,952
19,0,2,0,1e-05,0.001,0.502,0,0
19,104,2,0,1e-05,0.001,0.502,58,46
19,204,2,0,1e-05,0.001,0.502,116,88
19,304,2,0,1e-05,0.001,0.496,159,145
19,404,2,0,1e-05,0.001,0.476,212,192
19,504,2,0,1e-05,0.001,0.456,266,238
19,604,2,0,1e-05,0.001,0.43,317,287
19,704,2,0,1e-05,0.001,0.528,366,338
19,804,2,0,1e-05,0.001,0.55,421,383
19,904,2,0,1e-05,0.001,0.502,473,431
19,1004,2,0,1e-05,0.001,0.5,520,484
19,1104,2,0,1e-05,0.001,0.496,566,538
19,1204,2,0,1e-05,0.001,0.5,617,587
19,1304,2,0,1e-05,0.001,0.5,664,640
19,1404,2,0,1e-05,0.001,0.496,718,686
19,1504,2,0,1e-05,0.001,0.496,760,744
19,1604,2,0,1e-05,0.001,0.502,804,800
19,1704,2,0,1e-05,0.001,0.53,857,847
19,1804,2,0,1e-05,0.001,0.528,905,899
19,1904,2,0,1e-05,0.001,0.576,952,952
20,0,2,0,1e-05,0.001,0.5,0,0
20,104,2,0,1e-05,0.001,0.5,51,53
20,204,2,0,1e-05,0.001,0.5,100,104
20,304,2,0,1e-05,0.001,0.5,155,149
20,404,2,0,1e-05,0.001,0.5,210,194
20,504,2,0,1e-05,0.001,0.5,247,257
20,604,2,0,1e-05,0.001,0.5,302,302
20,704,2,0,1e-05,0.001,0.5,344,360
20,804,2,0,1e-05,0.001,0.5,396,408
20,904,2,0,1e-05,0.001,0.5,449,455
20,1004,2,0,1e-05,0.001,0.5,494,510
20,1104,2,0,1e-05,0.001,0.5,542,562
20,1204,2,0,1e-05,0.001,0.5,598,606
20,1304,2,0,1e-05,0.001,0.5,645,659
20,1404,2,0,1e-05,0.001,0.498,686,718
20,1504,2,0,1e-05,0.001,0.498,745,759
20,1604,2,0,1e-05,0.001,0.498,798,806
20,1704,2,0,1e-05,0.001,0.498,850,854
20,1804,2,0,1e-05,0.001,0.5,896,908
20,1904,2,0,1e-05,0.001,0.5,952,952
1,0,2,0,1e-05,0.01,0.752,0,0
1,104,2,0,1e-05,0.01,0.754,45,59
1,204,2,0,1e-05,0.01,0.74,95,109
1,304,2,0,1e-05,0.01,0.696,152,152
1,404,2,0,1e-05,0.01,0.65,211,193
1,504,2,0,1e-05,0.01,0.632,259,245
1,604,2,0,1e-05,0.01,0.66,312,292
1,704,2,0,1e-05,0.01,0.588,364,340
1,804,2,0,1e-05,0.01,0.684,412,392
1,904,2,0,1e-05,0.01,0.73,464,440
1,1004,2,0,1e-05,0.01,0.702,512,492
1,1104,2,0,1e-05,0.01,0.702,561,543
1,1204,2,0,1e-05,0.01,0.704,607,597
1,1304,2,0,1e-05,0.01,0.696,658,646
1,1404,2,0,1e-05,0.01,0.72,710,694
1,1504,2,0,1e-05,0.01,0.704,767,737
1,1604,2,0,1e-05,0.01,0.688,811,793
1,1704,2,0,1e-05,0.01,0.668,862,842
1,1804,2,0,1e-05,0.01,0.696,906,898
1,1904,2,0,1e-05,0.01,0.722,952,952
2,0,2,0,1e-05,0.01,0.516,0,0
2,104,2,0,1e-05,0.01,0.51,51,53
2,204,2,0,1e-05,0.01,0.498,95,109
2,304,2,0,1e-05,0.01,0.504,151,153
2,404,2,0,1e-05,0.01,0.5,200,204
2,504,2,0,1e-05,0.01,0.498,253,251
2,604,2,0,1e-05,0.01,0.498,297,307
2,704,2,0,1e-05,0.01,0.5,357,347
2,804,2,0,1e-05,0.01,0.5,400,404
2,904,2,0,1e-05,0.01,0.5,455,449
2,1004,2,0,1e-05,0.01,0.5,511,493
2,1104,2,0,1e-05,0.01,0.5,562,542
2,1204,2,0,1e-05,0.01,0.502,603,601
2,1304,2,0,1e-05,0.01,0.5,651,653
2,1404,2,0,1e-05,0.01,0.5,697,707
2,1504,2,0,1e-05,0.01,0.504,747,757
2,1604,2,0,1e-05,0.01,0.508,800,804
2,1704,2,0,1e-05,0.01,0.506,851,853
2,1804,2,0,1e-05,0.01,0.5,901,903
2,1904,2,0,1e-05,0.01,0.502,952,952
3,0,2,0,1e-05,0.01,0.492,0,0
3,104,2,0,1e-05,0.01,0.488,58,46
3,204,2,0,1e-05,0.01,0.492,104,100
3,304,2,0,1e-05,0.01,0.502,148,156
3,404,2,0,1e-05,0.01,0.5,196,208
3,504,2,0,1e-05,0.01,0.5,244,260
3,604,2,0,1e-05,0.01,0.488,298,306
3,704,2,0,1e-05,0.01,0.502,353,351
3,804,2,0,1e-05,0.01,0.472,408,396
3,904,2,0,1e-05,0.01,0.512,452,452
3,1004,2,0,1e-05,0.01,0.478,508,496
3,1104,2,0,1e-05,0.01,0.47,561,543
3,1204,2,0,1e-05,0.01,0.482,613,591
3,1304,2,0,1e-05,0.01,0.498,656,648
3,1404,2,0,1e-05,0.01,0.486,703,701
3,1504,2,0,1e-05,0.01,0.474,749,755
3,1604,2,0,1e-05,0.01,0.482,794,810
3,1704,2,0,1e-05,0.01,0.48,850,854
3,1804,2,0,1e-05,0.01,0.49,898,906
3,1904,2,0,1e-05,0.01,0.474,952,952
4,0,2,0,1e-05,0.01,0.502,0,0
4,104,2,0,1e-05,0.01,0.502,48,56
4,204,2,0,1e-05,0.01,0.502,106,98
4,304,2,0,1e-05,0.01,0.502,163,141
4,404,2,0,1e-05,0.01,0.49,213,191
4,504,2,0,1e-05,0.01,0.498,264,240
4,604,2,0,1e-05,0.01,0.5,306,298
4,704,2,0,1e-05,0.01,0.5,362,342
4,804,2,0,1e-05,0.01,0.5,406,398
4,904,2,0,1e-05,0.01,0.5,460,444
4,1004,2,0,1e-05,0.01,0.5,508,496
4,1104,2,0,1e-05,0.01,0.5,563,541
4,1204,2,0,1e-05,0.01,0.5,607,597
4,1304,2,0,1e-05,0.01,0.498,650,654
4,1404,2,0,1e-05,0.01,0.5,704,700
4,1504,2,0,1e-05,0.01,0.5,757,747
4,1604,2,0,1e-05,0.01,0.5,804,800
4,1704,2,0,1e-05,0.01,0.5,854,850
4,1804,2,0,1e-05,0.01,0.5,907,897
4,1904,2,0,1e-05,0.01,0.5,952,952
5,0,2,0,1e-05,0.01,0.532,0,0
5,104,2,0,1e-05,0.01,0.53,53,51
5,204,2,0,1e-05,0.01,0.542,106,98
5,304,2,0,1e-05,0.01,0.536,160,144
5,404,2,0,1e-05,0.01,0.534,210,194
5,504,2,0,1e-05,0.01,0.52,267,237
5,604,2,0,1e-05,0.01,0.524,312,292
5,704,2,0,1e-05,0.01,0.524,359,345
5,804,2,0,1e-05,0.01,0.514,409,395
5,904,2,0,1e-05,0.01,0.512,464,440
5,1004,2,0,1e-05,0.01,0.494,512,492
5,1104,2,0,1e-05,0.01,0.5,553,551
5,1204,2,0,1e-05,0.01,0.508,604,600
5,1304,2,0,1e-05,0.01,0.5,652,652
5,1404,2,0,1e-05,0.01,0.5,698,706
5,1504,2,0,1e-05,0.01,0.5,750,754
5,1604,2,0,1e-05,0.01,0.5,800,804
5,1704,2,0,1e-05,0.01,0.498,850,854
5,1804,2,0,1e-05,0.01,0.498,896,908
5,1904,2,0,1e-05,0.01,0.498,952,952
6,0,2,0,1e-05,0.01,0.634,0,0
6,104,2,0,1e-05,0.01,0.63,58,46
6,204,2,0,1e-05,0.01,0.62,111,93
6,304,2,0,1e-05,0.01,0.596,155,149
6,404,2,0,1e-05,0.01,0.586,196,208
6,504,2,0,1e-05,0.01,0.574,248,256
6,604,2,0,1e-05,0.01,0.55,296,308
6,704,2,0,1e-05,0.01,0.54,342,362
6,804,2,0,1e-05,0.01,0.534,391,413
6,904,2,0,1e-05,0.01,0.518,440,464
6,1004,2,0,1e-05,0.01,0.508,498,506
6,1104,2,0,1e-05,0.01,0.514,548,556
6,1204,2,0,1e-05,0.01,0.5,594,610
6,1304,2,0,1e-05,0.01,0.5,646,658
6,1404,2,0,1e-05,0.01,0.5,695,709
6,1504,2,0,1e-05,0.01,0.516,741,763
6,1604,2,0,1e-05,0.01,0.512,793,811
6,1704,2,0,1e-05,0.01,0.512,839,865
6,1804,2,0,1e-05,0.01,0.512,896,908
6,1904,2,0,1e-05,0.01,0.514,952,952
7,0,2,0,1e-05,0.01,0.692,0,0
7,104,2,0,1e-05,0.01,0.696,57,47
7,204,2,0,1e-05,0.01,0.694,101,103
7,304,2,0,1e-05,0.01,0.676,151,153
7,404,2,0,1e-05,0.01,0.614,212,192
7,504,2,0,1e-05,0.01,0.582,259,245
7,604,2,0,1e-05,0.01,0.568,309,295
7,704,2,0,1e-05,0.01,0.53,354,350
7,804,2,0,1e-05,0.01,0.528,413,391
7,904,2,0,1e-05,0.01,0.51,470,434
7,1004,2,0,1e-05,0.01,0.492,515,489
7,1104,2,0,1e-05,0.01,0.488,568,536
7,1204,2,0,1e-05,0.01,0.49,616,588
7,1304,2,0,1e-05,0.01,0.494,669,635
7,1404,2,0,1e-05,0.01,0.496,709,695
7,1504,2,0,1e-05,0.01,0.498,750,754
7,1604,2,0,1e-05,0.01,0.502,803,801
7,1704,2,0,1e-05,0.01,0.498,848,856
7,1804,2,0,1e-05,0.01,0.498,900,904
7,1904,2,0,1e-05,0.01,0.5,952,952
8,0,2,0,1e-05,0.01,0.732,0,0
8,104,2,0,1e-05,0.01,0.728,48,56
8,204,2,0,1e-05,0.01,0.72,97,107
8,304,2,0,1e-05,0.01,0.674,147,157
8,404,2,0,1e-05,0.01,0.65,193,211
8,504,2,0,1e-05,0.01,0.608,246,258
8,604,2,0,1e-05,0.01,0.548,292,312
8,704,2,0,1e-05,0.01,0.506,340,364
8,804,2,0,1e-05,0.01,0.49,396,408
8,904,2,0,1e-05,0.01,0.486,443,461
8,1004,2,0,1e-05,0.01,0.486,493,511
8,1104,2,0,1e-05,0.01,0.486,549,555
8,1204,2,0,1e-05,0.01,0.5,604,600
8,1304,2,0,1e-05,0.01,0.5,650,654
8,1404,2,0,1e-05,0.01,0.5,703,701
8,1504,2,0,1e-05,0.01,0.5,755,749
8,1604,2,0,1e-05,0.01,0.488,809,795
8,1704,2,0,1e-05,0.01,0.494,857,847
8,1804,2,0,1e-05,0.01,0.494,902,902
8,1904,2,0,1e-05,0.01,0.5,952,952
9,0,2,0,1e-05,0.01,0.734,0,0
9,104,2,0,1e-05,0.01,0.73,48,56
9,204,2,0,1e-05,0.01,0.714,97,107
9,304,2,0,1e-05,0.01,0.684,139,165
9,404,2,0,1e-05,0.01,0.666,193,211
9,504,2,0,1e-05,0.01,0.63,245,259
9,604,2,0,1e-05,0.01,0.61,297,307
9,704,2,0,1e-05,0.01,0.596,354,350
9,804,2,0,1e-05,0.01,0.638,406,398
9,904,2,0,1e-05,0.01,0.674,466,438
9,1004,2,0,1e-05,0.01,0.688,513,491
9,1104,2,0,1e-05,0.01,0.652,565,539
9,1204,2,0,1e-05,0.01,0.678,611,593
9,1304,2,0,1e-05,0.01,0.688,661,643
9,1404,2,0,1e-05,0.01,0.696,709,695
9,1504,2,0,1e-05,0.01,0.762,758,746
9,1604,2,0,1e-05,0.01,0.632,802,802
9,1704,2,0,1e-05,0.01,0.706,850,854
9,1804,2,0,1e-05,0.01,0.654,902,902
9,1904,2,0,1e-05,0.01,0.652,952,952
10,0,2,0,1e-05,0.01,0.606,0,0
10,104,2,0,1e-05,0.01,0.612,54,50
10,204,2,0,1e-05,0.01,0.636,102,102
10,304,2,0,1e-05,0.01,0.64,156,148
10,404,2,0,1e-05,0.01,0.614,196,208
10,504,2,0,1e-05,0.01,0.582,255,249
10,604,2,0,1e-05,0.01,0.546,303,301
10,704,2,0,1e-05,0.01,0.536,358,346
10,804,2,0,1e-05,0.01,0.524,408,396
10,904,2,0,1e-05,0.01,0.496,458,446
10,1004,2,0,1e-05,0.01,0.476,506,498
10,1104,2,0,1e-05,0.01,0.482,558,546
10,1204,2,0,1e-05,0.01,0.476,605,599
10,1304,2,0,1e-05,0.01,0.502,666,638
10,1404,2,0,1e-05,0.01,0.506,707,697
10,1504,2,0,1e-05,0.01,0.504,766,738
10,1604,2,0,1e-05,0.01,0.5,806,798
10,1704,2,0,1e-05,0.01,0.496,849,855
10,1804,2,0,1e-05,0.01,0.5,904,900
10,1904,2,0,1e-05,0.01,0.5,952,952
11,0,2,0,1e-05,0.01,0.78,0,0
11,104,2,0,1e-05,0.01,0.772,50,54
11,204,2,0,1e-05,0.01,0.73,105,99
11,304,2,0,1e-05,0.01,0.682,152,152
11,404,2,0,1e-05,0.01,0.69,204,200
11,504,2,0,1e-05,0.01,0.744,256,248
11,604,2,0,1e-05,0.01,0.784,305,299
11,704,2,0,1e-05,0.01,0.754,362,342
11,804,2,0,1e-05,0.01,0.77,409,395
11,904,2,0,1e-05,0.01,0.782,466,438
11,1004,2,0,1e-05,0.01,0.776,518,486
11,1104,2,0,1e-05,0.01,0.784,563,541
11,1204,2,0,1e-05,0.01,0.788,618,586
11,1304,2,0,1e-05,0.01,0.788,665,639
11,1404,2,0,1e-05,0.01,0.778,708,696
11,1504,2,0,1e-05,0.01,0.776,754,750
11,1604,2,0,1e-05,0.01,0.784,804,800
11,1704,2,0,1e-05,0.01,0.782,852,852
11,1804,2,0,1e-05,0.01,0.786,898,906
11,1904,2,0,1e-05,0.01,0.79,952,952
12,0,2,0,1e-05,0.01,0.5,0,0
12,104,2,0,1e-05,0.01,0.5,51,53
12,204,2,0,1e-05,0.01,0.5,98,106
12,304,2,0,1e-05,0.01,0.5,148,156
12,404,2,0,1e-05,0.01,0.5,195,209
12,504,2,0,1e-05,0.01,0.5,246,258
12,604,2,0,1e-05,0.01,0.5,291,313
12,704,2,0,1e-05,0.01,0.5,349,355
12,804,2,0,1e-05,0.01,0.5,398,406
12,904,2,0,1e-05,0.01,0.5,456,448
12,1004,2,0,1e-05,0.01,0.5,507,497
12,1104,2,0,1e-05,0.01,0.5,557,547
12,1204,2,0,1e-05,0.01,0.5,607,597
12,1304,2,0,1e-05,0.01,0.5,655,649
12,1404,2,0,1e-05,0.01,0.5,694,710
12,1504,2,0,1e-05,0.01,0.5,747,757
12,1604,2,0,1e-05,0.01,0.5,794,810
12,1704,2,0,1e-05,0.01,0.5,847,857
12,1804,2,0,1e-05,0.01,0.5,900,904
12,1904,2,0,1e-05,0.01,0.5,952,952
13,0,2,0,1e-05,0.01,0.484,0,0
13,104,2,0,1e-05,0.01,0.524,53,51
13,204,2,0,1e-05,0.01,0.508,98,106
13,304,2,0,1e-05,0.01,0.5,151,153
13,404,2,0,1e-05,0.01,0.5,193,211
13,504,2,0,1e-05,0.01,0.5,252,252
13,604,2,0,1e-05,0.01,0.5,303,301
13,704,2,0,1e-05,0.01,0.5,357,347
13,804,2,0,1e-05,0.01,0.5,408,396
13,904,2,0,1e-05,0.01,0.5,453,451
13,1004,2,0,1e-05,0.01,0.5,501,503
13,1104,2,0,1e-05,0.01,0.5,551,553
13,1204,2,0,1e-05,0.01,0.5,605,599
13,1304,2,0,1e-05,0.01,0.5,657,647
13,1404,2,0,1e-05,0.01,0.488,707,697
13,1504,2,0,1e-05,0.01,0.486,750,754
13,1604,2,0,1e-05,0.01,0.484,793,811
13,1704,2,0,1e-05,0.01,0.486,840,864
13,1804,2,0,1e-05,0.01,0.49,894,910
13,1904,2,0,1e-05,0.01,0.494,952,952
14,0,2,0,1e-05,0.01,0.516,0,0
14,104,2,0,1e-05,0.01,0.526,58,46
14,204,2,0,1e-05,0.01,0.526,115,89
14,304,2,0,1e-05,0.01,0.506,163,141
14,404,2,0,1e-05,0.01,0.494,208,196
14,504,2,0,1e-05,0.01,0.512,245,259
14,604,2,0,1e-05,0.01,0.482,297,307
14,704,2,0,1e-05,0.01,0.48,350,354
14,804,2,0,1e-05,0.01,0.454,401,403
14,904,2,0,1e-05,0.01,0.468,453,451
14,1004,2,0,1e-05,0.01,0.466,499,505
14,1104,2,0,1e-05,0.01,0.448,549,555
14,1204,2,0,1e-05,0.01,0.466,601,603
14,1304,2,0,1e-05,0.01,0.448,654,650
14,1404,2,0,1e-05,0.01,0.47,706,698
14,1504,2,0,1e-05,0.01,0.438,750,754
14,1604,2,0,1e-05,0.01,0.45,809,795
14,1704,2,0,1e-05,0.01,0.458,850,854
14,1804,2,0,1e-05,0.01,0.454,904,900
14,1904,2,0,1e-05,0.01,0.458,952,952
15,0,2,0,1e-05,0.01,0.486,0,0
15,104,2,0,1e-05,0.01,0.488,55,49
15,204,2,0,1e-05,0.01,0.486,108,96
15,304,2,0,1e-05,0.01,0.488,157,147
15,404,2,0,1e-05,0.01,0.5,210,194
15,504,2,0,1e-05,0.01,0.514,265,239
15,604,2,0,1e-05,0.01,0.512,311,293
15,704,2,0,1e-05,0.01,0.512,364,340
15,804,2,0,1e-05,0.01,0.5,406,398
15,904,2,0,1e-05,0.01,0.5,458,446
15,1004,2,0,1e-05,0.01,0.5,512,492
15,1104,2,0,1e-05,0.01,0.5,567,537
15,1204,2,0,1e-05,0.01,0.5,614,590
15,1304,2,0,1e-05,0.01,0.5,663,641
15,1404,2,0,1e-05,0.01,0.5,721,683
15,1504,2,0,1e-05,0.01,0.5,768,736
15,1604,2,0,1e-05,0.01,0.5,818,786
15,1704,2,0,1e-05,0.01,0.5,861,843
15,1804,2,0,1e-05,0.01,0.51,908,896
15,1904,2,0,1e-05,0.01,0.5,952,952
16,0,2,0,1e-05,0.01,0.492,0,0
16,104,2,0,1e-05,0.01,0.486,48,56
16,204,2,0,1e-05,0.01,0.492,90,114
16,304,2,0,1e-05,0.01,0.486,145,159
16,404,2,0,1e-05,0.01,0.488,195,209
16,504,2,0,1e-05,0.01,0.492,250,254
16,604,2,0,1e-05,0.01,0.498,303,301
16,704,2,0,1e-05,0.01,0.498,350,354
16,804,2,0,1e-05,0.01,0.498,393,411
16,904,2,0,1e-05,0.01,0.5,450,454
16,1004,2,0,1e-05,0.01,0.5,500,504
16,1104,2,0,1e-05,0.01,0.5,545,559
16,1204,2,0,1e-05,0.01,0.498,598,606
16,1304,2,0,1e-05,0.01,0.498,648,656
16,1404,2,0,1e-05,0.01,0.496,697,707
16,1504,2,0,1e-05,0.01,0.496,748,756
16,1604,2,0,1e-05,0.01,0.496,799,805
16,1704,2,0,1e-05,0.01,0.5,852,852
16,1804,2,0,1e-05,0.01,0.5,898,906
16,1904,2,0,1e-05,0.01,0.5,952,952
17,0,2,0,1e-05,0.01,0.724,0,0
17,104,2,0,1e-05,0.01,0.722,59,45
17,204,2,0,1e-05,0.01,0.706,102,102
17,304,2,0,1e-05,0.01,0.594,154,150
17,404,2,0,1e-05,0.01,0.572,204,200
17,504,2,0,1e-05,0.01,0.618,257,247
17,604,2,0,1e-05,0.01,0.538,309,295
17,704,2,0,1e-05,0.01,0.664,360,344
17,804,2,0,1e-05,0.01,0.684,403,401
17,904,2,0,1e-05,0.01,0.644,455,449
17,1004,2,0,1e-05,0.01,0.722,500,504
17,1104,2,0,1e-05,0.01,0.736,545,559
17,1204,2,0,1e-05,0.01,0.75,598,606
17,1304,2,0,1e-05,0.01,0.764,645,659
17,1404,2,0,1e-05,0.01,0.758,695,709
17,1504,2,0,1e-05,0.01,0.75,749,755
17,1604,2,0,1e-05,0.01,0.754,805,799
17,1704,2,0,1e-05,0.01,0.748,844,860
17,1804,2,0,1e-05,0.01,0.73,894,910
17,1904,2,0,1e-05,0.01,0.746,952,952
18,0,2,0,1e-05,0.01,0.502,0,0
18,104,2,0,1e-05,0.01,0.5,51,53
18,204,2,0,1e-05,0.01,0.516,99,105
18,304,2,0,1e-05,0.01,0.528,155,149
18,404,2,0,1e-05,0.01,0.518,210,194
18,504,2,0,1e-05,0.01,0.538,266,238
18,604,2,0,1e-05,0.01,0.532,315,289
18,704,2,0,1e-05,0.01,0.526,355,349
18,804,2,0,1e-05,0.01,0.5,394,410
18,904,2,0,1e-05,0.01,0.5,446,458
18,1004,2,0,1e-05,0.01,0.5,490,514
18,1104,2,0,1e-05,0.01,0.526,551,553
18,1204,2,0,1e-05,0.01,0.534,611,593
18,1304,2,0,1e-05,0.01,0.5,667,637
18,1404,2,0,1e-05,0.01,0.53,709,695
18,1504,2,0,1e-05,0.01,0.524,763,741
18,1604,2,0,1e-05,0.01,0.5,810,794
18,1704,2,0,1e-05,0.01,0.5,860,844
18,1804,2,0,1e-05,0.01,0.524,906,898
18,1904,2,0,1e-05,0.01,0.524,952,952
19,0,2,0,1e-05,0.01,0.522,0,0
19,104,2,0,1e-05,0.01,0.522,42,62
19,204,2,0,1e-05,0.01,0.52,84,120
19,304,2,0,1e-05,0.01,0.526,130,174
19,404,2,0,1e-05,0.01,0.516,186,218
19,504,2,0,1e-05,0.01,0.512,231,273
19,604,2,0,1e-05,0.01,0.512,285,319
19,704,2,0,1e-05,0.01,0.492,338,366
19,804,2,0,1e-05,0.01,0.5,396,408
19,904,2,0,1e-05,0.01,0.5,443,461
19,1004,2,0,1e-05,0.01,0.5,500,504
19,1104,2,0,1e-05,0.01,0.5,561,543
19,1204,2,0,1e-05,0.01,0.5,621,583
19,1304,2,0,1e-05,0.01,0.5,674,630
19,1404,2,0,1e-05,0.01,0.5,732,672
19,1504,2,0,1e-05,0.01,0.5,773,731
19,1604,2,0,1e-05,0.01,0.5,816,788
19,1704,2,0,1e-05,0.01,0.5,865,839
19,1804,2,0,1e-05,0.01,0.5,908,896
19,1904,2,0,1e-05,0.01,0.5,952,952
20,0,2,0,1e-05,0.01,0.494,0,0
20,104,2,0,1e-05,0.01,0.494,53,51
20,204,2,0,1e-05,0.01,0.514,100,104
20,304,2,0,1e-05,0.01,0.522,152,152
20,404,2,0,1e-05,0.01,0.51,208,196
20,504,2,0,1e-05,0.01,0.51,251,253
20,604,2,0,1e-05,0.01,0.506,299,305
20,704,2,0,1e-05,0.01,0.504,347,357
20,804,2,0,1e-05,0.01,0.504,395,409
20,904,2,0,1e-05,0.01,0.5,446,458
20,1004,2,0,1e-05,0.01,0.504,498,506
20,1104,2,0,1e-05,0.01,0.504,541,563
20,1204,2,0,1e-05,0.01,0.502,587,617
20,1304,2,0,1e-05,0.01,0.504,644,660
20,1404,2,0,1e-05,0.01,0.506,695,709
20,1504,2,0,1e-05,0.01,0.506,746,758
20,1604,2,0,1e-05,0.01,0.506,800,804
20,1704,2,0,1e-05,0.01,0.5,859,845
20,1804,2,0,1e-05,0.01,0.5,902,902
20,1904,2,0,1e-05,0.01,0.5,952,952
1,0,2,0,0.0001,0.0001,0.5,0,0
1,104,2,0,0.0001,0.0001,0.5,58,46
1,204,2,0,0.0001,0.0001,0.5,108,96
1,304,2,0,0.0001,0.0001,0.5,155,149
1,404,2,0,0.0001,0.0001,0.5,207,197
1,504,2,0,0.0001,0.0001,0.5,253,251
1,604,2,0,0.0001,0.0001,0.5,298,306
1,704,2,0,0.0001,0.0001,0.5,346,358
1,804,2,0,0.0001,0.0001,0.5,393,411
1,904,2,0,0.0001,0.0001,0.5,452,452
1,1004,2,0,0.0001,0.0001,0.5,497,507
1,1104,2,0,0.0001,0.0001,0.5,553,551
1,1204,2,0,0.0001,0.0001,0.5,602,602
1,1304,2,0,0.0001,0.0001,0.5,657,647
1,1404,2,0,0.0001,0.0001,0.5,703,701
1,1504,2,0,0.0001,0.0001,0.5,750,754
1,1604,2,0,0.0001,0.0001,0.5,789,815
1,1704,2,0,0.0001,0.0001,0.5,850,854
1,1804,2,0,0.0001,0.0001,0.5,901,903
1,1904,2,0,0.0001,0.0001,0.5,952,952
2,0,2,0,0.0001,0.0001,0.5,0,0
2,104,2,0,0.0001,0.0001,0.5,51,53
2,204,2,0,0.0001,0.0001,0.5,95,109
2,304,2,0,0.0001,0.0001,0.5,150,154
2,404,2,0,0.0001,0.0001,0.5,204,200
2,504,2,0,0.0001,0.0001,0.5,259,245
2,604,2,0,0.0001,0.0001,0.5,311,293
2,704,2,0,0.0001,0.0001,0.5,366,338
2,804,2,0,0.0001,0.0001,0.5,415,389
2,904,2,0,0.0001,0.0001,0.5,466,438
2,1004,2,0,0.0001,0.0001,0.5,509,495
2,1104,2,0,0.0001,0.0001,0.5,562,542
2,1204,2,0,0.0001,0.0001,0.5,612,592
2,1304,2,0,0.0001,0.0001,0.5,646,658
2,1404,2,0,0.0001,0.0001,0.5,698,706
2,1504,2,0,0.0001,0.0001,0.5,748,756
2,1604,2,0,0.0001,0.0001,0.5,795,809
2,1704,2,0,0.0001,0.0001,0.5,842,862
2,1804,2,0,0.0001,0.0001,0.5,896,908
2,1904,2,0,0.0001,0.0001,0.5,952,952
3,0,2,0,0.0001,0.0001,0.5,0,0
3,104,2,0,0.0001,0.0001,0.5,54,50
3,204,2,0,0.0001,0.0001,0.5,105,99
3,304,2,0,0.0001,0.0001,0.5,148,156
3,404,2,0,0.0001,0.0001,0.5,193,211
3,504,2,0,0.0001,0.0001,0.5,246,258
3,604,2,0,0.0001,0.0001,0.5,301,303
3,704,2,0,0.0001,0.0001,0.5,353,351
3,804,2,0,0.0001,0.0001,0.5,404,400
3,904,2,0,0.0001,0.0001,0.5,457,447
3,1004,2,0,0.0001,0.0001,0.5,511,493
3,1104,2,0,0.0001,0.0001,0.5,559,545
3,1204,2,0,0.0001,0.0001,0.5,603,601
3,1304,2,0,0.0001,0.0001,0.5,662,642
3,1404,2,0,0.0001,0.0001,0.5,710,694
3,1504,2,0,0.0001,0.0001,0.5,758,746
3,1604,2,0,0.0001,0.0001,0.5,802,802
3,1704,2,0,0.0001,0.0001,0.5,846,858
3,1804,2,0,0.0001,0.0001,0.5,899,905
3,1904,2,0,0.0001,0.0001,0.5,952,952
4,0,2,0,0.0001,0.0001,0.5,0,0
4,104,2,0,0.0001,0.0001,0.5,58,46
4,204,2,0,0.0001,0.0001,0.5,99,105
4,304,2,0,0.0001,0.0001,0.5,146,158
4,404,2,0,0.0001,0.0001,0.5,190,214
4,504,2,0,0.0001,0.0001,0.5,242,262
4,604,2,0,0.0001,0.0001,0.5,292,312
4,704,2,0,0.0001,0.0001,0.5,334,370
4,804,2,0,0.0001,0.0001,0.5,383,421
4,904,2,0,0.0001,0.0001,0.5,433,471
4,1004,2,0,0.0001,0.0001,0.5,483,521
4,1104,2,0,0.0001,0.0001,0.5,536,568
4,1204,2,0,0.0001,0.0001,0.5,583,621
4,1304,2,0,0.0001,0.0001,0.5,636,668
4,1404,2,0,0.0001,0.0001,0.5,697,707
4,1504,2,0,0.0001,0.0001,0.5,752,752
4,1604,2,0,0.0001,0.0001,0.5,804,800
4,1704,2,0,0.0001,0.0001,0.5,856,848
4,1804,2,0,0.0001,0.0001,0.5,909,895
4,1904,2,0,0.0001,0.0001,0.5,952,952
5,0,2,0,0.0001,0.0001,0.5,0,0
5,104,2,0,0.0001,0.0001,0.5,58,46
5,204,2,0,0.0001,0.0001,0.5,106,98
5,304,2,0,0.0001,0.0001,0.5,161,143
5,404,2,0,0.0001,0.0001,0.5,203,201
5,504,2,0,0.0001,0.0001,0.5,246,258
5,604,2,0,0.0001,0.0001,0.5,302,302
5,704,2,0,0.0001,0.0001,0.5,357,347
5,804,2,0,0.0001,0.0001,0.5,404,400
5,904,2,0,0.0001,0.0001,0.5,445,459
5,1004,2,0,0.0001,0.0001,0.5,500,504
5,1104,2,0,0.0001,0.0001,0.5,552,552
5,1204,2,0,0.0001,0.0001,0.5,602,602
5,1304,2,0,0.0001,0.0001,0.5,658,646
5,1404,2,0,0.0001,0.0001,0.5,701,703
5,1504,2,0,0.0001,0.0001,0.5,748,756
5,1604,2,0,0.0001,0.0001,0.5,798,806
5,1704,2,0,0.0001,0.0001,0.5,850,854
5,1804,2,0,0.0001,0.0001,0.5,904,900
5,1904,2,0,0.0001,0.0001,0.5,952,952
6,0,2,0,0.0001,0.0001,0.5,0,0
6,104,2,0,0.0001,0.0001,0.5,56,48
6,204,2,0,0.0001,0.0001,0.5,106,98
6,304,2,0,0.0001,0.0001,0.5,162,142
6,404,2,0,0.0001,0.0001,0.5,207,197
6,504,2,0,0.0001,0.0001,0.5,257,247
6,604,2,0,0.0001,0.0001,0.5,308,296
6,704,2,0,0.0001,0.0001,0.5,352,352
6,804,2,0,0.0001,0.0001,0.5,405,399
6,904,2,0,0.0001,0.0001,0.5,459,445
6,1004,2,0,0.0001,0.0001,0.5,505,499
6,1104,2,0,0.0001,0.0001,0.5,557,547
6,1204,2,0,0.0001,0.0001,0.5,611,593
6,1304,2,0,0.0001,0.0001,0.5,663,641
6,1404,2,0,0.0001,0.0001,0.5,709,695
6,1504,2,0,0.0001,0.0001,0.5,757,747
6,1604,2,0,0.0001,0.0001,0.5,798,806
6,1704,2,0,0.0001,0.0001,0.5,848,856
6,1804,2,0,0.0001,0.0001,0.5,906,898
6,1904,2,0,0.0001,0.0001,0.5,952,952
7,0,2,0,0.0001,0.0001,0.5,0,0
7,104,2,0,0.0001,0.0001,0.5,51,53
7,204,2,0,0.0001,0.0001,0.5,97,107
7,304,2,0,0.0001,0.0001,0.5,150,154
7,404,2,0,0.0001,0.0001,0.5,203,201
7,504,2,0,0.0001,0.0001,0.5,260,244
7,604,2,0,0.0001,0.0001,0.5,311,293
7,704,2,0,0.0001,0.0001,0.5,355,349
7,804,2,0,0.0001,0.0001,0.5,407,397
7,904,2,0,0.0001,0.0001,0.5,462,442
7,1004,2,0,0.0001,0.0001,0.5,507,497
7,1104,2,0,0.0001,0.0001,0.5,547,557
7,1204,2,0,0.0001,0.0001,0.5,595,609
7,1304,2,0,0.0001,0.0001,0.5,646,658
7,1404,2,0,0.0001,0.0001,0.5,698,706
7,1504,2,0,0.0001,0.0001,0.5,749,755
7,1604,2,0,0.0001,0.0001,0.5,806,798
7,1704,2,0,0.0001,0.0001,0.5,855,849
7,1804,2,0,0.0001,0.0001,0.5,904,900
7,1904,2,0,0.0001,0.0001,0.5,952,952
8,0,2,0,0.0001,0.0001,0.5,0,0
8,104,2,0,0.0001,0.0001,0.5,59,45
8,204,2,0,0.0001,0.0001,0.5,101,103
8,304,2,0,0.0001,0.0001,0.5,145,159
8,404,2,0,0.0001,0.0001,0.5,188,216
8,504,2,0,0.0001,0.0001,0.5,240,264
8,604,2,0,0.0001,0.0001,0.5,284,320
8,704,2,0,0.0001,0.0001,0.5,340,364
8,804,2,0,0.0001,0.0001,0.5,385,419
8,904,2,0,0.0001,0.0001,0.5,432,472
8,1004,2,0,0.0001,0.0001,0.5,483,521
8,1104,2,0,0.0001,0.0001,0.5,536,568
8,1204,2,0,0.0001,0.0001,0.5,590,614
8,1304,2,0,0.0001,0.0001,0.5,644,660
8,1404,2,0,0.0001,0.0001,0.5,699,705
8,1504,2,0,0.0001,0.0001,0.5,747,757
8,1604,2,0,0.0001,0.0001,0.5,793,811
8,1704,2,0,0.0001,0.0001,0.5,848,856
8,1804,2,0,0.0001,0.0001,0.5,905,899
8,1904,2,0,0.0001,0.0001,0.5,952,952
9,0,2,0,0.0001,0.0001,0.5,0,0
9,104,2,0,0.0001,0.0001,0.5,51,53
9,204,2,0,0.0001,0.0001,0.5,98,106
9,304,2,0,0.0001,0.0001,0.5,146,158
9,404,2,0,0.0001,0.0001,0.5,194,210
9,504,2,0,0.0001,0.0001,0.5,248,256
9,604,2,0,0.0001,0.0001,0.5,306,298
9,704,2,0,0.0001,0.0001,0.5,350,354
9,804,2,0,0.0001,0.0001,0.5,406,398
9,904,2,0,0.0001,0.0001,0.5,459,445
9,1004,2,0,0.0001,0.0001,0.5,497,507
9,1104,2,0,0.0001,0.0001,0.5,553,551
9,1204,2,0,0.0001,0.0001,0.5,600,604
9,1304,2,0,0.0001,0.0001,0.5,642,662
9,1404,2,0,0.0001,0.0001,0.5,687,717
9,1504,2,0,0.0001,0.0001,0.5,742,762
9,1604,2,0,0.0001,0.0001,0.5,797,807
9,1704,2,0,0.0001,0.0001,0.5,847,857
9,1804,2,0,0.0001,0.0001,0.5,905,899
9,1904,2,0,0.0001,0.0001,0.5,952,952
10,0,2,0,0.0001,0.0001,0.5,0,0
10,104,2,0,0.0001,0.0001,0.5,50,54
10,204,2,0,0.0001,0.0001,0.5,97,107
10,304,2,0,0.0001,0.0001,0.5,149,155
10,404,2,0,0.0001,0.0001,0.5,203,201
10,504,2,0,0.0001,0.0001,0.5,257,247
10,604,2,0,0.0001,0.0001,0.5,308,296
10,704,2,0,0.0001,0.0001,0.5,357,347
10,804,2,0,0.0001,0.0001,0.5,408,396
10,904,2,0,0.0001,0.0001,0.5,462,442
10,1004,2,0,0.0001,0.0001,0.5,514,490
10,1104,2,0,0.0001,0.0001,0.5,564,540
10,1204,2,0,0.0001,0.0001,0.5,610,594
10,1304,2,0,0.0001,0.0001,0.5,651,653
10,1404,2,0,0.0001,0.0001,0.5,702,702
10,1504,2,0,0.0001,0.0001,0.5,752,752
10,1604,2,0,0.0001,0.0001,0.5,804,800
10,1704,2,0,0.0001,0.0001,0.5,854,850
10,1804,2,0,0.0001,0.0001,0.5,907,897
10,1904,2,0,0.0001,0.0001,0.5,952,952
11,0,2,0,0.0001,0.0001,0.5,0,0
11,104,2,0,0.0001,0.0001,0.5,54,50
11,204,2,0,0.0001,0.0001,0.5,104,100
11,304,2,0,0.0001,0.0001,0.5,157,147
11,404,2,0,0.0001,0.0001,0.5,203,201
11,504,2,0,0.0001,0.0001,0.5,245,259
11,604,2,0,0.0001,0.0001,0.5,301,303
11,704,2,0,0.0001,0.0001,0.5,344,360
11,804,2,0,0.0001,0.0001,0.5,393,411
11,904,2,0,0.0001,0.0001,0.5,448,456
11,1004,2,0,0.0001,0.0001,0.5,501,503
11,1104,2,0,0.0001,0.0001,0.5,549,555
11,1204,2,0,0.0001,0.0001,0.5,599,605
11,1304,2,0,0.0001,0.0001,0.5,651,653
11,1404,2,0,0.0001,0.0001,0.5,697,707
11,1504,2,0,0.0001,0.0001,0.5,740,764
11,1604,2,0,0.0001,0.0001,0.5,793,811
11,1704,2,0,0.0001,0.0001,0.5,845,859
11,1804,2,0,0.0001,0.0001,0.5,896,908
11,1904,2,0,0.0001,0.0001,0.5,952,952
12,0,2,0,0.0001,0.0001,0.5,0,0
12,104,2,0,0.0001,0.0001,0.5,52,52
12,204,2,0,0.0001,0.0001,0.5,102,102
12,304,2,0,0.0001,0.0001,0.5,148,156
12,404,2,0,0.0001,0.0001,0.5,199,205
12,504,2,0,0.0001,0.0001,0.5,248,256
12,604,2,0,0.0001,0.0001,0.5,295,309
12,704,2,0,0.0001,0.0001,0.5,351,353
12,804,2,0,0.0001,0.0001,0.5,406,398
12,904,2,0,0.0001,0.0001,0.5,460,444
12,1004,2,0,0.0001,0.0001,0.5,514,490
12,1104,2,0,0.0001,0.0001,0.5,560,544
12,1204,2,0,0.0001,0.0001,0.5,605,599
12,1304,2,0,0.0001,0.0001,0.5,655,649
12,1404,2,0,0.0001,0.0001,0.5,698,706
12,1504,2,0,0.0001,0.0001,0.5,757,747
12,1604,2,0,0.0001,0.0001,0.5,808,796
12,1704,2,0,0.0001,0.0001,0.5,852,852
12,1804,2,0,0.0001,0.0001,0.5,902,902
12,1904,2,0,0.0001,0.0001,0.5,952,952
13,0,2,0,0.0001,0.0001,0.5,0,0
13,104,2,0,0.0001,0.0001,0.5,46,58
13,204,2,0,0.0001,0.0001,0.5,95,109
13,304,2,0,0.0001,0.0001,0.5,148,156
13,404,2,0,0.0001,0.0001,0.5,199,205
13,504,2,0,0.0001,0.0001,0.5,243,261
13,604,2,0,0.0001,0.0001,0.5,291,313
13,704,2,0,0.0001,0.0001,0.5,349,355
13,804,2,0,0.0001,0.0001,0.5,404,400
13,904,2,0,0.0001,0.0001,0.5,451,453
13,1004,2,0,0.0001,0.0001,0.5,499,505
13,1104,2,0,0.0001,0.0001,0.5,551,553
13,1204,2,0,0.0001,0.0001,0.5,599,605
13,1304,2,0,0.0001,0.0001,0.5,647,657
13,1404,2,0,0.0001,0.0001,0.5,704,700
13,1504,2,0,0.0001,0.0001,0.5,746,758
13,1604,2,0,0.0001,0.0001,0.5,799,805
13,1704,2,0,0.0001,0.0001,0.5,852,852
13,1804,2,0,0.0001,0.0001,0.5,901,903
13,1904,2,0,0.0001,0.0001,0.5,952,952
14,0,2,0,0.0001,0.0001,0.5,0,0
14,104,2,0,0.0001,0.0001,0.5,49,55
14,204,2,0,0.0001,0.0001,0.5,97,107
14,304,2,0,0.0001,0.0001,0.5,148,156
14,404,2,0,0.0001,0.0001,0.5,211,193
14,504,2,0,0.0001,0.0001,0.5,263,241
14,604,2,0,0.0001,0.0001,0.5,308,296
14,704,2,0,0.0001,0.0001,0.5,366,338
14,804,2,0,0.0001,0.0001,0.5,414,390
14,904,2,0,0.0001,0.0001,0.5,465,439
14,1004,2,0,0.0001,0.0001,0.5,515,489
14,1104,2,0,0.0001,0.0001,0.5,559,545
14,1204,2,0,0.0001,0.0001,0.5,602,602
14,1304,2,0,0.0001,0.0001,0.5,658,646
14,1404,2,0,0.0001,0.0001,0.5,715,689
14,1504,2,0,0.0001,0.0001,0.5,766,738
14,1604,2,0,0.0001,0.0001,0.5,814,790
14,1704,2,0,0.0001,0.0001,0.5,866,838
14,1804,2,0,0.0001,0.0001,0.5,913,891
14,1904,2,0,0.0001,0.0001,0.5,952,952
15,0,2,0,0.0001,0.0001,0.5,0,0
15,104,2,0,0.0001,0.0001,0.5,51,53
15,204,2,0,0.0001,0.0001,0.5,105,99
15,304,2,0,0.0001,0.0001,0.5,155,149
15,404,2,0,0.0001,0.0001,0.5,204,200
15,504,2,0,0.0001,0.0001,0.5,251,253
15,604,2,0,0.0001,0.0001,0.5,301,303
15,704,2,0,0.0001,0.0001,0.5,346,358
15,804,2,0,0.0001,0.0001,0.5,403,401
15,904,2,0,0.0001,0.0001,0.5,455,449
15,1004,2,0,0.0001,0.0001,0.5,495,509
15,1104,2,0,0.0001,0.0001,0.5,534,570
15,1204,2,0,0.0001,0.0001,0.5,581,623
15,1304,2,0,0.0001,0.0001,0.5,637,667
15,1404,2,0,0.0001,0.0001,0.5,687,717
15,1504,2,0,0.0001,0.0001,0.5,734,770
15,1604,2,0,0.0001,0.0001,0.5,790,814
15,1704,2,0,0.0001,0.0001,0.5,838,866
15,1804,2,0,0.0001,0.0001,0.5,891,913
15,1904,2,0,0.0001,0.0001,0.5,952,952
16,0,2,0,0.0001,0.0001,0.504,0,0
16,104,2,0,0.0001,0.0001,0.504,53,51
16,204,2,0,0.0001,0.0001,0.504,105,99
16,304,2,0,0.0001,0.0001,0.504,153,151
16,404,2,0,0.0001,0.0001,0.504,192,212
16,504,2,0,0.0001,0.0001,0.504,246,258
16,604,2,0,0.0001,0.0001,0.504,296,308
16,704,2,0,0.0001,0.0001,0.504,346,358
16,804,2,0,0.0001,0.0001,0.504,403,401
16,904,2,0,0.0001,0.0001,0.506,446,458
16,1004,2,0,0.0001,0.0001,0.506,497,507
16,1104,2,0,0.0001,0.0001,0.506,546,558
16,1204,2,0,0.0001,0.0001,0.506,591,613
16,1304,2,0,0.0001,0.0001,0.506,636,668
16,1404,2,0,0.0001,0.0001,0.506,696,708
16,1504,2,0,0.0001,0.0001,0.506,753,751
16,1604,2,0,0.0001,0.0001,0.506,803,801
16,1704,2,0,0.0001,0.0001,0.506,855,849
16,1804,2,0,0.0001,0.0001,0.508,905,899
16,1904,2,0,0.0001,0.0001,0.51,952,952
17,0,2,0,0.0001,0.0001,0.5,0,0
17,104,2,0,0.0001,0.0001,0.5,53,51
17,204,2,0,0.0001,0.0001,0.5,98,106
17,304,2,0,0.0001,0.0001,0.5,144,160
17,404,2,0,0.0001,0.0001,0.5,190,214
17,504,2,0,0.0001,0.0001,0.5,228,276
17,604,2,0,0.0001,0.0001,0.5,281,323
17,704,2,0,0.0001,0.0001,0.5,336,368
17,804,2,0,0.0001,0.0001,0.5,390,414
17,904,2,0,0.0001,0.0001,0.5,442,462
17,1004,2,0,0.0001,0.0001,0.5,495,509
17,1104,2,0,0.0001,0.0001,0.5,545,559
17,1204,2,0,0.0001,0.0001,0.5,591,613
17,1304,2,0,0.0001,0.0001,0.5,649,655
17,1404,2,0,0.0001,0.0001,0.5,698,706
17,1504,2,0,0.0001,0.0001,0.5,743,761
17,1604,2,0,0.0001,0.0001,0.5,793,811
17,1704,2,0,0.0001,0.0001,0.5,847,857
17,1804,2,0,0.0001,0.0001,0.5,897,907
17,1904,2,0,0.0001,0.0001,0.5,952,952
18,0,2,0,0.0001,0.0001,0.5,0,0
18,104,2,0,0.0001,0.0001,0.5,51,53
18,204,2,0,0.0001,0.0001,0.5,104,100
18,304,2,0,0.0001,0.0001,0.5,163,141
18,404,2,0,0.0001,0.0001,0.5,222,182
18,504,2,0,0.0001,0.0001,0.5,271,233
18,604,2,0,0.0001,0.0001,0.5,318,286
18,704,2,0,0.0001,0.0001,0.5,369,335
18,804,2,0,0.0001,0.0001,0.5,417,387
18,904,2,0,0.0001,0.0001,0.5,461,443
18,1004,2,0,0.0001,0.0001,0.5,516,488
18,1104,2,0,0.0001,0.0001,0.5,566,538
18,1204,2,0,0.0001,0.0001,0.5,613,591
18,1304,2,0,0.0001,0.0001,0.5,663,641
18,1404,2,0,0.0001,0.0001,0.5,709,695
18,1504,2,0,0.0001,0.0001,0.5,759,745
18,1604,2,0,0.0001,0.0001,0.5,814,790
18,1704,2,0,0.0001,0.0001,0.5,865,839
18,1804,2,0,0.0001,0.0001,0.5,913,891
18,1904,2,0,0.0001,0.0001,0.5,952,952
19,0,2,0,0.0001,0.0001,0.5,0,0
19,104,2,0,0.0001,0.0001,0.5,51,53
19,204,2,0,0.0001,0.0001,0.5,102,102
19,304,2,0,0.0001,0.0001,0.5,151,153
19,404,2,0,0.0001,0.0001,0.5,200,204
19,504,2,0,0.0001,0.0001,0.5,253,251
19,604,2,0,0.0001,0.0001,0.5,311,293
19,704,2,0,0.0001,0.0001,0.5,360,344
19,804,2,0,0.0001,0.0001,0.5,406,398
19,904,2,0,0.0001,0.0001,0.5,463,441
19,1004,2,0,0.0001,0.0001,0.5,514,490
19,1104,2,0,0.0001,0.0001,0.5,561,543
19,1204,2,0,0.0001,0.0001,0.5,610,594
19,1304,2,0,0.0001,0.0001,0.5,655,649
19,1404,2,0,0.0001,0.0001,0.5,707,697
19,1504,2,0,0.0001,0.0001,0.5,762,742
19,1604,2,0,0.0001,0.0001,0.5,809,795
19,1704,2,0,0.0001,0.0001,0.5,852,852
19,1804,2,0,0.0001,0.0001,0.5,906,898
19,1904,2,0,0.0001,0.0001,0.5,952,952
20,0,2,0,0.0001,0.0001,0.52,0,0
20,104,2,0,0.0001,0.0001,0.52,53,51
20,204,2,0,0.0001,0.0001,0.518,107,97
20,304,2,0,0.0001,0.0001,0.518,152,152
20,404,2,0,0.0001,0.0001,0.518,199,205
20,504,2,0,0.0001,0.0001,0.52,246,258
20,604,2,0,0.0001,0.0001,0.518,293,311
20,704,2,0,0.0001,0.0001,0.518,341,363
20,804,2,0,0.0001,0.0001,0.512,389,415
20,904,2,0,0.0001,0.0001,0.518,433,471
20,1004,2,0,0.0001,0.0001,0.512,493,511
20,1104,2,0,0.0001,0.0001,0.512,541,563
20,1204,2,0,0.0001,0.0001,0.512,587,617
20,1304,2,0,0.0001,0.0001,0.504,642,662
20,1404,2,0,0.0001,0.0001,0.514,688,716
20,1504,2,0,0.0001,0.0001,0.514,735,769
20,1604,2,0,0.0001,0.0001,0.512,790,814
20,1704,2,0,0.0001,0.0001,0.512,847,857
20,1804,2,0,0.0001,0.0001,0.512,901,903
20,1904,2,0,0.0001,0.0001,0.512,952,952
1,0,2,0,0.0001,0.001,0.528,0,0
1,104,2,0,0.0001,0.001,0.528,53,51
1,204,2,0,0.0001,0.001,0.526,105,99
1,304,2,0,0.0001,0.001,0.526,158,146
1,404,2,0,0.0001,0.001,0.53,197,207
1,504,2,0,0.0001,0.001,0.53,248,256
1,604,2,0,0.0001,0.001,0.546,299,305
1,704,2,0,0.0001,0.001,0.556,346,358
1,804,2,0,0.0001,0.001,0.568,387,417
1,904,2,0,0.0001,0.001,0.58,442,462
1,1004,2,0,0.0001,0.001,0.586,492,512
1,1104,2,0,0.0001,0.001,0.582,546,558
1,1204,2,0,0.0001,0.001,0.576,598,606
1,1304,2,0,0.0001,0.001,0.582,653,651
1,1404,2,0,0.0001,0.001,0.582,701,703
1,1504,2,0,0.0001,0.001,0.588,753,751
1,1604,2,0,0.0001,0.001,0.59,799,805
1,1704,2,0,0.0001,0.001,0.594,853,851
1,1804,2,0,0.0001,0.001,0.596,901,903
1,1904,2,0,0.0001,0.001,0.596,952,952
2,0,2,0,0.0001,0.001,0.5,0,0
2,104,2,0,0.0001,0.001,0.5,53,51
2,204,2,0,0.0001,0.001,0.5,100,104
2,304,2,0,0.0001,0.001,0.5,147,157
2,404,2,0,0.0001,0.001,0.5,196,208
2,504,2,0,0.0001,0.001,0.5,248,256
2,604,2,0,0.0001,0.001,0.5,295,309
2,704,2,0,0.0001,0.001,0.5,345,359
2,804,2,0,0.0001,0.001,0.5,406,398
2,904,2,0,0.0001,0.001,0.5,448,456
2,1004,2,0,0.0001,0.001,0.502,501,503
2,1104,2,0,0.0001,0.001,0.494,556,548
2,1204,2,0,0.0001,0.001,0.5,605,599
2,1304,2,0,0.0001,0.001,0.504,652,652
2,1404,2,0,0.0001,0.001,0.502,707,697
2,1504,2,0,0.0001,0.001,0.488,756,748
2,1604,2,0,0.0001,0.001,0.49,808,796
2,1704,2,0,0.0001,0.001,0.504,852,852
2,1804,2,0,0.0001,0.001,0.508,908,896
2,1904,2,0,0.0001,0.001,0.51,952,952
3,0,2,0,0.0001,0.001,0.52,0,0
3,104,2,0,0.0001,0.001,0.52,57,47
3,204,2,0,0.0001,0.001,0.522,107,97
3,304,2,0,0.0001,0.001,0.522,157,147
3,404,2,0,0.0001,0.001,0.526,206,198
3,504,2,0,0.0001,0.001,0.524,252,252
3,604,2,0,0.0001,0.001,0.522,304,300
3,704,2,0,0.0001,0.001,0.524,360,344
3,804,2,0,0.0001,0.001,0.528,400,404
3,904,2,0,0.0001,0.001,0.528,456,448
3,1004,2,0,0.0001,0.001,0.53,515,489
3,1104,2,0,0.0001,0.001,0.528,561,543
3,1204,2,0,0.0001,0.001,0.526,608,596
3,1304,2,0,0.0001,0.001,0.528,653,651
3,1404,2,0,0.0001,0.001,0.53,703,701
3,1504,2,0,0.0001,0.001,0.532,755,749
3,1604,2,0,0.0001,0.001,0.53,807,797
3,1704,2,0,0.0001,0.001,0.536,857,847
3,1804,2,0,0.0001,0.001,0.53,906,898
3,1904,2,0,0.0001,0.001,0.528,952,952
4,0,2,0,0.0001,0.001,0.536,0,0
4,104,2,0,0.0001,0.001,0.536,55,49
4,204,2,0,0.0001,0.001,0.534,109,95
4,304,2,0,0.0001,0.001,0.534,158,146
4,404,2,0,0.0001,0.001,0.536,211,193
4,504,2,0,0.0001,0.001,0.536,262,242
4,604,2,0,0.0001,0.001,0.536,320,284
4,704,2,0,0.0001,0.001,0.52,363,341
4,804,2,0,0.0001,0.001,0.512,419,385
4,904,2,0,0.0001,0.001,0.518,464,440
4,1004,2,0,0.0001,0.001,0.514,512,492
4,1104,2,0,0.0001,0.001,0.512,556,548
4,1204,2,0,0.0001,0.001,0.524,609,595
4,1304,2,0,0.0001,0.001,0.516,662,642
4,1404,2,0,0.0001,0.001,0.512,705,699
4,1504,2,0,0.0001,0.001,0.514,749,755
4,1604,2,0,0.0001,0.001,0.528,800,804
4,1704,2,0,0.0001,0.001,0.522,851,853
4,1804,2,0,0.0001,0.001,0.524,899,905
4,1904,2,0,0.0001,0.001,0.528,952,952
5,0,2,0,0.0001,0.001,0.5,0,0
5,104,2,0,0.0001,0.001,0.5,53,51
5,204,2,0,0.0001,0.001,0.5,105,99
5,304,2,0,0.0001,0.001,0.5,149,155
5,404,2,0,0.0001,0.001,0.5,201,203
5,504,2,0,0.0001,0.001,0.5,258,246
5,604,2,0,0.0001,0.001,0.5,311,293
5,704,2,0,0.0001,0.001,0.5,359,345
5,804,2,0,0.0001,0.001,0.5,406,398
5,904,2,0,0.0001,0.001,0.5,459,445
5,1004,2,0,0.0001,0.001,0.5,501,503
5,1104,2,0,0.0001,0.001,0.5,546,558
5,1204,2,0,0.0001,0.001,0.496,594,610
5,1304,2,0,0.0001,0.001,0.492,643,661
5,1404,2,0,0.0001,0.001,0.484,699,705
5,1504,2,0,0.0001,0.001,0.478,743,761
5,1604,2,0,0.0001,0.001,0.476,792,812
5,1704,2,0,0.0001,0.001,0.472,846,858
5,1804,2,0,0.0001,0.001,0.484,895,909
5,1904,2,0,0.0001,0.001,0.48,952,952
6,0,2,0,0.0001,0.001,0.5,0,0
6,104,2,0,0.0001,0.001,0.51,51,53
6,204,2,0,0.0001,0.001,0.512,96,108
6,304,2,0,0.0001,0.001,0.512,148,156
6,404,2,0,0.0001,0.001,0.518,193,211
6,504,2,0,0.0001,0.001,0.522,248,256
6,604,2,0,0.0001,0.001,0.544,301,303
6,704,2,0,0.0001,0.001,0.552,349,355
6,804,2,0,0.0001,0.001,0.548,405,399
6,904,2,0,0.0001,0.001,0.546,456,448
6,1004,2,0,0.0001,0.001,0.548,505,499
6,1104,2,0,0.0001,0.001,0.546,552,552
6,1204,2,0,0.0001,0.001,0.546,600,604
6,1304,2,0,0.0001,0.001,0.548,651,653
6,1404,2,0,0.0001,0.001,0.554,704,700
6,1504,2,0,0.0001,0.001,0.538,751,753
6,1604,2,0,0.0001,0.001,0.54,799,805
6,1704,2,0,0.0001,0.001,0.546,845,859
6,1804,2,0,0.0001,0.001,0.542,897,907
6,1904,2,0,0.0001,0.001,0.542,952,952
7,0,2,0,0.0001,0.001,0.5,0,0
7,104,2,0,0.0001,0.001,0.5,49,55
7,204,2,0,0.0001,0.001,0.5,108,96
7,304,2,0,0.0001,0.001,0.5,151,153
7,404,2,0,0.0001,0.001,0.5,201,203
7,504,2,0,0.0001,0.001,0.5,252,252
7,604,2,0,0.0001,0.001,0.51,303,301
7,704,2,0,0.0001,0.001,0.522,357,347
7,804,2,0,0.0001,0.001,0.52,411,393
7,904,2,0,0.0001,0.001,0.522,465,439
7,1004,2,0,0.0001,0.001,0.516,513,491
7,1104,2,0,0.0001,0.001,0.51,566,538
7,1204,2,0,0.0001,0.001,0.498,613,591
7,1304,2,0,0.0001,0.001,0.518,660,644
7,1404,2,0,0.0001,0.001,0.518,709,695
7,1504,2,0,0.0001,0.001,0.52,750,754
7,1604,2,0,0.0001,0.001,0.48,803,801
7,1704,2,0,0.0001,0.001,0.51,853,851
7,1804,2,0,0.0001,0.001,0.512,901,903
7,1904,2,0,0.0001,0.001,0.512,952,952
8,0,2,0,0.0001,0.001,0.508,0,0
8,104,2,0,0.0001,0.001,0.508,55,49
8,204,2,0,0.0001,0.001,0.512,101,103
8,304,2,0,0.0001,0.001,0.52,155,149
8,404,2,0,0.0001,0.001,0.528,209,195
8,504,2,0,0.0001,0.001,0.526,261,243
8,604,2,0,0.0001,0.001,0.534,315,289
8,704,2,0,0.0001,0.001,0.536,364,340
8,804,2,0,0.0001,0.001,0.538,400,404
8,904,2,0,0.0001,0.001,0.542,449,455
8,1004,2,0,0.0001,0.001,0.558,496,508
8,1104,2,0,0.0001,0.001,0.558,556,548
8,1204,2,0,0.0001,0.001,0.564,601,603
8,1304,2,0,0.0001,0.001,0.564,657,647
8,1404,2,0,0.0001,0.001,0.57,710,694
8,1504,2,0,0.0001,0.001,0.568,758,746
8,1604,2,0,0.0001,0.001,0.568,813,791
8,1704,2,0,0.0001,0.001,0.572,854,850
8,1804,2,0,0.0001,0.001,0.568,906,898
8,1904,2,0,0.0001,0.001,0.562,952,952
9,0,2,0,0.0001,0.001,0.528,0,0
9,104,2,0,0.0001,0.001,0.526,48,56
9,204,2,0,0.0001,0.001,0.528,96,108
9,304,2,0,0.0001,0.001,0.528,157,147
9,404,2,0,0.0001,0.001,0.536,203,201
9,504,2,0,0.0001,0.001,0.53,252,252
9,604,2,0,0.0001,0.001,0.532,301,303
9,704,2,0,0.0001,0.001,0.526,348,356
9,804,2,0,0.0001,0.001,0.528,399,405
9,904,2,0,0.0001,0.001,0.526,448,456
9,1004,2,0,0.0001,0.001,0.532,500,504
9,1104,2,0,0.0001,0.001,0.536,554,550
9,1204,2,0,0.0001,0.001,0.53,610,594
9,1304,2,0,0.0001,0.001,0.532,661,643
9,1404,2,0,0.0001,0.001,0.512,702,702
9,1504,2,0,0.0001,0.001,0.516,757,747
9,1604,2,0,0.0001,0.001,0.512,806,798
9,1704,2,0,0.0001,0.001,0.518,851,853
9,1804,2,0,0.0001,0.001,0.524,892,912
9,1904,2,0,0.0001,0.001,0.534,952,952
10,0,2,0,0.0001,0.001,0.686,0,0
10,104,2,0,0.0001,0.001,0.684,50,54
10,204,2,0,0.0001,0.001,0.686,99,105
10,304,2,0,0.0001,0.001,0.684,158,146
10,404,2,0,0.0001,0.001,0.676,206,198
10,504,2,0,0.0001,0.001,0.676,247,257
10,604,2,0,0.0001,0.001,0.68,288,316
10,704,2,0,0.0001,0.001,0.68,341,363
10,804,2,0,0.0001,0.001,0.674,385,419
10,904,2,0,0.0001,0.001,0.674,439,465
10,1004,2,0,0.0001,0.001,0.664,485,519
10,1104,2,0,0.0001,0.001,0.664,532,572
10,1204,2,0,0.0001,0.001,0.66,582,622
10,1304,2,0,0.0001,0.001,0.656,635,669
10,1404,2,0,0.0001,0.001,0.652,683,721
10,1504,2,0,0.0001,0.001,0.648,734,770
10,1604,2,0,0.0001,0.001,0.642,796,808
10,1704,2,0,0.0001,0.001,0.638,849,855
10,1804,2,0,0.0001,0.001,0.636,895,909
10,1904,2,0,0.0001,0.001,0.632,952,952
11,0,2,0,0.0001,0.001,0.478,0,0
11,104,2,0,0.0001,0.001,0.478,53,51
11,204,2,0,0.0001,0.001,0.48,103,101
11,304,2,0,0.0001,0.001,0.48,152,152
11,404,2,0,0.0001,0.001,0.482,195,209
11,504,2,0,0.0001,0.001,0.502,241,263
11,604,2,0,0.0001,0.001,0.506,290,314
11,704,2,0,0.0001,0.001,0.506,343,361
11,804,2,0,0.0001,0.001,0.514,397,407
11,904,2,0,0.0001,0.001,0.53,447,457
11,1004,2,0,0.0001,0.001,0.556,499,505
11,1104,2,0,0.0001,0.001,0.56,546,558
11,1204,2,0,0.0001,0.001,0.578,597,607
11,1304,2,0,0.0001,0.001,0.61,646,658
11,1404,2,0,0.0001,0.001,0.616,689,715
11,1504,2,0,0.0001,0.001,0.62,747,757
11,1604,2,0,0.0001,0.001,0.624,796,808
11,1704,2,0,0.0001,0.001,0.622,845,859
11,1804,2,0,0.0001,0.001,0.624,898,906
11,1904,2,0,0.0001,0.001,0.624,952,952
12,0,2,0,0.0001,0.001,0.546,0,0
12,104,2,0,0.0001,0.001,0.546,44,60
12,204,2,0,0.0001,0.001,0.548,96,108
12,304,2,0,0.0001,0.001,0.554,152,152
12,404,2,0,0.0001,0.001,0.562,199,205
12,504,2,0,0.0001,0.001,0.568,256,248
12,604,2,0,0.0001,0.001,0.578,314,290
12,704,2,0,0.0001,0.001,0.572,373,331
12,804,2,0,0.0001,0.001,0.574,420,384
12,904,2,0,0.0001,0.001,0.58,468,436
12,1004,2,0,0.0001,0.001,0.572,523,481
12,1104,2,0,0.0001,0.001,0.56,570,534
12,1204,2,0,0.0001,0.001,0.572,619,585
12,1304,2,0,0.0001,0.001,0.582,669,635
12,1404,2,0,0.0001,0.001,0.582,725,679
12,1504,2,0,0.0001,0.001,0.584,766,738
12,1604,2,0,0.0001,0.001,0.582,809,795
12,1704,2,0,0.0001,0.001,0.582,849,855
12,1804,2,0,0.0001,0.001,0.588,901,903
12,1904,2,0,0.0001,0.001,0.592,952,952
13,0,2,0,0.0001,0.001,0.506,0,0
13,104,2,0,0.0001,0.001,0.506,50,54
13,204,2,0,0.0001,0.001,0.508,98,106
13,304,2,0,0.0001,0.001,0.524,145,159
13,404,2,0,0.0001,0.001,0.498,197,207
13,504,2,0,0.0001,0.001,0.498,247,257
13,604,2,0,0.0001,0.001,0.498,294,310
13,704,2,0,0.0001,0.001,0.508,342,362
13,804,2,0,0.0001,0.001,0.5,382,422
13,904,2,0,0.0001,0.001,0.5,429,475
13,1004,2,0,0.0001,0.001,0.5,484,520
13,1104,2,0,0.0001,0.001,0.5,535,569
13,1204,2,0,0.0001,0.001,0.5,588,616
13,1304,2,0,0.0001,0.001,0.508,643,661
13,1404,2,0,0.0001,0.001,0.508,691,713
13,1504,2,0,0.0001,0.001,0.504,738,766
13,1604,2,0,0.0001,0.001,0.5,797,807
13,1704,2,0,0.0001,0.001,0.496,850,854
13,1804,2,0,0.0001,0.001,0.48,902,902
13,1904,2,0,0.0001,0.001,0.492,952,952
14,0,2,0,0.0001,0.001,0.644,0,0
14,104,2,0,0.0001,0.001,0.644,54,50
14,204,2,0,0.0001,0.001,0.644,103,101
14,304,2,0,0.0001,0.001,0.642,154,150
14,404,2,0,0.0001,0.001,0.638,205,199
14,504,2,0,0.0001,0.001,0.638,264,240
14,604,2,0,0.0001,0.001,0.64,309,295
14,704,2,0,0.0001,0.001,0.636,357,347
14,804,2,0,0.0001,0.001,0.638,403,401
14,904,2,0,0.0001,0.001,0.64,456,448
14,1004,2,0,0.0001,0.001,0.64,503,501
14,1104,2,0,0.0001,0.001,0.642,555,549
14,1204,2,0,0.0001,0.001,0.642,607,597
14,1304,2,0,0.0001,0.001,0.642,649,655
14,1404,2,0,0.0001,0.001,0.642,712,692
14,1504,2,0,0.0001,0.001,0.644,750,754
14,1604,2,0,0.0001,0.001,0.644,798,806
14,1704,2,0,0.0001,0.001,0.642,857,847
14,1804,2,0,0.0001,0.001,0.644,903,901
14,1904,2,0,0.0001,0.001,0.648,952,952
15,0,2,0,0.0001,0.001,0.508,0,0
15,104,2,0,0.0001,0.001,0.508,49,55
15,204,2,0,0.0001,0.001,0.508,111,93
15,304,2,0,0.0001,0.001,0.504,165,139
15,404,2,0,0.0001,0.001,0.506,220,184
15,504,2,0,0.0001,0.001,0.504,265,239
15,604,2,0,0.0001,0.001,0.504,322,282
15,704,2,0,0.0001,0.001,0.502,371,333
15,804,2,0,0.0001,0.001,0.504,420,384
15,904,2,0,0.0001,0.001,0.504,462,442
15,1004,2,0,0.0001,0.001,0.506,512,492
15,1104,2,0,0.0001,0.001,0.506,556,548
15,1204,2,0,0.0001,0.001,0.52,601,603
15,1304,2,0,0.0001,0.001,0.522,656,648
15,1404,2,0,0.0001,0.001,0.524,707,697
15,1504,2,0,0.0001,0.001,0.522,759,745
15,1604,2,0,0.0001,0.001,0.526,804,800
15,1704,2,0,0.0001,0.001,0.526,852,852
15,1804,2,0,0.0001,0.001,0.526,902,902
15,1904,2,0,0.0001,0.001,0.532,952,952
16,0,2,0,0.0001,0.001,0.49,0,0
16,104,2,0,0.0001,0.001,0.488,55,49
16,204,2,0,0.0001,0.001,0.486,97,107
16,304,2,0,0.0001,0.001,0.486,151,153
16,404,2,0,0.0001,0.001,0.484,204,200
16,504,2,0,0.0001,0.001,0.48,263,241
16,604,2,0,0.0001,0.001,0.476,312,292
16,704,2,0,0.0001,0.001,0.484,352,352
16,804,2,0,0.0001,0.001,0.496,400,404
16,904,2,0,0.0001,0.001,0.512,465,439
16,1004,2,0,0.0001,0.001,0.518,515,489
16,1104,2,0,0.0001,0.001,0.516,555,549
16,1204,2,0,0.0001,0.001,0.514,604,600
16,1304,2,0,0.0001,0.001,0.516,661,643
16,1404,2,0,0.0001,0.001,0.516,720,684
16,1504,2,0,0.0001,0.001,0.522,761,743
16,1604,2,0,0.0001,0.001,0.534,809,795
16,1704,2,0,0.0001,0.001,0.51,851,853
16,1804,2,0,0.0001,0.001,0.522,897,907
16,1904,2,0,0.0001,0.001,0.548,952,952
17,0,2,0,0.0001,0.001,0.496,0,0
17,104,2,0,0.0001,0.001,0.494,49,55
17,204,2,0,0.0001,0.001,0.496,97,107
17,304,2,0,0.0001,0.001,0.506,148,156
17,404,2,0,0.0001,0.001,0.52,198,206
17,504,2,0,0.0001,0.001,0.536,249,255
17,604,2,0,0.0001,0.001,0.548,301,303
17,704,2,0,0.0001,0.001,0.566,353,351
17,804,2,0,0.0001,0.001,0.568,397,407
17,904,2,0,0.0001,0.001,0.58,449,455
17,1004,2,0,0.0001,0.001,0.588,498,506
17,1104,2,0,0.0001,0.001,0.588,549,555
17,1204,2,0,0.0001,0.001,0.588,599,605
17,1304,2,0,0.0001,0.001,0.584,649,655
17,1404,2,0,0.0001,0.001,0.59,701,703
17,1504,2,0,0.0001,0.001,0.59,757,747
17,1604,2,0,0.0001,0.001,0.586,809,795
17,1704,2,0,0.0001,0.001,0.586,855,849
17,1804,2,0,0.0001,0.001,0.586,911,893
17,1904,2,0,0.0001,0.001,0.582,952,952
18,0,2,0,0.0001,0.001,0.506,0,0
18,104,2,0,0.0001,0.001,0.506,45,59
18,204,2,0,0.0001,0.001,0.506,86,118
18,304,2,0,0.0001,0.001,0.506,134,170
18,404,2,0,0.0001,0.001,0.504,186,218
18,504,2,0,0.0001,0.001,0.506,241,263
18,604,2,0,0.0001,0.001,0.506,296,308
18,704,2,0,0.0001,0.001,0.506,348,356
18,804,2,0,0.0001,0.001,0.506,405,399
18,904,2,0,0.0001,0.001,0.508,454,450
18,1004,2,0,0.0001,0.001,0.506,503,501
18,1104,2,0,0.0001,0.001,0.506,552,552
18,1204,2,0,0.0001,0.001,0.506,597,607
18,1304,2,0,0.0001,0.001,0.506,647,657
18,1404,2,0,0.0001,0.001,0.506,701,703
18,1504,2,0,0.0001,0.001,0.508,758,746
18,1604,2,0,0.0001,0.001,0.506,805,799
18,1704,2,0,0.0001,0.001,0.506,856,848
18,1804,2,0,0.0001,0.001,0.512,906,898
18,1904,2,0,0.0001,0.001,0.506,952,952
19,0,2,0,0.0001,0.001,0.528,0,0
19,104,2,0,0.0001,0.001,0.528,52,52
19,204,2,0,0.0001,0.001,0.53,104,100
19,304,2,0,0.0001,0.001,0.53,150,154
19,404,2,0,0.0001,0.001,0.526,197,207
19,504,2,0,0.0001,0.001,0.526,245,259
19,604,2,0,0.0001,0.001,0.528,295,309
19,704,2,0,0.0001,0.001,0.526,347,357
19,804,2,0,0.0001,0.001,0.526,394,410
19,904,2,0,0.0001,0.001,0.528,437,467
19,1004,2,0,0.0001,0.001,0.528,494,510
19,1104,2,0,0.0001,0.001,0.528,547,557
19,1204,2,0,0.0001,0.001,0.528,597,607
19,1304,2,0,0.0001,0.001,0.528,639,665
19,1404,2,0,0.0001,0.001,0.528,693,711
19,1504,2,0,0.0001,0.001,0.528,736,768
19,1604,2,0,0.0001,0.001,0.528,795,809
19,1704,2,0,0.0001,0.001,0.528,850,854
19,1804,2,0,0.0001,0.001,0.528,900,904
19,1904,2,0,0.0001,0.001,0.528,952,952
20,0,2,0,0.0001,0.001,0.508,0,0
20,104,2,0,0.0001,0.001,0.512,51,53
20,204,2,0,0.0001,0.001,0.516,104,100
20,304,2,0,0.0001,0.001,0.52,148,156
20,404,2,0,0.0001,0.001,0.528,189,215
20,504,2,0,0.0001,0.001,0.546,244,260
20,604,2,0,0.0001,0.001,0.568,294,310
20,704,2,0,0.0001,0.001,0.522,340,364
20,804,2,0,0.0001,0.001,0.526,389,415
20,904,2,0,0.0001,0.001,0.506,447,457
20,1004,2,0,0.0001,0.001,0.528,503,501
20,1104,2,0,0.0001,0.001,0.528,552,552
20,1204,2,0,0.0001,0.001,0.528,600,604
20,1304,2,0,0.0001,0.001,0.526,659,645
20,1404,2,0,0.0001,0.001,0.53,711,693
20,1504,2,0,0.0001,0.001,0.536,759,745
20,1604,2,0,0.0001,0.001,0.532,808,796
20,1704,2,0,0.0001,0.001,0.532,855,849
20,1804,2,0,0.0001,0.001,0.528,906,898
20,1904,2,0,0.0001,0.001,0.534,952,952
1,0,2,0,0.0001,0.01,0.496,0,0
1,104,2,0,0.0001,0.01,0.498,57,47
1,204,2,0,0.0001,0.01,0.504,110,94
1,304,2,0,0.0001,0.01,0.496,162,142
1,404,2,0,0.0001,0.01,0.502,211,193
1,504,2,0,0.0001,0.01,0.5,261,243
1,604,2,0,0.0001,0.01,0.5,304,300
1,704,2,0,0.0001,0.01,0.5,357,347
1,804,2,0,0.0001,0.01,0.5,407,397
1,904,2,0,0.0001,0.01,0.5,456,448
1,1004,2,0,0.0001,0.01,0.5,504,500
1,1104,2,0,0.0001,0.01,0.5,543,561
1,1204,2,0,0.0001,0.01,0.5,598,606
1,1304,2,0,0.0001,0.01,0.5,654,650
1,1404,2,0,0.0001,0.01,0.5,704,700
1,1504,2,0,0.0001,0.01,0.5,752,752
1,1604,2,0,0.0001,0.01,0.5,798,806
1,1704,2,0,0.0001,0.01,0.5,847,857
1,1804,2,0,0.0001,0.01,0.5,898,906
1,1904,2,0,0.0001,0.01,0.5,952,952
2,0,2,0,0.0001,0.01,0.674,0,0
2,104,2,0,0.0001,0.01,0.662,49,55
2,204,2,0,0.0001,0.01,0.606,100,104
2,304,2,0,0.0001,0.01,0.614,154,150
2,404,2,0,0.0001,0.01,0.616,202,202
2,504,2,0,0.0001,0.01,0.726,247,257
2,604,2,0,0.0001,0.01,0.678,295,309
2,704,2,0,0.0001,0.01,0.674,341,363
2,804,2,0,0.0001,0.01,0.718,392,412
2,904,2,0,0.0001,0.01,0.702,437,467
2,1004,2,0,0.0001,0.01,0.684,481,523
2,1104,2,0,0.0001,0.01,0.732,528,576
2,1204,2,0,0.0001,0.01,0.722,581,623
2,1304,2,0,0.0001,0.01,0.716,629,675
2,1404,2,0,0.0001,0.01,0.694,682,722
2,1504,2,0,0.0001,0.01,0.676,732,772
2,1604,2,0,0.0001,0.01,0.658,788,816
2,1704,2,0,0.0001,0.01,0.716,848,856
2,1804,2,0,0.0001,0.01,0.672,897,907
2,1904,2,0,0.0001,0.01,0.658,952,952
3,0,2,0,0.0001,0.01,0.746,0,0
3,104,2,0,0.0001,0.01,0.748,54,50
3,204,2,0,0.0001,0.01,0.688,101,103
3,304,2,0,0.0001,0.01,0.626,154,150
3,404,2,0,0.0001,0.01,0.648,205,199
3,504,2,0,0.0001,0.01,0.706,259,245
3,604,2,0,0.0001,0.01,0.674,307,297
3,704,2,0,0.0001,0.01,0.694,365,339
3,804,2,0,0.0001,0.01,0.702,416,388
3,904,2,0,0.0001,0.01,0.728,463,441
3,1004,2,0,0.0001,0.01,0.71,516,488
3,1104,2,0,0.0001,0.01,0.732,566,538
3,1204,2,0,0.0001,0.01,0.724,613,591
3,1304,2,0,0.0001,0.01,0.726,666,638
3,1404,2,0,0.0001,0.01,0.732,715,689
3,1504,2,0,0.0001,0.01,0.756,753,751
3,1604,2,0,0.0001,0.01,0.742,799,805
3,1704,2,0,0.0001,0.01,0.748,853,851
3,1804,2,0,0.0001,0.01,0.746,909,895
3,1904,2,0,0.0001,0.01,0.742,952,952
4,0,2,0,0.0001,0.01,0.508,0,0
4,104,2,0,0.0001,0.01,0.508,44,60
4,204,2,0,0.0001,0.01,0.504,92,112
4,304,2,0,0.0001,0.01,0.508,147,157
4,404,2,0,0.0001,0.01,0.51,189,215
4,504,2,0,0.0001,0.01,0.502,240,264
4,604,2,0,0.0001,0.01,0.506,295,309
4,704,2,0,0.0001,0.01,0.504,348,356
4,804,2,0,0.0001,0.01,0.504,399,405
4,904,2,0,0.0001,0.01,0.5,452,452
4,1004,2,0,0.0001,0.01,0.5,511,493
4,1104,2,0,0.0001,0.01,0.5,567,537
4,1204,2,0,0.0001,0.01,0.5,613,591
4,1304,2,0,0.0001,0.01,0.5,667,637
4,1404,2,0,0.0001,0.01,0.5,716,688
4,1504,2,0,0.0001,0.01,0.5,759,745
4,1604,2,0,0.0001,0.01,0.5,806,798
4,1704,2,0,0.0001,0.01,0.5,857,847
4,1804,2,0,0.0001,0.01,0.506,901,903
4,1904,2,0,0.0001,0.01,0.5,952,952
5,0,2,0,0.0001,0.01,0.536,0,0
5,104,2,0,0.0001,0.01,0.546,48,56
5,204,2,0,0.0001,0.01,0.526,91,113
5,304,2,0,0.0001,0.01,0.506,148,156
5,404,2,0,0.0001,0.01,0.504,195,209
5,504,2,0,0.0001,0.01,0.542,243,261
5,604,2,0,0.0001,0.01,0.488,287,317
5,704,2,0,0.0001,0.01,0.46,334,370
5,804,2,0,0.0001,0.01,0.464,389,415
5,904,2,0,0.0001,0.01,0.468,437,467
5,1004,2,0,0.0001,0.01,0.48,492,512
5,1104,2,0,0.0001,0.01,0.48,535,569
5,1204,2,0,0.0001,0.01,0.484,581,623
5,1304,2,0,0.0001,0.01,0.462,639,665
5,1404,2,0,0.0001,0.01,0.47,688,716
5,1504,2,0,0.0001,0.01,0.456,738,766
5,1604,2,0,0.0001,0.01,0.464,796,808
5,1704,2,0,0.0001,0.01,0.48,843,861
5,1804,2,0,0.0001,0.01,0.48,901,903
5,1904,2,0,0.0001,0.01,0.474,952,952
6,0,2,0,0.0001,0.01,0.536,0,0
6,104,2,0,0.0001,0.01,0.536,53,51
6,204,2,0,0.0001,0.01,0.536,99,105
6,304,2,0,0.0001,0.01,0.54,149,155
6,404,2,0,0.0001,0.01,0.518,193,211
6,504,2,0,0.0001,0.01,0.508,243,261
6,604,2,0,0.0001,0.01,0.502,301,303
6,704,2,0,0.0001,0.01,0.504,352,352
6,804,2,0,0.0001,0.01,0.5,408,396
6,904,2,0,0.0001,0.01,0.5,452,452
6,1004,2,0,0.0001,0.01,0.5,498,506
6,1104,2,0,0.0001,0.01,0.51,541,563
6,1204,2,0,0.0001,0.01,0.508,594,610
6,1304,2,0,0.0001,0.01,0.506,642,662
6,1404,2,0,0.0001,0.01,0.506,693,711
6,1504,2,0,0.0001,0.01,0.508,742,762
6,1604,2,0,0.0001,0.01,0.506,795,809
6,1704,2,0,0.0001,0.01,0.506,851,853
6,1804,2,0,0.0001,0.01,0.5,899,905
6,1904,2,0,0.0001,0.01,0.5,952,952
7,0,2,0,0.0001,0.01,0.482,0,0
7,104,2,0,0.0001,0.01,0.478,45,59
7,204,2,0,0.0001,0.01,0.48,107,97
7,304,2,0,0.0001,0.01,0.464,158,146
7,404,2,0,0.0001,0.01,0.48,205,199
7,504,2,0,0.0001,0.01,0.49,259,245
7,604,2,0,0.0001,0.01,0.494,310,294
7,704,2,0,0.0001,0.01,0.482,356,348
7,804,2,0,0.0001,0.01,0.476,400,404
7,904,2,0,0.0001,0.01,0.502,441,463
7,1004,2,0,0.0001,0.01,0.486,496,508
7,1104,2,0,0.0001,0.01,0.482,541,563
7,1204,2,0,0.0001,0.01,0.488,589,615
7,1304,2,0,0.0001,0.01,0.494,642,662
7,1404,2,0,0.0001,0.01,0.484,694,710
7,1504,2,0,0.0001,0.01,0.482,743,761
7,1604,2,0,0.0001,0.01,0.486,791,813
7,1704,2,0,0.0001,0.01,0.484,844,860
7,1804,2,0,0.0001,0.01,0.478,898,906
7,1904,2,0,0.0001,0.01,0.478,952,952
8,0,2,0,0.0001,0.01,0.736,0,0
8,104,2,0,0.0001,0.01,0.706,58,46
8,204,2,0,0.0001,0.01,0.656,114,90
8,304,2,0,0.0001,0.01,0.574,168,136
8,404,2,0,0.0001,0.01,0.612,212,192
8,504,2,0,0.0001,0.01,0.726,256,248
8,604,2,0,0.0001,0.01,0.632,302,302
8,704,2,0,0.0001,0.01,0.748,359,345
8,804,2,0,0.0001,0.01,0.768,405,399
8,904,2,0,0.0001,0.01,0.74,459,445
8,1004,2,0,0.0001,0.01,0.758,506,498
8,1104,2,0,0.0001,0.01,0.764,551,553
8,1204,2,0,0.0001,0.01,0.752,601,603
8,1304,2,0,0.0001,0.01,0.756,656,648
8,1404,2,0,0.0001,0.01,0.754,706,698
8,1504,2,0,0.0001,0.01,0.746,750,754
8,1604,2,0,0.0001,0.01,0.75,800,804
8,1704,2,0,0.0001,0.01,0.752,853,851
8,1804,2,0,0.0001,0.01,0.758,902,902
8,1904,2,0,0.0001,0.01,0.752,952,952
9,0,2,0,0.0001,0.01,0.736,0,0
9,104,2,0,0.0001,0.01,0.728,56,48
9,204,2,0,0.0001,0.01,0.714,104,100
9,304,2,0,0.0001,0.01,0.688,154,150
9,404,2,0,0.0001,0.01,0.648,209,195
9,504,2,0,0.0001,0.01,0.592,260,244
9,604,2,0,0.0001,0.01,0.568,306,298
9,704,2,0,0.0001,0.01,0.542,354,350
9,804,2,0,0.0001,0.01,0.58,408,396
9,904,2,0,0.0001,0.01,0.594,464,440
9,1004,2,0,0.0001,0.01,0.698,514,490
9,1104,2,0,0.0001,0.01,0.684,566,538
9,1204,2,0,0.0001,0.01,0.73,620,584
9,1304,2,0,0.0001,0.01,0.714,671,633
9,1404,2,0,0.0001,0.01,0.644,723,681
9,1504,2,0,0.0001,0.01,0.698,772,732
9,1604,2,0,0.0001,0.01,0.706,821,783
9,1704,2,0,0.0001,0.01,0.768,865,839
9,1804,2,0,0.0001,0.01,0.708,911,893
9,1904,2,0,0.0001,0.01,0.724,952,952
10,0,2,0,0.0001,0.01,0.5,0,0
10,104,2,0,0.0001,0.01,0.5,64,40
10,204,2,0,0.0001,0.01,0.5,112,92
10,304,2,0,0.0001,0.01,0.5,160,144
10,404,2,0,0.0001,0.01,0.5,200,204
10,504,2,0,0.0001,0.01,0.5,250,254
10,604,2,0,0.0001,0.01,0.5,297,307
10,704,2,0,0.0001,0.01,0.5,351,353
10,804,2,0,0.0001,0.01,0.5,403,401
10,904,2,0,0.0001,0.01,0.5,448,456
10,1004,2,0,0.0001,0.01,0.5,498,506
10,1104,2,0,0.0001,0.01,0.5,541,563
10,1204,2,0,0.0001,0.01,0.5,587,617
10,1304,2,0,0.0001,0.01,0.5,642,662
10,1404,2,0,0.0001,0.01,0.5,695,709
10,1504,2,0,0.0001,0.01,0.5,749,755
10,1604,2,0,0.0001,0.01,0.5,803,801
10,1704,2,0,0.0001,0.01,0.5,844,860
10,1804,2,0,0.0001,0.01,0.5,895,909
10,1904,2,0,0.0001,0.01,0.5,952,952
11,0,2,0,0.0001,0.01,0.5,0,0
11,104,2,0,0.0001,0.01,0.5,54,50
11,204,2,0,0.0001,0.01,0.5,102,102
11,304,2,0,0.0001,0.01,0.5,151,153
11,404,2,0,0.0001,0.01,0.5,198,206
11,504,2,0,0.0001,0.01,0.488,234,270
11,604,2,0,0.0001,0.01,0.5,284,320
11,704,2,0,0.0001,0.01,0.5,329,375
11,804,2,0,0.0001,0.01,0.5,366,438
11,904,2,0,0.0001,0.01,0.5,417,487
11,1004,2,0,0.0001,0.01,0.5,476,528
11,1104,2,0,0.0001,0.01,0.5,529,575
11,1204,2,0,0.0001,0.01,0.5,585,619
11,1304,2,0,0.0001,0.01,0.5,638,666
11,1404,2,0,0.0001,0.01,0.5,690,714
11,1504,2,0,0.0001,0.01,0.5,741,763
11,1604,2,0,0.0001,0.01,0.522,801,803
11,1704,2,0,0.0001,0.01,0.498,852,852
11,1804,2,0,0.0001,0.01,0.5,901,903
11,1904,2,0,0.0001,0.01,0.5,952,952
12,0,2,0,0.0001,0.01,0.724,0,0
12,104,2,0,0.0001,0.01,0.714,47,57
12,204,2,0,0.0001,0.01,0.714,95,109
12,304,2,0,0.0001,0.01,0.674,153,151
12,404,2,0,0.0001,0.01,0.652,193,211
12,504,2,0,0.0001,0.01,0.586,235,269
12,604,2,0,0.0001,0.01,0.574,290,314
12,704,2,0,0.0001,0.01,0.496,341,363
12,804,2,0,0.0001,0.01,0.492,387,417
12,904,2,0,0.0001,0.01,0.612,433,471
12,1004,2,0,0.0001,0.01,0.678,488,516
12,1104,2,0,0.0001,0.01,0.7,543,561
12,1204,2,0,0.0001,0.01,0.66,592,612
12,1304,2,0,0.0001,0.01,0.632,646,658
12,1404,2,0,0.0001,0.01,0.678,691,713
12,1504,2,0,0.0001,0.01,0.678,740,764
12,1604,2,0,0.0001,0.01,0.658,788,816
12,1704,2,0,0.0001,0.01,0.648,841,863
12,1804,2,0,0.0001,0.01,0.634,899,905
12,1904,2,0,0.0001,0.01,0.658,952,952
13,0,2,0,0.0001,0.01,0.49,0,0
13,104,2,0,0.0001,0.01,0.484,55,49
13,204,2,0,0.0001,0.01,0.498,103,101
13,304,2,0,0.0001,0.01,0.442,160,144
13,404,2,0,0.0001,0.01,0.5,205,199
13,504,2,0,0.0001,0.01,0.5,260,244
13,604,2,0,0.0001,0.01,0.48,304,300
13,704,2,0,0.0001,0.01,0.49,348,356
13,804,2,0,0.0001,0.01,0.502,396,408
13,904,2,0,0.0001,0.01,0.484,439,465
13,1004,2,0,0.0001,0.01,0.488,488,516
13,1104,2,0,0.0001,0.01,0.494,541,563
13,1204,2,0,0.0001,0.01,0.484,589,615
13,1304,2,0,0.0001,0.01,0.466,644,660
13,1404,2,0,0.0001,0.01,0.476,698,706
13,1504,2,0,0.0001,0.01,0.48,746,758
13,1604,2,0,0.0001,0.01,0.488,805,799
13,1704,2,0,0.0001,0.01,0.478,849,855
13,1804,2,0,0.0001,0.01,0.484,903,901
13,1904,2,0,0.0001,0.01,0.488,952,952
14,0,2,0,0.0001,0.01,0.718,0,0
14,104,2,0,0.0001,0.01,0.71,49,55
14,204,2,0,0.0001,0.01,0.656,100,104
14,304,2,0,0.0001,0.01,0.61,149,155
14,404,2,0,0.0001,0.01,0.602,194,210
14,504,2,0,0.0001,0.01,0.658,247,257
14,604,2,0,0.0001,0.01,0.624,298,306
14,704,2,0,0.0001,0.01,0.628,344,360
14,804,2,0,0.0001,0.01,0.716,397,407
14,904,2,0,0.0001,0.01,0.72,457,447
14,1004,2,0,0.0001,0.01,0.708,499,505
14,1104,2,0,0.0001,0.01,0.736,550,554
14,1204,2,0,0.0001,0.01,0.722,598,606
14,1304,2,0,0.0001,0.01,0.72,647,657
14,1404,2,0,0.0001,0.01,0.726,699,705
14,1504,2,0,0.0001,0.01,0.728,756,748
14,1604,2,0,0.0001,0.01,0.724,802,802
14,1704,2,0,0.0001,0.01,0.724,851,853
14,1804,2,0,0.0001,0.01,0.726,902,902
14,1904,2,0,0.0001,0.01,0.72,952,952
15,0,2,0,0.0001,0.01,0.74,0,0
15,104,2,0,0.0001,0.01,0.74,51,53
15,204,2,0,0.0001,0.01,0.734,90,114
15,304,2,0,0.0001,0.01,0.718,137,167
15,404,2,0,0.0001,0.01,0.716,194,210
15,504,2,0,0.0001,0.01,0.704,240,264
15,604,2,0,0.0001,0.01,0.666,290,314
15,704,2,0,0.0001,0.01,0.636,346,358
15,804,2,0,0.0001,0.01,0.606,405,399
15,904,2,0,0.0001,0.01,0.598,448,456
15,1004,2,0,0.0001,0.01,0.606,502,502
15,1104,2,0,0.0001,0.01,0.606,552,552
15,1204,2,0,0.0001,0.01,0.6,606,598
15,1304,2,0,0.0001,0.01,0.59,655,649
15,1404,2,0,0.0001,0.01,0.586,704,700
15,1504,2,0,0.0001,0.01,0.564,751,753
15,1604,2,0,0.0001,0.01,0.54,796,808
15,1704,2,0,0.0001,0.01,0.526,853,851
15,1804,2,0,0.0001,0.01,0.53,901,903
15,1904,2,0,0.0001,0.01,0.53,952,952
16,0,2,0,0.0001,0.01,0.492,0,0
16,104,2,0,0.0001,0.01,0.492,48,56
16,204,2,0,0.0001,0.01,0.486,96,108
16,304,2,0,0.0001,0.01,0.488,151,153
16,404,2,0,0.0001,0.01,0.492,202,202
16,504,2,0,0.0001,0.01,0.494,258,246
16,604,2,0,0.0001,0.01,0.494,307,297
16,704,2,0,0.0001,0.01,0.492,350,354
16,804,2,0,0.0001,0.01,0.494,396,408
16,904,2,0,0.0001,0.01,0.5,451,453
16,1004,2,0,0.0001,0.01,0.5,501,503
16,1104,2,0,0.0001,0.01,0.494,553,551
16,1204,2,0,0.0001,0.01,0.492,608,596
16,1304,2,0,0.0001,0.01,0.488,662,642
16,1404,2,0,0.0001,0.01,0.5,715,689
16,1504,2,0,0.0001,0.01,0.5,759,745
16,1604,2,0,0.0001,0.01,0.494,803,801
16,1704,2,0,0.0001,0.01,0.492,853,851
16,1804,2,0,0.0001,0.01,0.496,902,902
16,1904,2,0,0.0001,0.01,0.498,952,952
17,0,2,0,0.0001,0.01,0.522,0,0
17,104,2,0,0.0001,0.01,0.518,51,53
17,204,2,0,0.0001,0.01,0.518,105,99
17,304,2,0,0.0001,0.01,0.506,156,148
17,404,2,0,0.0001,0.01,0.512,205,199
17,504,2,0,0.0001,0.01,0.506,255,249
17,604,2,0,0.0001,0.01,0.51,306,298
17,704,2,0,0.0001,0.01,0.508,354,350
17,804,2,0,0.0001,0.01,0.5,411,393
17,904,2,0,0.0001,0.01,0.5,462,442
17,1004,2,0,0.0001,0.01,0.5,508,496
17,1104,2,0,0.0001,0.01,0.5,567,537
17,1204,2,0,0.0001,0.01,0.5,619,585
17,1304,2,0,0.0001,0.01,0.5,672,632
17,1404,2,0,0.0001,0.01,0.5,719,685
17,1504,2,0,0.0001,0.01,0.5,765,739
17,1604,2,0,0.0001,0.01,0.5,809,795
17,1704,2,0,0.0001,0.01,0.5,851,853
17,1804,2,0,0.0001,0.01,0.504,901,903
17,1904,2,0,0.0001,0.01,0.504,952,952
18,0,2,0,0.0001,0.01,0.5,0,0
18,104,2,0,0.0001,0.01,0.5,52,52
18,204,2,0,0.0001,0.01,0.5,101,103
18,304,2,0,0.0001,0.01,0.5,146,158
18,404,2,0,0.0001,0.01,0.5,195,209
18,504,2,0,0.0001,0.01,0.5,243,261
18,604,2,0,0.0001,0.01,0.5,295,309
18,704,2,0,0.0001,0.01,0.5,346,358
18,804,2,0,0.0001,0.01,0.5,401,403
18,904,2,0,0.0001,0.01,0.5,457,447
18,1004,2,0,0.0001,0.01,0.5,507,497
18,1104,2,0,0.0001,0.01,0.5,549,555
18,1204,2,0,0.0001,0.01,0.5,598,606
18,1304,2,0,0.0001,0.01,0.5,650,654
18,1404,2,0,0.0001,0.01,0.5,696,708
18,1504,2,0,0.0001,0.01,0.5,750,754
18,1604,2,0,0.0001,0.01,0.5,800,804
18,1704,2,0,0.0001,0.01,0.5,856,848
18,1804,2,0,0.0001,0.01,0.5,907,897
18,1904,2,0,0.0001,0.01,0.5,952,952
19,0,2,0,0.0001,0.01,0.476,0,0
19,104,2,0,0.0001,0.01,0.478,52,52
19,204,2,0,0.0001,0.01,0.486,99,105
19,304,2,0,0.0001,0.01,0.49,155,149
19,404,2,0,0.0001,0.01,0.49,205,199
19,504,2,0,0.0001,0.01,0.498,253,251
19,604,2,0,0.0001,0.01,0.496,295,309
19,704,2,0,0.0001,0.01,0.496,349,355
19,804,2,0,0.0001,0.01,0.5,401,403
19,904,2,0,0.0001,0.01,0.5,447,457
19,1004,2,0,0.0001,0.01,0.5,502,502
19,1104,2,0,0.0001,0.01,0.5,551,553
19,1204,2,0,0.0001,0.01,0.5,601,603
19,1304,2,0,0.0001,0.01,0.498,652,652
19,1404,2,0,0.0001,0.01,0.5,699,705
19,1504,2,0,0.0001,0.01,0.5,747,757
19,1604,2,0,0.0001,0.01,0.488,803,801
19,1704,2,0,0.0001,0.01,0.494,851,853
19,1804,2,0,0.0001,0.01,0.5,909,895
19,1904,2,0,0.0001,0.01,0.496,952,952
20,0,2,0,0.0001,0.01,0.5,0,0
20,104,2,0,0.0001,0.01,0.51,55,49
20,204,2,0,0.0001,0.01,0.5,99,105
20,304,2,0,0.0001,0.01,0.5,146,158
20,404,2,0,0.0001,0.01,0.5,200,204
20,504,2,0,0.0001,0.01,0.5,248,256
20,604,2,0,0.0001,0.01,0.5,300,304
20,704,2,0,0.0001,0.01,0.5,348,356
20,804,2,0,0.0001,0.01,0.5,399,405
20,904,2,0,0.0001,0.01,0.5,446,458
20,1004,2,0,0.0001,0.01,0.5,495,509
20,1104,2,0,0.0001,0.01,0.5,543,561
20,1204,2,0,0.0001,0.01,0.5,596,608
20,1304,2,0,0.0001,0.01,0.5,638,666
20,1404,2,0,0.0001,0.01,0.5,690,714
20,1504,2,0,0.0001,0.01,0.5,747,757
20,1604,2,0,0.0001,0.01,0.506,792,812
20,1704,2,0,0.0001,0.01,0.5,841,863
20,1804,2,0,0.0001,0.01,0.516,897,907
20,1904,2,0,0.0001,0.01,0.502,952,952
1,0,2,0,0.001,0.0001,0.5,0,0
1,104,2,0,0.001,0.0001,0.5,53,51
1,204,2,0,0.001,0.0001,0.5,103,101
1,304,2,0,0.001,0.0001,0.5,152,152
1,404,2,0,0.001,0.0001,0.5,196,208
1,504,2,0,0.001,0.0001,0.5,248,256
1,604,2,0,0.001,0.0001,0.5,298,306
1,704,2,0,0.001,0.0001,0.5,345,359
1,804,2,0,0.001,0.0001,0.5,393,411
1,904,2,0,0.001,0.0001,0.5,450,454
1,1004,2,0,0.001,0.0001,0.5,501,503
1,1104,2,0,0.001,0.0001,0.5,554,550
1,1204,2,0,0.001,0.0001,0.5,600,604
1,1304,2,0,0.001,0.0001,0.5,658,646
1,1404,2,0,0.001,0.0001,0.5,712,692
1,1504,2,0,0.001,0.0001,0.5,753,751
1,1604,2,0,0.001,0.0001,0.5,805,799
1,1704,2,0,0.001,0.0001,0.5,854,850
1,1804,2,0,0.001,0.0001,0.5,904,900
1,1904,2,0,0.001,0.0001,0.5,952,952
2,0,2,0,0.001,0.0001,0.5,0,0
2,104,2,0,0.001,0.0001,0.5,51,53
2,204,2,0,0.001,0.0001,0.5,99,105
2,304,2,0,0.001,0.0001,0.5,149,155
2,404,2,0,0.001,0.0001,0.5,205,199
2,504,2,0,0.001,0.0001,0.5,256,248
2,604,2,0,0.001,0.0001,0.5,303,301
2,704,2,0,0.001,0.0001,0.5,353,351
2,804,2,0,0.001,0.0001,0.5,410,394
2,904,2,0,0.001,0.0001,0.5,468,436
2,1004,2,0,0.001,0.0001,0.5,512,492
2,1104,2,0,0.001,0.0001,0.5,552,552
2,1204,2,0,0.001,0.0001,0.5,607,597
2,1304,2,0,0.001,0.0001,0.5,652,652
2,1404,2,0,0.001,0.0001,0.5,711,693
2,1504,2,0,0.001,0.0001,0.5,761,743
2,1604,2,0,0.001,0.0001,0.5,806,798
2,1704,2,0,0.001,0.0001,0.5,859,845
2,1804,2,0,0.001,0.0001,0.5,903,901
2,1904,2,0,0.001,0.0001,0.5,952,952
3,0,2,0,0.001,0.0001,0.5,0,0
3,104,2,0,0.001,0.0001,0.5,49,55
3,204,2,0,0.001,0.0001,0.5,100,104
3,304,2,0,0.001,0.0001,0.5,160,144
3,404,2,0,0.001,0.0001,0.5,208,196
3,504,2,0,0.001,0.0001,0.5,251,253
3,604,2,0,0.001,0.0001,0.5,296,308
3,704,2,0,0.001,0.0001,0.5,345,359
3,804,2,0,0.001,0.0001,0.5,394,410
3,904,2,0,0.001,0.0001,0.5,444,460
3,1004,2,0,0.001,0.0001,0.5,499,505
3,1104,2,0,0.001,0.0001,0.5,542,562
3,1204,2,0,0.001,0.0001,0.5,596,608
3,1304,2,0,0.001,0.0001,0.5,641,663
3,1404,2,0,0.001,0.0001,0.5,687,717
3,1504,2,0,0.001,0.0001,0.5,744,760
3,1604,2,0,0.001,0.0001,0.5,801,803
3,1704,2,0,0.001,0.0001,0.5,861,843
3,1804,2,0,0.001,0.0001,0.5,903,901
3,1904,2,0,0.001,0.0001,0.5,952,952
4,0,2,0,0.001,0.0001,0.5,0,0
4,104,2,0,0.001,0.0001,0.5,51,53
4,204,2,0,0.001,0.0001,0.5,101,103
4,304,2,0,0.001,0.0001,0.5,140,164
4,404,2,0,0.001,0.0001,0.5,192,212
4,504,2,0,0.001,0.0001,0.5,245,259
4,604,2,0,0.001,0.0001,0.5,297,307
4,704,2,0,0.001,0.0001,0.5,346,358
4,804,2,0,0.001,0.0001,0.5,391,413
4,904,2,0,0.001,0.0001,0.5,437,467
4,1004,2,0,0.001,0.0001,0.5,484,520
4,1104,2,0,0.001,0.0001,0.5,533,571
4,1204,2,0,0.001,0.0001,0.5,589,615
4,1304,2,0,0.001,0.0001,0.5,643,661
4,1404,2,0,0.001,0.0001,0.5,687,717
4,1504,2,0,0.001,0.0001,0.5,748,756
4,1604,2,0,0.001,0.0001,0.5,801,803
4,1704,2,0,0.001,0.0001,0.5,857,847
4,1804,2,0,0.001,0.0001,0.5,908,896
4,1904,2,0,0.001,0.0001,0.5,952,952
5,0,2,0,0.001,0.0001,0.5,0,0
5,104,2,0,0.001,0.0001,0.5,50,54
5,204,2,0,0.001,0.0001,0.5,97,107
5,304,2,0,0.001,0.0001,0.5,143,161
5,404,2,0,0.001,0.0001,0.5,200,204
5,504,2,0,0.001,0.0001,0.5,255,249
5,604,2,0,0.001,0.0001,0.5,305,299
5,704,2,0,0.001,0.0001,0.5,353,351
5,804,2,0,0.001,0.0001,0.5,406,398
5,904,2,0,0.001,0.0001,0.5,452,452
5,1004,2,0,0.001,0.0001,0.5,506,498
5,1104,2,0,0.001,0.0001,0.5,562,542
5,1204,2,0,0.001,0.0001,0.5,613,591
5,1304,2,0,0.001,0.0001,0.5,667,637
5,1404,2,0,0.001,0.0001,0.5,711,693
5,1504,2,0,0.001,0.0001,0.5,759,745
5,1604,2,0,0.001,0.0001,0.5,810,794
5,1704,2,0,0.001,0.0001,0.5,858,846
5,1804,2,0,0.001,0.0001,0.5,906,898
5,1904,2,0,0.001,0.0001,0.5,952,952
6,0,2,0,0.001,0.0001,0.5,0,0
6,104,2,0,0.001,0.0001,0.5,49,55
6,204,2,0,0.001,0.0001,0.5,100,104
6,304,2,0,0.001,0.0001,0.5,150,154
6,404,2,0,0.001,0.0001,0.5,192,212
6,504,2,0,0.001,0.0001,0.5,248,256
6,604,2,0,0.001,0.0001,0.5,298,306
6,704,2,0,0.001,0.0001,0.5,351,353
6,804,2,0,0.001,0.0001,0.5,397,407
6,904,2,0,0.001,0.0001,0.5,442,462
6,1004,2,0,0.001,0.0001,0.5,492,512
6,1104,2,0,0.001,0.0001,0.5,542,562
6,1204,2,0,0.001,0.0001,0.5,592,612
6,1304,2,0,0.001,0.0001,0.5,645,659
6,1404,2,0,0.001,0.0001,0.5,693,711
6,1504,2,0,0.001,0.0001,0.5,741,763
6,1604,2,0,0.001,0.0001,0.5,795,809
6,1704,2,0,0.001,0.0001,0.5,850,854
6,1804,2,0,0.001,0.0001,0.5,899,905
6,1904,2,0,0.001,0.0001,0.5,952,952
7,0,2,0,0.001,0.0001,0.5,0,0
7,104,2,0,0.001,0.0001,0.5,48,56
7,204,2,0,0.001,0.0001,0.5,96,108
7,304,2,0,0.001,0.0001,0.5,141,163
7,404,2,0,0.001,0.0001,0.5,193,211
7,504,2,0,0.001,0.0001,0.5,249,255
7,604,2,0,0.001,0.0001,0.5,300,304
7,704,2,0,0.001,0.0001,0.5,351,353
7,804,2,0,0.001,0.0001,0.5,408,396
7,904,2,0,0.001,0.0001,0.5,456,448
7,1004,2,0,0.001,0.0001,0.5,503,501
7,1104,2,0,0.001,0.0001,0.5,552,552
7,1204,2,0,0.001,0.0001,0.5,598,606
7,1304,2,0,0.001,0.0001,0.5,649,655
7,1404,2,0,0.001,0.0001,0.5,698,706
7,1504,2,0,0.001,0.0001,0.5,752,752
7,1604,2,0,0.001,0.0001,0.5,801,803
7,1704,2,0,0.001,0.0001,0.5,853,851
7,1804,2,0,0.001,0.0001,0.5,902,902
7,1904,2,0,0.001,0.0001,0.5,952,952
8,0,2,0,0.001,0.0001,0.5,0,0
8,104,2,0,0.001,0.0001,0.5,42,62
8,204,2,0,0.001,0.0001,0.5,102,102
8,304,2,0,0.001,0.0001,0.5,150,154
8,404,2,0,0.001,0.0001,0.5,202,202
8,504,2,0,0.001,0.0001,0.5,258,246
8,604,2,0,0.001,0.0001,0.5,310,294
8,704,2,0,0.001,0.0001,0.5,362,342
8,804,2,0,0.001,0.0001,0.5,404,400
8,904,2,0,0.001,0.0001,0.5,452,452
8,1004,2,0,0.001,0.0001,0.5,505,499
8,1104,2,0,0.001,0.0001,0.5,566,538
8,1204,2,0,0.001,0.0001,0.5,619,585
8,1304,2,0,0.001,0.0001,0.5,662,642
8,1404,2,0,0.001,0.0001,0.5,710,694
8,1504,2,0,0.001,0.0001,0.5,756,748
8,1604,2,0,0.001,0.0001,0.5,814,790
8,1704,2,0,0.001,0.0001,0.5,858,846
8,1804,2,0,0.001,0.0001,0.5,900,904
8,1904,2,0,0.001,0.0001,0.5,952,952
9,0,2,0,0.001,0.0001,0.5,0,0
9,104,2,0,0.001,0.0001,0.5,56,48
9,204,2,0,0.001,0.0001,0.5,100,104
9,304,2,0,0.001,0.0001,0.5,145,159
9,404,2,0,0.001,0.0001,0.5,192,212
9,504,2,0,0.001,0.0001,0.5,243,261
9,604,2,0,0.001,0.0001,0.5,292,312
9,704,2,0,0.001,0.0001,0.5,333,371
9,804,2,0,0.001,0.0001,0.5,390,414
9,904,2,0,0.001,0.0001,0.5,437,467
9,1004,2,0,0.001,0.0001,0.5,494,510
9,1104,2,0,0.001,0.0001,0.5,553,551
9,1204,2,0,0.001,0.0001,0.5,596,608
9,1304,2,0,0.001,0.0001,0.5,648,656
9,1404,2,0,0.001,0.0001,0.5,696,708
9,1504,2,0,0.001,0.0001,0.5,745,759
9,1604,2,0,0.001,0.0001,0.5,798,806
9,1704,2,0,0.001,0.0001,0.5,846,858
9,1804,2,0,0.001,0.0001,0.5,896,908
9,1904,2,0,0.001,0.0001,0.5,952,952
10,0,2,0,0.001,0.0001,0.5,0,0
10,104,2,0,0.001,0.0001,0.5,49,55
10,204,2,0,0.001,0.0001,0.5,105,99
10,304,2,0,0.001,0.0001,0.5,159,145
10,404,2,0,0.001,0.0001,0.5,213,191
10,504,2,0,0.001,0.0001,0.5,263,241
10,604,2,0,0.001,0.0001,0.5,307,297
10,704,2,0,0.001,0.0001,0.5,359,345
10,804,2,0,0.001,0.0001,0.5,414,390
10,904,2,0,0.001,0.0001,0.5,465,439
10,1004,2,0,0.001,0.0001,0.5,510,494
10,1104,2,0,0.001,0.0001,0.5,564,540
10,1204,2,0,0.001,0.0001,0.5,620,584
10,1304,2,0,0.001,0.0001,0.5,667,637
10,1404,2,0,0.001,0.0001,0.5,710,694
10,1504,2,0,0.001,0.0001,0.5,759,745
10,1604,2,0,0.001,0.0001,0.5,812,792
10,1704,2,0,0.001,0.0001,0.5,858,846
10,1804,2,0,0.001,0.0001,0.5,911,893
10,1904,2,0,0.001,0.0001,0.5,952,952
11,0,2,0,0.001,0.0001,0.5,0,0
11,104,2,0,0.001,0.0001,0.5,57,47
11,204,2,0,0.001,0.0001,0.5,101,103
11,304,2,0,0.001,0.0001,0.5,147,157
11,404,2,0,0.001,0.0001,0.5,197,207
11,504,2,0,0.001,0.0001,0.5,252,252
11,604,2,0,0.001,0.0001,0.5,303,301
11,704,2,0,0.001,0.0001,0.5,348,356
11,804,2,0,0.001,0.0001,0.5,400,404
11,904,2,0,0.001,0.0001,0.5,450,454
11,1004,2,0,0.001,0.0001,0.5,500,504
11,1104,2,0,0.001,0.0001,0.5,550,554
11,1204,2,0,0.001,0.0001,0.5,597,607
11,1304,2,0,0.001,0.0001,0.5,641,663
11,1404,2,0,0.001,0.0001,0.5,694,710
11,1504,2,0,0.001,0.0001,0.5,749,755
11,1604,2,0,0.001,0.0001,0.5,804,800
11,1704,2,0,0.001,0.0001,0.5,856,848
11,1804,2,0,0.001,0.0001,0.5,906,898
11,1904,2,0,0.001,0.0001,0.5,952,952
12,0,2,0,0.001,0.0001,0.5,0,0
12,104,2,0,0.001,0.0001,0.5,55,49
12,204,2,0,0.001,0.0001,0.5,105,99
12,304,2,0,0.001,0.0001,0.5,160,144
12,404,2,0,0.001,0.0001,0.5,204,200
12,504,2,0,0.001,0.0001,0.5,249,255
12,604,2,0,0.001,0.0001,0.5,309,295
12,704,2,0,0.001,0.0001,0.5,362,342
12,804,2,0,0.001,0.0001,0.5,408,396
12,904,2,0,0.001,0.0001,0.5,450,454
12,1004,2,0,0.001,0.0001,0.5,497,507
12,1104,2,0,0.001,0.0001,0.5,546,558
12,1204,2,0,0.001,0.0001,0.5,596,608
12,1304,2,0,0.001,0.0001,0.5,650,654
12,1404,2,0,0.001,0.0001,0.5,699,705
12,1504,2,0,0.001,0.0001,0.5,749,755
12,1604,2,0,0.001,0.0001,0.5,797,807
12,1704,2,0,0.001,0.0001,0.5,843,861
12,1804,2,0,0.001,0.0001,0.5,900,904
12,1904,2,0,0.001,0.0001,0.5,952,952
13,0,2,0,0.001,0.0001,0.5,0,0
13,104,2,0,0.001,0.0001,0.5,58,46
13,204,2,0,0.001,0.0001,0.5,108,96
13,304,2,0,0.001,0.0001,0.5,163,141
13,404,2,0,0.001,0.0001,0.5,209,195
13,504,2,0,0.001,0.0001,0.5,258,246
13,604,2,0,0.001,0.0001,0.5,300,304
13,704,2,0,0.001,0.0001,0.5,361,343
13,804,2,0,0.001,0.0001,0.5,413,391
13,904,2,0,0.001,0.0001,0.5,464,440
13,1004,2,0,0.001,0.0001,0.5,512,492
13,1104,2,0,0.001,0.0001,0.5,571,533
13,1204,2,0,0.001,0.0001,0.5,617,587
13,1304,2,0,0.001,0.0001,0.5,667,637
13,1404,2,0,0.001,0.0001,0.5,713,691
13,1504,2,0,0.001,0.0001,0.5,763,741
13,1604,2,0,0.001,0.0001,0.5,815,789
13,1704,2,0,0.001,0.0001,0.5,860,844
13,1804,2,0,0.001,0.0001,0.5,906,898
13,1904,2,0,0.001,0.0001,0.5,952,952
14,0,2,0,0.001,0.0001,0.5,0,0
14,104,2,0,0.001,0.0001,0.5,43,61
14,204,2,0,0.001,0.0001,0.5,98,106
14,304,2,0,0.001,0.0001,0.5,153,151
14,404,2,0,0.001,0.0001,0.5,201,203
14,504,2,0,0.001,0.0001,0.5,252,252
14,604,2,0,0.001,0.0001,0.5,301,303
14,704,2,0,0.001,0.0001,0.5,362,342
14,804,2,0,0.001,0.0001,0.5,408,396
14,904,2,0,0.001,0.0001,0.5,460,444
14,1004,2,0,0.001,0.0001,0.5,513,491
14,1104,2,0,0.001,0.0001,0.5,564,540
14,1204,2,0,0.001,0.0001,0.5,610,594
14,1304,2,0,0.001,0.0001,0.5,664,640
14,1404,2,0,0.001,0.0001,0.5,711,693
14,1504,2,0,0.001,0.0001,0.5,756,748
14,1604,2,0,0.001,0.0001,0.5,806,798
14,1704,2,0,0.001,0.0001,0.5,854,850
14,1804,2,0,0.001,0.0001,0.5,907,897
14,1904,2,0,0.001,0.0001,0.5,952,952
15,0,2,0,0.001,0.0001,0.504,0,0
15,104,2,0,0.001,0.0001,0.506,54,50
15,204,2,0,0.001,0.0001,0.506,101,103
15,304,2,0,0.001,0.0001,0.506,152,152
15,404,2,0,0.001,0.0001,0.506,193,211
15,504,2,0,0.001,0.0001,0.506,241,263
15,604,2,0,0.001,0.0001,0.506,295,309
15,704,2,0,0.001,0.0001,0.506,335,369
15,804,2,0,0.001,0.0001,0.506,395,409
15,904,2,0,0.001,0.0001,0.504,447,457
15,1004,2,0,0.001,0.0001,0.504,497,507
15,1104,2,0,0.001,0.0001,0.502,547,557
15,1204,2,0,0.001,0.0001,0.502,597,607
15,1304,2,0,0.001,0.0001,0.502,647,657
15,1404,2,0,0.001,0.0001,0.504,698,706
15,1504,2,0,0.001,0.0001,0.504,744,760
15,1604,2,0,0.001,0.0001,0.504,785,819
15,1704,2,0,0.001,0.0001,0.506,837,867
15,1804,2,0,0.001,0.0001,0.508,898,906
15,1904,2,0,0.001,0.0001,0.506,952,952
16,0,2,0,0.001,0.0001,0.5,0,0
16,104,2,0,0.001,0.0001,0.5,62,42
16,204,2,0,0.001,0.0001,0.5,110,94
16,304,2,0,0.001,0.0001,0.5,157,147
16,404,2,0,0.001,0.0001,0.5,204,200
16,504,2,0,0.001,0.0001,0.5,251,253
16,604,2,0,0.001,0.0001,0.5,292,312
16,704,2,0,0.001,0.0001,0.5,353,351
16,804,2,0,0.001,0.0001,0.5,400,404
16,904,2,0,0.001,0.0001,0.5,454,450
16,1004,2,0,0.001,0.0001,0.5,508,496
16,1104,2,0,0.001,0.0001,0.5,558,546
16,1204,2,0,0.001,0.0001,0.5,608,596
16,1304,2,0,0.001,0.0001,0.5,657,647
16,1404,2,0,0.001,0.0001,0.5,707,697
16,1504,2,0,0.001,0.0001,0.5,751,753
16,1604,2,0,0.001,0.0001,0.5,810,794
16,1704,2,0,0.001,0.0001,0.5,862,842
16,1804,2,0,0.001,0.0001,0.5,903,901
16,1904,2,0,0.001,0.0001,0.5,952,952
17,0,2,0,0.001,0.0001,0.5,0,0
17,104,2,0,0.001,0.0001,0.5,45,59
17,204,2,0,0.001,0.0001,0.5,96,108
17,304,2,0,0.001,0.0001,0.5,141,163
17,404,2,0,0.001,0.0001,0.5,184,220
17,504,2,0,0.001,0.0001,0.5,238,266
17,604,2,0,0.001,0.0001,0.5,288,316
17,704,2,0,0.001,0.0001,0.5,332,372
17,804,2,0,0.001,0.0001,0.5,376,428
17,904,2,0,0.001,0.0001,0.5,437,467
17,1004,2,0,0.001,0.0001,0.5,491,513
17,1104,2,0,0.001,0.0001,0.5,544,560
17,1204,2,0,0.001,0.0001,0.5,595,609
17,1304,2,0,0.001,0.0001,0.5,650,654
17,1404,2,0,0.001,0.0001,0.5,698,706
17,1504,2,0,0.001,0.0001,0.5,742,762
17,1604,2,0,0.001,0.0001,0.5,804,800
17,1704,2,0,0.001,0.0001,0.5,851,853
17,1804,2,0,0.001,0.0001,0.5,899,905
17,1904,2,0,0.001,0.0001,0.5,952,952
18,0,2,0,0.001,0.0001,0.5,0,0
18,104,2,0,0.001,0.0001,0.5,53,51
18,204,2,0,0.001,0.0001,0.5,101,103
18,304,2,0,0.001,0.0001,0.5,145,159
18,404,2,0,0.001,0.0001,0.5,198,206
18,504,2,0,0.001,0.0001,0.5,251,253
18,604,2,0,0.001,0.0001,0.5,295,309
18,704,2,0,0.001,0.0001,0.5,346,358
18,804,2,0,0.001,0.0001,0.5,390,414
18,904,2,0,0.001,0.0001,0.5,442,462
18,1004,2,0,0.001,0.0001,0.5,493,511
18,1104,2,0,0.001,0.0001,0.5,537,567
18,1204,2,0,0.001,0.0001,0.5,591,613
18,1304,2,0,0.001,0.0001,0.5,644,660
18,1404,2,0,0.001,0.0001,0.5,690,714
18,1504,2,0,0.001,0.0001,0.5,739,765
18,1604,2,0,0.001,0.0001,0.5,785,819
18,1704,2,0,0.001,0.0001,0.5,837,867
18,1804,2,0,0.001,0.0001,0.5,891,913
18,1904,2,0,0.001,0.0001,0.5,952,952
19,0,2,0,0.001,0.0001,0.5,0,0
19,104,2,0,0.001,0.0001,0.5,53,51
19,204,2,0,0.001,0.0001,0.5,104,100
19,304,2,0,0.001,0.0001,0.5,143,161
19,404,2,0,0.001,0.0001,0.5,193,211
19,504,2,0,0.001,0.0001,0.5,249,255
19,604,2,0,0.001,0.0001,0.5,305,299
19,704,2,0,0.001,0.0001,0.5,346,358
19,804,2,0,0.001,0.0001,0.5,390,414
19,904,2,0,0.001,0.0001,0.5,440,464
19,1004,2,0,0.001,0.0001,0.5,489,515
19,1104,2,0,0.001,0.0001,0.5,545,559
19,1204,2,0,0.001,0.0001,0.5,598,606
19,1304,2,0,0.001,0.0001,0.5,651,653
19,1404,2,0,0.001,0.0001,0.5,694,710
19,1504,2,0,0.001,0.0001,0.5,747,757
19,1604,2,0,0.001,0.0001,0.5,796,808
19,1704,2,0,0.001,0.0001,0.5,842,862
19,1804,2,0,0.001,0.0001,0.5,888,916
19,1904,2,0,0.001,0.0001,0.5,952,952
20,0,2,0,0.001,0.0001,0.5,0,0
20,104,2,0,0.001,0.0001,0.5,44,60
20,204,2,0,0.001,0.0001,0.5,90,114
20,304,2,0,0.001,0.0001,0.5,146,158
20,404,2,0,0.001,0.0001,0.5,196,208
20,504,2,0,0.001,0.0001,0.5,243,261
20,604,2,0,0.001,0.0001,0.5,291,313
20,704,2,0,0.001,0.0001,0.5,341,363
20,804,2,0,0.001,0.0001,0.5,391,413
20,904,2,0,0.001,0.0001,0.5,448,456
20,1004,2,0,0.001,0.0001,0.5,498,506
20,1104,2,0,0.001,0.0001,0.5,559,545
20,1204,2,0,0.001,0.0001,0.5,609,595
20,1304,2,0,0.001,0.0001,0.5,655,649
20,1404,2,0,0.001,0.0001,0.5,700,704
20,1504,2,0,0.001,0.0001,0.5,749,755
20,1604,2,0,0.001,0.0001,0.5,799,805
20,1704,2,0,0.001,0.0001,0.5,846,858
20,1804,2,0,0.001,0.0001,0.5,902,902
20,1904,2,0,0.001,0.0001,0.5,952,952
1,0,2,0,0.001,0.001,0.5,0,0
1,104,2,0,0.001,0.001,0.498,46,58
1,204,2,0,0.001,0.001,0.504,87,117
1,304,2,0,0.001,0.001,0.506,145,159
1,404,2,0,0.001,0.001,0.502,202,202
1,504,2,0,0.001,0.001,0.502,260,244
1,604,2,0,0.001,0.001,0.502,310,294
1,704,2,0,0.001,0.001,0.508,357,347
1,804,2,0,0.001,0.001,0.5,412,392
1,904,2,0,0.001,0.001,0.518,453,451
1,1004,2,0,0.001,0.001,0.504,500,504
1,1104,2,0,0.001,0.001,0.488,553,551
1,1204,2,0,0.001,0.001,0.486,606,598
1,1304,2,0,0.001,0.001,0.51,656,648
1,1404,2,0,0.001,0.001,0.514,700,704
1,1504,2,0,0.001,0.001,0.504,752,752
1,1604,2,0,0.001,0.001,0.504,809,795
1,1704,2,0,0.001,0.001,0.516,864,840
1,1804,2,0,0.001,0.001,0.502,909,895
1,1904,2,0,0.001,0.001,0.476,952,952
2,0,2,0,0.001,0.001,0.494,0,0
2,104,2,0,0.001,0.001,0.496,59,45
2,204,2,0,0.001,0.001,0.492,111,93
2,304,2,0,0.001,0.001,0.492,163,141
2,404,2,0,0.001,0.001,0.488,218,186
2,504,2,0,0.001,0.001,0.492,274,230
2,604,2,0,0.001,0.001,0.494,318,286
2,704,2,0,0.001,0.001,0.486,364,340
2,804,2,0,0.001,0.001,0.49,411,393
2,904,2,0,0.001,0.001,0.5,463,441
2,1004,2,0,0.001,0.001,0.51,501,503
2,1104,2,0,0.001,0.001,0.524,553,551
2,1204,2,0,0.001,0.001,0.522,600,604
2,1304,2,0,0.001,0.001,0.528,659,645
2,1404,2,0,0.001,0.001,0.526,705,699
2,1504,2,0,0.001,0.001,0.524,754,750
2,1604,2,0,0.001,0.001,0.532,806,798
2,1704,2,0,0.001,0.001,0.532,863,841
2,1804,2,0,0.001,0.001,0.532,905,899
2,1904,2,0,0.001,0.001,0.528,952,952
3,0,2,0,0.001,0.001,0.53,0,0
3,104,2,0,0.001,0.001,0.53,51,53
3,204,2,0,0.001,0.001,0.53,98,106
3,304,2,0,0.001,0.001,0.532,142,162
3,404,2,0,0.001,0.001,0.532,189,215
3,504,2,0,0.001,0.001,0.532,237,267
3,604,2,0,0.001,0.001,0.532,292,312
3,704,2,0,0.001,0.001,0.534,342,362
3,804,2,0,0.001,0.001,0.532,398,406
3,904,2,0,0.001,0.001,0.532,446,458
3,1004,2,0,0.001,0.001,0.532,504,500
3,1104,2,0,0.001,0.001,0.532,559,545
3,1204,2,0,0.001,0.001,0.53,606,598
3,1304,2,0,0.001,0.001,0.528,661,643
3,1404,2,0,0.001,0.001,0.53,708,696
3,1504,2,0,0.001,0.001,0.526,758,746
3,1604,2,0,0.001,0.001,0.526,813,791
3,1704,2,0,0.001,0.001,0.526,863,841
3,1804,2,0,0.001,0.001,0.526,910,894
3,1904,2,0,0.001,0.001,0.526,952,952
4,0,2,0,0.001,0.001,0.5,0,0
4,104,2,0,0.001,0.001,0.5,58,46
4,204,2,0,0.001,0.001,0.5,106,98
4,304,2,0,0.001,0.001,0.5,141,163
4,404,2,0,0.001,0.001,0.5,184,220
4,504,2,0,0.001,0.001,0.5,236,268
4,604,2,0,0.001,0.001,0.5,282,322
4,704,2,0,0.001,0.001,0.5,329,375
4,804,2,0,0.001,0.001,0.5,385,419
4,904,2,0,0.001,0.001,0.5,437,467
4,1004,2,0,0.001,0.001,0.5,486,518
4,1104,2,0,0.001,0.001,0.5,534,570
4,1204,2,0,0.001,0.001,0.612,594,610
4,1304,2,0,0.001,0.001,0.618,649,655
4,1404,2,0,0.001,0.001,0.612,705,699
4,1504,2,0,0.001,0.001,0.616,757,747
4,1604,2,0,0.001,0.001,0.616,809,795
4,1704,2,0,0.001,0.001,0.618,855,849
4,1804,2,0,0.001,0.001,0.614,910,894
4,1904,2,0,0.001,0.001,0.614,952,952
5,0,2,0,0.001,0.001,0.492,0,0
5,104,2,0,0.001,0.001,0.492,46,58
5,204,2,0,0.001,0.001,0.488,92,112
5,304,2,0,0.001,0.001,0.492,146,158
5,404,2,0,0.001,0.001,0.474,197,207
5,504,2,0,0.001,0.001,0.48,248,256
5,604,2,0,0.001,0.001,0.48,301,303
5,704,2,0,0.001,0.001,0.488,346,358
5,804,2,0,0.001,0.001,0.492,393,411
5,904,2,0,0.001,0.001,0.506,447,457
5,1004,2,0,0.001,0.001,0.502,498,506
5,1104,2,0,0.001,0.001,0.502,552,552
5,1204,2,0,0.001,0.001,0.502,592,612
5,1304,2,0,0.001,0.001,0.496,648,656
5,1404,2,0,0.001,0.001,0.49,701,703
5,1504,2,0,0.001,0.001,0.49,752,752
5,1604,2,0,0.001,0.001,0.488,799,805
5,1704,2,0,0.001,0.001,0.488,851,853
5,1804,2,0,0.001,0.001,0.492,907,897
5,1904,2,0,0.001,0.001,0.486,952,952
6,0,2,0,0.001,0.001,0.5,0,0
6,104,2,0,0.001,0.001,0.5,52,52
6,204,2,0,0.001,0.001,0.5,102,102
6,304,2,0,0.001,0.001,0.5,151,153
6,404,2,0,0.001,0.001,0.5,200,204
6,504,2,0,0.001,0.001,0.5,257,247
6,604,2,0,0.001,0.001,0.5,308,296
6,704,2,0,0.001,0.001,0.5,352,352
6,804,2,0,0.001,0.001,0.5,401,403
6,904,2,0,0.001,0.001,0.5,456,448
6,1004,2,0,0.001,0.001,0.5,497,507
6,1104,2,0,0.001,0.001,0.5,555,549
6,1204,2,0,0.001,0.001,0.5,602,602
6,1304,2,0,0.001,0.001,0.5,656,648
6,1404,2,0,0.001,0.001,0.504,710,694
6,1504,2,0,0.001,0.001,0.506,753,751
6,1604,2,0,0.001,0.001,0.498,811,793
6,1704,2,0,0.001,0.001,0.498,852,852
6,1804,2,0,0.001,0.001,0.492,902,902
6,1904,2,0,0.001,0.001,0.504,952,952
7,0,2,0,0.001,0.001,0.56,0,0
7,104,2,0,0.001,0.001,0.56,57,47
7,204,2,0,0.001,0.001,0.56,108,96
7,304,2,0,0.001,0.001,0.56,148,156
7,404,2,0,0.001,0.001,0.58,192,212
7,504,2,0,0.001,0.001,0.596,245,259
7,604,2,0,0.001,0.001,0.598,297,307
7,704,2,0,0.001,0.001,0.6,345,359
7,804,2,0,0.001,0.001,0.496,395,409
7,904,2,0,0.001,0.001,0.402,448,456
7,1004,2,0,0.001,0.001,0.394,507,497
7,1104,2,0,0.001,0.001,0.396,553,551
7,1204,2,0,0.001,0.001,0.396,610,594
7,1304,2,0,0.001,0.001,0.464,662,642
7,1404,2,0,0.001,0.001,0.602,710,694
7,1504,2,0,0.001,0.001,0.602,754,750
7,1604,2,0,0.001,0.001,0.594,807,797
7,1704,2,0,0.001,0.001,0.608,855,849
7,1804,2,0,0.001,0.001,0.53,898,906
7,1904,2,0,0.001,0.001,0.432,952,952
8,0,2,0,0.001,0.001,0.554,0,0
8,104,2,0,0.001,0.001,0.554,49,55
8,204,2,0,0.001,0.001,0.554,106,98
8,304,2,0,0.001,0.001,0.554,159,145
8,404,2,0,0.001,0.001,0.554,209,195
8,504,2,0,0.001,0.001,0.554,258,246
8,604,2,0,0.001,0.001,0.554,310,294
8,704,2,0,0.001,0.001,0.552,358,346
8,804,2,0,0.001,0.001,0.55,404,400
8,904,2,0,0.001,0.001,0.548,459,445
8,1004,2,0,0.001,0.001,0.55,509,495
8,1104,2,0,0.001,0.001,0.55,557,547
8,1204,2,0,0.001,0.001,0.55,605,599
8,1304,2,0,0.001,0.001,0.546,666,638
8,1404,2,0,0.001,0.001,0.546,706,698
8,1504,2,0,0.001,0.001,0.546,746,758
8,1604,2,0,0.001,0.001,0.548,800,804
8,1704,2,0,0.001,0.001,0.546,861,843
8,1804,2,0,0.001,0.001,0.546,904,900
8,1904,2,0,0.001,0.001,0.546,952,952
9,0,2,0,0.001,0.001,0.534,0,0
9,104,2,0,0.001,0.001,0.556,69,35
9,204,2,0,0.001,0.001,0.528,123,81
9,304,2,0,0.001,0.001,0.53,173,131
9,404,2,0,0.001,0.001,0.502,224,180
9,504,2,0,0.001,0.001,0.5,280,224
9,604,2,0,0.001,0.001,0.5,324,280
9,704,2,0,0.001,0.001,0.5,375,329
9,804,2,0,0.001,0.001,0.5,426,378
9,904,2,0,0.001,0.001,0.5,475,429
9,1004,2,0,0.001,0.001,0.5,522,482
9,1104,2,0,0.001,0.001,0.5,568,536
9,1204,2,0,0.001,0.001,0.5,619,585
9,1304,2,0,0.001,0.001,0.5,666,638
9,1404,2,0,0.001,0.001,0.5,712,692
9,1504,2,0,0.001,0.001,0.5,761,743
9,1604,2,0,0.001,0.001,0.512,807,797
9,1704,2,0,0.001,0.001,0.516,854,850
9,1804,2,0,0.001,0.001,0.516,901,903
9,1904,2,0,0.001,0.001,0.548,952,952
10,0,2,0,0.001,0.001,0.5,0,0
10,104,2,0,0.001,0.001,0.5,53,51
10,204,2,0,0.001,0.001,0.5,112,92
10,304,2,0,0.001,0.001,0.5,163,141
10,404,2,0,0.001,0.001,0.5,204,200
10,504,2,0,0.001,0.001,0.5,259,245
10,604,2,0,0.001,0.001,0.5,304,300
10,704,2,0,0.001,0.001,0.5,353,351
10,804,2,0,0.001,0.001,0.5,396,408
10,904,2,0,0.001,0.001,0.5,443,461
10,1004,2,0,0.001,0.001,0.5,490,514
10,1104,2,0,0.001,0.001,0.5,542,562
10,1204,2,0,0.001,0.001,0.5,596,608
10,1304,2,0,0.001,0.001,0.5,641,663
10,1404,2,0,0.001,0.001,0.5,688,716
10,1504,2,0,0.001,0.001,0.5,742,762
10,1604,2,0,0.001,0.001,0.5,791,813
10,1704,2,0,0.001,0.001,0.5,851,853
10,1804,2,0,0.001,0.001,0.5,904,900
10,1904,2,0,0.001,0.001,0.5,952,952
11,0,2,0,0.001,0.001,0.508,0,0
11,104,2,0,0.001,0.001,0.508,55,49
11,204,2,0,0.001,0.001,0.514,104,100
11,304,2,0,0.001,0.001,0.514,152,152
11,404,2,0,0.001,0.001,0.514,196,208
11,504,2,0,0.001,0.001,0.512,253,251
11,604,2,0,0.001,0.001,0.502,302,302
11,704,2,0,0.001,0.001,0.504,354,350
11,804,2,0,0.001,0.001,0.502,409,395
11,904,2,0,0.001,0.001,0.508,460,444
11,1004,2,0,0.001,0.001,0.508,505,499
11,1104,2,0,0.001,0.001,0.516,555,549
11,1204,2,0,0.001,0.001,0.508,603,601
11,1304,2,0,0.001,0.001,0.508,652,652
11,1404,2,0,0.001,0.001,0.506,704,700
11,1504,2,0,0.001,0.001,0.512,760,744
11,1604,2,0,0.001,0.001,0.51,803,801
11,1704,2,0,0.001,0.001,0.498,852,852
11,1804,2,0,0.001,0.001,0.504,909,895
11,1904,2,0,0.001,0.001,0.502,952,952
12,0,2,0,0.001,0.001,0.5,0,0
12,104,2,0,0.001,0.001,0.5,53,51
12,204,2,0,0.001,0.001,0.5,106,98
12,304,2,0,0.001,0.001,0.5,162,142
12,404,2,0,0.001,0.001,0.5,218,186
12,504,2,0,0.001,0.001,0.5,263,241
12,604,2,0,0.001,0.001,0.5,317,287
12,704,2,0,0.001,0.001,0.5,371,333
12,804,2,0,0.001,0.001,0.5,425,379
12,904,2,0,0.001,0.001,0.5,471,433
12,1004,2,0,0.001,0.001,0.5,511,493
12,1104,2,0,0.001,0.001,0.5,555,549
12,1204,2,0,0.001,0.001,0.5,611,593
12,1304,2,0,0.001,0.001,0.5,661,643
12,1404,2,0,0.001,0.001,0.5,720,684
12,1504,2,0,0.001,0.001,0.5,766,738
12,1604,2,0,0.001,0.001,0.5,813,791
12,1704,2,0,0.001,0.001,0.5,859,845
12,1804,2,0,0.001,0.001,0.5,899,905
12,1904,2,0,0.001,0.001,0.5,952,952
13,0,2,0,0.001,0.001,0.452,0,0
13,104,2,0,0.001,0.001,0.454,53,51
13,204,2,0,0.001,0.001,0.454,101,103
13,304,2,0,0.001,0.001,0.454,152,152
13,404,2,0,0.001,0.001,0.454,196,208
13,504,2,0,0.001,0.001,0.456,248,256
13,604,2,0,0.001,0.001,0.456,301,303
13,704,2,0,0.001,0.001,0.456,355,349
13,804,2,0,0.001,0.001,0.452,414,390
13,904,2,0,0.001,0.001,0.458,463,441
13,1004,2,0,0.001,0.001,0.466,513,491
13,1104,2,0,0.001,0.001,0.466,564,540
13,1204,2,0,0.001,0.001,0.462,618,586
13,1304,2,0,0.001,0.001,0.456,671,633
13,1404,2,0,0.001,0.001,0.456,727,677
13,1504,2,0,0.001,0.001,0.456,769,735
13,1604,2,0,0.001,0.001,0.454,818,786
13,1704,2,0,0.001,0.001,0.456,860,844
13,1804,2,0,0.001,0.001,0.454,906,898
13,1904,2,0,0.001,0.001,0.458,952,952
14,0,2,0,0.001,0.001,0.5,0,0
14,104,2,0,0.001,0.001,0.5,56,48
14,204,2,0,0.001,0.001,0.5,112,92
14,304,2,0,0.001,0.001,0.5,171,133
14,404,2,0,0.001,0.001,0.502,218,186
14,504,2,0,0.001,0.001,0.5,267,237
14,604,2,0,0.001,0.001,0.498,309,295
14,704,2,0,0.001,0.001,0.5,352,352
14,804,2,0,0.001,0.001,0.52,402,402
14,904,2,0,0.001,0.001,0.524,451,453
14,1004,2,0,0.001,0.001,0.534,500,504
14,1104,2,0,0.001,0.001,0.526,554,550
14,1204,2,0,0.001,0.001,0.516,610,594
14,1304,2,0,0.001,0.001,0.516,662,642
14,1404,2,0,0.001,0.001,0.514,709,695
14,1504,2,0,0.001,0.001,0.508,756,748
14,1604,2,0,0.001,0.001,0.502,806,798
14,1704,2,0,0.001,0.001,0.508,864,840
14,1804,2,0,0.001,0.001,0.5,905,899
14,1904,2,0,0.001,0.001,0.502,952,952
15,0,2,0,0.001,0.001,0.488,0,0
15,104,2,0,0.001,0.001,0.5,55,49
15,204,2,0,0.001,0.001,0.516,104,100
15,304,2,0,0.001,0.001,0.528,152,152
15,404,2,0,0.001,0.001,0.536,212,192
15,504,2,0,0.001,0.001,0.538,266,238
15,604,2,0,0.001,0.001,0.524,312,292
15,704,2,0,0.001,0.001,0.51,357,347
15,804,2,0,0.001,0.001,0.498,407,397
15,904,2,0,0.001,0.001,0.502,466,438
15,1004,2,0,0.001,0.001,0.496,505,499
15,1104,2,0,0.001,0.001,0.498,555,549
15,1204,2,0,0.001,0.001,0.498,606,598
15,1304,2,0,0.001,0.001,0.504,650,654
15,1404,2,0,0.001,0.001,0.526,695,709
15,1504,2,0,0.001,0.001,0.538,744,760
15,1604,2,0,0.001,0.001,0.592,797,807
15,1704,2,0,0.001,0.001,0.596,850,854
15,1804,2,0,0.001,0.001,0.616,899,905
15,1904,2,0,0.001,0.001,0.628,952,952
16,0,2,0,0.001,0.001,0.496,0,0
16,104,2,0,0.001,0.001,0.494,53,51
16,204,2,0,0.001,0.001,0.496,102,102
16,304,2,0,0.001,0.001,0.502,151,153
16,404,2,0,0.001,0.001,0.506,197,207
16,504,2,0,0.001,0.001,0.5,245,259
16,604,2,0,0.001,0.001,0.5,298,306
16,704,2,0,0.001,0.001,0.5,349,355
16,804,2,0,0.001,0.001,0.5,399,405
16,904,2,0,0.001,0.001,0.5,443,461
16,1004,2,0,0.001,0.001,0.5,493,511
16,1104,2,0,0.001,0.001,0.5,550,554
16,1204,2,0,0.001,0.001,0.5,597,607
16,1304,2,0,0.001,0.001,0.5,641,663
16,1404,2,0,0.001,0.001,0.5,699,705
16,1504,2,0,0.001,0.001,0.5,751,753
16,1604,2,0,0.001,0.001,0.5,794,810
16,1704,2,0,0.001,0.001,0.5,845,859
16,1804,2,0,0.001,0.001,0.5,903,901
16,1904,2,0,0.001,0.001,0.498,952,952
17,0,2,0,0.001,0.001,0.488,0,0
17,104,2,0,0.001,0.001,0.484,60,44
17,204,2,0,0.001,0.001,0.488,110,94
17,304,2,0,0.001,0.001,0.496,153,151
17,404,2,0,0.001,0.001,0.484,194,210
17,504,2,0,0.001,0.001,0.486,257,247
17,604,2,0,0.001,0.001,0.486,311,293
17,704,2,0,0.001,0.001,0.488,354,350
17,804,2,0,0.001,0.001,0.498,406,398
17,904,2,0,0.001,0.001,0.522,451,453
17,1004,2,0,0.001,0.001,0.49,501,503
17,1104,2,0,0.001,0.001,0.5,553,551
17,1204,2,0,0.001,0.001,0.504,604,600
17,1304,2,0,0.001,0.001,0.508,655,649
17,1404,2,0,0.001,0.001,0.498,706,698
17,1504,2,0,0.001,0.001,0.488,759,745
17,1604,2,0,0.001,0.001,0.486,807,797
17,1704,2,0,0.001,0.001,0.484,857,847
17,1804,2,0,0.001,0.001,0.484,900,904
17,1904,2,0,0.001,0.001,0.494,952,952
18,0,2,0,0.001,0.001,0.544,0,0
18,104,2,0,0.001,0.001,0.544,51,53
18,204,2,0,0.001,0.001,0.546,101,103
18,304,2,0,0.001,0.001,0.548,153,151
18,404,2,0,0.001,0.001,0.546,212,192
18,504,2,0,0.001,0.001,0.546,262,242
18,604,2,0,0.001,0.001,0.55,314,290
18,704,2,0,0.001,0.001,0.556,358,346
18,804,2,0,0.001,0.001,0.562,417,387
18,904,2,0,0.001,0.001,0.566,466,438
18,1004,2,0,0.001,0.001,0.57,511,493
18,1104,2,0,0.001,0.001,0.574,563,541
18,1204,2,0,0.001,0.001,0.588,612,592
18,1304,2,0,0.001,0.001,0.586,667,637
18,1404,2,0,0.001,0.001,0.594,716,688
18,1504,2,0,0.001,0.001,0.592,758,746
18,1604,2,0,0.001,0.001,0.588,804,800
18,1704,2,0,0.001,0.001,0.592,853,851
18,1804,2,0,0.001,0.001,0.588,904,900
18,1904,2,0,0.001,0.001,0.582,952,952
19,0,2,0,0.001,0.001,0.5,0,0
19,104,2,0,0.001,0.001,0.5,51,53
19,204,2,0,0.001,0.001,0.5,100,104
19,304,2,0,0.001,0.001,0.5,146,158
19,404,2,0,0.001,0.001,0.5,194,210
19,504,2,0,0.001,0.001,0.5,242,262
19,604,2,0,0.001,0.001,0.5,290,314
19,704,2,0,0.001,0.001,0.5,345,359
19,804,2,0,0.001,0.001,0.5,392,412
19,904,2,0,0.001,0.001,0.5,440,464
19,1004,2,0,0.001,0.001,0.5,490,514
19,1104,2,0,0.001,0.001,0.5,546,558
19,1204,2,0,0.001,0.001,0.5,590,614
19,1304,2,0,0.001,0.001,0.5,641,663
19,1404,2,0,0.001,0.001,0.5,695,709
19,1504,2,0,0.001,0.001,0.5,742,762
19,1604,2,0,0.001,0.001,0.5,798,806
19,1704,2,0,0.001,0.001,0.5,851,853
19,1804,2,0,0.001,0.001,0.5,901,903
19,1904,2,0,0.001,0.001,0.5,952,952
20,0,2,0,0.001,0.001,0.5,0,0
20,104,2,0,0.001,0.001,0.5,49,55
20,204,2,0,0.001,0.001,0.5,103,101
20,304,2,0,0.001,0.001,0.5,153,151
20,404,2,0,0.001,0.001,0.5,194,210
20,504,2,0,0.001,0.001,0.5,240,264
20,604,2,0,0.001,0.001,0.5,289,315
20,704,2,0,0.001,0.001,0.5,341,363
20,804,2,0,0.001,0.001,0.5,384,420
20,904,2,0,0.001,0.001,0.5,428,476
20,1004,2,0,0.001,0.001,0.5,480,524
20,1104,2,0,0.001,0.001,0.5,540,564
20,1204,2,0,0.001,0.001,0.5,588,616
20,1304,2,0,0.001,0.001,0.5,646,658
20,1404,2,0,0.001,0.001,0.5,703,701
20,1504,2,0,0.001,0.001,0.5,752,752
20,1604,2,0,0.001,0.001,0.5,804,800
20,1704,2,0,0.001,0.001,0.5,855,849
20,1804,2,0,0.001,0.001,0.5,901,903
20,1904,2,0,0.001,0.001,0.51,952,952
1,0,2,0,0.001,0.01,0.506,0,0
1,104,2,0,0.001,0.01,0.504,55,49
1,204,2,0,0.001,0.01,0.516,107,97
1,304,2,0,0.001,0.01,0.52,157,147
1,404,2,0,0.001,0.01,0.504,206,198
1,504,2,0,0.001,0.01,0.502,253,251
1,604,2,0,0.001,0.01,0.504,297,307
1,704,2,0,0.001,0.01,0.504,349,355
1,804,2,0,0.001,0.01,0.5,396,408
1,904,2,0,0.001,0.01,0.5,446,458
1,1004,2,0,0.001,0.01,0.498,497,507
1,1104,2,0,0.001,0.01,0.498,550,554
1,1204,2,0,0.001,0.01,0.5,594,610
1,1304,2,0,0.001,0.01,0.5,648,656
1,1404,2,0,0.001,0.01,0.5,702,702
1,1504,2,0,0.001,0.01,0.5,754,750
1,1604,2,0,0.001,0.01,0.498,801,803
1,1704,2,0,0.001,0.01,0.5,848,856
1,1804,2,0,0.001,0.01,0.5,898,906
1,1904,2,0,0.001,0.01,0.504,952,952
2,0,2,0,0.001,0.01,0.73,0,0
2,104,2,0,0.001,0.01,0.734,48,56
2,204,2,0,0.001,0.01,0.734,104,100
2,304,2,0,0.001,0.01,0.692,153,151
2,404,2,0,0.001,0.01,0.66,206,198
2,504,2,0,0.001,0.01,0.582,258,246
2,604,2,0,0.001,0.01,0.54,306,298
2,704,2,0,0.001,0.01,0.512,364,340
2,804,2,0,0.001,0.01,0.484,418,386
2,904,2,0,0.001,0.01,0.496,463,441
2,1004,2,0,0.001,0.01,0.496,511,493
2,1104,2,0,0.001,0.01,0.494,566,538
2,1204,2,0,0.001,0.01,0.494,610,594
2,1304,2,0,0.001,0.01,0.5,655,649
2,1404,2,0,0.001,0.01,0.5,697,707
2,1504,2,0,0.001,0.01,0.5,752,752
2,1604,2,0,0.001,0.01,0.5,800,804
2,1704,2,0,0.001,0.01,0.5,854,850
2,1804,2,0,0.001,0.01,0.498,900,904
2,1904,2,0,0.001,0.01,0.498,952,952
3,0,2,0,0.001,0.01,0.484,0,0
3,104,2,0,0.001,0.01,0.476,49,55
3,204,2,0,0.001,0.01,0.47,103,101
3,304,2,0,0.001,0.01,0.478,161,143
3,404,2,0,0.001,0.01,0.482,214,190
3,504,2,0,0.001,0.01,0.492,266,238
3,604,2,0,0.001,0.01,0.482,320,284
3,704,2,0,0.001,0.01,0.49,373,331
3,804,2,0,0.001,0.01,0.5,416,388
3,904,2,0,0.001,0.01,0.5,465,439
3,1004,2,0,0.001,0.01,0.5,508,496
3,1104,2,0,0.001,0.01,0.5,566,538
3,1204,2,0,0.001,0.01,0.5,613,591
3,1304,2,0,0.001,0.01,0.5,657,647
3,1404,2,0,0.001,0.01,0.5,714,690
3,1504,2,0,0.001,0.01,0.5,763,741
3,1604,2,0,0.001,0.01,0.5,806,798
3,1704,2,0,0.001,0.01,0.5,857,847
3,1804,2,0,0.001,0.01,0.502,903,901
3,1904,2,0,0.001,0.01,0.5,952,952
4,0,2,0,0.001,0.01,0.5,0,0
4,104,2,0,0.001,0.01,0.5,52,52
4,204,2,0,0.001,0.01,0.5,101,103
4,304,2,0,0.001,0.01,0.5,153,151
4,404,2,0,0.001,0.01,0.5,200,204
4,504,2,0,0.001,0.01,0.5,240,264
4,604,2,0,0.001,0.01,0.5,295,309
4,704,2,0,0.001,0.01,0.5,349,355
4,804,2,0,0.001,0.01,0.5,403,401
4,904,2,0,0.001,0.01,0.5,458,446
4,1004,2,0,0.001,0.01,0.5,506,498
4,1104,2,0,0.001,0.01,0.5,554,550
4,1204,2,0,0.001,0.01,0.5,600,604
4,1304,2,0,0.001,0.01,0.532,657,647
4,1404,2,0,0.001,0.01,0.5,708,696
4,1504,2,0,0.001,0.01,0.5,756,748
4,1604,2,0,0.001,0.01,0.5,804,800
4,1704,2,0,0.001,0.01,0.5,852,852
4,1804,2,0,0.001,0.01,0.506,901,903
4,1904,2,0,0.001,0.01,0.506,952,952
5,0,2,0,0.001,0.01,0.758,0,0
5,104,2,0,0.001,0.01,0.75,54,50
5,204,2,0,0.001,0.01,0.732,98,106
5,304,2,0,0.001,0.01,0.706,152,152
5,404,2,0,0.001,0.01,0.652,203,201
5,504,2,0,0.001,0.01,0.618,255,249
5,604,2,0,0.001,0.01,0.57,304,300
5,704,2,0,0.001,0.01,0.556,359,345
5,804,2,0,0.001,0.01,0.532,405,399
5,904,2,0,0.001,0.01,0.536,450,454
5,1004,2,0,0.001,0.01,0.53,508,496
5,1104,2,0,0.001,0.01,0.54,557,547
5,1204,2,0,0.001,0.01,0.546,604,600
5,1304,2,0,0.001,0.01,0.566,664,640
5,1404,2,0,0.001,0.01,0.558,707,697
5,1504,2,0,0.001,0.01,0.534,758,746
5,1604,2,0,0.001,0.01,0.528,804,800
5,1704,2,0,0.001,0.01,0.53,861,843
5,1804,2,0,0.001,0.01,0.516,908,896
5,1904,2,0,0.001,0.01,0.534,952,952
6,0,2,0,0.001,0.01,0.534,0,0
6,104,2,0,0.001,0.01,0.534,44,60
6,204,2,0,0.001,0.01,0.536,88,116
6,304,2,0,0.001,0.01,0.532,139,165
6,404,2,0,0.001,0.01,0.522,193,211
6,504,2,0,0.001,0.01,0.526,249,255
6,604,2,0,0.001,0.01,0.514,294,310
6,704,2,0,0.001,0.01,0.504,342,362
6,804,2,0,0.001,0.01,0.508,393,411
6,904,2,0,0.001,0.01,0.496,440,464
6,1004,2,0,0.001,0.01,0.5,492,512
6,1104,2,0,0.001,0.01,0.5,541,563
6,1204,2,0,0.001,0.01,0.5,593,611
6,1304,2,0,0.001,0.01,0.5,646,658
6,1404,2,0,0.001,0.01,0.5,697,707
6,1504,2,0,0.001,0.01,0.5,741,763
6,1604,2,0,0.001,0.01,0.5,787,817
6,1704,2,0,0.001,0.01,0.5,838,866
6,1804,2,0,0.001,0.01,0.5,896,908
6,1904,2,0,0.001,0.01,0.5,952,952
7,0,2,0,0.001,0.01,0.48,0,0
7,104,2,0,0.001,0.01,0.476,57,47
7,204,2,0,0.001,0.01,0.476,103,101
7,304,2,0,0.001,0.01,0.476,155,149
7,404,2,0,0.001,0.01,0.484,204,200
7,504,2,0,0.001,0.01,0.48,261,243
7,604,2,0,0.001,0.01,0.488,307,297
7,704,2,0,0.001,0.01,0.5,361,343
7,804,2,0,0.001,0.01,0.5,401,403
7,904,2,0,0.001,0.01,0.5,449,455
7,1004,2,0,0.001,0.01,0.498,490,514
7,1104,2,0,0.001,0.01,0.5,546,558
7,1204,2,0,0.001,0.01,0.506,598,606
7,1304,2,0,0.001,0.01,0.496,653,651
7,1404,2,0,0.001,0.01,0.496,701,703
7,1504,2,0,0.001,0.01,0.498,745,759
7,1604,2,0,0.001,0.01,0.508,794,810
7,1704,2,0,0.001,0.01,0.506,842,862
7,1804,2,0,0.001,0.01,0.5,898,906
7,1904,2,0,0.001,0.01,0.488,952,952
8,0,2,0,0.001,0.01,0.64,0,0
8,104,2,0,0.001,0.01,0.642,50,54
8,204,2,0,0.001,0.01,0.628,102,102
8,304,2,0,0.001,0.01,0.614,149,155
8,404,2,0,0.001,0.01,0.57,198,206
8,504,2,0,0.001,0.01,0.52,247,257
8,604,2,0,0.001,0.01,0.522,292,312
8,704,2,0,0.001,0.01,0.514,345,359
8,804,2,0,0.001,0.01,0.506,397,407
8,904,2,0,0.001,0.01,0.514,449,455
8,1004,2,0,0.001,0.01,0.5,503,501
8,1104,2,0,0.001,0.01,0.5,553,551
8,1204,2,0,0.001,0.01,0.5,600,604
8,1304,2,0,0.001,0.01,0.5,651,653
8,1404,2,0,0.001,0.01,0.502,710,694
8,1504,2,0,0.001,0.01,0.502,761,743
8,1604,2,0,0.001,0.01,0.502,802,802
8,1704,2,0,0.001,0.01,0.502,853,851
8,1804,2,0,0.001,0.01,0.5,900,904
8,1904,2,0,0.001,0.01,0.5,952,952
9,0,2,0,0.001,0.01,0.492,0,0
9,104,2,0,0.001,0.01,0.492,55,49
9,204,2,0,0.001,0.01,0.492,105,99
9,304,2,0,0.001,0.01,0.494,166,138
9,404,2,0,0.001,0.01,0.5,220,184
9,504,2,0,0.001,0.01,0.5,260,244
9,604,2,0,0.001,0.01,0.506,310,294
9,704,2,0,0.001,0.01,0.5,369,335
9,804,2,0,0.001,0.01,0.5,421,383
9,904,2,0,0.001,0.01,0.5,467,437
9,1004,2,0,0.001,0.01,0.5,504,500
9,1104,2,0,0.001,0.01,0.5,550,554
9,1204,2,0,0.001,0.01,0.498,592,612
9,1304,2,0,0.001,0.01,0.496,645,659
9,1404,2,0,0.001,0.01,0.496,696,708
9,1504,2,0,0.001,0.01,0.496,747,757
9,1604,2,0,0.001,0.01,0.5,800,804
9,1704,2,0,0.001,0.01,0.498,846,858
9,1804,2,0,0.001,0.01,0.496,893,911
9,1904,2,0,0.001,0.01,0.5,952,952
10,0,2,0,0.001,0.01,0.5,0,0
10,104,2,0,0.001,0.01,0.5,45,59
10,204,2,0,0.001,0.01,0.5,98,106
10,304,2,0,0.001,0.01,0.5,151,153
10,404,2,0,0.001,0.01,0.5,199,205
10,504,2,0,0.001,0.01,0.5,242,262
10,604,2,0,0.001,0.01,0.5,287,317
10,704,2,0,0.001,0.01,0.5,335,369
10,804,2,0,0.001,0.01,0.5,383,421
10,904,2,0,0.001,0.01,0.5,434,470
10,1004,2,0,0.001,0.01,0.5,504,500
10,1104,2,0,0.001,0.01,0.5,550,554
10,1204,2,0,0.001,0.01,0.5,601,603
10,1304,2,0,0.001,0.01,0.5,654,650
10,1404,2,0,0.001,0.01,0.5,704,700
10,1504,2,0,0.001,0.01,0.5,754,750
10,1604,2,0,0.001,0.01,0.5,802,802
10,1704,2,0,0.001,0.01,0.5,855,849
10,1804,2,0,0.001,0.01,0.5,899,905
10,1904,2,0,0.001,0.01,0.5,952,952
11,0,2,0,0.001,0.01,0.544,0,0
11,104,2,0,0.001,0.01,0.544,52,52
11,204,2,0,0.001,0.01,0.544,89,115
11,304,2,0,0.001,0.01,0.538,142,162
11,404,2,0,0.001,0.01,0.528,192,212
11,504,2,0,0.001,0.01,0.536,233,271
11,604,2,0,0.001,0.01,0.522,277,327
11,704,2,0,0.001,0.01,0.52,331,373
11,804,2,0,0.001,0.01,0.5,369,435
11,904,2,0,0.001,0.01,0.5,419,485
11,1004,2,0,0.001,0.01,0.5,465,539
11,1104,2,0,0.001,0.01,0.5,516,588
11,1204,2,0,0.001,0.01,0.5,574,630
11,1304,2,0,0.001,0.01,0.5,634,670
11,1404,2,0,0.001,0.01,0.522,689,715
11,1504,2,0,0.001,0.01,0.526,749,755
11,1604,2,0,0.001,0.01,0.524,795,809
11,1704,2,0,0.001,0.01,0.526,847,857
11,1804,2,0,0.001,0.01,0.52,901,903
11,1904,2,0,0.001,0.01,0.518,952,952
12,0,2,0,0.001,0.01,0.514,0,0
12,104,2,0,0.001,0.01,0.518,49,55
12,204,2,0,0.001,0.01,0.53,106,98
12,304,2,0,0.001,0.01,0.526,151,153
12,404,2,0,0.001,0.01,0.524,201,203
12,504,2,0,0.001,0.01,0.524,258,246
12,604,2,0,0.001,0.01,0.526,314,290
12,704,2,0,0.001,0.01,0.526,359,345
12,804,2,0,0.001,0.01,0.536,414,390
12,904,2,0,0.001,0.01,0.522,453,451
12,1004,2,0,0.001,0.01,0.51,512,492
12,1104,2,0,0.001,0.01,0.5,561,543
12,1204,2,0,0.001,0.01,0.5,600,604
12,1304,2,0,0.001,0.01,0.5,654,650
12,1404,2,0,0.001,0.01,0.5,695,709
12,1504,2,0,0.001,0.01,0.5,751,753
12,1604,2,0,0.001,0.01,0.502,807,797
12,1704,2,0,0.001,0.01,0.504,853,851
12,1804,2,0,0.001,0.01,0.502,909,895
12,1904,2,0,0.001,0.01,0.5,952,952
13,0,2,0,0.001,0.01,0.728,0,0
13,104,2,0,0.001,0.01,0.73,48,56
13,204,2,0,0.001,0.01,0.72,100,104
13,304,2,0,0.001,0.01,0.692,151,153
13,404,2,0,0.001,0.01,0.698,206,198
13,504,2,0,0.001,0.01,0.586,261,243
13,604,2,0,0.001,0.01,0.554,310,294
13,704,2,0,0.001,0.01,0.668,366,338
13,804,2,0,0.001,0.01,0.724,411,393
13,904,2,0,0.001,0.01,0.686,459,445
13,1004,2,0,0.001,0.01,0.69,502,502
13,1104,2,0,0.001,0.01,0.688,560,544
13,1204,2,0,0.001,0.01,0.69,608,596
13,1304,2,0,0.001,0.01,0.71,650,654
13,1404,2,0,0.001,0.01,0.668,696,708
13,1504,2,0,0.001,0.01,0.702,743,761
13,1604,2,0,0.001,0.01,0.712,797,807
13,1704,2,0,0.001,0.01,0.682,850,854
13,1804,2,0,0.001,0.01,0.704,896,908
13,1904,2,0,0.001,0.01,0.696,952,952
14,0,2,0,0.001,0.01,0.75,0,0
14,104,2,0,0.001,0.01,0.746,44,60
14,204,2,0,0.001,0.01,0.736,100,104
14,304,2,0,0.001,0.01,0.706,147,157
14,404,2,0,0.001,0.01,0.686,200,204
14,504,2,0,0.001,0.01,0.634,255,249
14,604,2,0,0.001,0.01,0.556,306,298
14,704,2,0,0.001,0.01,0.512,358,346
14,804,2,0,0.001,0.01,0.518,390,414
14,904,2,0,0.001,0.01,0.71,444,460
14,1004,2,0,0.001,0.01,0.67,505,499
14,1104,2,0,0.001,0.01,0.66,554,550
14,1204,2,0,0.001,0.01,0.692,608,596
14,1304,2,0,0.001,0.01,0.682,657,647
14,1404,2,0,0.001,0.01,0.668,703,701
14,1504,2,0,0.001,0.01,0.744,754,750
14,1604,2,0,0.001,0.01,0.708,802,802
14,1704,2,0,0.001,0.01,0.704,854,850
14,1804,2,0,0.001,0.01,0.714,907,897
14,1904,2,0,0.001,0.01,0.738,952,952
15,0,2,0,0.001,0.01,0.678,0,0
15,104,2,0,0.001,0.01,0.67,52,52
15,204,2,0,0.001,0.01,0.652,101,103
15,304,2,0,0.001,0.01,0.606,151,153
15,404,2,0,0.001,0.01,0.662,196,208
15,504,2,0,0.001,0.01,0.682,244,260
15,604,2,0,0.001,0.01,0.72,306,298
15,704,2,0,0.001,0.01,0.706,353,351
15,804,2,0,0.001,0.01,0.716,404,400
15,904,2,0,0.001,0.01,0.682,458,446
15,1004,2,0,0.001,0.01,0.7,508,496
15,1104,2,0,0.001,0.01,0.71,549,555
15,1204,2,0,0.001,0.01,0.702,607,597
15,1304,2,0,0.001,0.01,0.684,653,651
15,1404,2,0,0.001,0.01,0.724,704,700
15,1504,2,0,0.001,0.01,0.696,755,749
15,1604,2,0,0.001,0.01,0.676,796,808
15,1704,2,0,0.001,0.01,0.682,849,855
15,1804,2,0,0.001,0.01,0.718,901,903
15,1904,2,0,0.001,0.01,0.692,952,952
16,0,2,0,0.001,0.01,0.732,0,0
16,104,2,0,0.001,0.01,0.726,54,50
16,204,2,0,0.001,0.01,0.696,106,98
16,304,2,0,0.001,0.01,0.634,156,148
16,404,2,0,0.001,0.01,0.578,200,204
16,504,2,0,0.001,0.01,0.538,250,254
16,604,2,0,0.001,0.01,0.506,295,309
16,704,2,0,0.001,0.01,0.508,341,363
16,804,2,0,0.001,0.01,0.512,394,410
16,904,2,0,0.001,0.01,0.508,446,458
16,1004,2,0,0.001,0.01,0.514,492,512
16,1104,2,0,0.001,0.01,0.512,549,555
16,1204,2,0,0.001,0.01,0.5,602,602
16,1304,2,0,0.001,0.01,0.5,658,646
16,1404,2,0,0.001,0.01,0.5,706,698
16,1504,2,0,0.001,0.01,0.502,759,745
16,1604,2,0,0.001,0.01,0.5,803,801
16,1704,2,0,0.001,0.01,0.498,850,854
16,1804,2,0,0.001,0.01,0.5,902,902
16,1904,2,0,0.001,0.01,0.5,952,952
17,0,2,0,0.001,0.01,0.612,0,0
17,104,2,0,0.001,0.01,0.614,55,49
17,204,2,0,0.001,0.01,0.602,99,105
17,304,2,0,0.001,0.01,0.596,150,154
17,404,2,0,0.001,0.01,0.578,203,201
17,504,2,0,0.001,0.01,0.582,254,250
17,604,2,0,0.001,0.01,0.592,303,301
17,704,2,0,0.001,0.01,0.57,350,354
17,804,2,0,0.001,0.01,0.53,403,401
17,904,2,0,0.001,0.01,0.51,451,453
17,1004,2,0,0.001,0.01,0.502,498,506
17,1104,2,0,0.001,0.01,0.5,539,565
17,1204,2,0,0.001,0.01,0.49,590,614
17,1304,2,0,0.001,0.01,0.498,647,657
17,1404,2,0,0.001,0.01,0.506,697,707
17,1504,2,0,0.001,0.01,0.508,754,750
17,1604,2,0,0.001,0.01,0.514,805,799
17,1704,2,0,0.001,0.01,0.514,853,851
17,1804,2,0,0.001,0.01,0.514,907,897
17,1904,2,0,0.001,0.01,0.508,952,952
18,0,2,0,0.001,0.01,0.496,0,0
18,104,2,0,0.001,0.01,0.502,57,47
18,204,2,0,0.001,0.01,0.496,99,105
18,304,2,0,0.001,0.01,0.498,146,158
18,404,2,0,0.001,0.01,0.502,194,210
18,504,2,0,0.001,0.01,0.498,237,267
18,604,2,0,0.001,0.01,0.498,285,319
18,704,2,0,0.001,0.01,0.496,331,373
18,804,2,0,0.001,0.01,0.498,386,418
18,904,2,0,0.001,0.01,0.498,429,475
18,1004,2,0,0.001,0.01,0.502,479,525
18,1104,2,0,0.001,0.01,0.502,530,574
18,1204,2,0,0.001,0.01,0.502,586,618
18,1304,2,0,0.001,0.01,0.502,638,666
18,1404,2,0,0.001,0.01,0.502,688,716
18,1504,2,0,0.001,0.01,0.502,742,762
18,1604,2,0,0.001,0.01,0.502,787,817
18,1704,2,0,0.001,0.01,0.502,844,860
18,1804,2,0,0.001,0.01,0.502,903,901
18,1904,2,0,0.001,0.01,0.502,952,952
19,0,2,0,0.001,0.01,0.714,0,0
19,104,2,0,0.001,0.01,0.714,42,62
19,204,2,0,0.001,0.01,0.708,87,117
19,304,2,0,0.001,0.01,0.686,136,168
19,404,2,0,0.001,0.01,0.654,190,214
19,504,2,0,0.001,0.01,0.586,239,265
19,604,2,0,0.001,0.01,0.568,290,314
19,704,2,0,0.001,0.01,0.564,340,364
19,804,2,0,0.001,0.01,0.532,397,407
19,904,2,0,0.001,0.01,0.518,445,459
19,1004,2,0,0.001,0.01,0.498,495,509
19,1104,2,0,0.001,0.01,0.512,558,546
19,1204,2,0,0.001,0.01,0.498,611,593
19,1304,2,0,0.001,0.01,0.502,661,643
19,1404,2,0,0.001,0.01,0.506,715,689
19,1504,2,0,0.001,0.01,0.498,757,747
19,1604,2,0,0.001,0.01,0.502,805,799
19,1704,2,0,0.001,0.01,0.502,857,847
19,1804,2,0,0.001,0.01,0.51,901,903
19,1904,2,0,0.001,0.01,0.512,952,952
20,0,2,0,0.001,0.01,0.506,0,0
20,104,2,0,0.001,0.01,0.506,61,43
20,204,2,0,0.001,0.01,0.498,106,98
20,304,2,0,0.001,0.01,0.498,151,153
20,404,2,0,0.001,0.01,0.492,204,200
20,504,2,0,0.001,0.01,0.5,252,252
20,604,2,0,0.001,0.01,0.504,306,298
20,704,2,0,0.001,0.01,0.502,358,346
20,804,2,0,0.001,0.01,0.5,406,398
20,904,2,0,0.001,0.01,0.5,463,441
20,1004,2,0,0.001,0.01,0.5,514,490
20,1104,2,0,0.001,0.01,0.5,559,545
20,1204,2,0,0.001,0.01,0.5,614,590
20,1304,2,0,0.001,0.01,0.5,661,643
20,1404,2,0,0.001,0.01,0.5,713,691
20,1504,2,0,0.001,0.01,0.5,762,742
20,1604,2,0,0.001,0.01,0.5,816,788
20,1704,2,0,0.001,0.01,0.5,858,846
20,1804,2,0,0.001,0.01,0.5,900,904
20,1904,2,0,0.001,0.01,0.5,952,952
1,0,10,0,1e-05,0.0001,0.5,0,0
1,104,10,0,1e-05,0.0001,0.5,45,59
1,204,10,0,1e-05,0.0001,0.5,94,110
1,304,10,0,1e-05,0.0001,0.5,144,160
1,404,10,0,1e-05,0.0001,0.5,195,209
1,504,10,0,1e-05,0.0001,0.5,247,257
1,604,10,0,1e-05,0.0001,0.5,301,303
1,704,10,0,1e-05,0.0001,0.5,344,360
1,804,10,0,1e-05,0.0001,0.5,389,415
1,904,10,0,1e-05,0.0001,0.5,439,465
1,1004,10,0,1e-05,0.0001,0.5,485,519
1,1104,10,0,1e-05,0.0001,0.5,533,571
1,1204,10,0,1e-05,0.0001,0.5,585,619
1,1304,10,0,1e-05,0.0001,0.5,638,666
1,1404,10,0,1e-05,0.0001,0.5,689,715
1,1504,10,0,1e-05,0.0001,0.5,744,760
1,1604,10,0,1e-05,0.0001,0.5,796,808
1,1704,10,0,1e-05,0.0001,0.5,852,852
1,1804,10,0,1e-05,0.0001,0.5,894,910
1,1904,10,0,1e-05,0.0001,0.5,952,952
2,0,10,0,1e-05,0.0001,0.478,0,0
2,104,10,0,1e-05,0.0001,0.478,58,46
2,204,10,0,1e-05,0.0001,0.478,108,96
2,304,10,0,1e-05,0.0001,0.476,158,146
2,404,10,0,1e-05,0.0001,0.474,218,186
2,504,10,0,1e-05,0.0001,0.478,260,244
2,604,10,0,1e-05,0.0001,0.48,312,292
2,704,10,0,1e-05,0.0001,0.472,353,351
2,804,10,0,1e-05,0.0001,0.468,399,405
2,904,10,0,1e-05,0.0001,0.47,451,453
2,1004,10,0,1e-05,0.0001,0.476,503,501
2,1104,10,0,1e-05,0.0001,0.482,541,563
2,1204,10,0,1e-05,0.0001,0.48,595,609
2,1304,10,0,1e-05,0.0001,0.48,644,660
2,1404,10,0,1e-05,0.0001,0.478,696,708
2,1504,10,0,1e-05,0.0001,0.478,750,754
2,1604,10,0,1e-05,0.0001,0.482,807,797
2,1704,10,0,1e-05,0.0001,0.482,852,852
2,1804,10,0,1e-05,0.0001,0.484,900,904
2,1904,10,0,1e-05,0.0001,0.49,952,952
3,0,10,0,1e-05,0.0001,0.5,0,0
3,104,10,0,1e-05,0.0001,0.5,57,47
3,204,10,0,1e-05,0.0001,0.5,107,97
3,304,10,0,1e-05,0.0001,0.5,156,148
3,404,10,0,1e-05,0.0001,0.5,196,208
3,504,10,0,1e-05,0.0001,0.5,248,256
3,604,10,0,1e-05,0.0001,0.5,297,307
3,704,10,0,1e-05,0.0001,0.5,346,358
3,804,10,0,1e-05,0.0001,0.5,387,417
3,904,10,0,1e-05,0.0001,0.5,440,464
3,1004,10,0,1e-05,0.0001,0.502,486,518
3,1104,10,0,1e-05,0.0001,0.502,539,565
3,1204,10,0,1e-05,0.0001,0.502,591,613
3,1304,10,0,1e-05,0.0001,0.502,643,661
3,1404,10,0,1e-05,0.0001,0.502,701,703
3,1504,10,0,1e-05,0.0001,0.502,753,751
3,1604,10,0,1e-05,0.0001,0.502,796,808
3,1704,10,0,1e-05,0.0001,0.502,840,864
3,1804,10,0,1e-05,0.0001,0.502,892,912
3,1904,10,0,1e-05,0.0001,0.502,952,952
4,0,10,0,1e-05,0.0001,0.484,0,0
4,104,10,0,1e-05,0.0001,0.486,52,52
4,204,10,0,1e-05,0.0001,0.484,94,110
4,304,10,0,1e-05,0.0001,0.484,143,161
4,404,10,0,1e-05,0.0001,0.484,195,209
4,504,10,0,1e-05,0.0001,0.482,242,262
4,604,10,0,1e-05,0.0001,0.482,285,319
4,704,10,0,1e-05,0.0001,0.482,340,364
4,804,10,0,1e-05,0.0001,0.486,389,415
4,904,10,0,1e-05,0.0001,0.486,447,457
4,1004,10,0,1e-05,0.0001,0.486,493,511
4,1104,10,0,1e-05,0.0001,0.484,539,565
4,1204,10,0,1e-05,0.0001,0.486,599,605
4,1304,10,0,1e-05,0.0001,0.488,642,662
4,1404,10,0,1e-05,0.0001,0.488,688,716
4,1504,10,0,1e-05,0.0001,0.484,739,765
4,1604,10,0,1e-05,0.0001,0.478,784,820
4,1704,10,0,1e-05,0.0001,0.478,841,863
4,1804,10,0,1e-05,0.0001,0.476,889,915
4,1904,10,0,1e-05,0.0001,0.482,952,952
5,0,10,0,1e-05,0.0001,0.5,0,0
5,104,10,0,1e-05,0.0001,0.5,52,52
5,204,10,0,1e-05,0.0001,0.5,106,98
5,304,10,0,1e-05,0.0001,0.5,164,140
5,404,10,0,1e-05,0.0001,0.5,215,189
5,504,10,0,1e-05,0.0001,0.5,273,231
5,604,10,0,1e-05,0.0001,0.5,326,278
5,704,10,0,1e-05,0.0001,0.5,371,333
5,804,10,0,1e-05,0.0001,0.5,416,388
5,904,10,0,1e-05,0.0001,0.5,465,439
5,1004,10,0,1e-05,0.0001,0.5,511,493
5,1104,10,0,1e-05,0.0001,0.5,560,544
5,1204,10,0,1e-05,0.0001,0.5,597,607
5,1304,10,0,1e-05,0.0001,0.5,650,654
5,1404,10,0,1e-05,0.0001,0.5,708,696
5,1504,10,0,1e-05,0.0001,0.5,749,755
5,1604,10,0,1e-05,0.0001,0.5,801,803
5,1704,10,0,1e-05,0.0001,0.5,853,851
5,1804,10,0,1e-05,0.0001,0.5,901,903
5,1904,10,0,1e-05,0.0001,0.5,952,952
6,0,10,0,1e-05,0.0001,0.5,0,0
6,104,10,0,1e-05,0.0001,0.5,50,54
6,204,10,0,1e-05,0.0001,0.5,105,99
6,304,10,0,1e-05,0.0001,0.5,154,150
6,404,10,0,1e-05,0.0001,0.5,200,204
6,504,10,0,1e-05,0.0001,0.5,244,260
6,604,10,0,1e-05,0.0001,0.5,287,317
6,704,10,0,1e-05,0.0001,0.5,342,362
6,804,10,0,1e-05,0.0001,0.5,398,406
6,904,10,0,1e-05,0.0001,0.5,449,455
6,1004,10,0,1e-05,0.0001,0.5,489,515
6,1104,10,0,1e-05,0.0001,0.5,533,571
6,1204,10,0,1e-05,0.0001,0.5,587,617
6,1304,10,0,1e-05,0.0001,0.498,639,665
6,1404,10,0,1e-05,0.0001,0.498,685,719
6,1504,10,0,1e-05,0.0001,0.498,744,760
6,1604,10,0,1e-05,0.0001,0.498,795,809
6,1704,10,0,1e-05,0.0001,0.5,844,860
6,1804,10,0,1e-05,0.0001,0.498,896,908
6,1904,10,0,1e-05,0.0001,0.498,952,952
7,0,10,0,1e-05,0.0001,0.524,0,0
7,104,10,0,1e-05,0.0001,0.524,53,51
7,204,10,0,1e-05,0.0001,0.524,100,104
7,304,10,0,1e-05,0.0001,0.524,149,155
7,404,10,0,1e-05,0.0001,0.522,194,210
7,504,10,0,1e-05,0.0001,0.524,243,261
7,604,10,0,1e-05,0.0001,0.524,291,313
7,704,10,0,1e-05,0.0001,0.52,345,359
7,804,10,0,1e-05,0.0001,0.52,403,401
7,904,10,0,1e-05,0.0001,0.52,456,448
7,1004,10,0,1e-05,0.0001,0.52,512,492
7,1104,10,0,1e-05,0.0001,0.518,566,538
7,1204,10,0,1e-05,0.0001,0.524,616,588
7,1304,10,0,1e-05,0.0001,0.524,665,639
7,1404,10,0,1e-05,0.0001,0.514,713,691
7,1504,10,0,1e-05,0.0001,0.506,763,741
7,1604,10,0,1e-05,0.0001,0.51,807,797
7,1704,10,0,1e-05,0.0001,0.516,850,854
7,1804,10,0,1e-05,0.0001,0.518,899,905
7,1904,10,0,1e-05,0.0001,0.52,952,952
8,0,10,0,1e-05,0.0001,0.498,0,0
8,104,10,0,1e-05,0.0001,0.498,58,46
8,204,10,0,1e-05,0.0001,0.498,105,99
8,304,10,0,1e-05,0.0001,0.498,159,145
8,404,10,0,1e-05,0.0001,0.498,213,191
8,504,10,0,1e-05,0.0001,0.498,260,244
8,604,10,0,1e-05,0.0001,0.498,312,292
8,704,10,0,1e-05,0.0001,0.498,362,342
8,804,10,0,1e-05,0.0001,0.498,403,401
8,904,10,0,1e-05,0.0001,0.498,454,450
8,1004,10,0,1e-05,0.0001,0.498,497,507
8,1104,10,0,1e-05,0.0001,0.5,541,563
8,1204,10,0,1e-05,0.0001,0.498,599,605
8,1304,10,0,1e-05,0.0001,0.498,655,649
8,1404,10,0,1e-05,0.0001,0.498,701,703
8,1504,10,0,1e-05,0.0001,0.5,753,751
8,1604,10,0,1e-05,0.0001,0.502,799,805
8,1704,10,0,1e-05,0.0001,0.502,850,854
8,1804,10,0,1e-05,0.0001,0.506,903,901
8,1904,10,0,1e-05,0.0001,0.51,952,952
9,0,10,0,1e-05,0.0001,0.51,0,0
9,104,10,0,1e-05,0.0001,0.512,66,38
9,204,10,0,1e-05,0.0001,0.522,112,92
9,304,10,0,1e-05,0.0001,0.524,165,139
9,404,10,0,1e-05,0.0001,0.54,214,190
9,504,10,0,1e-05,0.0001,0.534,267,237
9,604,10,0,1e-05,0.0001,0.52,318,286
9,704,10,0,1e-05,0.0001,0.506,363,341
9,804,10,0,1e-05,0.0001,0.51,414,390
9,904,10,0,1e-05,0.0001,0.51,470,434
9,1004,10,0,1e-05,0.0001,0.51,521,483
9,1104,10,0,1e-05,0.0001,0.518,565,539
9,1204,10,0,1e-05,0.0001,0.52,608,596
9,1304,10,0,1e-05,0.0001,0.52,665,639
9,1404,10,0,1e-05,0.0001,0.518,706,698
9,1504,10,0,1e-05,0.0001,0.516,758,746
9,1604,10,0,1e-05,0.0001,0.52,806,798
9,1704,10,0,1e-05,0.0001,0.516,852,852
9,1804,10,0,1e-05,0.0001,0.518,901,903
9,1904,10,0,1e-05,0.0001,0.522,952,952
10,0,10,0,1e-05,0.0001,0.5,0,0
10,104,10,0,1e-05,0.0001,0.5,47,57
10,204,10,0,1e-05,0.0001,0.5,100,104
10,304,10,0,1e-05,0.0001,0.5,154,150
10,404,10,0,1e-05,0.0001,0.5,199,205
10,504,10,0,1e-05,0.0001,0.5,243,261
10,604,10,0,1e-05,0.0001,0.5,292,312
10,704,10,0,1e-05,0.0001,0.5,353,351
10,804,10,0,1e-05,0.0001,0.5,400,404
10,904,10,0,1e-05,0.0001,0.5,452,452
10,1004,10,0,1e-05,0.0001,0.5,501,503
10,1104,10,0,1e-05,0.0001,0.5,556,548
10,1204,10,0,1e-05,0.0001,0.5,600,604
10,1304,10,0,1e-05,0.0001,0.5,650,654
10,1404,10,0,1e-05,0.0001,0.5,691,713
10,1504,10,0,1e-05,0.0001,0.5,747,757
10,1604,10,0,1e-05,0.0001,0.5,801,803
10,1704,10,0,1e-05,0.0001,0.5,854,850
10,1804,10,0,1e-05,0.0001,0.5,907,897
10,1904,10,0,1e-05,0.0001,0.5,952,952
11,0,10,0,1e-05,0.0001,0.494,0,0
11,104,10,0,1e-05,0.0001,0.494,56,48
11,204,10,0,1e-05,0.0001,0.494,107,97
11,304,10,0,1e-05,0.0001,0.49,146,158
11,404,10,0,1e-05,0.0001,0.49,197,207
11,504,10,0,1e-05,0.0001,0.488,238,266
11,604,10,0,1e-05,0.0001,0.488,280,324
11,704,10,0,1e-05,0.0001,0.486,329,375
11,804,10,0,1e-05,0.0001,0.478,379,425
11,904,10,0,1e-05,0.0001,0.478,433,471
11,1004,10,0,1e-05,0.0001,0.478,484,520
11,1104,10,0,1e-05,0.0001,0.482,545,559
11,1204,10,0,1e-05,0.0001,0.472,591,613
11,1304,10,0,1e-05,0.0001,0.468,640,664
11,1404,10,0,1e-05,0.0001,0.466,687,717
11,1504,10,0,1e-05,0.0001,0.462,738,766
11,1604,10,0,1e-05,0.0001,0.472,784,820
11,1704,10,0,1e-05,0.0001,0.464,844,860
11,1804,10,0,1e-05,0.0001,0.478,899,905
11,1904,10,0,1e-05,0.0001,0.484,952,952
12,0,10,0,1e-05,0.0001,0.5,0,0
12,104,10,0,1e-05,0.0001,0.5,60,44
12,204,10,0,1e-05,0.0001,0.5,105,99
12,304,10,0,1e-05,0.0001,0.5,153,151
12,404,10,0,1e-05,0.0001,0.5,199,205
12,504,10,0,1e-05,0.0001,0.5,246,258
12,604,10,0,1e-05,0.0001,0.5,294,310
12,704,10,0,1e-05,0.0001,0.5,351,353
12,804,10,0,1e-05,0.0001,0.5,405,399
12,904,10,0,1e-05,0.0001,0.5,458,446
12,1004,10,0,1e-05,0.0001,0.5,514,490
12,1104,10,0,1e-05,0.0001,0.5,563,541
12,1204,10,0,1e-05,0.0001,0.5,610,594
12,1304,10,0,1e-05,0.0001,0.5,665,639
12,1404,10,0,1e-05,0.0001,0.5,712,692
12,1504,10,0,1e-05,0.0001,0.5,760,744
12,1604,10,0,1e-05,0.0001,0.5,813,791
12,1704,10,0,1e-05,0.0001,0.5,862,842
12,1804,10,0,1e-05,0.0001,0.5,905,899
12,1904,10,0,1e-05,0.0001,0.5,952,952
13,0,10,0,1e-05,0.0001,0.5,0,0
13,104,10,0,1e-05,0.0001,0.5,50,54
13,204,10,0,1e-05,0.0001,0.5,101,103
13,304,10,0,1e-05,0.0001,0.5,152,152
13,404,10,0,1e-05,0.0001,0.5,203,201
13,504,10,0,1e-05,0.0001,0.5,250,254
13,604,10,0,1e-05,0.0001,0.5,300,304
13,704,10,0,1e-05,0.0001,0.5,351,353
13,804,10,0,1e-05,0.0001,0.5,394,410
13,904,10,0,1e-05,0.0001,0.5,437,467
13,1004,10,0,1e-05,0.0001,0.5,487,517
13,1104,10,0,1e-05,0.0001,0.5,539,565
13,1204,10,0,1e-05,0.0001,0.5,582,622
13,1304,10,0,1e-05,0.0001,0.5,638,666
13,1404,10,0,1e-05,0.0001,0.5,685,719
13,1504,10,0,1e-05,0.0001,0.5,745,759
13,1604,10,0,1e-05,0.0001,0.5,795,809
13,1704,10,0,1e-05,0.0001,0.5,852,852
13,1804,10,0,1e-05,0.0001,0.5,900,904
13,1904,10,0,1e-05,0.0001,0.5,952,952
14,0,10,0,1e-05,0.0001,0.5,0,0
14,104,10,0,1e-05,0.0001,0.5,55,49
14,204,10,0,1e-05,0.0001,0.5,100,104
14,304,10,0,1e-05,0.0001,0.5,155,149
14,404,10,0,1e-05,0.0001,0.5,216,188
14,504,10,0,1e-05,0.0001,0.5,270,234
14,604,10,0,1e-05,0.0001,0.5,323,281
14,704,10,0,1e-05,0.0001,0.5,377,327
14,804,10,0,1e-05,0.0001,0.5,430,374
14,904,10,0,1e-05,0.0001,0.5,485,419
14,1004,10,0,1e-05,0.0001,0.5,528,476
14,1104,10,0,1e-05,0.0001,0.5,580,524
14,1204,10,0,1e-05,0.0001,0.5,631,573
14,1304,10,0,1e-05,0.0001,0.5,671,633
14,1404,10,0,1e-05,0.0001,0.5,727,677
14,1504,10,0,1e-05,0.0001,0.5,777,727
14,1604,10,0,1e-05,0.0001,0.5,821,783
14,1704,10,0,1e-05,0.0001,0.5,866,838
14,1804,10,0,1e-05,0.0001,0.5,909,895
14,1904,10,0,1e-05,0.0001,0.5,952,952
15,0,10,0,1e-05,0.0001,0.5,0,0
15,104,10,0,1e-05,0.0001,0.5,57,47
15,204,10,0,1e-05,0.0001,0.5,112,92
15,304,10,0,1e-05,0.0001,0.5,169,135
15,404,10,0,1e-05,0.0001,0.5,216,188
15,504,10,0,1e-05,0.0001,0.5,260,244
15,604,10,0,1e-05,0.0001,0.5,312,292
15,704,10,0,1e-05,0.0001,0.5,366,338
15,804,10,0,1e-05,0.0001,0.5,420,384
15,904,10,0,1e-05,0.0001,0.5,479,425
15,1004,10,0,1e-05,0.0001,0.5,525,479
15,1104,10,0,1e-05,0.0001,0.5,574,530
15,1204,10,0,1e-05,0.0001,0.5,611,593
15,1304,10,0,1e-05,0.0001,0.5,662,642
15,1404,10,0,1e-05,0.0001,0.5,707,697
15,1504,10,0,1e-05,0.0001,0.5,754,750
15,1604,10,0,1e-05,0.0001,0.5,810,794
15,1704,10,0,1e-05,0.0001,0.5,859,845
15,1804,10,0,1e-05,0.0001,0.5,909,895
15,1904,10,0,1e-05,0.0001,0.502,952,952
16,0,10,0,1e-05,0.0001,0.488,0,0
16,104,10,0,1e-05,0.0001,0.488,53,51
16,204,10,0,1e-05,0.0001,0.486,103,101
16,304,10,0,1e-05,0.0001,0.486,153,151
16,404,10,0,1e-05,0.0001,0.48,209,195
16,504,10,0,1e-05,0.0001,0.484,267,237
16,604,10,0,1e-05,0.0001,0.476,314,290
16,704,10,0,1e-05,0.0001,0.484,355,349
16,804,10,0,1e-05,0.0001,0.484,407,397
16,904,10,0,1e-05,0.0001,0.484,460,444
16,1004,10,0,1e-05,0.0001,0.48,504,500
16,1104,10,0,1e-05,0.0001,0.472,553,551
16,1204,10,0,1e-05,0.0001,0.468,611,593
16,1304,10,0,1e-05,0.0001,0.462,656,648
16,1404,10,0,1e-05,0.0001,0.466,701,703
16,1504,10,0,1e-05,0.0001,0.472,759,745
16,1604,10,0,1e-05,0.0001,0.47,806,798
16,1704,10,0,1e-05,0.0001,0.47,859,845
16,1804,10,0,1e-05,0.0001,0.466,903,901
16,1904,10,0,1e-05,0.0001,0.478,952,952
17,0,10,0,1e-05,0.0001,0.464,0,0
17,104,10,0,1e-05,0.0001,0.466,59,45
17,204,10,0,1e-05,0.0001,0.462,113,91
17,304,10,0,1e-05,0.0001,0.468,157,147
17,404,10,0,1e-05,0.0001,0.462,206,198
17,504,10,0,1e-05,0.0001,0.462,250,254
17,604,10,0,1e-05,0.0001,0.462,298,306
17,704,10,0,1e-05,0.0001,0.46,354,350
17,804,10,0,1e-05,0.0001,0.458,406,398
17,904,10,0,1e-05,0.0001,0.46,467,437
17,1004,10,0,1e-05,0.0001,0.458,519,485
17,1104,10,0,1e-05,0.0001,0.464,565,539
17,1204,10,0,1e-05,0.0001,0.456,621,583
17,1304,10,0,1e-05,0.0001,0.46,661,643
17,1404,10,0,1e-05,0.0001,0.46,711,693
17,1504,10,0,1e-05,0.0001,0.46,761,743
17,1604,10,0,1e-05,0.0001,0.46,812,792
17,1704,10,0,1e-05,0.0001,0.462,859,845
17,1804,10,0,1e-05,0.0001,0.46,907,897
17,1904,10,0,1e-05,0.0001,0.454,952,952
18,0,10,0,1e-05,0.0001,0.5,0,0
18,104,10,0,1e-05,0.0001,0.5,44,60
18,204,10,0,1e-05,0.0001,0.5,93,111
18,304,10,0,1e-05,0.0001,0.5,141,163
18,404,10,0,1e-05,0.0001,0.5,190,214
18,504,10,0,1e-05,0.0001,0.5,236,268
18,604,10,0,1e-05,0.0001,0.5,294,310
18,704,10,0,1e-05,0.0001,0.5,347,357
18,804,10,0,1e-05,0.0001,0.5,392,412
18,904,10,0,1e-05,0.0001,0.5,431,473
18,1004,10,0,1e-05,0.0001,0.5,481,523
18,1104,10,0,1e-05,0.0001,0.5,543,561
18,1204,10,0,1e-05,0.0001,0.5,588,616
18,1304,10,0,1e-05,0.0001,0.5,640,664
18,1404,10,0,1e-05,0.0001,0.5,688,716
18,1504,10,0,1e-05,0.0001,0.5,740,764
18,1604,10,0,1e-05,0.0001,0.5,792,812
18,1704,10,0,1e-05,0.0001,0.5,847,857
18,1804,10,0,1e-05,0.0001,0.5,901,903
18,1904,10,0,1e-05,0.0001,0.5,952,952
19,0,10,0,1e-05,0.0001,0.498,0,0
19,104,10,0,1e-05,0.0001,0.498,44,60
19,204,10,0,1e-05,0.0001,0.498,93,111
19,304,10,0,1e-05,0.0001,0.496,144,160
19,404,10,0,1e-05,0.0001,0.496,192,212
19,504,10,0,1e-05,0.0001,0.496,246,258
19,604,10,0,1e-05,0.0001,0.496,305,299
19,704,10,0,1e-05,0.0001,0.496,355,349
19,804,10,0,1e-05,0.0001,0.496,400,404
19,904,10,0,1e-05,0.0001,0.498,442,462
19,1004,10,0,1e-05,0.0001,0.498,497,507
19,1104,10,0,1e-05,0.0001,0.5,550,554
19,1204,10,0,1e-05,0.0001,0.502,605,599
19,1304,10,0,1e-05,0.0001,0.504,644,660
19,1404,10,0,1e-05,0.0001,0.506,695,709
19,1504,10,0,1e-05,0.0001,0.506,751,753
19,1604,10,0,1e-05,0.0001,0.498,795,809
19,1704,10,0,1e-05,0.0001,0.5,848,856
19,1804,10,0,1e-05,0.0001,0.502,900,904
19,1904,10,0,1e-05,0.0001,0.506,952,952
20,0,10,0,1e-05,0.0001,0.5,0,0
20,104,10,0,1e-05,0.0001,0.5,53,51
20,204,10,0,1e-05,0.0001,0.5,100,104
20,304,10,0,1e-05,0.0001,0.5,146,158
20,404,10,0,1e-05,0.0001,0.5,189,215
20,504,10,0,1e-05,0.0001,0.5,234,270
20,604,10,0,1e-05,0.0001,0.5,287,317
20,704,10,0,1e-05,0.0001,0.5,341,363
20,804,10,0,1e-05,0.0001,0.502,398,406
20,904,10,0,1e-05,0.0001,0.502,449,455
20,1004,10,0,1e-05,0.0001,0.502,502,502
20,1104,10,0,1e-05,0.0001,0.498,549,555
20,1204,10,0,1e-05,0.0001,0.498,599,605
20,1304,10,0,1e-05,0.0001,0.494,652,652
20,1404,10,0,1e-05,0.0001,0.498,693,711
20,1504,10,0,1e-05,0.0001,0.498,744,760
20,1604,10,0,1e-05,0.0001,0.5,792,812
20,1704,10,0,1e-05,0.0001,0.508,845,859
20,1804,10,0,1e-05,0.0001,0.514,902,902
20,1904,10,0,1e-05,0.0001,0.51,952,952
1,0,10,0,1e-05,0.001,0.502,0,0
1,104,10,0,1e-05,0.001,0.506,50,54
1,204,10,0,1e-05,0.001,0.512,111,93
1,304,10,0,1e-05,0.001,0.512,159,145
1,404,10,0,1e-05,0.001,0.51,202,202
1,504,10,0,1e-05,0.001,0.536,257,247
1,604,10,0,1e-05,0.001,0.532,296,308
1,704,10,0,1e-05,0.001,0.528,345,359
1,804,10,0,1e-05,0.001,0.526,393,411
1,904,10,0,1e-05,0.001,0.538,445,459
1,1004,10,0,1e-05,0.001,0.536,505,499
1,1104,10,0,1e-05,0.001,0.532,556,548
1,1204,10,0,1e-05,0.001,0.522,610,594
1,1304,10,0,1e-05,0.001,0.526,654,650
1,1404,10,0,1e-05,0.001,0.528,704,700
1,1504,10,0,1e-05,0.001,0.53,753,751
1,1604,10,0,1e-05,0.001,0.534,802,802
1,1704,10,0,1e-05,0.001,0.534,859,845
1,1804,10,0,1e-05,0.001,0.542,907,897
1,1904,10,0,1e-05,0.001,0.55,952,952
2,0,10,0,1e-05,0.001,0.574,0,0
2,104,10,0,1e-05,0.001,0.574,59,45
2,204,10,0,1e-05,0.001,0.588,118,86
2,304,10,0,1e-05,0.001,0.604,173,131
2,404,10,0,1e-05,0.001,0.582,225,179
2,504,10,0,1e-05,0.001,0.578,270,234
2,604,10,0,1e-05,0.001,0.58,311,293
2,704,10,0,1e-05,0.001,0.574,366,338
2,804,10,0,1e-05,0.001,0.584,415,389
2,904,10,0,1e-05,0.001,0.594,466,438
2,1004,10,0,1e-05,0.001,0.602,518,486
2,1104,10,0,1e-05,0.001,0.612,573,531
2,1204,10,0,1e-05,0.001,0.624,619,585
2,1304,10,0,1e-05,0.001,0.642,660,644
2,1404,10,0,1e-05,0.001,0.648,709,695
2,1504,10,0,1e-05,0.001,0.652,745,759
2,1604,10,0,1e-05,0.001,0.676,803,801
2,1704,10,0,1e-05,0.001,0.696,855,849
2,1804,10,0,1e-05,0.001,0.694,905,899
2,1904,10,0,1e-05,0.001,0.702,952,952
3,0,10,0,1e-05,0.001,0.57,0,0
3,104,10,0,1e-05,0.001,0.572,55,49
3,204,10,0,1e-05,0.001,0.584,105,99
3,304,10,0,1e-05,0.001,0.582,156,148
3,404,10,0,1e-05,0.001,0.594,206,198
3,504,10,0,1e-05,0.001,0.618,255,249
3,604,10,0,1e-05,0.001,0.616,303,301
3,704,10,0,1e-05,0.001,0.622,351,353
3,804,10,0,1e-05,0.001,0.64,400,404
3,904,10,0,1e-05,0.001,0.644,447,457
3,1004,10,0,1e-05,0.001,0.68,501,503
3,1104,10,0,1e-05,0.001,0.694,547,557
3,1204,10,0,1e-05,0.001,0.704,600,604
3,1304,10,0,1e-05,0.001,0.73,655,649
3,1404,10,0,1e-05,0.001,0.752,702,702
3,1504,10,0,1e-05,0.001,0.782,753,751
3,1604,10,0,1e-05,0.001,0.796,807,797
3,1704,10,0,1e-05,0.001,0.808,854,850
3,1804,10,0,1e-05,0.001,0.82,903,901
3,1904,10,0,1e-05,0.001,0.844,952,952
4,0,10,0,1e-05,0.001,0.52,0,0
4,104,10,0,1e-05,0.001,0.524,55,49
4,204,10,0,1e-05,0.001,0.526,107,97
4,304,10,0,1e-05,0.001,0.54,156,148
4,404,10,0,1e-05,0.001,0.534,211,193
4,504,10,0,1e-05,0.001,0.546,266,238
4,604,10,0,1e-05,0.001,0.542,322,282
4,704,10,0,1e-05,0.001,0.556,366,338
4,804,10,0,1e-05,0.001,0.552,423,381
4,904,10,0,1e-05,0.001,0.56,482,422
4,1004,10,0,1e-05,0.001,0.572,533,471
4,1104,10,0,1e-05,0.001,0.578,577,527
4,1204,10,0,1e-05,0.001,0.57,626,578
4,1304,10,0,1e-05,0.001,0.57,669,635
4,1404,10,0,1e-05,0.001,0.572,723,681
4,1504,10,0,1e-05,0.001,0.588,761,743
4,1604,10,0,1e-05,0.001,0.596,806,798
4,1704,10,0,1e-05,0.001,0.61,855,849
4,1804,10,0,1e-05,0.001,0.628,903,901
4,1904,10,0,1e-05,0.001,0.642,952,952
5,0,10,0,1e-05,0.001,0.572,0,0
5,104,10,0,1e-05,0.001,0.57,53,51
5,204,10,0,1e-05,0.001,0.572,107,97
5,304,10,0,1e-05,0.001,0.574,155,149
5,404,10,0,1e-05,0.001,0.556,204,200
5,504,10,0,1e-05,0.001,0.562,256,248
5,604,10,0,1e-05,0.001,0.54,308,296
5,704,10,0,1e-05,0.001,0.528,355,349
5,804,10,0,1e-05,0.001,0.542,404,400
5,904,10,0,1e-05,0.001,0.542,443,461
5,1004,10,0,1e-05,0.001,0.56,491,513
5,1104,10,0,1e-05,0.001,0.57,548,556
5,1204,10,0,1e-05,0.001,0.58,595,609
5,1304,10,0,1e-05,0.001,0.594,653,651
5,1404,10,0,1e-05,0.001,0.606,701,703
5,1504,10,0,1e-05,0.001,0.614,748,756
5,1604,10,0,1e-05,0.001,0.636,803,801
5,1704,10,0,1e-05,0.001,0.666,857,847
5,1804,10,0,1e-05,0.001,0.672,909,895
5,1904,10,0,1e-05,0.001,0.7,952,952
6,0,10,0,1e-05,0.001,0.516,0,0
6,104,10,0,1e-05,0.001,0.518,53,51
6,204,10,0,1e-05,0.001,0.528,104,100
6,304,10,0,1e-05,0.001,0.53,156,148
6,404,10,0,1e-05,0.001,0.544,198,206
6,504,10,0,1e-05,0.001,0.536,255,249
6,604,10,0,1e-05,0.001,0.52,306,298
6,704,10,0,1e-05,0.001,0.516,355,349
6,804,10,0,1e-05,0.001,0.5,407,397
6,904,10,0,1e-05,0.001,0.488,458,446
6,1004,10,0,1e-05,0.001,0.5,511,493
6,1104,10,0,1e-05,0.001,0.498,551,553
6,1204,10,0,1e-05,0.001,0.514,602,602
6,1304,10,0,1e-05,0.001,0.502,651,653
6,1404,10,0,1e-05,0.001,0.516,698,706
6,1504,10,0,1e-05,0.001,0.514,748,756
6,1604,10,0,1e-05,0.001,0.514,804,800
6,1704,10,0,1e-05,0.001,0.522,852,852
6,1804,10,0,1e-05,0.001,0.508,903,901
6,1904,10,0,1e-05,0.001,0.516,952,952
7,0,10,0,1e-05,0.001,0.606,0,0
7,104,10,0,1e-05,0.001,0.604,54,50
7,204,10,0,1e-05,0.001,0.604,101,103
7,304,10,0,1e-05,0.001,0.598,150,154
7,404,10,0,1e-05,0.001,0.612,202,202
7,504,10,0,1e-05,0.001,0.598,251,253
7,604,10,0,1e-05,0.001,0.602,310,294
7,704,10,0,1e-05,0.001,0.604,361,343
7,804,10,0,1e-05,0.001,0.594,412,392
7,904,10,0,1e-05,0.001,0.616,459,445
7,1004,10,0,1e-05,0.001,0.624,509,495
7,1104,10,0,1e-05,0.001,0.642,564,540
7,1204,10,0,1e-05,0.001,0.664,605,599
7,1304,10,0,1e-05,0.001,0.672,652,652
7,1404,10,0,1e-05,0.001,0.688,704,700
7,1504,10,0,1e-05,0.001,0.712,749,755
7,1604,10,0,1e-05,0.001,0.732,800,804
7,1704,10,0,1e-05,0.001,0.746,851,853
7,1804,10,0,1e-05,0.001,0.778,905,899
7,1904,10,0,1e-05,0.001,0.788,952,952
8,0,10,0,1e-05,0.001,0.522,0,0
8,104,10,0,1e-05,0.001,0.522,56,48
8,204,10,0,1e-05,0.001,0.524,100,104
8,304,10,0,1e-05,0.001,0.534,144,160
8,404,10,0,1e-05,0.001,0.55,195,209
8,504,10,0,1e-05,0.001,0.554,260,244
8,604,10,0,1e-05,0.001,0.562,312,292
8,704,10,0,1e-05,0.001,0.562,356,348
8,804,10,0,1e-05,0.001,0.566,407,397
8,904,10,0,1e-05,0.001,0.56,456,448
8,1004,10,0,1e-05,0.001,0.578,509,495
8,1104,10,0,1e-05,0.001,0.58,550,554
8,1204,10,0,1e-05,0.001,0.566,602,602
8,1304,10,0,1e-05,0.001,0.57,647,657
8,1404,10,0,1e-05,0.001,0.57,697,707
8,1504,10,0,1e-05,0.001,0.566,752,752
8,1604,10,0,1e-05,0.001,0.572,801,803
8,1704,10,0,1e-05,0.001,0.58,854,850
8,1804,10,0,1e-05,0.001,0.584,895,909
8,1904,10,0,1e-05,0.001,0.592,952,952
9,0,10,0,1e-05,0.001,0.596,0,0
9,104,10,0,1e-05,0.001,0.594,48,56
9,204,10,0,1e-05,0.001,0.592,98,106
9,304,10,0,1e-05,0.001,0.62,143,161
9,404,10,0,1e-05,0.001,0.608,185,219
9,504,10,0,1e-05,0.001,0.594,232,272
9,604,10,0,1e-05,0.001,0.576,282,322
9,704,10,0,1e-05,0.001,0.57,333,371
9,804,10,0,1e-05,0.001,0.59,388,416
9,904,10,0,1e-05,0.001,0.61,437,467
9,1004,10,0,1e-05,0.001,0.632,487,517
9,1104,10,0,1e-05,0.001,0.648,547,557
9,1204,10,0,1e-05,0.001,0.656,603,601
9,1304,10,0,1e-05,0.001,0.674,650,654
9,1404,10,0,1e-05,0.001,0.684,701,703
9,1504,10,0,1e-05,0.001,0.722,756,748
9,1604,10,0,1e-05,0.001,0.742,802,802
9,1704,10,0,1e-05,0.001,0.754,849,855
9,1804,10,0,1e-05,0.001,0.784,894,910
9,1904,10,0,1e-05,0.001,0.804,952,952
10,0,10,0,1e-05,0.001,0.542,0,0
10,104,10,0,1e-05,0.001,0.546,50,54
10,204,10,0,1e-05,0.001,0.55,95,109
10,304,10,0,1e-05,0.001,0.556,148,156
10,404,10,0,1e-05,0.001,0.554,200,204
10,504,10,0,1e-05,0.001,0.592,250,254
10,604,10,0,1e-05,0.001,0.61,293,311
10,704,10,0,1e-05,0.001,0.626,338,366
10,804,10,0,1e-05,0.001,0.654,395,409
10,904,10,0,1e-05,0.001,0.67,444,460
10,1004,10,0,1e-05,0.001,0.668,484,520
10,1104,10,0,1e-05,0.001,0.672,537,567
10,1204,10,0,1e-05,0.001,0.68,585,619
10,1304,10,0,1e-05,0.001,0.702,641,663
10,1404,10,0,1e-05,0.001,0.722,682,722
10,1504,10,0,1e-05,0.001,0.742,740,764
10,1604,10,0,1e-05,0.001,0.762,793,811
10,1704,10,0,1e-05,0.001,0.788,851,853
10,1804,10,0,1e-05,0.001,0.806,903,901
10,1904,10,0,1e-05,0.001,0.83,952,952
11,0,10,0,1e-05,0.001,0.534,0,0
11,104,10,0,1e-05,0.001,0.536,45,59
11,204,10,0,1e-05,0.001,0.534,99,105
11,304,10,0,1e-05,0.001,0.544,147,157
11,404,10,0,1e-05,0.001,0.568,204,200
11,504,10,0,1e-05,0.001,0.61,250,254
11,604,10,0,1e-05,0.001,0.626,302,302
11,704,10,0,1e-05,0.001,0.63,350,354
11,804,10,0,1e-05,0.001,0.624,412,392
11,904,10,0,1e-05,0.001,0.668,463,441
11,1004,10,0,1e-05,0.001,0.678,515,489
11,1104,10,0,1e-05,0.001,0.678,555,549
11,1204,10,0,1e-05,0.001,0.686,603,601
11,1304,10,0,1e-05,0.001,0.7,656,648
11,1404,10,0,1e-05,0.001,0.714,695,709
11,1504,10,0,1e-05,0.001,0.724,742,762
11,1604,10,0,1e-05,0.001,0.726,795,809
11,1704,10,0,1e-05,0.001,0.744,845,859
11,1804,10,0,1e-05,0.001,0.772,895,909
11,1904,10,0,1e-05,0.001,0.786,952,952
12,0,10,0,1e-05,0.001,0.51,0,0
12,104,10,0,1e-05,0.001,0.512,58,46
12,204,10,0,1e-05,0.001,0.516,105,99
12,304,10,0,1e-05,0.001,0.516,170,134
12,404,10,0,1e-05,0.001,0.528,219,185
12,504,10,0,1e-05,0.001,0.514,269,235
12,604,10,0,1e-05,0.001,0.526,317,287
12,704,10,0,1e-05,0.001,0.53,368,336
12,804,10,0,1e-05,0.001,0.528,411,393
12,904,10,0,1e-05,0.001,0.534,460,444
12,1004,10,0,1e-05,0.001,0.54,512,492
12,1104,10,0,1e-05,0.001,0.534,557,547
12,1204,10,0,1e-05,0.001,0.544,594,610
12,1304,10,0,1e-05,0.001,0.54,647,657
12,1404,10,0,1e-05,0.001,0.552,701,703
12,1504,10,0,1e-05,0.001,0.56,758,746
12,1604,10,0,1e-05,0.001,0.564,806,798
12,1704,10,0,1e-05,0.001,0.57,862,842
12,1804,10,0,1e-05,0.001,0.568,903,901
12,1904,10,0,1e-05,0.001,0.576,952,952
13,0,10,0,1e-05,0.001,0.548,0,0
13,104,10,0,1e-05,0.001,0.556,57,47
13,204,10,0,1e-05,0.001,0.558,109,95
13,304,10,0,1e-05,0.001,0.562,154,150
13,404,10,0,1e-05,0.001,0.58,201,203
13,504,10,0,1e-05,0.001,0.568,251,253
13,604,10,0,1e-05,0.001,0.586,302,302
13,704,10,0,1e-05,0.001,0.574,353,351
13,804,10,0,1e-05,0.001,0.586,398,406
13,904,10,0,1e-05,0.001,0.606,449,455
13,1004,10,0,1e-05,0.001,0.612,500,504
13,1104,10,0,1e-05,0.001,0.626,555,549
13,1204,10,0,1e-05,0.001,0.636,599,605
13,1304,10,0,1e-05,0.001,0.644,647,657
13,1404,10,0,1e-05,0.001,0.652,689,715
13,1504,10,0,1e-05,0.001,0.664,741,763
13,1604,10,0,1e-05,0.001,0.678,794,810
13,1704,10,0,1e-05,0.001,0.69,851,853
13,1804,10,0,1e-05,0.001,0.712,898,906
13,1904,10,0,1e-05,0.001,0.728,952,952
14,0,10,0,1e-05,0.001,0.564,0,0
14,104,10,0,1e-05,0.001,0.566,58,46
14,204,10,0,1e-05,0.001,0.572,113,91
14,304,10,0,1e-05,0.001,0.562,160,144
14,404,10,0,1e-05,0.001,0.58,211,193
14,504,10,0,1e-05,0.001,0.574,261,243
14,604,10,0,1e-05,0.001,0.554,315,289
14,704,10,0,1e-05,0.001,0.552,360,344
14,804,10,0,1e-05,0.001,0.554,406,398
14,904,10,0,1e-05,0.001,0.558,450,454
14,1004,10,0,1e-05,0.001,0.552,500,504
14,1104,10,0,1e-05,0.001,0.564,554,550
14,1204,10,0,1e-05,0.001,0.566,609,595
14,1304,10,0,1e-05,0.001,0.576,659,645
14,1404,10,0,1e-05,0.001,0.588,701,703
14,1504,10,0,1e-05,0.001,0.592,752,752
14,1604,10,0,1e-05,0.001,0.606,800,804
14,1704,10,0,1e-05,0.001,0.622,854,850
14,1804,10,0,1e-05,0.001,0.642,902,902
14,1904,10,0,1e-05,0.001,0.652,952,952
15,0,10,0,1e-05,0.001,0.524,0,0
15,104,10,0,1e-05,0.001,0.528,56,48
15,204,10,0,1e-05,0.001,0.534,109,95
15,304,10,0,1e-05,0.001,0.554,152,152
15,404,10,0,1e-05,0.001,0.538,200,204
15,504,10,0,1e-05,0.001,0.56,240,264
15,604,10,0,1e-05,0.001,0.556,297,307
15,704,10,0,1e-05,0.001,0.548,347,357
15,804,10,0,1e-05,0.001,0.558,399,405
15,904,10,0,1e-05,0.001,0.552,446,458
15,1004,10,0,1e-05,0.001,0.56,504,500
15,1104,10,0,1e-05,0.001,0.558,547,557
15,1204,10,0,1e-05,0.001,0.55,595,609
15,1304,10,0,1e-05,0.001,0.544,644,660
15,1404,10,0,1e-05,0.001,0.552,694,710
15,1504,10,0,1e-05,0.001,0.556,741,763
15,1604,10,0,1e-05,0.001,0.55,792,812
15,1704,10,0,1e-05,0.001,0.56,846,858
15,1804,10,0,1e-05,0.001,0.558,904,900
15,1904,10,0,1e-05,0.001,0.568,952,952
16,0,10,0,1e-05,0.001,0.6,0,0
16,104,10,0,1e-05,0.001,0.602,48,56
16,204,10,0,1e-05,0.001,0.6,94,110
16,304,10,0,1e-05,0.001,0.616,141,163
16,404,10,0,1e-05,0.001,0.64,191,213
16,504,10,0,1e-05,0.001,0.668,246,258
16,604,10,0,1e-05,0.001,0.684,293,311
16,704,10,0,1e-05,0.001,0.686,348,356
16,804,10,0,1e-05,0.001,0.706,401,403
16,904,10,0,1e-05,0.001,0.73,451,453
16,1004,10,0,1e-05,0.001,0.744,509,495
16,1104,10,0,1e-05,0.001,0.774,560,544
16,1204,10,0,1e-05,0.001,0.786,612,592
16,1304,10,0,1e-05,0.001,0.804,665,639
16,1404,10,0,1e-05,0.001,0.818,716,688
16,1504,10,0,1e-05,0.001,0.826,764,740
16,1604,10,0,1e-05,0.001,0.85,811,793
16,1704,10,0,1e-05,0.001,0.878,858,846
16,1804,10,0,1e-05,0.001,0.894,902,902
16,1904,10,0,1e-05,0.001,0.914,952,952
17,0,10,0,1e-05,0.001,0.586,0,0
17,104,10,0,1e-05,0.001,0.59,57,47
17,204,10,0,1e-05,0.001,0.616,108,96
17,304,10,0,1e-05,0.001,0.616,145,159
17,404,10,0,1e-05,0.001,0.644,200,204
17,504,10,0,1e-05,0.001,0.646,248,256
17,604,10,0,1e-05,0.001,0.634,297,307
17,704,10,0,1e-05,0.001,0.628,349,355
17,804,10,0,1e-05,0.001,0.642,406,398
17,904,10,0,1e-05,0.001,0.67,451,453
17,1004,10,0,1e-05,0.001,0.688,501,503
17,1104,10,0,1e-05,0.001,0.702,546,558
17,1204,10,0,1e-05,0.001,0.714,601,603
17,1304,10,0,1e-05,0.001,0.724,651,653
17,1404,10,0,1e-05,0.001,0.746,700,704
17,1504,10,0,1e-05,0.001,0.75,744,760
17,1604,10,0,1e-05,0.001,0.764,791,813
17,1704,10,0,1e-05,0.001,0.78,845,859
17,1804,10,0,1e-05,0.001,0.814,897,907
17,1904,10,0,1e-05,0.001,0.816,952,952
18,0,10,0,1e-05,0.001,0.528,0,0
18,104,10,0,1e-05,0.001,0.53,51,53
18,204,10,0,1e-05,0.001,0.534,101,103
18,304,10,0,1e-05,0.001,0.534,155,149
18,404,10,0,1e-05,0.001,0.53,205,199
18,504,10,0,1e-05,0.001,0.536,249,255
18,604,10,0,1e-05,0.001,0.55,300,304
18,704,10,0,1e-05,0.001,0.544,349,355
18,804,10,0,1e-05,0.001,0.554,399,405
18,904,10,0,1e-05,0.001,0.566,451,453
18,1004,10,0,1e-05,0.001,0.57,512,492
18,1104,10,0,1e-05,0.001,0.578,563,541
18,1204,10,0,1e-05,0.001,0.582,606,598
18,1304,10,0,1e-05,0.001,0.584,655,649
18,1404,10,0,1e-05,0.001,0.584,701,703
18,1504,10,0,1e-05,0.001,0.59,759,745
18,1604,10,0,1e-05,0.001,0.608,804,800
18,1704,10,0,1e-05,0.001,0.638,848,856
18,1804,10,0,1e-05,0.001,0.638,904,900
18,1904,10,0,1e-05,0.001,0.656,952,952
19,0,10,0,1e-05,0.001,0.546,0,0
19,104,10,0,1e-05,0.001,0.546,47,57
19,204,10,0,1e-05,0.001,0.546,100,104
19,304,10,0,1e-05,0.001,0.54,143,161
19,404,10,0,1e-05,0.001,0.546,202,202
19,504,10,0,1e-05,0.001,0.544,239,265
19,604,10,0,1e-05,0.001,0.552,293,311
19,704,10,0,1e-05,0.001,0.564,343,361
19,804,10,0,1e-05,0.001,0.568,394,410
19,904,10,0,1e-05,0.001,0.582,443,461
19,1004,10,0,1e-05,0.001,0.58,494,510
19,1104,10,0,1e-05,0.001,0.576,545,559
19,1204,10,0,1e-05,0.001,0.58,596,608
19,1304,10,0,1e-05,0.001,0.586,643,661
19,1404,10,0,1e-05,0.001,0.588,697,707
19,1504,10,0,1e-05,0.001,0.586,744,760
19,1604,10,0,1e-05,0.001,0.584,795,809
19,1704,10,0,1e-05,0.001,0.59,847,857
19,1804,10,0,1e-05,0.001,0.598,902,902
19,1904,10,0,1e-05,0.001,0.606,952,952
20,0,10,0,1e-05,0.001,0.474,0,0
20,104,10,0,1e-05,0.001,0.472,53,51
20,204,10,0,1e-05,0.001,0.474,106,98
20,304,10,0,1e-05,0.001,0.48,155,149
20,404,10,0,1e-05,0.001,0.494,211,193
20,504,10,0,1e-05,0.001,0.494,264,240
20,604,10,0,1e-05,0.001,0.512,315,289
20,704,10,0,1e-05,0.001,0.512,366,338
20,804,10,0,1e-05,0.001,0.522,412,392
20,904,10,0,1e-05,0.001,0.526,454,450
20,1004,10,0,1e-05,0.001,0.522,511,493
20,1104,10,0,1e-05,0.001,0.532,564,540
20,1204,10,0,1e-05,0.001,0.532,610,594
20,1304,10,0,1e-05,0.001,0.536,654,650
20,1404,10,0,1e-05,0.001,0.54,703,701
20,1504,10,0,1e-05,0.001,0.53,749,755
20,1604,10,0,1e-05,0.001,0.55,803,801
20,1704,10,0,1e-05,0.001,0.542,853,851
20,1804,10,0,1e-05,0.001,0.546,904,900
20,1904,10,0,1e-05,0.001,0.546,952,952
1,0,10,0,1e-05,0.01,0.51,0,0
1,104,10,0,1e-05,0.01,0.528,58,46
1,204,10,0,1e-05,0.01,0.574,114,90
1,304,10,0,1e-05,0.01,0.536,159,145
1,404,10,0,1e-05,0.01,0.52,211,193
1,504,10,0,1e-05,0.01,0.552,267,237
1,604,10,0,1e-05,0.01,0.558,316,288
1,704,10,0,1e-05,0.01,0.554,365,339
1,804,10,0,1e-05,0.01,0.574,411,393
1,904,10,0,1e-05,0.01,0.56,455,449
1,1004,10,0,1e-05,0.01,0.556,503,501
1,1104,10,0,1e-05,0.01,0.566,555,549
1,1204,10,0,1e-05,0.01,0.558,603,601
1,1304,10,0,1e-05,0.01,0.556,652,652
1,1404,10,0,1e-05,0.01,0.56,699,705
1,1504,10,0,1e-05,0.01,0.552,748,756
1,1604,10,0,1e-05,0.01,0.532,801,803
1,1704,10,0,1e-05,0.01,0.536,849,855
1,1804,10,0,1e-05,0.01,0.534,901,903
1,1904,10,0,1e-05,0.01,0.566,952,952
2,0,10,0,1e-05,0.01,0.518,0,0
2,104,10,0,1e-05,0.01,0.532,59,45
2,204,10,0,1e-05,0.01,0.608,118,86
2,304,10,0,1e-05,0.01,0.532,163,141
2,404,10,0,1e-05,0.01,0.512,220,184
2,504,10,0,1e-05,0.01,0.528,271,233
2,604,10,0,1e-05,0.01,0.546,316,288
2,704,10,0,1e-05,0.01,0.552,373,331
2,804,10,0,1e-05,0.01,0.542,424,380
2,904,10,0,1e-05,0.01,0.548,472,432
2,1004,10,0,1e-05,0.01,0.536,520,484
2,1104,10,0,1e-05,0.01,0.532,570,534
2,1204,10,0,1e-05,0.01,0.546,613,591
2,1304,10,0,1e-05,0.01,0.548,657,647
2,1404,10,0,1e-05,0.01,0.556,705,699
2,1504,10,0,1e-05,0.01,0.56,758,746
2,1604,10,0,1e-05,0.01,0.548,808,796
2,1704,10,0,1e-05,0.01,0.544,863,841
2,1804,10,0,1e-05,0.01,0.55,906,898
2,1904,10,0,1e-05,0.01,0.554,952,952
3,0,10,0,1e-05,0.01,0.506,0,0
3,104,10,0,1e-05,0.01,0.524,54,50
3,204,10,0,1e-05,0.01,0.578,96,108
3,304,10,0,1e-05,0.01,0.548,140,164
3,404,10,0,1e-05,0.01,0.548,196,208
3,504,10,0,1e-05,0.01,0.588,257,247
3,604,10,0,1e-05,0.01,0.576,306,298
3,704,10,0,1e-05,0.01,0.578,359,345
3,804,10,0,1e-05,0.01,0.592,414,390
3,904,10,0,1e-05,0.01,0.606,463,441
3,1004,10,0,1e-05,0.01,0.602,518,486
3,1104,10,0,1e-05,0.01,0.604,561,543
3,1204,10,0,1e-05,0.01,0.61,619,585
3,1304,10,0,1e-05,0.01,0.614,665,639
3,1404,10,0,1e-05,0.01,0.614,716,688
3,1504,10,0,1e-05,0.01,0.644,763,741
3,1604,10,0,1e-05,0.01,0.652,807,797
3,1704,10,0,1e-05,0.01,0.658,860,844
3,1804,10,0,1e-05,0.01,0.67,908,896
3,1904,10,0,1e-05,0.01,0.684,952,952
4,0,10,0,1e-05,0.01,0.524,0,0
4,104,10,0,1e-05,0.01,0.54,53,51
4,204,10,0,1e-05,0.01,0.578,92,112
4,304,10,0,1e-05,0.01,0.542,141,163
4,404,10,0,1e-05,0.01,0.526,194,210
4,504,10,0,1e-05,0.01,0.532,245,259
4,604,10,0,1e-05,0.01,0.526,298,306
4,704,10,0,1e-05,0.01,0.538,355,349
4,804,10,0,1e-05,0.01,0.532,404,400
4,904,10,0,1e-05,0.01,0.552,453,451
4,1004,10,0,1e-05,0.01,0.544,503,501
4,1104,10,0,1e-05,0.01,0.534,558,546
4,1204,10,0,1e-05,0.01,0.542,613,591
4,1304,10,0,1e-05,0.01,0.54,659,645
4,1404,10,0,1e-05,0.01,0.522,702,702
4,1504,10,0,1e-05,0.01,0.548,752,752
4,1604,10,0,1e-05,0.01,0.54,798,806
4,1704,10,0,1e-05,0.01,0.54,835,869
4,1804,10,0,1e-05,0.01,0.536,893,911
4,1904,10,0,1e-05,0.01,0.546,952,952
5,0,10,0,1e-05,0.01,0.514,0,0
5,104,10,0,1e-05,0.01,0.53,50,54
5,204,10,0,1e-05,0.01,0.566,96,108
5,304,10,0,1e-05,0.01,0.582,143,161
5,404,10,0,1e-05,0.01,0.57,196,208
5,504,10,0,1e-05,0.01,0.6,249,255
5,604,10,0,1e-05,0.01,0.598,296,308
5,704,10,0,1e-05,0.01,0.608,339,365
5,804,10,0,1e-05,0.01,0.61,392,412
5,904,10,0,1e-05,0.01,0.668,450,454
5,1004,10,0,1e-05,0.01,0.686,492,512
5,1104,10,0,1e-05,0.01,0.7,544,560
5,1204,10,0,1e-05,0.01,0.72,593,611
5,1304,10,0,1e-05,0.01,0.732,647,657
5,1404,10,0,1e-05,0.01,0.76,702,702
5,1504,10,0,1e-05,0.01,0.784,752,752
5,1604,10,0,1e-05,0.01,0.8,806,798
5,1704,10,0,1e-05,0.01,0.84,856,848
5,1804,10,0,1e-05,0.01,0.862,903,901
5,1904,10,0,1e-05,0.01,0.878,952,952
6,0,10,0,1e-05,0.01,0.51,0,0
6,104,10,0,1e-05,0.01,0.522,59,45
6,204,10,0,1e-05,0.01,0.612,102,102
6,304,10,0,1e-05,0.01,0.578,157,147
6,404,10,0,1e-05,0.01,0.578,204,200
6,504,10,0,1e-05,0.01,0.626,260,244
6,604,10,0,1e-05,0.01,0.612,305,299
6,704,10,0,1e-05,0.01,0.62,356,348
6,804,10,0,1e-05,0.01,0.628,403,401
6,904,10,0,1e-05,0.01,0.668,450,454
6,1004,10,0,1e-05,0.01,0.688,505,499
6,1104,10,0,1e-05,0.01,0.7,555,549
6,1204,10,0,1e-05,0.01,0.72,608,596
6,1304,10,0,1e-05,0.01,0.738,654,650
6,1404,10,0,1e-05,0.01,0.75,707,697
6,1504,10,0,1e-05,0.01,0.78,757,747
6,1604,10,0,1e-05,0.01,0.816,800,804
6,1704,10,0,1e-05,0.01,0.864,846,858
6,1804,10,0,1e-05,0.01,0.89,903,901
6,1904,10,0,1e-05,0.01,0.924,952,952
7,0,10,0,1e-05,0.01,0.498,0,0
7,104,10,0,1e-05,0.01,0.506,46,58
7,204,10,0,1e-05,0.01,0.522,99,105
7,304,10,0,1e-05,0.01,0.55,157,147
7,404,10,0,1e-05,0.01,0.556,208,196
7,504,10,0,1e-05,0.01,0.568,259,245
7,604,10,0,1e-05,0.01,0.594,309,295
7,704,10,0,1e-05,0.01,0.616,359,345
7,804,10,0,1e-05,0.01,0.652,408,396
7,904,10,0,1e-05,0.01,0.644,468,436
7,1004,10,0,1e-05,0.01,0.638,518,486
7,1104,10,0,1e-05,0.01,0.654,573,531
7,1204,10,0,1e-05,0.01,0.668,622,582
7,1304,10,0,1e-05,0.01,0.68,670,634
7,1404,10,0,1e-05,0.01,0.67,719,685
7,1504,10,0,1e-05,0.01,0.68,765,739
7,1604,10,0,1e-05,0.01,0.686,813,791
7,1704,10,0,1e-05,0.01,0.714,866,838
7,1804,10,0,1e-05,0.01,0.714,907,897
7,1904,10,0,1e-05,0.01,0.728,952,952
8,0,10,0,1e-05,0.01,0.508,0,0
8,104,10,0,1e-05,0.01,0.516,45,59
8,204,10,0,1e-05,0.01,0.548,93,111
8,304,10,0,1e-05,0.01,0.55,148,156
8,404,10,0,1e-05,0.01,0.516,203,201
8,504,10,0,1e-05,0.01,0.54,260,244
8,604,10,0,1e-05,0.01,0.548,313,291
8,704,10,0,1e-05,0.01,0.566,362,342
8,804,10,0,1e-05,0.01,0.546,417,387
8,904,10,0,1e-05,0.01,0.552,459,445
8,1004,10,0,1e-05,0.01,0.532,508,496
8,1104,10,0,1e-05,0.01,0.54,565,539
8,1204,10,0,1e-05,0.01,0.552,614,590
8,1304,10,0,1e-05,0.01,0.556,671,633
8,1404,10,0,1e-05,0.01,0.56,727,677
8,1504,10,0,1e-05,0.01,0.556,775,729
8,1604,10,0,1e-05,0.01,0.548,823,781
8,1704,10,0,1e-05,0.01,0.556,870,834
8,1804,10,0,1e-05,0.01,0.558,907,897
8,1904,10,0,1e-05,0.01,0.562,952,952
9,0,10,0,1e-05,0.01,0.528,0,0
9,104,10,0,1e-05,0.01,0.548,58,46
9,204,10,0,1e-05,0.01,0.618,103,101
9,304,10,0,1e-05,0.01,0.58,148,156
9,404,10,0,1e-05,0.01,0.6,198,206
9,504,10,0,1e-05,0.01,0.674,241,263
9,604,10,0,1e-05,0.01,0.658,300,304
9,704,10,0,1e-05,0.01,0.702,348,356
9,804,10,0,1e-05,0.01,0.66,398,406
9,904,10,0,1e-05,0.01,0.688,450,454
9,1004,10,0,1e-05,0.01,0.692,490,514
9,1104,10,0,1e-05,0.01,0.706,537,567
9,1204,10,0,1e-05,0.01,0.722,591,613
9,1304,10,0,1e-05,0.01,0.734,643,661
9,1404,10,0,1e-05,0.01,0.75,702,702
9,1504,10,0,1e-05,0.01,0.772,756,748
9,1604,10,0,1e-05,0.01,0.794,803,801
9,1704,10,0,1e-05,0.01,0.82,855,849
9,1804,10,0,1e-05,0.01,0.84,902,902
9,1904,10,0,1e-05,0.01,0.88,952,952
10,0,10,0,1e-05,0.01,0.504,0,0
10,104,10,0,1e-05,0.01,0.506,56,48
10,204,10,0,1e-05,0.01,0.544,98,106
10,304,10,0,1e-05,0.01,0.56,141,163
10,404,10,0,1e-05,0.01,0.548,192,212
10,504,10,0,1e-05,0.01,0.576,251,253
10,604,10,0,1e-05,0.01,0.572,301,303
10,704,10,0,1e-05,0.01,0.584,354,350
10,804,10,0,1e-05,0.01,0.604,402,402
10,904,10,0,1e-05,0.01,0.618,454,450
10,1004,10,0,1e-05,0.01,0.646,491,513
10,1104,10,0,1e-05,0.01,0.664,547,557
10,1204,10,0,1e-05,0.01,0.68,592,612
10,1304,10,0,1e-05,0.01,0.696,652,652
10,1404,10,0,1e-05,0.01,0.736,710,694
10,1504,10,0,1e-05,0.01,0.772,765,739
10,1604,10,0,1e-05,0.01,0.798,813,791
10,1704,10,0,1e-05,0.01,0.814,864,840
10,1804,10,0,1e-05,0.01,0.828,900,904
10,1904,10,0,1e-05,0.01,0.854,952,952
11,0,10,0,1e-05,0.01,0.54,0,0
11,104,10,0,1e-05,0.01,0.56,52,52
11,204,10,0,1e-05,0.01,0.606,101,103
11,304,10,0,1e-05,0.01,0.554,155,149
11,404,10,0,1e-05,0.01,0.544,211,193
11,504,10,0,1e-05,0.01,0.596,264,240
11,604,10,0,1e-05,0.01,0.594,321,283
11,704,10,0,1e-05,0.01,0.594,367,337
11,804,10,0,1e-05,0.01,0.606,412,392
11,904,10,0,1e-05,0.01,0.596,461,443
11,1004,10,0,1e-05,0.01,0.606,509,495
11,1104,10,0,1e-05,0.01,0.628,558,546
11,1204,10,0,1e-05,0.01,0.606,612,592
11,1304,10,0,1e-05,0.01,0.628,657,647
11,1404,10,0,1e-05,0.01,0.662,709,695
11,1504,10,0,1e-05,0.01,0.674,760,744
11,1604,10,0,1e-05,0.01,0.716,802,802
11,1704,10,0,1e-05,0.01,0.74,850,854
11,1804,10,0,1e-05,0.01,0.768,900,904
11,1904,10,0,1e-05,0.01,0.794,952,952
12,0,10,0,1e-05,0.01,0.5,0,0
12,104,10,0,1e-05,0.01,0.502,48,56
12,204,10,0,1e-05,0.01,0.524,102,102
12,304,10,0,1e-05,0.01,0.504,157,147
12,404,10,0,1e-05,0.01,0.54,210,194
12,504,10,0,1e-05,0.01,0.536,263,241
12,604,10,0,1e-05,0.01,0.558,315,289
12,704,10,0,1e-05,0.01,0.548,366,338
12,804,10,0,1e-05,0.01,0.556,415,389
12,904,10,0,1e-05,0.01,0.544,469,435
12,1004,10,0,1e-05,0.01,0.55,521,483
12,1104,10,0,1e-05,0.01,0.538,574,530
12,1204,10,0,1e-05,0.01,0.544,615,589
12,1304,10,0,1e-05,0.01,0.562,661,643
12,1404,10,0,1e-05,0.01,0.556,706,698
12,1504,10,0,1e-05,0.01,0.588,761,743
12,1604,10,0,1e-05,0.01,0.576,813,791
12,1704,10,0,1e-05,0.01,0.58,853,851
12,1804,10,0,1e-05,0.01,0.602,902,902
12,1904,10,0,1e-05,0.01,0.574,952,952
13,0,10,0,1e-05,0.01,0.592,0,0
13,104,10,0,1e-05,0.01,0.612,48,56
13,204,10,0,1e-05,0.01,0.682,103,101
13,304,10,0,1e-05,0.01,0.592,153,151
13,404,10,0,1e-05,0.01,0.556,206,198
13,504,10,0,1e-05,0.01,0.614,256,248
13,604,10,0,1e-05,0.01,0.664,299,305
13,704,10,0,1e-05,0.01,0.668,348,356
13,804,10,0,1e-05,0.01,0.694,400,404
13,904,10,0,1e-05,0.01,0.668,441,463
13,1004,10,0,1e-05,0.01,0.698,490,514
13,1104,10,0,1e-05,0.01,0.728,541,563
13,1204,10,0,1e-05,0.01,0.712,588,616
13,1304,10,0,1e-05,0.01,0.732,644,660
13,1404,10,0,1e-05,0.01,0.746,692,712
13,1504,10,0,1e-05,0.01,0.756,747,757
13,1604,10,0,1e-05,0.01,0.766,794,810
13,1704,10,0,1e-05,0.01,0.774,846,858
13,1804,10,0,1e-05,0.01,0.788,901,903
13,1904,10,0,1e-05,0.01,0.796,952,952
14,0,10,0,1e-05,0.01,0.506,0,0
14,104,10,0,1e-05,0.01,0.512,41,63
14,204,10,0,1e-05,0.01,0.562,95,109
14,304,10,0,1e-05,0.01,0.54,148,156
14,404,10,0,1e-05,0.01,0.548,205,199
14,504,10,0,1e-05,0.01,0.56,250,254
14,604,10,0,1e-05,0.01,0.566,298,306
14,704,10,0,1e-05,0.01,0.566,344,360
14,804,10,0,1e-05,0.01,0.57,395,409
14,904,10,0,1e-05,0.01,0.596,440,464
14,1004,10,0,1e-05,0.01,0.6,490,514
14,1104,10,0,1e-05,0.01,0.606,541,563
14,1204,10,0,1e-05,0.01,0.612,597,607
14,1304,10,0,1e-05,0.01,0.63,648,656
14,1404,10,0,1e-05,0.01,0.634,704,700
14,1504,10,0,1e-05,0.01,0.648,755,749
14,1604,10,0,1e-05,0.01,0.668,803,801
14,1704,10,0,1e-05,0.01,0.69,853,851
14,1804,10,0,1e-05,0.01,0.712,901,903
14,1904,10,0,1e-05,0.01,0.722,952,952
15,0,10,0,1e-05,0.01,0.528,0,0
15,104,10,0,1e-05,0.01,0.536,57,47
15,204,10,0,1e-05,0.01,0.556,97,107
15,304,10,0,1e-05,0.01,0.562,155,149
15,404,10,0,1e-05,0.01,0.568,202,202
15,504,10,0,1e-05,0.01,0.602,252,252
15,604,10,0,1e-05,0.01,0.594,297,307
15,704,10,0,1e-05,0.01,0.61,348,356
15,804,10,0,1e-05,0.01,0.618,398,406
15,904,10,0,1e-05,0.01,0.6,440,464
15,1004,10,0,1e-05,0.01,0.606,488,516
15,1104,10,0,1e-05,0.01,0.626,539,565
15,1204,10,0,1e-05,0.01,0.626,591,613
15,1304,10,0,1e-05,0.01,0.64,646,658
15,1404,10,0,1e-05,0.01,0.648,706,698
15,1504,10,0,1e-05,0.01,0.672,748,756
15,1604,10,0,1e-05,0.01,0.702,796,808
15,1704,10,0,1e-05,0.01,0.71,841,863
15,1804,10,0,1e-05,0.01,0.754,899,905
15,1904,10,0,1e-05,0.01,0.766,952,952
16,0,10,0,1e-05,0.01,0.502,0,0
16,104,10,0,1e-05,0.01,0.51,53,51
16,204,10,0,1e-05,0.01,0.576,105,99
16,304,10,0,1e-05,0.01,0.602,162,142
16,404,10,0,1e-05,0.01,0.612,204,200
16,504,10,0,1e-05,0.01,0.634,250,254
16,604,10,0,1e-05,0.01,0.636,305,299
16,704,10,0,1e-05,0.01,0.642,364,340
16,804,10,0,1e-05,0.01,0.658,410,394
16,904,10,0,1e-05,0.01,0.716,460,444
16,1004,10,0,1e-05,0.01,0.73,504,500
16,1104,10,0,1e-05,0.01,0.736,548,556
16,1204,10,0,1e-05,0.01,0.792,595,609
16,1304,10,0,1e-05,0.01,0.828,645,659
16,1404,10,0,1e-05,0.01,0.846,701,703
16,1504,10,0,1e-05,0.01,0.87,748,756
16,1604,10,0,1e-05,0.01,0.882,795,809
16,1704,10,0,1e-05,0.01,0.908,844,860
16,1804,10,0,1e-05,0.01,0.936,897,907
16,1904,10,0,1e-05,0.01,0.946,952,952
17,0,10,0,1e-05,0.01,0.52,0,0
17,104,10,0,1e-05,0.01,0.54,51,53
17,204,10,0,1e-05,0.01,0.612,97,107
17,304,10,0,1e-05,0.01,0.59,146,158
17,404,10,0,1e-05,0.01,0.562,193,211
17,504,10,0,1e-05,0.01,0.616,243,261
17,604,10,0,1e-05,0.01,0.602,298,306
17,704,10,0,1e-05,0.01,0.628,345,359
17,804,10,0,1e-05,0.01,0.632,392,412
17,904,10,0,1e-05,0.01,0.668,445,459
17,1004,10,0,1e-05,0.01,0.666,496,508
17,1104,10,0,1e-05,0.01,0.676,550,554
17,1204,10,0,1e-05,0.01,0.688,594,610
17,1304,10,0,1e-05,0.01,0.712,652,652
17,1404,10,0,1e-05,0.01,0.73,694,710
17,1504,10,0,1e-05,0.01,0.748,742,762
17,1604,10,0,1e-05,0.01,0.766,796,808
17,1704,10,0,1e-05,0.01,0.8,850,854
17,1804,10,0,1e-05,0.01,0.836,901,903
17,1904,10,0,1e-05,0.01,0.848,952,952
18,0,10,0,1e-05,0.01,0.514,0,0
18,104,10,0,1e-05,0.01,0.532,50,54
18,204,10,0,1e-05,0.01,0.598,100,104
18,304,10,0,1e-05,0.01,0.556,151,153
18,404,10,0,1e-05,0.01,0.526,203,201
18,504,10,0,1e-05,0.01,0.568,250,254
18,604,10,0,1e-05,0.01,0.582,300,304
18,704,10,0,1e-05,0.01,0.606,355,349
18,804,10,0,1e-05,0.01,0.61,401,403
18,904,10,0,1e-05,0.01,0.632,457,447
18,1004,10,0,1e-05,0.01,0.672,505,499
18,1104,10,0,1e-05,0.01,0.694,556,548
18,1204,10,0,1e-05,0.01,0.72,599,605
18,1304,10,0,1e-05,0.01,0.732,649,655
18,1404,10,0,1e-05,0.01,0.754,703,701
18,1504,10,0,1e-05,0.01,0.76,757,747
18,1604,10,0,1e-05,0.01,0.774,801,803
18,1704,10,0,1e-05,0.01,0.802,848,856
18,1804,10,0,1e-05,0.01,0.806,902,902
18,1904,10,0,1e-05,0.01,0.828,952,952
19,0,10,0,1e-05,0.01,0.498,0,0
19,104,10,0,1e-05,0.01,0.498,53,51
19,204,10,0,1e-05,0.01,0.51,102,102
19,304,10,0,1e-05,0.01,0.508,156,148
19,404,10,0,1e-05,0.01,0.5,209,195
19,504,10,0,1e-05,0.01,0.508,255,249
19,604,10,0,1e-05,0.01,0.532,310,294
19,704,10,0,1e-05,0.01,0.526,362,342
19,804,10,0,1e-05,0.01,0.57,405,399
19,904,10,0,1e-05,0.01,0.578,450,454
19,1004,10,0,1e-05,0.01,0.586,497,507
19,1104,10,0,1e-05,0.01,0.594,546,558
19,1204,10,0,1e-05,0.01,0.608,594,610
19,1304,10,0,1e-05,0.01,0.61,650,654
19,1404,10,0,1e-05,0.01,0.602,696,708
19,1504,10,0,1e-05,0.01,0.62,754,750
19,1604,10,0,1e-05,0.01,0.62,804,800
19,1704,10,0,1e-05,0.01,0.638,852,852
19,1804,10,0,1e-05,0.01,0.666,897,907
19,1904,10,0,1e-05,0.01,0.694,952,952
20,0,10,0,1e-05,0.01,0.53,0,0
20,104,10,0,1e-05,0.01,0.554,50,54
20,204,10,0,1e-05,0.01,0.588,103,101
20,304,10,0,1e-05,0.01,0.576,151,153
20,404,10,0,1e-05,0.01,0.582,199,205
20,504,10,0,1e-05,0.01,0.572,245,259
20,604,10,0,1e-05,0.01,0.576,297,307
20,704,10,0,1e-05,0.01,0.596,351,353
20,804,10,0,1e-05,0.01,0.596,408,396
20,904,10,0,1e-05,0.01,0.606,456,448
20,1004,10,0,1e-05,0.01,0.646,510,494
20,1104,10,0,1e-05,0.01,0.642,557,547
20,1204,10,0,1e-05,0.01,0.654,609,595
20,1304,10,0,1e-05,0.01,0.67,661,643
20,1404,10,0,1e-05,0.01,0.692,712,692
20,1504,10,0,1e-05,0.01,0.706,756,748
20,1604,10,0,1e-05,0.01,0.72,796,808
20,1704,10,0,1e-05,0.01,0.74,855,849
20,1804,10,0,1e-05,0.01,0.738,904,900
20,1904,10,0,1e-05,0.01,0.752,952,952
1,0,10,0,0.0001,0.0001,0.502,0,0
1,104,10,0,0.0001,0.0001,0.502,41,63
1,204,10,0,0.0001,0.0001,0.502,91,113
1,304,10,0,0.0001,0.0001,0.504,138,166
1,404,10,0,0.0001,0.0001,0.502,180,224
1,504,10,0,0.0001,0.0001,0.502,233,271
1,604,10,0,0.0001,0.0001,0.502,281,323
1,704,10,0,0.0001,0.0001,0.502,334,370
1,804,10,0,0.0001,0.0001,0.502,384,420
1,904,10,0,0.0001,0.0001,0.502,436,468
1,1004,10,0,0.0001,0.0001,0.502,485,519
1,1104,10,0,0.0001,0.0001,0.502,533,571
1,1204,10,0,0.0001,0.0001,0.502,590,614
1,1304,10,0,0.0001,0.0001,0.502,631,673
1,1404,10,0,0.0001,0.0001,0.502,682,722
1,1504,10,0,0.0001,0.0001,0.502,738,766
1,1604,10,0,0.0001,0.0001,0.502,793,811
1,1704,10,0,0.0001,0.0001,0.502,835,869
1,1804,10,0,0.0001,0.0001,0.502,898,906
1,1904,10,0,0.0001,0.0001,0.502,952,952
2,0,10,0,0.0001,0.0001,0.524,0,0
2,104,10,0,0.0001,0.0001,0.524,59,45
2,204,10,0,0.0001,0.0001,0.524,112,92
2,304,10,0,0.0001,0.0001,0.526,166,138
2,404,10,0,0.0001,0.0001,0.522,215,189
2,504,10,0,0.0001,0.0001,0.518,264,240
2,604,10,0,0.0001,0.0001,0.516,308,296
2,704,10,0,0.0001,0.0001,0.514,355,349
2,804,10,0,0.0001,0.0001,0.51,407,397
2,904,10,0,0.0001,0.0001,0.51,452,452
2,1004,10,0,0.0001,0.0001,0.512,496,508
2,1104,10,0,0.0001,0.0001,0.518,539,565
2,1204,10,0,0.0001,0.0001,0.518,596,608
2,1304,10,0,0.0001,0.0001,0.522,639,665
2,1404,10,0,0.0001,0.0001,0.524,688,716
2,1504,10,0,0.0001,0.0001,0.52,741,763
2,1604,10,0,0.0001,0.0001,0.518,781,823
2,1704,10,0,0.0001,0.0001,0.51,844,860
2,1804,10,0,0.0001,0.0001,0.516,899,905
2,1904,10,0,0.0001,0.0001,0.52,952,952
3,0,10,0,0.0001,0.0001,0.518,0,0
3,104,10,0,0.0001,0.0001,0.518,44,60
3,204,10,0,0.0001,0.0001,0.518,104,100
3,304,10,0,0.0001,0.0001,0.518,160,144
3,404,10,0,0.0001,0.0001,0.514,213,191
3,504,10,0,0.0001,0.0001,0.516,261,243
3,604,10,0,0.0001,0.0001,0.524,318,286
3,704,10,0,0.0001,0.0001,0.528,371,333
3,804,10,0,0.0001,0.0001,0.524,428,376
3,904,10,0,0.0001,0.0001,0.526,486,418
3,1004,10,0,0.0001,0.0001,0.534,526,478
3,1104,10,0,0.0001,0.0001,0.532,572,532
3,1204,10,0,0.0001,0.0001,0.534,624,580
3,1304,10,0,0.0001,0.0001,0.54,674,630
3,1404,10,0,0.0001,0.0001,0.53,721,683
3,1504,10,0,0.0001,0.0001,0.53,766,738
3,1604,10,0,0.0001,0.0001,0.528,806,798
3,1704,10,0,0.0001,0.0001,0.53,855,849
3,1804,10,0,0.0001,0.0001,0.528,905,899
3,1904,10,0,0.0001,0.0001,0.526,952,952
4,0,10,0,0.0001,0.0001,0.49,0,0
4,104,10,0,0.0001,0.0001,0.49,47,57
4,204,10,0,0.0001,0.0001,0.494,99,105
4,304,10,0,0.0001,0.0001,0.49,147,157
4,404,10,0,0.0001,0.0001,0.49,198,206
4,504,10,0,0.0001,0.0001,0.49,251,253
4,604,10,0,0.0001,0.0001,0.488,297,307
4,704,10,0,0.0001,0.0001,0.488,346,358
4,804,10,0,0.0001,0.0001,0.488,399,405
4,904,10,0,0.0001,0.0001,0.49,458,446
4,1004,10,0,0.0001,0.0001,0.492,507,497
4,1104,10,0,0.0001,0.0001,0.484,563,541
4,1204,10,0,0.0001,0.0001,0.48,609,595
4,1304,10,0,0.0001,0.0001,0.486,661,643
4,1404,10,0,0.0001,0.0001,0.492,713,691
4,1504,10,0,0.0001,0.0001,0.5,758,746
4,1604,10,0,0.0001,0.0001,0.486,808,796
4,1704,10,0,0.0001,0.0001,0.468,856,848
4,1804,10,0,0.0001,0.0001,0.468,906,898
4,1904,10,0,0.0001,0.0001,0.476,952,952
5,0,10,0,0.0001,0.0001,0.494,0,0
5,104,10,0,0.0001,0.0001,0.492,49,55
5,204,10,0,0.0001,0.0001,0.494,99,105
5,304,10,0,0.0001,0.0001,0.49,147,157
5,404,10,0,0.0001,0.0001,0.49,193,211
5,504,10,0,0.0001,0.0001,0.488,251,253
5,604,10,0,0.0001,0.0001,0.482,296,308
5,704,10,0,0.0001,0.0001,0.49,349,355
5,804,10,0,0.0001,0.0001,0.494,397,407
5,904,10,0,0.0001,0.0001,0.494,452,452
5,1004,10,0,0.0001,0.0001,0.494,510,494
5,1104,10,0,0.0001,0.0001,0.494,561,543
5,1204,10,0,0.0001,0.0001,0.494,603,601
5,1304,10,0,0.0001,0.0001,0.494,649,655
5,1404,10,0,0.0001,0.0001,0.498,704,700
5,1504,10,0,0.0001,0.0001,0.492,749,755
5,1604,10,0,0.0001,0.0001,0.496,797,807
5,1704,10,0,0.0001,0.0001,0.492,840,864
5,1804,10,0,0.0001,0.0001,0.498,889,915
5,1904,10,0,0.0001,0.0001,0.498,952,952
6,0,10,0,0.0001,0.0001,0.508,0,0
6,104,10,0,0.0001,0.0001,0.508,57,47
6,204,10,0,0.0001,0.0001,0.51,114,90
6,304,10,0,0.0001,0.0001,0.51,171,133
6,404,10,0,0.0001,0.0001,0.51,225,179
6,504,10,0,0.0001,0.0001,0.508,277,227
6,604,10,0,0.0001,0.0001,0.512,326,278
6,704,10,0,0.0001,0.0001,0.508,375,329
6,804,10,0,0.0001,0.0001,0.51,424,380
6,904,10,0,0.0001,0.0001,0.508,467,437
6,1004,10,0,0.0001,0.0001,0.506,516,488
6,1104,10,0,0.0001,0.0001,0.508,567,537
6,1204,10,0,0.0001,0.0001,0.51,612,592
6,1304,10,0,0.0001,0.0001,0.522,660,644
6,1404,10,0,0.0001,0.0001,0.518,709,695
6,1504,10,0,0.0001,0.0001,0.514,760,744
6,1604,10,0,0.0001,0.0001,0.514,808,796
6,1704,10,0,0.0001,0.0001,0.518,863,841
6,1804,10,0,0.0001,0.0001,0.514,902,902
6,1904,10,0,0.0001,0.0001,0.512,952,952
7,0,10,0,0.0001,0.0001,0.486,0,0
7,104,10,0,0.0001,0.0001,0.486,44,60
7,204,10,0,0.0001,0.0001,0.488,94,110
7,304,10,0,0.0001,0.0001,0.49,137,167
7,404,10,0,0.0001,0.0001,0.482,175,229
7,504,10,0,0.0001,0.0001,0.492,223,281
7,604,10,0,0.0001,0.0001,0.486,275,329
7,704,10,0,0.0001,0.0001,0.488,323,381
7,804,10,0,0.0001,0.0001,0.486,378,426
7,904,10,0,0.0001,0.0001,0.486,430,474
7,1004,10,0,0.0001,0.0001,0.49,485,519
7,1104,10,0,0.0001,0.0001,0.484,536,568
7,1204,10,0,0.0001,0.0001,0.488,583,621
7,1304,10,0,0.0001,0.0001,0.488,638,666
7,1404,10,0,0.0001,0.0001,0.488,692,712
7,1504,10,0,0.0001,0.0001,0.484,743,761
7,1604,10,0,0.0001,0.0001,0.486,798,806
7,1704,10,0,0.0001,0.0001,0.486,852,852
7,1804,10,0,0.0001,0.0001,0.484,903,901
7,1904,10,0,0.0001,0.0001,0.486,952,952
8,0,10,0,0.0001,0.0001,0.502,0,0
8,104,10,0,0.0001,0.0001,0.502,52,52
8,204,10,0,0.0001,0.0001,0.502,100,104
8,304,10,0,0.0001,0.0001,0.502,146,158
8,404,10,0,0.0001,0.0001,0.5,201,203
8,504,10,0,0.0001,0.0001,0.5,251,253
8,604,10,0,0.0001,0.0001,0.5,303,301
8,704,10,0,0.0001,0.0001,0.5,355,349
8,804,10,0,0.0001,0.0001,0.5,396,408
8,904,10,0,0.0001,0.0001,0.502,441,463
8,1004,10,0,0.0001,0.0001,0.504,494,510
8,1104,10,0,0.0001,0.0001,0.508,550,554
8,1204,10,0,0.0001,0.0001,0.508,607,597
8,1304,10,0,0.0001,0.0001,0.51,658,646
8,1404,10,0,0.0001,0.0001,0.51,713,691
8,1504,10,0,0.0001,0.0001,0.512,753,751
8,1604,10,0,0.0001,0.0001,0.518,795,809
8,1704,10,0,0.0001,0.0001,0.518,844,860
8,1804,10,0,0.0001,0.0001,0.518,898,906
8,1904,10,0,0.0001,0.0001,0.518,952,952
9,0,10,0,0.0001,0.0001,0.5,0,0
9,104,10,0,0.0001,0.0001,0.5,47,57
9,204,10,0,0.0001,0.0001,0.5,87,117
9,304,10,0,0.0001,0.0001,0.5,136,168
9,404,10,0,0.0001,0.0001,0.5,189,215
9,504,10,0,0.0001,0.0001,0.5,238,266
9,604,10,0,0.0001,0.0001,0.5,288,316
9,704,10,0,0.0001,0.0001,0.5,336,368
9,804,10,0,0.0001,0.0001,0.5,384,420
9,904,10,0,0.0001,0.0001,0.5,438,466
9,1004,10,0,0.0001,0.0001,0.5,481,523
9,1104,10,0,0.0001,0.0001,0.5,536,568
9,1204,10,0,0.0001,0.0001,0.5,591,613
9,1304,10,0,0.0001,0.0001,0.5,643,661
9,1404,10,0,0.0001,0.0001,0.5,698,706
9,1504,10,0,0.0001,0.0001,0.5,747,757
9,1604,10,0,0.0001,0.0001,0.5,790,814
9,1704,10,0,0.0001,0.0001,0.5,841,863
9,1804,10,0,0.0001,0.0001,0.5,890,914
9,1904,10,0,0.0001,0.0001,0.502,952,952
10,0,10,0,0.0001,0.0001,0.5,0,0
10,104,10,0,0.0001,0.0001,0.5,47,57
10,204,10,0,0.0001,0.0001,0.5,102,102
10,304,10,0,0.0001,0.0001,0.5,150,154
10,404,10,0,0.0001,0.0001,0.5,196,208
10,504,10,0,0.0001,0.0001,0.5,246,258
10,604,10,0,0.0001,0.0001,0.5,296,308
10,704,10,0,0.0001,0.0001,0.5,345,359
10,804,10,0,0.0001,0.0001,0.5,398,406
10,904,10,0,0.0001,0.0001,0.5,444,460
10,1004,10,0,0.0001,0.0001,0.5,496,508
10,1104,10,0,0.0001,0.0001,0.5,546,558
10,1204,10,0,0.0001,0.0001,0.5,590,614
10,1304,10,0,0.0001,0.0001,0.5,639,665
10,1404,10,0,0.0001,0.0001,0.5,687,717
10,1504,10,0,0.0001,0.0001,0.5,747,757
10,1604,10,0,0.0001,0.0001,0.5,796,808
10,1704,10,0,0.0001,0.0001,0.5,848,856
10,1804,10,0,0.0001,0.0001,0.5,899,905
10,1904,10,0,0.0001,0.0001,0.5,952,952
11,0,10,0,0.0001,0.0001,0.5,0,0
11,104,10,0,0.0001,0.0001,0.5,56,48
11,204,10,0,0.0001,0.0001,0.5,104,100
11,304,10,0,0.0001,0.0001,0.5,164,140
11,404,10,0,0.0001,0.0001,0.5,213,191
11,504,10,0,0.0001,0.0001,0.5,262,242
11,604,10,0,0.0001,0.0001,0.5,301,303
11,704,10,0,0.0001,0.0001,0.5,355,349
11,804,10,0,0.0001,0.0001,0.5,411,393
11,904,10,0,0.0001,0.0001,0.5,463,441
11,1004,10,0,0.0001,0.0001,0.5,515,489
11,1104,10,0,0.0001,0.0001,0.5,560,544
11,1204,10,0,0.0001,0.0001,0.5,613,591
11,1304,10,0,0.0001,0.0001,0.5,670,634
11,1404,10,0,0.0001,0.0001,0.5,717,687
11,1504,10,0,0.0001,0.0001,0.5,769,735
11,1604,10,0,0.0001,0.0001,0.5,817,787
11,1704,10,0,0.0001,0.0001,0.5,856,848
11,1804,10,0,0.0001,0.0001,0.5,903,901
11,1904,10,0,0.0001,0.0001,0.5,952,952
12,0,10,0,0.0001,0.0001,0.5,0,0
12,104,10,0,0.0001,0.0001,0.5,54,50
12,204,10,0,0.0001,0.0001,0.5,118,86
12,304,10,0,0.0001,0.0001,0.5,163,141
12,404,10,0,0.0001,0.0001,0.5,215,189
12,504,10,0,0.0001,0.0001,0.5,255,249
12,604,10,0,0.0001,0.0001,0.5,320,284
12,704,10,0,0.0001,0.0001,0.5,375,329
12,804,10,0,0.0001,0.0001,0.5,411,393
12,904,10,0,0.0001,0.0001,0.5,457,447
12,1004,10,0,0.0001,0.0001,0.5,511,493
12,1104,10,0,0.0001,0.0001,0.5,557,547
12,1204,10,0,0.0001,0.0001,0.5,603,601
12,1304,10,0,0.0001,0.0001,0.5,663,641
12,1404,10,0,0.0001,0.0001,0.5,711,693
12,1504,10,0,0.0001,0.0001,0.5,762,742
12,1604,10,0,0.0001,0.0001,0.5,808,796
12,1704,10,0,0.0001,0.0001,0.5,862,842
12,1804,10,0,0.0001,0.0001,0.5,910,894
12,1904,10,0,0.0001,0.0001,0.5,952,952
13,0,10,0,0.0001,0.0001,0.506,0,0
13,104,10,0,0.0001,0.0001,0.504,56,48
13,204,10,0,0.0001,0.0001,0.504,108,96
13,304,10,0,0.0001,0.0001,0.502,149,155
13,404,10,0,0.0001,0.0001,0.504,197,207
13,504,10,0,0.0001,0.0001,0.504,244,260
13,604,10,0,0.0001,0.0001,0.506,289,315
13,704,10,0,0.0001,0.0001,0.506,336,368
13,804,10,0,0.0001,0.0001,0.506,388,416
13,904,10,0,0.0001,0.0001,0.502,441,463
13,1004,10,0,0.0001,0.0001,0.502,488,516
13,1104,10,0,0.0001,0.0001,0.508,546,558
13,1204,10,0,0.0001,0.0001,0.506,601,603
13,1304,10,0,0.0001,0.0001,0.504,660,644
13,1404,10,0,0.0001,0.0001,0.502,724,680
13,1504,10,0,0.0001,0.0001,0.51,768,736
13,1604,10,0,0.0001,0.0001,0.514,819,785
13,1704,10,0,0.0001,0.0001,0.518,864,840
13,1804,10,0,0.0001,0.0001,0.512,906,898
13,1904,10,0,0.0001,0.0001,0.514,952,952
14,0,10,0,0.0001,0.0001,0.484,0,0
14,104,10,0,0.0001,0.0001,0.482,62,42
14,204,10,0,0.0001,0.0001,0.484,104,100
14,304,10,0,0.0001,0.0001,0.484,152,152
14,404,10,0,0.0001,0.0001,0.484,205,199
14,504,10,0,0.0001,0.0001,0.484,257,247
14,604,10,0,0.0001,0.0001,0.484,305,299
14,704,10,0,0.0001,0.0001,0.484,356,348
14,804,10,0,0.0001,0.0001,0.486,416,388
14,904,10,0,0.0001,0.0001,0.488,460,444
14,1004,10,0,0.0001,0.0001,0.494,515,489
14,1104,10,0,0.0001,0.0001,0.496,566,538
14,1204,10,0,0.0001,0.0001,0.496,623,581
14,1304,10,0,0.0001,0.0001,0.492,665,639
14,1404,10,0,0.0001,0.0001,0.492,712,692
14,1504,10,0,0.0001,0.0001,0.492,765,739
14,1604,10,0,0.0001,0.0001,0.492,817,787
14,1704,10,0,0.0001,0.0001,0.492,860,844
14,1804,10,0,0.0001,0.0001,0.492,903,901
14,1904,10,0,0.0001,0.0001,0.488,952,952
15,0,10,0,0.0001,0.0001,0.5,0,0
15,104,10,0,0.0001,0.0001,0.5,51,53
15,204,10,0,0.0001,0.0001,0.5,97,107
15,304,10,0,0.0001,0.0001,0.5,144,160
15,404,10,0,0.0001,0.0001,0.5,197,207
15,504,10,0,0.0001,0.0001,0.5,247,257
15,604,10,0,0.0001,0.0001,0.5,304,300
15,704,10,0,0.0001,0.0001,0.5,355,349
15,804,10,0,0.0001,0.0001,0.5,403,401
15,904,10,0,0.0001,0.0001,0.5,450,454
15,1004,10,0,0.0001,0.0001,0.5,504,500
15,1104,10,0,0.0001,0.0001,0.5,556,548
15,1204,10,0,0.0001,0.0001,0.5,606,598
15,1304,10,0,0.0001,0.0001,0.5,660,644
15,1404,10,0,0.0001,0.0001,0.498,704,700
15,1504,10,0,0.0001,0.0001,0.498,750,754
15,1604,10,0,0.0001,0.0001,0.5,798,806
15,1704,10,0,0.0001,0.0001,0.5,850,854
15,1804,10,0,0.0001,0.0001,0.5,902,902
15,1904,10,0,0.0001,0.0001,0.5,952,952
16,0,10,0,0.0001,0.0001,0.498,0,0
16,104,10,0,0.0001,0.0001,0.498,55,49
16,204,10,0,0.0001,0.0001,0.498,106,98
16,304,10,0,0.0001,0.0001,0.498,153,151
16,404,10,0,0.0001,0.0001,0.498,202,202
16,504,10,0,0.0001,0.0001,0.498,247,257
16,604,10,0,0.0001,0.0001,0.498,292,312
16,704,10,0,0.0001,0.0001,0.498,342,362
16,804,10,0,0.0001,0.0001,0.498,388,416
16,904,10,0,0.0001,0.0001,0.498,441,463
16,1004,10,0,0.0001,0.0001,0.496,504,500
16,1104,10,0,0.0001,0.0001,0.494,551,553
16,1204,10,0,0.0001,0.0001,0.494,598,606
16,1304,10,0,0.0001,0.0001,0.492,651,653
16,1404,10,0,0.0001,0.0001,0.492,701,703
16,1504,10,0,0.0001,0.0001,0.496,754,750
16,1604,10,0,0.0001,0.0001,0.494,803,801
16,1704,10,0,0.0001,0.0001,0.496,858,846
16,1804,10,0,0.0001,0.0001,0.498,910,894
16,1904,10,0,0.0001,0.0001,0.496,952,952
17,0,10,0,0.0001,0.0001,0.502,0,0
17,104,10,0,0.0001,0.0001,0.502,47,57
17,204,10,0,0.0001,0.0001,0.502,96,108
17,304,10,0,0.0001,0.0001,0.502,148,156
17,404,10,0,0.0001,0.0001,0.502,199,205
17,504,10,0,0.0001,0.0001,0.502,246,258
17,604,10,0,0.0001,0.0001,0.502,300,304
17,704,10,0,0.0001,0.0001,0.502,347,357
17,804,10,0,0.0001,0.0001,0.5,394,410
17,904,10,0,0.0001,0.0001,0.502,446,458
17,1004,10,0,0.0001,0.0001,0.5,490,514
17,1104,10,0,0.0001,0.0001,0.5,540,564
17,1204,10,0,0.0001,0.0001,0.504,588,616
17,1304,10,0,0.0001,0.0001,0.504,639,665
17,1404,10,0,0.0001,0.0001,0.502,697,707
17,1504,10,0,0.0001,0.0001,0.502,742,762
17,1604,10,0,0.0001,0.0001,0.5,798,806
17,1704,10,0,0.0001,0.0001,0.492,846,858
17,1804,10,0,0.0001,0.0001,0.496,895,909
17,1904,10,0,0.0001,0.0001,0.498,952,952
18,0,10,0,0.0001,0.0001,0.524,0,0
18,104,10,0,0.0001,0.0001,0.526,52,52
18,204,10,0,0.0001,0.0001,0.526,103,101
18,304,10,0,0.0001,0.0001,0.522,155,149
18,404,10,0,0.0001,0.0001,0.524,197,207
18,504,10,0,0.0001,0.0001,0.524,252,252
18,604,10,0,0.0001,0.0001,0.526,302,302
18,704,10,0,0.0001,0.0001,0.524,352,352
18,804,10,0,0.0001,0.0001,0.532,405,399
18,904,10,0,0.0001,0.0001,0.528,461,443
18,1004,10,0,0.0001,0.0001,0.524,506,498
18,1104,10,0,0.0001,0.0001,0.526,546,558
18,1204,10,0,0.0001,0.0001,0.528,599,605
18,1304,10,0,0.0001,0.0001,0.526,654,650
18,1404,10,0,0.0001,0.0001,0.526,699,705
18,1504,10,0,0.0001,0.0001,0.524,759,745
18,1604,10,0,0.0001,0.0001,0.526,801,803
18,1704,10,0,0.0001,0.0001,0.53,857,847
18,1804,10,0,0.0001,0.0001,0.53,907,897
18,1904,10,0,0.0001,0.0001,0.528,952,952
19,0,10,0,0.0001,0.0001,0.5,0,0
19,104,10,0,0.0001,0.0001,0.5,51,53
19,204,10,0,0.0001,0.0001,0.5,100,104
19,304,10,0,0.0001,0.0001,0.5,154,150
19,404,10,0,0.0001,0.0001,0.5,204,200
19,504,10,0,0.0001,0.0001,0.5,247,257
19,604,10,0,0.0001,0.0001,0.5,294,310
19,704,10,0,0.0001,0.0001,0.5,343,361
19,804,10,0,0.0001,0.0001,0.5,399,405
19,904,10,0,0.0001,0.0001,0.5,451,453
19,1004,10,0,0.0001,0.0001,0.5,501,503
19,1104,10,0,0.0001,0.0001,0.502,549,555
19,1204,10,0,0.0001,0.0001,0.502,607,597
19,1304,10,0,0.0001,0.0001,0.502,649,655
19,1404,10,0,0.0001,0.0001,0.502,705,699
19,1504,10,0,0.0001,0.0001,0.504,748,756
19,1604,10,0,0.0001,0.0001,0.504,802,802
19,1704,10,0,0.0001,0.0001,0.504,864,840
19,1804,10,0,0.0001,0.0001,0.504,906,898
19,1904,10,0,0.0001,0.0001,0.504,952,952
20,0,10,0,0.0001,0.0001,0.504,0,0
20,104,10,0,0.0001,0.0001,0.504,56,48
20,204,10,0,0.0001,0.0001,0.504,111,93
20,304,10,0,0.0001,0.0001,0.504,161,143
20,404,10,0,0.0001,0.0001,0.504,215,189
20,504,10,0,0.0001,0.0001,0.504,261,243
20,604,10,0,0.0001,0.0001,0.504,304,300
20,704,10,0,0.0001,0.0001,0.504,355,349
20,804,10,0,0.0001,0.0001,0.504,401,403
20,904,10,0,0.0001,0.0001,0.502,454,450
20,1004,10,0,0.0001,0.0001,0.504,506,498
20,1104,10,0,0.0001,0.0001,0.502,547,557
20,1204,10,0,0.0001,0.0001,0.502,609,595
20,1304,10,0,0.0001,0.0001,0.504,656,648
20,1404,10,0,0.0001,0.0001,0.502,699,705
20,1504,10,0,0.0001,0.0001,0.502,755,749
20,1604,10,0,0.0001,0.0001,0.502,809,795
20,1704,10,0,0.0001,0.0001,0.502,857,847
20,1804,10,0,0.0001,0.0001,0.5,907,897
20,1904,10,0,0.0001,0.0001,0.498,952,952
1,0,10,0,0.0001,0.001,0.596,0,0
1,104,10,0,0.0001,0.001,0.598,61,43
1,204,10,0,0.0001,0.001,0.598,105,99
1,304,10,0,0.0001,0.001,0.6,159,145
1,404,10,0,0.0001,0.001,0.594,203,201
1,504,10,0,0.0001,0.001,0.594,253,251
1,604,10,0,0.0001,0.001,0.584,305,299
1,704,10,0,0.0001,0.001,0.588,356,348
1,804,10,0,0.0001,0.001,0.6,410,394
1,904,10,0,0.0001,0.001,0.614,454,450
1,1004,10,0,0.0001,0.001,0.622,510,494
1,1104,10,0,0.0001,0.001,0.616,546,558
1,1204,10,0,0.0001,0.001,0.624,604,600
1,1304,10,0,0.0001,0.001,0.652,656,648
1,1404,10,0,0.0001,0.001,0.666,710,694
1,1504,10,0,0.0001,0.001,0.682,760,744
1,1604,10,0,0.0001,0.001,0.682,813,791
1,1704,10,0,0.0001,0.001,0.702,861,843
1,1804,10,0,0.0001,0.001,0.726,901,903
1,1904,10,0,0.0001,0.001,0.742,952,952
2,0,10,0,0.0001,0.001,0.554,0,0
2,104,10,0,0.0001,0.001,0.554,55,49
2,204,10,0,0.0001,0.001,0.556,97,107
2,304,10,0,0.0001,0.001,0.564,131,173
2,404,10,0,0.0001,0.001,0.578,181,223
2,504,10,0,0.0001,0.001,0.594,231,273
2,604,10,0,0.0001,0.001,0.59,281,323
2,704,10,0,0.0001,0.001,0.61,329,375
2,804,10,0,0.0001,0.001,0.614,385,419
2,904,10,0,0.0001,0.001,0.62,433,471
2,1004,10,0,0.0001,0.001,0.618,474,530
2,1104,10,0,0.0001,0.001,0.61,527,577
2,1204,10,0,0.0001,0.001,0.608,585,619
2,1304,10,0,0.0001,0.001,0.61,628,676
2,1404,10,0,0.0001,0.001,0.604,681,723
2,1504,10,0,0.0001,0.001,0.606,745,759
2,1604,10,0,0.0001,0.001,0.612,800,804
2,1704,10,0,0.0001,0.001,0.614,852,852
2,1804,10,0,0.0001,0.001,0.628,899,905
2,1904,10,0,0.0001,0.001,0.636,952,952
3,0,10,0,0.0001,0.001,0.548,0,0
3,104,10,0,0.0001,0.001,0.548,56,48
3,204,10,0,0.0001,0.001,0.55,104,100
3,304,10,0,0.0001,0.001,0.56,152,152
3,404,10,0,0.0001,0.001,0.552,203,201
3,504,10,0,0.0001,0.001,0.53,255,249
3,604,10,0,0.0001,0.001,0.53,304,300
3,704,10,0,0.0001,0.001,0.528,354,350
3,804,10,0,0.0001,0.001,0.532,408,396
3,904,10,0,0.0001,0.001,0.54,453,451
3,1004,10,0,0.0001,0.001,0.536,505,499
3,1104,10,0,0.0001,0.001,0.572,556,548
3,1204,10,0,0.0001,0.001,0.598,599,605
3,1304,10,0,0.0001,0.001,0.598,651,653
3,1404,10,0,0.0001,0.001,0.588,708,696
3,1504,10,0,0.0001,0.001,0.586,768,736
3,1604,10,0,0.0001,0.001,0.602,811,793
3,1704,10,0,0.0001,0.001,0.624,859,845
3,1804,10,0,0.0001,0.001,0.64,910,894
3,1904,10,0,0.0001,0.001,0.64,952,952
4,0,10,0,0.0001,0.001,0.556,0,0
4,104,10,0,0.0001,0.001,0.558,52,52
4,204,10,0,0.0001,0.001,0.56,108,96
4,304,10,0,0.0001,0.001,0.566,166,138
4,404,10,0,0.0001,0.001,0.582,215,189
4,504,10,0,0.0001,0.001,0.606,258,246
4,604,10,0,0.0001,0.001,0.594,309,295
4,704,10,0,0.0001,0.001,0.57,365,339
4,804,10,0,0.0001,0.001,0.57,412,392
4,904,10,0,0.0001,0.001,0.592,453,451
4,1004,10,0,0.0001,0.001,0.6,502,502
4,1104,10,0,0.0001,0.001,0.598,553,551
4,1204,10,0,0.0001,0.001,0.622,599,605
4,1304,10,0,0.0001,0.001,0.636,646,658
4,1404,10,0,0.0001,0.001,0.652,702,702
4,1504,10,0,0.0001,0.001,0.676,750,754
4,1604,10,0,0.0001,0.001,0.696,798,806
4,1704,10,0,0.0001,0.001,0.722,854,850
4,1804,10,0,0.0001,0.001,0.734,909,895
4,1904,10,0,0.0001,0.001,0.758,952,952
5,0,10,0,0.0001,0.001,0.574,0,0
5,104,10,0,0.0001,0.001,0.576,49,55
5,204,10,0,0.0001,0.001,0.586,101,103
5,304,10,0,0.0001,0.001,0.594,148,156
5,404,10,0,0.0001,0.001,0.604,204,200
5,504,10,0,0.0001,0.001,0.614,256,248
5,604,10,0,0.0001,0.001,0.616,307,297
5,704,10,0,0.0001,0.001,0.59,366,338
5,804,10,0,0.0001,0.001,0.608,417,387
5,904,10,0,0.0001,0.001,0.622,473,431
5,1004,10,0,0.0001,0.001,0.624,514,490
5,1104,10,0,0.0001,0.001,0.628,556,548
5,1204,10,0,0.0001,0.001,0.64,607,597
5,1304,10,0,0.0001,0.001,0.652,660,644
5,1404,10,0,0.0001,0.001,0.656,705,699
5,1504,10,0,0.0001,0.001,0.69,755,749
5,1604,10,0,0.0001,0.001,0.7,802,802
5,1704,10,0,0.0001,0.001,0.718,850,854
5,1804,10,0,0.0001,0.001,0.744,907,897
5,1904,10,0,0.0001,0.001,0.764,952,952
6,0,10,0,0.0001,0.001,0.51,0,0
6,104,10,0,0.0001,0.001,0.512,55,49
6,204,10,0,0.0001,0.001,0.514,111,93
6,304,10,0,0.0001,0.001,0.512,159,145
6,404,10,0,0.0001,0.001,0.524,209,195
6,504,10,0,0.0001,0.001,0.522,253,251
6,604,10,0,0.0001,0.001,0.532,309,295
6,704,10,0,0.0001,0.001,0.526,356,348
6,804,10,0,0.0001,0.001,0.532,403,401
6,904,10,0,0.0001,0.001,0.52,461,443
6,1004,10,0,0.0001,0.001,0.52,514,490
6,1104,10,0,0.0001,0.001,0.518,562,542
6,1204,10,0,0.0001,0.001,0.52,613,591
6,1304,10,0,0.0001,0.001,0.518,661,643
6,1404,10,0,0.0001,0.001,0.516,714,690
6,1504,10,0,0.0001,0.001,0.526,757,747
6,1604,10,0,0.0001,0.001,0.526,804,800
6,1704,10,0,0.0001,0.001,0.524,856,848
6,1804,10,0,0.0001,0.001,0.538,909,895
6,1904,10,0,0.0001,0.001,0.548,952,952
7,0,10,0,0.0001,0.001,0.566,0,0
7,104,10,0,0.0001,0.001,0.568,46,58
7,204,10,0,0.0001,0.001,0.572,99,105
7,304,10,0,0.0001,0.001,0.578,155,149
7,404,10,0,0.0001,0.001,0.586,205,199
7,504,10,0,0.0001,0.001,0.584,255,249
7,604,10,0,0.0001,0.001,0.588,306,298
7,704,10,0,0.0001,0.001,0.582,345,359
7,804,10,0,0.0001,0.001,0.594,400,404
7,904,10,0,0.0001,0.001,0.598,454,450
7,1004,10,0,0.0001,0.001,0.606,496,508
7,1104,10,0,0.0001,0.001,0.612,547,557
7,1204,10,0,0.0001,0.001,0.614,600,604
7,1304,10,0,0.0001,0.001,0.618,657,647
7,1404,10,0,0.0001,0.001,0.622,707,697
7,1504,10,0,0.0001,0.001,0.63,758,746
7,1604,10,0,0.0001,0.001,0.646,805,799
7,1704,10,0,0.0001,0.001,0.65,851,853
7,1804,10,0,0.0001,0.001,0.674,903,901
7,1904,10,0,0.0001,0.001,0.676,952,952
8,0,10,0,0.0001,0.001,0.534,0,0
8,104,10,0,0.0001,0.001,0.534,56,48
8,204,10,0,0.0001,0.001,0.534,107,97
8,304,10,0,0.0001,0.001,0.552,154,150
8,404,10,0,0.0001,0.001,0.57,196,208
8,504,10,0,0.0001,0.001,0.564,245,259
8,604,10,0,0.0001,0.001,0.57,294,310
8,704,10,0,0.0001,0.001,0.578,337,367
8,804,10,0,0.0001,0.001,0.576,380,424
8,904,10,0,0.0001,0.001,0.578,431,473
8,1004,10,0,0.0001,0.001,0.59,484,520
8,1104,10,0,0.0001,0.001,0.602,539,565
8,1204,10,0,0.0001,0.001,0.614,595,609
8,1304,10,0,0.0001,0.001,0.622,646,658
8,1404,10,0,0.0001,0.001,0.632,699,705
8,1504,10,0,0.0001,0.001,0.634,756,748
8,1604,10,0,0.0001,0.001,0.648,805,799
8,1704,10,0,0.0001,0.001,0.672,856,848
8,1804,10,0,0.0001,0.001,0.682,895,909
8,1904,10,0,0.0001,0.001,0.7,952,952
9,0,10,0,0.0001,0.001,0.576,0,0
9,104,10,0,0.0001,0.001,0.576,52,52
9,204,10,0,0.0001,0.001,0.574,98,106
9,304,10,0,0.0001,0.001,0.57,153,151
9,404,10,0,0.0001,0.001,0.57,202,202
9,504,10,0,0.0001,0.001,0.574,255,249
9,604,10,0,0.0001,0.001,0.562,295,309
9,704,10,0,0.0001,0.001,0.572,347,357
9,804,10,0,0.0001,0.001,0.582,396,408
9,904,10,0,0.0001,0.001,0.596,443,461
9,1004,10,0,0.0001,0.001,0.598,492,512
9,1104,10,0,0.0001,0.001,0.602,540,564
9,1204,10,0,0.0001,0.001,0.604,595,609
9,1304,10,0,0.0001,0.001,0.624,643,661
9,1404,10,0,0.0001,0.001,0.632,700,704
9,1504,10,0,0.0001,0.001,0.654,753,751
9,1604,10,0,0.0001,0.001,0.664,813,791
9,1704,10,0,0.0001,0.001,0.684,855,849
9,1804,10,0,0.0001,0.001,0.702,907,897
9,1904,10,0,0.0001,0.001,0.708,952,952
10,0,10,0,0.0001,0.001,0.534,0,0
10,104,10,0,0.0001,0.001,0.538,54,50
10,204,10,0,0.0001,0.001,0.532,98,106
10,304,10,0,0.0001,0.001,0.51,151,153
10,404,10,0,0.0001,0.001,0.502,210,194
10,504,10,0,0.0001,0.001,0.508,256,248
10,604,10,0,0.0001,0.001,0.53,303,301
10,704,10,0,0.0001,0.001,0.532,352,352
10,804,10,0,0.0001,0.001,0.536,402,402
10,904,10,0,0.0001,0.001,0.534,453,451
10,1004,10,0,0.0001,0.001,0.522,507,497
10,1104,10,0,0.0001,0.001,0.536,551,553
10,1204,10,0,0.0001,0.001,0.532,603,601
10,1304,10,0,0.0001,0.001,0.546,650,654
10,1404,10,0,0.0001,0.001,0.54,704,700
10,1504,10,0,0.0001,0.001,0.532,759,745
10,1604,10,0,0.0001,0.001,0.538,801,803
10,1704,10,0,0.0001,0.001,0.546,845,859
10,1804,10,0,0.0001,0.001,0.54,896,908
10,1904,10,0,0.0001,0.001,0.552,952,952
11,0,10,0,0.0001,0.001,0.492,0,0
11,104,10,0,0.0001,0.001,0.492,47,57
11,204,10,0,0.0001,0.001,0.486,98,106
11,304,10,0,0.0001,0.001,0.474,144,160
11,404,10,0,0.0001,0.001,0.492,199,205
11,504,10,0,0.0001,0.001,0.472,244,260
11,604,10,0,0.0001,0.001,0.49,296,308
11,704,10,0,0.0001,0.001,0.504,348,356
11,804,10,0,0.0001,0.001,0.506,397,407
11,904,10,0,0.0001,0.001,0.502,451,453
11,1004,10,0,0.0001,0.001,0.506,502,502
11,1104,10,0,0.0001,0.001,0.52,544,560
11,1204,10,0,0.0001,0.001,0.534,597,607
11,1304,10,0,0.0001,0.001,0.542,641,663
11,1404,10,0,0.0001,0.001,0.556,695,709
11,1504,10,0,0.0001,0.001,0.564,747,757
11,1604,10,0,0.0001,0.001,0.574,803,801
11,1704,10,0,0.0001,0.001,0.592,856,848
11,1804,10,0,0.0001,0.001,0.6,910,894
11,1904,10,0,0.0001,0.001,0.622,952,952
12,0,10,0,0.0001,0.001,0.518,0,0
12,104,10,0,0.0001,0.001,0.516,51,53
12,204,10,0,0.0001,0.001,0.522,102,102
12,304,10,0,0.0001,0.001,0.532,160,144
12,404,10,0,0.0001,0.001,0.554,214,190
12,504,10,0,0.0001,0.001,0.576,269,235
12,604,10,0,0.0001,0.001,0.582,318,286
12,704,10,0,0.0001,0.001,0.564,366,338
12,804,10,0,0.0001,0.001,0.562,413,391
12,904,10,0,0.0001,0.001,0.56,459,445
12,1004,10,0,0.0001,0.001,0.602,508,496
12,1104,10,0,0.0001,0.001,0.61,564,540
12,1204,10,0,0.0001,0.001,0.62,619,585
12,1304,10,0,0.0001,0.001,0.62,658,646
12,1404,10,0,0.0001,0.001,0.628,709,695
12,1504,10,0,0.0001,0.001,0.636,762,742
12,1604,10,0,0.0001,0.001,0.658,809,795
12,1704,10,0,0.0001,0.001,0.666,864,840
12,1804,10,0,0.0001,0.001,0.678,908,896
12,1904,10,0,0.0001,0.001,0.698,952,952
13,0,10,0,0.0001,0.001,0.536,0,0
13,104,10,0,0.0001,0.001,0.536,55,49
13,204,10,0,0.0001,0.001,0.536,114,90
13,304,10,0,0.0001,0.001,0.554,166,138
13,404,10,0,0.0001,0.001,0.558,212,192
13,504,10,0,0.0001,0.001,0.536,259,245
13,604,10,0,0.0001,0.001,0.542,315,289
13,704,10,0,0.0001,0.001,0.514,364,340
13,804,10,0,0.0001,0.001,0.528,413,391
13,904,10,0,0.0001,0.001,0.528,462,442
13,1004,10,0,0.0001,0.001,0.56,515,489
13,1104,10,0,0.0001,0.001,0.564,570,534
13,1204,10,0,0.0001,0.001,0.578,618,586
13,1304,10,0,0.0001,0.001,0.588,664,640
13,1404,10,0,0.0001,0.001,0.596,713,691
13,1504,10,0,0.0001,0.001,0.604,764,740
13,1604,10,0,0.0001,0.001,0.624,803,801
13,1704,10,0,0.0001,0.001,0.636,854,850
13,1804,10,0,0.0001,0.001,0.646,907,897
13,1904,10,0,0.0001,0.001,0.652,952,952
14,0,10,0,0.0001,0.001,0.572,0,0
14,104,10,0,0.0001,0.001,0.576,55,49
14,204,10,0,0.0001,0.001,0.588,100,104
14,304,10,0,0.0001,0.001,0.59,156,148
14,404,10,0,0.0001,0.001,0.61,202,202
14,504,10,0,0.0001,0.001,0.63,252,252
14,604,10,0,0.0001,0.001,0.628,308,296
14,704,10,0,0.0001,0.001,0.63,364,340
14,804,10,0,0.0001,0.001,0.644,416,388
14,904,10,0,0.0001,0.001,0.648,452,452
14,1004,10,0,0.0001,0.001,0.676,497,507
14,1104,10,0,0.0001,0.001,0.696,545,559
14,1204,10,0,0.0001,0.001,0.71,594,610
14,1304,10,0,0.0001,0.001,0.728,645,659
14,1404,10,0,0.0001,0.001,0.734,693,711
14,1504,10,0,0.0001,0.001,0.752,745,759
14,1604,10,0,0.0001,0.001,0.762,788,816
14,1704,10,0,0.0001,0.001,0.772,845,859
14,1804,10,0,0.0001,0.001,0.794,902,902
14,1904,10,0,0.0001,0.001,0.802,952,952
15,0,10,0,0.0001,0.001,0.54,0,0
15,104,10,0,0.0001,0.001,0.542,68,36
15,204,10,0,0.0001,0.001,0.55,114,90
15,304,10,0,0.0001,0.001,0.552,163,141
15,404,10,0,0.0001,0.001,0.53,208,196
15,504,10,0,0.0001,0.001,0.508,258,246
15,604,10,0,0.0001,0.001,0.508,307,297
15,704,10,0,0.0001,0.001,0.516,356,348
15,804,10,0,0.0001,0.001,0.516,409,395
15,904,10,0,0.0001,0.001,0.53,458,446
15,1004,10,0,0.0001,0.001,0.546,505,499
15,1104,10,0,0.0001,0.001,0.564,551,553
15,1204,10,0,0.0001,0.001,0.58,591,613
15,1304,10,0,0.0001,0.001,0.586,644,660
15,1404,10,0,0.0001,0.001,0.586,700,704
15,1504,10,0,0.0001,0.001,0.606,752,752
15,1604,10,0,0.0001,0.001,0.636,805,799
15,1704,10,0,0.0001,0.001,0.642,857,847
15,1804,10,0,0.0001,0.001,0.658,903,901
15,1904,10,0,0.0001,0.001,0.678,952,952
16,0,10,0,0.0001,0.001,0.522,0,0
16,104,10,0,0.0001,0.001,0.524,48,56
16,204,10,0,0.0001,0.001,0.522,97,107
16,304,10,0,0.0001,0.001,0.52,138,166
16,404,10,0,0.0001,0.001,0.512,185,219
16,504,10,0,0.0001,0.001,0.506,233,271
16,604,10,0,0.0001,0.001,0.49,283,321
16,704,10,0,0.0001,0.001,0.472,334,370
16,804,10,0,0.0001,0.001,0.472,387,417
16,904,10,0,0.0001,0.001,0.482,440,464
16,1004,10,0,0.0001,0.001,0.492,487,517
16,1104,10,0,0.0001,0.001,0.494,537,567
16,1204,10,0,0.0001,0.001,0.488,595,609
16,1304,10,0,0.0001,0.001,0.494,652,652
16,1404,10,0,0.0001,0.001,0.502,697,707
16,1504,10,0,0.0001,0.001,0.506,756,748
16,1604,10,0,0.0001,0.001,0.5,813,791
16,1704,10,0,0.0001,0.001,0.504,862,842
16,1804,10,0,0.0001,0.001,0.514,918,886
16,1904,10,0,0.0001,0.001,0.508,952,952
17,0,10,0,0.0001,0.001,0.516,0,0
17,104,10,0,0.0001,0.001,0.518,49,55
17,204,10,0,0.0001,0.001,0.52,94,110
17,304,10,0,0.0001,0.001,0.516,133,171
17,404,10,0,0.0001,0.001,0.524,179,225
17,504,10,0,0.0001,0.001,0.514,225,279
17,604,10,0,0.0001,0.001,0.512,272,332
17,704,10,0,0.0001,0.001,0.534,321,383
17,804,10,0,0.0001,0.001,0.54,374,430
17,904,10,0,0.0001,0.001,0.536,430,474
17,1004,10,0,0.0001,0.001,0.544,480,524
17,1104,10,0,0.0001,0.001,0.552,528,576
17,1204,10,0,0.0001,0.001,0.56,580,624
17,1304,10,0,0.0001,0.001,0.562,634,670
17,1404,10,0,0.0001,0.001,0.566,690,714
17,1504,10,0,0.0001,0.001,0.572,741,763
17,1604,10,0,0.0001,0.001,0.584,799,805
17,1704,10,0,0.0001,0.001,0.606,850,854
17,1804,10,0,0.0001,0.001,0.622,898,906
17,1904,10,0,0.0001,0.001,0.656,952,952
18,0,10,0,0.0001,0.001,0.564,0,0
18,104,10,0,0.0001,0.001,0.566,49,55
18,204,10,0,0.0001,0.001,0.58,102,102
18,304,10,0,0.0001,0.001,0.594,152,152
18,404,10,0,0.0001,0.001,0.594,198,206
18,504,10,0,0.0001,0.001,0.606,243,261
18,604,10,0,0.0001,0.001,0.61,295,309
18,704,10,0,0.0001,0.001,0.622,349,355
18,804,10,0,0.0001,0.001,0.632,398,406
18,904,10,0,0.0001,0.001,0.65,446,458
18,1004,10,0,0.0001,0.001,0.662,501,503
18,1104,10,0,0.0001,0.001,0.674,542,562
18,1204,10,0,0.0001,0.001,0.688,591,613
18,1304,10,0,0.0001,0.001,0.7,629,675
18,1404,10,0,0.0001,0.001,0.716,699,705
18,1504,10,0,0.0001,0.001,0.734,754,750
18,1604,10,0,0.0001,0.001,0.742,807,797
18,1704,10,0,0.0001,0.001,0.754,858,846
18,1804,10,0,0.0001,0.001,0.772,911,893
18,1904,10,0,0.0001,0.001,0.79,952,952
19,0,10,0,0.0001,0.001,0.534,0,0
19,104,10,0,0.0001,0.001,0.532,60,44
19,204,10,0,0.0001,0.001,0.536,106,98
19,304,10,0,0.0001,0.001,0.546,157,147
19,404,10,0,0.0001,0.001,0.532,195,209
19,504,10,0,0.0001,0.001,0.524,249,255
19,604,10,0,0.0001,0.001,0.51,294,310
19,704,10,0,0.0001,0.001,0.514,352,352
19,804,10,0,0.0001,0.001,0.518,397,407
19,904,10,0,0.0001,0.001,0.534,456,448
19,1004,10,0,0.0001,0.001,0.544,511,493
19,1104,10,0,0.0001,0.001,0.538,563,541
19,1204,10,0,0.0001,0.001,0.536,608,596
19,1304,10,0,0.0001,0.001,0.536,660,644
19,1404,10,0,0.0001,0.001,0.534,705,699
19,1504,10,0,0.0001,0.001,0.534,755,749
19,1604,10,0,0.0001,0.001,0.528,809,795
19,1704,10,0,0.0001,0.001,0.552,854,850
19,1804,10,0,0.0001,0.001,0.562,903,901
19,1904,10,0,0.0001,0.001,0.554,952,952
20,0,10,0,0.0001,0.001,0.604,0,0
20,104,10,0,0.0001,0.001,0.604,48,56
20,204,10,0,0.0001,0.001,0.61,100,104
20,304,10,0,0.0001,0.001,0.598,141,163
20,404,10,0,0.0001,0.001,0.608,189,215
20,504,10,0,0.0001,0.001,0.624,246,258
20,604,10,0,0.0001,0.001,0.626,290,314
20,704,10,0,0.0001,0.001,0.632,344,360
20,804,10,0,0.0001,0.001,0.648,386,418
20,904,10,0,0.0001,0.001,0.654,436,468
20,1004,10,0,0.0001,0.001,0.666,482,522
20,1104,10,0,0.0001,0.001,0.67,535,569
20,1204,10,0,0.0001,0.001,0.69,582,622
20,1304,10,0,0.0001,0.001,0.71,634,670
20,1404,10,0,0.0001,0.001,0.718,691,713
20,1504,10,0,0.0001,0.001,0.72,733,771
20,1604,10,0,0.0001,0.001,0.728,790,814
20,1704,10,0,0.0001,0.001,0.75,843,861
20,1804,10,0,0.0001,0.001,0.76,893,911
20,1904,10,0,0.0001,0.001,0.766,952,952
1,0,10,0,0.0001,0.01,0.518,0,0
1,104,10,0,0.0001,0.01,0.53,44,60
1,204,10,0,0.0001,0.01,0.562,84,120
1,304,10,0,0.0001,0.01,0.538,137,167
1,404,10,0,0.0001,0.01,0.532,181,223
1,504,10,0,0.0001,0.01,0.58,232,272
1,604,10,0,0.0001,0.01,0.58,287,317
1,704,10,0,0.0001,0.01,0.556,348,356
1,804,10,0,0.0001,0.01,0.542,401,403
1,904,10,0,0.0001,0.01,0.56,447,457
1,1004,10,0,0.0001,0.01,0.556,497,507
1,1104,10,0,0.0001,0.01,0.574,553,551
1,1204,10,0,0.0001,0.01,0.592,599,605
1,1304,10,0,0.0001,0.01,0.598,648,656
1,1404,10,0,0.0001,0.01,0.608,692,712
1,1504,10,0,0.0001,0.01,0.626,747,757
1,1604,10,0,0.0001,0.01,0.656,791,813
1,1704,10,0,0.0001,0.01,0.692,841,863
1,1804,10,0,0.0001,0.01,0.694,898,906
1,1904,10,0,0.0001,0.01,0.738,952,952
2,0,10,0,0.0001,0.01,0.516,0,0
2,104,10,0,0.0001,0.01,0.544,56,48
2,204,10,0,0.0001,0.01,0.572,104,100
2,304,10,0,0.0001,0.01,0.566,156,148
2,404,10,0,0.0001,0.01,0.576,197,207
2,504,10,0,0.0001,0.01,0.622,250,254
2,604,10,0,0.0001,0.01,0.636,297,307
2,704,10,0,0.0001,0.01,0.61,346,358
2,804,10,0,0.0001,0.01,0.624,401,403
2,904,10,0,0.0001,0.01,0.652,457,447
2,1004,10,0,0.0001,0.01,0.656,506,498
2,1104,10,0,0.0001,0.01,0.656,556,548
2,1204,10,0,0.0001,0.01,0.692,604,600
2,1304,10,0,0.0001,0.01,0.708,656,648
2,1404,10,0,0.0001,0.01,0.72,706,698
2,1504,10,0,0.0001,0.01,0.752,754,750
2,1604,10,0,0.0001,0.01,0.766,804,800
2,1704,10,0,0.0001,0.01,0.802,843,861
2,1804,10,0,0.0001,0.01,0.826,896,908
2,1904,10,0,0.0001,0.01,0.854,952,952
3,0,10,0,0.0001,0.01,0.518,0,0
3,104,10,0,0.0001,0.01,0.55,54,50
3,204,10,0,0.0001,0.01,0.64,97,107
3,304,10,0,0.0001,0.01,0.564,147,157
3,404,10,0,0.0001,0.01,0.576,206,198
3,504,10,0,0.0001,0.01,0.62,252,252
3,604,10,0,0.0001,0.01,0.638,299,305
3,704,10,0,0.0001,0.01,0.642,344,360
3,804,10,0,0.0001,0.01,0.608,407,397
3,904,10,0,0.0001,0.01,0.636,455,449
3,1004,10,0,0.0001,0.01,0.662,502,502
3,1104,10,0,0.0001,0.01,0.666,548,556
3,1204,10,0,0.0001,0.01,0.674,596,608
3,1304,10,0,0.0001,0.01,0.688,652,652
3,1404,10,0,0.0001,0.01,0.714,704,700
3,1504,10,0,0.0001,0.01,0.726,756,748
3,1604,10,0,0.0001,0.01,0.756,808,796
3,1704,10,0,0.0001,0.01,0.77,866,838
3,1804,10,0,0.0001,0.01,0.82,908,896
3,1904,10,0,0.0001,0.01,0.832,952,952
4,0,10,0,0.0001,0.01,0.524,0,0
4,104,10,0,0.0001,0.01,0.528,58,46
4,204,10,0,0.0001,0.01,0.552,112,92
4,304,10,0,0.0001,0.01,0.54,154,150
4,404,10,0,0.0001,0.01,0.548,206,198
4,504,10,0,0.0001,0.01,0.542,258,246
4,604,10,0,0.0001,0.01,0.54,313,291
4,704,10,0,0.0001,0.01,0.566,360,344
4,804,10,0,0.0001,0.01,0.548,405,399
4,904,10,0,0.0001,0.01,0.558,453,451
4,1004,10,0,0.0001,0.01,0.53,506,498
4,1104,10,0,0.0001,0.01,0.56,556,548
4,1204,10,0,0.0001,0.01,0.56,599,605
4,1304,10,0,0.0001,0.01,0.558,653,651
4,1404,10,0,0.0001,0.01,0.566,709,695
4,1504,10,0,0.0001,0.01,0.576,768,736
4,1604,10,0,0.0001,0.01,0.59,808,796
4,1704,10,0,0.0001,0.01,0.596,855,849
4,1804,10,0,0.0001,0.01,0.632,904,900
4,1904,10,0,0.0001,0.01,0.636,952,952
5,0,10,0,0.0001,0.01,0.504,0,0
5,104,10,0,0.0001,0.01,0.51,54,50
5,204,10,0,0.0001,0.01,0.55,104,100
5,304,10,0,0.0001,0.01,0.55,151,153
5,404,10,0,0.0001,0.01,0.564,199,205
5,504,10,0,0.0001,0.01,0.552,253,251
5,604,10,0,0.0001,0.01,0.548,301,303
5,704,10,0,0.0001,0.01,0.548,354,350
5,804,10,0,0.0001,0.01,0.534,404,400
5,904,10,0,0.0001,0.01,0.532,448,456
5,1004,10,0,0.0001,0.01,0.532,501,503
5,1104,10,0,0.0001,0.01,0.546,551,553
5,1204,10,0,0.0001,0.01,0.556,607,597
5,1304,10,0,0.0001,0.01,0.566,654,650
5,1404,10,0,0.0001,0.01,0.566,703,701
5,1504,10,0,0.0001,0.01,0.572,751,753
5,1604,10,0,0.0001,0.01,0.574,797,807
5,1704,10,0,0.0001,0.01,0.588,857,847
5,1804,10,0,0.0001,0.01,0.59,899,905
5,1904,10,0,0.0001,0.01,0.59,952,952
6,0,10,0,0.0001,0.01,0.51,0,0
6,104,10,0,0.0001,0.01,0.522,52,52
6,204,10,0,0.0001,0.01,0.616,108,96
6,304,10,0,0.0001,0.01,0.626,146,158
6,404,10,0,0.0001,0.01,0.618,196,208
6,504,10,0,0.0001,0.01,0.632,235,269
6,604,10,0,0.0001,0.01,0.622,280,324
6,704,10,0,0.0001,0.01,0.63,340,364
6,804,10,0,0.0001,0.01,0.624,392,412
6,904,10,0,0.0001,0.01,0.64,443,461
6,1004,10,0,0.0001,0.01,0.638,499,505
6,1104,10,0,0.0001,0.01,0.646,539,565
6,1204,10,0,0.0001,0.01,0.688,597,607
6,1304,10,0,0.0001,0.01,0.726,658,646
6,1404,10,0,0.0001,0.01,0.776,701,703
6,1504,10,0,0.0001,0.01,0.8,747,757
6,1604,10,0,0.0001,0.01,0.846,793,811
6,1704,10,0,0.0001,0.01,0.864,847,857
6,1804,10,0,0.0001,0.01,0.89,890,914
6,1904,10,0,0.0001,0.01,0.918,952,952
7,0,10,0,0.0001,0.01,0.494,0,0
7,104,10,0,0.0001,0.01,0.51,62,42
7,204,10,0,0.0001,0.01,0.548,123,81
7,304,10,0,0.0001,0.01,0.538,162,142
7,404,10,0,0.0001,0.01,0.55,214,190
7,504,10,0,0.0001,0.01,0.588,258,246
7,604,10,0,0.0001,0.01,0.56,298,306
7,704,10,0,0.0001,0.01,0.574,356,348
7,804,10,0,0.0001,0.01,0.564,404,400
7,904,10,0,0.0001,0.01,0.596,450,454
7,1004,10,0,0.0001,0.01,0.6,500,504
7,1104,10,0,0.0001,0.01,0.614,551,553
7,1204,10,0,0.0001,0.01,0.626,602,602
7,1304,10,0,0.0001,0.01,0.628,648,656
7,1404,10,0,0.0001,0.01,0.654,711,693
7,1504,10,0,0.0001,0.01,0.682,755,749
7,1604,10,0,0.0001,0.01,0.708,797,807
7,1704,10,0,0.0001,0.01,0.718,848,856
7,1804,10,0,0.0001,0.01,0.746,900,904
7,1904,10,0,0.0001,0.01,0.758,952,952
8,0,10,0,0.0001,0.01,0.5,0,0
8,104,10,0,0.0001,0.01,0.508,53,51
8,204,10,0,0.0001,0.01,0.534,103,101
8,304,10,0,0.0001,0.01,0.542,144,160
8,404,10,0,0.0001,0.01,0.546,189,215
8,504,10,0,0.0001,0.01,0.55,245,259
8,604,10,0,0.0001,0.01,0.578,301,303
8,704,10,0,0.0001,0.01,0.578,353,351
8,804,10,0,0.0001,0.01,0.562,402,402
8,904,10,0,0.0001,0.01,0.606,457,447
8,1004,10,0,0.0001,0.01,0.596,506,498
8,1104,10,0,0.0001,0.01,0.614,554,550
8,1204,10,0,0.0001,0.01,0.634,608,596
8,1304,10,0,0.0001,0.01,0.66,646,658
8,1404,10,0,0.0001,0.01,0.688,689,715
8,1504,10,0,0.0001,0.01,0.704,743,761
8,1604,10,0,0.0001,0.01,0.732,798,806
8,1704,10,0,0.0001,0.01,0.774,852,852
8,1804,10,0,0.0001,0.01,0.82,903,901
8,1904,10,0,0.0001,0.01,0.842,952,952
9,0,10,0,0.0001,0.01,0.51,0,0
9,104,10,0,0.0001,0.01,0.536,53,51
9,204,10,0,0.0001,0.01,0.622,107,97
9,304,10,0,0.0001,0.01,0.594,160,144
9,404,10,0,0.0001,0.01,0.578,211,193
9,504,10,0,0.0001,0.01,0.648,256,248
9,604,10,0,0.0001,0.01,0.646,303,301
9,704,10,0,0.0001,0.01,0.654,357,347
9,804,10,0,0.0001,0.01,0.656,404,400
9,904,10,0,0.0001,0.01,0.678,447,457
9,1004,10,0,0.0001,0.01,0.68,494,510
9,1104,10,0,0.0001,0.01,0.682,541,563
9,1204,10,0,0.0001,0.01,0.664,594,610
9,1304,10,0,0.0001,0.01,0.66,648,656
9,1404,10,0,0.0001,0.01,0.664,692,712
9,1504,10,0,0.0001,0.01,0.656,748,756
9,1604,10,0,0.0001,0.01,0.678,802,802
9,1704,10,0,0.0001,0.01,0.71,848,856
9,1804,10,0,0.0001,0.01,0.72,899,905
9,1904,10,0,0.0001,0.01,0.736,952,952
10,0,10,0,0.0001,0.01,0.538,0,0
10,104,10,0,0.0001,0.01,0.576,55,49
10,204,10,0,0.0001,0.01,0.62,99,105
10,304,10,0,0.0001,0.01,0.566,152,152
10,404,10,0,0.0001,0.01,0.586,199,205
10,504,10,0,0.0001,0.01,0.61,247,257
10,604,10,0,0.0001,0.01,0.648,301,303
10,704,10,0,0.0001,0.01,0.67,350,354
10,804,10,0,0.0001,0.01,0.684,398,406
10,904,10,0,0.0001,0.01,0.724,446,458
10,1004,10,0,0.0001,0.01,0.732,498,506
10,1104,10,0,0.0001,0.01,0.74,550,554
10,1204,10,0,0.0001,0.01,0.776,598,606
10,1304,10,0,0.0001,0.01,0.8,649,655
10,1404,10,0,0.0001,0.01,0.826,694,710
10,1504,10,0,0.0001,0.01,0.864,745,759
10,1604,10,0,0.0001,0.01,0.874,794,810
10,1704,10,0,0.0001,0.01,0.912,842,862
10,1804,10,0,0.0001,0.01,0.924,900,904
10,1904,10,0,0.0001,0.01,0.942,952,952
11,0,10,0,0.0001,0.01,0.506,0,0
11,104,10,0,0.0001,0.01,0.52,56,48
11,204,10,0,0.0001,0.01,0.606,99,105
11,304,10,0,0.0001,0.01,0.57,150,154
11,404,10,0,0.0001,0.01,0.566,193,211
11,504,10,0,0.0001,0.01,0.578,249,255
11,604,10,0,0.0001,0.01,0.616,299,305
11,704,10,0,0.0001,0.01,0.63,349,355
11,804,10,0,0.0001,0.01,0.654,405,399
11,904,10,0,0.0001,0.01,0.668,449,455
11,1004,10,0,0.0001,0.01,0.696,497,507
11,1104,10,0,0.0001,0.01,0.72,557,547
11,1204,10,0,0.0001,0.01,0.724,607,597
11,1304,10,0,0.0001,0.01,0.732,657,647
11,1404,10,0,0.0001,0.01,0.746,707,697
11,1504,10,0,0.0001,0.01,0.762,752,752
11,1604,10,0,0.0001,0.01,0.764,802,802
11,1704,10,0,0.0001,0.01,0.8,855,849
11,1804,10,0,0.0001,0.01,0.82,906,898
11,1904,10,0,0.0001,0.01,0.83,952,952
12,0,10,0,0.0001,0.01,0.506,0,0
12,104,10,0,0.0001,0.01,0.51,50,54
12,204,10,0,0.0001,0.01,0.57,93,111
12,304,10,0,0.0001,0.01,0.542,146,158
12,404,10,0,0.0001,0.01,0.548,201,203
12,504,10,0,0.0001,0.01,0.578,241,263
12,604,10,0,0.0001,0.01,0.552,290,314
12,704,10,0,0.0001,0.01,0.524,343,361
12,804,10,0,0.0001,0.01,0.538,388,416
12,904,10,0,0.0001,0.01,0.536,439,465
12,1004,10,0,0.0001,0.01,0.534,493,511
12,1104,10,0,0.0001,0.01,0.552,545,559
12,1204,10,0,0.0001,0.01,0.506,594,610
12,1304,10,0,0.0001,0.01,0.5,648,656
12,1404,10,0,0.0001,0.01,0.512,702,702
12,1504,10,0,0.0001,0.01,0.52,750,754
12,1604,10,0,0.0001,0.01,0.524,805,799
12,1704,10,0,0.0001,0.01,0.528,853,851
12,1804,10,0,0.0001,0.01,0.522,909,895
12,1904,10,0,0.0001,0.01,0.546,952,952
13,0,10,0,0.0001,0.01,0.532,0,0
13,104,10,0,0.0001,0.01,0.56,63,41
13,204,10,0,0.0001,0.01,0.614,112,92
13,304,10,0,0.0001,0.01,0.542,169,135
13,404,10,0,0.0001,0.01,0.538,211,193
13,504,10,0,0.0001,0.01,0.608,263,241
13,604,10,0,0.0001,0.01,0.612,323,281
13,704,10,0,0.0001,0.01,0.63,378,326
13,804,10,0,0.0001,0.01,0.608,421,383
13,904,10,0,0.0001,0.01,0.634,466,438
13,1004,10,0,0.0001,0.01,0.626,522,482
13,1104,10,0,0.0001,0.01,0.65,573,531
13,1204,10,0,0.0001,0.01,0.666,611,593
13,1304,10,0,0.0001,0.01,0.668,661,643
13,1404,10,0,0.0001,0.01,0.666,708,696
13,1504,10,0,0.0001,0.01,0.674,755,749
13,1604,10,0,0.0001,0.01,0.69,807,797
13,1704,10,0,0.0001,0.01,0.72,847,857
13,1804,10,0,0.0001,0.01,0.746,901,903
13,1904,10,0,0.0001,0.01,0.77,952,952
14,0,10,0,0.0001,0.01,0.512,0,0
14,104,10,0,0.0001,0.01,0.518,54,50
14,204,10,0,0.0001,0.01,0.548,111,93
14,304,10,0,0.0001,0.01,0.552,163,141
14,404,10,0,0.0001,0.01,0.578,213,191
14,504,10,0,0.0001,0.01,0.58,260,244
14,604,10,0,0.0001,0.01,0.582,308,296
14,704,10,0,0.0001,0.01,0.598,351,353
14,804,10,0,0.0001,0.01,0.614,393,411
14,904,10,0,0.0001,0.01,0.622,438,466
14,1004,10,0,0.0001,0.01,0.638,488,516
14,1104,10,0,0.0001,0.01,0.64,537,567
14,1204,10,0,0.0001,0.01,0.652,594,610
14,1304,10,0,0.0001,0.01,0.648,648,656
14,1404,10,0,0.0001,0.01,0.676,697,707
14,1504,10,0,0.0001,0.01,0.708,743,761
14,1604,10,0,0.0001,0.01,0.724,808,796
14,1704,10,0,0.0001,0.01,0.758,853,851
14,1804,10,0,0.0001,0.01,0.796,907,897
14,1904,10,0,0.0001,0.01,0.848,952,952
15,0,10,0,0.0001,0.01,0.526,0,0
15,104,10,0,0.0001,0.01,0.546,58,46
15,204,10,0,0.0001,0.01,0.592,108,96
15,304,10,0,0.0001,0.01,0.55,163,141
15,404,10,0,0.0001,0.01,0.552,205,199
15,504,10,0,0.0001,0.01,0.558,260,244
15,604,10,0,0.0001,0.01,0.582,313,291
15,704,10,0,0.0001,0.01,0.62,357,347
15,804,10,0,0.0001,0.01,0.612,403,401
15,904,10,0,0.0001,0.01,0.596,461,443
15,1004,10,0,0.0001,0.01,0.62,506,498
15,1104,10,0,0.0001,0.01,0.612,563,541
15,1204,10,0,0.0001,0.01,0.612,607,597
15,1304,10,0,0.0001,0.01,0.642,651,653
15,1404,10,0,0.0001,0.01,0.652,707,697
15,1504,10,0,0.0001,0.01,0.658,750,754
15,1604,10,0,0.0001,0.01,0.666,797,807
15,1704,10,0,0.0001,0.01,0.68,845,859
15,1804,10,0,0.0001,0.01,0.69,902,902
15,1904,10,0,0.0001,0.01,0.688,952,952
16,0,10,0,0.0001,0.01,0.504,0,0
16,104,10,0,0.0001,0.01,0.51,44,60
16,204,10,0,0.0001,0.01,0.546,103,101
16,304,10,0,0.0001,0.01,0.524,156,148
16,404,10,0,0.0001,0.01,0.508,211,193
16,504,10,0,0.0001,0.01,0.516,269,235
16,604,10,0,0.0001,0.01,0.522,317,287
16,704,10,0,0.0001,0.01,0.532,370,334
16,804,10,0,0.0001,0.01,0.516,413,391
16,904,10,0,0.0001,0.01,0.528,464,440
16,1004,10,0,0.0001,0.01,0.526,519,485
16,1104,10,0,0.0001,0.01,0.558,567,537
16,1204,10,0,0.0001,0.01,0.566,616,588
16,1304,10,0,0.0001,0.01,0.574,663,641
16,1404,10,0,0.0001,0.01,0.592,711,693
16,1504,10,0,0.0001,0.01,0.62,763,741
16,1604,10,0,0.0001,0.01,0.644,819,785
16,1704,10,0,0.0001,0.01,0.672,864,840
16,1804,10,0,0.0001,0.01,0.696,910,894
16,1904,10,0,0.0001,0.01,0.706,952,952
17,0,10,0,0.0001,0.01,0.514,0,0
17,104,10,0,0.0001,0.01,0.538,54,50
17,204,10,0,0.0001,0.01,0.632,102,102
17,304,10,0,0.0001,0.01,0.616,155,149
17,404,10,0,0.0001,0.01,0.616,199,205
17,504,10,0,0.0001,0.01,0.676,246,258
17,604,10,0,0.0001,0.01,0.668,293,311
17,704,10,0,0.0001,0.01,0.676,348,356
17,804,10,0,0.0001,0.01,0.676,397,407
17,904,10,0,0.0001,0.01,0.678,443,461
17,1004,10,0,0.0001,0.01,0.674,490,514
17,1104,10,0,0.0001,0.01,0.706,538,566
17,1204,10,0,0.0001,0.01,0.728,590,614
17,1304,10,0,0.0001,0.01,0.748,644,660
17,1404,10,0,0.0001,0.01,0.774,691,713
17,1504,10,0,0.0001,0.01,0.802,749,755
17,1604,10,0,0.0001,0.01,0.832,799,805
17,1704,10,0,0.0001,0.01,0.856,851,853
17,1804,10,0,0.0001,0.01,0.866,901,903
17,1904,10,0,0.0001,0.01,0.892,952,952
18,0,10,0,0.0001,0.01,0.528,0,0
18,104,10,0,0.0001,0.01,0.538,66,38
18,204,10,0,0.0001,0.01,0.522,111,93
18,304,10,0,0.0001,0.01,0.528,165,139
18,404,10,0,0.0001,0.01,0.542,222,182
18,504,10,0,0.0001,0.01,0.552,264,240
18,604,10,0,0.0001,0.01,0.548,312,292
18,704,10,0,0.0001,0.01,0.562,363,341
18,804,10,0,0.0001,0.01,0.564,412,392
18,904,10,0,0.0001,0.01,0.562,459,445
18,1004,10,0,0.0001,0.01,0.55,508,496
18,1104,10,0,0.0001,0.01,0.542,559,545
18,1204,10,0,0.0001,0.01,0.546,607,597
18,1304,10,0,0.0001,0.01,0.546,653,651
18,1404,10,0,0.0001,0.01,0.55,701,703
18,1504,10,0,0.0001,0.01,0.548,749,755
18,1604,10,0,0.0001,0.01,0.556,800,804
18,1704,10,0,0.0001,0.01,0.548,859,845
18,1804,10,0,0.0001,0.01,0.56,908,896
18,1904,10,0,0.0001,0.01,0.558,952,952
19,0,10,0,0.0001,0.01,0.518,0,0
19,104,10,0,0.0001,0.01,0.536,50,54
19,204,10,0,0.0001,0.01,0.588,97,107
19,304,10,0,0.0001,0.01,0.536,150,154
19,404,10,0,0.0001,0.01,0.542,192,212
19,504,10,0,0.0001,0.01,0.616,240,264
19,604,10,0,0.0001,0.01,0.624,281,323
19,704,10,0,0.0001,0.01,0.638,331,373
19,804,10,0,0.0001,0.01,0.6,388,416
19,904,10,0,0.0001,0.01,0.652,437,467
19,1004,10,0,0.0001,0.01,0.644,491,513
19,1104,10,0,0.0001,0.01,0.65,533,571
19,1204,10,0,0.0001,0.01,0.674,582,622
19,1304,10,0,0.0001,0.01,0.718,641,663
19,1404,10,0,0.0001,0.01,0.744,685,719
19,1504,10,0,0.0001,0.01,0.772,734,770
19,1604,10,0,0.0001,0.01,0.812,794,810
19,1704,10,0,0.0001,0.01,0.838,848,856
19,1804,10,0,0.0001,0.01,0.868,897,907
19,1904,10,0,0.0001,0.01,0.89,952,952
20,0,10,0,0.0001,0.01,0.504,0,0
20,104,10,0,0.0001,0.01,0.508,59,45
20,204,10,0,0.0001,0.01,0.532,101,103
20,304,10,0,0.0001,0.01,0.478,143,161
20,404,10,0,0.0001,0.01,0.486,191,213
20,504,10,0,0.0001,0.01,0.546,240,264
20,604,10,0,0.0001,0.01,0.54,289,315
20,704,10,0,0.0001,0.01,0.534,344,360
20,804,10,0,0.0001,0.01,0.526,385,419
20,904,10,0,0.0001,0.01,0.534,430,474
20,1004,10,0,0.0001,0.01,0.544,495,509
20,1104,10,0,0.0001,0.01,0.548,542,562
20,1204,10,0,0.0001,0.01,0.556,596,608
20,1304,10,0,0.0001,0.01,0.56,650,654
20,1404,10,0,0.0001,0.01,0.57,699,705
20,1504,10,0,0.0001,0.01,0.574,750,754
20,1604,10,0,0.0001,0.01,0.578,799,805
20,1704,10,0,0.0001,0.01,0.584,852,852
20,1804,10,0,0.0001,0.01,0.6,903,901
20,1904,10,0,0.0001,0.01,0.608,952,952
1,0,10,0,0.001,0.0001,0.5,0,0
1,104,10,0,0.001,0.0001,0.5,56,48
1,204,10,0,0.001,0.0001,0.5,110,94
1,304,10,0,0.001,0.0001,0.5,156,148
1,404,10,0,0.001,0.0001,0.5,202,202
1,504,10,0,0.001,0.0001,0.5,251,253
1,604,10,0,0.001,0.0001,0.5,301,303
1,704,10,0,0.001,0.0001,0.5,358,346
1,804,10,0,0.001,0.0001,0.5,405,399
1,904,10,0,0.001,0.0001,0.5,459,445
1,1004,10,0,0.001,0.0001,0.5,504,500
1,1104,10,0,0.001,0.0001,0.5,551,553
1,1204,10,0,0.001,0.0001,0.5,595,609
1,1304,10,0,0.001,0.0001,0.5,640,664
1,1404,10,0,0.001,0.0001,0.5,698,706
1,1504,10,0,0.001,0.0001,0.5,747,757
1,1604,10,0,0.001,0.0001,0.5,802,802
1,1704,10,0,0.001,0.0001,0.5,852,852
1,1804,10,0,0.001,0.0001,0.5,896,908
1,1904,10,0,0.001,0.0001,0.5,952,952
2,0,10,0,0.001,0.0001,0.494,0,0
2,104,10,0,0.001,0.0001,0.494,56,48
2,204,10,0,0.001,0.0001,0.492,103,101
2,304,10,0,0.001,0.0001,0.49,141,163
2,404,10,0,0.001,0.0001,0.494,185,219
2,504,10,0,0.001,0.0001,0.486,239,265
2,604,10,0,0.001,0.0001,0.484,297,307
2,704,10,0,0.001,0.0001,0.48,346,358
2,804,10,0,0.001,0.0001,0.476,397,407
2,904,10,0,0.001,0.0001,0.476,449,455
2,1004,10,0,0.001,0.0001,0.476,497,507
2,1104,10,0,0.001,0.0001,0.47,547,557
2,1204,10,0,0.001,0.0001,0.466,607,597
2,1304,10,0,0.001,0.0001,0.474,657,647
2,1404,10,0,0.001,0.0001,0.468,711,693
2,1504,10,0,0.001,0.0001,0.47,758,746
2,1604,10,0,0.001,0.0001,0.478,808,796
2,1704,10,0,0.001,0.0001,0.48,861,843
2,1804,10,0,0.001,0.0001,0.476,909,895
2,1904,10,0,0.001,0.0001,0.484,952,952
3,0,10,0,0.001,0.0001,0.492,0,0
3,104,10,0,0.001,0.0001,0.492,51,53
3,204,10,0,0.001,0.0001,0.494,107,97
3,304,10,0,0.001,0.0001,0.496,166,138
3,404,10,0,0.001,0.0001,0.496,213,191
3,504,10,0,0.001,0.0001,0.496,258,246
3,604,10,0,0.001,0.0001,0.496,307,297
3,704,10,0,0.001,0.0001,0.496,363,341
3,804,10,0,0.001,0.0001,0.494,413,391
3,904,10,0,0.001,0.0001,0.492,457,447
3,1004,10,0,0.001,0.0001,0.494,505,499
3,1104,10,0,0.001,0.0001,0.494,551,553
3,1204,10,0,0.001,0.0001,0.5,601,603
3,1304,10,0,0.001,0.0001,0.496,646,658
3,1404,10,0,0.001,0.0001,0.498,704,700
3,1504,10,0,0.001,0.0001,0.494,746,758
3,1604,10,0,0.001,0.0001,0.498,802,802
3,1704,10,0,0.001,0.0001,0.496,849,855
3,1804,10,0,0.001,0.0001,0.496,903,901
3,1904,10,0,0.001,0.0001,0.496,952,952
4,0,10,0,0.001,0.0001,0.5,0,0
4,104,10,0,0.001,0.0001,0.5,62,42
4,204,10,0,0.001,0.0001,0.498,112,92
4,304,10,0,0.001,0.0001,0.498,163,141
4,404,10,0,0.001,0.0001,0.498,214,190
4,504,10,0,0.001,0.0001,0.496,267,237
4,604,10,0,0.001,0.0001,0.494,324,280
4,704,10,0,0.001,0.0001,0.5,361,343
4,804,10,0,0.001,0.0001,0.502,416,388
4,904,10,0,0.001,0.0001,0.5,468,436
4,1004,10,0,0.001,0.0001,0.49,515,489
4,1104,10,0,0.001,0.0001,0.496,565,539
4,1204,10,0,0.001,0.0001,0.496,610,594
4,1304,10,0,0.001,0.0001,0.498,661,643
4,1404,10,0,0.001,0.0001,0.498,713,691
4,1504,10,0,0.001,0.0001,0.492,759,745
4,1604,10,0,0.001,0.0001,0.494,812,792
4,1704,10,0,0.001,0.0001,0.492,859,845
4,1804,10,0,0.001,0.0001,0.496,911,893
4,1904,10,0,0.001,0.0001,0.498,952,952
5,0,10,0,0.001,0.0001,0.542,0,0
5,104,10,0,0.001,0.0001,0.542,46,58
5,204,10,0,0.001,0.0001,0.54,98,106
5,304,10,0,0.001,0.0001,0.538,154,150
5,404,10,0,0.001,0.0001,0.54,200,204
5,504,10,0,0.001,0.0001,0.542,248,256
5,604,10,0,0.001,0.0001,0.54,299,305
5,704,10,0,0.001,0.0001,0.542,338,366
5,804,10,0,0.001,0.0001,0.534,388,416
5,904,10,0,0.001,0.0001,0.528,435,469
5,1004,10,0,0.001,0.0001,0.524,495,509
5,1104,10,0,0.001,0.0001,0.53,552,552
5,1204,10,0,0.001,0.0001,0.526,605,599
5,1304,10,0,0.001,0.0001,0.53,653,651
5,1404,10,0,0.001,0.0001,0.53,707,697
5,1504,10,0,0.001,0.0001,0.538,753,751
5,1604,10,0,0.001,0.0001,0.532,807,797
5,1704,10,0,0.001,0.0001,0.516,862,842
5,1804,10,0,0.001,0.0001,0.516,906,898
5,1904,10,0,0.001,0.0001,0.53,952,952
6,0,10,0,0.001,0.0001,0.5,0,0
6,104,10,0,0.001,0.0001,0.5,51,53
6,204,10,0,0.001,0.0001,0.5,98,106
6,304,10,0,0.001,0.0001,0.5,151,153
6,404,10,0,0.001,0.0001,0.5,200,204
6,504,10,0,0.001,0.0001,0.5,256,248
6,604,10,0,0.001,0.0001,0.5,295,309
6,704,10,0,0.001,0.0001,0.5,343,361
6,804,10,0,0.001,0.0001,0.5,387,417
6,904,10,0,0.001,0.0001,0.5,442,462
6,1004,10,0,0.001,0.0001,0.5,488,516
6,1104,10,0,0.001,0.0001,0.5,542,562
6,1204,10,0,0.001,0.0001,0.5,594,610
6,1304,10,0,0.001,0.0001,0.5,654,650
6,1404,10,0,0.001,0.0001,0.5,705,699
6,1504,10,0,0.001,0.0001,0.5,758,746
6,1604,10,0,0.001,0.0001,0.5,807,797
6,1704,10,0,0.001,0.0001,0.5,852,852
6,1804,10,0,0.001,0.0001,0.5,904,900
6,1904,10,0,0.001,0.0001,0.5,952,952
7,0,10,0,0.001,0.0001,0.486,0,0
7,104,10,0,0.001,0.0001,0.486,51,53
7,204,10,0,0.001,0.0001,0.488,103,101
7,304,10,0,0.001,0.0001,0.486,156,148
7,404,10,0,0.001,0.0001,0.486,207,197
7,504,10,0,0.001,0.0001,0.486,257,247
7,604,10,0,0.001,0.0001,0.482,314,290
7,704,10,0,0.001,0.0001,0.484,359,345
7,804,10,0,0.001,0.0001,0.486,407,397
7,904,10,0,0.001,0.0001,0.484,457,447
7,1004,10,0,0.001,0.0001,0.484,513,491
7,1104,10,0,0.001,0.0001,0.484,559,545
7,1204,10,0,0.001,0.0001,0.488,613,591
7,1304,10,0,0.001,0.0001,0.488,663,641
7,1404,10,0,0.001,0.0001,0.488,719,685
7,1504,10,0,0.001,0.0001,0.482,763,741
7,1604,10,0,0.001,0.0001,0.482,814,790
7,1704,10,0,0.001,0.0001,0.482,865,839
7,1804,10,0,0.001,0.0001,0.484,915,889
7,1904,10,0,0.001,0.0001,0.486,952,952
8,0,10,0,0.001,0.0001,0.502,0,0
8,104,10,0,0.001,0.0001,0.502,53,51
8,204,10,0,0.001,0.0001,0.502,100,104
8,304,10,0,0.001,0.0001,0.502,149,155
8,404,10,0,0.001,0.0001,0.502,198,206
8,504,10,0,0.001,0.0001,0.5,244,260
8,604,10,0,0.001,0.0001,0.5,290,314
8,704,10,0,0.001,0.0001,0.502,347,357
8,804,10,0,0.001,0.0001,0.502,394,410
8,904,10,0,0.001,0.0001,0.496,447,457
8,1004,10,0,0.001,0.0001,0.5,499,505
8,1104,10,0,0.001,0.0001,0.502,548,556
8,1204,10,0,0.001,0.0001,0.504,596,608
8,1304,10,0,0.001,0.0001,0.506,637,667
8,1404,10,0,0.001,0.0001,0.508,691,713
8,1504,10,0,0.001,0.0001,0.506,748,756
8,1604,10,0,0.001,0.0001,0.508,793,811
8,1704,10,0,0.001,0.0001,0.508,843,861
8,1804,10,0,0.001,0.0001,0.502,895,909
8,1904,10,0,0.001,0.0001,0.5,952,952
9,0,10,0,0.001,0.0001,0.492,0,0
9,104,10,0,0.001,0.0001,0.492,56,48
9,204,10,0,0.001,0.0001,0.492,101,103
9,304,10,0,0.001,0.0001,0.49,154,150
9,404,10,0,0.001,0.0001,0.49,208,196
9,504,10,0,0.001,0.0001,0.492,258,246
9,604,10,0,0.001,0.0001,0.488,302,302
9,704,10,0,0.001,0.0001,0.488,357,347
9,804,10,0,0.001,0.0001,0.49,403,401
9,904,10,0,0.001,0.0001,0.488,456,448
9,1004,10,0,0.001,0.0001,0.486,500,504
9,1104,10,0,0.001,0.0001,0.488,541,563
9,1204,10,0,0.001,0.0001,0.504,588,616
9,1304,10,0,0.001,0.0001,0.502,644,660
9,1404,10,0,0.001,0.0001,0.504,701,703
9,1504,10,0,0.001,0.0001,0.506,756,748
9,1604,10,0,0.001,0.0001,0.502,803,801
9,1704,10,0,0.001,0.0001,0.5,853,851
9,1804,10,0,0.001,0.0001,0.502,904,900
9,1904,10,0,0.001,0.0001,0.502,952,952
10,0,10,0,0.001,0.0001,0.5,0,0
10,104,10,0,0.001,0.0001,0.5,46,58
10,204,10,0,0.001,0.0001,0.5,98,106
10,304,10,0,0.001,0.0001,0.5,159,145
10,404,10,0,0.001,0.0001,0.5,216,188
10,504,10,0,0.001,0.0001,0.5,266,238
10,604,10,0,0.001,0.0001,0.5,315,289
10,704,10,0,0.001,0.0001,0.5,370,334
10,804,10,0,0.001,0.0001,0.5,422,382
10,904,10,0,0.001,0.0001,0.5,467,437
10,1004,10,0,0.001,0.0001,0.5,516,488
10,1104,10,0,0.001,0.0001,0.5,569,535
10,1204,10,0,0.001,0.0001,0.5,624,580
10,1304,10,0,0.001,0.0001,0.5,669,635
10,1404,10,0,0.001,0.0001,0.5,714,690
10,1504,10,0,0.001,0.0001,0.5,762,742
10,1604,10,0,0.001,0.0001,0.5,805,799
10,1704,10,0,0.001,0.0001,0.5,857,847
10,1804,10,0,0.001,0.0001,0.5,901,903
10,1904,10,0,0.001,0.0001,0.5,952,952
11,0,10,0,0.001,0.0001,0.5,0,0
11,104,10,0,0.001,0.0001,0.5,53,51
11,204,10,0,0.001,0.0001,0.5,98,106
11,304,10,0,0.001,0.0001,0.5,146,158
11,404,10,0,0.001,0.0001,0.5,193,211
11,504,10,0,0.001,0.0001,0.5,246,258
11,604,10,0,0.001,0.0001,0.5,282,322
11,704,10,0,0.001,0.0001,0.5,326,378
11,804,10,0,0.001,0.0001,0.5,380,424
11,904,10,0,0.001,0.0001,0.5,431,473
11,1004,10,0,0.001,0.0001,0.5,484,520
11,1104,10,0,0.001,0.0001,0.5,534,570
11,1204,10,0,0.001,0.0001,0.5,589,615
11,1304,10,0,0.001,0.0001,0.5,638,666
11,1404,10,0,0.001,0.0001,0.5,683,721
11,1504,10,0,0.001,0.0001,0.498,735,769
11,1604,10,0,0.001,0.0001,0.498,785,819
11,1704,10,0,0.001,0.0001,0.496,841,863
11,1804,10,0,0.001,0.0001,0.496,898,906
11,1904,10,0,0.001,0.0001,0.492,952,952
12,0,10,0,0.001,0.0001,0.5,0,0
12,104,10,0,0.001,0.0001,0.5,51,53
12,204,10,0,0.001,0.0001,0.5,93,111
12,304,10,0,0.001,0.0001,0.5,135,169
12,404,10,0,0.001,0.0001,0.5,185,219
12,504,10,0,0.001,0.0001,0.5,229,275
12,604,10,0,0.001,0.0001,0.5,282,322
12,704,10,0,0.001,0.0001,0.5,330,374
12,804,10,0,0.001,0.0001,0.5,387,417
12,904,10,0,0.001,0.0001,0.5,437,467
12,1004,10,0,0.001,0.0001,0.5,489,515
12,1104,10,0,0.001,0.0001,0.5,536,568
12,1204,10,0,0.001,0.0001,0.5,588,616
12,1304,10,0,0.001,0.0001,0.5,644,660
12,1404,10,0,0.001,0.0001,0.5,693,711
12,1504,10,0,0.001,0.0001,0.5,744,760
12,1604,10,0,0.001,0.0001,0.5,793,811
12,1704,10,0,0.001,0.0001,0.5,840,864
12,1804,10,0,0.001,0.0001,0.5,893,911
12,1904,10,0,0.001,0.0001,0.5,952,952
13,0,10,0,0.001,0.0001,0.502,0,0
13,104,10,0,0.001,0.0001,0.502,56,48
13,204,10,0,0.001,0.0001,0.5,97,107
13,304,10,0,0.001,0.0001,0.5,151,153
13,404,10,0,0.001,0.0001,0.5,203,201
13,504,10,0,0.001,0.0001,0.494,247,257
13,604,10,0,0.001,0.0001,0.5,296,308
13,704,10,0,0.001,0.0001,0.496,348,356
13,804,10,0,0.001,0.0001,0.496,398,406
13,904,10,0,0.001,0.0001,0.494,454,450
13,1004,10,0,0.001,0.0001,0.498,512,492
13,1104,10,0,0.001,0.0001,0.494,562,542
13,1204,10,0,0.001,0.0001,0.5,612,592
13,1304,10,0,0.001,0.0001,0.496,670,634
13,1404,10,0,0.001,0.0001,0.496,720,684
13,1504,10,0,0.001,0.0001,0.496,773,731
13,1604,10,0,0.001,0.0001,0.49,822,782
13,1704,10,0,0.001,0.0001,0.498,866,838
13,1804,10,0,0.001,0.0001,0.5,907,897
13,1904,10,0,0.001,0.0001,0.492,952,952
14,0,10,0,0.001,0.0001,0.5,0,0
14,104,10,0,0.001,0.0001,0.5,58,46
14,204,10,0,0.001,0.0001,0.5,102,102
14,304,10,0,0.001,0.0001,0.5,158,146
14,404,10,0,0.001,0.0001,0.5,208,196
14,504,10,0,0.001,0.0001,0.5,259,245
14,604,10,0,0.001,0.0001,0.5,309,295
14,704,10,0,0.001,0.0001,0.5,352,352
14,804,10,0,0.001,0.0001,0.5,400,404
14,904,10,0,0.001,0.0001,0.5,448,456
14,1004,10,0,0.001,0.0001,0.5,498,506
14,1104,10,0,0.001,0.0001,0.5,538,566
14,1204,10,0,0.001,0.0001,0.5,598,606
14,1304,10,0,0.001,0.0001,0.5,647,657
14,1404,10,0,0.001,0.0001,0.5,689,715
14,1504,10,0,0.001,0.0001,0.5,742,762
14,1604,10,0,0.001,0.0001,0.5,794,810
14,1704,10,0,0.001,0.0001,0.5,852,852
14,1804,10,0,0.001,0.0001,0.5,899,905
14,1904,10,0,0.001,0.0001,0.5,952,952
15,0,10,0,0.001,0.0001,0.502,0,0
15,104,10,0,0.001,0.0001,0.502,59,45
15,204,10,0,0.001,0.0001,0.502,110,94
15,304,10,0,0.001,0.0001,0.502,164,140
15,404,10,0,0.001,0.0001,0.502,214,190
15,504,10,0,0.001,0.0001,0.502,261,243
15,604,10,0,0.001,0.0001,0.502,318,286
15,704,10,0,0.001,0.0001,0.502,369,335
15,804,10,0,0.001,0.0001,0.502,414,390
15,904,10,0,0.001,0.0001,0.502,468,436
15,1004,10,0,0.001,0.0001,0.502,511,493
15,1104,10,0,0.001,0.0001,0.502,563,541
15,1204,10,0,0.001,0.0001,0.502,608,596
15,1304,10,0,0.001,0.0001,0.502,655,649
15,1404,10,0,0.001,0.0001,0.502,707,697
15,1504,10,0,0.001,0.0001,0.504,751,753
15,1604,10,0,0.001,0.0001,0.504,804,800
15,1704,10,0,0.001,0.0001,0.502,856,848
15,1804,10,0,0.001,0.0001,0.502,911,893
15,1904,10,0,0.001,0.0001,0.508,952,952
16,0,10,0,0.001,0.0001,0.5,0,0
16,104,10,0,0.001,0.0001,0.5,49,55
16,204,10,0,0.001,0.0001,0.5,103,101
16,304,10,0,0.001,0.0001,0.5,149,155
16,404,10,0,0.001,0.0001,0.5,205,199
16,504,10,0,0.001,0.0001,0.5,262,242
16,604,10,0,0.001,0.0001,0.5,309,295
16,704,10,0,0.001,0.0001,0.5,358,346
16,804,10,0,0.001,0.0001,0.5,408,396
16,904,10,0,0.001,0.0001,0.5,454,450
16,1004,10,0,0.001,0.0001,0.5,505,499
16,1104,10,0,0.001,0.0001,0.5,552,552
16,1204,10,0,0.001,0.0001,0.502,604,600
16,1304,10,0,0.001,0.0001,0.502,652,652
16,1404,10,0,0.001,0.0001,0.502,704,700
16,1504,10,0,0.001,0.0001,0.504,755,749
16,1604,10,0,0.001,0.0001,0.502,807,797
16,1704,10,0,0.001,0.0001,0.502,855,849
16,1804,10,0,0.001,0.0001,0.498,902,902
16,1904,10,0,0.001,0.0001,0.5,952,952
17,0,10,0,0.001,0.0001,0.478,0,0
17,104,10,0,0.001,0.0001,0.478,56,48
17,204,10,0,0.001,0.0001,0.478,103,101
17,304,10,0,0.001,0.0001,0.48,152,152
17,404,10,0,0.001,0.0001,0.482,204,200
17,504,10,0,0.001,0.0001,0.48,250,254
17,604,10,0,0.001,0.0001,0.482,304,300
17,704,10,0,0.001,0.0001,0.484,359,345
17,804,10,0,0.001,0.0001,0.48,410,394
17,904,10,0,0.001,0.0001,0.482,457,447
17,1004,10,0,0.001,0.0001,0.482,514,490
17,1104,10,0,0.001,0.0001,0.48,569,535
17,1204,10,0,0.001,0.0001,0.474,617,587
17,1304,10,0,0.001,0.0001,0.478,665,639
17,1404,10,0,0.001,0.0001,0.478,711,693
17,1504,10,0,0.001,0.0001,0.474,763,741
17,1604,10,0,0.001,0.0001,0.476,809,795
17,1704,10,0,0.001,0.0001,0.474,856,848
17,1804,10,0,0.001,0.0001,0.472,901,903
17,1904,10,0,0.001,0.0001,0.476,952,952
18,0,10,0,0.001,0.0001,0.484,0,0
18,104,10,0,0.001,0.0001,0.488,48,56
18,204,10,0,0.001,0.0001,0.484,97,107
18,304,10,0,0.001,0.0001,0.486,143,161
18,404,10,0,0.001,0.0001,0.482,190,214
18,504,10,0,0.001,0.0001,0.48,230,274
18,604,10,0,0.001,0.0001,0.492,281,323
18,704,10,0,0.001,0.0001,0.496,331,373
18,804,10,0,0.001,0.0001,0.494,382,422
18,904,10,0,0.001,0.0001,0.5,436,468
18,1004,10,0,0.001,0.0001,0.492,492,512
18,1104,10,0,0.001,0.0001,0.502,550,554
18,1204,10,0,0.001,0.0001,0.492,596,608
18,1304,10,0,0.001,0.0001,0.492,644,660
18,1404,10,0,0.001,0.0001,0.492,696,708
18,1504,10,0,0.001,0.0001,0.494,746,758
18,1604,10,0,0.001,0.0001,0.496,797,807
18,1704,10,0,0.001,0.0001,0.496,849,855
18,1804,10,0,0.001,0.0001,0.498,909,895
18,1904,10,0,0.001,0.0001,0.502,952,952
19,0,10,0,0.001,0.0001,0.5,0,0
19,104,10,0,0.001,0.0001,0.5,50,54
19,204,10,0,0.001,0.0001,0.5,105,99
19,304,10,0,0.001,0.0001,0.498,151,153
19,404,10,0,0.001,0.0001,0.496,196,208
19,504,10,0,0.001,0.0001,0.496,235,269
19,604,10,0,0.001,0.0001,0.504,288,316
19,704,10,0,0.001,0.0001,0.508,339,365
19,804,10,0,0.001,0.0001,0.502,399,405
19,904,10,0,0.001,0.0001,0.5,448,456
19,1004,10,0,0.001,0.0001,0.496,496,508
19,1104,10,0,0.001,0.0001,0.49,549,555
19,1204,10,0,0.001,0.0001,0.498,598,606
19,1304,10,0,0.001,0.0001,0.498,650,654
19,1404,10,0,0.001,0.0001,0.502,699,705
19,1504,10,0,0.001,0.0001,0.502,750,754
19,1604,10,0,0.001,0.0001,0.504,808,796
19,1704,10,0,0.001,0.0001,0.502,853,851
19,1804,10,0,0.001,0.0001,0.496,905,899
19,1904,10,0,0.001,0.0001,0.508,952,952
20,0,10,0,0.001,0.0001,0.498,0,0
20,104,10,0,0.001,0.0001,0.5,60,44
20,204,10,0,0.001,0.0001,0.502,110,94
20,304,10,0,0.001,0.0001,0.502,157,147
20,404,10,0,0.001,0.0001,0.502,214,190
20,504,10,0,0.001,0.0001,0.502,259,245
20,604,10,0,0.001,0.0001,0.502,304,300
20,704,10,0,0.001,0.0001,0.502,360,344
20,804,10,0,0.001,0.0001,0.502,408,396
20,904,10,0,0.001,0.0001,0.502,467,437
20,1004,10,0,0.001,0.0001,0.5,512,492
20,1104,10,0,0.001,0.0001,0.5,570,534
20,1204,10,0,0.001,0.0001,0.504,623,581
20,1304,10,0,0.001,0.0001,0.5,663,641
20,1404,10,0,0.001,0.0001,0.502,711,693
20,1504,10,0,0.001,0.0001,0.504,764,740
20,1604,10,0,0.001,0.0001,0.504,811,793
20,1704,10,0,0.001,0.0001,0.5,860,844
20,1804,10,0,0.001,0.0001,0.498,912,892
20,1904,10,0,0.001,0.0001,0.496,952,952
1,0,10,0,0.001,0.001,0.526,0,0
1,104,10,0,0.001,0.001,0.526,40,64
1,204,10,0,0.001,0.001,0.526,88,116
1,304,10,0,0.001,0.001,0.53,134,170
1,404,10,0,0.001,0.001,0.53,191,213
1,504,10,0,0.001,0.001,0.536,239,265
1,604,10,0,0.001,0.001,0.526,285,319
1,704,10,0,0.001,0.001,0.534,344,360
1,804,10,0,0.001,0.001,0.528,400,404
1,904,10,0,0.001,0.001,0.53,444,460
1,1004,10,0,0.001,0.001,0.538,491,513
1,1104,10,0,0.001,0.001,0.554,540,564
1,1204,10,0,0.001,0.001,0.568,595,609
1,1304,10,0,0.001,0.001,0.578,646,658
1,1404,10,0,0.001,0.001,0.578,697,707
1,1504,10,0,0.001,0.001,0.594,750,754
1,1604,10,0,0.001,0.001,0.598,797,807
1,1704,10,0,0.001,0.001,0.616,847,857
1,1804,10,0,0.001,0.001,0.604,901,903
1,1904,10,0,0.001,0.001,0.614,952,952
2,0,10,0,0.001,0.001,0.5,0,0
2,104,10,0,0.001,0.001,0.506,55,49
2,204,10,0,0.001,0.001,0.51,92,112
2,304,10,0,0.001,0.001,0.514,142,162
2,404,10,0,0.001,0.001,0.516,184,220
2,504,10,0,0.001,0.001,0.512,236,268
2,604,10,0,0.001,0.001,0.524,278,326
2,704,10,0,0.001,0.001,0.526,328,376
2,804,10,0,0.001,0.001,0.516,383,421
2,904,10,0,0.001,0.001,0.53,436,468
2,1004,10,0,0.001,0.001,0.514,484,520
2,1104,10,0,0.001,0.001,0.51,535,569
2,1204,10,0,0.001,0.001,0.516,584,620
2,1304,10,0,0.001,0.001,0.528,638,666
2,1404,10,0,0.001,0.001,0.53,682,722
2,1504,10,0,0.001,0.001,0.526,733,771
2,1604,10,0,0.001,0.001,0.534,794,810
2,1704,10,0,0.001,0.001,0.548,845,859
2,1804,10,0,0.001,0.001,0.552,894,910
2,1904,10,0,0.001,0.001,0.538,952,952
3,0,10,0,0.001,0.001,0.538,0,0
3,104,10,0,0.001,0.001,0.54,52,52
3,204,10,0,0.001,0.001,0.536,97,107
3,304,10,0,0.001,0.001,0.532,143,161
3,404,10,0,0.001,0.001,0.52,196,208
3,504,10,0,0.001,0.001,0.518,243,261
3,604,10,0,0.001,0.001,0.504,288,316
3,704,10,0,0.001,0.001,0.508,343,361
3,804,10,0,0.001,0.001,0.514,391,413
3,904,10,0,0.001,0.001,0.522,435,469
3,1004,10,0,0.001,0.001,0.516,481,523
3,1104,10,0,0.001,0.001,0.518,530,574
3,1204,10,0,0.001,0.001,0.514,583,621
3,1304,10,0,0.001,0.001,0.516,639,665
3,1404,10,0,0.001,0.001,0.514,696,708
3,1504,10,0,0.001,0.001,0.518,753,751
3,1604,10,0,0.001,0.001,0.526,804,800
3,1704,10,0,0.001,0.001,0.538,861,843
3,1804,10,0,0.001,0.001,0.55,909,895
3,1904,10,0,0.001,0.001,0.57,952,952
4,0,10,0,0.001,0.001,0.574,0,0
4,104,10,0,0.001,0.001,0.572,52,52
4,204,10,0,0.001,0.001,0.57,105,99
4,304,10,0,0.001,0.001,0.57,160,144
4,404,10,0,0.001,0.001,0.588,212,192
4,504,10,0,0.001,0.001,0.568,255,249
4,604,10,0,0.001,0.001,0.55,300,304
4,704,10,0,0.001,0.001,0.566,345,359
4,804,10,0,0.001,0.001,0.562,406,398
4,904,10,0,0.001,0.001,0.58,444,460
4,1004,10,0,0.001,0.001,0.584,491,513
4,1104,10,0,0.001,0.001,0.59,547,557
4,1204,10,0,0.001,0.001,0.61,598,606
4,1304,10,0,0.001,0.001,0.624,650,654
4,1404,10,0,0.001,0.001,0.65,697,707
4,1504,10,0,0.001,0.001,0.664,745,759
4,1604,10,0,0.001,0.001,0.682,799,805
4,1704,10,0,0.001,0.001,0.698,844,860
4,1804,10,0,0.001,0.001,0.726,898,906
4,1904,10,0,0.001,0.001,0.742,952,952
5,0,10,0,0.001,0.001,0.52,0,0
5,104,10,0,0.001,0.001,0.52,49,55
5,204,10,0,0.001,0.001,0.52,86,118
5,304,10,0,0.001,0.001,0.524,137,167
5,404,10,0,0.001,0.001,0.528,189,215
5,504,10,0,0.001,0.001,0.518,244,260
5,604,10,0,0.001,0.001,0.532,292,312
5,704,10,0,0.001,0.001,0.516,348,356
5,804,10,0,0.001,0.001,0.526,395,409
5,904,10,0,0.001,0.001,0.516,443,461
5,1004,10,0,0.001,0.001,0.526,481,523
5,1104,10,0,0.001,0.001,0.54,529,575
5,1204,10,0,0.001,0.001,0.55,584,620
5,1304,10,0,0.001,0.001,0.554,632,672
5,1404,10,0,0.001,0.001,0.554,690,714
5,1504,10,0,0.001,0.001,0.566,735,769
5,1604,10,0,0.001,0.001,0.584,789,815
5,1704,10,0,0.001,0.001,0.596,840,864
5,1804,10,0,0.001,0.001,0.594,893,911
5,1904,10,0,0.001,0.001,0.62,952,952
6,0,10,0,0.001,0.001,0.512,0,0
6,104,10,0,0.001,0.001,0.512,48,56
6,204,10,0,0.001,0.001,0.512,97,107
6,304,10,0,0.001,0.001,0.51,156,148
6,404,10,0,0.001,0.001,0.532,212,192
6,504,10,0,0.001,0.001,0.528,267,237
6,604,10,0,0.001,0.001,0.552,314,290
6,704,10,0,0.001,0.001,0.554,354,350
6,804,10,0,0.001,0.001,0.55,397,407
6,904,10,0,0.001,0.001,0.55,448,456
6,1004,10,0,0.001,0.001,0.54,498,506
6,1104,10,0,0.001,0.001,0.536,549,555
6,1204,10,0,0.001,0.001,0.526,592,612
6,1304,10,0,0.001,0.001,0.532,640,664
6,1404,10,0,0.001,0.001,0.524,692,712
6,1504,10,0,0.001,0.001,0.522,745,759
6,1604,10,0,0.001,0.001,0.528,797,807
6,1704,10,0,0.001,0.001,0.528,852,852
6,1804,10,0,0.001,0.001,0.534,899,905
6,1904,10,0,0.001,0.001,0.538,952,952
7,0,10,0,0.001,0.001,0.534,0,0
7,104,10,0,0.001,0.001,0.534,51,53
7,204,10,0,0.001,0.001,0.53,98,106
7,304,10,0,0.001,0.001,0.528,145,159
7,404,10,0,0.001,0.001,0.506,184,220
7,504,10,0,0.001,0.001,0.52,229,275
7,604,10,0,0.001,0.001,0.522,285,319
7,704,10,0,0.001,0.001,0.528,333,371
7,804,10,0,0.001,0.001,0.536,378,426
7,904,10,0,0.001,0.001,0.542,427,477
7,1004,10,0,0.001,0.001,0.528,479,525
7,1104,10,0,0.001,0.001,0.528,535,569
7,1204,10,0,0.001,0.001,0.526,585,619
7,1304,10,0,0.001,0.001,0.53,639,665
7,1404,10,0,0.001,0.001,0.542,700,704
7,1504,10,0,0.001,0.001,0.544,750,754
7,1604,10,0,0.001,0.001,0.546,798,806
7,1704,10,0,0.001,0.001,0.56,850,854
7,1804,10,0,0.001,0.001,0.57,899,905
7,1904,10,0,0.001,0.001,0.586,952,952
8,0,10,0,0.001,0.001,0.55,0,0
8,104,10,0,0.001,0.001,0.55,61,43
8,204,10,0,0.001,0.001,0.546,109,95
8,304,10,0,0.001,0.001,0.554,157,147
8,404,10,0,0.001,0.001,0.574,209,195
8,504,10,0,0.001,0.001,0.584,261,243
8,604,10,0,0.001,0.001,0.56,317,287
8,704,10,0,0.001,0.001,0.562,363,341
8,804,10,0,0.001,0.001,0.56,403,401
8,904,10,0,0.001,0.001,0.582,453,451
8,1004,10,0,0.001,0.001,0.602,513,491
8,1104,10,0,0.001,0.001,0.626,567,537
8,1204,10,0,0.001,0.001,0.652,614,590
8,1304,10,0,0.001,0.001,0.68,658,646
8,1404,10,0,0.001,0.001,0.702,708,696
8,1504,10,0,0.001,0.001,0.732,757,747
8,1604,10,0,0.001,0.001,0.76,809,795
8,1704,10,0,0.001,0.001,0.788,855,849
8,1804,10,0,0.001,0.001,0.828,900,904
8,1904,10,0,0.001,0.001,0.84,952,952
9,0,10,0,0.001,0.001,0.574,0,0
9,104,10,0,0.001,0.001,0.578,53,51
9,204,10,0,0.001,0.001,0.586,105,99
9,304,10,0,0.001,0.001,0.602,156,148
9,404,10,0,0.001,0.001,0.6,203,201
9,504,10,0,0.001,0.001,0.596,249,255
9,604,10,0,0.001,0.001,0.598,294,310
9,704,10,0,0.001,0.001,0.602,340,364
9,804,10,0,0.001,0.001,0.606,387,417
9,904,10,0,0.001,0.001,0.63,441,463
9,1004,10,0,0.001,0.001,0.638,492,512
9,1104,10,0,0.001,0.001,0.64,551,553
9,1204,10,0,0.001,0.001,0.644,597,607
9,1304,10,0,0.001,0.001,0.642,647,657
9,1404,10,0,0.001,0.001,0.662,699,705
9,1504,10,0,0.001,0.001,0.664,753,751
9,1604,10,0,0.001,0.001,0.668,801,803
9,1704,10,0,0.001,0.001,0.674,850,854
9,1804,10,0,0.001,0.001,0.688,903,901
9,1904,10,0,0.001,0.001,0.69,952,952
10,0,10,0,0.001,0.001,0.58,0,0
10,104,10,0,0.001,0.001,0.58,54,50
10,204,10,0,0.001,0.001,0.586,107,97
10,304,10,0,0.001,0.001,0.6,158,146
10,404,10,0,0.001,0.001,0.606,210,194
10,504,10,0,0.001,0.001,0.584,265,239
10,604,10,0,0.001,0.001,0.576,313,291
10,704,10,0,0.001,0.001,0.582,364,340
10,804,10,0,0.001,0.001,0.582,417,387
10,904,10,0,0.001,0.001,0.598,460,444
10,1004,10,0,0.001,0.001,0.618,505,499
10,1104,10,0,0.001,0.001,0.628,559,545
10,1204,10,0,0.001,0.001,0.636,611,593
10,1304,10,0,0.001,0.001,0.628,664,640
10,1404,10,0,0.001,0.001,0.646,711,693
10,1504,10,0,0.001,0.001,0.664,759,745
10,1604,10,0,0.001,0.001,0.684,801,803
10,1704,10,0,0.001,0.001,0.71,852,852
10,1804,10,0,0.001,0.001,0.712,909,895
10,1904,10,0,0.001,0.001,0.748,952,952
11,0,10,0,0.001,0.001,0.584,0,0
11,104,10,0,0.001,0.001,0.588,56,48
11,204,10,0,0.001,0.001,0.58,110,94
11,304,10,0,0.001,0.001,0.592,163,141
11,404,10,0,0.001,0.001,0.61,215,189
11,504,10,0,0.001,0.001,0.6,265,239
11,604,10,0,0.001,0.001,0.584,309,295
11,704,10,0,0.001,0.001,0.578,356,348
11,804,10,0,0.001,0.001,0.61,408,396
11,904,10,0,0.001,0.001,0.64,455,449
11,1004,10,0,0.001,0.001,0.634,500,504
11,1104,10,0,0.001,0.001,0.642,552,552
11,1204,10,0,0.001,0.001,0.65,598,606
11,1304,10,0,0.001,0.001,0.662,642,662
11,1404,10,0,0.001,0.001,0.664,694,710
11,1504,10,0,0.001,0.001,0.67,750,754
11,1604,10,0,0.001,0.001,0.688,802,802
11,1704,10,0,0.001,0.001,0.682,851,853
11,1804,10,0,0.001,0.001,0.714,900,904
11,1904,10,0,0.001,0.001,0.722,952,952
12,0,10,0,0.001,0.001,0.608,0,0
12,104,10,0,0.001,0.001,0.61,50,54
12,204,10,0,0.001,0.001,0.61,100,104
12,304,10,0,0.001,0.001,0.614,154,150
12,404,10,0,0.001,0.001,0.62,194,210
12,504,10,0,0.001,0.001,0.622,253,251
12,604,10,0,0.001,0.001,0.624,297,307
12,704,10,0,0.001,0.001,0.616,358,346
12,804,10,0,0.001,0.001,0.622,406,398
12,904,10,0,0.001,0.001,0.642,458,446
12,1004,10,0,0.001,0.001,0.65,508,496
12,1104,10,0,0.001,0.001,0.664,552,552
12,1204,10,0,0.001,0.001,0.666,605,599
12,1304,10,0,0.001,0.001,0.674,652,652
12,1404,10,0,0.001,0.001,0.688,697,707
12,1504,10,0,0.001,0.001,0.7,750,754
12,1604,10,0,0.001,0.001,0.722,803,801
12,1704,10,0,0.001,0.001,0.738,855,849
12,1804,10,0,0.001,0.001,0.752,904,900
12,1904,10,0,0.001,0.001,0.764,952,952
13,0,10,0,0.001,0.001,0.602,0,0
13,104,10,0,0.001,0.001,0.602,59,45
13,204,10,0,0.001,0.001,0.602,117,87
13,304,10,0,0.001,0.001,0.63,167,137
13,404,10,0,0.001,0.001,0.63,220,184
13,504,10,0,0.001,0.001,0.616,262,242
13,604,10,0,0.001,0.001,0.614,315,289
13,704,10,0,0.001,0.001,0.608,367,337
13,804,10,0,0.001,0.001,0.62,422,382
13,904,10,0,0.001,0.001,0.63,479,425
13,1004,10,0,0.001,0.001,0.64,517,487
13,1104,10,0,0.001,0.001,0.654,564,540
13,1204,10,0,0.001,0.001,0.668,612,592
13,1304,10,0,0.001,0.001,0.672,660,644
13,1404,10,0,0.001,0.001,0.688,705,699
13,1504,10,0,0.001,0.001,0.69,750,754
13,1604,10,0,0.001,0.001,0.704,797,807
13,1704,10,0,0.001,0.001,0.702,845,859
13,1804,10,0,0.001,0.001,0.71,897,907
13,1904,10,0,0.001,0.001,0.716,952,952
14,0,10,0,0.001,0.001,0.55,0,0
14,104,10,0,0.001,0.001,0.55,52,52
14,204,10,0,0.001,0.001,0.554,107,97
14,304,10,0,0.001,0.001,0.55,167,137
14,404,10,0,0.001,0.001,0.57,216,188
14,504,10,0,0.001,0.001,0.572,275,229
14,604,10,0,0.001,0.001,0.588,327,277
14,704,10,0,0.001,0.001,0.57,377,327
14,804,10,0,0.001,0.001,0.57,417,387
14,904,10,0,0.001,0.001,0.59,464,440
14,1004,10,0,0.001,0.001,0.6,511,493
14,1104,10,0,0.001,0.001,0.6,562,542
14,1204,10,0,0.001,0.001,0.61,615,589
14,1304,10,0,0.001,0.001,0.628,662,642
14,1404,10,0,0.001,0.001,0.636,709,695
14,1504,10,0,0.001,0.001,0.664,761,743
14,1604,10,0,0.001,0.001,0.688,807,797
14,1704,10,0,0.001,0.001,0.698,847,857
14,1804,10,0,0.001,0.001,0.704,908,896
14,1904,10,0,0.001,0.001,0.754,952,952
15,0,10,0,0.001,0.001,0.698,0,0
15,104,10,0,0.001,0.001,0.7,48,56
15,204,10,0,0.001,0.001,0.704,98,106
15,304,10,0,0.001,0.001,0.714,141,163
15,404,10,0,0.001,0.001,0.714,196,208
15,504,10,0,0.001,0.001,0.706,242,262
15,604,10,0,0.001,0.001,0.68,296,308
15,704,10,0,0.001,0.001,0.69,341,363
15,804,10,0,0.001,0.001,0.702,383,421
15,904,10,0,0.001,0.001,0.702,438,466
15,1004,10,0,0.001,0.001,0.708,478,526
15,1104,10,0,0.001,0.001,0.716,533,571
15,1204,10,0,0.001,0.001,0.738,573,631
15,1304,10,0,0.001,0.001,0.738,631,673
15,1404,10,0,0.001,0.001,0.74,679,725
15,1504,10,0,0.001,0.001,0.754,734,770
15,1604,10,0,0.001,0.001,0.764,784,820
15,1704,10,0,0.001,0.001,0.77,842,862
15,1804,10,0,0.001,0.001,0.776,891,913
15,1904,10,0,0.001,0.001,0.782,952,952
16,0,10,0,0.001,0.001,0.522,0,0
16,104,10,0,0.001,0.001,0.522,59,45
16,204,10,0,0.001,0.001,0.524,106,98
16,304,10,0,0.001,0.001,0.522,162,142
16,404,10,0,0.001,0.001,0.554,215,189
16,504,10,0,0.001,0.001,0.554,268,236
16,604,10,0,0.001,0.001,0.56,314,290
16,704,10,0,0.001,0.001,0.558,371,333
16,804,10,0,0.001,0.001,0.558,425,379
16,904,10,0,0.001,0.001,0.574,480,424
16,1004,10,0,0.001,0.001,0.558,525,479
16,1104,10,0,0.001,0.001,0.584,569,535
16,1204,10,0,0.001,0.001,0.588,614,590
16,1304,10,0,0.001,0.001,0.6,668,636
16,1404,10,0,0.001,0.001,0.594,719,685
16,1504,10,0,0.001,0.001,0.594,771,733
16,1604,10,0,0.001,0.001,0.606,817,787
16,1704,10,0,0.001,0.001,0.606,869,835
16,1804,10,0,0.001,0.001,0.608,908,896
16,1904,10,0,0.001,0.001,0.61,952,952
17,0,10,0,0.001,0.001,0.53,0,0
17,104,10,0,0.001,0.001,0.532,61,43
17,204,10,0,0.001,0.001,0.542,112,92
17,304,10,0,0.001,0.001,0.548,154,150
17,404,10,0,0.001,0.001,0.548,207,197
17,504,10,0,0.001,0.001,0.558,259,245
17,604,10,0,0.001,0.001,0.548,300,304
17,704,10,0,0.001,0.001,0.548,359,345
17,804,10,0,0.001,0.001,0.56,408,396
17,904,10,0,0.001,0.001,0.574,461,443
17,1004,10,0,0.001,0.001,0.564,500,504
17,1104,10,0,0.001,0.001,0.566,552,552
17,1204,10,0,0.001,0.001,0.58,597,607
17,1304,10,0,0.001,0.001,0.584,650,654
17,1404,10,0,0.001,0.001,0.598,704,700
17,1504,10,0,0.001,0.001,0.606,753,751
17,1604,10,0,0.001,0.001,0.61,802,802
17,1704,10,0,0.001,0.001,0.622,857,847
17,1804,10,0,0.001,0.001,0.642,904,900
17,1904,10,0,0.001,0.001,0.658,952,952
18,0,10,0,0.001,0.001,0.536,0,0
18,104,10,0,0.001,0.001,0.542,57,47
18,204,10,0,0.001,0.001,0.548,101,103
18,304,10,0,0.001,0.001,0.554,155,149
18,404,10,0,0.001,0.001,0.55,197,207
18,504,10,0,0.001,0.001,0.556,243,261
18,604,10,0,0.001,0.001,0.562,296,308
18,704,10,0,0.001,0.001,0.564,354,350
18,804,10,0,0.001,0.001,0.56,409,395
18,904,10,0,0.001,0.001,0.564,457,447
18,1004,10,0,0.001,0.001,0.56,507,497
18,1104,10,0,0.001,0.001,0.55,560,544
18,1204,10,0,0.001,0.001,0.578,605,599
18,1304,10,0,0.001,0.001,0.584,660,644
18,1404,10,0,0.001,0.001,0.588,711,693
18,1504,10,0,0.001,0.001,0.582,763,741
18,1604,10,0,0.001,0.001,0.594,814,790
18,1704,10,0,0.001,0.001,0.596,858,846
18,1804,10,0,0.001,0.001,0.596,903,901
18,1904,10,0,0.001,0.001,0.594,952,952
19,0,10,0,0.001,0.001,0.488,0,0
19,104,10,0,0.001,0.001,0.486,52,52
19,204,10,0,0.001,0.001,0.486,99,105
19,304,10,0,0.001,0.001,0.492,149,155
19,404,10,0,0.001,0.001,0.49,196,208
19,504,10,0,0.001,0.001,0.48,245,259
19,604,10,0,0.001,0.001,0.478,307,297
19,704,10,0,0.001,0.001,0.504,356,348
19,804,10,0,0.001,0.001,0.508,408,396
19,904,10,0,0.001,0.001,0.506,455,449
19,1004,10,0,0.001,0.001,0.49,511,493
19,1104,10,0,0.001,0.001,0.49,562,542
19,1204,10,0,0.001,0.001,0.492,602,602
19,1304,10,0,0.001,0.001,0.488,657,647
19,1404,10,0,0.001,0.001,0.498,711,693
19,1504,10,0,0.001,0.001,0.51,764,740
19,1604,10,0,0.001,0.001,0.516,817,787
19,1704,10,0,0.001,0.001,0.522,863,841
19,1804,10,0,0.001,0.001,0.52,909,895
19,1904,10,0,0.001,0.001,0.514,952,952
20,0,10,0,0.001,0.001,0.524,0,0
20,104,10,0,0.001,0.001,0.526,56,48
20,204,10,0,0.001,0.001,0.524,100,104
20,304,10,0,0.001,0.001,0.534,157,147
20,404,10,0,0.001,0.001,0.536,205,199
20,504,10,0,0.001,0.001,0.522,258,246
20,604,10,0,0.001,0.001,0.532,309,295
20,704,10,0,0.001,0.001,0.528,352,352
20,804,10,0,0.001,0.001,0.546,397,407
20,904,10,0,0.001,0.001,0.546,444,460
20,1004,10,0,0.001,0.001,0.544,490,514
20,1104,10,0,0.001,0.001,0.552,551,553
20,1204,10,0,0.001,0.001,0.566,598,606
20,1304,10,0,0.001,0.001,0.568,643,661
20,1404,10,0,0.001,0.001,0.58,683,721
20,1504,10,0,0.001,0.001,0.594,744,760
20,1604,10,0,0.001,0.001,0.612,795,809
20,1704,10,0,0.001,0.001,0.624,849,855
20,1804,10,0,0.001,0.001,0.632,900,904
20,1904,10,0,0.001,0.001,0.64,952,952
1,0,10,0,0.001,0.01,0.51,0,0
1,104,10,0,0.001,0.01,0.532,46,58
1,204,10,0,0.001,0.01,0.592,95,109
1,304,10,0,0.001,0.01,0.51,142,162
1,404,10,0,0.001,0.01,0.59,189,215
1,504,10,0,0.001,0.01,0.604,243,261
1,604,10,0,0.001,0.01,0.62,288,316
1,704,10,0,0.001,0.01,0.59,340,364
1,804,10,0,0.001,0.01,0.588,388,416
1,904,10,0,0.001,0.01,0.596,433,471
1,1004,10,0,0.001,0.01,0.61,482,522
1,1104,10,0,0.001,0.01,0.628,540,564
1,1204,10,0,0.001,0.01,0.662,585,619
1,1304,10,0,0.001,0.01,0.688,633,671
1,1404,10,0,0.001,0.01,0.724,682,722
1,1504,10,0,0.001,0.01,0.738,736,768
1,1604,10,0,0.001,0.01,0.784,784,820
1,1704,10,0,0.001,0.01,0.83,833,871
1,1804,10,0,0.001,0.01,0.866,891,913
1,1904,10,0,0.001,0.01,0.902,952,952
2,0,10,0,0.001,0.01,0.486,0,0
2,104,10,0,0.001,0.01,0.472,44,60
2,204,10,0,0.001,0.01,0.534,99,105
2,304,10,0,0.001,0.01,0.564,145,159
2,404,10,0,0.001,0.01,0.552,200,204
2,504,10,0,0.001,0.01,0.564,250,254
2,604,10,0,0.001,0.01,0.562,294,310
2,704,10,0,0.001,0.01,0.566,342,362
2,804,10,0,0.001,0.01,0.598,394,410
2,904,10,0,0.001,0.01,0.606,448,456
2,1004,10,0,0.001,0.01,0.6,496,508
2,1104,10,0,0.001,0.01,0.598,544,560
2,1204,10,0,0.001,0.01,0.626,587,617
2,1304,10,0,0.001,0.01,0.672,633,671
2,1404,10,0,0.001,0.01,0.674,679,725
2,1504,10,0,0.001,0.01,0.706,734,770
2,1604,10,0,0.001,0.01,0.748,790,814
2,1704,10,0,0.001,0.01,0.81,838,866
2,1804,10,0,0.001,0.01,0.84,895,909
2,1904,10,0,0.001,0.01,0.886,952,952
3,0,10,0,0.001,0.01,0.748,0,0
3,104,10,0,0.001,0.01,0.73,56,48
3,204,10,0,0.001,0.01,0.61,110,94
3,304,10,0,0.001,0.01,0.528,153,151
3,404,10,0,0.001,0.01,0.632,202,202
3,504,10,0,0.001,0.01,0.676,249,255
3,604,10,0,0.001,0.01,0.678,298,306
3,704,10,0,0.001,0.01,0.664,359,345
3,804,10,0,0.001,0.01,0.724,405,399
3,904,10,0,0.001,0.01,0.734,449,455
3,1004,10,0,0.001,0.01,0.748,499,505
3,1104,10,0,0.001,0.01,0.784,553,551
3,1204,10,0,0.001,0.01,0.83,594,610
3,1304,10,0,0.001,0.01,0.846,645,659
3,1404,10,0,0.001,0.01,0.868,698,706
3,1504,10,0,0.001,0.01,0.89,737,767
3,1604,10,0,0.001,0.01,0.916,790,814
3,1704,10,0,0.001,0.01,0.934,845,859
3,1804,10,0,0.001,0.01,0.95,891,913
3,1904,10,0,0.001,0.01,0.96,952,952
4,0,10,0,0.001,0.01,0.512,0,0
4,104,10,0,0.001,0.01,0.532,59,45
4,204,10,0,0.001,0.01,0.554,110,94
4,304,10,0,0.001,0.01,0.524,159,145
4,404,10,0,0.001,0.01,0.562,216,188
4,504,10,0,0.001,0.01,0.552,265,239
4,604,10,0,0.001,0.01,0.556,322,282
4,704,10,0,0.001,0.01,0.566,368,336
4,804,10,0,0.001,0.01,0.592,419,385
4,904,10,0,0.001,0.01,0.606,470,434
4,1004,10,0,0.001,0.01,0.602,517,487
4,1104,10,0,0.001,0.01,0.574,570,534
4,1204,10,0,0.001,0.01,0.576,618,586
4,1304,10,0,0.001,0.01,0.584,667,637
4,1404,10,0,0.001,0.01,0.598,714,690
4,1504,10,0,0.001,0.01,0.624,764,740
4,1604,10,0,0.001,0.01,0.652,812,792
4,1704,10,0,0.001,0.01,0.688,856,848
4,1804,10,0,0.001,0.01,0.726,895,909
4,1904,10,0,0.001,0.01,0.752,952,952
5,0,10,0,0.001,0.01,0.57,0,0
5,104,10,0,0.001,0.01,0.558,49,55
5,204,10,0,0.001,0.01,0.54,101,103
5,304,10,0,0.001,0.01,0.556,144,160
5,404,10,0,0.001,0.01,0.53,204,200
5,504,10,0,0.001,0.01,0.514,250,254
5,604,10,0,0.001,0.01,0.526,294,310
5,704,10,0,0.001,0.01,0.526,344,360
5,804,10,0,0.001,0.01,0.53,389,415
5,904,10,0,0.001,0.01,0.542,430,474
5,1004,10,0,0.001,0.01,0.56,480,524
5,1104,10,0,0.001,0.01,0.56,531,573
5,1204,10,0,0.001,0.01,0.556,588,616
5,1304,10,0,0.001,0.01,0.56,639,665
5,1404,10,0,0.001,0.01,0.602,683,721
5,1504,10,0,0.001,0.01,0.618,739,765
5,1604,10,0,0.001,0.01,0.628,786,818
5,1704,10,0,0.001,0.01,0.644,838,866
5,1804,10,0,0.001,0.01,0.642,888,916
5,1904,10,0,0.001,0.01,0.676,952,952
6,0,10,0,0.001,0.01,0.5,0,0
6,104,10,0,0.001,0.01,0.524,49,55
6,204,10,0,0.001,0.01,0.522,101,103
6,304,10,0,0.001,0.01,0.494,150,154
6,404,10,0,0.001,0.01,0.526,197,207
6,504,10,0,0.001,0.01,0.516,249,255
6,604,10,0,0.001,0.01,0.506,306,298
6,704,10,0,0.001,0.01,0.48,357,347
6,804,10,0,0.001,0.01,0.492,404,400
6,904,10,0,0.001,0.01,0.502,445,459
6,1004,10,0,0.001,0.01,0.492,498,506
6,1104,10,0,0.001,0.01,0.5,548,556
6,1204,10,0,0.001,0.01,0.494,590,614
6,1304,10,0,0.001,0.01,0.506,636,668
6,1404,10,0,0.001,0.01,0.514,682,722
6,1504,10,0,0.001,0.01,0.526,736,768
6,1604,10,0,0.001,0.01,0.5,793,811
6,1704,10,0,0.001,0.01,0.512,849,855
6,1804,10,0,0.001,0.01,0.544,905,899
6,1904,10,0,0.001,0.01,0.566,952,952
7,0,10,0,0.001,0.01,0.512,0,0
7,104,10,0,0.001,0.01,0.516,57,47
7,204,10,0,0.001,0.01,0.48,109,95
7,304,10,0,0.001,0.01,0.53,154,150
7,404,10,0,0.001,0.01,0.52,210,194
7,504,10,0,0.001,0.01,0.516,252,252
7,604,10,0,0.001,0.01,0.552,291,313
7,704,10,0,0.001,0.01,0.538,336,368
7,804,10,0,0.001,0.01,0.532,384,420
7,904,10,0,0.001,0.01,0.544,438,466
7,1004,10,0,0.001,0.01,0.564,486,518
7,1104,10,0,0.001,0.01,0.556,534,570
7,1204,10,0,0.001,0.01,0.578,587,617
7,1304,10,0,0.001,0.01,0.588,636,668
7,1404,10,0,0.001,0.01,0.58,686,718
7,1504,10,0,0.001,0.01,0.58,742,762
7,1604,10,0,0.001,0.01,0.584,788,816
7,1704,10,0,0.001,0.01,0.618,842,862
7,1804,10,0,0.001,0.01,0.616,895,909
7,1904,10,0,0.001,0.01,0.596,952,952
8,0,10,0,0.001,0.01,0.54,0,0
8,104,10,0,0.001,0.01,0.558,49,55
8,204,10,0,0.001,0.01,0.558,100,104
8,304,10,0,0.001,0.01,0.526,151,153
8,404,10,0,0.001,0.01,0.54,196,208
8,504,10,0,0.001,0.01,0.584,246,258
8,604,10,0,0.001,0.01,0.58,295,309
8,704,10,0,0.001,0.01,0.582,341,363
8,804,10,0,0.001,0.01,0.588,398,406
8,904,10,0,0.001,0.01,0.582,443,461
8,1004,10,0,0.001,0.01,0.614,496,508
8,1104,10,0,0.001,0.01,0.638,547,557
8,1204,10,0,0.001,0.01,0.634,600,604
8,1304,10,0,0.001,0.01,0.64,654,650
8,1404,10,0,0.001,0.01,0.638,697,707
8,1504,10,0,0.001,0.01,0.634,747,757
8,1604,10,0,0.001,0.01,0.652,801,803
8,1704,10,0,0.001,0.01,0.646,856,848
8,1804,10,0,0.001,0.01,0.632,903,901
8,1904,10,0,0.001,0.01,0.636,952,952
9,0,10,0,0.001,0.01,0.532,0,0
9,104,10,0,0.001,0.01,0.564,59,45
9,204,10,0,0.001,0.01,0.606,110,94
9,304,10,0,0.001,0.01,0.54,159,145
9,404,10,0,0.001,0.01,0.604,215,189
9,504,10,0,0.001,0.01,0.622,255,249
9,604,10,0,0.001,0.01,0.626,310,294
9,704,10,0,0.001,0.01,0.592,356,348
9,804,10,0,0.001,0.01,0.636,408,396
9,904,10,0,0.001,0.01,0.626,460,444
9,1004,10,0,0.001,0.01,0.63,506,498
9,1104,10,0,0.001,0.01,0.672,554,550
9,1204,10,0,0.001,0.01,0.706,608,596
9,1304,10,0,0.001,0.01,0.728,654,650
9,1404,10,0,0.001,0.01,0.758,701,703
9,1504,10,0,0.001,0.01,0.8,749,755
9,1604,10,0,0.001,0.01,0.818,793,811
9,1704,10,0,0.001,0.01,0.86,845,859
9,1804,10,0,0.001,0.01,0.9,899,905
9,1904,10,0,0.001,0.01,0.938,952,952
10,0,10,0,0.001,0.01,0.606,0,0
10,104,10,0,0.001,0.01,0.676,47,57
10,204,10,0,0.001,0.01,0.61,97,107
10,304,10,0,0.001,0.01,0.556,151,153
10,404,10,0,0.001,0.01,0.688,204,200
10,504,10,0,0.001,0.01,0.678,249,255
10,604,10,0,0.001,0.01,0.686,296,308
10,704,10,0,0.001,0.01,0.702,355,349
10,804,10,0,0.001,0.01,0.73,406,398
10,904,10,0,0.001,0.01,0.788,456,448
10,1004,10,0,0.001,0.01,0.81,506,498
10,1104,10,0,0.001,0.01,0.844,556,548
10,1204,10,0,0.001,0.01,0.868,601,603
10,1304,10,0,0.001,0.01,0.896,647,657
10,1404,10,0,0.001,0.01,0.904,692,712
10,1504,10,0,0.001,0.01,0.916,749,755
10,1604,10,0,0.001,0.01,0.938,805,799
10,1704,10,0,0.001,0.01,0.942,853,851
10,1804,10,0,0.001,0.01,0.944,897,907
10,1904,10,0,0.001,0.01,0.956,952,952
11,0,10,0,0.001,0.01,0.524,0,0
11,104,10,0,0.001,0.01,0.558,56,48
11,204,10,0,0.001,0.01,0.578,103,101
11,304,10,0,0.001,0.01,0.576,155,149
11,404,10,0,0.001,0.01,0.566,210,194
11,504,10,0,0.001,0.01,0.56,262,242
11,604,10,0,0.001,0.01,0.562,316,288
11,704,10,0,0.001,0.01,0.59,367,337
11,804,10,0,0.001,0.01,0.632,426,378
11,904,10,0,0.001,0.01,0.652,467,437
11,1004,10,0,0.001,0.01,0.666,524,480
11,1104,10,0,0.001,0.01,0.704,570,534
11,1204,10,0,0.001,0.01,0.73,617,587
11,1304,10,0,0.001,0.01,0.744,661,643
11,1404,10,0,0.001,0.01,0.772,708,696
11,1504,10,0,0.001,0.01,0.79,755,749
11,1604,10,0,0.001,0.01,0.842,806,798
11,1704,10,0,0.001,0.01,0.842,855,849
11,1804,10,0,0.001,0.01,0.886,905,899
11,1904,10,0,0.001,0.01,0.906,952,952
12,0,10,0,0.001,0.01,0.504,0,0
12,104,10,0,0.001,0.01,0.514,49,55
12,204,10,0,0.001,0.01,0.5,97,107
12,304,10,0,0.001,0.01,0.508,139,165
12,404,10,0,0.001,0.01,0.53,191,213
12,504,10,0,0.001,0.01,0.514,245,259
12,604,10,0,0.001,0.01,0.538,298,306
12,704,10,0,0.001,0.01,0.526,344,360
12,804,10,0,0.001,0.01,0.54,406,398
12,904,10,0,0.001,0.01,0.528,458,446
12,1004,10,0,0.001,0.01,0.52,513,491
12,1104,10,0,0.001,0.01,0.534,561,543
12,1204,10,0,0.001,0.01,0.52,615,589
12,1304,10,0,0.001,0.01,0.542,666,638
12,1404,10,0,0.001,0.01,0.544,707,697
12,1504,10,0,0.001,0.01,0.546,749,755
12,1604,10,0,0.001,0.01,0.566,792,812
12,1704,10,0,0.001,0.01,0.578,842,862
12,1804,10,0,0.001,0.01,0.604,894,910
12,1904,10,0,0.001,0.01,0.622,952,952
13,0,10,0,0.001,0.01,0.658,0,0
13,104,10,0,0.001,0.01,0.702,46,58
13,204,10,0,0.001,0.01,0.576,97,107
13,304,10,0,0.001,0.01,0.52,144,160
13,404,10,0,0.001,0.01,0.594,193,211
13,504,10,0,0.001,0.01,0.62,236,268
13,604,10,0,0.001,0.01,0.598,281,323
13,704,10,0,0.001,0.01,0.614,334,370
13,804,10,0,0.001,0.01,0.672,382,422
13,904,10,0,0.001,0.01,0.688,432,472
13,1004,10,0,0.001,0.01,0.73,491,513
13,1104,10,0,0.001,0.01,0.738,536,568
13,1204,10,0,0.001,0.01,0.778,586,618
13,1304,10,0,0.001,0.01,0.838,637,667
13,1404,10,0,0.001,0.01,0.872,691,713
13,1504,10,0,0.001,0.01,0.916,742,762
13,1604,10,0,0.001,0.01,0.914,794,810
13,1704,10,0,0.001,0.01,0.942,841,863
13,1804,10,0,0.001,0.01,0.944,899,905
13,1904,10,0,0.001,0.01,0.942,952,952
14,0,10,0,0.001,0.01,0.508,0,0
14,104,10,0,0.001,0.01,0.518,48,56
14,204,10,0,0.001,0.01,0.55,104,100
14,304,10,0,0.001,0.01,0.5,159,145
14,404,10,0,0.001,0.01,0.518,214,190
14,504,10,0,0.001,0.01,0.516,263,241
14,604,10,0,0.001,0.01,0.5,316,288
14,704,10,0,0.001,0.01,0.526,369,335
14,804,10,0,0.001,0.01,0.524,421,383
14,904,10,0,0.001,0.01,0.522,471,433
14,1004,10,0,0.001,0.01,0.52,521,483
14,1104,10,0,0.001,0.01,0.52,572,532
14,1204,10,0,0.001,0.01,0.52,624,580
14,1304,10,0,0.001,0.01,0.512,670,634
14,1404,10,0,0.001,0.01,0.526,713,691
14,1504,10,0,0.001,0.01,0.528,752,752
14,1604,10,0,0.001,0.01,0.526,801,803
14,1704,10,0,0.001,0.01,0.52,849,855
14,1804,10,0,0.001,0.01,0.548,899,905
14,1904,10,0,0.001,0.01,0.544,952,952
15,0,10,0,0.001,0.01,0.532,0,0
15,104,10,0,0.001,0.01,0.542,50,54
15,204,10,0,0.001,0.01,0.6,99,105
15,304,10,0,0.001,0.01,0.534,151,153
15,404,10,0,0.001,0.01,0.568,191,213
15,504,10,0,0.001,0.01,0.552,242,262
15,604,10,0,0.001,0.01,0.54,295,309
15,704,10,0,0.001,0.01,0.558,347,357
15,804,10,0,0.001,0.01,0.582,394,410
15,904,10,0,0.001,0.01,0.614,451,453
15,1004,10,0,0.001,0.01,0.638,506,498
15,1104,10,0,0.001,0.01,0.668,563,541
15,1204,10,0,0.001,0.01,0.686,613,591
15,1304,10,0,0.001,0.01,0.728,671,633
15,1404,10,0,0.001,0.01,0.768,714,690
15,1504,10,0,0.001,0.01,0.836,764,740
15,1604,10,0,0.001,0.01,0.882,805,799
15,1704,10,0,0.001,0.01,0.912,855,849
15,1804,10,0,0.001,0.01,0.936,903,901
15,1904,10,0,0.001,0.01,0.958,952,952
16,0,10,0,0.001,0.01,0.51,0,0
16,104,10,0,0.001,0.01,0.522,56,48
16,204,10,0,0.001,0.01,0.542,104,100
16,304,10,0,0.001,0.01,0.546,150,154
16,404,10,0,0.001,0.01,0.536,199,205
16,504,10,0,0.001,0.01,0.576,242,262
16,604,10,0,0.001,0.01,0.588,295,309
16,704,10,0,0.001,0.01,0.572,347,357
16,804,10,0,0.001,0.01,0.588,403,401
16,904,10,0,0.001,0.01,0.592,453,451
16,1004,10,0,0.001,0.01,0.582,502,502
16,1104,10,0,0.001,0.01,0.618,556,548
16,1204,10,0,0.001,0.01,0.628,612,592
16,1304,10,0,0.001,0.01,0.656,658,646
16,1404,10,0,0.001,0.01,0.678,710,694
16,1504,10,0,0.001,0.01,0.724,756,748
16,1604,10,0,0.001,0.01,0.758,807,797
16,1704,10,0,0.001,0.01,0.79,858,846
16,1804,10,0,0.001,0.01,0.826,909,895
16,1904,10,0,0.001,0.01,0.866,952,952
17,0,10,0,0.001,0.01,0.508,0,0
17,104,10,0,0.001,0.01,0.534,56,48
17,204,10,0,0.001,0.01,0.552,110,94
17,304,10,0,0.001,0.01,0.522,157,147
17,404,10,0,0.001,0.01,0.55,208,196
17,504,10,0,0.001,0.01,0.524,252,252
17,604,10,0,0.001,0.01,0.512,305,299
17,704,10,0,0.001,0.01,0.546,351,353
17,804,10,0,0.001,0.01,0.552,412,392
17,904,10,0,0.001,0.01,0.556,454,450
17,1004,10,0,0.001,0.01,0.558,502,502
17,1104,10,0,0.001,0.01,0.558,557,547
17,1204,10,0,0.001,0.01,0.57,610,594
17,1304,10,0,0.001,0.01,0.602,665,639
17,1404,10,0,0.001,0.01,0.596,717,687
17,1504,10,0,0.001,0.01,0.608,762,742
17,1604,10,0,0.001,0.01,0.596,813,791
17,1704,10,0,0.001,0.01,0.632,863,841
17,1804,10,0,0.001,0.01,0.646,905,899
17,1904,10,0,0.001,0.01,0.68,952,952
18,0,10,0,0.001,0.01,0.5,0,0
18,104,10,0,0.001,0.01,0.516,51,53
18,204,10,0,0.001,0.01,0.522,101,103
18,304,10,0,0.001,0.01,0.49,148,156
18,404,10,0,0.001,0.01,0.486,199,205
18,504,10,0,0.001,0.01,0.49,242,262
18,604,10,0,0.001,0.01,0.478,291,313
18,704,10,0,0.001,0.01,0.482,342,362
18,804,10,0,0.001,0.01,0.524,394,410
18,904,10,0,0.001,0.01,0.498,448,456
18,1004,10,0,0.001,0.01,0.506,501,503
18,1104,10,0,0.001,0.01,0.528,545,559
18,1204,10,0,0.001,0.01,0.516,597,607
18,1304,10,0,0.001,0.01,0.528,647,657
18,1404,10,0,0.001,0.01,0.53,694,710
18,1504,10,0,0.001,0.01,0.544,751,753
18,1604,10,0,0.001,0.01,0.566,804,800
18,1704,10,0,0.001,0.01,0.562,846,858
18,1804,10,0,0.001,0.01,0.586,903,901
18,1904,10,0,0.001,0.01,0.63,952,952
19,0,10,0,0.001,0.01,0.522,0,0
19,104,10,0,0.001,0.01,0.542,56,48
19,204,10,0,0.001,0.01,0.602,100,104
19,304,10,0,0.001,0.01,0.566,162,142
19,404,10,0,0.001,0.01,0.634,217,187
19,504,10,0,0.001,0.01,0.654,265,239
19,604,10,0,0.001,0.01,0.656,321,283
19,704,10,0,0.001,0.01,0.654,372,332
19,804,10,0,0.001,0.01,0.688,412,392
19,904,10,0,0.001,0.01,0.71,457,447
19,1004,10,0,0.001,0.01,0.74,506,498
19,1104,10,0,0.001,0.01,0.77,556,548
19,1204,10,0,0.001,0.01,0.806,609,595
19,1304,10,0,0.001,0.01,0.846,654,650
19,1404,10,0,0.001,0.01,0.876,701,703
19,1504,10,0,0.001,0.01,0.894,750,754
19,1604,10,0,0.001,0.01,0.924,808,796
19,1704,10,0,0.001,0.01,0.932,864,840
19,1804,10,0,0.001,0.01,0.946,907,897
19,1904,10,0,0.001,0.01,0.96,952,952
20,0,10,0,0.001,0.01,0.632,0,0
20,104,10,0,0.001,0.01,0.684,61,43
20,204,10,0,0.001,0.01,0.6,108,96
20,304,10,0,0.001,0.01,0.524,160,144
20,404,10,0,0.001,0.01,0.62,203,201
20,504,10,0,0.001,0.01,0.64,251,253
20,604,10,0,0.001,0.01,0.668,304,300
20,704,10,0,0.001,0.01,0.658,356,348
20,804,10,0,0.001,0.01,0.67,403,401
20,904,10,0,0.001,0.01,0.718,446,458
20,1004,10,0,0.001,0.01,0.724,494,510
20,1104,10,0,0.001,0.01,0.74,548,556
20,1204,10,0,0.001,0.01,0.766,597,607
20,1304,10,0,0.001,0.01,0.798,647,657
20,1404,10,0,0.001,0.01,0.842,694,710
20,1504,10,0,0.001,0.01,0.864,739,765
20,1604,10,0,0.001,0.01,0.912,796,808
20,1704,10,0,0.001,0.01,0.942,852,852
20,1804,10,0,0.001,0.01,0.956,906,898
20,1904,10,0,0.001,0.01,0.966,952,952
1,0,25,0,1e-05,0.0001,0.46,0,0
1,104,25,0,1e-05,0.0001,0.46,42,62
1,204,25,0,1e-05,0.0001,0.458,93,111
1,304,25,0,1e-05,0.0001,0.454,150,154
1,404,25,0,1e-05,0.0001,0.454,202,202
1,504,25,0,1e-05,0.0001,0.464,252,252
1,604,25,0,1e-05,0.0001,0.466,301,303
1,704,25,0,1e-05,0.0001,0.462,355,349
1,804,25,0,1e-05,0.0001,0.466,408,396
1,904,25,0,1e-05,0.0001,0.462,464,440
1,1004,25,0,1e-05,0.0001,0.462,518,486
1,1104,25,0,1e-05,0.0001,0.468,561,543
1,1204,25,0,1e-05,0.0001,0.464,609,595
1,1304,25,0,1e-05,0.0001,0.46,656,648
1,1404,25,0,1e-05,0.0001,0.46,708,696
1,1504,25,0,1e-05,0.0001,0.462,760,744
1,1604,25,0,1e-05,0.0001,0.46,805,799
1,1704,25,0,1e-05,0.0001,0.46,847,857
1,1804,25,0,1e-05,0.0001,0.462,903,901
1,1904,25,0,1e-05,0.0001,0.462,952,952
2,0,25,0,1e-05,0.0001,0.516,0,0
2,104,25,0,1e-05,0.0001,0.516,52,52
2,204,25,0,1e-05,0.0001,0.518,94,110
2,304,25,0,1e-05,0.0001,0.52,146,158
2,404,25,0,1e-05,0.0001,0.516,200,204
2,504,25,0,1e-05,0.0001,0.512,260,244
2,604,25,0,1e-05,0.0001,0.512,314,290
2,704,25,0,1e-05,0.0001,0.512,361,343
2,804,25,0,1e-05,0.0001,0.512,408,396
2,904,25,0,1e-05,0.0001,0.514,459,445
2,1004,25,0,1e-05,0.0001,0.51,500,504
2,1104,25,0,1e-05,0.0001,0.508,556,548
2,1204,25,0,1e-05,0.0001,0.51,610,594
2,1304,25,0,1e-05,0.0001,0.508,665,639
2,1404,25,0,1e-05,0.0001,0.514,712,692
2,1504,25,0,1e-05,0.0001,0.516,769,735
2,1604,25,0,1e-05,0.0001,0.516,817,787
2,1704,25,0,1e-05,0.0001,0.516,866,838
2,1804,25,0,1e-05,0.0001,0.52,909,895
2,1904,25,0,1e-05,0.0001,0.51,952,952
3,0,25,0,1e-05,0.0001,0.478,0,0
3,104,25,0,1e-05,0.0001,0.478,54,50
3,204,25,0,1e-05,0.0001,0.474,105,99
3,304,25,0,1e-05,0.0001,0.474,155,149
3,404,25,0,1e-05,0.0001,0.474,189,215
3,504,25,0,1e-05,0.0001,0.47,242,262
3,604,25,0,1e-05,0.0001,0.466,285,319
3,704,25,0,1e-05,0.0001,0.476,331,373
3,804,25,0,1e-05,0.0001,0.476,377,427
3,904,25,0,1e-05,0.0001,0.472,429,475
3,1004,25,0,1e-05,0.0001,0.484,475,529
3,1104,25,0,1e-05,0.0001,0.496,538,566
3,1204,25,0,1e-05,0.0001,0.492,586,618
3,1304,25,0,1e-05,0.0001,0.48,644,660
3,1404,25,0,1e-05,0.0001,0.488,691,713
3,1504,25,0,1e-05,0.0001,0.486,745,759
3,1604,25,0,1e-05,0.0001,0.484,795,809
3,1704,25,0,1e-05,0.0001,0.48,849,855
3,1804,25,0,1e-05,0.0001,0.484,906,898
3,1904,25,0,1e-05,0.0001,0.49,952,952
4,0,25,0,1e-05,0.0001,0.484,0,0
4,104,25,0,1e-05,0.0001,0.484,51,53
4,204,25,0,1e-05,0.0001,0.484,106,98
4,304,25,0,1e-05,0.0001,0.484,159,145
4,404,25,0,1e-05,0.0001,0.484,217,187
4,504,25,0,1e-05,0.0001,0.488,266,238
4,604,25,0,1e-05,0.0001,0.484,310,294
4,704,25,0,1e-05,0.0001,0.482,362,342
4,804,25,0,1e-05,0.0001,0.48,415,389
4,904,25,0,1e-05,0.0001,0.478,464,440
4,1004,25,0,1e-05,0.0001,0.478,521,483
4,1104,25,0,1e-05,0.0001,0.474,574,530
4,1204,25,0,1e-05,0.0001,0.48,625,579
4,1304,25,0,1e-05,0.0001,0.474,666,638
4,1404,25,0,1e-05,0.0001,0.478,712,692
4,1504,25,0,1e-05,0.0001,0.47,761,743
4,1604,25,0,1e-05,0.0001,0.474,806,798
4,1704,25,0,1e-05,0.0001,0.474,842,862
4,1804,25,0,1e-05,0.0001,0.476,898,906
4,1904,25,0,1e-05,0.0001,0.472,952,952
5,0,25,0,1e-05,0.0001,0.5,0,0
5,104,25,0,1e-05,0.0001,0.5,54,50
5,204,25,0,1e-05,0.0001,0.502,103,101
5,304,25,0,1e-05,0.0001,0.502,150,154
5,404,25,0,1e-05,0.0001,0.5,192,212
5,504,25,0,1e-05,0.0001,0.502,238,266
5,604,25,0,1e-05,0.0001,0.5,286,318
5,704,25,0,1e-05,0.0001,0.5,344,360
5,804,25,0,1e-05,0.0001,0.496,391,413
5,904,25,0,1e-05,0.0001,0.494,437,467
5,1004,25,0,1e-05,0.0001,0.49,495,509
5,1104,25,0,1e-05,0.0001,0.484,544,560
5,1204,25,0,1e-05,0.0001,0.494,593,611
5,1304,25,0,1e-05,0.0001,0.512,644,660
5,1404,25,0,1e-05,0.0001,0.51,695,709
5,1504,25,0,1e-05,0.0001,0.514,742,762
5,1604,25,0,1e-05,0.0001,0.524,790,814
5,1704,25,0,1e-05,0.0001,0.52,845,859
5,1804,25,0,1e-05,0.0001,0.516,900,904
5,1904,25,0,1e-05,0.0001,0.522,952,952
6,0,25,0,1e-05,0.0001,0.478,0,0
6,104,25,0,1e-05,0.0001,0.478,62,42
6,204,25,0,1e-05,0.0001,0.478,117,87
6,304,25,0,1e-05,0.0001,0.478,167,137
6,404,25,0,1e-05,0.0001,0.48,209,195
6,504,25,0,1e-05,0.0001,0.472,259,245
6,604,25,0,1e-05,0.0001,0.464,309,295
6,704,25,0,1e-05,0.0001,0.468,352,352
6,804,25,0,1e-05,0.0001,0.454,404,400
6,904,25,0,1e-05,0.0001,0.442,456,448
6,1004,25,0,1e-05,0.0001,0.448,505,499
6,1104,25,0,1e-05,0.0001,0.452,557,547
6,1204,25,0,1e-05,0.0001,0.464,608,596
6,1304,25,0,1e-05,0.0001,0.468,660,644
6,1404,25,0,1e-05,0.0001,0.476,702,702
6,1504,25,0,1e-05,0.0001,0.48,761,743
6,1604,25,0,1e-05,0.0001,0.48,807,797
6,1704,25,0,1e-05,0.0001,0.462,853,851
6,1804,25,0,1e-05,0.0001,0.458,899,905
6,1904,25,0,1e-05,0.0001,0.466,952,952
7,0,25,0,1e-05,0.0001,0.486,0,0
7,104,25,0,1e-05,0.0001,0.486,50,54
7,204,25,0,1e-05,0.0001,0.486,102,102
7,304,25,0,1e-05,0.0001,0.484,151,153
7,404,25,0,1e-05,0.0001,0.486,199,205
7,504,25,0,1e-05,0.0001,0.488,245,259
7,604,25,0,1e-05,0.0001,0.486,297,307
7,704,25,0,1e-05,0.0001,0.488,345,359
7,804,25,0,1e-05,0.0001,0.49,389,415
7,904,25,0,1e-05,0.0001,0.494,438,466
7,1004,25,0,1e-05,0.0001,0.502,490,514
7,1104,25,0,1e-05,0.0001,0.5,535,569
7,1204,25,0,1e-05,0.0001,0.508,588,616
7,1304,25,0,1e-05,0.0001,0.502,646,658
7,1404,25,0,1e-05,0.0001,0.496,700,704
7,1504,25,0,1e-05,0.0001,0.494,750,754
7,1604,25,0,1e-05,0.0001,0.492,806,798
7,1704,25,0,1e-05,0.0001,0.496,862,842
7,1804,25,0,1e-05,0.0001,0.49,909,895
7,1904,25,0,1e-05,0.0001,0.498,952,952
8,0,25,0,1e-05,0.0001,0.522,0,0
8,104,25,0,1e-05,0.0001,0.52,49,55
8,204,25,0,1e-05,0.0001,0.52,89,115
8,304,25,0,1e-05,0.0001,0.52,134,170
8,404,25,0,1e-05,0.0001,0.52,180,224
8,504,25,0,1e-05,0.0001,0.516,231,273
8,604,25,0,1e-05,0.0001,0.512,284,320
8,704,25,0,1e-05,0.0001,0.514,336,368
8,804,25,0,1e-05,0.0001,0.512,384,420
8,904,25,0,1e-05,0.0001,0.512,442,462
8,1004,25,0,1e-05,0.0001,0.51,497,507
8,1104,25,0,1e-05,0.0001,0.512,550,554
8,1204,25,0,1e-05,0.0001,0.512,597,607
8,1304,25,0,1e-05,0.0001,0.508,640,664
8,1404,25,0,1e-05,0.0001,0.512,689,715
8,1504,25,0,1e-05,0.0001,0.512,736,768
8,1604,25,0,1e-05,0.0001,0.508,791,813
8,1704,25,0,1e-05,0.0001,0.512,843,861
8,1804,25,0,1e-05,0.0001,0.518,905,899
8,1904,25,0,1e-05,0.0001,0.53,952,952
9,0,25,0,1e-05,0.0001,0.486,0,0
9,104,25,0,1e-05,0.0001,0.486,54,50
9,204,25,0,1e-05,0.0001,0.484,102,102
9,304,25,0,1e-05,0.0001,0.484,156,148
9,404,25,0,1e-05,0.0001,0.484,201,203
9,504,25,0,1e-05,0.0001,0.488,245,259
9,604,25,0,1e-05,0.0001,0.486,303,301
9,704,25,0,1e-05,0.0001,0.486,355,349
9,804,25,0,1e-05,0.0001,0.486,404,400
9,904,25,0,1e-05,0.0001,0.488,449,455
9,1004,25,0,1e-05,0.0001,0.49,499,505
9,1104,25,0,1e-05,0.0001,0.49,552,552
9,1204,25,0,1e-05,0.0001,0.486,598,606
9,1304,25,0,1e-05,0.0001,0.484,649,655
9,1404,25,0,1e-05,0.0001,0.478,703,701
9,1504,25,0,1e-05,0.0001,0.48,747,757
9,1604,25,0,1e-05,0.0001,0.486,803,801
9,1704,25,0,1e-05,0.0001,0.482,849,855
9,1804,25,0,1e-05,0.0001,0.476,901,903
9,1904,25,0,1e-05,0.0001,0.474,952,952
10,0,25,0,1e-05,0.0001,0.512,0,0
10,104,25,0,1e-05,0.0001,0.512,39,65
10,204,25,0,1e-05,0.0001,0.506,95,109
10,304,25,0,1e-05,0.0001,0.508,146,158
10,404,25,0,1e-05,0.0001,0.502,189,215
10,504,25,0,1e-05,0.0001,0.506,236,268
10,604,25,0,1e-05,0.0001,0.502,283,321
10,704,25,0,1e-05,0.0001,0.504,337,367
10,804,25,0,1e-05,0.0001,0.506,382,422
10,904,25,0,1e-05,0.0001,0.508,427,477
10,1004,25,0,1e-05,0.0001,0.512,469,535
10,1104,25,0,1e-05,0.0001,0.5,524,580
10,1204,25,0,1e-05,0.0001,0.488,576,628
10,1304,25,0,1e-05,0.0001,0.496,625,679
10,1404,25,0,1e-05,0.0001,0.502,681,723
10,1504,25,0,1e-05,0.0001,0.5,737,767
10,1604,25,0,1e-05,0.0001,0.502,795,809
10,1704,25,0,1e-05,0.0001,0.5,849,855
10,1804,25,0,1e-05,0.0001,0.504,905,899
10,1904,25,0,1e-05,0.0001,0.504,952,952
11,0,25,0,1e-05,0.0001,0.464,0,0
11,104,25,0,1e-05,0.0001,0.464,45,59
11,204,25,0,1e-05,0.0001,0.462,106,98
11,304,25,0,1e-05,0.0001,0.464,148,156
11,404,25,0,1e-05,0.0001,0.468,197,207
11,504,25,0,1e-05,0.0001,0.466,252,252
11,604,25,0,1e-05,0.0001,0.468,312,292
11,704,25,0,1e-05,0.0001,0.464,359,345
11,804,25,0,1e-05,0.0001,0.464,412,392
11,904,25,0,1e-05,0.0001,0.474,456,448
11,1004,25,0,1e-05,0.0001,0.474,506,498
11,1104,25,0,1e-05,0.0001,0.472,556,548
11,1204,25,0,1e-05,0.0001,0.472,599,605
11,1304,25,0,1e-05,0.0001,0.468,644,660
11,1404,25,0,1e-05,0.0001,0.478,696,708
11,1504,25,0,1e-05,0.0001,0.476,743,761
11,1604,25,0,1e-05,0.0001,0.468,792,812
11,1704,25,0,1e-05,0.0001,0.47,844,860
11,1804,25,0,1e-05,0.0001,0.47,900,904
11,1904,25,0,1e-05,0.0001,0.482,952,952
12,0,25,0,1e-05,0.0001,0.498,0,0
12,104,25,0,1e-05,0.0001,0.5,43,61
12,204,25,0,1e-05,0.0001,0.5,99,105
12,304,25,0,1e-05,0.0001,0.5,154,150
12,404,25,0,1e-05,0.0001,0.502,196,208
12,504,25,0,1e-05,0.0001,0.498,240,264
12,604,25,0,1e-05,0.0001,0.498,292,312
12,704,25,0,1e-05,0.0001,0.496,353,351
12,804,25,0,1e-05,0.0001,0.498,399,405
12,904,25,0,1e-05,0.0001,0.496,445,459
12,1004,25,0,1e-05,0.0001,0.496,495,509
12,1104,25,0,1e-05,0.0001,0.496,548,556
12,1204,25,0,1e-05,0.0001,0.498,597,607
12,1304,25,0,1e-05,0.0001,0.496,649,655
12,1404,25,0,1e-05,0.0001,0.496,704,700
12,1504,25,0,1e-05,0.0001,0.492,753,751
12,1604,25,0,1e-05,0.0001,0.492,802,802
12,1704,25,0,1e-05,0.0001,0.492,854,850
12,1804,25,0,1e-05,0.0001,0.492,896,908
12,1904,25,0,1e-05,0.0001,0.492,952,952
13,0,25,0,1e-05,0.0001,0.5,0,0
13,104,25,0,1e-05,0.0001,0.5,53,51
13,204,25,0,1e-05,0.0001,0.498,101,103
13,304,25,0,1e-05,0.0001,0.494,157,147
13,404,25,0,1e-05,0.0001,0.492,207,197
13,504,25,0,1e-05,0.0001,0.492,262,242
13,604,25,0,1e-05,0.0001,0.492,316,288
13,704,25,0,1e-05,0.0001,0.492,368,336
13,804,25,0,1e-05,0.0001,0.492,421,383
13,904,25,0,1e-05,0.0001,0.49,476,428
13,1004,25,0,1e-05,0.0001,0.49,529,475
13,1104,25,0,1e-05,0.0001,0.49,577,527
13,1204,25,0,1e-05,0.0001,0.49,627,577
13,1304,25,0,1e-05,0.0001,0.492,671,633
13,1404,25,0,1e-05,0.0001,0.49,724,680
13,1504,25,0,1e-05,0.0001,0.492,769,735
13,1604,25,0,1e-05,0.0001,0.488,813,791
13,1704,25,0,1e-05,0.0001,0.492,855,849
13,1804,25,0,1e-05,0.0001,0.49,906,898
13,1904,25,0,1e-05,0.0001,0.488,952,952
14,0,25,0,1e-05,0.0001,0.504,0,0
14,104,25,0,1e-05,0.0001,0.504,55,49
14,204,25,0,1e-05,0.0001,0.504,93,111
14,304,25,0,1e-05,0.0001,0.504,152,152
14,404,25,0,1e-05,0.0001,0.506,201,203
14,504,25,0,1e-05,0.0001,0.506,248,256
14,604,25,0,1e-05,0.0001,0.506,303,301
14,704,25,0,1e-05,0.0001,0.506,353,351
14,804,25,0,1e-05,0.0001,0.504,410,394
14,904,25,0,1e-05,0.0001,0.504,459,445
14,1004,25,0,1e-05,0.0001,0.506,508,496
14,1104,25,0,1e-05,0.0001,0.51,556,548
14,1204,25,0,1e-05,0.0001,0.5,602,602
14,1304,25,0,1e-05,0.0001,0.498,657,647
14,1404,25,0,1e-05,0.0001,0.496,705,699
14,1504,25,0,1e-05,0.0001,0.5,749,755
14,1604,25,0,1e-05,0.0001,0.504,799,805
14,1704,25,0,1e-05,0.0001,0.502,847,857
14,1804,25,0,1e-05,0.0001,0.51,901,903
14,1904,25,0,1e-05,0.0001,0.514,952,952
15,0,25,0,1e-05,0.0001,0.502,0,0
15,104,25,0,1e-05,0.0001,0.502,40,64
15,204,25,0,1e-05,0.0001,0.504,94,110
15,304,25,0,1e-05,0.0001,0.504,147,157
15,404,25,0,1e-05,0.0001,0.504,203,201
15,504,25,0,1e-05,0.0001,0.504,252,252
15,604,25,0,1e-05,0.0001,0.502,304,300
15,704,25,0,1e-05,0.0001,0.502,346,358
15,804,25,0,1e-05,0.0001,0.502,396,408
15,904,25,0,1e-05,0.0001,0.502,435,469
15,1004,25,0,1e-05,0.0001,0.5,479,525
15,1104,25,0,1e-05,0.0001,0.5,527,577
15,1204,25,0,1e-05,0.0001,0.504,588,616
15,1304,25,0,1e-05,0.0001,0.504,649,655
15,1404,25,0,1e-05,0.0001,0.498,694,710
15,1504,25,0,1e-05,0.0001,0.508,755,749
15,1604,25,0,1e-05,0.0001,0.506,809,795
15,1704,25,0,1e-05,0.0001,0.516,854,850
15,1804,25,0,1e-05,0.0001,0.518,901,903
15,1904,25,0,1e-05,0.0001,0.522,952,952
16,0,25,0,1e-05,0.0001,0.492,0,0
16,104,25,0,1e-05,0.0001,0.492,54,50
16,204,25,0,1e-05,0.0001,0.492,104,100
16,304,25,0,1e-05,0.0001,0.492,147,157
16,404,25,0,1e-05,0.0001,0.49,198,206
16,504,25,0,1e-05,0.0001,0.494,249,255
16,604,25,0,1e-05,0.0001,0.494,298,306
16,704,25,0,1e-05,0.0001,0.492,344,360
16,804,25,0,1e-05,0.0001,0.492,386,418
16,904,25,0,1e-05,0.0001,0.49,440,464
16,1004,25,0,1e-05,0.0001,0.494,492,512
16,1104,25,0,1e-05,0.0001,0.498,542,562
16,1204,25,0,1e-05,0.0001,0.5,591,613
16,1304,25,0,1e-05,0.0001,0.5,645,659
16,1404,25,0,1e-05,0.0001,0.502,692,712
16,1504,25,0,1e-05,0.0001,0.504,749,755
16,1604,25,0,1e-05,0.0001,0.508,798,806
16,1704,25,0,1e-05,0.0001,0.502,847,857
16,1804,25,0,1e-05,0.0001,0.496,899,905
16,1904,25,0,1e-05,0.0001,0.496,952,952
17,0,25,0,1e-05,0.0001,0.526,0,0
17,104,25,0,1e-05,0.0001,0.528,52,52
17,204,25,0,1e-05,0.0001,0.526,109,95
17,304,25,0,1e-05,0.0001,0.532,162,142
17,404,25,0,1e-05,0.0001,0.534,217,187
17,504,25,0,1e-05,0.0001,0.542,267,237
17,604,25,0,1e-05,0.0001,0.542,318,286
17,704,25,0,1e-05,0.0001,0.534,372,332
17,804,25,0,1e-05,0.0001,0.538,423,381
17,904,25,0,1e-05,0.0001,0.522,474,430
17,1004,25,0,1e-05,0.0001,0.524,518,486
17,1104,25,0,1e-05,0.0001,0.524,572,532
17,1204,25,0,1e-05,0.0001,0.528,620,584
17,1304,25,0,1e-05,0.0001,0.524,662,642
17,1404,25,0,1e-05,0.0001,0.528,716,688
17,1504,25,0,1e-05,0.0001,0.53,761,743
17,1604,25,0,1e-05,0.0001,0.526,810,794
17,1704,25,0,1e-05,0.0001,0.528,862,842
17,1804,25,0,1e-05,0.0001,0.532,903,901
17,1904,25,0,1e-05,0.0001,0.54,952,952
18,0,25,0,1e-05,0.0001,0.476,0,0
18,104,25,0,1e-05,0.0001,0.474,49,55
18,204,25,0,1e-05,0.0001,0.474,100,104
18,304,25,0,1e-05,0.0001,0.476,144,160
18,404,25,0,1e-05,0.0001,0.478,197,207
18,504,25,0,1e-05,0.0001,0.474,250,254
18,604,25,0,1e-05,0.0001,0.472,311,293
18,704,25,0,1e-05,0.0001,0.474,356,348
18,804,25,0,1e-05,0.0001,0.478,407,397
18,904,25,0,1e-05,0.0001,0.476,457,447
18,1004,25,0,1e-05,0.0001,0.476,496,508
18,1104,25,0,1e-05,0.0001,0.48,542,562
18,1204,25,0,1e-05,0.0001,0.488,591,613
18,1304,25,0,1e-05,0.0001,0.498,644,660
18,1404,25,0,1e-05,0.0001,0.5,697,707
18,1504,25,0,1e-05,0.0001,0.48,745,759
18,1604,25,0,1e-05,0.0001,0.472,795,809
18,1704,25,0,1e-05,0.0001,0.472,850,854
18,1804,25,0,1e-05,0.0001,0.476,904,900
18,1904,25,0,1e-05,0.0001,0.48,952,952
19,0,25,0,1e-05,0.0001,0.476,0,0
19,104,25,0,1e-05,0.0001,0.476,52,52
19,204,25,0,1e-05,0.0001,0.476,106,98
19,304,25,0,1e-05,0.0001,0.478,156,148
19,404,25,0,1e-05,0.0001,0.482,206,198
19,504,25,0,1e-05,0.0001,0.474,243,261
19,604,25,0,1e-05,0.0001,0.478,289,315
19,704,25,0,1e-05,0.0001,0.47,343,361
19,804,25,0,1e-05,0.0001,0.464,387,417
19,904,25,0,1e-05,0.0001,0.468,437,467
19,1004,25,0,1e-05,0.0001,0.47,481,523
19,1104,25,0,1e-05,0.0001,0.464,528,576
19,1204,25,0,1e-05,0.0001,0.466,579,625
19,1304,25,0,1e-05,0.0001,0.476,627,677
19,1404,25,0,1e-05,0.0001,0.478,675,729
19,1504,25,0,1e-05,0.0001,0.488,733,771
19,1604,25,0,1e-05,0.0001,0.472,786,818
19,1704,25,0,1e-05,0.0001,0.474,838,866
19,1804,25,0,1e-05,0.0001,0.472,898,906
19,1904,25,0,1e-05,0.0001,0.474,952,952
20,0,25,0,1e-05,0.0001,0.508,0,0
20,104,25,0,1e-05,0.0001,0.508,53,51
20,204,25,0,1e-05,0.0001,0.51,96,108
20,304,25,0,1e-05,0.0001,0.508,147,157
20,404,25,0,1e-05,0.0001,0.512,196,208
20,504,25,0,1e-05,0.0001,0.516,243,261
20,604,25,0,1e-05,0.0001,0.514,290,314
20,704,25,0,1e-05,0.0001,0.518,339,365
20,804,25,0,1e-05,0.0001,0.518,393,411
20,904,25,0,1e-05,0.0001,0.516,447,457
20,1004,25,0,1e-05,0.0001,0.502,493,511
20,1104,25,0,1e-05,0.0001,0.51,543,561
20,1204,25,0,1e-05,0.0001,0.508,595,609
20,1304,25,0,1e-05,0.0001,0.51,639,665
20,1404,25,0,1e-05,0.0001,0.512,695,709
20,1504,25,0,1e-05,0.0001,0.518,754,750
20,1604,25,0,1e-05,0.0001,0.52,800,804
20,1704,25,0,1e-05,0.0001,0.522,849,855
20,1804,25,0,1e-05,0.0001,0.518,892,912
20,1904,25,0,1e-05,0.0001,0.522,952,952
1,0,25,0,1e-05,0.001,0.528,0,0
1,104,25,0,1e-05,0.001,0.534,50,54
1,204,25,0,1e-05,0.001,0.552,97,107
1,304,25,0,1e-05,0.001,0.562,154,150
1,404,25,0,1e-05,0.001,0.572,206,198
1,504,25,0,1e-05,0.001,0.546,264,240
1,604,25,0,1e-05,0.001,0.6,312,292
1,704,25,0,1e-05,0.001,0.612,358,346
1,804,25,0,1e-05,0.001,0.638,404,400
1,904,25,0,1e-05,0.001,0.634,451,453
1,1004,25,0,1e-05,0.001,0.644,500,504
1,1104,25,0,1e-05,0.001,0.666,555,549
1,1204,25,0,1e-05,0.001,0.696,604,600
1,1304,25,0,1e-05,0.001,0.73,651,653
1,1404,25,0,1e-05,0.001,0.764,697,707
1,1504,25,0,1e-05,0.001,0.788,749,755
1,1604,25,0,1e-05,0.001,0.832,803,801
1,1704,25,0,1e-05,0.001,0.864,848,856
1,1804,25,0,1e-05,0.001,0.9,895,909
1,1904,25,0,1e-05,0.001,0.918,952,952
2,0,25,0,1e-05,0.001,0.532,0,0
2,104,25,0,1e-05,0.001,0.54,48,56
2,204,25,0,1e-05,0.001,0.608,102,102
2,304,25,0,1e-05,0.001,0.682,149,155
2,404,25,0,1e-05,0.001,0.634,198,206
2,504,25,0,1e-05,0.001,0.646,249,255
2,604,25,0,1e-05,0.001,0.72,287,317
2,704,25,0,1e-05,0.001,0.718,339,365
2,804,25,0,1e-05,0.001,0.77,394,410
2,904,25,0,1e-05,0.001,0.772,443,461
2,1004,25,0,1e-05,0.001,0.784,485,519
2,1104,25,0,1e-05,0.001,0.812,539,565
2,1204,25,0,1e-05,0.001,0.83,597,607
2,1304,25,0,1e-05,0.001,0.85,645,659
2,1404,25,0,1e-05,0.001,0.886,705,699
2,1504,25,0,1e-05,0.001,0.908,749,755
2,1604,25,0,1e-05,0.001,0.926,800,804
2,1704,25,0,1e-05,0.001,0.946,848,856
2,1804,25,0,1e-05,0.001,0.956,895,909
2,1904,25,0,1e-05,0.001,0.958,952,952
3,0,25,0,1e-05,0.001,0.512,0,0
3,104,25,0,1e-05,0.001,0.516,44,60
3,204,25,0,1e-05,0.001,0.516,101,103
3,304,25,0,1e-05,0.001,0.568,153,151
3,404,25,0,1e-05,0.001,0.538,205,199
3,504,25,0,1e-05,0.001,0.536,252,252
3,604,25,0,1e-05,0.001,0.55,307,297
3,704,25,0,1e-05,0.001,0.568,353,351
3,804,25,0,1e-05,0.001,0.582,389,415
3,904,25,0,1e-05,0.001,0.586,444,460
3,1004,25,0,1e-05,0.001,0.6,487,517
3,1104,25,0,1e-05,0.001,0.61,537,567
3,1204,25,0,1e-05,0.001,0.624,598,606
3,1304,25,0,1e-05,0.001,0.62,656,648
3,1404,25,0,1e-05,0.001,0.646,703,701
3,1504,25,0,1e-05,0.001,0.688,751,753
3,1604,25,0,1e-05,0.001,0.724,802,802
3,1704,25,0,1e-05,0.001,0.762,853,851
3,1804,25,0,1e-05,0.001,0.796,894,910
3,1904,25,0,1e-05,0.001,0.816,952,952
4,0,25,0,1e-05,0.001,0.516,0,0
4,104,25,0,1e-05,0.001,0.518,57,47
4,204,25,0,1e-05,0.001,0.572,115,89
4,304,25,0,1e-05,0.001,0.596,160,144
4,404,25,0,1e-05,0.001,0.542,210,194
4,504,25,0,1e-05,0.001,0.56,258,246
4,604,25,0,1e-05,0.001,0.624,307,297
4,704,25,0,1e-05,0.001,0.622,368,336
4,804,25,0,1e-05,0.001,0.638,409,395
4,904,25,0,1e-05,0.001,0.622,459,445
4,1004,25,0,1e-05,0.001,0.646,512,492
4,1104,25,0,1e-05,0.001,0.676,560,544
4,1204,25,0,1e-05,0.001,0.696,605,599
4,1304,25,0,1e-05,0.001,0.73,653,651
4,1404,25,0,1e-05,0.001,0.748,703,701
4,1504,25,0,1e-05,0.001,0.776,753,751
4,1604,25,0,1e-05,0.001,0.786,801,803
4,1704,25,0,1e-05,0.001,0.806,848,856
4,1804,25,0,1e-05,0.001,0.832,899,905
4,1904,25,0,1e-05,0.001,0.858,952,952
5,0,25,0,1e-05,0.001,0.522,0,0
5,104,25,0,1e-05,0.001,0.526,54,50
5,204,25,0,1e-05,0.001,0.554,101,103
5,304,25,0,1e-05,0.001,0.624,158,146
5,404,25,0,1e-05,0.001,0.578,217,187
5,504,25,0,1e-05,0.001,0.58,264,240
5,604,25,0,1e-05,0.001,0.638,312,292
5,704,25,0,1e-05,0.001,0.662,371,333
5,804,25,0,1e-05,0.001,0.686,422,382
5,904,25,0,1e-05,0.001,0.694,472,432
5,1004,25,0,1e-05,0.001,0.72,511,493
5,1104,25,0,1e-05,0.001,0.738,559,545
5,1204,25,0,1e-05,0.001,0.766,611,593
5,1304,25,0,1e-05,0.001,0.782,659,645
5,1404,25,0,1e-05,0.001,0.802,719,685
5,1504,25,0,1e-05,0.001,0.838,771,733
5,1604,25,0,1e-05,0.001,0.874,820,784
5,1704,25,0,1e-05,0.001,0.904,865,839
5,1804,25,0,1e-05,0.001,0.918,906,898
5,1904,25,0,1e-05,0.001,0.942,952,952
6,0,25,0,1e-05,0.001,0.538,0,0
6,104,25,0,1e-05,0.001,0.54,50,54
6,204,25,0,1e-05,0.001,0.554,100,104
6,304,25,0,1e-05,0.001,0.574,155,149
6,404,25,0,1e-05,0.001,0.53,196,208
6,504,25,0,1e-05,0.001,0.536,248,256
6,604,25,0,1e-05,0.001,0.594,291,313
6,704,25,0,1e-05,0.001,0.604,340,364
6,804,25,0,1e-05,0.001,0.612,392,412
6,904,25,0,1e-05,0.001,0.614,447,457
6,1004,25,0,1e-05,0.001,0.64,492,512
6,1104,25,0,1e-05,0.001,0.65,546,558
6,1204,25,0,1e-05,0.001,0.66,594,610
6,1304,25,0,1e-05,0.001,0.68,649,655
6,1404,25,0,1e-05,0.001,0.7,703,701
6,1504,25,0,1e-05,0.001,0.742,749,755
6,1604,25,0,1e-05,0.001,0.752,795,809
6,1704,25,0,1e-05,0.001,0.782,848,856
6,1804,25,0,1e-05,0.001,0.8,899,905
6,1904,25,0,1e-05,0.001,0.84,952,952
7,0,25,0,1e-05,0.001,0.532,0,0
7,104,25,0,1e-05,0.001,0.532,41,63
7,204,25,0,1e-05,0.001,0.562,95,109
7,304,25,0,1e-05,0.001,0.614,149,155
7,404,25,0,1e-05,0.001,0.606,198,206
7,504,25,0,1e-05,0.001,0.584,253,251
7,604,25,0,1e-05,0.001,0.62,303,301
7,704,25,0,1e-05,0.001,0.666,355,349
7,804,25,0,1e-05,0.001,0.684,403,401
7,904,25,0,1e-05,0.001,0.72,452,452
7,1004,25,0,1e-05,0.001,0.732,507,497
7,1104,25,0,1e-05,0.001,0.752,552,552
7,1204,25,0,1e-05,0.001,0.776,610,594
7,1304,25,0,1e-05,0.001,0.794,657,647
7,1404,25,0,1e-05,0.001,0.814,702,702
7,1504,25,0,1e-05,0.001,0.822,750,754
7,1604,25,0,1e-05,0.001,0.846,799,805
7,1704,25,0,1e-05,0.001,0.88,856,848
7,1804,25,0,1e-05,0.001,0.888,907,897
7,1904,25,0,1e-05,0.001,0.908,952,952
8,0,25,0,1e-05,0.001,0.534,0,0
8,104,25,0,1e-05,0.001,0.538,57,47
8,204,25,0,1e-05,0.001,0.562,109,95
8,304,25,0,1e-05,0.001,0.586,160,144
8,404,25,0,1e-05,0.001,0.558,212,192
8,504,25,0,1e-05,0.001,0.536,268,236
8,604,25,0,1e-05,0.001,0.576,309,295
8,704,25,0,1e-05,0.001,0.638,362,342
8,804,25,0,1e-05,0.001,0.65,411,393
8,904,25,0,1e-05,0.001,0.666,458,446
8,1004,25,0,1e-05,0.001,0.688,498,506
8,1104,25,0,1e-05,0.001,0.706,554,550
8,1204,25,0,1e-05,0.001,0.726,608,596
8,1304,25,0,1e-05,0.001,0.758,658,646
8,1404,25,0,1e-05,0.001,0.794,709,695
8,1504,25,0,1e-05,0.001,0.818,765,739
8,1604,25,0,1e-05,0.001,0.852,802,802
8,1704,25,0,1e-05,0.001,0.892,841,863
8,1804,25,0,1e-05,0.001,0.914,900,904
8,1904,25,0,1e-05,0.001,0.938,952,952
9,0,25,0,1e-05,0.001,0.548,0,0
9,104,25,0,1e-05,0.001,0.55,53,51
9,204,25,0,1e-05,0.001,0.562,105,99
9,304,25,0,1e-05,0.001,0.598,156,148
9,404,25,0,1e-05,0.001,0.566,208,196
9,504,25,0,1e-05,0.001,0.556,258,246
9,604,25,0,1e-05,0.001,0.596,316,288
9,704,25,0,1e-05,0.001,0.624,367,337
9,804,25,0,1e-05,0.001,0.612,416,388
9,904,25,0,1e-05,0.001,0.618,473,431
9,1004,25,0,1e-05,0.001,0.624,513,491
9,1104,25,0,1e-05,0.001,0.668,563,541
9,1204,25,0,1e-05,0.001,0.68,620,584
9,1304,25,0,1e-05,0.001,0.688,665,639
9,1404,25,0,1e-05,0.001,0.722,717,687
9,1504,25,0,1e-05,0.001,0.742,768,736
9,1604,25,0,1e-05,0.001,0.782,812,792
9,1704,25,0,1e-05,0.001,0.82,861,843
9,1804,25,0,1e-05,0.001,0.858,904,900
9,1904,25,0,1e-05,0.001,0.866,952,952
10,0,25,0,1e-05,0.001,0.522,0,0
10,104,25,0,1e-05,0.001,0.518,43,61
10,204,25,0,1e-05,0.001,0.538,95,109
10,304,25,0,1e-05,0.001,0.584,154,150
10,404,25,0,1e-05,0.001,0.584,199,205
10,504,25,0,1e-05,0.001,0.578,245,259
10,604,25,0,1e-05,0.001,0.6,294,310
10,704,25,0,1e-05,0.001,0.604,340,364
10,804,25,0,1e-05,0.001,0.608,386,418
10,904,25,0,1e-05,0.001,0.642,438,466
10,1004,25,0,1e-05,0.001,0.65,479,525
10,1104,25,0,1e-05,0.001,0.66,538,566
10,1204,25,0,1e-05,0.001,0.698,595,609
10,1304,25,0,1e-05,0.001,0.72,644,660
10,1404,25,0,1e-05,0.001,0.738,698,706
10,1504,25,0,1e-05,0.001,0.758,744,760
10,1604,25,0,1e-05,0.001,0.774,797,807
10,1704,25,0,1e-05,0.001,0.814,847,857
10,1804,25,0,1e-05,0.001,0.838,894,910
10,1904,25,0,1e-05,0.001,0.862,952,952
11,0,25,0,1e-05,0.001,0.524,0,0
11,104,25,0,1e-05,0.001,0.526,53,51
11,204,25,0,1e-05,0.001,0.542,96,108
11,304,25,0,1e-05,0.001,0.59,144,160
11,404,25,0,1e-05,0.001,0.564,191,213
11,504,25,0,1e-05,0.001,0.558,237,267
11,604,25,0,1e-05,0.001,0.588,289,315
11,704,25,0,1e-05,0.001,0.618,336,368
11,804,25,0,1e-05,0.001,0.632,386,418
11,904,25,0,1e-05,0.001,0.618,436,468
11,1004,25,0,1e-05,0.001,0.65,492,512
11,1104,25,0,1e-05,0.001,0.676,534,570
11,1204,25,0,1e-05,0.001,0.704,585,619
11,1304,25,0,1e-05,0.001,0.732,639,665
11,1404,25,0,1e-05,0.001,0.752,685,719
11,1504,25,0,1e-05,0.001,0.76,745,759
11,1604,25,0,1e-05,0.001,0.786,799,805
11,1704,25,0,1e-05,0.001,0.82,847,857
11,1804,25,0,1e-05,0.001,0.852,900,904
11,1904,25,0,1e-05,0.001,0.886,952,952
12,0,25,0,1e-05,0.001,0.522,0,0
12,104,25,0,1e-05,0.001,0.532,56,48
12,204,25,0,1e-05,0.001,0.578,103,101
12,304,25,0,1e-05,0.001,0.676,156,148
12,404,25,0,1e-05,0.001,0.668,208,196
12,504,25,0,1e-05,0.001,0.648,255,249
12,604,25,0,1e-05,0.001,0.698,303,301
12,704,25,0,1e-05,0.001,0.726,356,348
12,804,25,0,1e-05,0.001,0.742,400,404
12,904,25,0,1e-05,0.001,0.772,450,454
12,1004,25,0,1e-05,0.001,0.804,500,504
12,1104,25,0,1e-05,0.001,0.822,550,554
12,1204,25,0,1e-05,0.001,0.84,595,609
12,1304,25,0,1e-05,0.001,0.86,649,655
12,1404,25,0,1e-05,0.001,0.872,701,703
12,1504,25,0,1e-05,0.001,0.89,746,758
12,1604,25,0,1e-05,0.001,0.918,794,810
12,1704,25,0,1e-05,0.001,0.934,846,858
12,1804,25,0,1e-05,0.001,0.95,898,906
12,1904,25,0,1e-05,0.001,0.952,952,952
13,0,25,0,1e-05,0.001,0.51,0,0
13,104,25,0,1e-05,0.001,0.516,48,56
13,204,25,0,1e-05,0.001,0.548,104,100
13,304,25,0,1e-05,0.001,0.634,154,150
13,404,25,0,1e-05,0.001,0.622,199,205
13,504,25,0,1e-05,0.001,0.614,248,256
13,604,25,0,1e-05,0.001,0.66,296,308
13,704,25,0,1e-05,0.001,0.654,348,356
13,804,25,0,1e-05,0.001,0.666,392,412
13,904,25,0,1e-05,0.001,0.668,436,468
13,1004,25,0,1e-05,0.001,0.692,486,518
13,1104,25,0,1e-05,0.001,0.712,537,567
13,1204,25,0,1e-05,0.001,0.738,582,622
13,1304,25,0,1e-05,0.001,0.762,633,671
13,1404,25,0,1e-05,0.001,0.778,686,718
13,1504,25,0,1e-05,0.001,0.8,733,771
13,1604,25,0,1e-05,0.001,0.842,792,812
13,1704,25,0,1e-05,0.001,0.872,855,849
13,1804,25,0,1e-05,0.001,0.896,898,906
13,1904,25,0,1e-05,0.001,0.926,952,952
14,0,25,0,1e-05,0.001,0.53,0,0
14,104,25,0,1e-05,0.001,0.536,53,51
14,204,25,0,1e-05,0.001,0.536,107,97
14,304,25,0,1e-05,0.001,0.538,162,142
14,404,25,0,1e-05,0.001,0.526,206,198
14,504,25,0,1e-05,0.001,0.526,258,246
14,604,25,0,1e-05,0.001,0.556,318,286
14,704,25,0,1e-05,0.001,0.558,361,343
14,804,25,0,1e-05,0.001,0.58,405,399
14,904,25,0,1e-05,0.001,0.578,456,448
14,1004,25,0,1e-05,0.001,0.602,506,498
14,1104,25,0,1e-05,0.001,0.63,548,556
14,1204,25,0,1e-05,0.001,0.65,596,608
14,1304,25,0,1e-05,0.001,0.666,649,655
14,1404,25,0,1e-05,0.001,0.708,708,696
14,1504,25,0,1e-05,0.001,0.724,756,748
14,1604,25,0,1e-05,0.001,0.756,806,798
14,1704,25,0,1e-05,0.001,0.79,853,851
14,1804,25,0,1e-05,0.001,0.832,901,903
14,1904,25,0,1e-05,0.001,0.856,952,952
15,0,25,0,1e-05,0.001,0.554,0,0
15,104,25,0,1e-05,0.001,0.56,47,57
15,204,25,0,1e-05,0.001,0.562,96,108
15,304,25,0,1e-05,0.001,0.56,148,156
15,404,25,0,1e-05,0.001,0.556,195,209
15,504,25,0,1e-05,0.001,0.558,240,264
15,604,25,0,1e-05,0.001,0.582,285,319
15,704,25,0,1e-05,0.001,0.57,335,369
15,804,25,0,1e-05,0.001,0.58,392,412
15,904,25,0,1e-05,0.001,0.61,446,458
15,1004,25,0,1e-05,0.001,0.614,498,506
15,1104,25,0,1e-05,0.001,0.626,545,559
15,1204,25,0,1e-05,0.001,0.642,581,623
15,1304,25,0,1e-05,0.001,0.662,631,673
15,1404,25,0,1e-05,0.001,0.68,679,725
15,1504,25,0,1e-05,0.001,0.7,732,772
15,1604,25,0,1e-05,0.001,0.72,788,816
15,1704,25,0,1e-05,0.001,0.75,845,859
15,1804,25,0,1e-05,0.001,0.788,898,906
15,1904,25,0,1e-05,0.001,0.818,952,952
16,0,25,0,1e-05,0.001,0.522,0,0
16,104,25,0,1e-05,0.001,0.524,48,56
16,204,25,0,1e-05,0.001,0.53,106,98
16,304,25,0,1e-05,0.001,0.526,160,144
16,404,25,0,1e-05,0.001,0.522,210,194
16,504,25,0,1e-05,0.001,0.536,258,246
16,604,25,0,1e-05,0.001,0.544,311,293
16,704,25,0,1e-05,0.001,0.55,363,341
16,804,25,0,1e-05,0.001,0.55,412,392
16,904,25,0,1e-05,0.001,0.576,462,442
16,1004,25,0,1e-05,0.001,0.58,512,492
16,1104,25,0,1e-05,0.001,0.578,556,548
16,1204,25,0,1e-05,0.001,0.6,603,601
16,1304,25,0,1e-05,0.001,0.596,645,659
16,1404,25,0,1e-05,0.001,0.624,698,706
16,1504,25,0,1e-05,0.001,0.664,746,758
16,1604,25,0,1e-05,0.001,0.686,800,804
16,1704,25,0,1e-05,0.001,0.716,849,855
16,1804,25,0,1e-05,0.001,0.738,905,899
16,1904,25,0,1e-05,0.001,0.784,952,952
17,0,25,0,1e-05,0.001,0.524,0,0
17,104,25,0,1e-05,0.001,0.53,61,43
17,204,25,0,1e-05,0.001,0.57,114,90
17,304,25,0,1e-05,0.001,0.608,166,138
17,404,25,0,1e-05,0.001,0.584,212,192
17,504,25,0,1e-05,0.001,0.566,264,240
17,604,25,0,1e-05,0.001,0.598,324,280
17,704,25,0,1e-05,0.001,0.63,371,333
17,804,25,0,1e-05,0.001,0.656,422,382
17,904,25,0,1e-05,0.001,0.68,469,435
17,1004,25,0,1e-05,0.001,0.696,519,485
17,1104,25,0,1e-05,0.001,0.696,572,532
17,1204,25,0,1e-05,0.001,0.72,619,585
17,1304,25,0,1e-05,0.001,0.744,666,638
17,1404,25,0,1e-05,0.001,0.766,711,693
17,1504,25,0,1e-05,0.001,0.806,758,746
17,1604,25,0,1e-05,0.001,0.846,807,797
17,1704,25,0,1e-05,0.001,0.874,856,848
17,1804,25,0,1e-05,0.001,0.916,898,906
17,1904,25,0,1e-05,0.001,0.928,952,952
18,0,25,0,1e-05,0.001,0.508,0,0
18,104,25,0,1e-05,0.001,0.508,52,52
18,204,25,0,1e-05,0.001,0.53,101,103
18,304,25,0,1e-05,0.001,0.55,152,152
18,404,25,0,1e-05,0.001,0.528,204,200
18,504,25,0,1e-05,0.001,0.524,253,251
18,604,25,0,1e-05,0.001,0.556,299,305
18,704,25,0,1e-05,0.001,0.548,344,360
18,804,25,0,1e-05,0.001,0.564,397,407
18,904,25,0,1e-05,0.001,0.572,451,453
18,1004,25,0,1e-05,0.001,0.576,508,496
18,1104,25,0,1e-05,0.001,0.58,550,554
18,1204,25,0,1e-05,0.001,0.59,610,594
18,1304,25,0,1e-05,0.001,0.614,659,645
18,1404,25,0,1e-05,0.001,0.63,707,697
18,1504,25,0,1e-05,0.001,0.65,760,744
18,1604,25,0,1e-05,0.001,0.674,801,803
18,1704,25,0,1e-05,0.001,0.726,848,856
18,1804,25,0,1e-05,0.001,0.762,901,903
18,1904,25,0,1e-05,0.001,0.798,952,952
19,0,25,0,1e-05,0.001,0.522,0,0
19,104,25,0,1e-05,0.001,0.536,65,39
19,204,25,0,1e-05,0.001,0.572,113,91
19,304,25,0,1e-05,0.001,0.612,164,140
19,404,25,0,1e-05,0.001,0.59,208,196
19,504,25,0,1e-05,0.001,0.594,257,247
19,604,25,0,1e-05,0.001,0.638,306,298
19,704,25,0,1e-05,0.001,0.624,360,344
19,804,25,0,1e-05,0.001,0.676,410,394
19,904,25,0,1e-05,0.001,0.704,465,439
19,1004,25,0,1e-05,0.001,0.718,518,486
19,1104,25,0,1e-05,0.001,0.748,572,532
19,1204,25,0,1e-05,0.001,0.77,610,594
19,1304,25,0,1e-05,0.001,0.804,661,643
19,1404,25,0,1e-05,0.001,0.826,716,688
19,1504,25,0,1e-05,0.001,0.862,766,738
19,1604,25,0,1e-05,0.001,0.896,807,797
19,1704,25,0,1e-05,0.001,0.918,856,848
19,1804,25,0,1e-05,0.001,0.934,899,905
19,1904,25,0,1e-05,0.001,0.958,952,952
20,0,25,0,1e-05,0.001,0.54,0,0
20,104,25,0,1e-05,0.001,0.546,56,48
20,204,25,0,1e-05,0.001,0.574,109,95
20,304,25,0,1e-05,0.001,0.582,158,146
20,404,25,0,1e-05,0.001,0.538,218,186
20,504,25,0,1e-05,0.001,0.54,260,244
20,604,25,0,1e-05,0.001,0.6,310,294
20,704,25,0,1e-05,0.001,0.594,361,343
20,804,25,0,1e-05,0.001,0.616,403,401
20,904,25,0,1e-05,0.001,0.614,451,453
20,1004,25,0,1e-05,0.001,0.64,495,509
20,1104,25,0,1e-05,0.001,0.666,539,565
20,1204,25,0,1e-05,0.001,0.698,590,614
20,1304,25,0,1e-05,0.001,0.718,639,665
20,1404,25,0,1e-05,0.001,0.74,697,707
20,1504,25,0,1e-05,0.001,0.772,743,761
20,1604,25,0,1e-05,0.001,0.8,800,804
20,1704,25,0,1e-05,0.001,0.82,850,854
20,1804,25,0,1e-05,0.001,0.854,901,903
20,1904,25,0,1e-05,0.001,0.88,952,952
1,0,25,0,1e-05,0.01,0.5,0,0
1,104,25,0,1e-05,0.01,0.55,46,58
1,204,25,0,1e-05,0.01,0.548,101,103
1,304,25,0,1e-05,0.01,0.644,147,157
1,404,25,0,1e-05,0.01,0.6,192,212
1,504,25,0,1e-05,0.01,0.676,237,267
1,604,25,0,1e-05,0.01,0.666,287,317
1,704,25,0,1e-05,0.01,0.71,333,371
1,804,25,0,1e-05,0.01,0.728,380,424
1,904,25,0,1e-05,0.01,0.756,433,471
1,1004,25,0,1e-05,0.01,0.772,479,525
1,1104,25,0,1e-05,0.01,0.804,526,578
1,1204,25,0,1e-05,0.01,0.84,578,626
1,1304,25,0,1e-05,0.01,0.848,642,662
1,1404,25,0,1e-05,0.01,0.864,693,711
1,1504,25,0,1e-05,0.01,0.89,739,765
1,1604,25,0,1e-05,0.01,0.91,789,815
1,1704,25,0,1e-05,0.01,0.934,842,862
1,1804,25,0,1e-05,0.01,0.946,899,905
1,1904,25,0,1e-05,0.01,0.944,952,952
2,0,25,0,1e-05,0.01,0.5,0,0
2,104,25,0,1e-05,0.01,0.544,60,44
2,204,25,0,1e-05,0.01,0.514,111,93
2,304,25,0,1e-05,0.01,0.554,158,146
2,404,25,0,1e-05,0.01,0.558,204,200
2,504,25,0,1e-05,0.01,0.568,256,248
2,604,25,0,1e-05,0.01,0.55,306,298
2,704,25,0,1e-05,0.01,0.588,361,343
2,804,25,0,1e-05,0.01,0.614,407,397
2,904,25,0,1e-05,0.01,0.628,457,447
2,1004,25,0,1e-05,0.01,0.616,504,500
2,1104,25,0,1e-05,0.01,0.62,555,549
2,1204,25,0,1e-05,0.01,0.624,602,602
2,1304,25,0,1e-05,0.01,0.646,644,660
2,1404,25,0,1e-05,0.01,0.664,692,712
2,1504,25,0,1e-05,0.01,0.67,735,769
2,1604,25,0,1e-05,0.01,0.684,789,815
2,1704,25,0,1e-05,0.01,0.708,844,860
2,1804,25,0,1e-05,0.01,0.716,897,907
2,1904,25,0,1e-05,0.01,0.73,952,952
3,0,25,0,1e-05,0.01,0.506,0,0
3,104,25,0,1e-05,0.01,0.56,46,58
3,204,25,0,1e-05,0.01,0.524,97,107
3,304,25,0,1e-05,0.01,0.608,148,156
3,404,25,0,1e-05,0.01,0.584,201,203
3,504,25,0,1e-05,0.01,0.588,247,257
3,604,25,0,1e-05,0.01,0.604,295,309
3,704,25,0,1e-05,0.01,0.614,342,362
3,804,25,0,1e-05,0.01,0.628,396,408
3,904,25,0,1e-05,0.01,0.658,448,456
3,1004,25,0,1e-05,0.01,0.684,500,504
3,1104,25,0,1e-05,0.01,0.69,550,554
3,1204,25,0,1e-05,0.01,0.746,601,603
3,1304,25,0,1e-05,0.01,0.762,650,654
3,1404,25,0,1e-05,0.01,0.798,710,694
3,1504,25,0,1e-05,0.01,0.834,755,749
3,1604,25,0,1e-05,0.01,0.854,800,804
3,1704,25,0,1e-05,0.01,0.856,851,853
3,1804,25,0,1e-05,0.01,0.886,904,900
3,1904,25,0,1e-05,0.01,0.91,952,952
4,0,25,0,1e-05,0.01,0.5,0,0
4,104,25,0,1e-05,0.01,0.518,48,56
4,204,25,0,1e-05,0.01,0.546,87,117
4,304,25,0,1e-05,0.01,0.624,131,173
4,404,25,0,1e-05,0.01,0.552,182,222
4,504,25,0,1e-05,0.01,0.644,235,269
4,604,25,0,1e-05,0.01,0.602,294,310
4,704,25,0,1e-05,0.01,0.662,347,357
4,804,25,0,1e-05,0.01,0.648,402,402
4,904,25,0,1e-05,0.01,0.66,449,455
4,1004,25,0,1e-05,0.01,0.686,503,501
4,1104,25,0,1e-05,0.01,0.724,544,560
4,1204,25,0,1e-05,0.01,0.754,598,606
4,1304,25,0,1e-05,0.01,0.778,649,655
4,1404,25,0,1e-05,0.01,0.806,705,699
4,1504,25,0,1e-05,0.01,0.832,762,742
4,1604,25,0,1e-05,0.01,0.856,810,794
4,1704,25,0,1e-05,0.01,0.862,860,844
4,1804,25,0,1e-05,0.01,0.89,912,892
4,1904,25,0,1e-05,0.01,0.888,952,952
5,0,25,0,1e-05,0.01,0.502,0,0
5,104,25,0,1e-05,0.01,0.546,44,60
5,204,25,0,1e-05,0.01,0.534,100,104
5,304,25,0,1e-05,0.01,0.61,152,152
5,404,25,0,1e-05,0.01,0.576,202,202
5,504,25,0,1e-05,0.01,0.626,245,259
5,604,25,0,1e-05,0.01,0.592,299,305
5,704,25,0,1e-05,0.01,0.65,341,363
5,804,25,0,1e-05,0.01,0.668,398,406
5,904,25,0,1e-05,0.01,0.652,448,456
5,1004,25,0,1e-05,0.01,0.674,496,508
5,1104,25,0,1e-05,0.01,0.68,540,564
5,1204,25,0,1e-05,0.01,0.694,592,612
5,1304,25,0,1e-05,0.01,0.714,648,656
5,1404,25,0,1e-05,0.01,0.748,698,706
5,1504,25,0,1e-05,0.01,0.792,744,760
5,1604,25,0,1e-05,0.01,0.814,795,809
5,1704,25,0,1e-05,0.01,0.844,854,850
5,1804,25,0,1e-05,0.01,0.864,899,905
5,1904,25,0,1e-05,0.01,0.89,952,952
6,0,25,0,1e-05,0.01,0.528,0,0
6,104,25,0,1e-05,0.01,0.618,49,55
6,204,25,0,1e-05,0.01,0.552,99,105
6,304,25,0,1e-05,0.01,0.634,149,155
6,404,25,0,1e-05,0.01,0.654,207,197
6,504,25,0,1e-05,0.01,0.672,263,241
6,604,25,0,1e-05,0.01,0.61,325,279
6,704,25,0,1e-05,0.01,0.658,371,333
6,804,25,0,1e-05,0.01,0.688,419,385
6,904,25,0,1e-05,0.01,0.68,465,439
6,1004,25,0,1e-05,0.01,0.73,510,494
6,1104,25,0,1e-05,0.01,0.738,560,544
6,1204,25,0,1e-05,0.01,0.776,614,590
6,1304,25,0,1e-05,0.01,0.804,658,646
6,1404,25,0,1e-05,0.01,0.83,703,701
6,1504,25,0,1e-05,0.01,0.86,755,749
6,1604,25,0,1e-05,0.01,0.874,808,796
6,1704,25,0,1e-05,0.01,0.9,864,840
6,1804,25,0,1e-05,0.01,0.916,911,893
6,1904,25,0,1e-05,0.01,0.934,952,952
7,0,25,0,1e-05,0.01,0.508,0,0
7,104,25,0,1e-05,0.01,0.542,58,46
7,204,25,0,1e-05,0.01,0.54,100,104
7,304,25,0,1e-05,0.01,0.57,145,159
7,404,25,0,1e-05,0.01,0.57,200,204
7,504,25,0,1e-05,0.01,0.6,250,254
7,604,25,0,1e-05,0.01,0.596,302,302
7,704,25,0,1e-05,0.01,0.672,349,355
7,804,25,0,1e-05,0.01,0.68,400,404
7,904,25,0,1e-05,0.01,0.71,445,459
7,1004,25,0,1e-05,0.01,0.71,497,507
7,1104,25,0,1e-05,0.01,0.756,552,552
7,1204,25,0,1e-05,0.01,0.788,609,595
7,1304,25,0,1e-05,0.01,0.806,661,643
7,1404,25,0,1e-05,0.01,0.824,716,688
7,1504,25,0,1e-05,0.01,0.842,759,745
7,1604,25,0,1e-05,0.01,0.864,811,793
7,1704,25,0,1e-05,0.01,0.894,860,844
7,1804,25,0,1e-05,0.01,0.912,912,892
7,1904,25,0,1e-05,0.01,0.924,952,952
8,0,25,0,1e-05,0.01,0.5,0,0
8,104,25,0,1e-05,0.01,0.542,57,47
8,204,25,0,1e-05,0.01,0.534,106,98
8,304,25,0,1e-05,0.01,0.61,159,145
8,404,25,0,1e-05,0.01,0.57,207,197
8,504,25,0,1e-05,0.01,0.602,262,242
8,604,25,0,1e-05,0.01,0.602,316,288
8,704,25,0,1e-05,0.01,0.636,369,335
8,804,25,0,1e-05,0.01,0.672,414,390
8,904,25,0,1e-05,0.01,0.688,460,444
8,1004,25,0,1e-05,0.01,0.718,508,496
8,1104,25,0,1e-05,0.01,0.734,561,543
8,1204,25,0,1e-05,0.01,0.77,617,587
8,1304,25,0,1e-05,0.01,0.798,660,644
8,1404,25,0,1e-05,0.01,0.806,713,691
8,1504,25,0,1e-05,0.01,0.832,761,743
8,1604,25,0,1e-05,0.01,0.868,806,798
8,1704,25,0,1e-05,0.01,0.896,858,846
8,1804,25,0,1e-05,0.01,0.912,905,899
8,1904,25,0,1e-05,0.01,0.928,952,952
9,0,25,0,1e-05,0.01,0.5,0,0
9,104,25,0,1e-05,0.01,0.552,51,53
9,204,25,0,1e-05,0.01,0.506,101,103
9,304,25,0,1e-05,0.01,0.6,149,155
9,404,25,0,1e-05,0.01,0.594,201,203
9,504,25,0,1e-05,0.01,0.656,257,247
9,604,25,0,1e-05,0.01,0.644,305,299
9,704,25,0,1e-05,0.01,0.662,354,350
9,804,25,0,1e-05,0.01,0.658,401,403
9,904,25,0,1e-05,0.01,0.682,446,458
9,1004,25,0,1e-05,0.01,0.684,500,504
9,1104,25,0,1e-05,0.01,0.698,555,549
9,1204,25,0,1e-05,0.01,0.724,611,593
9,1304,25,0,1e-05,0.01,0.756,659,645
9,1404,25,0,1e-05,0.01,0.768,706,698
9,1504,25,0,1e-05,0.01,0.788,760,744
9,1604,25,0,1e-05,0.01,0.83,805,799
9,1704,25,0,1e-05,0.01,0.842,855,849
9,1804,25,0,1e-05,0.01,0.862,908,896
9,1904,25,0,1e-05,0.01,0.9,952,952
10,0,25,0,1e-05,0.01,0.502,0,0
10,104,25,0,1e-05,0.01,0.542,59,45
10,204,25,0,1e-05,0.01,0.506,110,94
10,304,25,0,1e-05,0.01,0.58,156,148
10,404,25,0,1e-05,0.01,0.57,210,194
10,504,25,0,1e-05,0.01,0.616,262,242
10,604,25,0,1e-05,0.01,0.6,317,287
10,704,25,0,1e-05,0.01,0.644,363,341
10,804,25,0,1e-05,0.01,0.662,407,397
10,904,25,0,1e-05,0.01,0.676,457,447
10,1004,25,0,1e-05,0.01,0.7,500,504
10,1104,25,0,1e-05,0.01,0.716,550,554
10,1204,25,0,1e-05,0.01,0.73,606,598
10,1304,25,0,1e-05,0.01,0.756,640,664
10,1404,25,0,1e-05,0.01,0.762,691,713
10,1504,25,0,1e-05,0.01,0.792,746,758
10,1604,25,0,1e-05,0.01,0.824,798,806
10,1704,25,0,1e-05,0.01,0.862,851,853
10,1804,25,0,1e-05,0.01,0.882,901,903
10,1904,25,0,1e-05,0.01,0.882,952,952
11,0,25,0,1e-05,0.01,0.504,0,0
11,104,25,0,1e-05,0.01,0.548,46,58
11,204,25,0,1e-05,0.01,0.548,98,106
11,304,25,0,1e-05,0.01,0.628,146,158
11,404,25,0,1e-05,0.01,0.61,188,216
11,504,25,0,1e-05,0.01,0.594,238,266
11,604,25,0,1e-05,0.01,0.618,303,301
11,704,25,0,1e-05,0.01,0.63,360,344
11,804,25,0,1e-05,0.01,0.658,406,398
11,904,25,0,1e-05,0.01,0.712,457,447
11,1004,25,0,1e-05,0.01,0.736,510,494
11,1104,25,0,1e-05,0.01,0.77,554,550
11,1204,25,0,1e-05,0.01,0.788,612,592
11,1304,25,0,1e-05,0.01,0.802,669,635
11,1404,25,0,1e-05,0.01,0.82,718,686
11,1504,25,0,1e-05,0.01,0.826,766,738
11,1604,25,0,1e-05,0.01,0.848,807,797
11,1704,25,0,1e-05,0.01,0.874,862,842
11,1804,25,0,1e-05,0.01,0.874,905,899
11,1904,25,0,1e-05,0.01,0.896,952,952
12,0,25,0,1e-05,0.01,0.502,0,0
12,104,25,0,1e-05,0.01,0.528,53,51
12,204,25,0,1e-05,0.01,0.504,109,95
12,304,25,0,1e-05,0.01,0.53,162,142
12,404,25,0,1e-05,0.01,0.548,212,192
12,504,25,0,1e-05,0.01,0.572,250,254
12,604,25,0,1e-05,0.01,0.574,302,302
12,704,25,0,1e-05,0.01,0.596,344,360
12,804,25,0,1e-05,0.01,0.646,397,407
12,904,25,0,1e-05,0.01,0.688,458,446
12,1004,25,0,1e-05,0.01,0.688,509,495
12,1104,25,0,1e-05,0.01,0.698,552,552
12,1204,25,0,1e-05,0.01,0.696,608,596
12,1304,25,0,1e-05,0.01,0.708,649,655
12,1404,25,0,1e-05,0.01,0.718,703,701
12,1504,25,0,1e-05,0.01,0.754,758,746
12,1604,25,0,1e-05,0.01,0.77,812,792
12,1704,25,0,1e-05,0.01,0.81,857,847
12,1804,25,0,1e-05,0.01,0.834,911,893
12,1904,25,0,1e-05,0.01,0.862,952,952
13,0,25,0,1e-05,0.01,0.502,0,0
13,104,25,0,1e-05,0.01,0.524,54,50
13,204,25,0,1e-05,0.01,0.52,108,96
13,304,25,0,1e-05,0.01,0.576,149,155
13,404,25,0,1e-05,0.01,0.574,199,205
13,504,25,0,1e-05,0.01,0.62,242,262
13,604,25,0,1e-05,0.01,0.594,292,312
13,704,25,0,1e-05,0.01,0.648,344,360
13,804,25,0,1e-05,0.01,0.652,393,411
13,904,25,0,1e-05,0.01,0.664,444,460
13,1004,25,0,1e-05,0.01,0.684,502,502
13,1104,25,0,1e-05,0.01,0.704,552,552
13,1204,25,0,1e-05,0.01,0.718,602,602
13,1304,25,0,1e-05,0.01,0.764,659,645
13,1404,25,0,1e-05,0.01,0.778,714,690
13,1504,25,0,1e-05,0.01,0.814,768,736
13,1604,25,0,1e-05,0.01,0.844,815,789
13,1704,25,0,1e-05,0.01,0.874,865,839
13,1804,25,0,1e-05,0.01,0.886,909,895
13,1904,25,0,1e-05,0.01,0.912,952,952
14,0,25,0,1e-05,0.01,0.5,0,0
14,104,25,0,1e-05,0.01,0.562,51,53
14,204,25,0,1e-05,0.01,0.544,89,115
14,304,25,0,1e-05,0.01,0.63,147,157
14,404,25,0,1e-05,0.01,0.618,195,209
14,504,25,0,1e-05,0.01,0.604,254,250
14,604,25,0,1e-05,0.01,0.642,313,291
14,704,25,0,1e-05,0.01,0.652,367,337
14,804,25,0,1e-05,0.01,0.692,415,389
14,904,25,0,1e-05,0.01,0.698,458,446
14,1004,25,0,1e-05,0.01,0.708,512,492
14,1104,25,0,1e-05,0.01,0.742,560,544
14,1204,25,0,1e-05,0.01,0.758,608,596
14,1304,25,0,1e-05,0.01,0.788,666,638
14,1404,25,0,1e-05,0.01,0.812,719,685
14,1504,25,0,1e-05,0.01,0.826,767,737
14,1604,25,0,1e-05,0.01,0.854,809,795
14,1704,25,0,1e-05,0.01,0.868,855,849
14,1804,25,0,1e-05,0.01,0.878,905,899
14,1904,25,0,1e-05,0.01,0.88,952,952
15,0,25,0,1e-05,0.01,0.504,0,0
15,104,25,0,1e-05,0.01,0.542,52,52
15,204,25,0,1e-05,0.01,0.566,107,97
15,304,25,0,1e-05,0.01,0.612,148,156
15,404,25,0,1e-05,0.01,0.572,198,206
15,504,25,0,1e-05,0.01,0.62,246,258
15,604,25,0,1e-05,0.01,0.632,299,305
15,704,25,0,1e-05,0.01,0.65,350,354
15,804,25,0,1e-05,0.01,0.668,393,411
15,904,25,0,1e-05,0.01,0.688,444,460
15,1004,25,0,1e-05,0.01,0.708,495,509
15,1104,25,0,1e-05,0.01,0.728,537,567
15,1204,25,0,1e-05,0.01,0.732,579,625
15,1304,25,0,1e-05,0.01,0.76,632,672
15,1404,25,0,1e-05,0.01,0.78,679,725
15,1504,25,0,1e-05,0.01,0.804,726,778
15,1604,25,0,1e-05,0.01,0.82,780,824
15,1704,25,0,1e-05,0.01,0.836,839,865
15,1804,25,0,1e-05,0.01,0.852,901,903
15,1904,25,0,1e-05,0.01,0.856,952,952
16,0,25,0,1e-05,0.01,0.5,0,0
16,104,25,0,1e-05,0.01,0.538,52,52
16,204,25,0,1e-05,0.01,0.548,101,103
16,304,25,0,1e-05,0.01,0.646,147,157
16,404,25,0,1e-05,0.01,0.594,186,218
16,504,25,0,1e-05,0.01,0.652,241,263
16,604,25,0,1e-05,0.01,0.656,285,319
16,704,25,0,1e-05,0.01,0.634,332,372
16,804,25,0,1e-05,0.01,0.65,390,414
16,904,25,0,1e-05,0.01,0.672,440,464
16,1004,25,0,1e-05,0.01,0.676,497,507
16,1104,25,0,1e-05,0.01,0.684,552,552
16,1204,25,0,1e-05,0.01,0.694,597,607
16,1304,25,0,1e-05,0.01,0.714,641,663
16,1404,25,0,1e-05,0.01,0.72,697,707
16,1504,25,0,1e-05,0.01,0.732,749,755
16,1604,25,0,1e-05,0.01,0.746,791,813
16,1704,25,0,1e-05,0.01,0.782,838,866
16,1804,25,0,1e-05,0.01,0.82,897,907
16,1904,25,0,1e-05,0.01,0.838,952,952
17,0,25,0,1e-05,0.01,0.5,0,0
17,104,25,0,1e-05,0.01,0.538,52,52
17,204,25,0,1e-05,0.01,0.522,97,107
17,304,25,0,1e-05,0.01,0.632,147,157
17,404,25,0,1e-05,0.01,0.572,196,208
17,504,25,0,1e-05,0.01,0.646,243,261
17,604,25,0,1e-05,0.01,0.624,296,308
17,704,25,0,1e-05,0.01,0.668,345,359
17,804,25,0,1e-05,0.01,0.69,392,412
17,904,25,0,1e-05,0.01,0.698,444,460
17,1004,25,0,1e-05,0.01,0.728,486,518
17,1104,25,0,1e-05,0.01,0.742,541,563
17,1204,25,0,1e-05,0.01,0.776,588,616
17,1304,25,0,1e-05,0.01,0.788,642,662
17,1404,25,0,1e-05,0.01,0.8,693,711
17,1504,25,0,1e-05,0.01,0.81,749,755
17,1604,25,0,1e-05,0.01,0.83,796,808
17,1704,25,0,1e-05,0.01,0.856,845,859
17,1804,25,0,1e-05,0.01,0.876,900,904
17,1904,25,0,1e-05,0.01,0.896,952,952
18,0,25,0,1e-05,0.01,0.5,0,0
18,104,25,0,1e-05,0.01,0.566,61,43
18,204,25,0,1e-05,0.01,0.532,107,97
18,304,25,0,1e-05,0.01,0.604,162,142
18,404,25,0,1e-05,0.01,0.582,208,196
18,504,25,0,1e-05,0.01,0.62,259,245
18,604,25,0,1e-05,0.01,0.604,306,298
18,704,25,0,1e-05,0.01,0.638,359,345
18,804,25,0,1e-05,0.01,0.666,409,395
18,904,25,0,1e-05,0.01,0.662,464,440
18,1004,25,0,1e-05,0.01,0.692,514,490
18,1104,25,0,1e-05,0.01,0.712,561,543
18,1204,25,0,1e-05,0.01,0.76,609,595
18,1304,25,0,1e-05,0.01,0.778,656,648
18,1404,25,0,1e-05,0.01,0.804,707,697
18,1504,25,0,1e-05,0.01,0.826,753,751
18,1604,25,0,1e-05,0.01,0.862,797,807
18,1704,25,0,1e-05,0.01,0.88,845,859
18,1804,25,0,1e-05,0.01,0.918,898,906
18,1904,25,0,1e-05,0.01,0.944,952,952
19,0,25,0,1e-05,0.01,0.504,0,0
19,104,25,0,1e-05,0.01,0.542,55,49
19,204,25,0,1e-05,0.01,0.538,103,101
19,304,25,0,1e-05,0.01,0.606,137,167
19,404,25,0,1e-05,0.01,0.574,193,211
19,504,25,0,1e-05,0.01,0.62,241,263
19,604,25,0,1e-05,0.01,0.632,290,314
19,704,25,0,1e-05,0.01,0.624,349,355
19,804,25,0,1e-05,0.01,0.62,395,409
19,904,25,0,1e-05,0.01,0.658,441,463
19,1004,25,0,1e-05,0.01,0.656,488,516
19,1104,25,0,1e-05,0.01,0.664,541,563
19,1204,25,0,1e-05,0.01,0.702,595,609
19,1304,25,0,1e-05,0.01,0.744,643,661
19,1404,25,0,1e-05,0.01,0.758,696,708
19,1504,25,0,1e-05,0.01,0.792,743,761
19,1604,25,0,1e-05,0.01,0.834,805,799
19,1704,25,0,1e-05,0.01,0.85,852,852
19,1804,25,0,1e-05,0.01,0.876,899,905
19,1904,25,0,1e-05,0.01,0.89,952,952
20,0,25,0,1e-05,0.01,0.502,0,0
20,104,25,0,1e-05,0.01,0.538,51,53
20,204,25,0,1e-05,0.01,0.492,107,97
20,304,25,0,1e-05,0.01,0.558,160,144
20,404,25,0,1e-05,0.01,0.592,215,189
20,504,25,0,1e-05,0.01,0.566,270,234
20,604,25,0,1e-05,0.01,0.542,314,290
20,704,25,0,1e-05,0.01,0.604,363,341
20,804,25,0,1e-05,0.01,0.638,424,380
20,904,25,0,1e-05,0.01,0.62,464,440
20,1004,25,0,1e-05,0.01,0.616,510,494
20,1104,25,0,1e-05,0.01,0.62,567,537
20,1204,25,0,1e-05,0.01,0.656,617,587
20,1304,25,0,1e-05,0.01,0.666,666,638
20,1404,25,0,1e-05,0.01,0.678,718,686
20,1504,25,0,1e-05,0.01,0.706,761,743
20,1604,25,0,1e-05,0.01,0.726,811,793
20,1704,25,0,1e-05,0.01,0.76,857,847
20,1804,25,0,1e-05,0.01,0.792,903,901
20,1904,25,0,1e-05,0.01,0.828,952,952
1,0,25,0,0.0001,0.0001,0.5,0,0
1,104,25,0,0.0001,0.0001,0.5,42,62
1,204,25,0,0.0001,0.0001,0.5,91,113
1,304,25,0,0.0001,0.0001,0.502,140,164
1,404,25,0,0.0001,0.0001,0.504,191,213
1,504,25,0,0.0001,0.0001,0.504,241,263
1,604,25,0,0.0001,0.0001,0.502,296,308
1,704,25,0,0.0001,0.0001,0.504,353,351
1,804,25,0,0.0001,0.0001,0.502,403,401
1,904,25,0,0.0001,0.0001,0.504,457,447
1,1004,25,0,0.0001,0.0001,0.506,505,499
1,1104,25,0,0.0001,0.0001,0.506,553,551
1,1204,25,0,0.0001,0.0001,0.506,605,599
1,1304,25,0,0.0001,0.0001,0.508,658,646
1,1404,25,0,0.0001,0.0001,0.504,702,702
1,1504,25,0,0.0001,0.0001,0.502,748,756
1,1604,25,0,0.0001,0.0001,0.508,792,812
1,1704,25,0,0.0001,0.0001,0.508,846,858
1,1804,25,0,0.0001,0.0001,0.508,896,908
1,1904,25,0,0.0001,0.0001,0.502,952,952
2,0,25,0,0.0001,0.0001,0.502,0,0
2,104,25,0,0.0001,0.0001,0.502,49,55
2,204,25,0,0.0001,0.0001,0.5,105,99
2,304,25,0,0.0001,0.0001,0.498,158,146
2,404,25,0,0.0001,0.0001,0.498,199,205
2,504,25,0,0.0001,0.0001,0.5,249,255
2,604,25,0,0.0001,0.0001,0.5,301,303
2,704,25,0,0.0001,0.0001,0.502,350,354
2,804,25,0,0.0001,0.0001,0.5,400,404
2,904,25,0,0.0001,0.0001,0.502,457,447
2,1004,25,0,0.0001,0.0001,0.504,509,495
2,1104,25,0,0.0001,0.0001,0.506,566,538
2,1204,25,0,0.0001,0.0001,0.504,609,595
2,1304,25,0,0.0001,0.0001,0.498,663,641
2,1404,25,0,0.0001,0.0001,0.488,712,692
2,1504,25,0,0.0001,0.0001,0.492,757,747
2,1604,25,0,0.0001,0.0001,0.484,804,800
2,1704,25,0,0.0001,0.0001,0.486,853,851
2,1804,25,0,0.0001,0.0001,0.482,907,897
2,1904,25,0,0.0001,0.0001,0.478,952,952
3,0,25,0,0.0001,0.0001,0.534,0,0
3,104,25,0,0.0001,0.0001,0.536,52,52
3,204,25,0,0.0001,0.0001,0.536,92,112
3,304,25,0,0.0001,0.0001,0.532,146,158
3,404,25,0,0.0001,0.0001,0.532,197,207
3,504,25,0,0.0001,0.0001,0.522,248,256
3,604,25,0,0.0001,0.0001,0.516,294,310
3,704,25,0,0.0001,0.0001,0.516,347,357
3,804,25,0,0.0001,0.0001,0.514,400,404
3,904,25,0,0.0001,0.0001,0.512,444,460
3,1004,25,0,0.0001,0.0001,0.514,502,502
3,1104,25,0,0.0001,0.0001,0.526,554,550
3,1204,25,0,0.0001,0.0001,0.52,608,596
3,1304,25,0,0.0001,0.0001,0.528,667,637
3,1404,25,0,0.0001,0.0001,0.524,710,694
3,1504,25,0,0.0001,0.0001,0.528,762,742
3,1604,25,0,0.0001,0.0001,0.526,813,791
3,1704,25,0,0.0001,0.0001,0.522,863,841
3,1804,25,0,0.0001,0.0001,0.512,901,903
3,1904,25,0,0.0001,0.0001,0.524,952,952
4,0,25,0,0.0001,0.0001,0.518,0,0
4,104,25,0,0.0001,0.0001,0.518,40,64
4,204,25,0,0.0001,0.0001,0.512,94,110
4,304,25,0,0.0001,0.0001,0.514,139,165
4,404,25,0,0.0001,0.0001,0.512,189,215
4,504,25,0,0.0001,0.0001,0.516,243,261
4,604,25,0,0.0001,0.0001,0.514,290,314
4,704,25,0,0.0001,0.0001,0.51,343,361
4,804,25,0,0.0001,0.0001,0.512,399,405
4,904,25,0,0.0001,0.0001,0.512,450,454
4,1004,25,0,0.0001,0.0001,0.51,497,507
4,1104,25,0,0.0001,0.0001,0.514,551,553
4,1204,25,0,0.0001,0.0001,0.518,604,600
4,1304,25,0,0.0001,0.0001,0.516,652,652
4,1404,25,0,0.0001,0.0001,0.524,702,702
4,1504,25,0,0.0001,0.0001,0.518,755,749
4,1604,25,0,0.0001,0.0001,0.52,808,796
4,1704,25,0,0.0001,0.0001,0.522,853,851
4,1804,25,0,0.0001,0.0001,0.528,899,905
4,1904,25,0,0.0001,0.0001,0.52,952,952
5,0,25,0,0.0001,0.0001,0.478,0,0
5,104,25,0,0.0001,0.0001,0.478,44,60
5,204,25,0,0.0001,0.0001,0.48,87,117
5,304,25,0,0.0001,0.0001,0.488,140,164
5,404,25,0,0.0001,0.0001,0.49,196,208
5,504,25,0,0.0001,0.0001,0.49,245,259
5,604,25,0,0.0001,0.0001,0.492,299,305
5,704,25,0,0.0001,0.0001,0.49,354,350
5,804,25,0,0.0001,0.0001,0.488,410,394
5,904,25,0,0.0001,0.0001,0.49,451,453
5,1004,25,0,0.0001,0.0001,0.49,505,499
5,1104,25,0,0.0001,0.0001,0.49,561,543
5,1204,25,0,0.0001,0.0001,0.484,615,589
5,1304,25,0,0.0001,0.0001,0.482,662,642
5,1404,25,0,0.0001,0.0001,0.484,714,690
5,1504,25,0,0.0001,0.0001,0.482,763,741
5,1604,25,0,0.0001,0.0001,0.492,810,794
5,1704,25,0,0.0001,0.0001,0.488,857,847
5,1804,25,0,0.0001,0.0001,0.492,903,901
5,1904,25,0,0.0001,0.0001,0.49,952,952
6,0,25,0,0.0001,0.0001,0.504,0,0
6,104,25,0,0.0001,0.0001,0.504,54,50
6,204,25,0,0.0001,0.0001,0.506,112,92
6,304,25,0,0.0001,0.0001,0.506,164,140
6,404,25,0,0.0001,0.0001,0.504,227,177
6,504,25,0,0.0001,0.0001,0.508,279,225
6,604,25,0,0.0001,0.0001,0.51,325,279
6,704,25,0,0.0001,0.0001,0.506,373,331
6,804,25,0,0.0001,0.0001,0.504,422,382
6,904,25,0,0.0001,0.0001,0.504,473,431
6,1004,25,0,0.0001,0.0001,0.504,523,481
6,1104,25,0,0.0001,0.0001,0.506,569,535
6,1204,25,0,0.0001,0.0001,0.504,622,582
6,1304,25,0,0.0001,0.0001,0.502,673,631
6,1404,25,0,0.0001,0.0001,0.502,715,689
6,1504,25,0,0.0001,0.0001,0.508,757,747
6,1604,25,0,0.0001,0.0001,0.508,805,799
6,1704,25,0,0.0001,0.0001,0.506,857,847
6,1804,25,0,0.0001,0.0001,0.506,902,902
6,1904,25,0,0.0001,0.0001,0.506,952,952
7,0,25,0,0.0001,0.0001,0.51,0,0
7,104,25,0,0.0001,0.0001,0.51,49,55
7,204,25,0,0.0001,0.0001,0.51,97,107
7,304,25,0,0.0001,0.0001,0.51,157,147
7,404,25,0,0.0001,0.0001,0.51,206,198
7,504,25,0,0.0001,0.0001,0.514,259,245
7,604,25,0,0.0001,0.0001,0.512,310,294
7,704,25,0,0.0001,0.0001,0.508,360,344
7,804,25,0,0.0001,0.0001,0.516,411,393
7,904,25,0,0.0001,0.0001,0.516,455,449
7,1004,25,0,0.0001,0.0001,0.514,506,498
7,1104,25,0,0.0001,0.0001,0.51,563,541
7,1204,25,0,0.0001,0.0001,0.5,614,590
7,1304,25,0,0.0001,0.0001,0.504,667,637
7,1404,25,0,0.0001,0.0001,0.5,712,692
7,1504,25,0,0.0001,0.0001,0.502,759,745
7,1604,25,0,0.0001,0.0001,0.502,810,794
7,1704,25,0,0.0001,0.0001,0.506,851,853
7,1804,25,0,0.0001,0.0001,0.5,897,907
7,1904,25,0,0.0001,0.0001,0.504,952,952
8,0,25,0,0.0001,0.0001,0.508,0,0
8,104,25,0,0.0001,0.0001,0.508,48,56
8,204,25,0,0.0001,0.0001,0.508,94,110
8,304,25,0,0.0001,0.0001,0.506,144,160
8,404,25,0,0.0001,0.0001,0.502,193,211
8,504,25,0,0.0001,0.0001,0.498,239,265
8,604,25,0,0.0001,0.0001,0.494,291,313
8,704,25,0,0.0001,0.0001,0.498,336,368
8,804,25,0,0.0001,0.0001,0.486,386,418
8,904,25,0,0.0001,0.0001,0.484,442,462
8,1004,25,0,0.0001,0.0001,0.488,487,517
8,1104,25,0,0.0001,0.0001,0.498,535,569
8,1204,25,0,0.0001,0.0001,0.498,591,613
8,1304,25,0,0.0001,0.0001,0.486,647,657
8,1404,25,0,0.0001,0.0001,0.486,699,705
8,1504,25,0,0.0001,0.0001,0.492,753,751
8,1604,25,0,0.0001,0.0001,0.492,804,800
8,1704,25,0,0.0001,0.0001,0.492,856,848
8,1804,25,0,0.0001,0.0001,0.494,907,897
8,1904,25,0,0.0001,0.0001,0.494,952,952
9,0,25,0,0.0001,0.0001,0.474,0,0
9,104,25,0,0.0001,0.0001,0.474,56,48
9,204,25,0,0.0001,0.0001,0.472,105,99
9,304,25,0,0.0001,0.0001,0.474,156,148
9,404,25,0,0.0001,0.0001,0.472,201,203
9,504,25,0,0.0001,0.0001,0.478,252,252
9,604,25,0,0.0001,0.0001,0.482,295,309
9,704,25,0,0.0001,0.0001,0.478,351,353
9,804,25,0,0.0001,0.0001,0.478,410,394
9,904,25,0,0.0001,0.0001,0.482,453,451
9,1004,25,0,0.0001,0.0001,0.482,512,492
9,1104,25,0,0.0001,0.0001,0.484,565,539
9,1204,25,0,0.0001,0.0001,0.478,613,591
9,1304,25,0,0.0001,0.0001,0.476,662,642
9,1404,25,0,0.0001,0.0001,0.476,708,696
9,1504,25,0,0.0001,0.0001,0.476,751,753
9,1604,25,0,0.0001,0.0001,0.48,804,800
9,1704,25,0,0.0001,0.0001,0.486,854,850
9,1804,25,0,0.0001,0.0001,0.484,910,894
9,1904,25,0,0.0001,0.0001,0.482,952,952
10,0,25,0,0.0001,0.0001,0.506,0,0
10,104,25,0,0.0001,0.0001,0.506,53,51
10,204,25,0,0.0001,0.0001,0.506,105,99
10,304,25,0,0.0001,0.0001,0.508,156,148
10,404,25,0,0.0001,0.0001,0.51,202,202
10,504,25,0,0.0001,0.0001,0.512,255,249
10,604,25,0,0.0001,0.0001,0.516,306,298
10,704,25,0,0.0001,0.0001,0.51,358,346
10,804,25,0,0.0001,0.0001,0.512,408,396
10,904,25,0,0.0001,0.0001,0.508,458,446
10,1004,25,0,0.0001,0.0001,0.518,506,498
10,1104,25,0,0.0001,0.0001,0.516,554,550
10,1204,25,0,0.0001,0.0001,0.512,606,598
10,1304,25,0,0.0001,0.0001,0.516,655,649
10,1404,25,0,0.0001,0.0001,0.514,704,700
10,1504,25,0,0.0001,0.0001,0.508,751,753
10,1604,25,0,0.0001,0.0001,0.502,797,807
10,1704,25,0,0.0001,0.0001,0.5,842,862
10,1804,25,0,0.0001,0.0001,0.5,893,911
10,1904,25,0,0.0001,0.0001,0.5,952,952
11,0,25,0,0.0001,0.0001,0.502,0,0
11,104,25,0,0.0001,0.0001,0.502,44,60
11,204,25,0,0.0001,0.0001,0.502,91,113
11,304,25,0,0.0001,0.0001,0.5,138,166
11,404,25,0,0.0001,0.0001,0.502,189,215
11,504,25,0,0.0001,0.0001,0.504,246,258
11,604,25,0,0.0001,0.0001,0.51,295,309
11,704,25,0,0.0001,0.0001,0.508,347,357
11,804,25,0,0.0001,0.0001,0.504,399,405
11,904,25,0,0.0001,0.0001,0.5,456,448
11,1004,25,0,0.0001,0.0001,0.502,505,499
11,1104,25,0,0.0001,0.0001,0.5,552,552
11,1204,25,0,0.0001,0.0001,0.5,606,598
11,1304,25,0,0.0001,0.0001,0.498,660,644
11,1404,25,0,0.0001,0.0001,0.496,710,694
11,1504,25,0,0.0001,0.0001,0.494,763,741
11,1604,25,0,0.0001,0.0001,0.496,807,797
11,1704,25,0,0.0001,0.0001,0.49,862,842
11,1804,25,0,0.0001,0.0001,0.486,906,898
11,1904,25,0,0.0001,0.0001,0.49,952,952
12,0,25,0,0.0001,0.0001,0.498,0,0
12,104,25,0,0.0001,0.0001,0.498,52,52
12,204,25,0,0.0001,0.0001,0.498,105,99
12,304,25,0,0.0001,0.0001,0.498,149,155
12,404,25,0,0.0001,0.0001,0.498,202,202
12,504,25,0,0.0001,0.0001,0.496,261,243
12,604,25,0,0.0001,0.0001,0.496,308,296
12,704,25,0,0.0001,0.0001,0.496,354,350
12,804,25,0,0.0001,0.0001,0.5,400,404
12,904,25,0,0.0001,0.0001,0.502,456,448
12,1004,25,0,0.0001,0.0001,0.502,505,499
12,1104,25,0,0.0001,0.0001,0.494,553,551
12,1204,25,0,0.0001,0.0001,0.496,608,596
12,1304,25,0,0.0001,0.0001,0.494,655,649
12,1404,25,0,0.0001,0.0001,0.492,714,690
12,1504,25,0,0.0001,0.0001,0.492,755,749
12,1604,25,0,0.0001,0.0001,0.488,801,803
12,1704,25,0,0.0001,0.0001,0.488,850,854
12,1804,25,0,0.0001,0.0001,0.49,904,900
12,1904,25,0,0.0001,0.0001,0.492,952,952
13,0,25,0,0.0001,0.0001,0.51,0,0
13,104,25,0,0.0001,0.0001,0.51,51,53
13,204,25,0,0.0001,0.0001,0.508,104,100
13,304,25,0,0.0001,0.0001,0.512,154,150
13,404,25,0,0.0001,0.0001,0.51,206,198
13,504,25,0,0.0001,0.0001,0.51,252,252
13,604,25,0,0.0001,0.0001,0.516,300,304
13,704,25,0,0.0001,0.0001,0.524,350,354
13,804,25,0,0.0001,0.0001,0.528,404,400
13,904,25,0,0.0001,0.0001,0.528,451,453
13,1004,25,0,0.0001,0.0001,0.522,510,494
13,1104,25,0,0.0001,0.0001,0.528,557,547
13,1204,25,0,0.0001,0.0001,0.532,606,598
13,1304,25,0,0.0001,0.0001,0.526,658,646
13,1404,25,0,0.0001,0.0001,0.524,704,700
13,1504,25,0,0.0001,0.0001,0.53,757,747
13,1604,25,0,0.0001,0.0001,0.524,803,801
13,1704,25,0,0.0001,0.0001,0.516,845,859
13,1804,25,0,0.0001,0.0001,0.532,901,903
13,1904,25,0,0.0001,0.0001,0.516,952,952
14,0,25,0,0.0001,0.0001,0.52,0,0
14,104,25,0,0.0001,0.0001,0.52,48,56
14,204,25,0,0.0001,0.0001,0.518,94,110
14,304,25,0,0.0001,0.0001,0.516,148,156
14,404,25,0,0.0001,0.0001,0.516,201,203
14,504,25,0,0.0001,0.0001,0.514,253,251
14,604,25,0,0.0001,0.0001,0.52,307,297
14,704,25,0,0.0001,0.0001,0.526,366,338
14,804,25,0,0.0001,0.0001,0.538,416,388
14,904,25,0,0.0001,0.0001,0.534,473,431
14,1004,25,0,0.0001,0.0001,0.536,518,486
14,1104,25,0,0.0001,0.0001,0.542,564,540
14,1204,25,0,0.0001,0.0001,0.542,609,595
14,1304,25,0,0.0001,0.0001,0.534,650,654
14,1404,25,0,0.0001,0.0001,0.544,694,710
14,1504,25,0,0.0001,0.0001,0.55,747,757
14,1604,25,0,0.0001,0.0001,0.55,794,810
14,1704,25,0,0.0001,0.0001,0.552,848,856
14,1804,25,0,0.0001,0.0001,0.552,900,904
14,1904,25,0,0.0001,0.0001,0.55,952,952
15,0,25,0,0.0001,0.0001,0.476,0,0
15,104,25,0,0.0001,0.0001,0.476,50,54
15,204,25,0,0.0001,0.0001,0.476,102,102
15,304,25,0,0.0001,0.0001,0.472,159,145
15,404,25,0,0.0001,0.0001,0.474,209,195
15,504,25,0,0.0001,0.0001,0.476,247,257
15,604,25,0,0.0001,0.0001,0.476,295,309
15,704,25,0,0.0001,0.0001,0.48,342,362
15,804,25,0,0.0001,0.0001,0.474,387,417
15,904,25,0,0.0001,0.0001,0.478,443,461
15,1004,25,0,0.0001,0.0001,0.478,488,516
15,1104,25,0,0.0001,0.0001,0.476,541,563
15,1204,25,0,0.0001,0.0001,0.474,596,608
15,1304,25,0,0.0001,0.0001,0.47,649,655
15,1404,25,0,0.0001,0.0001,0.468,695,709
15,1504,25,0,0.0001,0.0001,0.478,753,751
15,1604,25,0,0.0001,0.0001,0.476,807,797
15,1704,25,0,0.0001,0.0001,0.478,860,844
15,1804,25,0,0.0001,0.0001,0.466,905,899
15,1904,25,0,0.0001,0.0001,0.47,952,952
16,0,25,0,0.0001,0.0001,0.5,0,0
16,104,25,0,0.0001,0.0001,0.5,50,54
16,204,25,0,0.0001,0.0001,0.5,99,105
16,304,25,0,0.0001,0.0001,0.5,145,159
16,404,25,0,0.0001,0.0001,0.5,195,209
16,504,25,0,0.0001,0.0001,0.5,254,250
16,604,25,0,0.0001,0.0001,0.5,311,293
16,704,25,0,0.0001,0.0001,0.5,362,342
16,804,25,0,0.0001,0.0001,0.5,413,391
16,904,25,0,0.0001,0.0001,0.5,463,441
16,1004,25,0,0.0001,0.0001,0.5,514,490
16,1104,25,0,0.0001,0.0001,0.5,556,548
16,1204,25,0,0.0001,0.0001,0.5,607,597
16,1304,25,0,0.0001,0.0001,0.5,648,656
16,1404,25,0,0.0001,0.0001,0.5,698,706
16,1504,25,0,0.0001,0.0001,0.5,748,756
16,1604,25,0,0.0001,0.0001,0.5,793,811
16,1704,25,0,0.0001,0.0001,0.5,843,861
16,1804,25,0,0.0001,0.0001,0.5,905,899
16,1904,25,0,0.0001,0.0001,0.498,952,952
17,0,25,0,0.0001,0.0001,0.498,0,0
17,104,25,0,0.0001,0.0001,0.498,60,44
17,204,25,0,0.0001,0.0001,0.498,111,93
17,304,25,0,0.0001,0.0001,0.498,166,138
17,404,25,0,0.0001,0.0001,0.5,218,186
17,504,25,0,0.0001,0.0001,0.5,267,237
17,604,25,0,0.0001,0.0001,0.5,317,287
17,704,25,0,0.0001,0.0001,0.5,360,344
17,804,25,0,0.0001,0.0001,0.498,409,395
17,904,25,0,0.0001,0.0001,0.498,459,445
17,1004,25,0,0.0001,0.0001,0.498,504,500
17,1104,25,0,0.0001,0.0001,0.498,559,545
17,1204,25,0,0.0001,0.0001,0.496,611,593
17,1304,25,0,0.0001,0.0001,0.496,662,642
17,1404,25,0,0.0001,0.0001,0.49,713,691
17,1504,25,0,0.0001,0.0001,0.492,761,743
17,1604,25,0,0.0001,0.0001,0.49,815,789
17,1704,25,0,0.0001,0.0001,0.49,857,847
17,1804,25,0,0.0001,0.0001,0.49,907,897
17,1904,25,0,0.0001,0.0001,0.48,952,952
18,0,25,0,0.0001,0.0001,0.504,0,0
18,104,25,0,0.0001,0.0001,0.504,59,45
18,204,25,0,0.0001,0.0001,0.504,113,91
18,304,25,0,0.0001,0.0001,0.502,173,131
18,404,25,0,0.0001,0.0001,0.498,227,177
18,504,25,0,0.0001,0.0001,0.5,272,232
18,604,25,0,0.0001,0.0001,0.498,326,278
18,704,25,0,0.0001,0.0001,0.502,368,336
18,804,25,0,0.0001,0.0001,0.504,415,389
18,904,25,0,0.0001,0.0001,0.504,458,446
18,1004,25,0,0.0001,0.0001,0.502,515,489
18,1104,25,0,0.0001,0.0001,0.502,561,543
18,1204,25,0,0.0001,0.0001,0.502,614,590
18,1304,25,0,0.0001,0.0001,0.504,657,647
18,1404,25,0,0.0001,0.0001,0.502,703,701
18,1504,25,0,0.0001,0.0001,0.502,751,753
18,1604,25,0,0.0001,0.0001,0.504,796,808
18,1704,25,0,0.0001,0.0001,0.508,847,857
18,1804,25,0,0.0001,0.0001,0.51,895,909
18,1904,25,0,0.0001,0.0001,0.51,952,952
19,0,25,0,0.0001,0.0001,0.5,0,0
19,104,25,0,0.0001,0.0001,0.5,45,59
19,204,25,0,0.0001,0.0001,0.496,102,102
19,304,25,0,0.0001,0.0001,0.498,155,149
19,404,25,0,0.0001,0.0001,0.504,210,194
19,504,25,0,0.0001,0.0001,0.504,257,247
19,604,25,0,0.0001,0.0001,0.506,311,293
19,704,25,0,0.0001,0.0001,0.51,370,334
19,804,25,0,0.0001,0.0001,0.506,414,390
19,904,25,0,0.0001,0.0001,0.514,452,452
19,1004,25,0,0.0001,0.0001,0.518,510,494
19,1104,25,0,0.0001,0.0001,0.518,563,541
19,1204,25,0,0.0001,0.0001,0.518,612,592
19,1304,25,0,0.0001,0.0001,0.514,662,642
19,1404,25,0,0.0001,0.0001,0.514,708,696
19,1504,25,0,0.0001,0.0001,0.518,758,746
19,1604,25,0,0.0001,0.0001,0.514,805,799
19,1704,25,0,0.0001,0.0001,0.512,846,858
19,1804,25,0,0.0001,0.0001,0.52,900,904
19,1904,25,0,0.0001,0.0001,0.514,952,952
20,0,25,0,0.0001,0.0001,0.528,0,0
20,104,25,0,0.0001,0.0001,0.528,57,47
20,204,25,0,0.0001,0.0001,0.528,97,107
20,304,25,0,0.0001,0.0001,0.526,141,163
20,404,25,0,0.0001,0.0001,0.518,195,209
20,504,25,0,0.0001,0.0001,0.51,233,271
20,604,25,0,0.0001,0.0001,0.518,287,317
20,704,25,0,0.0001,0.0001,0.516,334,370
20,804,25,0,0.0001,0.0001,0.516,385,419
20,904,25,0,0.0001,0.0001,0.514,438,466
20,1004,25,0,0.0001,0.0001,0.516,489,515
20,1104,25,0,0.0001,0.0001,0.514,549,555
20,1204,25,0,0.0001,0.0001,0.516,603,601
20,1304,25,0,0.0001,0.0001,0.522,649,655
20,1404,25,0,0.0001,0.0001,0.524,695,709
20,1504,25,0,0.0001,0.0001,0.52,739,765
20,1604,25,0,0.0001,0.0001,0.52,792,812
20,1704,25,0,0.0001,0.0001,0.522,847,857
20,1804,25,0,0.0001,0.0001,0.516,898,906
20,1904,25,0,0.0001,0.0001,0.512,952,952
1,0,25,0,0.0001,0.001,0.558,0,0
1,104,25,0,0.0001,0.001,0.56,51,53
1,204,25,0,0.0001,0.001,0.58,103,101
1,304,25,0,0.0001,0.001,0.584,150,154
1,404,25,0,0.0001,0.001,0.574,206,198
1,504,25,0,0.0001,0.001,0.576,250,254
1,604,25,0,0.0001,0.001,0.606,306,298
1,704,25,0,0.0001,0.001,0.618,358,346
1,804,25,0,0.0001,0.001,0.632,407,397
1,904,25,0,0.0001,0.001,0.662,457,447
1,1004,25,0,0.0001,0.001,0.662,508,496
1,1104,25,0,0.0001,0.001,0.7,560,544
1,1204,25,0,0.0001,0.001,0.726,613,591
1,1304,25,0,0.0001,0.001,0.748,661,643
1,1404,25,0,0.0001,0.001,0.782,709,695
1,1504,25,0,0.0001,0.001,0.824,760,744
1,1604,25,0,0.0001,0.001,0.856,807,797
1,1704,25,0,0.0001,0.001,0.876,854,850
1,1804,25,0,0.0001,0.001,0.9,898,906
1,1904,25,0,0.0001,0.001,0.908,952,952
2,0,25,0,0.0001,0.001,0.532,0,0
2,104,25,0,0.0001,0.001,0.53,55,49
2,204,25,0,0.0001,0.001,0.528,95,109
2,304,25,0,0.0001,0.001,0.538,139,165
2,404,25,0,0.0001,0.001,0.562,188,216
2,504,25,0,0.0001,0.001,0.556,243,261
2,604,25,0,0.0001,0.001,0.558,297,307
2,704,25,0,0.0001,0.001,0.568,344,360
2,804,25,0,0.0001,0.001,0.576,393,411
2,904,25,0,0.0001,0.001,0.582,442,462
2,1004,25,0,0.0001,0.001,0.596,496,508
2,1104,25,0,0.0001,0.001,0.61,542,562
2,1204,25,0,0.0001,0.001,0.63,594,610
2,1304,25,0,0.0001,0.001,0.656,648,656
2,1404,25,0,0.0001,0.001,0.656,700,704
2,1504,25,0,0.0001,0.001,0.676,751,753
2,1604,25,0,0.0001,0.001,0.698,803,801
2,1704,25,0,0.0001,0.001,0.716,848,856
2,1804,25,0,0.0001,0.001,0.748,898,906
2,1904,25,0,0.0001,0.001,0.78,952,952
3,0,25,0,0.0001,0.001,0.516,0,0
3,104,25,0,0.0001,0.001,0.514,48,56
3,204,25,0,0.0001,0.001,0.526,100,104
3,304,25,0,0.0001,0.001,0.544,143,161
3,404,25,0,0.0001,0.001,0.558,186,218
3,504,25,0,0.0001,0.001,0.562,235,269
3,604,25,0,0.0001,0.001,0.558,288,316
3,704,25,0,0.0001,0.001,0.556,338,366
3,804,25,0,0.0001,0.001,0.572,391,413
3,904,25,0,0.0001,0.001,0.582,439,465
3,1004,25,0,0.0001,0.001,0.592,480,524
3,1104,25,0,0.0001,0.001,0.606,529,575
3,1204,25,0,0.0001,0.001,0.62,582,622
3,1304,25,0,0.0001,0.001,0.654,641,663
3,1404,25,0,0.0001,0.001,0.686,696,708
3,1504,25,0,0.0001,0.001,0.714,751,753
3,1604,25,0,0.0001,0.001,0.752,799,805
3,1704,25,0,0.0001,0.001,0.798,851,853
3,1804,25,0,0.0001,0.001,0.828,901,903
3,1904,25,0,0.0001,0.001,0.872,952,952
4,0,25,0,0.0001,0.001,0.532,0,0
4,104,25,0,0.0001,0.001,0.542,53,51
4,204,25,0,0.0001,0.001,0.566,106,98
4,304,25,0,0.0001,0.001,0.614,160,144
4,404,25,0,0.0001,0.001,0.574,205,199
4,504,25,0,0.0001,0.001,0.578,255,249
4,604,25,0,0.0001,0.001,0.634,305,299
4,704,25,0,0.0001,0.001,0.638,360,344
4,804,25,0,0.0001,0.001,0.674,408,396
4,904,25,0,0.0001,0.001,0.692,457,447
4,1004,25,0,0.0001,0.001,0.71,503,501
4,1104,25,0,0.0001,0.001,0.722,550,554
4,1204,25,0,0.0001,0.001,0.76,602,602
4,1304,25,0,0.0001,0.001,0.792,655,649
4,1404,25,0,0.0001,0.001,0.808,699,705
4,1504,25,0,0.0001,0.001,0.858,741,763
4,1604,25,0,0.0001,0.001,0.888,791,813
4,1704,25,0,0.0001,0.001,0.912,844,860
4,1804,25,0,0.0001,0.001,0.928,900,904
4,1904,25,0,0.0001,0.001,0.946,952,952
5,0,25,0,0.0001,0.001,0.522,0,0
5,104,25,0,0.0001,0.001,0.528,56,48
5,204,25,0,0.0001,0.001,0.552,106,98
5,304,25,0,0.0001,0.001,0.572,156,148
5,404,25,0,0.0001,0.001,0.576,200,204
5,504,25,0,0.0001,0.001,0.576,247,257
5,604,25,0,0.0001,0.001,0.586,296,308
5,704,25,0,0.0001,0.001,0.59,344,360
5,804,25,0,0.0001,0.001,0.6,397,407
5,904,25,0,0.0001,0.001,0.626,441,463
5,1004,25,0,0.0001,0.001,0.65,502,502
5,1104,25,0,0.0001,0.001,0.658,556,548
5,1204,25,0,0.0001,0.001,0.674,606,598
5,1304,25,0,0.0001,0.001,0.7,652,652
5,1404,25,0,0.0001,0.001,0.726,707,697
5,1504,25,0,0.0001,0.001,0.75,753,751
5,1604,25,0,0.0001,0.001,0.762,806,798
5,1704,25,0,0.0001,0.001,0.784,850,854
5,1804,25,0,0.0001,0.001,0.816,900,904
5,1904,25,0,0.0001,0.001,0.848,952,952
6,0,25,0,0.0001,0.001,0.516,0,0
6,104,25,0,0.0001,0.001,0.524,50,54
6,204,25,0,0.0001,0.001,0.56,98,106
6,304,25,0,0.0001,0.001,0.624,147,157
6,404,25,0,0.0001,0.001,0.6,200,204
6,504,25,0,0.0001,0.001,0.586,247,257
6,604,25,0,0.0001,0.001,0.662,293,311
6,704,25,0,0.0001,0.001,0.654,344,360
6,804,25,0,0.0001,0.001,0.676,397,407
6,904,25,0,0.0001,0.001,0.692,451,453
6,1004,25,0,0.0001,0.001,0.712,502,502
6,1104,25,0,0.0001,0.001,0.74,551,553
6,1204,25,0,0.0001,0.001,0.764,606,598
6,1304,25,0,0.0001,0.001,0.79,659,645
6,1404,25,0,0.0001,0.001,0.8,709,695
6,1504,25,0,0.0001,0.001,0.826,762,742
6,1604,25,0,0.0001,0.001,0.854,803,801
6,1704,25,0,0.0001,0.001,0.886,850,854
6,1804,25,0,0.0001,0.001,0.902,904,900
6,1904,25,0,0.0001,0.001,0.92,952,952
7,0,25,0,0.0001,0.001,0.506,0,0
7,104,25,0,0.0001,0.001,0.51,56,48
7,204,25,0,0.0001,0.001,0.53,105,99
7,304,25,0,0.0001,0.001,0.564,149,155
7,404,25,0,0.0001,0.001,0.52,203,201
7,504,25,0,0.0001,0.001,0.552,255,249
7,604,25,0,0.0001,0.001,0.566,304,300
7,704,25,0,0.0001,0.001,0.582,357,347
7,804,25,0,0.0001,0.001,0.594,407,397
7,904,25,0,0.0001,0.001,0.616,464,440
7,1004,25,0,0.0001,0.001,0.632,509,495
7,1104,25,0,0.0001,0.001,0.656,558,546
7,1204,25,0,0.0001,0.001,0.692,611,593
7,1304,25,0,0.0001,0.001,0.718,653,651
7,1404,25,0,0.0001,0.001,0.742,708,696
7,1504,25,0,0.0001,0.001,0.772,757,747
7,1604,25,0,0.0001,0.001,0.808,812,792
7,1704,25,0,0.0001,0.001,0.822,856,848
7,1804,25,0,0.0001,0.001,0.854,904,900
7,1904,25,0,0.0001,0.001,0.88,952,952
8,0,25,0,0.0001,0.001,0.512,0,0
8,104,25,0,0.0001,0.001,0.514,46,58
8,204,25,0,0.0001,0.001,0.544,103,101
8,304,25,0,0.0001,0.001,0.538,153,151
8,404,25,0,0.0001,0.001,0.502,209,195
8,504,25,0,0.0001,0.001,0.504,249,255
8,604,25,0,0.0001,0.001,0.534,301,303
8,704,25,0,0.0001,0.001,0.538,345,359
8,804,25,0,0.0001,0.001,0.536,392,412
8,904,25,0,0.0001,0.001,0.54,440,464
8,1004,25,0,0.0001,0.001,0.536,490,514
8,1104,25,0,0.0001,0.001,0.54,539,565
8,1204,25,0,0.0001,0.001,0.548,591,613
8,1304,25,0,0.0001,0.001,0.572,646,658
8,1404,25,0,0.0001,0.001,0.596,702,702
8,1504,25,0,0.0001,0.001,0.608,757,747
8,1604,25,0,0.0001,0.001,0.646,814,790
8,1704,25,0,0.0001,0.001,0.678,857,847
8,1804,25,0,0.0001,0.001,0.714,907,897
8,1904,25,0,0.0001,0.001,0.768,952,952
9,0,25,0,0.0001,0.001,0.536,0,0
9,104,25,0,0.0001,0.001,0.536,50,54
9,204,25,0,0.0001,0.001,0.56,101,103
9,304,25,0,0.0001,0.001,0.614,144,160
9,404,25,0,0.0001,0.001,0.584,197,207
9,504,25,0,0.0001,0.001,0.584,248,256
9,604,25,0,0.0001,0.001,0.638,308,296
9,704,25,0,0.0001,0.001,0.644,355,349
9,804,25,0,0.0001,0.001,0.656,402,402
9,904,25,0,0.0001,0.001,0.674,454,450
9,1004,25,0,0.0001,0.001,0.674,493,511
9,1104,25,0,0.0001,0.001,0.694,542,562
9,1204,25,0,0.0001,0.001,0.726,593,611
9,1304,25,0,0.0001,0.001,0.746,648,656
9,1404,25,0,0.0001,0.001,0.774,692,712
9,1504,25,0,0.0001,0.001,0.796,741,763
9,1604,25,0,0.0001,0.001,0.834,801,803
9,1704,25,0,0.0001,0.001,0.868,852,852
9,1804,25,0,0.0001,0.001,0.888,895,909
9,1904,25,0,0.0001,0.001,0.908,952,952
10,0,25,0,0.0001,0.001,0.512,0,0
10,104,25,0,0.0001,0.001,0.522,45,59
10,204,25,0,0.0001,0.001,0.548,96,108
10,304,25,0,0.0001,0.001,0.572,147,157
10,404,25,0,0.0001,0.001,0.562,197,207
10,504,25,0,0.0001,0.001,0.572,249,255
10,604,25,0,0.0001,0.001,0.602,294,310
10,704,25,0,0.0001,0.001,0.594,351,353
10,804,25,0,0.0001,0.001,0.598,404,400
10,904,25,0,0.0001,0.001,0.596,456,448
10,1004,25,0,0.0001,0.001,0.624,504,500
10,1104,25,0,0.0001,0.001,0.642,550,554
10,1204,25,0,0.0001,0.001,0.662,603,601
10,1304,25,0,0.0001,0.001,0.704,648,656
10,1404,25,0,0.0001,0.001,0.73,695,709
10,1504,25,0,0.0001,0.001,0.73,748,756
10,1604,25,0,0.0001,0.001,0.768,803,801
10,1704,25,0,0.0001,0.001,0.798,849,855
10,1804,25,0,0.0001,0.001,0.83,899,905
10,1904,25,0,0.0001,0.001,0.854,952,952
11,0,25,0,0.0001,0.001,0.506,0,0
11,104,25,0,0.0001,0.001,0.506,53,51
11,204,25,0,0.0001,0.001,0.55,104,100
11,304,25,0,0.0001,0.001,0.58,143,161
11,404,25,0,0.0001,0.001,0.55,199,205
11,504,25,0,0.0001,0.001,0.562,247,257
11,604,25,0,0.0001,0.001,0.598,302,302
11,704,25,0,0.0001,0.001,0.608,350,354
11,804,25,0,0.0001,0.001,0.616,407,397
11,904,25,0,0.0001,0.001,0.618,455,449
11,1004,25,0,0.0001,0.001,0.652,507,497
11,1104,25,0,0.0001,0.001,0.682,563,541
11,1204,25,0,0.0001,0.001,0.698,615,589
11,1304,25,0,0.0001,0.001,0.724,664,640
11,1404,25,0,0.0001,0.001,0.752,708,696
11,1504,25,0,0.0001,0.001,0.774,760,744
11,1604,25,0,0.0001,0.001,0.794,808,796
11,1704,25,0,0.0001,0.001,0.842,857,847
11,1804,25,0,0.0001,0.001,0.868,904,900
11,1904,25,0,0.0001,0.001,0.888,952,952
12,0,25,0,0.0001,0.001,0.524,0,0
12,104,25,0,0.0001,0.001,0.534,49,55
12,204,25,0,0.0001,0.001,0.55,97,107
12,304,25,0,0.0001,0.001,0.6,148,156
12,404,25,0,0.0001,0.001,0.582,209,195
12,504,25,0,0.0001,0.001,0.582,261,243
12,604,25,0,0.0001,0.001,0.616,318,286
12,704,25,0,0.0001,0.001,0.634,364,340
12,804,25,0,0.0001,0.001,0.638,418,386
12,904,25,0,0.0001,0.001,0.644,465,439
12,1004,25,0,0.0001,0.001,0.668,515,489
12,1104,25,0,0.0001,0.001,0.688,559,545
12,1204,25,0,0.0001,0.001,0.702,603,601
12,1304,25,0,0.0001,0.001,0.744,659,645
12,1404,25,0,0.0001,0.001,0.78,707,697
12,1504,25,0,0.0001,0.001,0.812,748,756
12,1604,25,0,0.0001,0.001,0.856,808,796
12,1704,25,0,0.0001,0.001,0.882,858,846
12,1804,25,0,0.0001,0.001,0.912,903,901
12,1904,25,0,0.0001,0.001,0.938,952,952
13,0,25,0,0.0001,0.001,0.526,0,0
13,104,25,0,0.0001,0.001,0.526,48,56
13,204,25,0,0.0001,0.001,0.558,94,110
13,304,25,0,0.0001,0.001,0.636,137,167
13,404,25,0,0.0001,0.001,0.622,184,220
13,504,25,0,0.0001,0.001,0.636,230,274
13,604,25,0,0.0001,0.001,0.656,280,324
13,704,25,0,0.0001,0.001,0.676,330,374
13,804,25,0,0.0001,0.001,0.696,375,429
13,904,25,0,0.0001,0.001,0.712,431,473
13,1004,25,0,0.0001,0.001,0.74,482,522
13,1104,25,0,0.0001,0.001,0.772,528,576
13,1204,25,0,0.0001,0.001,0.806,579,625
13,1304,25,0,0.0001,0.001,0.836,637,667
13,1404,25,0,0.0001,0.001,0.86,691,713
13,1504,25,0,0.0001,0.001,0.884,744,760
13,1604,25,0,0.0001,0.001,0.91,794,810
13,1704,25,0,0.0001,0.001,0.932,841,863
13,1804,25,0,0.0001,0.001,0.942,896,908
13,1904,25,0,0.0001,0.001,0.956,952,952
14,0,25,0,0.0001,0.001,0.534,0,0
14,104,25,0,0.0001,0.001,0.54,53,51
14,204,25,0,0.0001,0.001,0.576,98,106
14,304,25,0,0.0001,0.001,0.628,138,166
14,404,25,0,0.0001,0.001,0.568,189,215
14,504,25,0,0.0001,0.001,0.57,238,266
14,604,25,0,0.0001,0.001,0.606,292,312
14,704,25,0,0.0001,0.001,0.67,342,362
14,804,25,0,0.0001,0.001,0.696,396,408
14,904,25,0,0.0001,0.001,0.708,451,453
14,1004,25,0,0.0001,0.001,0.712,490,514
14,1104,25,0,0.0001,0.001,0.768,553,551
14,1204,25,0,0.0001,0.001,0.784,596,608
14,1304,25,0,0.0001,0.001,0.812,643,661
14,1404,25,0,0.0001,0.001,0.826,697,707
14,1504,25,0,0.0001,0.001,0.866,748,756
14,1604,25,0,0.0001,0.001,0.89,800,804
14,1704,25,0,0.0001,0.001,0.916,853,851
14,1804,25,0,0.0001,0.001,0.92,894,910
14,1904,25,0,0.0001,0.001,0.938,952,952
15,0,25,0,0.0001,0.001,0.506,0,0
15,104,25,0,0.0001,0.001,0.502,48,56
15,204,25,0,0.0001,0.001,0.538,101,103
15,304,25,0,0.0001,0.001,0.59,146,158
15,404,25,0,0.0001,0.001,0.554,194,210
15,504,25,0,0.0001,0.001,0.55,236,268
15,604,25,0,0.0001,0.001,0.614,297,307
15,704,25,0,0.0001,0.001,0.626,346,358
15,804,25,0,0.0001,0.001,0.638,396,408
15,904,25,0,0.0001,0.001,0.628,446,458
15,1004,25,0,0.0001,0.001,0.648,498,506
15,1104,25,0,0.0001,0.001,0.656,551,553
15,1204,25,0,0.0001,0.001,0.676,603,601
15,1304,25,0,0.0001,0.001,0.696,665,639
15,1404,25,0,0.0001,0.001,0.698,716,688
15,1504,25,0,0.0001,0.001,0.724,756,748
15,1604,25,0,0.0001,0.001,0.762,801,803
15,1704,25,0,0.0001,0.001,0.782,851,853
15,1804,25,0,0.0001,0.001,0.81,903,901
15,1904,25,0,0.0001,0.001,0.844,952,952
16,0,25,0,0.0001,0.001,0.512,0,0
16,104,25,0,0.0001,0.001,0.518,53,51
16,204,25,0,0.0001,0.001,0.54,116,88
16,304,25,0,0.0001,0.001,0.566,170,134
16,404,25,0,0.0001,0.001,0.542,213,191
16,504,25,0,0.0001,0.001,0.55,256,248
16,604,25,0,0.0001,0.001,0.596,300,304
16,704,25,0,0.0001,0.001,0.59,352,352
16,804,25,0,0.0001,0.001,0.61,405,399
16,904,25,0,0.0001,0.001,0.628,460,444
16,1004,25,0,0.0001,0.001,0.632,506,498
16,1104,25,0,0.0001,0.001,0.66,554,550
16,1204,25,0,0.0001,0.001,0.686,601,603
16,1304,25,0,0.0001,0.001,0.704,649,655
16,1404,25,0,0.0001,0.001,0.722,701,703
16,1504,25,0,0.0001,0.001,0.758,751,753
16,1604,25,0,0.0001,0.001,0.784,801,803
16,1704,25,0,0.0001,0.001,0.808,852,852
16,1804,25,0,0.0001,0.001,0.838,903,901
16,1904,25,0,0.0001,0.001,0.88,952,952
17,0,25,0,0.0001,0.001,0.522,0,0
17,104,25,0,0.0001,0.001,0.534,51,53
17,204,25,0,0.0001,0.001,0.572,98,106
17,304,25,0,0.0001,0.001,0.628,145,159
17,404,25,0,0.0001,0.001,0.666,199,205
17,504,25,0,0.0001,0.001,0.648,254,250
17,604,25,0,0.0001,0.001,0.686,300,304
17,704,25,0,0.0001,0.001,0.682,354,350
17,804,25,0,0.0001,0.001,0.712,400,404
17,904,25,0,0.0001,0.001,0.734,453,451
17,1004,25,0,0.0001,0.001,0.75,509,495
17,1104,25,0,0.0001,0.001,0.774,562,542
17,1204,25,0,0.0001,0.001,0.8,609,595
17,1304,25,0,0.0001,0.001,0.826,650,654
17,1404,25,0,0.0001,0.001,0.854,705,699
17,1504,25,0,0.0001,0.001,0.89,753,751
17,1604,25,0,0.0001,0.001,0.924,804,800
17,1704,25,0,0.0001,0.001,0.944,850,854
17,1804,25,0,0.0001,0.001,0.968,900,904
17,1904,25,0,0.0001,0.001,0.97,952,952
18,0,25,0,0.0001,0.001,0.518,0,0
18,104,25,0,0.0001,0.001,0.52,58,46
18,204,25,0,0.0001,0.001,0.532,107,97
18,304,25,0,0.0001,0.001,0.556,156,148
18,404,25,0,0.0001,0.001,0.588,196,208
18,504,25,0,0.0001,0.001,0.588,250,254
18,604,25,0,0.0001,0.001,0.614,305,299
18,704,25,0,0.0001,0.001,0.622,356,348
18,804,25,0,0.0001,0.001,0.638,405,399
18,904,25,0,0.0001,0.001,0.658,453,451
18,1004,25,0,0.0001,0.001,0.658,503,501
18,1104,25,0,0.0001,0.001,0.672,547,557
18,1204,25,0,0.0001,0.001,0.696,589,615
18,1304,25,0,0.0001,0.001,0.73,643,661
18,1404,25,0,0.0001,0.001,0.76,695,709
18,1504,25,0,0.0001,0.001,0.786,737,767
18,1604,25,0,0.0001,0.001,0.844,789,815
18,1704,25,0,0.0001,0.001,0.866,844,860
18,1804,25,0,0.0001,0.001,0.898,898,906
18,1904,25,0,0.0001,0.001,0.914,952,952
19,0,25,0,0.0001,0.001,0.518,0,0
19,104,25,0,0.0001,0.001,0.516,60,44
19,204,25,0,0.0001,0.001,0.55,119,85
19,304,25,0,0.0001,0.001,0.636,173,131
19,404,25,0,0.0001,0.001,0.6,215,189
19,504,25,0,0.0001,0.001,0.586,261,243
19,604,25,0,0.0001,0.001,0.654,313,291
19,704,25,0,0.0001,0.001,0.658,362,342
19,804,25,0,0.0001,0.001,0.664,409,395
19,904,25,0,0.0001,0.001,0.682,457,447
19,1004,25,0,0.0001,0.001,0.694,499,505
19,1104,25,0,0.0001,0.001,0.734,541,563
19,1204,25,0,0.0001,0.001,0.742,587,617
19,1304,25,0,0.0001,0.001,0.772,640,664
19,1404,25,0,0.0001,0.001,0.798,697,707
19,1504,25,0,0.0001,0.001,0.82,751,753
19,1604,25,0,0.0001,0.001,0.862,796,808
19,1704,25,0,0.0001,0.001,0.882,857,847
19,1804,25,0,0.0001,0.001,0.904,907,897
19,1904,25,0,0.0001,0.001,0.924,952,952
20,0,25,0,0.0001,0.001,0.522,0,0
20,104,25,0,0.0001,0.001,0.526,62,42
20,204,25,0,0.0001,0.001,0.576,118,86
20,304,25,0,0.0001,0.001,0.612,165,139
20,404,25,0,0.0001,0.001,0.592,207,197
20,504,25,0,0.0001,0.001,0.572,253,251
20,604,25,0,0.0001,0.001,0.604,303,301
20,704,25,0,0.0001,0.001,0.654,353,351
20,804,25,0,0.0001,0.001,0.662,407,397
20,904,25,0,0.0001,0.001,0.696,460,444
20,1004,25,0,0.0001,0.001,0.694,512,492
20,1104,25,0,0.0001,0.001,0.74,561,543
20,1204,25,0,0.0001,0.001,0.77,619,585
20,1304,25,0,0.0001,0.001,0.778,666,638
20,1404,25,0,0.0001,0.001,0.812,706,698
20,1504,25,0,0.0001,0.001,0.824,757,747
20,1604,25,0,0.0001,0.001,0.846,806,798
20,1704,25,0,0.0001,0.001,0.878,855,849
20,1804,25,0,0.0001,0.001,0.912,905,899
20,1904,25,0,0.0001,0.001,0.922,952,952
1,0,25,0,0.0001,0.01,0.502,0,0
1,104,25,0,0.0001,0.01,0.568,54,50
1,204,25,0,0.0001,0.01,0.51,100,104
1,304,25,0,0.0001,0.01,0.628,152,152
1,404,25,0,0.0001,0.01,0.572,203,201
1,504,25,0,0.0001,0.01,0.646,259,245
1,604,25,0,0.0001,0.01,0.646,313,291
1,704,25,0,0.0001,0.01,0.622,359,345
1,804,25,0,0.0001,0.01,0.702,409,395
1,904,25,0,0.0001,0.01,0.73,456,448
1,1004,25,0,0.0001,0.01,0.73,506,498
1,1104,25,0,0.0001,0.01,0.774,548,556
1,1204,25,0,0.0001,0.01,0.808,602,602
1,1304,25,0,0.0001,0.01,0.83,659,645
1,1404,25,0,0.0001,0.01,0.852,714,690
1,1504,25,0,0.0001,0.01,0.874,765,739
1,1604,25,0,0.0001,0.01,0.89,815,789
1,1704,25,0,0.0001,0.01,0.906,863,841
1,1804,25,0,0.0001,0.01,0.928,907,897
1,1904,25,0,0.0001,0.01,0.934,952,952
2,0,25,0,0.0001,0.01,0.504,0,0
2,104,25,0,0.0001,0.01,0.57,43,61
2,204,25,0,0.0001,0.01,0.544,81,123
2,304,25,0,0.0001,0.01,0.59,130,174
2,404,25,0,0.0001,0.01,0.63,181,223
2,504,25,0,0.0001,0.01,0.622,230,274
2,604,25,0,0.0001,0.01,0.656,284,320
2,704,25,0,0.0001,0.01,0.678,331,373
2,804,25,0,0.0001,0.01,0.69,386,418
2,904,25,0,0.0001,0.01,0.72,438,466
2,1004,25,0,0.0001,0.01,0.74,499,505
2,1104,25,0,0.0001,0.01,0.752,550,554
2,1204,25,0,0.0001,0.01,0.782,600,604
2,1304,25,0,0.0001,0.01,0.822,652,652
2,1404,25,0,0.0001,0.01,0.84,706,698
2,1504,25,0,0.0001,0.01,0.876,752,752
2,1604,25,0,0.0001,0.01,0.884,800,804
2,1704,25,0,0.0001,0.01,0.912,848,856
2,1804,25,0,0.0001,0.01,0.926,892,912
2,1904,25,0,0.0001,0.01,0.938,952,952
3,0,25,0,0.0001,0.01,0.508,0,0
3,104,25,0,0.0001,0.01,0.61,58,46
3,204,25,0,0.0001,0.01,0.508,104,100
3,304,25,0,0.0001,0.01,0.644,157,147
3,404,25,0,0.0001,0.01,0.628,209,195
3,504,25,0,0.0001,0.01,0.624,257,247
3,604,25,0,0.0001,0.01,0.656,306,298
3,704,25,0,0.0001,0.01,0.678,352,352
3,804,25,0,0.0001,0.01,0.728,397,407
3,904,25,0,0.0001,0.01,0.74,446,458
3,1004,25,0,0.0001,0.01,0.784,494,510
3,1104,25,0,0.0001,0.01,0.836,540,564
3,1204,25,0,0.0001,0.01,0.868,588,616
3,1304,25,0,0.0001,0.01,0.898,645,659
3,1404,25,0,0.0001,0.01,0.916,698,706
3,1504,25,0,0.0001,0.01,0.93,745,759
3,1604,25,0,0.0001,0.01,0.94,793,811
3,1704,25,0,0.0001,0.01,0.956,844,860
3,1804,25,0,0.0001,0.01,0.96,901,903
3,1904,25,0,0.0001,0.01,0.964,952,952
4,0,25,0,0.0001,0.01,0.514,0,0
4,104,25,0,0.0001,0.01,0.552,52,52
4,204,25,0,0.0001,0.01,0.51,94,110
4,304,25,0,0.0001,0.01,0.574,143,161
4,404,25,0,0.0001,0.01,0.568,192,212
4,504,25,0,0.0001,0.01,0.556,243,261
4,604,25,0,0.0001,0.01,0.53,290,314
4,704,25,0,0.0001,0.01,0.548,348,356
4,804,25,0,0.0001,0.01,0.556,393,411
4,904,25,0,0.0001,0.01,0.576,440,464
4,1004,25,0,0.0001,0.01,0.608,488,516
4,1104,25,0,0.0001,0.01,0.602,539,565
4,1204,25,0,0.0001,0.01,0.608,591,613
4,1304,25,0,0.0001,0.01,0.618,645,659
4,1404,25,0,0.0001,0.01,0.636,694,710
4,1504,25,0,0.0001,0.01,0.676,747,757
4,1604,25,0,0.0001,0.01,0.722,801,803
4,1704,25,0,0.0001,0.01,0.746,849,855
4,1804,25,0,0.0001,0.01,0.768,899,905
4,1904,25,0,0.0001,0.01,0.786,952,952
5,0,25,0,0.0001,0.01,0.5,0,0
5,104,25,0,0.0001,0.01,0.578,46,58
5,204,25,0,0.0001,0.01,0.528,107,97
5,304,25,0,0.0001,0.01,0.67,156,148
5,404,25,0,0.0001,0.01,0.636,209,195
5,504,25,0,0.0001,0.01,0.618,257,247
5,604,25,0,0.0001,0.01,0.632,300,304
5,704,25,0,0.0001,0.01,0.664,346,358
5,804,25,0,0.0001,0.01,0.678,391,413
5,904,25,0,0.0001,0.01,0.702,455,449
5,1004,25,0,0.0001,0.01,0.716,503,501
5,1104,25,0,0.0001,0.01,0.738,557,547
5,1204,25,0,0.0001,0.01,0.738,605,599
5,1304,25,0,0.0001,0.01,0.792,652,652
5,1404,25,0,0.0001,0.01,0.808,709,695
5,1504,25,0,0.0001,0.01,0.83,756,748
5,1604,25,0,0.0001,0.01,0.848,809,795
5,1704,25,0,0.0001,0.01,0.86,857,847
5,1804,25,0,0.0001,0.01,0.882,908,896
5,1904,25,0,0.0001,0.01,0.894,952,952
6,0,25,0,0.0001,0.01,0.504,0,0
6,104,25,0,0.0001,0.01,0.53,48,56
6,204,25,0,0.0001,0.01,0.514,92,112
6,304,25,0,0.0001,0.01,0.548,146,158
6,404,25,0,0.0001,0.01,0.542,193,211
6,504,25,0,0.0001,0.01,0.528,232,272
6,604,25,0,0.0001,0.01,0.542,285,319
6,704,25,0,0.0001,0.01,0.574,334,370
6,804,25,0,0.0001,0.01,0.574,377,427
6,904,25,0,0.0001,0.01,0.592,426,478
6,1004,25,0,0.0001,0.01,0.64,480,524
6,1104,25,0,0.0001,0.01,0.642,533,571
6,1204,25,0,0.0001,0.01,0.686,589,615
6,1304,25,0,0.0001,0.01,0.706,641,663
6,1404,25,0,0.0001,0.01,0.728,701,703
6,1504,25,0,0.0001,0.01,0.762,751,753
6,1604,25,0,0.0001,0.01,0.796,802,802
6,1704,25,0,0.0001,0.01,0.816,853,851
6,1804,25,0,0.0001,0.01,0.844,908,896
6,1904,25,0,0.0001,0.01,0.862,952,952
7,0,25,0,0.0001,0.01,0.504,0,0
7,104,25,0,0.0001,0.01,0.618,47,57
7,204,25,0,0.0001,0.01,0.542,96,108
7,304,25,0,0.0001,0.01,0.676,149,155
7,404,25,0,0.0001,0.01,0.656,197,207
7,504,25,0,0.0001,0.01,0.612,249,255
7,604,25,0,0.0001,0.01,0.654,311,293
7,704,25,0,0.0001,0.01,0.71,364,340
7,804,25,0,0.0001,0.01,0.692,409,395
7,904,25,0,0.0001,0.01,0.722,461,443
7,1004,25,0,0.0001,0.01,0.74,509,495
7,1104,25,0,0.0001,0.01,0.764,556,548
7,1204,25,0,0.0001,0.01,0.79,603,601
7,1304,25,0,0.0001,0.01,0.82,649,655
7,1404,25,0,0.0001,0.01,0.866,702,702
7,1504,25,0,0.0001,0.01,0.892,752,752
7,1604,25,0,0.0001,0.01,0.926,811,793
7,1704,25,0,0.0001,0.01,0.942,857,847
7,1804,25,0,0.0001,0.01,0.948,908,896
7,1904,25,0,0.0001,0.01,0.962,952,952
8,0,25,0,0.0001,0.01,0.504,0,0
8,104,25,0,0.0001,0.01,0.548,50,54
8,204,25,0,0.0001,0.01,0.548,101,103
8,304,25,0,0.0001,0.01,0.546,151,153
8,404,25,0,0.0001,0.01,0.588,209,195
8,504,25,0,0.0001,0.01,0.586,257,247
8,604,25,0,0.0001,0.01,0.642,313,291
8,704,25,0,0.0001,0.01,0.65,360,344
8,804,25,0,0.0001,0.01,0.686,416,388
8,904,25,0,0.0001,0.01,0.692,467,437
8,1004,25,0,0.0001,0.01,0.752,515,489
8,1104,25,0,0.0001,0.01,0.772,560,544
8,1204,25,0,0.0001,0.01,0.802,607,597
8,1304,25,0,0.0001,0.01,0.838,655,649
8,1404,25,0,0.0001,0.01,0.866,700,704
8,1504,25,0,0.0001,0.01,0.89,744,760
8,1604,25,0,0.0001,0.01,0.92,793,811
8,1704,25,0,0.0001,0.01,0.924,841,863
8,1804,25,0,0.0001,0.01,0.946,897,907
8,1904,25,0,0.0001,0.01,0.954,952,952
9,0,25,0,0.0001,0.01,0.5,0,0
9,104,25,0,0.0001,0.01,0.564,56,48
9,204,25,0,0.0001,0.01,0.53,103,101
9,304,25,0,0.0001,0.01,0.584,145,159
9,404,25,0,0.0001,0.01,0.568,195,209
9,504,25,0,0.0001,0.01,0.596,250,254
9,604,25,0,0.0001,0.01,0.574,295,309
9,704,25,0,0.0001,0.01,0.604,339,365
9,804,25,0,0.0001,0.01,0.638,394,410
9,904,25,0,0.0001,0.01,0.63,441,463
9,1004,25,0,0.0001,0.01,0.65,491,513
9,1104,25,0,0.0001,0.01,0.674,544,560
9,1204,25,0,0.0001,0.01,0.706,599,605
9,1304,25,0,0.0001,0.01,0.736,654,650
9,1404,25,0,0.0001,0.01,0.76,696,708
9,1504,25,0,0.0001,0.01,0.792,749,755
9,1604,25,0,0.0001,0.01,0.832,806,798
9,1704,25,0,0.0001,0.01,0.86,856,848
9,1804,25,0,0.0001,0.01,0.884,905,899
9,1904,25,0,0.0001,0.01,0.91,952,952
10,0,25,0,0.0001,0.01,0.5,0,0
10,104,25,0,0.0001,0.01,0.588,47,57
10,204,25,0,0.0001,0.01,0.546,101,103
10,304,25,0,0.0001,0.01,0.656,152,152
10,404,25,0,0.0001,0.01,0.654,205,199
10,504,25,0,0.0001,0.01,0.648,255,249
10,604,25,0,0.0001,0.01,0.708,299,305
10,704,25,0,0.0001,0.01,0.708,350,354
10,804,25,0,0.0001,0.01,0.73,411,393
10,904,25,0,0.0001,0.01,0.76,457,447
10,1004,25,0,0.0001,0.01,0.81,515,489
10,1104,25,0,0.0001,0.01,0.842,554,550
10,1204,25,0,0.0001,0.01,0.864,618,586
10,1304,25,0,0.0001,0.01,0.894,662,642
10,1404,25,0,0.0001,0.01,0.912,707,697
10,1504,25,0,0.0001,0.01,0.928,753,751
10,1604,25,0,0.0001,0.01,0.938,811,793
10,1704,25,0,0.0001,0.01,0.95,859,845
10,1804,25,0,0.0001,0.01,0.952,903,901
10,1904,25,0,0.0001,0.01,0.958,952,952
11,0,25,0,0.0001,0.01,0.502,0,0
11,104,25,0,0.0001,0.01,0.598,51,53
11,204,25,0,0.0001,0.01,0.55,99,105
11,304,25,0,0.0001,0.01,0.618,149,155
11,404,25,0,0.0001,0.01,0.634,203,201
11,504,25,0,0.0001,0.01,0.614,260,244
11,604,25,0,0.0001,0.01,0.656,313,291
11,704,25,0,0.0001,0.01,0.674,363,341
11,804,25,0,0.0001,0.01,0.688,406,398
11,904,25,0,0.0001,0.01,0.714,457,447
11,1004,25,0,0.0001,0.01,0.712,514,490
11,1104,25,0,0.0001,0.01,0.756,560,544
11,1204,25,0,0.0001,0.01,0.78,610,594
11,1304,25,0,0.0001,0.01,0.798,661,643
11,1404,25,0,0.0001,0.01,0.814,708,696
11,1504,25,0,0.0001,0.01,0.842,751,753
11,1604,25,0,0.0001,0.01,0.874,806,798
11,1704,25,0,0.0001,0.01,0.9,853,851
11,1804,25,0,0.0001,0.01,0.91,907,897
11,1904,25,0,0.0001,0.01,0.936,952,952
12,0,25,0,0.0001,0.01,0.504,0,0
12,104,25,0,0.0001,0.01,0.572,53,51
12,204,25,0,0.0001,0.01,0.522,104,100
12,304,25,0,0.0001,0.01,0.628,158,146
12,404,25,0,0.0001,0.01,0.59,208,196
12,504,25,0,0.0001,0.01,0.618,251,253
12,604,25,0,0.0001,0.01,0.622,305,299
12,704,25,0,0.0001,0.01,0.632,351,353
12,804,25,0,0.0001,0.01,0.668,401,403
12,904,25,0,0.0001,0.01,0.68,442,462
12,1004,25,0,0.0001,0.01,0.7,499,505
12,1104,25,0,0.0001,0.01,0.714,549,555
12,1204,25,0,0.0001,0.01,0.736,602,602
12,1304,25,0,0.0001,0.01,0.744,650,654
12,1404,25,0,0.0001,0.01,0.768,702,702
12,1504,25,0,0.0001,0.01,0.786,744,760
12,1604,25,0,0.0001,0.01,0.814,800,804
12,1704,25,0,0.0001,0.01,0.838,852,852
12,1804,25,0,0.0001,0.01,0.862,905,899
12,1904,25,0,0.0001,0.01,0.904,952,952
13,0,25,0,0.0001,0.01,0.502,0,0
13,104,25,0,0.0001,0.01,0.554,53,51
13,204,25,0,0.0001,0.01,0.518,103,101
13,304,25,0,0.0001,0.01,0.622,152,152
13,404,25,0,0.0001,0.01,0.602,207,197
13,504,25,0,0.0001,0.01,0.626,256,248
13,604,25,0,0.0001,0.01,0.658,312,292
13,704,25,0,0.0001,0.01,0.662,358,346
13,804,25,0,0.0001,0.01,0.714,402,402
13,904,25,0,0.0001,0.01,0.708,450,454
13,1004,25,0,0.0001,0.01,0.72,507,497
13,1104,25,0,0.0001,0.01,0.762,553,551
13,1204,25,0,0.0001,0.01,0.782,608,596
13,1304,25,0,0.0001,0.01,0.812,665,639
13,1404,25,0,0.0001,0.01,0.846,715,689
13,1504,25,0,0.0001,0.01,0.862,761,743
13,1604,25,0,0.0001,0.01,0.898,810,794
13,1704,25,0,0.0001,0.01,0.904,851,853
13,1804,25,0,0.0001,0.01,0.924,899,905
13,1904,25,0,0.0001,0.01,0.93,952,952
14,0,25,0,0.0001,0.01,0.502,0,0
14,104,25,0,0.0001,0.01,0.602,47,57
14,204,25,0,0.0001,0.01,0.506,101,103
14,304,25,0,0.0001,0.01,0.628,157,147
14,404,25,0,0.0001,0.01,0.61,200,204
14,504,25,0,0.0001,0.01,0.626,252,252
14,604,25,0,0.0001,0.01,0.624,302,302
14,704,25,0,0.0001,0.01,0.64,355,349
14,804,25,0,0.0001,0.01,0.666,407,397
14,904,25,0,0.0001,0.01,0.68,453,451
14,1004,25,0,0.0001,0.01,0.682,508,496
14,1104,25,0,0.0001,0.01,0.702,559,545
14,1204,25,0,0.0001,0.01,0.74,616,588
14,1304,25,0,0.0001,0.01,0.768,661,643
14,1404,25,0,0.0001,0.01,0.796,703,701
14,1504,25,0,0.0001,0.01,0.826,753,751
14,1604,25,0,0.0001,0.01,0.858,806,798
14,1704,25,0,0.0001,0.01,0.88,848,856
14,1804,25,0,0.0001,0.01,0.892,901,903
14,1904,25,0,0.0001,0.01,0.916,952,952
15,0,25,0,0.0001,0.01,0.502,0,0
15,104,25,0,0.0001,0.01,0.584,55,49
15,204,25,0,0.0001,0.01,0.53,97,107
15,304,25,0,0.0001,0.01,0.568,157,147
15,404,25,0,0.0001,0.01,0.57,206,198
15,504,25,0,0.0001,0.01,0.58,251,253
15,604,25,0,0.0001,0.01,0.602,290,314
15,704,25,0,0.0001,0.01,0.616,345,359
15,804,25,0,0.0001,0.01,0.636,398,406
15,904,25,0,0.0001,0.01,0.676,457,447
15,1004,25,0,0.0001,0.01,0.684,501,503
15,1104,25,0,0.0001,0.01,0.686,560,544
15,1204,25,0,0.0001,0.01,0.738,617,587
15,1304,25,0,0.0001,0.01,0.756,655,649
15,1404,25,0,0.0001,0.01,0.788,712,692
15,1504,25,0,0.0001,0.01,0.822,758,746
15,1604,25,0,0.0001,0.01,0.848,803,801
15,1704,25,0,0.0001,0.01,0.868,849,855
15,1804,25,0,0.0001,0.01,0.896,898,906
15,1904,25,0,0.0001,0.01,0.91,952,952
16,0,25,0,0.0001,0.01,0.51,0,0
16,104,25,0,0.0001,0.01,0.6,49,55
16,204,25,0,0.0001,0.01,0.534,96,108
16,304,25,0,0.0001,0.01,0.562,146,158
16,404,25,0,0.0001,0.01,0.594,192,212
16,504,25,0,0.0001,0.01,0.63,240,264
16,604,25,0,0.0001,0.01,0.638,294,310
16,704,25,0,0.0001,0.01,0.664,344,360
16,804,25,0,0.0001,0.01,0.712,392,412
16,904,25,0,0.0001,0.01,0.716,445,459
16,1004,25,0,0.0001,0.01,0.734,494,510
16,1104,25,0,0.0001,0.01,0.75,550,554
16,1204,25,0,0.0001,0.01,0.77,605,599
16,1304,25,0,0.0001,0.01,0.792,656,648
16,1404,25,0,0.0001,0.01,0.812,703,701
16,1504,25,0,0.0001,0.01,0.852,748,756
16,1604,25,0,0.0001,0.01,0.86,802,802
16,1704,25,0,0.0001,0.01,0.888,839,865
16,1804,25,0,0.0001,0.01,0.904,895,909
16,1904,25,0,0.0001,0.01,0.922,952,952
17,0,25,0,0.0001,0.01,0.502,0,0
17,104,25,0,0.0001,0.01,0.568,52,52
17,204,25,0,0.0001,0.01,0.512,102,102
17,304,25,0,0.0001,0.01,0.586,154,150
17,404,25,0,0.0001,0.01,0.554,204,200
17,504,25,0,0.0001,0.01,0.588,247,257
17,604,25,0,0.0001,0.01,0.582,290,314
17,704,25,0,0.0001,0.01,0.584,338,366
17,804,25,0,0.0001,0.01,0.606,388,416
17,904,25,0,0.0001,0.01,0.64,436,468
17,1004,25,0,0.0001,0.01,0.648,491,513
17,1104,25,0,0.0001,0.01,0.692,538,566
17,1204,25,0,0.0001,0.01,0.746,595,609
17,1304,25,0,0.0001,0.01,0.768,644,660
17,1404,25,0,0.0001,0.01,0.792,703,701
17,1504,25,0,0.0001,0.01,0.834,745,759
17,1604,25,0,0.0001,0.01,0.858,800,804
17,1704,25,0,0.0001,0.01,0.876,853,851
17,1804,25,0,0.0001,0.01,0.896,907,897
17,1904,25,0,0.0001,0.01,0.918,952,952
18,0,25,0,0.0001,0.01,0.532,0,0
18,104,25,0,0.0001,0.01,0.672,48,56
18,204,25,0,0.0001,0.01,0.512,107,97
18,304,25,0,0.0001,0.01,0.666,160,144
18,404,25,0,0.0001,0.01,0.656,200,204
18,504,25,0,0.0001,0.01,0.596,253,251
18,604,25,0,0.0001,0.01,0.644,305,299
18,704,25,0,0.0001,0.01,0.7,356,348
18,804,25,0,0.0001,0.01,0.69,403,401
18,904,25,0,0.0001,0.01,0.764,453,451
18,1004,25,0,0.0001,0.01,0.786,496,508
18,1104,25,0,0.0001,0.01,0.816,545,559
18,1204,25,0,0.0001,0.01,0.842,602,602
18,1304,25,0,0.0001,0.01,0.866,652,652
18,1404,25,0,0.0001,0.01,0.882,697,707
18,1504,25,0,0.0001,0.01,0.904,749,755
18,1604,25,0,0.0001,0.01,0.924,798,806
18,1704,25,0,0.0001,0.01,0.926,851,853
18,1804,25,0,0.0001,0.01,0.944,903,901
18,1904,25,0,0.0001,0.01,0.96,952,952
19,0,25,0,0.0001,0.01,0.504,0,0
19,104,25,0,0.0001,0.01,0.518,53,51
19,204,25,0,0.0001,0.01,0.538,102,102
19,304,25,0,0.0001,0.01,0.578,151,153
19,404,25,0,0.0001,0.01,0.576,202,202
19,504,25,0,0.0001,0.01,0.586,245,259
19,604,25,0,0.0001,0.01,0.61,294,310
19,704,25,0,0.0001,0.01,0.62,345,359
19,804,25,0,0.0001,0.01,0.672,396,408
19,904,25,0,0.0001,0.01,0.692,445,459
19,1004,25,0,0.0001,0.01,0.714,493,511
19,1104,25,0,0.0001,0.01,0.75,549,555
19,1204,25,0,0.0001,0.01,0.76,597,607
19,1304,25,0,0.0001,0.01,0.772,647,657
19,1404,25,0,0.0001,0.01,0.812,697,707
19,1504,25,0,0.0001,0.01,0.834,749,755
19,1604,25,0,0.0001,0.01,0.864,797,807
19,1704,25,0,0.0001,0.01,0.878,846,858
19,1804,25,0,0.0001,0.01,0.89,901,903
19,1904,25,0,0.0001,0.01,0.91,952,952
20,0,25,0,0.0001,0.01,0.504,0,0
20,104,25,0,0.0001,0.01,0.59,59,45
20,204,25,0,0.0001,0.01,0.514,108,96
20,304,25,0,0.0001,0.01,0.606,160,144
20,404,25,0,0.0001,0.01,0.54,200,204
20,504,25,0,0.0001,0.01,0.576,246,258
20,604,25,0,0.0001,0.01,0.584,312,292
20,704,25,0,0.0001,0.01,0.598,359,345
20,804,25,0,0.0001,0.01,0.624,400,404
20,904,25,0,0.0001,0.01,0.622,452,452
20,1004,25,0,0.0001,0.01,0.662,504,500
20,1104,25,0,0.0001,0.01,0.694,557,547
20,1204,25,0,0.0001,0.01,0.706,612,592
20,1304,25,0,0.0001,0.01,0.756,654,650
20,1404,25,0,0.0001,0.01,0.786,705,699
20,1504,25,0,0.0001,0.01,0.816,757,747
20,1604,25,0,0.0001,0.01,0.844,808,796
20,1704,25,0,0.0001,0.01,0.89,855,849
20,1804,25,0,0.0001,0.01,0.914,902,902
20,1904,25,0,0.0001,0.01,0.928,952,952
1,0,25,0,0.001,0.0001,0.504,0,0
1,104,25,0,0.001,0.0001,0.504,51,53
1,204,25,0,0.001,0.0001,0.504,96,108
1,304,25,0,0.001,0.0001,0.504,142,162
1,404,25,0,0.001,0.0001,0.506,184,220
1,504,25,0,0.001,0.0001,0.504,239,265
1,604,25,0,0.001,0.0001,0.5,288,316
1,704,25,0,0.001,0.0001,0.5,338,366
1,804,25,0,0.001,0.0001,0.502,389,415
1,904,25,0,0.001,0.0001,0.496,446,458
1,1004,25,0,0.001,0.0001,0.496,496,508
1,1104,25,0,0.001,0.0001,0.5,545,559
1,1204,25,0,0.001,0.0001,0.502,596,608
1,1304,25,0,0.001,0.0001,0.502,653,651
1,1404,25,0,0.001,0.0001,0.506,703,701
1,1504,25,0,0.001,0.0001,0.502,746,758
1,1604,25,0,0.001,0.0001,0.492,794,810
1,1704,25,0,0.001,0.0001,0.482,843,861
1,1804,25,0,0.001,0.0001,0.478,900,904
1,1904,25,0,0.001,0.0001,0.482,952,952
2,0,25,0,0.001,0.0001,0.51,0,0
2,104,25,0,0.001,0.0001,0.51,51,53
2,204,25,0,0.001,0.0001,0.508,99,105
2,304,25,0,0.001,0.0001,0.51,145,159
2,404,25,0,0.001,0.0001,0.51,203,201
2,504,25,0,0.001,0.0001,0.508,250,254
2,604,25,0,0.001,0.0001,0.508,297,307
2,704,25,0,0.001,0.0001,0.512,350,354
2,804,25,0,0.001,0.0001,0.516,402,402
2,904,25,0,0.001,0.0001,0.516,446,458
2,1004,25,0,0.001,0.0001,0.514,497,507
2,1104,25,0,0.001,0.0001,0.514,548,556
2,1204,25,0,0.001,0.0001,0.514,590,614
2,1304,25,0,0.001,0.0001,0.514,635,669
2,1404,25,0,0.001,0.0001,0.518,681,723
2,1504,25,0,0.001,0.0001,0.52,732,772
2,1604,25,0,0.001,0.0001,0.52,781,823
2,1704,25,0,0.001,0.0001,0.518,841,863
2,1804,25,0,0.001,0.0001,0.508,900,904
2,1904,25,0,0.001,0.0001,0.512,952,952
3,0,25,0,0.001,0.0001,0.5,0,0
3,104,25,0,0.001,0.0001,0.5,50,54
3,204,25,0,0.001,0.0001,0.5,103,101
3,304,25,0,0.001,0.0001,0.5,153,151
3,404,25,0,0.001,0.0001,0.5,204,200
3,504,25,0,0.001,0.0001,0.5,258,246
3,604,25,0,0.001,0.0001,0.5,303,301
3,704,25,0,0.001,0.0001,0.5,358,346
3,804,25,0,0.001,0.0001,0.5,402,402
3,904,25,0,0.001,0.0001,0.5,444,460
3,1004,25,0,0.001,0.0001,0.5,497,507
3,1104,25,0,0.001,0.0001,0.5,553,551
3,1204,25,0,0.001,0.0001,0.498,604,600
3,1304,25,0,0.001,0.0001,0.498,659,645
3,1404,25,0,0.001,0.0001,0.498,713,691
3,1504,25,0,0.001,0.0001,0.498,760,744
3,1604,25,0,0.001,0.0001,0.498,803,801
3,1704,25,0,0.001,0.0001,0.496,849,855
3,1804,25,0,0.001,0.0001,0.496,900,904
3,1904,25,0,0.001,0.0001,0.496,952,952
4,0,25,0,0.001,0.0001,0.508,0,0
4,104,25,0,0.001,0.0001,0.508,58,46
4,204,25,0,0.001,0.0001,0.508,112,92
4,304,25,0,0.001,0.0001,0.51,155,149
4,404,25,0,0.001,0.0001,0.51,204,200
4,504,25,0,0.001,0.0001,0.51,256,248
4,604,25,0,0.001,0.0001,0.51,305,299
4,704,25,0,0.001,0.0001,0.514,363,341
4,804,25,0,0.001,0.0001,0.514,411,393
4,904,25,0,0.001,0.0001,0.516,456,448
4,1004,25,0,0.001,0.0001,0.514,513,491
4,1104,25,0,0.001,0.0001,0.506,563,541
4,1204,25,0,0.001,0.0001,0.516,614,590
4,1304,25,0,0.001,0.0001,0.518,662,642
4,1404,25,0,0.001,0.0001,0.522,697,707
4,1504,25,0,0.001,0.0001,0.51,751,753
4,1604,25,0,0.001,0.0001,0.502,798,806
4,1704,25,0,0.001,0.0001,0.504,845,859
4,1804,25,0,0.001,0.0001,0.494,901,903
4,1904,25,0,0.001,0.0001,0.496,952,952
5,0,25,0,0.001,0.0001,0.504,0,0
5,104,25,0,0.001,0.0001,0.508,55,49
5,204,25,0,0.001,0.0001,0.508,105,99
5,304,25,0,0.001,0.0001,0.514,147,157
5,404,25,0,0.001,0.0001,0.514,194,210
5,504,25,0,0.001,0.0001,0.51,246,258
5,604,25,0,0.001,0.0001,0.506,294,310
5,704,25,0,0.001,0.0001,0.506,349,355
5,804,25,0,0.001,0.0001,0.506,405,399
5,904,25,0,0.001,0.0001,0.512,462,442
5,1004,25,0,0.001,0.0001,0.514,516,488
5,1104,25,0,0.001,0.0001,0.508,569,535
5,1204,25,0,0.001,0.0001,0.512,611,593
5,1304,25,0,0.001,0.0001,0.516,660,644
5,1404,25,0,0.001,0.0001,0.516,701,703
5,1504,25,0,0.001,0.0001,0.514,750,754
5,1604,25,0,0.001,0.0001,0.506,809,795
5,1704,25,0,0.001,0.0001,0.508,858,846
5,1804,25,0,0.001,0.0001,0.502,904,900
5,1904,25,0,0.001,0.0001,0.498,952,952
6,0,25,0,0.001,0.0001,0.502,0,0
6,104,25,0,0.001,0.0001,0.502,53,51
6,204,25,0,0.001,0.0001,0.502,104,100
6,304,25,0,0.001,0.0001,0.502,155,149
6,404,25,0,0.001,0.0001,0.502,202,202
6,504,25,0,0.001,0.0001,0.502,252,252
6,604,25,0,0.001,0.0001,0.502,304,300
6,704,25,0,0.001,0.0001,0.502,348,356
6,804,25,0,0.001,0.0001,0.5,398,406
6,904,25,0,0.001,0.0001,0.496,452,452
6,1004,25,0,0.001,0.0001,0.492,497,507
6,1104,25,0,0.001,0.0001,0.5,557,547
6,1204,25,0,0.001,0.0001,0.498,608,596
6,1304,25,0,0.001,0.0001,0.496,665,639
6,1404,25,0,0.001,0.0001,0.496,713,691
6,1504,25,0,0.001,0.0001,0.496,757,747
6,1604,25,0,0.001,0.0001,0.496,802,802
6,1704,25,0,0.001,0.0001,0.504,852,852
6,1804,25,0,0.001,0.0001,0.502,906,898
6,1904,25,0,0.001,0.0001,0.494,952,952
7,0,25,0,0.001,0.0001,0.478,0,0
7,104,25,0,0.001,0.0001,0.476,57,47
7,204,25,0,0.001,0.0001,0.476,110,94
7,304,25,0,0.001,0.0001,0.474,155,149
7,404,25,0,0.001,0.0001,0.466,209,195
7,504,25,0,0.001,0.0001,0.47,263,241
7,604,25,0,0.001,0.0001,0.47,308,296
7,704,25,0,0.001,0.0001,0.468,353,351
7,804,25,0,0.001,0.0001,0.466,405,399
7,904,25,0,0.001,0.0001,0.472,452,452
7,1004,25,0,0.001,0.0001,0.474,494,510
7,1104,25,0,0.001,0.0001,0.474,542,562
7,1204,25,0,0.001,0.0001,0.474,588,616
7,1304,25,0,0.001,0.0001,0.468,648,656
7,1404,25,0,0.001,0.0001,0.47,687,717
7,1504,25,0,0.001,0.0001,0.474,739,765
7,1604,25,0,0.001,0.0001,0.492,790,814
7,1704,25,0,0.001,0.0001,0.488,839,865
7,1804,25,0,0.001,0.0001,0.492,891,913
7,1904,25,0,0.001,0.0001,0.49,952,952
8,0,25,0,0.001,0.0001,0.514,0,0
8,104,25,0,0.001,0.0001,0.514,53,51
8,204,25,0,0.001,0.0001,0.514,105,99
8,304,25,0,0.001,0.0001,0.512,152,152
8,404,25,0,0.001,0.0001,0.512,213,191
8,504,25,0,0.001,0.0001,0.508,271,233
8,604,25,0,0.001,0.0001,0.514,321,283
8,704,25,0,0.001,0.0001,0.52,368,336
8,804,25,0,0.001,0.0001,0.546,407,397
8,904,25,0,0.001,0.0001,0.546,455,449
8,1004,25,0,0.001,0.0001,0.53,505,499
8,1104,25,0,0.001,0.0001,0.524,560,544
8,1204,25,0,0.001,0.0001,0.528,607,597
8,1304,25,0,0.001,0.0001,0.534,662,642
8,1404,25,0,0.001,0.0001,0.536,715,689
8,1504,25,0,0.001,0.0001,0.536,756,748
8,1604,25,0,0.001,0.0001,0.538,806,798
8,1704,25,0,0.001,0.0001,0.536,858,846
8,1804,25,0,0.001,0.0001,0.54,900,904
8,1904,25,0,0.001,0.0001,0.542,952,952
9,0,25,0,0.001,0.0001,0.488,0,0
9,104,25,0,0.001,0.0001,0.49,47,57
9,204,25,0,0.001,0.0001,0.49,91,113
9,304,25,0,0.001,0.0001,0.492,147,157
9,404,25,0,0.001,0.0001,0.49,200,204
9,504,25,0,0.001,0.0001,0.49,252,252
9,604,25,0,0.001,0.0001,0.492,298,306
9,704,25,0,0.001,0.0001,0.49,348,356
9,804,25,0,0.001,0.0001,0.49,394,410
9,904,25,0,0.001,0.0001,0.484,442,462
9,1004,25,0,0.001,0.0001,0.486,484,520
9,1104,25,0,0.001,0.0001,0.48,538,566
9,1204,25,0,0.001,0.0001,0.48,589,615
9,1304,25,0,0.001,0.0001,0.474,638,666
9,1404,25,0,0.001,0.0001,0.488,692,712
9,1504,25,0,0.001,0.0001,0.482,741,763
9,1604,25,0,0.001,0.0001,0.484,798,806
9,1704,25,0,0.001,0.0001,0.48,847,857
9,1804,25,0,0.001,0.0001,0.486,901,903
9,1904,25,0,0.001,0.0001,0.47,952,952
10,0,25,0,0.001,0.0001,0.5,0,0
10,104,25,0,0.001,0.0001,0.5,49,55
10,204,25,0,0.001,0.0001,0.5,93,111
10,304,25,0,0.001,0.0001,0.5,145,159
10,404,25,0,0.001,0.0001,0.5,188,216
10,504,25,0,0.001,0.0001,0.5,238,266
10,604,25,0,0.001,0.0001,0.5,288,316
10,704,25,0,0.001,0.0001,0.5,338,366
10,804,25,0,0.001,0.0001,0.5,384,420
10,904,25,0,0.001,0.0001,0.5,433,471
10,1004,25,0,0.001,0.0001,0.5,478,526
10,1104,25,0,0.001,0.0001,0.5,528,576
10,1204,25,0,0.001,0.0001,0.5,574,630
10,1304,25,0,0.001,0.0001,0.5,633,671
10,1404,25,0,0.001,0.0001,0.5,693,711
10,1504,25,0,0.001,0.0001,0.5,741,763
10,1604,25,0,0.001,0.0001,0.5,787,817
10,1704,25,0,0.001,0.0001,0.5,843,861
10,1804,25,0,0.001,0.0001,0.5,897,907
10,1904,25,0,0.001,0.0001,0.5,952,952
11,0,25,0,0.001,0.0001,0.5,0,0
11,104,25,0,0.001,0.0001,0.5,60,44
11,204,25,0,0.001,0.0001,0.5,114,90
11,304,25,0,0.001,0.0001,0.5,156,148
11,404,25,0,0.001,0.0001,0.5,209,195
11,504,25,0,0.001,0.0001,0.5,252,252
11,604,25,0,0.001,0.0001,0.5,302,302
11,704,25,0,0.001,0.0001,0.5,348,356
11,804,25,0,0.001,0.0001,0.5,389,415
11,904,25,0,0.001,0.0001,0.5,435,469
11,1004,25,0,0.001,0.0001,0.5,482,522
11,1104,25,0,0.001,0.0001,0.5,538,566
11,1204,25,0,0.001,0.0001,0.5,595,609
11,1304,25,0,0.001,0.0001,0.5,649,655
11,1404,25,0,0.001,0.0001,0.5,704,700
11,1504,25,0,0.001,0.0001,0.5,753,751
11,1604,25,0,0.001,0.0001,0.502,817,787
11,1704,25,0,0.001,0.0001,0.502,858,846
11,1804,25,0,0.001,0.0001,0.506,909,895
11,1904,25,0,0.001,0.0001,0.502,952,952
12,0,25,0,0.001,0.0001,0.496,0,0
12,104,25,0,0.001,0.0001,0.496,49,55
12,204,25,0,0.001,0.0001,0.496,101,103
12,304,25,0,0.001,0.0001,0.496,148,156
12,404,25,0,0.001,0.0001,0.496,198,206
12,504,25,0,0.001,0.0001,0.496,248,256
12,604,25,0,0.001,0.0001,0.498,291,313
12,704,25,0,0.001,0.0001,0.498,348,356
12,804,25,0,0.001,0.0001,0.494,399,405
12,904,25,0,0.001,0.0001,0.49,444,460
12,1004,25,0,0.001,0.0001,0.49,497,507
12,1104,25,0,0.001,0.0001,0.486,556,548
12,1204,25,0,0.001,0.0001,0.486,604,600
12,1304,25,0,0.001,0.0001,0.488,651,653
12,1404,25,0,0.001,0.0001,0.5,705,699
12,1504,25,0,0.001,0.0001,0.5,761,743
12,1604,25,0,0.001,0.0001,0.498,814,790
12,1704,25,0,0.001,0.0001,0.5,867,837
12,1804,25,0,0.001,0.0001,0.496,909,895
12,1904,25,0,0.001,0.0001,0.504,952,952
13,0,25,0,0.001,0.0001,0.5,0,0
13,104,25,0,0.001,0.0001,0.5,51,53
13,204,25,0,0.001,0.0001,0.5,97,107
13,304,25,0,0.001,0.0001,0.5,143,161
13,404,25,0,0.001,0.0001,0.5,194,210
13,504,25,0,0.001,0.0001,0.5,247,257
13,604,25,0,0.001,0.0001,0.5,304,300
13,704,25,0,0.001,0.0001,0.5,359,345
13,804,25,0,0.001,0.0001,0.5,414,390
13,904,25,0,0.001,0.0001,0.5,467,437
13,1004,25,0,0.001,0.0001,0.496,516,488
13,1104,25,0,0.001,0.0001,0.492,571,533
13,1204,25,0,0.001,0.0001,0.496,618,586
13,1304,25,0,0.001,0.0001,0.49,663,641
13,1404,25,0,0.001,0.0001,0.494,707,697
13,1504,25,0,0.001,0.0001,0.494,757,747
13,1604,25,0,0.001,0.0001,0.49,810,794
13,1704,25,0,0.001,0.0001,0.482,852,852
13,1804,25,0,0.001,0.0001,0.48,902,902
13,1904,25,0,0.001,0.0001,0.486,952,952
14,0,25,0,0.001,0.0001,0.55,0,0
14,104,25,0,0.001,0.0001,0.55,50,54
14,204,25,0,0.001,0.0001,0.55,97,107
14,304,25,0,0.001,0.0001,0.542,144,160
14,404,25,0,0.001,0.0001,0.546,198,206
14,504,25,0,0.001,0.0001,0.542,247,257
14,604,25,0,0.001,0.0001,0.54,296,308
14,704,25,0,0.001,0.0001,0.54,344,360
14,804,25,0,0.001,0.0001,0.528,390,414
14,904,25,0,0.001,0.0001,0.526,444,460
14,1004,25,0,0.001,0.0001,0.53,497,507
14,1104,25,0,0.001,0.0001,0.53,551,553
14,1204,25,0,0.001,0.0001,0.534,603,601
14,1304,25,0,0.001,0.0001,0.528,659,645
14,1404,25,0,0.001,0.0001,0.532,708,696
14,1504,25,0,0.001,0.0001,0.532,754,750
14,1604,25,0,0.001,0.0001,0.532,808,796
14,1704,25,0,0.001,0.0001,0.534,860,844
14,1804,25,0,0.001,0.0001,0.536,902,902
14,1904,25,0,0.001,0.0001,0.534,952,952
15,0,25,0,0.001,0.0001,0.476,0,0
15,104,25,0,0.001,0.0001,0.476,62,42
15,204,25,0,0.001,0.0001,0.474,112,92
15,304,25,0,0.001,0.0001,0.472,166,138
15,404,25,0,0.001,0.0001,0.478,219,185
15,504,25,0,0.001,0.0001,0.476,279,225
15,604,25,0,0.001,0.0001,0.478,325,279
15,704,25,0,0.001,0.0001,0.486,370,334
15,804,25,0,0.001,0.0001,0.484,417,387
15,904,25,0,0.001,0.0001,0.486,466,438
15,1004,25,0,0.001,0.0001,0.486,509,495
15,1104,25,0,0.001,0.0001,0.484,551,553
15,1204,25,0,0.001,0.0001,0.486,600,604
15,1304,25,0,0.001,0.0001,0.482,645,659
15,1404,25,0,0.001,0.0001,0.478,699,705
15,1504,25,0,0.001,0.0001,0.48,748,756
15,1604,25,0,0.001,0.0001,0.474,792,812
15,1704,25,0,0.001,0.0001,0.48,845,859
15,1804,25,0,0.001,0.0001,0.48,902,902
15,1904,25,0,0.001,0.0001,0.48,952,952
16,0,25,0,0.001,0.0001,0.552,0,0
16,104,25,0,0.001,0.0001,0.552,44,60
16,204,25,0,0.001,0.0001,0.556,98,106
16,304,25,0,0.001,0.0001,0.544,147,157
16,404,25,0,0.001,0.0001,0.542,198,206
16,504,25,0,0.001,0.0001,0.538,247,257
16,604,25,0,0.001,0.0001,0.536,298,306
16,704,25,0,0.001,0.0001,0.538,343,361
16,804,25,0,0.001,0.0001,0.534,396,408
16,904,25,0,0.001,0.0001,0.536,441,463
16,1004,25,0,0.001,0.0001,0.536,497,507
16,1104,25,0,0.001,0.0001,0.54,541,563
16,1204,25,0,0.001,0.0001,0.536,590,614
16,1304,25,0,0.001,0.0001,0.54,637,667
16,1404,25,0,0.001,0.0001,0.538,698,706
16,1504,25,0,0.001,0.0001,0.536,752,752
16,1604,25,0,0.001,0.0001,0.536,797,807
16,1704,25,0,0.001,0.0001,0.538,850,854
16,1804,25,0,0.001,0.0001,0.534,899,905
16,1904,25,0,0.001,0.0001,0.528,952,952
17,0,25,0,0.001,0.0001,0.49,0,0
17,104,25,0,0.001,0.0001,0.492,50,54
17,204,25,0,0.001,0.0001,0.492,93,111
17,304,25,0,0.001,0.0001,0.488,153,151
17,404,25,0,0.001,0.0001,0.488,198,206
17,504,25,0,0.001,0.0001,0.492,246,258
17,604,25,0,0.001,0.0001,0.494,292,312
17,704,25,0,0.001,0.0001,0.502,347,357
17,804,25,0,0.001,0.0001,0.51,401,403
17,904,25,0,0.001,0.0001,0.504,441,463
17,1004,25,0,0.001,0.0001,0.508,498,506
17,1104,25,0,0.001,0.0001,0.506,548,556
17,1204,25,0,0.001,0.0001,0.518,603,601
17,1304,25,0,0.001,0.0001,0.516,655,649
17,1404,25,0,0.001,0.0001,0.516,703,701
17,1504,25,0,0.001,0.0001,0.514,751,753
17,1604,25,0,0.001,0.0001,0.516,800,804
17,1704,25,0,0.001,0.0001,0.514,853,851
17,1804,25,0,0.001,0.0001,0.516,903,901
17,1904,25,0,0.001,0.0001,0.522,952,952
18,0,25,0,0.001,0.0001,0.488,0,0
18,104,25,0,0.001,0.0001,0.488,50,54
18,204,25,0,0.001,0.0001,0.488,107,97
18,304,25,0,0.001,0.0001,0.486,146,158
18,404,25,0,0.001,0.0001,0.486,202,202
18,504,25,0,0.001,0.0001,0.486,255,249
18,604,25,0,0.001,0.0001,0.49,298,306
18,704,25,0,0.001,0.0001,0.494,340,364
18,804,25,0,0.001,0.0001,0.496,394,410
18,904,25,0,0.001,0.0001,0.496,446,458
18,1004,25,0,0.001,0.0001,0.498,492,512
18,1104,25,0,0.001,0.0001,0.492,548,556
18,1204,25,0,0.001,0.0001,0.496,609,595
18,1304,25,0,0.001,0.0001,0.5,653,651
18,1404,25,0,0.001,0.0001,0.51,706,698
18,1504,25,0,0.001,0.0001,0.508,752,752
18,1604,25,0,0.001,0.0001,0.51,803,801
18,1704,25,0,0.001,0.0001,0.514,853,851
18,1804,25,0,0.001,0.0001,0.512,899,905
18,1904,25,0,0.001,0.0001,0.504,952,952
19,0,25,0,0.001,0.0001,0.502,0,0
19,104,25,0,0.001,0.0001,0.502,48,56
19,204,25,0,0.001,0.0001,0.5,99,105
19,304,25,0,0.001,0.0001,0.502,148,156
19,404,25,0,0.001,0.0001,0.5,200,204
19,504,25,0,0.001,0.0001,0.5,258,246
19,604,25,0,0.001,0.0001,0.498,307,297
19,704,25,0,0.001,0.0001,0.498,361,343
19,804,25,0,0.001,0.0001,0.492,411,393
19,904,25,0,0.001,0.0001,0.494,465,439
19,1004,25,0,0.001,0.0001,0.48,517,487
19,1104,25,0,0.001,0.0001,0.474,572,532
19,1204,25,0,0.001,0.0001,0.486,620,584
19,1304,25,0,0.001,0.0001,0.486,676,628
19,1404,25,0,0.001,0.0001,0.484,715,689
19,1504,25,0,0.001,0.0001,0.484,766,738
19,1604,25,0,0.001,0.0001,0.476,811,793
19,1704,25,0,0.001,0.0001,0.478,858,846
19,1804,25,0,0.001,0.0001,0.476,901,903
19,1904,25,0,0.001,0.0001,0.476,952,952
20,0,25,0,0.001,0.0001,0.518,0,0
20,104,25,0,0.001,0.0001,0.516,60,44
20,204,25,0,0.001,0.0001,0.514,104,100
20,304,25,0,0.001,0.0001,0.516,154,150
20,404,25,0,0.001,0.0001,0.514,199,205
20,504,25,0,0.001,0.0001,0.512,253,251
20,604,25,0,0.001,0.0001,0.512,298,306
20,704,25,0,0.001,0.0001,0.514,340,364
20,804,25,0,0.001,0.0001,0.514,400,404
20,904,25,0,0.001,0.0001,0.514,446,458
20,1004,25,0,0.001,0.0001,0.508,494,510
20,1104,25,0,0.001,0.0001,0.51,545,559
20,1204,25,0,0.001,0.0001,0.506,594,610
20,1304,25,0,0.001,0.0001,0.506,638,666
20,1404,25,0,0.001,0.0001,0.506,679,725
20,1504,25,0,0.001,0.0001,0.504,730,774
20,1604,25,0,0.001,0.0001,0.504,780,824
20,1704,25,0,0.001,0.0001,0.504,829,875
20,1804,25,0,0.001,0.0001,0.502,889,915
20,1904,25,0,0.001,0.0001,0.504,952,952
1,0,25,0,0.001,0.001,0.522,0,0
1,104,25,0,0.001,0.001,0.526,50,54
1,204,25,0,0.001,0.001,0.55,103,101
1,304,25,0,0.001,0.001,0.654,157,147
1,404,25,0,0.001,0.001,0.672,206,198
1,504,25,0,0.001,0.001,0.656,254,250
1,604,25,0,0.001,0.001,0.696,303,301
1,704,25,0,0.001,0.001,0.728,363,341
1,804,25,0,0.001,0.001,0.736,425,379
1,904,25,0,0.001,0.001,0.716,469,435
1,1004,25,0,0.001,0.001,0.756,517,487
1,1104,25,0,0.001,0.001,0.784,569,535
1,1204,25,0,0.001,0.001,0.794,616,588
1,1304,25,0,0.001,0.001,0.842,657,647
1,1404,25,0,0.001,0.001,0.862,709,695
1,1504,25,0,0.001,0.001,0.898,749,755
1,1604,25,0,0.001,0.001,0.916,797,807
1,1704,25,0,0.001,0.001,0.94,852,852
1,1804,25,0,0.001,0.001,0.95,908,896
1,1904,25,0,0.001,0.001,0.956,952,952
2,0,25,0,0.001,0.001,0.52,0,0
2,104,25,0,0.001,0.001,0.526,53,51
2,204,25,0,0.001,0.001,0.576,106,98
2,304,25,0,0.001,0.001,0.638,154,150
2,404,25,0,0.001,0.001,0.56,214,190
2,504,25,0,0.001,0.001,0.558,262,242
2,604,25,0,0.001,0.001,0.652,312,292
2,704,25,0,0.001,0.001,0.658,358,346
2,804,25,0,0.001,0.001,0.67,405,399
2,904,25,0,0.001,0.001,0.704,451,453
2,1004,25,0,0.001,0.001,0.706,509,495
2,1104,25,0,0.001,0.001,0.72,558,546
2,1204,25,0,0.001,0.001,0.744,607,597
2,1304,25,0,0.001,0.001,0.778,658,646
2,1404,25,0,0.001,0.001,0.812,706,698
2,1504,25,0,0.001,0.001,0.834,760,744
2,1604,25,0,0.001,0.001,0.856,808,796
2,1704,25,0,0.001,0.001,0.886,855,849
2,1804,25,0,0.001,0.001,0.9,901,903
2,1904,25,0,0.001,0.001,0.926,952,952
3,0,25,0,0.001,0.001,0.532,0,0
3,104,25,0,0.001,0.001,0.544,50,54
3,204,25,0,0.001,0.001,0.56,95,109
3,304,25,0,0.001,0.001,0.584,141,163
3,404,25,0,0.001,0.001,0.606,192,212
3,504,25,0,0.001,0.001,0.6,241,263
3,604,25,0,0.001,0.001,0.628,285,319
3,704,25,0,0.001,0.001,0.64,338,366
3,804,25,0,0.001,0.001,0.66,394,410
3,904,25,0,0.001,0.001,0.688,443,461
3,1004,25,0,0.001,0.001,0.706,499,505
3,1104,25,0,0.001,0.001,0.736,549,555
3,1204,25,0,0.001,0.001,0.764,597,607
3,1304,25,0,0.001,0.001,0.79,644,660
3,1404,25,0,0.001,0.001,0.818,695,709
3,1504,25,0,0.001,0.001,0.844,746,758
3,1604,25,0,0.001,0.001,0.87,792,812
3,1704,25,0,0.001,0.001,0.902,844,860
3,1804,25,0,0.001,0.001,0.928,900,904
3,1904,25,0,0.001,0.001,0.944,952,952
4,0,25,0,0.001,0.001,0.528,0,0
4,104,25,0,0.001,0.001,0.542,45,59
4,204,25,0,0.001,0.001,0.564,94,110
4,304,25,0,0.001,0.001,0.622,144,160
4,404,25,0,0.001,0.001,0.606,200,204
4,504,25,0,0.001,0.001,0.61,248,256
4,604,25,0,0.001,0.001,0.64,297,307
4,704,25,0,0.001,0.001,0.622,347,357
4,804,25,0,0.001,0.001,0.672,395,409
4,904,25,0,0.001,0.001,0.696,445,459
4,1004,25,0,0.001,0.001,0.696,497,507
4,1104,25,0,0.001,0.001,0.726,552,552
4,1204,25,0,0.001,0.001,0.746,596,608
4,1304,25,0,0.001,0.001,0.77,646,658
4,1404,25,0,0.001,0.001,0.79,697,707
4,1504,25,0,0.001,0.001,0.816,742,762
4,1604,25,0,0.001,0.001,0.846,789,815
4,1704,25,0,0.001,0.001,0.87,851,853
4,1804,25,0,0.001,0.001,0.888,900,904
4,1904,25,0,0.001,0.001,0.892,952,952
5,0,25,0,0.001,0.001,0.52,0,0
5,104,25,0,0.001,0.001,0.522,54,50
5,204,25,0,0.001,0.001,0.56,101,103
5,304,25,0,0.001,0.001,0.632,150,154
5,404,25,0,0.001,0.001,0.584,204,200
5,504,25,0,0.001,0.001,0.578,256,248
5,604,25,0,0.001,0.001,0.634,307,297
5,704,25,0,0.001,0.001,0.664,350,354
5,804,25,0,0.001,0.001,0.678,398,406
5,904,25,0,0.001,0.001,0.684,451,453
5,1004,25,0,0.001,0.001,0.708,492,512
5,1104,25,0,0.001,0.001,0.732,538,566
5,1204,25,0,0.001,0.001,0.776,589,615
5,1304,25,0,0.001,0.001,0.8,646,658
5,1404,25,0,0.001,0.001,0.84,691,713
5,1504,25,0,0.001,0.001,0.862,750,754
5,1604,25,0,0.001,0.001,0.892,798,806
5,1704,25,0,0.001,0.001,0.918,855,849
5,1804,25,0,0.001,0.001,0.932,900,904
5,1904,25,0,0.001,0.001,0.96,952,952
6,0,25,0,0.001,0.001,0.536,0,0
6,104,25,0,0.001,0.001,0.544,57,47
6,204,25,0,0.001,0.001,0.562,111,93
6,304,25,0,0.001,0.001,0.582,163,141
6,404,25,0,0.001,0.001,0.546,214,190
6,504,25,0,0.001,0.001,0.538,262,242
6,604,25,0,0.001,0.001,0.598,307,297
6,704,25,0,0.001,0.001,0.648,363,341
6,804,25,0,0.001,0.001,0.642,406,398
6,904,25,0,0.001,0.001,0.662,449,455
6,1004,25,0,0.001,0.001,0.678,509,495
6,1104,25,0,0.001,0.001,0.68,567,537
6,1204,25,0,0.001,0.001,0.704,617,587
6,1304,25,0,0.001,0.001,0.726,665,639
6,1404,25,0,0.001,0.001,0.746,714,690
6,1504,25,0,0.001,0.001,0.79,759,745
6,1604,25,0,0.001,0.001,0.832,804,800
6,1704,25,0,0.001,0.001,0.87,849,855
6,1804,25,0,0.001,0.001,0.906,899,905
6,1904,25,0,0.001,0.001,0.938,952,952
7,0,25,0,0.001,0.001,0.526,0,0
7,104,25,0,0.001,0.001,0.534,47,57
7,204,25,0,0.001,0.001,0.534,98,106
7,304,25,0,0.001,0.001,0.562,145,159
7,404,25,0,0.001,0.001,0.592,194,210
7,504,25,0,0.001,0.001,0.602,244,260
7,604,25,0,0.001,0.001,0.642,301,303
7,704,25,0,0.001,0.001,0.636,343,361
7,804,25,0,0.001,0.001,0.648,393,411
7,904,25,0,0.001,0.001,0.646,446,458
7,1004,25,0,0.001,0.001,0.662,489,515
7,1104,25,0,0.001,0.001,0.696,536,568
7,1204,25,0,0.001,0.001,0.732,578,626
7,1304,25,0,0.001,0.001,0.764,630,674
7,1404,25,0,0.001,0.001,0.8,685,719
7,1504,25,0,0.001,0.001,0.832,740,764
7,1604,25,0,0.001,0.001,0.866,797,807
7,1704,25,0,0.001,0.001,0.9,848,856
7,1804,25,0,0.001,0.001,0.92,896,908
7,1904,25,0,0.001,0.001,0.942,952,952
8,0,25,0,0.001,0.001,0.526,0,0
8,104,25,0,0.001,0.001,0.534,52,52
8,204,25,0,0.001,0.001,0.558,103,101
8,304,25,0,0.001,0.001,0.628,138,166
8,404,25,0,0.001,0.001,0.576,195,209
8,504,25,0,0.001,0.001,0.58,248,256
8,604,25,0,0.001,0.001,0.634,304,300
8,704,25,0,0.001,0.001,0.656,348,356
8,804,25,0,0.001,0.001,0.662,389,415
8,904,25,0,0.001,0.001,0.67,445,459
8,1004,25,0,0.001,0.001,0.714,496,508
8,1104,25,0,0.001,0.001,0.722,562,542
8,1204,25,0,0.001,0.001,0.726,618,586
8,1304,25,0,0.001,0.001,0.76,659,645
8,1404,25,0,0.001,0.001,0.788,710,694
8,1504,25,0,0.001,0.001,0.81,761,743
8,1604,25,0,0.001,0.001,0.852,805,799
8,1704,25,0,0.001,0.001,0.89,852,852
8,1804,25,0,0.001,0.001,0.922,898,906
8,1904,25,0,0.001,0.001,0.944,952,952
9,0,25,0,0.001,0.001,0.506,0,0
9,104,25,0,0.001,0.001,0.51,52,52
9,204,25,0,0.001,0.001,0.534,107,97
9,304,25,0,0.001,0.001,0.582,159,145
9,404,25,0,0.001,0.001,0.56,210,194
9,504,25,0,0.001,0.001,0.57,263,241
9,604,25,0,0.001,0.001,0.588,321,283
9,704,25,0,0.001,0.001,0.628,369,335
9,804,25,0,0.001,0.001,0.638,418,386
9,904,25,0,0.001,0.001,0.662,470,434
9,1004,25,0,0.001,0.001,0.68,518,486
9,1104,25,0,0.001,0.001,0.7,559,545
9,1204,25,0,0.001,0.001,0.712,610,594
9,1304,25,0,0.001,0.001,0.74,659,645
9,1404,25,0,0.001,0.001,0.77,720,684
9,1504,25,0,0.001,0.001,0.796,763,741
9,1604,25,0,0.001,0.001,0.842,813,791
9,1704,25,0,0.001,0.001,0.87,855,849
9,1804,25,0,0.001,0.001,0.886,901,903
9,1904,25,0,0.001,0.001,0.912,952,952
10,0,25,0,0.001,0.001,0.532,0,0
10,104,25,0,0.001,0.001,0.54,49,55
10,204,25,0,0.001,0.001,0.544,102,102
10,304,25,0,0.001,0.001,0.6,158,146
10,404,25,0,0.001,0.001,0.592,200,204
10,504,25,0,0.001,0.001,0.586,248,256
10,604,25,0,0.001,0.001,0.62,294,310
10,704,25,0,0.001,0.001,0.624,343,361
10,804,25,0,0.001,0.001,0.648,392,412
10,904,25,0,0.001,0.001,0.68,436,468
10,1004,25,0,0.001,0.001,0.688,488,516
10,1104,25,0,0.001,0.001,0.708,544,560
10,1204,25,0,0.001,0.001,0.74,592,612
10,1304,25,0,0.001,0.001,0.77,644,660
10,1404,25,0,0.001,0.001,0.796,701,703
10,1504,25,0,0.001,0.001,0.814,755,749
10,1604,25,0,0.001,0.001,0.84,802,802
10,1704,25,0,0.001,0.001,0.868,850,854
10,1804,25,0,0.001,0.001,0.894,908,896
10,1904,25,0,0.001,0.001,0.902,952,952
11,0,25,0,0.001,0.001,0.538,0,0
11,104,25,0,0.001,0.001,0.552,54,50
11,204,25,0,0.001,0.001,0.584,105,99
11,304,25,0,0.001,0.001,0.636,158,146
11,404,25,0,0.001,0.001,0.626,210,194
11,504,25,0,0.001,0.001,0.622,259,245
11,604,25,0,0.001,0.001,0.672,307,297
11,704,25,0,0.001,0.001,0.68,355,349
11,804,25,0,0.001,0.001,0.708,397,407
11,904,25,0,0.001,0.001,0.712,455,449
11,1004,25,0,0.001,0.001,0.736,510,494
11,1104,25,0,0.001,0.001,0.782,563,541
11,1204,25,0,0.001,0.001,0.808,611,593
11,1304,25,0,0.001,0.001,0.846,651,653
11,1404,25,0,0.001,0.001,0.87,700,704
11,1504,25,0,0.001,0.001,0.904,752,752
11,1604,25,0,0.001,0.001,0.918,806,798
11,1704,25,0,0.001,0.001,0.936,848,856
11,1804,25,0,0.001,0.001,0.952,903,901
11,1904,25,0,0.001,0.001,0.966,952,952
12,0,25,0,0.001,0.001,0.53,0,0
12,104,25,0,0.001,0.001,0.544,56,48
12,204,25,0,0.001,0.001,0.58,105,99
12,304,25,0,0.001,0.001,0.666,151,153
12,404,25,0,0.001,0.001,0.654,198,206
12,504,25,0,0.001,0.001,0.674,244,260
12,604,25,0,0.001,0.001,0.712,287,317
12,704,25,0,0.001,0.001,0.704,347,357
12,804,25,0,0.001,0.001,0.742,397,407
12,904,25,0,0.001,0.001,0.76,452,452
12,1004,25,0,0.001,0.001,0.774,498,506
12,1104,25,0,0.001,0.001,0.812,555,549
12,1204,25,0,0.001,0.001,0.836,607,597
12,1304,25,0,0.001,0.001,0.856,654,650
12,1404,25,0,0.001,0.001,0.882,699,705
12,1504,25,0,0.001,0.001,0.9,750,754
12,1604,25,0,0.001,0.001,0.924,802,802
12,1704,25,0,0.001,0.001,0.94,849,855
12,1804,25,0,0.001,0.001,0.954,899,905
12,1904,25,0,0.001,0.001,0.974,952,952
13,0,25,0,0.001,0.001,0.52,0,0
13,104,25,0,0.001,0.001,0.526,55,49
13,204,25,0,0.001,0.001,0.566,107,97
13,304,25,0,0.001,0.001,0.616,158,146
13,404,25,0,0.001,0.001,0.588,218,186
13,504,25,0,0.001,0.001,0.582,262,242
13,604,25,0,0.001,0.001,0.654,319,285
13,704,25,0,0.001,0.001,0.674,366,338
13,804,25,0,0.001,0.001,0.69,417,387
13,904,25,0,0.001,0.001,0.714,469,435
13,1004,25,0,0.001,0.001,0.73,521,483
13,1104,25,0,0.001,0.001,0.772,561,543
13,1204,25,0,0.001,0.001,0.798,608,596
13,1304,25,0,0.001,0.001,0.814,659,645
13,1404,25,0,0.001,0.001,0.846,709,695
13,1504,25,0,0.001,0.001,0.866,764,740
13,1604,25,0,0.001,0.001,0.892,817,787
13,1704,25,0,0.001,0.001,0.914,862,842
13,1804,25,0,0.001,0.001,0.936,901,903
13,1904,25,0,0.001,0.001,0.948,952,952
14,0,25,0,0.001,0.001,0.536,0,0
14,104,25,0,0.001,0.001,0.546,59,45
14,204,25,0,0.001,0.001,0.592,117,87
14,304,25,0,0.001,0.001,0.628,160,144
14,404,25,0,0.001,0.001,0.594,199,205
14,504,25,0,0.001,0.001,0.616,247,257
14,604,25,0,0.001,0.001,0.674,304,300
14,704,25,0,0.001,0.001,0.668,355,349
14,804,25,0,0.001,0.001,0.698,398,406
14,904,25,0,0.001,0.001,0.704,453,451
14,1004,25,0,0.001,0.001,0.746,506,498
14,1104,25,0,0.001,0.001,0.77,558,546
14,1204,25,0,0.001,0.001,0.798,606,598
14,1304,25,0,0.001,0.001,0.822,653,651
14,1404,25,0,0.001,0.001,0.834,706,698
14,1504,25,0,0.001,0.001,0.864,754,750
14,1604,25,0,0.001,0.001,0.898,802,802
14,1704,25,0,0.001,0.001,0.92,854,850
14,1804,25,0,0.001,0.001,0.936,895,909
14,1904,25,0,0.001,0.001,0.948,952,952
15,0,25,0,0.001,0.001,0.522,0,0
15,104,25,0,0.001,0.001,0.532,52,52
15,204,25,0,0.001,0.001,0.568,106,98
15,304,25,0,0.001,0.001,0.636,154,150
15,404,25,0,0.001,0.001,0.634,200,204
15,504,25,0,0.001,0.001,0.638,248,256
15,604,25,0,0.001,0.001,0.676,291,313
15,704,25,0,0.001,0.001,0.68,352,352
15,804,25,0,0.001,0.001,0.706,401,403
15,904,25,0,0.001,0.001,0.73,455,449
15,1004,25,0,0.001,0.001,0.756,506,498
15,1104,25,0,0.001,0.001,0.776,552,552
15,1204,25,0,0.001,0.001,0.806,606,598
15,1304,25,0,0.001,0.001,0.832,654,650
15,1404,25,0,0.001,0.001,0.85,705,699
15,1504,25,0,0.001,0.001,0.876,758,746
15,1604,25,0,0.001,0.001,0.898,809,795
15,1704,25,0,0.001,0.001,0.92,850,854
15,1804,25,0,0.001,0.001,0.934,890,914
15,1904,25,0,0.001,0.001,0.956,952,952
16,0,25,0,0.001,0.001,0.508,0,0
16,104,25,0,0.001,0.001,0.514,46,58
16,204,25,0,0.001,0.001,0.534,94,110
16,304,25,0,0.001,0.001,0.598,143,161
16,404,25,0,0.001,0.001,0.566,190,214
16,504,25,0,0.001,0.001,0.562,235,269
16,604,25,0,0.001,0.001,0.59,292,312
16,704,25,0,0.001,0.001,0.606,347,357
16,804,25,0,0.001,0.001,0.612,398,406
16,904,25,0,0.001,0.001,0.6,446,458
16,1004,25,0,0.001,0.001,0.61,491,513
16,1104,25,0,0.001,0.001,0.63,537,567
16,1204,25,0,0.001,0.001,0.644,587,617
16,1304,25,0,0.001,0.001,0.668,630,674
16,1404,25,0,0.001,0.001,0.706,681,723
16,1504,25,0,0.001,0.001,0.728,737,767
16,1604,25,0,0.001,0.001,0.756,796,808
16,1704,25,0,0.001,0.001,0.796,847,857
16,1804,25,0,0.001,0.001,0.828,900,904
16,1904,25,0,0.001,0.001,0.858,952,952
17,0,25,0,0.001,0.001,0.52,0,0
17,104,25,0,0.001,0.001,0.526,51,53
17,204,25,0,0.001,0.001,0.554,99,105
17,304,25,0,0.001,0.001,0.558,149,155
17,404,25,0,0.001,0.001,0.556,191,213
17,504,25,0,0.001,0.001,0.56,244,260
17,604,25,0,0.001,0.001,0.566,294,310
17,704,25,0,0.001,0.001,0.59,344,360
17,804,25,0,0.001,0.001,0.612,404,400
17,904,25,0,0.001,0.001,0.612,450,454
17,1004,25,0,0.001,0.001,0.634,499,505
17,1104,25,0,0.001,0.001,0.664,553,551
17,1204,25,0,0.001,0.001,0.688,606,598
17,1304,25,0,0.001,0.001,0.73,661,643
17,1404,25,0,0.001,0.001,0.764,708,696
17,1504,25,0,0.001,0.001,0.806,752,752
17,1604,25,0,0.001,0.001,0.846,805,799
17,1704,25,0,0.001,0.001,0.862,855,849
17,1804,25,0,0.001,0.001,0.892,904,900
17,1904,25,0,0.001,0.001,0.92,952,952
18,0,25,0,0.001,0.001,0.518,0,0
18,104,25,0,0.001,0.001,0.526,51,53
18,204,25,0,0.001,0.001,0.572,107,97
18,304,25,0,0.001,0.001,0.668,161,143
18,404,25,0,0.001,0.001,0.612,211,193
18,504,25,0,0.001,0.001,0.592,254,250
18,604,25,0,0.001,0.001,0.684,305,299
18,704,25,0,0.001,0.001,0.72,367,337
18,804,25,0,0.001,0.001,0.73,421,383
18,904,25,0,0.001,0.001,0.768,467,437
18,1004,25,0,0.001,0.001,0.79,514,490
18,1104,25,0,0.001,0.001,0.824,561,543
18,1204,25,0,0.001,0.001,0.85,610,594
18,1304,25,0,0.001,0.001,0.88,661,643
18,1404,25,0,0.001,0.001,0.896,710,694
18,1504,25,0,0.001,0.001,0.916,753,751
18,1604,25,0,0.001,0.001,0.944,812,792
18,1704,25,0,0.001,0.001,0.96,855,849
18,1804,25,0,0.001,0.001,0.974,904,900
18,1904,25,0,0.001,0.001,0.98,952,952
19,0,25,0,0.001,0.001,0.518,0,0
19,104,25,0,0.001,0.001,0.522,47,57
19,204,25,0,0.001,0.001,0.544,93,111
19,304,25,0,0.001,0.001,0.582,154,150
19,404,25,0,0.001,0.001,0.58,199,205
19,504,25,0,0.001,0.001,0.578,246,258
19,604,25,0,0.001,0.001,0.596,294,310
19,704,25,0,0.001,0.001,0.624,349,355
19,804,25,0,0.001,0.001,0.632,392,412
19,904,25,0,0.001,0.001,0.638,441,463
19,1004,25,0,0.001,0.001,0.644,496,508
19,1104,25,0,0.001,0.001,0.682,540,564
19,1204,25,0,0.001,0.001,0.714,587,617
19,1304,25,0,0.001,0.001,0.742,643,661
19,1404,25,0,0.001,0.001,0.75,692,712
19,1504,25,0,0.001,0.001,0.794,750,754
19,1604,25,0,0.001,0.001,0.816,793,811
19,1704,25,0,0.001,0.001,0.84,853,851
19,1804,25,0,0.001,0.001,0.858,901,903
19,1904,25,0,0.001,0.001,0.886,952,952
20,0,25,0,0.001,0.001,0.526,0,0
20,104,25,0,0.001,0.001,0.526,59,45
20,204,25,0,0.001,0.001,0.546,113,91
20,304,25,0,0.001,0.001,0.602,165,139
20,404,25,0,0.001,0.001,0.578,206,198
20,504,25,0,0.001,0.001,0.572,260,244
20,604,25,0,0.001,0.001,0.616,305,299
20,704,25,0,0.001,0.001,0.66,349,355
20,804,25,0,0.001,0.001,0.67,403,401
20,904,25,0,0.001,0.001,0.688,459,445
20,1004,25,0,0.001,0.001,0.698,505,499
20,1104,25,0,0.001,0.001,0.716,562,542
20,1204,25,0,0.001,0.001,0.746,617,587
20,1304,25,0,0.001,0.001,0.788,663,641
20,1404,25,0,0.001,0.001,0.808,720,684
20,1504,25,0,0.001,0.001,0.844,767,737
20,1604,25,0,0.001,0.001,0.872,815,789
20,1704,25,0,0.001,0.001,0.896,861,843
20,1804,25,0,0.001,0.001,0.93,906,898
20,1904,25,0,0.001,0.001,0.96,952,952
1,0,25,0,0.001,0.01,0.748,0,0
1,104,25,0,0.001,0.01,0.516,63,41
1,204,25,0,0.001,0.01,0.694,107,97
1,304,25,0,0.001,0.01,0.728,155,149
1,404,25,0,0.001,0.01,0.71,204,200
1,504,25,0,0.001,0.01,0.714,251,253
1,604,25,0,0.001,0.01,0.756,299,305
1,704,25,0,0.001,0.01,0.834,353,351
1,804,25,0,0.001,0.01,0.862,404,400
1,904,25,0,0.001,0.01,0.898,452,452
1,1004,25,0,0.001,0.01,0.912,496,508
1,1104,25,0,0.001,0.01,0.944,548,556
1,1204,25,0,0.001,0.01,0.938,601,603
1,1304,25,0,0.001,0.01,0.944,654,650
1,1404,25,0,0.001,0.01,0.962,704,700
1,1504,25,0,0.001,0.01,0.97,750,754
1,1604,25,0,0.001,0.01,0.972,789,815
1,1704,25,0,0.001,0.01,0.97,845,859
1,1804,25,0,0.001,0.01,0.982,897,907
1,1904,25,0,0.001,0.01,0.98,952,952
2,0,25,0,0.001,0.01,0.528,0,0
2,104,25,0,0.001,0.01,0.666,51,53
2,204,25,0,0.001,0.01,0.564,106,98
2,304,25,0,0.001,0.01,0.59,160,144
2,404,25,0,0.001,0.01,0.686,207,197
2,504,25,0,0.001,0.01,0.656,255,249
2,604,25,0,0.001,0.01,0.676,303,301
2,704,25,0,0.001,0.01,0.73,351,353
2,804,25,0,0.001,0.01,0.81,399,405
2,904,25,0,0.001,0.01,0.842,455,449
2,1004,25,0,0.001,0.01,0.846,496,508
2,1104,25,0,0.001,0.01,0.906,546,558
2,1204,25,0,0.001,0.01,0.924,597,607
2,1304,25,0,0.001,0.01,0.944,656,648
2,1404,25,0,0.001,0.01,0.956,705,699
2,1504,25,0,0.001,0.01,0.972,750,754
2,1604,25,0,0.001,0.01,0.97,800,804
2,1704,25,0,0.001,0.01,0.978,840,864
2,1804,25,0,0.001,0.01,0.986,898,906
2,1904,25,0,0.001,0.01,0.984,952,952
3,0,25,0,0.001,0.01,0.548,0,0
3,104,25,0,0.001,0.01,0.6,45,59
3,204,25,0,0.001,0.01,0.642,92,112
3,304,25,0,0.001,0.01,0.646,142,162
3,404,25,0,0.001,0.01,0.638,189,215
3,504,25,0,0.001,0.01,0.646,236,268
3,604,25,0,0.001,0.01,0.704,284,320
3,704,25,0,0.001,0.01,0.728,337,367
3,804,25,0,0.001,0.01,0.784,393,411
3,904,25,0,0.001,0.01,0.818,443,461
3,1004,25,0,0.001,0.01,0.828,490,514
3,1104,25,0,0.001,0.01,0.882,543,561
3,1204,25,0,0.001,0.01,0.898,582,622
3,1304,25,0,0.001,0.01,0.928,632,672
3,1404,25,0,0.001,0.01,0.944,691,713
3,1504,25,0,0.001,0.01,0.946,739,765
3,1604,25,0,0.001,0.01,0.962,791,813
3,1704,25,0,0.001,0.01,0.964,839,865
3,1804,25,0,0.001,0.01,0.966,899,905
3,1904,25,0,0.001,0.01,0.976,952,952
4,0,25,0,0.001,0.01,0.75,0,0
4,104,25,0,0.001,0.01,0.504,59,45
4,204,25,0,0.001,0.01,0.642,110,94
4,304,25,0,0.001,0.01,0.728,162,142
4,404,25,0,0.001,0.01,0.668,206,198
4,504,25,0,0.001,0.01,0.694,248,256
4,604,25,0,0.001,0.01,0.766,305,299
4,704,25,0,0.001,0.01,0.802,355,349
4,804,25,0,0.001,0.01,0.836,402,402
4,904,25,0,0.001,0.01,0.88,456,448
4,1004,25,0,0.001,0.01,0.87,505,499
4,1104,25,0,0.001,0.01,0.908,556,548
4,1204,25,0,0.001,0.01,0.918,603,601
4,1304,25,0,0.001,0.01,0.952,658,646
4,1404,25,0,0.001,0.01,0.95,705,699
4,1504,25,0,0.001,0.01,0.962,754,750
4,1604,25,0,0.001,0.01,0.964,808,796
4,1704,25,0,0.001,0.01,0.97,852,852
4,1804,25,0,0.001,0.01,0.97,899,905
4,1904,25,0,0.001,0.01,0.98,952,952
5,0,25,0,0.001,0.01,0.728,0,0
5,104,25,0,0.001,0.01,0.508,51,53
5,204,25,0,0.001,0.01,0.7,107,97
5,304,25,0,0.001,0.01,0.718,160,144
5,404,25,0,0.001,0.01,0.696,206,198
5,504,25,0,0.001,0.01,0.712,262,242
5,604,25,0,0.001,0.01,0.766,309,295
5,704,25,0,0.001,0.01,0.79,351,353
5,804,25,0,0.001,0.01,0.876,404,400
5,904,25,0,0.001,0.01,0.898,459,445
5,1004,25,0,0.001,0.01,0.928,512,492
5,1104,25,0,0.001,0.01,0.942,555,549
5,1204,25,0,0.001,0.01,0.968,607,597
5,1304,25,0,0.001,0.01,0.974,653,651
5,1404,25,0,0.001,0.01,0.974,703,701
5,1504,25,0,0.001,0.01,0.976,751,753
5,1604,25,0,0.001,0.01,0.98,803,801
5,1704,25,0,0.001,0.01,0.984,854,850
5,1804,25,0,0.001,0.01,0.992,902,902
5,1904,25,0,0.001,0.01,0.99,952,952
6,0,25,0,0.001,0.01,0.742,0,0
6,104,25,0,0.001,0.01,0.528,52,52
6,204,25,0,0.001,0.01,0.744,100,104
6,304,25,0,0.001,0.01,0.71,158,146
6,404,25,0,0.001,0.01,0.754,211,193
6,504,25,0,0.001,0.01,0.756,251,253
6,604,25,0,0.001,0.01,0.772,302,302
6,704,25,0,0.001,0.01,0.804,350,354
6,804,25,0,0.001,0.01,0.838,405,399
6,904,25,0,0.001,0.01,0.86,455,449
6,1004,25,0,0.001,0.01,0.876,503,501
6,1104,25,0,0.001,0.01,0.89,555,549
6,1204,25,0,0.001,0.01,0.92,607,597
6,1304,25,0,0.001,0.01,0.934,647,657
6,1404,25,0,0.001,0.01,0.952,705,699
6,1504,25,0,0.001,0.01,0.952,747,757
6,1604,25,0,0.001,0.01,0.964,797,807
6,1704,25,0,0.001,0.01,0.964,849,855
6,1804,25,0,0.001,0.01,0.966,898,906
6,1904,25,0,0.001,0.01,0.972,952,952
7,0,25,0,0.001,0.01,0.578,0,0
7,104,25,0,0.001,0.01,0.54,62,42
7,204,25,0,0.001,0.01,0.55,116,88
7,304,25,0,0.001,0.01,0.566,159,145
7,404,25,0,0.001,0.01,0.65,198,206
7,504,25,0,0.001,0.01,0.682,239,265
7,604,25,0,0.001,0.01,0.666,287,317
7,704,25,0,0.001,0.01,0.686,341,363
7,804,25,0,0.001,0.01,0.742,396,408
7,904,25,0,0.001,0.01,0.754,448,456
7,1004,25,0,0.001,0.01,0.774,496,508
7,1104,25,0,0.001,0.01,0.828,555,549
7,1204,25,0,0.001,0.01,0.878,604,600
7,1304,25,0,0.001,0.01,0.908,653,651
7,1404,25,0,0.001,0.01,0.924,699,705
7,1504,25,0,0.001,0.01,0.938,751,753
7,1604,25,0,0.001,0.01,0.956,798,806
7,1704,25,0,0.001,0.01,0.956,850,854
7,1804,25,0,0.001,0.01,0.964,898,906
7,1904,25,0,0.001,0.01,0.972,952,952
8,0,25,0,0.001,0.01,0.68,0,0
8,104,25,0,0.001,0.01,0.486,48,56
8,204,25,0,0.001,0.01,0.67,99,105
8,304,25,0,0.001,0.01,0.652,148,156
8,404,25,0,0.001,0.01,0.6,198,206
8,504,25,0,0.001,0.01,0.626,250,254
8,604,25,0,0.001,0.01,0.684,299,305
8,704,25,0,0.001,0.01,0.714,351,353
8,804,25,0,0.001,0.01,0.762,405,399
8,904,25,0,0.001,0.01,0.814,453,451
8,1004,25,0,0.001,0.01,0.856,507,497
8,1104,25,0,0.001,0.01,0.886,559,545
8,1204,25,0,0.001,0.01,0.912,598,606
8,1304,25,0,0.001,0.01,0.906,651,653
8,1404,25,0,0.001,0.01,0.928,702,702
8,1504,25,0,0.001,0.01,0.938,752,752
8,1604,25,0,0.001,0.01,0.938,797,807
8,1704,25,0,0.001,0.01,0.958,848,856
8,1804,25,0,0.001,0.01,0.962,894,910
8,1904,25,0,0.001,0.01,0.972,952,952
9,0,25,0,0.001,0.01,0.57,0,0
9,104,25,0,0.001,0.01,0.546,50,54
9,204,25,0,0.001,0.01,0.594,106,98
9,304,25,0,0.001,0.01,0.604,152,152
9,404,25,0,0.001,0.01,0.612,202,202
9,504,25,0,0.001,0.01,0.658,256,248
9,604,25,0,0.001,0.01,0.71,299,305
9,704,25,0,0.001,0.01,0.736,348,356
9,804,25,0,0.001,0.01,0.778,398,406
9,904,25,0,0.001,0.01,0.844,445,459
9,1004,25,0,0.001,0.01,0.866,503,501
9,1104,25,0,0.001,0.01,0.88,554,550
9,1204,25,0,0.001,0.01,0.934,606,598
9,1304,25,0,0.001,0.01,0.952,656,648
9,1404,25,0,0.001,0.01,0.956,703,701
9,1504,25,0,0.001,0.01,0.972,756,748
9,1604,25,0,0.001,0.01,0.982,815,789
9,1704,25,0,0.001,0.01,0.982,862,842
9,1804,25,0,0.001,0.01,0.984,899,905
9,1904,25,0,0.001,0.01,0.986,952,952
10,0,25,0,0.001,0.01,0.676,0,0
10,104,25,0,0.001,0.01,0.496,49,55
10,204,25,0,0.001,0.01,0.682,101,103
10,304,25,0,0.001,0.01,0.682,158,146
10,404,25,0,0.001,0.01,0.618,209,195
10,504,25,0,0.001,0.01,0.6,256,248
10,604,25,0,0.001,0.01,0.656,307,297
10,704,25,0,0.001,0.01,0.708,358,346
10,804,25,0,0.001,0.01,0.752,416,388
10,904,25,0,0.001,0.01,0.78,463,441
10,1004,25,0,0.001,0.01,0.81,511,493
10,1104,25,0,0.001,0.01,0.856,563,541
10,1204,25,0,0.001,0.01,0.9,602,602
10,1304,25,0,0.001,0.01,0.922,658,646
10,1404,25,0,0.001,0.01,0.934,711,693
10,1504,25,0,0.001,0.01,0.944,758,746
10,1604,25,0,0.001,0.01,0.952,793,811
10,1704,25,0,0.001,0.01,0.958,853,851
10,1804,25,0,0.001,0.01,0.964,904,900
10,1904,25,0,0.001,0.01,0.966,952,952
11,0,25,0,0.001,0.01,0.732,0,0
11,104,25,0,0.001,0.01,0.478,51,53
11,204,25,0,0.001,0.01,0.68,109,95
11,304,25,0,0.001,0.01,0.62,161,143
11,404,25,0,0.001,0.01,0.604,209,195
11,504,25,0,0.001,0.01,0.67,259,245
11,604,25,0,0.001,0.01,0.714,307,297
11,704,25,0,0.001,0.01,0.754,357,347
11,804,25,0,0.001,0.01,0.766,406,398
11,904,25,0,0.001,0.01,0.794,460,444
11,1004,25,0,0.001,0.01,0.784,503,501
11,1104,25,0,0.001,0.01,0.846,552,552
11,1204,25,0,0.001,0.01,0.886,604,600
11,1304,25,0,0.001,0.01,0.904,654,650
11,1404,25,0,0.001,0.01,0.93,707,697
11,1504,25,0,0.001,0.01,0.954,756,748
11,1604,25,0,0.001,0.01,0.962,803,801
11,1704,25,0,0.001,0.01,0.972,857,847
11,1804,25,0,0.001,0.01,0.98,904,900
11,1904,25,0,0.001,0.01,0.986,952,952
12,0,25,0,0.001,0.01,0.73,0,0
12,104,25,0,0.001,0.01,0.528,51,53
12,204,25,0,0.001,0.01,0.756,98,106
12,304,25,0,0.001,0.01,0.678,151,153
12,404,25,0,0.001,0.01,0.652,202,202
12,504,25,0,0.001,0.01,0.72,249,255
12,604,25,0,0.001,0.01,0.712,300,304
12,704,25,0,0.001,0.01,0.8,351,353
12,804,25,0,0.001,0.01,0.802,402,402
12,904,25,0,0.001,0.01,0.864,453,451
12,1004,25,0,0.001,0.01,0.886,509,495
12,1104,25,0,0.001,0.01,0.922,559,545
12,1204,25,0,0.001,0.01,0.942,601,603
12,1304,25,0,0.001,0.01,0.954,652,652
12,1404,25,0,0.001,0.01,0.968,702,702
12,1504,25,0,0.001,0.01,0.964,749,755
12,1604,25,0,0.001,0.01,0.972,788,816
12,1704,25,0,0.001,0.01,0.98,838,866
12,1804,25,0,0.001,0.01,0.988,894,910
12,1904,25,0,0.001,0.01,0.99,952,952
13,0,25,0,0.001,0.01,0.556,0,0
13,104,25,0,0.001,0.01,0.614,51,53
13,204,25,0,0.001,0.01,0.63,108,96
13,304,25,0,0.001,0.01,0.654,159,145
13,404,25,0,0.001,0.01,0.674,209,195
13,504,25,0,0.001,0.01,0.674,260,244
13,604,25,0,0.001,0.01,0.708,313,291
13,704,25,0,0.001,0.01,0.752,371,333
13,804,25,0,0.001,0.01,0.778,417,387
13,904,25,0,0.001,0.01,0.822,464,440
13,1004,25,0,0.001,0.01,0.846,511,493
13,1104,25,0,0.001,0.01,0.894,559,545
13,1204,25,0,0.001,0.01,0.9,602,602
13,1304,25,0,0.001,0.01,0.926,648,656
13,1404,25,0,0.001,0.01,0.942,701,703
13,1504,25,0,0.001,0.01,0.952,755,749
13,1604,25,0,0.001,0.01,0.966,807,797
13,1704,25,0,0.001,0.01,0.97,852,852
13,1804,25,0,0.001,0.01,0.972,908,896
13,1904,25,0,0.001,0.01,0.966,952,952
14,0,25,0,0.001,0.01,0.594,0,0
14,104,25,0,0.001,0.01,0.532,53,51
14,204,25,0,0.001,0.01,0.646,98,106
14,304,25,0,0.001,0.01,0.638,152,152
14,404,25,0,0.001,0.01,0.654,202,202
14,504,25,0,0.001,0.01,0.646,256,248
14,604,25,0,0.001,0.01,0.68,299,305
14,704,25,0,0.001,0.01,0.732,349,355
14,804,25,0,0.001,0.01,0.754,400,404
14,904,25,0,0.001,0.01,0.818,443,461
14,1004,25,0,0.001,0.01,0.848,494,510
14,1104,25,0,0.001,0.01,0.894,544,560
14,1204,25,0,0.001,0.01,0.924,590,614
14,1304,25,0,0.001,0.01,0.946,635,669
14,1404,25,0,0.001,0.01,0.96,686,718
14,1504,25,0,0.001,0.01,0.956,733,771
14,1604,25,0,0.001,0.01,0.968,786,818
14,1704,25,0,0.001,0.01,0.972,842,862
14,1804,25,0,0.001,0.01,0.98,897,907
14,1904,25,0,0.001,0.01,0.976,952,952
15,0,25,0,0.001,0.01,0.61,0,0
15,104,25,0,0.001,0.01,0.56,53,51
15,204,25,0,0.001,0.01,0.716,100,104
15,304,25,0,0.001,0.01,0.73,143,161
15,404,25,0,0.001,0.01,0.65,199,205
15,504,25,0,0.001,0.01,0.718,248,256
15,604,25,0,0.001,0.01,0.746,302,302
15,704,25,0,0.001,0.01,0.778,353,351
15,804,25,0,0.001,0.01,0.808,402,402
15,904,25,0,0.001,0.01,0.85,451,453
15,1004,25,0,0.001,0.01,0.872,498,506
15,1104,25,0,0.001,0.01,0.89,543,561
15,1204,25,0,0.001,0.01,0.922,590,614
15,1304,25,0,0.001,0.01,0.93,647,657
15,1404,25,0,0.001,0.01,0.93,701,703
15,1504,25,0,0.001,0.01,0.942,750,754
15,1604,25,0,0.001,0.01,0.952,803,801
15,1704,25,0,0.001,0.01,0.94,846,858
15,1804,25,0,0.001,0.01,0.96,899,905
15,1904,25,0,0.001,0.01,0.968,952,952
16,0,25,0,0.001,0.01,0.528,0,0
16,104,25,0,0.001,0.01,0.616,43,61
16,204,25,0,0.001,0.01,0.578,100,104
16,304,25,0,0.001,0.01,0.536,149,155
16,404,25,0,0.001,0.01,0.556,205,199
16,504,25,0,0.001,0.01,0.628,251,253
16,604,25,0,0.001,0.01,0.678,302,302
16,704,25,0,0.001,0.01,0.668,359,345
16,804,25,0,0.001,0.01,0.724,413,391
16,904,25,0,0.001,0.01,0.772,460,444
16,1004,25,0,0.001,0.01,0.822,513,491
16,1104,25,0,0.001,0.01,0.86,564,540
16,1204,25,0,0.001,0.01,0.896,612,592
16,1304,25,0,0.001,0.01,0.93,654,650
16,1404,25,0,0.001,0.01,0.936,706,698
16,1504,25,0,0.001,0.01,0.946,765,739
16,1604,25,0,0.001,0.01,0.97,816,788
16,1704,25,0,0.001,0.01,0.972,864,840
16,1804,25,0,0.001,0.01,0.988,909,895
16,1904,25,0,0.001,0.01,0.992,952,952
17,0,25,0,0.001,0.01,0.642,0,0
17,104,25,0,0.001,0.01,0.532,45,59
17,204,25,0,0.001,0.01,0.708,89,115
17,304,25,0,0.001,0.01,0.676,138,166
17,404,25,0,0.001,0.01,0.688,190,214
17,504,25,0,0.001,0.01,0.692,246,258
17,604,25,0,0.001,0.01,0.732,290,314
17,704,25,0,0.001,0.01,0.776,341,363
17,804,25,0,0.001,0.01,0.814,399,405
17,904,25,0,0.001,0.01,0.84,451,453
17,1004,25,0,0.001,0.01,0.852,503,501
17,1104,25,0,0.001,0.01,0.896,550,554
17,1204,25,0,0.001,0.01,0.91,603,601
17,1304,25,0,0.001,0.01,0.932,650,654
17,1404,25,0,0.001,0.01,0.944,697,707
17,1504,25,0,0.001,0.01,0.966,750,754
17,1604,25,0,0.001,0.01,0.974,802,802
17,1704,25,0,0.001,0.01,0.974,853,851
17,1804,25,0,0.001,0.01,0.982,903,901
17,1904,25,0,0.001,0.01,0.978,952,952
18,0,25,0,0.001,0.01,0.744,0,0
18,104,25,0,0.001,0.01,0.5,49,55
18,204,25,0,0.001,0.01,0.76,99,105
18,304,25,0,0.001,0.01,0.702,140,164
18,404,25,0,0.001,0.01,0.668,199,205
18,504,25,0,0.001,0.01,0.7,245,259
18,604,25,0,0.001,0.01,0.678,298,306
18,704,25,0,0.001,0.01,0.796,348,356
18,804,25,0,0.001,0.01,0.826,394,410
18,904,25,0,0.001,0.01,0.856,443,461
18,1004,25,0,0.001,0.01,0.88,483,521
18,1104,25,0,0.001,0.01,0.9,542,562
18,1204,25,0,0.001,0.01,0.922,587,617
18,1304,25,0,0.001,0.01,0.948,635,669
18,1404,25,0,0.001,0.01,0.958,688,716
18,1504,25,0,0.001,0.01,0.964,736,768
18,1604,25,0,0.001,0.01,0.97,797,807
18,1704,25,0,0.001,0.01,0.974,841,863
18,1804,25,0,0.001,0.01,0.978,895,909
18,1904,25,0,0.001,0.01,0.988,952,952
19,0,25,0,0.001,0.01,0.568,0,0
19,104,25,0,0.001,0.01,0.544,54,50
19,204,25,0,0.001,0.01,0.562,105,99
19,304,25,0,0.001,0.01,0.566,154,150
19,404,25,0,0.001,0.01,0.562,210,194
19,504,25,0,0.001,0.01,0.586,260,244
19,604,25,0,0.001,0.01,0.588,313,291
19,704,25,0,0.001,0.01,0.584,370,334
19,804,25,0,0.001,0.01,0.61,425,379
19,904,25,0,0.001,0.01,0.63,472,432
19,1004,25,0,0.001,0.01,0.662,514,490
19,1104,25,0,0.001,0.01,0.718,570,534
19,1204,25,0,0.001,0.01,0.76,613,591
19,1304,25,0,0.001,0.01,0.82,655,649
19,1404,25,0,0.001,0.01,0.862,710,694
19,1504,25,0,0.001,0.01,0.922,760,744
19,1604,25,0,0.001,0.01,0.944,805,799
19,1704,25,0,0.001,0.01,0.96,851,853
19,1804,25,0,0.001,0.01,0.974,902,902
19,1904,25,0,0.001,0.01,0.976,952,952
20,0,25,0,0.001,0.01,0.744,0,0
20,104,25,0,0.001,0.01,0.512,50,54
20,204,25,0,0.001,0.01,0.748,104,100
20,304,25,0,0.001,0.01,0.706,152,152
20,404,25,0,0.001,0.01,0.69,203,201
20,504,25,0,0.001,0.01,0.754,243,261
20,604,25,0,0.001,0.01,0.794,293,311
20,704,25,0,0.001,0.01,0.81,347,357
20,804,25,0,0.001,0.01,0.858,394,410
20,904,25,0,0.001,0.01,0.894,448,456
20,1004,25,0,0.001,0.01,0.906,488,516
20,1104,25,0,0.001,0.01,0.916,534,570
20,1204,25,0,0.001,0.01,0.948,583,621
20,1304,25,0,0.001,0.01,0.954,631,673
20,1404,25,0,0.001,0.01,0.952,683,721
20,1504,25,0,0.001,0.01,0.958,746,758
20,1604,25,0,0.001,0.01,0.964,798,806
20,1704,25,0,0.001,0.01,0.97,853,851
20,1804,25,0,0.001,0.01,0.976,901,903
20,1904,25,0,0.001,0.01,0.98,952,952
1,0,50,0,1e-05,0.0001,0.48,0,0
1,104,50,0,1e-05,0.0001,0.482,60,44
1,204,50,0,1e-05,0.0001,0.482,99,105
1,304,50,0,1e-05,0.0001,0.478,154,150
1,404,50,0,1e-05,0.0001,0.486,204,200
1,504,50,0,1e-05,0.0001,0.49,252,252
1,604,50,0,1e-05,0.0001,0.488,300,304
1,704,50,0,1e-05,0.0001,0.476,344,360
1,804,50,0,1e-05,0.0001,0.482,398,406
1,904,50,0,1e-05,0.0001,0.478,447,457
1,1004,50,0,1e-05,0.0001,0.486,508,496
1,1104,50,0,1e-05,0.0001,0.49,558,546
1,1204,50,0,1e-05,0.0001,0.486,601,603
1,1304,50,0,1e-05,0.0001,0.506,658,646
1,1404,50,0,1e-05,0.0001,0.48,702,702
1,1504,50,0,1e-05,0.0001,0.488,750,754
1,1604,50,0,1e-05,0.0001,0.48,797,807
1,1704,50,0,1e-05,0.0001,0.48,842,862
1,1804,50,0,1e-05,0.0001,0.484,896,908
1,1904,50,0,1e-05,0.0001,0.49,952,952
2,0,50,0,1e-05,0.0001,0.494,0,0
2,104,50,0,1e-05,0.0001,0.496,55,49
2,204,50,0,1e-05,0.0001,0.498,108,96
2,304,50,0,1e-05,0.0001,0.496,154,150
2,404,50,0,1e-05,0.0001,0.496,199,205
2,504,50,0,1e-05,0.0001,0.498,241,263
2,604,50,0,1e-05,0.0001,0.496,293,311
2,704,50,0,1e-05,0.0001,0.498,344,360
2,804,50,0,1e-05,0.0001,0.498,394,410
2,904,50,0,1e-05,0.0001,0.494,440,464
2,1004,50,0,1e-05,0.0001,0.49,494,510
2,1104,50,0,1e-05,0.0001,0.494,545,559
2,1204,50,0,1e-05,0.0001,0.494,598,606
2,1304,50,0,1e-05,0.0001,0.502,647,657
2,1404,50,0,1e-05,0.0001,0.498,701,703
2,1504,50,0,1e-05,0.0001,0.502,747,757
2,1604,50,0,1e-05,0.0001,0.502,804,800
2,1704,50,0,1e-05,0.0001,0.488,858,846
2,1804,50,0,1e-05,0.0001,0.5,898,906
2,1904,50,0,1e-05,0.0001,0.506,952,952
3,0,50,0,1e-05,0.0001,0.508,0,0
3,104,50,0,1e-05,0.0001,0.508,51,53
3,204,50,0,1e-05,0.0001,0.508,100,104
3,304,50,0,1e-05,0.0001,0.506,149,155
3,404,50,0,1e-05,0.0001,0.51,205,199
3,504,50,0,1e-05,0.0001,0.51,259,245
3,604,50,0,1e-05,0.0001,0.506,302,302
3,704,50,0,1e-05,0.0001,0.498,350,354
3,804,50,0,1e-05,0.0001,0.498,396,408
3,904,50,0,1e-05,0.0001,0.496,452,452
3,1004,50,0,1e-05,0.0001,0.498,511,493
3,1104,50,0,1e-05,0.0001,0.502,559,545
3,1204,50,0,1e-05,0.0001,0.498,607,597
3,1304,50,0,1e-05,0.0001,0.486,662,642
3,1404,50,0,1e-05,0.0001,0.486,706,698
3,1504,50,0,1e-05,0.0001,0.486,744,760
3,1604,50,0,1e-05,0.0001,0.486,792,812
3,1704,50,0,1e-05,0.0001,0.49,848,856
3,1804,50,0,1e-05,0.0001,0.49,898,906
3,1904,50,0,1e-05,0.0001,0.488,952,952
4,0,50,0,1e-05,0.0001,0.518,0,0
4,104,50,0,1e-05,0.0001,0.518,54,50
4,204,50,0,1e-05,0.0001,0.516,102,102
4,304,50,0,1e-05,0.0001,0.518,160,144
4,404,50,0,1e-05,0.0001,0.516,205,199
4,504,50,0,1e-05,0.0001,0.514,254,250
4,604,50,0,1e-05,0.0001,0.514,304,300
4,704,50,0,1e-05,0.0001,0.516,357,347
4,804,50,0,1e-05,0.0001,0.516,410,394
4,904,50,0,1e-05,0.0001,0.516,457,447
4,1004,50,0,1e-05,0.0001,0.506,498,506
4,1104,50,0,1e-05,0.0001,0.506,554,550
4,1204,50,0,1e-05,0.0001,0.508,609,595
4,1304,50,0,1e-05,0.0001,0.506,660,644
4,1404,50,0,1e-05,0.0001,0.51,711,693
4,1504,50,0,1e-05,0.0001,0.514,756,748
4,1604,50,0,1e-05,0.0001,0.51,802,802
4,1704,50,0,1e-05,0.0001,0.51,853,851
4,1804,50,0,1e-05,0.0001,0.508,905,899
4,1904,50,0,1e-05,0.0001,0.496,952,952
5,0,50,0,1e-05,0.0001,0.488,0,0
5,104,50,0,1e-05,0.0001,0.488,51,53
5,204,50,0,1e-05,0.0001,0.492,109,95
5,304,50,0,1e-05,0.0001,0.49,159,145
5,404,50,0,1e-05,0.0001,0.486,200,204
5,504,50,0,1e-05,0.0001,0.48,246,258
5,604,50,0,1e-05,0.0001,0.484,291,313
5,704,50,0,1e-05,0.0001,0.472,341,363
5,804,50,0,1e-05,0.0001,0.494,388,416
5,904,50,0,1e-05,0.0001,0.5,441,463
5,1004,50,0,1e-05,0.0001,0.492,488,516
5,1104,50,0,1e-05,0.0001,0.496,546,558
5,1204,50,0,1e-05,0.0001,0.494,593,611
5,1304,50,0,1e-05,0.0001,0.502,647,657
5,1404,50,0,1e-05,0.0001,0.5,705,699
5,1504,50,0,1e-05,0.0001,0.504,761,743
5,1604,50,0,1e-05,0.0001,0.504,810,794
5,1704,50,0,1e-05,0.0001,0.5,854,850
5,1804,50,0,1e-05,0.0001,0.504,907,897
5,1904,50,0,1e-05,0.0001,0.494,952,952
6,0,50,0,1e-05,0.0001,0.502,0,0
6,104,50,0,1e-05,0.0001,0.504,50,54
6,204,50,0,1e-05,0.0001,0.502,100,104
6,304,50,0,1e-05,0.0001,0.502,159,145
6,404,50,0,1e-05,0.0001,0.504,203,201
6,504,50,0,1e-05,0.0001,0.504,249,255
6,604,50,0,1e-05,0.0001,0.504,294,310
6,704,50,0,1e-05,0.0001,0.502,349,355
6,804,50,0,1e-05,0.0001,0.504,395,409
6,904,50,0,1e-05,0.0001,0.502,442,462
6,1004,50,0,1e-05,0.0001,0.502,499,505
6,1104,50,0,1e-05,0.0001,0.502,549,555
6,1204,50,0,1e-05,0.0001,0.502,592,612
6,1304,50,0,1e-05,0.0001,0.508,644,660
6,1404,50,0,1e-05,0.0001,0.51,693,711
6,1504,50,0,1e-05,0.0001,0.51,739,765
6,1604,50,0,1e-05,0.0001,0.512,794,810
6,1704,50,0,1e-05,0.0001,0.516,846,858
6,1804,50,0,1e-05,0.0001,0.526,900,904
6,1904,50,0,1e-05,0.0001,0.516,952,952
7,0,50,0,1e-05,0.0001,0.5,0,0
7,104,50,0,1e-05,0.0001,0.504,47,57
7,204,50,0,1e-05,0.0001,0.498,102,102
7,304,50,0,1e-05,0.0001,0.498,149,155
7,404,50,0,1e-05,0.0001,0.498,200,204
7,504,50,0,1e-05,0.0001,0.496,249,255
7,604,50,0,1e-05,0.0001,0.5,307,297
7,704,50,0,1e-05,0.0001,0.5,355,349
7,804,50,0,1e-05,0.0001,0.506,404,400
7,904,50,0,1e-05,0.0001,0.51,451,453
7,1004,50,0,1e-05,0.0001,0.512,506,498
7,1104,50,0,1e-05,0.0001,0.508,550,554
7,1204,50,0,1e-05,0.0001,0.512,602,602
7,1304,50,0,1e-05,0.0001,0.512,656,648
7,1404,50,0,1e-05,0.0001,0.506,701,703
7,1504,50,0,1e-05,0.0001,0.512,745,759
7,1604,50,0,1e-05,0.0001,0.514,797,807
7,1704,50,0,1e-05,0.0001,0.512,846,858
7,1804,50,0,1e-05,0.0001,0.502,901,903
7,1904,50,0,1e-05,0.0001,0.504,952,952
8,0,50,0,1e-05,0.0001,0.516,0,0
8,104,50,0,1e-05,0.0001,0.516,54,50
8,204,50,0,1e-05,0.0001,0.512,107,97
8,304,50,0,1e-05,0.0001,0.506,152,152
8,404,50,0,1e-05,0.0001,0.512,201,203
8,504,50,0,1e-05,0.0001,0.514,250,254
8,604,50,0,1e-05,0.0001,0.518,307,297
8,704,50,0,1e-05,0.0001,0.516,353,351
8,804,50,0,1e-05,0.0001,0.518,402,402
8,904,50,0,1e-05,0.0001,0.526,455,449
8,1004,50,0,1e-05,0.0001,0.528,499,505
8,1104,50,0,1e-05,0.0001,0.526,550,554
8,1204,50,0,1e-05,0.0001,0.518,603,601
8,1304,50,0,1e-05,0.0001,0.518,655,649
8,1404,50,0,1e-05,0.0001,0.518,709,695
8,1504,50,0,1e-05,0.0001,0.524,758,746
8,1604,50,0,1e-05,0.0001,0.528,802,802
8,1704,50,0,1e-05,0.0001,0.52,848,856
8,1804,50,0,1e-05,0.0001,0.534,899,905
8,1904,50,0,1e-05,0.0001,0.518,952,952
9,0,50,0,1e-05,0.0001,0.512,0,0
9,104,50,0,1e-05,0.0001,0.512,56,48
9,204,50,0,1e-05,0.0001,0.512,102,102
9,304,50,0,1e-05,0.0001,0.512,156,148
9,404,50,0,1e-05,0.0001,0.506,205,199
9,504,50,0,1e-05,0.0001,0.502,253,251
9,604,50,0,1e-05,0.0001,0.506,318,286
9,704,50,0,1e-05,0.0001,0.502,364,340
9,804,50,0,1e-05,0.0001,0.508,406,398
9,904,50,0,1e-05,0.0001,0.516,458,446
9,1004,50,0,1e-05,0.0001,0.508,506,498
9,1104,50,0,1e-05,0.0001,0.512,553,551
9,1204,50,0,1e-05,0.0001,0.516,611,593
9,1304,50,0,1e-05,0.0001,0.512,658,646
9,1404,50,0,1e-05,0.0001,0.504,699,705
9,1504,50,0,1e-05,0.0001,0.502,758,746
9,1604,50,0,1e-05,0.0001,0.506,810,794
9,1704,50,0,1e-05,0.0001,0.506,849,855
9,1804,50,0,1e-05,0.0001,0.5,904,900
9,1904,50,0,1e-05,0.0001,0.508,952,952
10,0,50,0,1e-05,0.0001,0.49,0,0
10,104,50,0,1e-05,0.0001,0.49,63,41
10,204,50,0,1e-05,0.0001,0.488,104,100
10,304,50,0,1e-05,0.0001,0.49,140,164
10,404,50,0,1e-05,0.0001,0.482,185,219
10,504,50,0,1e-05,0.0001,0.478,239,265
10,604,50,0,1e-05,0.0001,0.476,287,317
10,704,50,0,1e-05,0.0001,0.482,343,361
10,804,50,0,1e-05,0.0001,0.478,394,410
10,904,50,0,1e-05,0.0001,0.474,443,461
10,1004,50,0,1e-05,0.0001,0.478,496,508
10,1104,50,0,1e-05,0.0001,0.478,551,553
10,1204,50,0,1e-05,0.0001,0.482,596,608
10,1304,50,0,1e-05,0.0001,0.478,652,652
10,1404,50,0,1e-05,0.0001,0.482,708,696
10,1504,50,0,1e-05,0.0001,0.476,751,753
10,1604,50,0,1e-05,0.0001,0.48,799,805
10,1704,50,0,1e-05,0.0001,0.48,858,846
10,1804,50,0,1e-05,0.0001,0.476,900,904
10,1904,50,0,1e-05,0.0001,0.488,952,952
11,0,50,0,1e-05,0.0001,0.498,0,0
11,104,50,0,1e-05,0.0001,0.498,56,48
11,204,50,0,1e-05,0.0001,0.498,110,94
11,304,50,0,1e-05,0.0001,0.5,164,140
11,404,50,0,1e-05,0.0001,0.498,211,193
11,504,50,0,1e-05,0.0001,0.498,259,245
11,604,50,0,1e-05,0.0001,0.504,313,291
11,704,50,0,1e-05,0.0001,0.506,365,339
11,804,50,0,1e-05,0.0001,0.5,416,388
11,904,50,0,1e-05,0.0001,0.508,468,436
11,1004,50,0,1e-05,0.0001,0.514,514,490
11,1104,50,0,1e-05,0.0001,0.516,559,545
11,1204,50,0,1e-05,0.0001,0.5,608,596
11,1304,50,0,1e-05,0.0001,0.496,654,650
11,1404,50,0,1e-05,0.0001,0.502,698,706
11,1504,50,0,1e-05,0.0001,0.49,749,755
11,1604,50,0,1e-05,0.0001,0.49,800,804
11,1704,50,0,1e-05,0.0001,0.474,849,855
11,1804,50,0,1e-05,0.0001,0.476,902,902
11,1904,50,0,1e-05,0.0001,0.49,952,952
12,0,50,0,1e-05,0.0001,0.522,0,0
12,104,50,0,1e-05,0.0001,0.522,49,55
12,204,50,0,1e-05,0.0001,0.522,92,112
12,304,50,0,1e-05,0.0001,0.516,142,162
12,404,50,0,1e-05,0.0001,0.512,191,213
12,504,50,0,1e-05,0.0001,0.514,243,261
12,604,50,0,1e-05,0.0001,0.508,292,312
12,704,50,0,1e-05,0.0001,0.51,347,357
12,804,50,0,1e-05,0.0001,0.506,401,403
12,904,50,0,1e-05,0.0001,0.508,450,454
12,1004,50,0,1e-05,0.0001,0.51,491,513
12,1104,50,0,1e-05,0.0001,0.508,543,561
12,1204,50,0,1e-05,0.0001,0.512,591,613
12,1304,50,0,1e-05,0.0001,0.512,646,658
12,1404,50,0,1e-05,0.0001,0.516,699,705
12,1504,50,0,1e-05,0.0001,0.516,749,755
12,1604,50,0,1e-05,0.0001,0.508,798,806
12,1704,50,0,1e-05,0.0001,0.504,843,861
12,1804,50,0,1e-05,0.0001,0.508,894,910
12,1904,50,0,1e-05,0.0001,0.508,952,952
13,0,50,0,1e-05,0.0001,0.504,0,0
13,104,50,0,1e-05,0.0001,0.504,50,54
13,204,50,0,1e-05,0.0001,0.504,92,112
13,304,50,0,1e-05,0.0001,0.506,145,159
13,404,50,0,1e-05,0.0001,0.502,203,201
13,504,50,0,1e-05,0.0001,0.5,253,251
13,604,50,0,1e-05,0.0001,0.502,299,305
13,704,50,0,1e-05,0.0001,0.502,347,357
13,804,50,0,1e-05,0.0001,0.504,409,395
13,904,50,0,1e-05,0.0001,0.498,459,445
13,1004,50,0,1e-05,0.0001,0.498,502,502
13,1104,50,0,1e-05,0.0001,0.498,549,555
13,1204,50,0,1e-05,0.0001,0.494,604,600
13,1304,50,0,1e-05,0.0001,0.49,655,649
13,1404,50,0,1e-05,0.0001,0.488,701,703
13,1504,50,0,1e-05,0.0001,0.494,756,748
13,1604,50,0,1e-05,0.0001,0.486,806,798
13,1704,50,0,1e-05,0.0001,0.484,855,849
13,1804,50,0,1e-05,0.0001,0.504,913,891
13,1904,50,0,1e-05,0.0001,0.504,952,952
14,0,50,0,1e-05,0.0001,0.502,0,0
14,104,50,0,1e-05,0.0001,0.502,54,50
14,204,50,0,1e-05,0.0001,0.504,94,110
14,304,50,0,1e-05,0.0001,0.5,146,158
14,404,50,0,1e-05,0.0001,0.508,198,206
14,504,50,0,1e-05,0.0001,0.514,256,248
14,604,50,0,1e-05,0.0001,0.514,309,295
14,704,50,0,1e-05,0.0001,0.508,354,350
14,804,50,0,1e-05,0.0001,0.498,396,408
14,904,50,0,1e-05,0.0001,0.5,442,462
14,1004,50,0,1e-05,0.0001,0.508,495,509
14,1104,50,0,1e-05,0.0001,0.504,546,558
14,1204,50,0,1e-05,0.0001,0.506,596,608
14,1304,50,0,1e-05,0.0001,0.504,642,662
14,1404,50,0,1e-05,0.0001,0.506,700,704
14,1504,50,0,1e-05,0.0001,0.506,755,749
14,1604,50,0,1e-05,0.0001,0.506,810,794
14,1704,50,0,1e-05,0.0001,0.5,865,839
14,1804,50,0,1e-05,0.0001,0.502,907,897
14,1904,50,0,1e-05,0.0001,0.508,952,952
15,0,50,0,1e-05,0.0001,0.504,0,0
15,104,50,0,1e-05,0.0001,0.504,44,60
15,204,50,0,1e-05,0.0001,0.504,100,104
15,304,50,0,1e-05,0.0001,0.504,152,152
15,404,50,0,1e-05,0.0001,0.504,207,197
15,504,50,0,1e-05,0.0001,0.504,256,248
15,604,50,0,1e-05,0.0001,0.504,302,302
15,704,50,0,1e-05,0.0001,0.502,356,348
15,804,50,0,1e-05,0.0001,0.496,409,395
15,904,50,0,1e-05,0.0001,0.494,451,453
15,1004,50,0,1e-05,0.0001,0.498,502,502
15,1104,50,0,1e-05,0.0001,0.502,553,551
15,1204,50,0,1e-05,0.0001,0.502,606,598
15,1304,50,0,1e-05,0.0001,0.498,656,648
15,1404,50,0,1e-05,0.0001,0.494,704,700
15,1504,50,0,1e-05,0.0001,0.488,754,750
15,1604,50,0,1e-05,0.0001,0.494,802,802
15,1704,50,0,1e-05,0.0001,0.5,847,857
15,1804,50,0,1e-05,0.0001,0.492,903,901
15,1904,50,0,1e-05,0.0001,0.498,952,952
16,0,50,0,1e-05,0.0001,0.538,0,0
16,104,50,0,1e-05,0.0001,0.538,48,56
16,204,50,0,1e-05,0.0001,0.534,99,105
16,304,50,0,1e-05,0.0001,0.54,153,151
16,404,50,0,1e-05,0.0001,0.544,207,197
16,504,50,0,1e-05,0.0001,0.542,262,242
16,604,50,0,1e-05,0.0001,0.54,313,291
16,704,50,0,1e-05,0.0001,0.544,363,341
16,804,50,0,1e-05,0.0001,0.544,408,396
16,904,50,0,1e-05,0.0001,0.548,456,448
16,1004,50,0,1e-05,0.0001,0.54,504,500
16,1104,50,0,1e-05,0.0001,0.532,554,550
16,1204,50,0,1e-05,0.0001,0.528,606,598
16,1304,50,0,1e-05,0.0001,0.53,659,645
16,1404,50,0,1e-05,0.0001,0.52,708,696
16,1504,50,0,1e-05,0.0001,0.524,753,751
16,1604,50,0,1e-05,0.0001,0.53,797,807
16,1704,50,0,1e-05,0.0001,0.518,846,858
16,1804,50,0,1e-05,0.0001,0.524,900,904
16,1904,50,0,1e-05,0.0001,0.542,952,952
17,0,50,0,1e-05,0.0001,0.498,0,0
17,104,50,0,1e-05,0.0001,0.498,52,52
17,204,50,0,1e-05,0.0001,0.498,94,110
17,304,50,0,1e-05,0.0001,0.498,142,162
17,404,50,0,1e-05,0.0001,0.498,197,207
17,504,50,0,1e-05,0.0001,0.498,250,254
17,604,50,0,1e-05,0.0001,0.498,308,296
17,704,50,0,1e-05,0.0001,0.492,361,343
17,804,50,0,1e-05,0.0001,0.494,412,392
17,904,50,0,1e-05,0.0001,0.488,458,446
17,1004,50,0,1e-05,0.0001,0.498,514,490
17,1104,50,0,1e-05,0.0001,0.496,566,538
17,1204,50,0,1e-05,0.0001,0.504,622,582
17,1304,50,0,1e-05,0.0001,0.498,675,629
17,1404,50,0,1e-05,0.0001,0.496,717,687
17,1504,50,0,1e-05,0.0001,0.518,766,738
17,1604,50,0,1e-05,0.0001,0.528,812,792
17,1704,50,0,1e-05,0.0001,0.532,857,847
17,1804,50,0,1e-05,0.0001,0.528,900,904
17,1904,50,0,1e-05,0.0001,0.52,952,952
18,0,50,0,1e-05,0.0001,0.5,0,0
18,104,50,0,1e-05,0.0001,0.5,50,54
18,204,50,0,1e-05,0.0001,0.5,100,104
18,304,50,0,1e-05,0.0001,0.5,148,156
18,404,50,0,1e-05,0.0001,0.5,194,210
18,504,50,0,1e-05,0.0001,0.5,242,262
18,604,50,0,1e-05,0.0001,0.5,292,312
18,704,50,0,1e-05,0.0001,0.502,351,353
18,804,50,0,1e-05,0.0001,0.502,398,406
18,904,50,0,1e-05,0.0001,0.5,445,459
18,1004,50,0,1e-05,0.0001,0.498,492,512
18,1104,50,0,1e-05,0.0001,0.494,544,560
18,1204,50,0,1e-05,0.0001,0.496,593,611
18,1304,50,0,1e-05,0.0001,0.486,652,652
18,1404,50,0,1e-05,0.0001,0.472,709,695
18,1504,50,0,1e-05,0.0001,0.47,758,746
18,1604,50,0,1e-05,0.0001,0.47,806,798
18,1704,50,0,1e-05,0.0001,0.47,846,858
18,1804,50,0,1e-05,0.0001,0.476,900,904
18,1904,50,0,1e-05,0.0001,0.476,952,952
19,0,50,0,1e-05,0.0001,0.506,0,0
19,104,50,0,1e-05,0.0001,0.506,53,51
19,204,50,0,1e-05,0.0001,0.506,101,103
19,304,50,0,1e-05,0.0001,0.508,146,158
19,404,50,0,1e-05,0.0001,0.506,195,209
19,504,50,0,1e-05,0.0001,0.508,245,259
19,604,50,0,1e-05,0.0001,0.512,296,308
19,704,50,0,1e-05,0.0001,0.522,341,363
19,804,50,0,1e-05,0.0001,0.526,386,418
19,904,50,0,1e-05,0.0001,0.526,430,474
19,1004,50,0,1e-05,0.0001,0.53,480,524
19,1104,50,0,1e-05,0.0001,0.526,524,580
19,1204,50,0,1e-05,0.0001,0.516,572,632
19,1304,50,0,1e-05,0.0001,0.514,628,676
19,1404,50,0,1e-05,0.0001,0.514,684,720
19,1504,50,0,1e-05,0.0001,0.518,735,769
19,1604,50,0,1e-05,0.0001,0.516,792,812
19,1704,50,0,1e-05,0.0001,0.52,845,859
19,1804,50,0,1e-05,0.0001,0.512,895,909
19,1904,50,0,1e-05,0.0001,0.524,952,952
20,0,50,0,1e-05,0.0001,0.5,0,0
20,104,50,0,1e-05,0.0001,0.498,59,45
20,204,50,0,1e-05,0.0001,0.498,106,98
20,304,50,0,1e-05,0.0001,0.494,156,148
20,404,50,0,1e-05,0.0001,0.49,205,199
20,504,50,0,1e-05,0.0001,0.49,252,252
20,604,50,0,1e-05,0.0001,0.492,301,303
20,704,50,0,1e-05,0.0001,0.492,345,359
20,804,50,0,1e-05,0.0001,0.494,402,402
20,904,50,0,1e-05,0.0001,0.49,455,449
20,1004,50,0,1e-05,0.0001,0.494,510,494
20,1104,50,0,1e-05,0.0001,0.486,554,550
20,1204,50,0,1e-05,0.0001,0.472,610,594
20,1304,50,0,1e-05,0.0001,0.47,663,641
20,1404,50,0,1e-05,0.0001,0.47,708,696
20,1504,50,0,1e-05,0.0001,0.486,764,740
20,1604,50,0,1e-05,0.0001,0.498,811,793
20,1704,50,0,1e-05,0.0001,0.488,860,844
20,1804,50,0,1e-05,0.0001,0.498,908,896
20,1904,50,0,1e-05,0.0001,0.486,952,952
1,0,50,0,1e-05,0.001,0.504,0,0
1,104,50,0,1e-05,0.001,0.522,59,45
1,204,50,0,1e-05,0.001,0.63,116,88
1,304,50,0,1e-05,0.001,0.516,164,140
1,404,50,0,1e-05,0.001,0.57,205,199
1,504,50,0,1e-05,0.001,0.644,258,246
1,604,50,0,1e-05,0.001,0.636,312,292
1,704,50,0,1e-05,0.001,0.656,353,351
1,804,50,0,1e-05,0.001,0.72,406,398
1,904,50,0,1e-05,0.001,0.712,452,452
1,1004,50,0,1e-05,0.001,0.77,508,496
1,1104,50,0,1e-05,0.001,0.802,563,541
1,1204,50,0,1e-05,0.001,0.822,620,584
1,1304,50,0,1e-05,0.001,0.866,666,638
1,1404,50,0,1e-05,0.001,0.888,718,686
1,1504,50,0,1e-05,0.001,0.912,766,738
1,1604,50,0,1e-05,0.001,0.932,810,794
1,1704,50,0,1e-05,0.001,0.95,864,840
1,1804,50,0,1e-05,0.001,0.97,908,896
1,1904,50,0,1e-05,0.001,0.978,952,952
2,0,50,0,1e-05,0.001,0.506,0,0
2,104,50,0,1e-05,0.001,0.512,43,61
2,204,50,0,1e-05,0.001,0.614,89,115
2,304,50,0,1e-05,0.001,0.596,133,171
2,404,50,0,1e-05,0.001,0.636,185,219
2,504,50,0,1e-05,0.001,0.634,235,269
2,604,50,0,1e-05,0.001,0.688,287,317
2,704,50,0,1e-05,0.001,0.696,341,363
2,804,50,0,1e-05,0.001,0.772,392,412
2,904,50,0,1e-05,0.001,0.814,448,456
2,1004,50,0,1e-05,0.001,0.84,499,505
2,1104,50,0,1e-05,0.001,0.878,538,566
2,1204,50,0,1e-05,0.001,0.914,588,616
2,1304,50,0,1e-05,0.001,0.948,647,657
2,1404,50,0,1e-05,0.001,0.974,693,711
2,1504,50,0,1e-05,0.001,0.98,745,759
2,1604,50,0,1e-05,0.001,0.982,798,806
2,1704,50,0,1e-05,0.001,0.99,851,853
2,1804,50,0,1e-05,0.001,0.996,901,903
2,1904,50,0,1e-05,0.001,0.996,952,952
3,0,50,0,1e-05,0.001,0.508,0,0
3,104,50,0,1e-05,0.001,0.526,54,50
3,204,50,0,1e-05,0.001,0.644,106,98
3,304,50,0,1e-05,0.001,0.544,159,145
3,404,50,0,1e-05,0.001,0.626,208,196
3,504,50,0,1e-05,0.001,0.652,256,248
3,604,50,0,1e-05,0.001,0.686,308,296
3,704,50,0,1e-05,0.001,0.698,352,352
3,804,50,0,1e-05,0.001,0.746,405,399
3,904,50,0,1e-05,0.001,0.774,459,445
3,1004,50,0,1e-05,0.001,0.8,510,494
3,1104,50,0,1e-05,0.001,0.842,559,545
3,1204,50,0,1e-05,0.001,0.872,596,608
3,1304,50,0,1e-05,0.001,0.906,643,661
3,1404,50,0,1e-05,0.001,0.926,689,715
3,1504,50,0,1e-05,0.001,0.946,745,759
3,1604,50,0,1e-05,0.001,0.96,799,805
3,1704,50,0,1e-05,0.001,0.974,846,858
3,1804,50,0,1e-05,0.001,0.978,898,906
3,1904,50,0,1e-05,0.001,0.982,952,952
4,0,50,0,1e-05,0.001,0.504,0,0
4,104,50,0,1e-05,0.001,0.516,64,40
4,204,50,0,1e-05,0.001,0.624,111,93
4,304,50,0,1e-05,0.001,0.552,163,141
4,404,50,0,1e-05,0.001,0.596,215,189
4,504,50,0,1e-05,0.001,0.68,269,235
4,604,50,0,1e-05,0.001,0.682,316,288
4,704,50,0,1e-05,0.001,0.692,357,347
4,804,50,0,1e-05,0.001,0.744,408,396
4,904,50,0,1e-05,0.001,0.77,459,445
4,1004,50,0,1e-05,0.001,0.796,517,487
4,1104,50,0,1e-05,0.001,0.82,565,539
4,1204,50,0,1e-05,0.001,0.848,614,590
4,1304,50,0,1e-05,0.001,0.872,668,636
4,1404,50,0,1e-05,0.001,0.908,714,690
4,1504,50,0,1e-05,0.001,0.93,766,738
4,1604,50,0,1e-05,0.001,0.946,810,794
4,1704,50,0,1e-05,0.001,0.952,856,848
4,1804,50,0,1e-05,0.001,0.962,911,893
4,1904,50,0,1e-05,0.001,0.98,952,952
5,0,50,0,1e-05,0.001,0.506,0,0
5,104,50,0,1e-05,0.001,0.53,52,52
5,204,50,0,1e-05,0.001,0.666,101,103
5,304,50,0,1e-05,0.001,0.55,154,150
5,404,50,0,1e-05,0.001,0.644,207,197
5,504,50,0,1e-05,0.001,0.684,259,245
5,604,50,0,1e-05,0.001,0.694,305,299
5,704,50,0,1e-05,0.001,0.7,358,346
5,804,50,0,1e-05,0.001,0.75,398,406
5,904,50,0,1e-05,0.001,0.79,446,458
5,1004,50,0,1e-05,0.001,0.83,490,514
5,1104,50,0,1e-05,0.001,0.852,540,564
5,1204,50,0,1e-05,0.001,0.89,595,609
5,1304,50,0,1e-05,0.001,0.926,649,655
5,1404,50,0,1e-05,0.001,0.944,690,714
5,1504,50,0,1e-05,0.001,0.958,736,768
5,1604,50,0,1e-05,0.001,0.97,790,814
5,1704,50,0,1e-05,0.001,0.976,842,862
5,1804,50,0,1e-05,0.001,0.98,895,909
5,1904,50,0,1e-05,0.001,0.984,952,952
6,0,50,0,1e-05,0.001,0.506,0,0
6,104,50,0,1e-05,0.001,0.522,58,46
6,204,50,0,1e-05,0.001,0.572,115,89
6,304,50,0,1e-05,0.001,0.562,173,131
6,404,50,0,1e-05,0.001,0.578,220,184
6,504,50,0,1e-05,0.001,0.626,269,235
6,604,50,0,1e-05,0.001,0.618,320,284
6,704,50,0,1e-05,0.001,0.664,370,334
6,804,50,0,1e-05,0.001,0.704,407,397
6,904,50,0,1e-05,0.001,0.724,457,447
6,1004,50,0,1e-05,0.001,0.758,507,497
6,1104,50,0,1e-05,0.001,0.784,560,544
6,1204,50,0,1e-05,0.001,0.826,607,597
6,1304,50,0,1e-05,0.001,0.856,663,641
6,1404,50,0,1e-05,0.001,0.882,699,705
6,1504,50,0,1e-05,0.001,0.926,749,755
6,1604,50,0,1e-05,0.001,0.94,806,798
6,1704,50,0,1e-05,0.001,0.956,846,858
6,1804,50,0,1e-05,0.001,0.968,901,903
6,1904,50,0,1e-05,0.001,0.974,952,952
7,0,50,0,1e-05,0.001,0.504,0,0
7,104,50,0,1e-05,0.001,0.516,53,51
7,204,50,0,1e-05,0.001,0.632,109,95
7,304,50,0,1e-05,0.001,0.576,157,147
7,404,50,0,1e-05,0.001,0.602,207,197
7,504,50,0,1e-05,0.001,0.696,256,248
7,604,50,0,1e-05,0.001,0.692,302,302
7,704,50,0,1e-05,0.001,0.712,358,346
7,804,50,0,1e-05,0.001,0.788,413,391
7,904,50,0,1e-05,0.001,0.808,459,445
7,1004,50,0,1e-05,0.001,0.834,510,494
7,1104,50,0,1e-05,0.001,0.864,554,550
7,1204,50,0,1e-05,0.001,0.896,603,601
7,1304,50,0,1e-05,0.001,0.934,656,648
7,1404,50,0,1e-05,0.001,0.948,692,712
7,1504,50,0,1e-05,0.001,0.97,747,757
7,1604,50,0,1e-05,0.001,0.982,801,803
7,1704,50,0,1e-05,0.001,0.988,852,852
7,1804,50,0,1e-05,0.001,0.99,903,901
7,1904,50,0,1e-05,0.001,0.992,952,952
8,0,50,0,1e-05,0.001,0.514,0,0
8,104,50,0,1e-05,0.001,0.524,56,48
8,204,50,0,1e-05,0.001,0.662,116,88
8,304,50,0,1e-05,0.001,0.552,163,141
8,404,50,0,1e-05,0.001,0.566,220,184
8,504,50,0,1e-05,0.001,0.682,268,236
8,604,50,0,1e-05,0.001,0.674,305,299
8,704,50,0,1e-05,0.001,0.666,359,345
8,804,50,0,1e-05,0.001,0.7,400,404
8,904,50,0,1e-05,0.001,0.734,443,461
8,1004,50,0,1e-05,0.001,0.75,498,506
8,1104,50,0,1e-05,0.001,0.81,543,561
8,1204,50,0,1e-05,0.001,0.836,596,608
8,1304,50,0,1e-05,0.001,0.874,645,659
8,1404,50,0,1e-05,0.001,0.896,689,715
8,1504,50,0,1e-05,0.001,0.908,742,762
8,1604,50,0,1e-05,0.001,0.934,793,811
8,1704,50,0,1e-05,0.001,0.952,848,856
8,1804,50,0,1e-05,0.001,0.96,902,902
8,1904,50,0,1e-05,0.001,0.97,952,952
9,0,50,0,1e-05,0.001,0.506,0,0
9,104,50,0,1e-05,0.001,0.508,55,49
9,204,50,0,1e-05,0.001,0.638,106,98
9,304,50,0,1e-05,0.001,0.582,153,151
9,404,50,0,1e-05,0.001,0.664,194,210
9,504,50,0,1e-05,0.001,0.684,245,259
9,604,50,0,1e-05,0.001,0.684,298,306
9,704,50,0,1e-05,0.001,0.75,343,361
9,804,50,0,1e-05,0.001,0.784,398,406
9,904,50,0,1e-05,0.001,0.804,449,455
9,1004,50,0,1e-05,0.001,0.828,495,509
9,1104,50,0,1e-05,0.001,0.848,546,558
9,1204,50,0,1e-05,0.001,0.874,600,604
9,1304,50,0,1e-05,0.001,0.914,651,653
9,1404,50,0,1e-05,0.001,0.924,695,709
9,1504,50,0,1e-05,0.001,0.942,750,754
9,1604,50,0,1e-05,0.001,0.958,804,800
9,1704,50,0,1e-05,0.001,0.966,852,852
9,1804,50,0,1e-05,0.001,0.978,898,906
9,1904,50,0,1e-05,0.001,0.982,952,952
10,0,50,0,1e-05,0.001,0.508,0,0
10,104,50,0,1e-05,0.001,0.514,52,52
10,204,50,0,1e-05,0.001,0.61,103,101
10,304,50,0,1e-05,0.001,0.518,155,149
10,404,50,0,1e-05,0.001,0.578,196,208
10,504,50,0,1e-05,0.001,0.628,240,264
10,604,50,0,1e-05,0.001,0.622,288,316
10,704,50,0,1e-05,0.001,0.668,342,362
10,804,50,0,1e-05,0.001,0.708,401,403
10,904,50,0,1e-05,0.001,0.756,449,455
10,1004,50,0,1e-05,0.001,0.754,499,505
10,1104,50,0,1e-05,0.001,0.796,550,554
10,1204,50,0,1e-05,0.001,0.842,600,604
10,1304,50,0,1e-05,0.001,0.868,653,651
10,1404,50,0,1e-05,0.001,0.904,696,708
10,1504,50,0,1e-05,0.001,0.934,734,770
10,1604,50,0,1e-05,0.001,0.95,789,815
10,1704,50,0,1e-05,0.001,0.964,840,864
10,1804,50,0,1e-05,0.001,0.966,898,906
10,1904,50,0,1e-05,0.001,0.978,952,952
11,0,50,0,1e-05,0.001,0.506,0,0
11,104,50,0,1e-05,0.001,0.51,58,46
11,204,50,0,1e-05,0.001,0.592,120,84
11,304,50,0,1e-05,0.001,0.506,172,132
11,404,50,0,1e-05,0.001,0.542,220,184
11,504,50,0,1e-05,0.001,0.638,272,232
11,604,50,0,1e-05,0.001,0.64,321,283
11,704,50,0,1e-05,0.001,0.636,372,332
11,804,50,0,1e-05,0.001,0.674,415,389
11,904,50,0,1e-05,0.001,0.71,462,442
11,1004,50,0,1e-05,0.001,0.746,511,493
11,1104,50,0,1e-05,0.001,0.776,565,539
11,1204,50,0,1e-05,0.001,0.824,620,584
11,1304,50,0,1e-05,0.001,0.856,662,642
11,1404,50,0,1e-05,0.001,0.896,714,690
11,1504,50,0,1e-05,0.001,0.93,752,752
11,1604,50,0,1e-05,0.001,0.952,798,806
11,1704,50,0,1e-05,0.001,0.972,852,852
11,1804,50,0,1e-05,0.001,0.986,903,901
11,1904,50,0,1e-05,0.001,0.99,952,952
12,0,50,0,1e-05,0.001,0.502,0,0
12,104,50,0,1e-05,0.001,0.514,51,53
12,204,50,0,1e-05,0.001,0.614,108,96
12,304,50,0,1e-05,0.001,0.516,161,143
12,404,50,0,1e-05,0.001,0.6,205,199
12,504,50,0,1e-05,0.001,0.64,254,250
12,604,50,0,1e-05,0.001,0.666,313,291
12,704,50,0,1e-05,0.001,0.684,363,341
12,804,50,0,1e-05,0.001,0.756,400,404
12,904,50,0,1e-05,0.001,0.774,450,454
12,1004,50,0,1e-05,0.001,0.788,503,501
12,1104,50,0,1e-05,0.001,0.812,549,555
12,1204,50,0,1e-05,0.001,0.85,602,602
12,1304,50,0,1e-05,0.001,0.878,658,646
12,1404,50,0,1e-05,0.001,0.906,711,693
12,1504,50,0,1e-05,0.001,0.934,761,743
12,1604,50,0,1e-05,0.001,0.954,810,794
12,1704,50,0,1e-05,0.001,0.966,855,849
12,1804,50,0,1e-05,0.001,0.974,908,896
12,1904,50,0,1e-05,0.001,0.98,952,952
13,0,50,0,1e-05,0.001,0.504,0,0
13,104,50,0,1e-05,0.001,0.508,50,54
13,204,50,0,1e-05,0.001,0.596,93,111
13,304,50,0,1e-05,0.001,0.534,144,160
13,404,50,0,1e-05,0.001,0.57,192,212
13,504,50,0,1e-05,0.001,0.626,242,262
13,604,50,0,1e-05,0.001,0.642,289,315
13,704,50,0,1e-05,0.001,0.65,342,362
13,804,50,0,1e-05,0.001,0.702,394,410
13,904,50,0,1e-05,0.001,0.724,450,454
13,1004,50,0,1e-05,0.001,0.78,499,505
13,1104,50,0,1e-05,0.001,0.808,553,551
13,1204,50,0,1e-05,0.001,0.83,609,595
13,1304,50,0,1e-05,0.001,0.854,657,647
13,1404,50,0,1e-05,0.001,0.9,711,693
13,1504,50,0,1e-05,0.001,0.932,756,748
13,1604,50,0,1e-05,0.001,0.948,807,797
13,1704,50,0,1e-05,0.001,0.952,858,846
13,1804,50,0,1e-05,0.001,0.976,906,898
13,1904,50,0,1e-05,0.001,0.982,952,952
14,0,50,0,1e-05,0.001,0.518,0,0
14,104,50,0,1e-05,0.001,0.524,53,51
14,204,50,0,1e-05,0.001,0.594,99,105
14,304,50,0,1e-05,0.001,0.552,148,156
14,404,50,0,1e-05,0.001,0.612,192,212
14,504,50,0,1e-05,0.001,0.614,243,261
14,604,50,0,1e-05,0.001,0.638,301,303
14,704,50,0,1e-05,0.001,0.664,358,346
14,804,50,0,1e-05,0.001,0.704,402,402
14,904,50,0,1e-05,0.001,0.738,449,455
14,1004,50,0,1e-05,0.001,0.76,489,515
14,1104,50,0,1e-05,0.001,0.794,545,559
14,1204,50,0,1e-05,0.001,0.818,586,618
14,1304,50,0,1e-05,0.001,0.862,637,667
14,1404,50,0,1e-05,0.001,0.9,688,716
14,1504,50,0,1e-05,0.001,0.924,739,765
14,1604,50,0,1e-05,0.001,0.948,798,806
14,1704,50,0,1e-05,0.001,0.968,843,861
14,1804,50,0,1e-05,0.001,0.984,897,907
14,1904,50,0,1e-05,0.001,0.992,952,952
15,0,50,0,1e-05,0.001,0.508,0,0
15,104,50,0,1e-05,0.001,0.522,51,53
15,204,50,0,1e-05,0.001,0.63,108,96
15,304,50,0,1e-05,0.001,0.526,158,146
15,404,50,0,1e-05,0.001,0.594,210,194
15,504,50,0,1e-05,0.001,0.644,251,253
15,604,50,0,1e-05,0.001,0.654,305,299
15,704,50,0,1e-05,0.001,0.662,349,355
15,804,50,0,1e-05,0.001,0.722,395,409
15,904,50,0,1e-05,0.001,0.756,465,439
15,1004,50,0,1e-05,0.001,0.76,513,491
15,1104,50,0,1e-05,0.001,0.83,561,543
15,1204,50,0,1e-05,0.001,0.856,608,596
15,1304,50,0,1e-05,0.001,0.88,653,651
15,1404,50,0,1e-05,0.001,0.908,698,706
15,1504,50,0,1e-05,0.001,0.926,746,758
15,1604,50,0,1e-05,0.001,0.942,801,803
15,1704,50,0,1e-05,0.001,0.96,857,847
15,1804,50,0,1e-05,0.001,0.97,905,899
15,1904,50,0,1e-05,0.001,0.982,952,952
16,0,50,0,1e-05,0.001,0.508,0,0
16,104,50,0,1e-05,0.001,0.512,39,65
16,204,50,0,1e-05,0.001,0.546,92,112
16,304,50,0,1e-05,0.001,0.554,145,159
16,404,50,0,1e-05,0.001,0.604,204,200
16,504,50,0,1e-05,0.001,0.612,256,248
16,604,50,0,1e-05,0.001,0.618,306,298
16,704,50,0,1e-05,0.001,0.646,360,344
16,804,50,0,1e-05,0.001,0.66,410,394
16,904,50,0,1e-05,0.001,0.706,456,448
16,1004,50,0,1e-05,0.001,0.734,510,494
16,1104,50,0,1e-05,0.001,0.774,567,537
16,1204,50,0,1e-05,0.001,0.804,618,586
16,1304,50,0,1e-05,0.001,0.848,664,640
16,1404,50,0,1e-05,0.001,0.874,710,694
16,1504,50,0,1e-05,0.001,0.908,752,752
16,1604,50,0,1e-05,0.001,0.926,803,801
16,1704,50,0,1e-05,0.001,0.938,851,853
16,1804,50,0,1e-05,0.001,0.942,903,901
16,1904,50,0,1e-05,0.001,0.962,952,952
17,0,50,0,1e-05,0.001,0.508,0,0
17,104,50,0,1e-05,0.001,0.526,50,54
17,204,50,0,1e-05,0.001,0.624,103,101
17,304,50,0,1e-05,0.001,0.598,154,150
17,404,50,0,1e-05,0.001,0.636,199,205
17,504,50,0,1e-05,0.001,0.696,255,249
17,604,50,0,1e-05,0.001,0.72,313,291
17,704,50,0,1e-05,0.001,0.748,361,343
17,804,50,0,1e-05,0.001,0.784,414,390
17,904,50,0,1e-05,0.001,0.792,471,433
17,1004,50,0,1e-05,0.001,0.83,515,489
17,1104,50,0,1e-05,0.001,0.858,559,545
17,1204,50,0,1e-05,0.001,0.886,612,592
17,1304,50,0,1e-05,0.001,0.916,664,640
17,1404,50,0,1e-05,0.001,0.934,713,691
17,1504,50,0,1e-05,0.001,0.942,766,738
17,1604,50,0,1e-05,0.001,0.956,813,791
17,1704,50,0,1e-05,0.001,0.97,858,846
17,1804,50,0,1e-05,0.001,0.978,909,895
17,1904,50,0,1e-05,0.001,0.98,952,952
18,0,50,0,1e-05,0.001,0.502,0,0
18,104,50,0,1e-05,0.001,0.508,54,50
18,204,50,0,1e-05,0.001,0.64,99,105
18,304,50,0,1e-05,0.001,0.518,145,159
18,404,50,0,1e-05,0.001,0.62,201,203
18,504,50,0,1e-05,0.001,0.636,260,244
18,604,50,0,1e-05,0.001,0.654,304,300
18,704,50,0,1e-05,0.001,0.656,355,349
18,804,50,0,1e-05,0.001,0.696,406,398
18,904,50,0,1e-05,0.001,0.706,452,452
18,1004,50,0,1e-05,0.001,0.734,498,506
18,1104,50,0,1e-05,0.001,0.786,546,558
18,1204,50,0,1e-05,0.001,0.844,604,600
18,1304,50,0,1e-05,0.001,0.874,656,648
18,1404,50,0,1e-05,0.001,0.898,703,701
18,1504,50,0,1e-05,0.001,0.914,754,750
18,1604,50,0,1e-05,0.001,0.936,800,804
18,1704,50,0,1e-05,0.001,0.948,849,855
18,1804,50,0,1e-05,0.001,0.962,901,903
18,1904,50,0,1e-05,0.001,0.974,952,952
19,0,50,0,1e-05,0.001,0.508,0,0
19,104,50,0,1e-05,0.001,0.514,53,51
19,204,50,0,1e-05,0.001,0.606,102,102
19,304,50,0,1e-05,0.001,0.532,160,144
19,404,50,0,1e-05,0.001,0.592,215,189
19,504,50,0,1e-05,0.001,0.64,277,227
19,604,50,0,1e-05,0.001,0.65,320,284
19,704,50,0,1e-05,0.001,0.664,370,334
19,804,50,0,1e-05,0.001,0.718,420,384
19,904,50,0,1e-05,0.001,0.738,472,432
19,1004,50,0,1e-05,0.001,0.774,521,483
19,1104,50,0,1e-05,0.001,0.792,564,540
19,1204,50,0,1e-05,0.001,0.838,618,586
19,1304,50,0,1e-05,0.001,0.864,666,638
19,1404,50,0,1e-05,0.001,0.886,713,691
19,1504,50,0,1e-05,0.001,0.914,756,748
19,1604,50,0,1e-05,0.001,0.94,807,797
19,1704,50,0,1e-05,0.001,0.96,854,850
19,1804,50,0,1e-05,0.001,0.97,900,904
19,1904,50,0,1e-05,0.001,0.974,952,952
20,0,50,0,1e-05,0.001,0.508,0,0
20,104,50,0,1e-05,0.001,0.522,62,42
20,204,50,0,1e-05,0.001,0.644,111,93
20,304,50,0,1e-05,0.001,0.554,163,141
20,404,50,0,1e-05,0.001,0.606,209,195
20,504,50,0,1e-05,0.001,0.676,248,256
20,604,50,0,1e-05,0.001,0.69,298,306
20,704,50,0,1e-05,0.001,0.694,351,353
20,804,50,0,1e-05,0.001,0.75,403,401
20,904,50,0,1e-05,0.001,0.782,453,451
20,1004,50,0,1e-05,0.001,0.794,496,508
20,1104,50,0,1e-05,0.001,0.834,544,560
20,1204,50,0,1e-05,0.001,0.854,583,621
20,1304,50,0,1e-05,0.001,0.876,637,667
20,1404,50,0,1e-05,0.001,0.9,690,714
20,1504,50,0,1e-05,0.001,0.916,746,758
20,1604,50,0,1e-05,0.001,0.93,795,809
20,1704,50,0,1e-05,0.001,0.954,850,854
20,1804,50,0,1e-05,0.001,0.96,903,901
20,1904,50,0,1e-05,0.001,0.974,952,952
1,0,50,0,1e-05,0.01,0.502,0,0
1,104,50,0,1e-05,0.01,0.606,44,60
1,204,50,0,1e-05,0.01,0.646,94,110
1,304,50,0,1e-05,0.01,0.648,139,165
1,404,50,0,1e-05,0.01,0.656,188,216
1,504,50,0,1e-05,0.01,0.636,237,267
1,604,50,0,1e-05,0.01,0.666,294,310
1,704,50,0,1e-05,0.01,0.71,350,354
1,804,50,0,1e-05,0.01,0.724,402,402
1,904,50,0,1e-05,0.01,0.76,455,449
1,1004,50,0,1e-05,0.01,0.78,511,493
1,1104,50,0,1e-05,0.01,0.788,557,547
1,1204,50,0,1e-05,0.01,0.836,602,602
1,1304,50,0,1e-05,0.01,0.854,656,648
1,1404,50,0,1e-05,0.01,0.866,710,694
1,1504,50,0,1e-05,0.01,0.88,762,742
1,1604,50,0,1e-05,0.01,0.896,816,788
1,1704,50,0,1e-05,0.01,0.914,857,847
1,1804,50,0,1e-05,0.01,0.92,904,900
1,1904,50,0,1e-05,0.01,0.93,952,952
2,0,50,0,1e-05,0.01,0.504,0,0
2,104,50,0,1e-05,0.01,0.552,50,54
2,204,50,0,1e-05,0.01,0.672,97,107
2,304,50,0,1e-05,0.01,0.634,145,159
2,404,50,0,1e-05,0.01,0.668,190,214
2,504,50,0,1e-05,0.01,0.68,244,260
2,604,50,0,1e-05,0.01,0.702,293,311
2,704,50,0,1e-05,0.01,0.728,335,369
2,804,50,0,1e-05,0.01,0.736,394,410
2,904,50,0,1e-05,0.01,0.766,451,453
2,1004,50,0,1e-05,0.01,0.806,493,511
2,1104,50,0,1e-05,0.01,0.818,545,559
2,1204,50,0,1e-05,0.01,0.844,590,614
2,1304,50,0,1e-05,0.01,0.854,636,668
2,1404,50,0,1e-05,0.01,0.87,679,725
2,1504,50,0,1e-05,0.01,0.906,735,769
2,1604,50,0,1e-05,0.01,0.904,790,814
2,1704,50,0,1e-05,0.01,0.918,835,869
2,1804,50,0,1e-05,0.01,0.924,899,905
2,1904,50,0,1e-05,0.01,0.95,952,952
3,0,50,0,1e-05,0.01,0.502,0,0
3,104,50,0,1e-05,0.01,0.556,32,72
3,204,50,0,1e-05,0.01,0.588,75,129
3,304,50,0,1e-05,0.01,0.572,120,184
3,404,50,0,1e-05,0.01,0.582,170,234
3,504,50,0,1e-05,0.01,0.65,219,285
3,604,50,0,1e-05,0.01,0.682,274,330
3,704,50,0,1e-05,0.01,0.676,321,383
3,804,50,0,1e-05,0.01,0.712,368,436
3,904,50,0,1e-05,0.01,0.722,418,486
3,1004,50,0,1e-05,0.01,0.76,470,534
3,1104,50,0,1e-05,0.01,0.774,526,578
3,1204,50,0,1e-05,0.01,0.806,570,634
3,1304,50,0,1e-05,0.01,0.836,617,687
3,1404,50,0,1e-05,0.01,0.852,671,733
3,1504,50,0,1e-05,0.01,0.876,728,776
3,1604,50,0,1e-05,0.01,0.89,787,817
3,1704,50,0,1e-05,0.01,0.916,838,866
3,1804,50,0,1e-05,0.01,0.918,897,907
3,1904,50,0,1e-05,0.01,0.936,952,952
4,0,50,0,1e-05,0.01,0.5,0,0
4,104,50,0,1e-05,0.01,0.56,54,50
4,204,50,0,1e-05,0.01,0.642,105,99
4,304,50,0,1e-05,0.01,0.588,148,156
4,404,50,0,1e-05,0.01,0.6,193,211
4,504,50,0,1e-05,0.01,0.624,242,262
4,604,50,0,1e-05,0.01,0.632,289,315
4,704,50,0,1e-05,0.01,0.654,343,361
4,804,50,0,1e-05,0.01,0.686,398,406
4,904,50,0,1e-05,0.01,0.668,442,462
4,1004,50,0,1e-05,0.01,0.704,493,511
4,1104,50,0,1e-05,0.01,0.738,542,562
4,1204,50,0,1e-05,0.01,0.768,594,610
4,1304,50,0,1e-05,0.01,0.794,654,650
4,1404,50,0,1e-05,0.01,0.818,701,703
4,1504,50,0,1e-05,0.01,0.828,747,757
4,1604,50,0,1e-05,0.01,0.85,798,806
4,1704,50,0,1e-05,0.01,0.874,854,850
4,1804,50,0,1e-05,0.01,0.894,901,903
4,1904,50,0,1e-05,0.01,0.906,952,952
5,0,50,0,1e-05,0.01,0.502,0,0
5,104,50,0,1e-05,0.01,0.562,51,53
5,204,50,0,1e-05,0.01,0.67,103,101
5,304,50,0,1e-05,0.01,0.62,143,161
5,404,50,0,1e-05,0.01,0.656,192,212
5,504,50,0,1e-05,0.01,0.7,245,259
5,604,50,0,1e-05,0.01,0.69,292,312
5,704,50,0,1e-05,0.01,0.698,346,358
5,804,50,0,1e-05,0.01,0.726,395,409
5,904,50,0,1e-05,0.01,0.76,443,461
5,1004,50,0,1e-05,0.01,0.798,499,505
5,1104,50,0,1e-05,0.01,0.814,554,550
5,1204,50,0,1e-05,0.01,0.84,601,603
5,1304,50,0,1e-05,0.01,0.866,645,659
5,1404,50,0,1e-05,0.01,0.89,695,709
5,1504,50,0,1e-05,0.01,0.91,747,757
5,1604,50,0,1e-05,0.01,0.906,792,812
5,1704,50,0,1e-05,0.01,0.92,847,857
5,1804,50,0,1e-05,0.01,0.912,901,903
5,1904,50,0,1e-05,0.01,0.944,952,952
6,0,50,0,1e-05,0.01,0.5,0,0
6,104,50,0,1e-05,0.01,0.552,50,54
6,204,50,0,1e-05,0.01,0.612,103,101
6,304,50,0,1e-05,0.01,0.616,150,154
6,404,50,0,1e-05,0.01,0.614,201,203
6,504,50,0,1e-05,0.01,0.616,252,252
6,604,50,0,1e-05,0.01,0.682,300,304
6,704,50,0,1e-05,0.01,0.712,348,356
6,804,50,0,1e-05,0.01,0.714,391,413
6,904,50,0,1e-05,0.01,0.758,446,458
6,1004,50,0,1e-05,0.01,0.768,507,497
6,1104,50,0,1e-05,0.01,0.812,557,547
6,1204,50,0,1e-05,0.01,0.842,607,597
6,1304,50,0,1e-05,0.01,0.862,660,644
6,1404,50,0,1e-05,0.01,0.87,702,702
6,1504,50,0,1e-05,0.01,0.888,752,752
6,1604,50,0,1e-05,0.01,0.92,800,804
6,1704,50,0,1e-05,0.01,0.92,853,851
6,1804,50,0,1e-05,0.01,0.938,895,909
6,1904,50,0,1e-05,0.01,0.954,952,952
7,0,50,0,1e-05,0.01,0.502,0,0
7,104,50,0,1e-05,0.01,0.552,63,41
7,204,50,0,1e-05,0.01,0.586,112,92
7,304,50,0,1e-05,0.01,0.598,160,144
7,404,50,0,1e-05,0.01,0.6,210,194
7,504,50,0,1e-05,0.01,0.636,260,244
7,604,50,0,1e-05,0.01,0.64,307,297
7,704,50,0,1e-05,0.01,0.666,358,346
7,804,50,0,1e-05,0.01,0.674,403,401
7,904,50,0,1e-05,0.01,0.686,452,452
7,1004,50,0,1e-05,0.01,0.708,504,500
7,1104,50,0,1e-05,0.01,0.724,554,550
7,1204,50,0,1e-05,0.01,0.76,602,602
7,1304,50,0,1e-05,0.01,0.788,654,650
7,1404,50,0,1e-05,0.01,0.808,709,695
7,1504,50,0,1e-05,0.01,0.842,760,744
7,1604,50,0,1e-05,0.01,0.856,813,791
7,1704,50,0,1e-05,0.01,0.9,866,838
7,1804,50,0,1e-05,0.01,0.898,906,898
7,1904,50,0,1e-05,0.01,0.932,952,952
8,0,50,0,1e-05,0.01,0.5,0,0
8,104,50,0,1e-05,0.01,0.57,52,52
8,204,50,0,1e-05,0.01,0.662,103,101
8,304,50,0,1e-05,0.01,0.682,153,151
8,404,50,0,1e-05,0.01,0.65,194,210
8,504,50,0,1e-05,0.01,0.658,257,247
8,604,50,0,1e-05,0.01,0.692,308,296
8,704,50,0,1e-05,0.01,0.704,367,337
8,804,50,0,1e-05,0.01,0.708,413,391
8,904,50,0,1e-05,0.01,0.718,461,443
8,1004,50,0,1e-05,0.01,0.756,501,503
8,1104,50,0,1e-05,0.01,0.79,550,554
8,1204,50,0,1e-05,0.01,0.832,608,596
8,1304,50,0,1e-05,0.01,0.858,662,642
8,1404,50,0,1e-05,0.01,0.89,708,696
8,1504,50,0,1e-05,0.01,0.91,757,747
8,1604,50,0,1e-05,0.01,0.918,800,804
8,1704,50,0,1e-05,0.01,0.928,852,852
8,1804,50,0,1e-05,0.01,0.944,904,900
8,1904,50,0,1e-05,0.01,0.956,952,952
9,0,50,0,1e-05,0.01,0.5,0,0
9,104,50,0,1e-05,0.01,0.572,52,52
9,204,50,0,1e-05,0.01,0.598,105,99
9,304,50,0,1e-05,0.01,0.578,159,145
9,404,50,0,1e-05,0.01,0.576,207,197
9,504,50,0,1e-05,0.01,0.602,250,254
9,604,50,0,1e-05,0.01,0.588,300,304
9,704,50,0,1e-05,0.01,0.596,365,339
9,804,50,0,1e-05,0.01,0.628,412,392
9,904,50,0,1e-05,0.01,0.652,471,433
9,1004,50,0,1e-05,0.01,0.668,518,486
9,1104,50,0,1e-05,0.01,0.69,571,533
9,1204,50,0,1e-05,0.01,0.688,623,581
9,1304,50,0,1e-05,0.01,0.706,670,634
9,1404,50,0,1e-05,0.01,0.722,713,691
9,1504,50,0,1e-05,0.01,0.754,756,748
9,1604,50,0,1e-05,0.01,0.784,801,803
9,1704,50,0,1e-05,0.01,0.814,849,855
9,1804,50,0,1e-05,0.01,0.824,899,905
9,1904,50,0,1e-05,0.01,0.824,952,952
10,0,50,0,1e-05,0.01,0.5,0,0
10,104,50,0,1e-05,0.01,0.528,56,48
10,204,50,0,1e-05,0.01,0.62,103,101
10,304,50,0,1e-05,0.01,0.582,152,152
10,404,50,0,1e-05,0.01,0.584,204,200
10,504,50,0,1e-05,0.01,0.636,251,253
10,604,50,0,1e-05,0.01,0.634,306,298
10,704,50,0,1e-05,0.01,0.648,352,352
10,804,50,0,1e-05,0.01,0.644,400,404
10,904,50,0,1e-05,0.01,0.676,462,442
10,1004,50,0,1e-05,0.01,0.68,513,491
10,1104,50,0,1e-05,0.01,0.712,563,541
10,1204,50,0,1e-05,0.01,0.748,613,591
10,1304,50,0,1e-05,0.01,0.77,656,648
10,1404,50,0,1e-05,0.01,0.816,706,698
10,1504,50,0,1e-05,0.01,0.838,758,746
10,1604,50,0,1e-05,0.01,0.86,808,796
10,1704,50,0,1e-05,0.01,0.892,856,848
10,1804,50,0,1e-05,0.01,0.926,910,894
10,1904,50,0,1e-05,0.01,0.936,952,952
11,0,50,0,1e-05,0.01,0.504,0,0
11,104,50,0,1e-05,0.01,0.558,47,57
11,204,50,0,1e-05,0.01,0.604,96,108
11,304,50,0,1e-05,0.01,0.602,135,169
11,404,50,0,1e-05,0.01,0.638,183,221
11,504,50,0,1e-05,0.01,0.626,234,270
11,604,50,0,1e-05,0.01,0.658,283,321
11,704,50,0,1e-05,0.01,0.686,331,373
11,804,50,0,1e-05,0.01,0.696,385,419
11,904,50,0,1e-05,0.01,0.7,445,459
11,1004,50,0,1e-05,0.01,0.68,496,508
11,1104,50,0,1e-05,0.01,0.724,552,552
11,1204,50,0,1e-05,0.01,0.75,599,605
11,1304,50,0,1e-05,0.01,0.766,653,651
11,1404,50,0,1e-05,0.01,0.806,698,706
11,1504,50,0,1e-05,0.01,0.828,751,753
11,1604,50,0,1e-05,0.01,0.83,796,808
11,1704,50,0,1e-05,0.01,0.846,845,859
11,1804,50,0,1e-05,0.01,0.86,903,901
11,1904,50,0,1e-05,0.01,0.858,952,952
12,0,50,0,1e-05,0.01,0.5,0,0
12,104,50,0,1e-05,0.01,0.584,42,62
12,204,50,0,1e-05,0.01,0.698,96,108
12,304,50,0,1e-05,0.01,0.716,141,163
12,404,50,0,1e-05,0.01,0.75,194,210
12,504,50,0,1e-05,0.01,0.768,247,257
12,604,50,0,1e-05,0.01,0.792,298,306
12,704,50,0,1e-05,0.01,0.808,347,357
12,804,50,0,1e-05,0.01,0.8,399,405
12,904,50,0,1e-05,0.01,0.818,453,451
12,1004,50,0,1e-05,0.01,0.854,507,497
12,1104,50,0,1e-05,0.01,0.872,552,552
12,1204,50,0,1e-05,0.01,0.91,597,607
12,1304,50,0,1e-05,0.01,0.918,643,661
12,1404,50,0,1e-05,0.01,0.938,696,708
12,1504,50,0,1e-05,0.01,0.944,745,759
12,1604,50,0,1e-05,0.01,0.952,804,800
12,1704,50,0,1e-05,0.01,0.966,854,850
12,1804,50,0,1e-05,0.01,0.972,903,901
12,1904,50,0,1e-05,0.01,0.968,952,952
13,0,50,0,1e-05,0.01,0.5,0,0
13,104,50,0,1e-05,0.01,0.55,56,48
13,204,50,0,1e-05,0.01,0.568,107,97
13,304,50,0,1e-05,0.01,0.566,156,148
13,404,50,0,1e-05,0.01,0.63,207,197
13,504,50,0,1e-05,0.01,0.626,255,249
13,604,50,0,1e-05,0.01,0.672,303,301
13,704,50,0,1e-05,0.01,0.676,359,345
13,804,50,0,1e-05,0.01,0.69,413,391
13,904,50,0,1e-05,0.01,0.73,466,438
13,1004,50,0,1e-05,0.01,0.742,505,499
13,1104,50,0,1e-05,0.01,0.764,552,552
13,1204,50,0,1e-05,0.01,0.776,603,601
13,1304,50,0,1e-05,0.01,0.812,655,649
13,1404,50,0,1e-05,0.01,0.856,703,701
13,1504,50,0,1e-05,0.01,0.878,749,755
13,1604,50,0,1e-05,0.01,0.896,794,810
13,1704,50,0,1e-05,0.01,0.928,850,854
13,1804,50,0,1e-05,0.01,0.94,898,906
13,1904,50,0,1e-05,0.01,0.948,952,952
14,0,50,0,1e-05,0.01,0.508,0,0
14,104,50,0,1e-05,0.01,0.542,55,49
14,204,50,0,1e-05,0.01,0.656,102,102
14,304,50,0,1e-05,0.01,0.62,162,142
14,404,50,0,1e-05,0.01,0.614,212,192
14,504,50,0,1e-05,0.01,0.63,267,237
14,604,50,0,1e-05,0.01,0.652,318,286
14,704,50,0,1e-05,0.01,0.652,371,333
14,804,50,0,1e-05,0.01,0.662,423,381
14,904,50,0,1e-05,0.01,0.682,466,438
14,1004,50,0,1e-05,0.01,0.696,508,496
14,1104,50,0,1e-05,0.01,0.716,562,542
14,1204,50,0,1e-05,0.01,0.742,612,592
14,1304,50,0,1e-05,0.01,0.786,659,645
14,1404,50,0,1e-05,0.01,0.812,705,699
14,1504,50,0,1e-05,0.01,0.85,753,751
14,1604,50,0,1e-05,0.01,0.878,802,802
14,1704,50,0,1e-05,0.01,0.896,852,852
14,1804,50,0,1e-05,0.01,0.91,898,906
14,1904,50,0,1e-05,0.01,0.924,952,952
15,0,50,0,1e-05,0.01,0.5,0,0
15,104,50,0,1e-05,0.01,0.58,57,47
15,204,50,0,1e-05,0.01,0.584,107,97
15,304,50,0,1e-05,0.01,0.562,152,152
15,404,50,0,1e-05,0.01,0.648,194,210
15,504,50,0,1e-05,0.01,0.638,251,253
15,604,50,0,1e-05,0.01,0.652,302,302
15,704,50,0,1e-05,0.01,0.684,355,349
15,804,50,0,1e-05,0.01,0.702,395,409
15,904,50,0,1e-05,0.01,0.738,447,457
15,1004,50,0,1e-05,0.01,0.744,500,504
15,1104,50,0,1e-05,0.01,0.76,552,552
15,1204,50,0,1e-05,0.01,0.798,589,615
15,1304,50,0,1e-05,0.01,0.812,633,671
15,1404,50,0,1e-05,0.01,0.828,695,709
15,1504,50,0,1e-05,0.01,0.872,742,762
15,1604,50,0,1e-05,0.01,0.892,789,815
15,1704,50,0,1e-05,0.01,0.906,843,861
15,1804,50,0,1e-05,0.01,0.924,904,900
15,1904,50,0,1e-05,0.01,0.932,952,952
16,0,50,0,1e-05,0.01,0.5,0,0
16,104,50,0,1e-05,0.01,0.51,48,56
16,204,50,0,1e-05,0.01,0.638,99,105
16,304,50,0,1e-05,0.01,0.608,153,151
16,404,50,0,1e-05,0.01,0.6,204,200
16,504,50,0,1e-05,0.01,0.604,248,256
16,604,50,0,1e-05,0.01,0.63,298,306
16,704,50,0,1e-05,0.01,0.638,348,356
16,804,50,0,1e-05,0.01,0.672,389,415
16,904,50,0,1e-05,0.01,0.69,441,463
16,1004,50,0,1e-05,0.01,0.74,490,514
16,1104,50,0,1e-05,0.01,0.766,542,562
16,1204,50,0,1e-05,0.01,0.826,586,618
16,1304,50,0,1e-05,0.01,0.87,639,665
16,1404,50,0,1e-05,0.01,0.886,690,714
16,1504,50,0,1e-05,0.01,0.898,740,764
16,1604,50,0,1e-05,0.01,0.912,790,814
16,1704,50,0,1e-05,0.01,0.93,847,857
16,1804,50,0,1e-05,0.01,0.936,899,905
16,1904,50,0,1e-05,0.01,0.94,952,952
17,0,50,0,1e-05,0.01,0.504,0,0
17,104,50,0,1e-05,0.01,0.556,53,51
17,204,50,0,1e-05,0.01,0.662,103,101
17,304,50,0,1e-05,0.01,0.598,149,155
17,404,50,0,1e-05,0.01,0.596,202,202
17,504,50,0,1e-05,0.01,0.606,245,259
17,604,50,0,1e-05,0.01,0.622,296,308
17,704,50,0,1e-05,0.01,0.626,347,357
17,804,50,0,1e-05,0.01,0.638,398,406
17,904,50,0,1e-05,0.01,0.646,454,450
17,1004,50,0,1e-05,0.01,0.668,508,496
17,1104,50,0,1e-05,0.01,0.678,551,553
17,1204,50,0,1e-05,0.01,0.708,600,604
17,1304,50,0,1e-05,0.01,0.74,644,660
17,1404,50,0,1e-05,0.01,0.754,688,716
17,1504,50,0,1e-05,0.01,0.788,736,768
17,1604,50,0,1e-05,0.01,0.826,792,812
17,1704,50,0,1e-05,0.01,0.854,840,864
17,1804,50,0,1e-05,0.01,0.866,884,920
17,1904,50,0,1e-05,0.01,0.872,952,952
18,0,50,0,1e-05,0.01,0.5,0,0
18,104,50,0,1e-05,0.01,0.56,56,48
18,204,50,0,1e-05,0.01,0.624,101,103
18,304,50,0,1e-05,0.01,0.616,154,150
18,404,50,0,1e-05,0.01,0.626,200,204
18,504,50,0,1e-05,0.01,0.628,259,245
18,604,50,0,1e-05,0.01,0.66,308,296
18,704,50,0,1e-05,0.01,0.656,361,343
18,804,50,0,1e-05,0.01,0.678,416,388
18,904,50,0,1e-05,0.01,0.666,470,434
18,1004,50,0,1e-05,0.01,0.69,521,483
18,1104,50,0,1e-05,0.01,0.692,570,534
18,1204,50,0,1e-05,0.01,0.724,624,580
18,1304,50,0,1e-05,0.01,0.754,669,635
18,1404,50,0,1e-05,0.01,0.786,709,695
18,1504,50,0,1e-05,0.01,0.826,756,748
18,1604,50,0,1e-05,0.01,0.856,805,799
18,1704,50,0,1e-05,0.01,0.874,857,847
18,1804,50,0,1e-05,0.01,0.884,903,901
18,1904,50,0,1e-05,0.01,0.9,952,952
19,0,50,0,1e-05,0.01,0.504,0,0
19,104,50,0,1e-05,0.01,0.566,55,49
19,204,50,0,1e-05,0.01,0.596,105,99
19,304,50,0,1e-05,0.01,0.61,150,154
19,404,50,0,1e-05,0.01,0.612,204,200
19,504,50,0,1e-05,0.01,0.654,249,255
19,604,50,0,1e-05,0.01,0.664,302,302
19,704,50,0,1e-05,0.01,0.684,353,351
19,804,50,0,1e-05,0.01,0.716,406,398
19,904,50,0,1e-05,0.01,0.74,457,447
19,1004,50,0,1e-05,0.01,0.752,504,500
19,1104,50,0,1e-05,0.01,0.794,542,562
19,1204,50,0,1e-05,0.01,0.81,593,611
19,1304,50,0,1e-05,0.01,0.832,656,648
19,1404,50,0,1e-05,0.01,0.846,697,707
19,1504,50,0,1e-05,0.01,0.858,749,755
19,1604,50,0,1e-05,0.01,0.882,799,805
19,1704,50,0,1e-05,0.01,0.908,848,856
19,1804,50,0,1e-05,0.01,0.916,899,905
19,1904,50,0,1e-05,0.01,0.926,952,952
20,0,50,0,1e-05,0.01,0.5,0,0
20,104,50,0,1e-05,0.01,0.558,49,55
20,204,50,0,1e-05,0.01,0.62,98,106
20,304,50,0,1e-05,0.01,0.676,150,154
20,404,50,0,1e-05,0.01,0.716,193,211
20,504,50,0,1e-05,0.01,0.694,240,264
20,604,50,0,1e-05,0.01,0.718,283,321
20,704,50,0,1e-05,0.01,0.746,337,367
20,804,50,0,1e-05,0.01,0.758,389,415
20,904,50,0,1e-05,0.01,0.79,445,459
20,1004,50,0,1e-05,0.01,0.796,501,503
20,1104,50,0,1e-05,0.01,0.832,549,555
20,1204,50,0,1e-05,0.01,0.88,599,605
20,1304,50,0,1e-05,0.01,0.894,655,649
20,1404,50,0,1e-05,0.01,0.906,720,684
20,1504,50,0,1e-05,0.01,0.93,759,745
20,1604,50,0,1e-05,0.01,0.946,805,799
20,1704,50,0,1e-05,0.01,0.958,855,849
20,1804,50,0,1e-05,0.01,0.968,901,903
20,1904,50,0,1e-05,0.01,0.964,952,952
1,0,50,0,0.0001,0.0001,0.53,0,0
1,104,50,0,0.0001,0.0001,0.528,48,56
1,204,50,0,0.0001,0.0001,0.528,102,102
1,304,50,0,0.0001,0.0001,0.528,155,149
1,404,50,0,0.0001,0.0001,0.528,211,193
1,504,50,0,0.0001,0.0001,0.524,258,246
1,604,50,0,0.0001,0.0001,0.52,305,299
1,704,50,0,0.0001,0.0001,0.506,365,339
1,804,50,0,0.0001,0.0001,0.492,412,392
1,904,50,0,0.0001,0.0001,0.494,454,450
1,1004,50,0,0.0001,0.0001,0.496,502,502
1,1104,50,0,0.0001,0.0001,0.488,552,552
1,1204,50,0,0.0001,0.0001,0.492,605,599
1,1304,50,0,0.0001,0.0001,0.5,652,652
1,1404,50,0,0.0001,0.0001,0.504,703,701
1,1504,50,0,0.0001,0.0001,0.504,749,755
1,1604,50,0,0.0001,0.0001,0.502,795,809
1,1704,50,0,0.0001,0.0001,0.504,853,851
1,1804,50,0,0.0001,0.0001,0.498,899,905
1,1904,50,0,0.0001,0.0001,0.502,952,952
2,0,50,0,0.0001,0.0001,0.494,0,0
2,104,50,0,0.0001,0.0001,0.496,40,64
2,204,50,0,0.0001,0.0001,0.494,85,119
2,304,50,0,0.0001,0.0001,0.5,132,172
2,404,50,0,0.0001,0.0001,0.512,185,219
2,504,50,0,0.0001,0.0001,0.506,242,262
2,604,50,0,0.0001,0.0001,0.502,293,311
2,704,50,0,0.0001,0.0001,0.506,346,358
2,804,50,0,0.0001,0.0001,0.5,395,409
2,904,50,0,0.0001,0.0001,0.508,447,457
2,1004,50,0,0.0001,0.0001,0.508,496,508
2,1104,50,0,0.0001,0.0001,0.496,550,554
2,1204,50,0,0.0001,0.0001,0.496,605,599
2,1304,50,0,0.0001,0.0001,0.504,661,643
2,1404,50,0,0.0001,0.0001,0.51,705,699
2,1504,50,0,0.0001,0.0001,0.504,761,743
2,1604,50,0,0.0001,0.0001,0.502,812,792
2,1704,50,0,0.0001,0.0001,0.5,861,843
2,1804,50,0,0.0001,0.0001,0.51,902,902
2,1904,50,0,0.0001,0.0001,0.496,952,952
3,0,50,0,0.0001,0.0001,0.512,0,0
3,104,50,0,0.0001,0.0001,0.512,45,59
3,204,50,0,0.0001,0.0001,0.512,94,110
3,304,50,0,0.0001,0.0001,0.514,144,160
3,404,50,0,0.0001,0.0001,0.51,195,209
3,504,50,0,0.0001,0.0001,0.514,244,260
3,604,50,0,0.0001,0.0001,0.512,300,304
3,704,50,0,0.0001,0.0001,0.51,355,349
3,804,50,0,0.0001,0.0001,0.514,406,398
3,904,50,0,0.0001,0.0001,0.51,455,449
3,1004,50,0,0.0001,0.0001,0.512,503,501
3,1104,50,0,0.0001,0.0001,0.522,547,557
3,1204,50,0,0.0001,0.0001,0.522,595,609
3,1304,50,0,0.0001,0.0001,0.536,656,648
3,1404,50,0,0.0001,0.0001,0.532,704,700
3,1504,50,0,0.0001,0.0001,0.536,759,745
3,1604,50,0,0.0001,0.0001,0.536,804,800
3,1704,50,0,0.0001,0.0001,0.538,850,854
3,1804,50,0,0.0001,0.0001,0.542,898,906
3,1904,50,0,0.0001,0.0001,0.566,952,952
4,0,50,0,0.0001,0.0001,0.522,0,0
4,104,50,0,0.0001,0.0001,0.522,54,50
4,204,50,0,0.0001,0.0001,0.52,114,90
4,304,50,0,0.0001,0.0001,0.522,160,144
4,404,50,0,0.0001,0.0001,0.52,202,202
4,504,50,0,0.0001,0.0001,0.524,253,251
4,604,50,0,0.0001,0.0001,0.524,297,307
4,704,50,0,0.0001,0.0001,0.52,344,360
4,804,50,0,0.0001,0.0001,0.518,398,406
4,904,50,0,0.0001,0.0001,0.524,453,451
4,1004,50,0,0.0001,0.0001,0.534,503,501
4,1104,50,0,0.0001,0.0001,0.534,550,554
4,1204,50,0,0.0001,0.0001,0.526,595,609
4,1304,50,0,0.0001,0.0001,0.526,648,656
4,1404,50,0,0.0001,0.0001,0.522,699,705
4,1504,50,0,0.0001,0.0001,0.524,752,752
4,1604,50,0,0.0001,0.0001,0.516,793,811
4,1704,50,0,0.0001,0.0001,0.52,845,859
4,1804,50,0,0.0001,0.0001,0.52,904,900
4,1904,50,0,0.0001,0.0001,0.526,952,952
5,0,50,0,0.0001,0.0001,0.508,0,0
5,104,50,0,0.0001,0.0001,0.508,58,46
5,204,50,0,0.0001,0.0001,0.506,118,86
5,304,50,0,0.0001,0.0001,0.504,172,132
5,404,50,0,0.0001,0.0001,0.512,217,187
5,504,50,0,0.0001,0.0001,0.502,264,240
5,604,50,0,0.0001,0.0001,0.478,321,283
5,704,50,0,0.0001,0.0001,0.47,374,330
5,804,50,0,0.0001,0.0001,0.464,427,377
5,904,50,0,0.0001,0.0001,0.48,477,427
5,1004,50,0,0.0001,0.0001,0.494,521,483
5,1104,50,0,0.0001,0.0001,0.506,559,545
5,1204,50,0,0.0001,0.0001,0.506,611,593
5,1304,50,0,0.0001,0.0001,0.51,654,650
5,1404,50,0,0.0001,0.0001,0.506,705,699
5,1504,50,0,0.0001,0.0001,0.502,755,749
5,1604,50,0,0.0001,0.0001,0.498,804,800
5,1704,50,0,0.0001,0.0001,0.496,851,853
5,1804,50,0,0.0001,0.0001,0.486,904,900
5,1904,50,0,0.0001,0.0001,0.484,952,952
6,0,50,0,0.0001,0.0001,0.492,0,0
6,104,50,0,0.0001,0.0001,0.492,47,57
6,204,50,0,0.0001,0.0001,0.492,94,110
6,304,50,0,0.0001,0.0001,0.492,148,156
6,404,50,0,0.0001,0.0001,0.492,194,210
6,504,50,0,0.0001,0.0001,0.49,232,272
6,604,50,0,0.0001,0.0001,0.494,288,316
6,704,50,0,0.0001,0.0001,0.492,342,362
6,804,50,0,0.0001,0.0001,0.496,388,416
6,904,50,0,0.0001,0.0001,0.498,439,465
6,1004,50,0,0.0001,0.0001,0.514,485,519
6,1104,50,0,0.0001,0.0001,0.5,533,571
6,1204,50,0,0.0001,0.0001,0.502,589,615
6,1304,50,0,0.0001,0.0001,0.508,644,660
6,1404,50,0,0.0001,0.0001,0.508,691,713
6,1504,50,0,0.0001,0.0001,0.506,741,763
6,1604,50,0,0.0001,0.0001,0.5,802,802
6,1704,50,0,0.0001,0.0001,0.508,849,855
6,1804,50,0,0.0001,0.0001,0.498,901,903
6,1904,50,0,0.0001,0.0001,0.486,952,952
7,0,50,0,0.0001,0.0001,0.524,0,0
7,104,50,0,0.0001,0.0001,0.524,50,54
7,204,50,0,0.0001,0.0001,0.524,108,96
7,304,50,0,0.0001,0.0001,0.526,151,153
7,404,50,0,0.0001,0.0001,0.526,197,207
7,504,50,0,0.0001,0.0001,0.526,246,258
7,604,50,0,0.0001,0.0001,0.524,302,302
7,704,50,0,0.0001,0.0001,0.526,351,353
7,804,50,0,0.0001,0.0001,0.526,399,405
7,904,50,0,0.0001,0.0001,0.532,455,449
7,1004,50,0,0.0001,0.0001,0.532,505,499
7,1104,50,0,0.0001,0.0001,0.534,557,547
7,1204,50,0,0.0001,0.0001,0.524,608,596
7,1304,50,0,0.0001,0.0001,0.524,662,642
7,1404,50,0,0.0001,0.0001,0.524,712,692
7,1504,50,0,0.0001,0.0001,0.522,763,741
7,1604,50,0,0.0001,0.0001,0.516,809,795
7,1704,50,0,0.0001,0.0001,0.512,854,850
7,1804,50,0,0.0001,0.0001,0.508,905,899
7,1904,50,0,0.0001,0.0001,0.492,952,952
8,0,50,0,0.0001,0.0001,0.512,0,0
8,104,50,0,0.0001,0.0001,0.514,54,50
8,204,50,0,0.0001,0.0001,0.514,107,97
8,304,50,0,0.0001,0.0001,0.514,151,153
8,404,50,0,0.0001,0.0001,0.516,203,201
8,504,50,0,0.0001,0.0001,0.518,255,249
8,604,50,0,0.0001,0.0001,0.514,299,305
8,704,50,0,0.0001,0.0001,0.506,345,359
8,804,50,0,0.0001,0.0001,0.51,397,407
8,904,50,0,0.0001,0.0001,0.502,450,454
8,1004,50,0,0.0001,0.0001,0.504,504,500
8,1104,50,0,0.0001,0.0001,0.498,550,554
8,1204,50,0,0.0001,0.0001,0.484,601,603
8,1304,50,0,0.0001,0.0001,0.492,653,651
8,1404,50,0,0.0001,0.0001,0.484,700,704
8,1504,50,0,0.0001,0.0001,0.49,757,747
8,1604,50,0,0.0001,0.0001,0.498,803,801
8,1704,50,0,0.0001,0.0001,0.506,849,855
8,1804,50,0,0.0001,0.0001,0.502,903,901
8,1904,50,0,0.0001,0.0001,0.502,952,952
9,0,50,0,0.0001,0.0001,0.504,0,0
9,104,50,0,0.0001,0.0001,0.504,60,44
9,204,50,0,0.0001,0.0001,0.506,105,99
9,304,50,0,0.0001,0.0001,0.504,160,144
9,404,50,0,0.0001,0.0001,0.5,204,200
9,504,50,0,0.0001,0.0001,0.496,249,255
9,604,50,0,0.0001,0.0001,0.502,300,304
9,704,50,0,0.0001,0.0001,0.488,344,360
9,804,50,0,0.0001,0.0001,0.474,393,411
9,904,50,0,0.0001,0.0001,0.484,447,457
9,1004,50,0,0.0001,0.0001,0.484,496,508
9,1104,50,0,0.0001,0.0001,0.476,543,561
9,1204,50,0,0.0001,0.0001,0.466,590,614
9,1304,50,0,0.0001,0.0001,0.472,631,673
9,1404,50,0,0.0001,0.0001,0.464,688,716
9,1504,50,0,0.0001,0.0001,0.464,745,759
9,1604,50,0,0.0001,0.0001,0.462,792,812
9,1704,50,0,0.0001,0.0001,0.468,843,861
9,1804,50,0,0.0001,0.0001,0.466,899,905
9,1904,50,0,0.0001,0.0001,0.468,952,952
10,0,50,0,0.0001,0.0001,0.49,0,0
10,104,50,0,0.0001,0.0001,0.486,52,52
10,204,50,0,0.0001,0.0001,0.492,102,102
10,304,50,0,0.0001,0.0001,0.494,140,164
10,404,50,0,0.0001,0.0001,0.496,184,220
10,504,50,0,0.0001,0.0001,0.496,237,267
10,604,50,0,0.0001,0.0001,0.496,280,324
10,704,50,0,0.0001,0.0001,0.502,335,369
10,804,50,0,0.0001,0.0001,0.506,382,422
10,904,50,0,0.0001,0.0001,0.504,434,470
10,1004,50,0,0.0001,0.0001,0.504,478,526
10,1104,50,0,0.0001,0.0001,0.502,529,575
10,1204,50,0,0.0001,0.0001,0.502,586,618
10,1304,50,0,0.0001,0.0001,0.502,640,664
10,1404,50,0,0.0001,0.0001,0.502,685,719
10,1504,50,0,0.0001,0.0001,0.5,740,764
10,1604,50,0,0.0001,0.0001,0.496,794,810
10,1704,50,0,0.0001,0.0001,0.488,843,861
10,1804,50,0,0.0001,0.0001,0.486,897,907
10,1904,50,0,0.0001,0.0001,0.484,952,952
11,0,50,0,0.0001,0.0001,0.496,0,0
11,104,50,0,0.0001,0.0001,0.494,47,57
11,204,50,0,0.0001,0.0001,0.492,100,104
11,304,50,0,0.0001,0.0001,0.492,156,148
11,404,50,0,0.0001,0.0001,0.492,204,200
11,504,50,0,0.0001,0.0001,0.494,261,243
11,604,50,0,0.0001,0.0001,0.492,310,294
11,704,50,0,0.0001,0.0001,0.494,358,346
11,804,50,0,0.0001,0.0001,0.49,415,389
11,904,50,0,0.0001,0.0001,0.494,460,444
11,1004,50,0,0.0001,0.0001,0.498,508,496
11,1104,50,0,0.0001,0.0001,0.488,558,546
11,1204,50,0,0.0001,0.0001,0.492,610,594
11,1304,50,0,0.0001,0.0001,0.498,661,643
11,1404,50,0,0.0001,0.0001,0.498,706,698
11,1504,50,0,0.0001,0.0001,0.5,758,746
11,1604,50,0,0.0001,0.0001,0.496,806,798
11,1704,50,0,0.0001,0.0001,0.51,855,849
11,1804,50,0,0.0001,0.0001,0.504,908,896
11,1904,50,0,0.0001,0.0001,0.51,952,952
12,0,50,0,0.0001,0.0001,0.51,0,0
12,104,50,0,0.0001,0.0001,0.51,56,48
12,204,50,0,0.0001,0.0001,0.51,98,106
12,304,50,0,0.0001,0.0001,0.508,152,152
12,404,50,0,0.0001,0.0001,0.508,200,204
12,504,50,0,0.0001,0.0001,0.512,248,256
12,604,50,0,0.0001,0.0001,0.512,291,313
12,704,50,0,0.0001,0.0001,0.53,343,361
12,804,50,0,0.0001,0.0001,0.54,387,417
12,904,50,0,0.0001,0.0001,0.536,431,473
12,1004,50,0,0.0001,0.0001,0.546,487,517
12,1104,50,0,0.0001,0.0001,0.562,551,553
12,1204,50,0,0.0001,0.0001,0.56,602,602
12,1304,50,0,0.0001,0.0001,0.566,645,659
12,1404,50,0,0.0001,0.0001,0.566,695,709
12,1504,50,0,0.0001,0.0001,0.566,752,752
12,1604,50,0,0.0001,0.0001,0.566,806,798
12,1704,50,0,0.0001,0.0001,0.574,863,841
12,1804,50,0,0.0001,0.0001,0.572,904,900
12,1904,50,0,0.0001,0.0001,0.576,952,952
13,0,50,0,0.0001,0.0001,0.512,0,0
13,104,50,0,0.0001,0.0001,0.512,53,51
13,204,50,0,0.0001,0.0001,0.514,102,102
13,304,50,0,0.0001,0.0001,0.51,164,140
13,404,50,0,0.0001,0.0001,0.51,216,188
13,504,50,0,0.0001,0.0001,0.51,263,241
13,604,50,0,0.0001,0.0001,0.506,307,297
13,704,50,0,0.0001,0.0001,0.506,363,341
13,804,50,0,0.0001,0.0001,0.504,412,392
13,904,50,0,0.0001,0.0001,0.51,464,440
13,1004,50,0,0.0001,0.0001,0.514,511,493
13,1104,50,0,0.0001,0.0001,0.512,564,540
13,1204,50,0,0.0001,0.0001,0.514,611,593
13,1304,50,0,0.0001,0.0001,0.514,661,643
13,1404,50,0,0.0001,0.0001,0.516,715,689
13,1504,50,0,0.0001,0.0001,0.52,759,745
13,1604,50,0,0.0001,0.0001,0.514,815,789
13,1704,50,0,0.0001,0.0001,0.516,871,833
13,1804,50,0,0.0001,0.0001,0.516,912,892
13,1904,50,0,0.0001,0.0001,0.518,952,952
14,0,50,0,0.0001,0.0001,0.52,0,0
14,104,50,0,0.0001,0.0001,0.522,51,53
14,204,50,0,0.0001,0.0001,0.53,98,106
14,304,50,0,0.0001,0.0001,0.526,150,154
14,404,50,0,0.0001,0.0001,0.528,189,215
14,504,50,0,0.0001,0.0001,0.524,230,274
14,604,50,0,0.0001,0.0001,0.522,275,329
14,704,50,0,0.0001,0.0001,0.512,333,371
14,804,50,0,0.0001,0.0001,0.504,378,426
14,904,50,0,0.0001,0.0001,0.524,431,473
14,1004,50,0,0.0001,0.0001,0.528,480,524
14,1104,50,0,0.0001,0.0001,0.53,530,574
14,1204,50,0,0.0001,0.0001,0.522,582,622
14,1304,50,0,0.0001,0.0001,0.524,642,662
14,1404,50,0,0.0001,0.0001,0.524,694,710
14,1504,50,0,0.0001,0.0001,0.518,748,756
14,1604,50,0,0.0001,0.0001,0.522,802,802
14,1704,50,0,0.0001,0.0001,0.528,850,854
14,1804,50,0,0.0001,0.0001,0.526,897,907
14,1904,50,0,0.0001,0.0001,0.526,952,952
15,0,50,0,0.0001,0.0001,0.496,0,0
15,104,50,0,0.0001,0.0001,0.496,52,52
15,204,50,0,0.0001,0.0001,0.496,105,99
15,304,50,0,0.0001,0.0001,0.502,157,147
15,404,50,0,0.0001,0.0001,0.502,205,199
15,504,50,0,0.0001,0.0001,0.506,253,251
15,604,50,0,0.0001,0.0001,0.506,301,303
15,704,50,0,0.0001,0.0001,0.502,345,359
15,804,50,0,0.0001,0.0001,0.512,392,412
15,904,50,0,0.0001,0.0001,0.512,449,455
15,1004,50,0,0.0001,0.0001,0.496,498,506
15,1104,50,0,0.0001,0.0001,0.494,545,559
15,1204,50,0,0.0001,0.0001,0.496,588,616
15,1304,50,0,0.0001,0.0001,0.508,645,659
15,1404,50,0,0.0001,0.0001,0.51,694,710
15,1504,50,0,0.0001,0.0001,0.502,749,755
15,1604,50,0,0.0001,0.0001,0.494,802,802
15,1704,50,0,0.0001,0.0001,0.5,849,855
15,1804,50,0,0.0001,0.0001,0.488,898,906
15,1904,50,0,0.0001,0.0001,0.48,952,952
16,0,50,0,0.0001,0.0001,0.504,0,0
16,104,50,0,0.0001,0.0001,0.504,59,45
16,204,50,0,0.0001,0.0001,0.504,106,98
16,304,50,0,0.0001,0.0001,0.504,155,149
16,404,50,0,0.0001,0.0001,0.504,207,197
16,504,50,0,0.0001,0.0001,0.502,257,247
16,604,50,0,0.0001,0.0001,0.5,315,289
16,704,50,0,0.0001,0.0001,0.502,368,336
16,804,50,0,0.0001,0.0001,0.502,414,390
16,904,50,0,0.0001,0.0001,0.502,471,433
16,1004,50,0,0.0001,0.0001,0.5,520,484
16,1104,50,0,0.0001,0.0001,0.5,570,534
16,1204,50,0,0.0001,0.0001,0.502,617,587
16,1304,50,0,0.0001,0.0001,0.5,664,640
16,1404,50,0,0.0001,0.0001,0.504,709,695
16,1504,50,0,0.0001,0.0001,0.496,757,747
16,1604,50,0,0.0001,0.0001,0.488,799,805
16,1704,50,0,0.0001,0.0001,0.492,846,858
16,1804,50,0,0.0001,0.0001,0.496,893,911
16,1904,50,0,0.0001,0.0001,0.51,952,952
17,0,50,0,0.0001,0.0001,0.476,0,0
17,104,50,0,0.0001,0.0001,0.468,67,37
17,204,50,0,0.0001,0.0001,0.474,111,93
17,304,50,0,0.0001,0.0001,0.486,163,141
17,404,50,0,0.0001,0.0001,0.484,200,204
17,504,50,0,0.0001,0.0001,0.484,253,251
17,604,50,0,0.0001,0.0001,0.486,302,302
17,704,50,0,0.0001,0.0001,0.49,349,355
17,804,50,0,0.0001,0.0001,0.492,399,405
17,904,50,0,0.0001,0.0001,0.486,442,462
17,1004,50,0,0.0001,0.0001,0.48,481,523
17,1104,50,0,0.0001,0.0001,0.492,540,564
17,1204,50,0,0.0001,0.0001,0.49,595,609
17,1304,50,0,0.0001,0.0001,0.496,642,662
17,1404,50,0,0.0001,0.0001,0.496,696,708
17,1504,50,0,0.0001,0.0001,0.5,739,765
17,1604,50,0,0.0001,0.0001,0.49,792,812
17,1704,50,0,0.0001,0.0001,0.494,846,858
17,1804,50,0,0.0001,0.0001,0.498,895,909
17,1904,50,0,0.0001,0.0001,0.49,952,952
18,0,50,0,0.0001,0.0001,0.51,0,0
18,104,50,0,0.0001,0.0001,0.51,53,51
18,204,50,0,0.0001,0.0001,0.51,108,96
18,304,50,0,0.0001,0.0001,0.5,160,144
18,404,50,0,0.0001,0.0001,0.494,214,190
18,504,50,0,0.0001,0.0001,0.49,277,227
18,604,50,0,0.0001,0.0001,0.486,326,278
18,704,50,0,0.0001,0.0001,0.5,372,332
18,804,50,0,0.0001,0.0001,0.514,414,390
18,904,50,0,0.0001,0.0001,0.512,461,443
18,1004,50,0,0.0001,0.0001,0.518,511,493
18,1104,50,0,0.0001,0.0001,0.514,558,546
18,1204,50,0,0.0001,0.0001,0.514,609,595
18,1304,50,0,0.0001,0.0001,0.52,665,639
18,1404,50,0,0.0001,0.0001,0.516,709,695
18,1504,50,0,0.0001,0.0001,0.514,751,753
18,1604,50,0,0.0001,0.0001,0.524,801,803
18,1704,50,0,0.0001,0.0001,0.524,849,855
18,1804,50,0,0.0001,0.0001,0.516,896,908
18,1904,50,0,0.0001,0.0001,0.51,952,952
19,0,50,0,0.0001,0.0001,0.51,0,0
19,104,50,0,0.0001,0.0001,0.512,43,61
19,204,50,0,0.0001,0.0001,0.512,96,108
19,304,50,0,0.0001,0.0001,0.518,143,161
19,404,50,0,0.0001,0.0001,0.516,194,210
19,504,50,0,0.0001,0.0001,0.524,239,265
19,604,50,0,0.0001,0.0001,0.534,295,309
19,704,50,0,0.0001,0.0001,0.534,345,359
19,804,50,0,0.0001,0.0001,0.53,386,418
19,904,50,0,0.0001,0.0001,0.524,437,467
19,1004,50,0,0.0001,0.0001,0.516,489,515
19,1104,50,0,0.0001,0.0001,0.518,546,558
19,1204,50,0,0.0001,0.0001,0.512,596,608
19,1304,50,0,0.0001,0.0001,0.512,648,656
19,1404,50,0,0.0001,0.0001,0.51,709,695
19,1504,50,0,0.0001,0.0001,0.51,756,748
19,1604,50,0,0.0001,0.0001,0.518,797,807
19,1704,50,0,0.0001,0.0001,0.518,845,859
19,1804,50,0,0.0001,0.0001,0.516,898,906
19,1904,50,0,0.0001,0.0001,0.518,952,952
20,0,50,0,0.0001,0.0001,0.506,0,0
20,104,50,0,0.0001,0.0001,0.506,48,56
20,204,50,0,0.0001,0.0001,0.508,100,104
20,304,50,0,0.0001,0.0001,0.508,150,154
20,404,50,0,0.0001,0.0001,0.502,199,205
20,504,50,0,0.0001,0.0001,0.51,243,261
20,604,50,0,0.0001,0.0001,0.516,295,309
20,704,50,0,0.0001,0.0001,0.52,342,362
20,804,50,0,0.0001,0.0001,0.504,394,410
20,904,50,0,0.0001,0.0001,0.51,439,465
20,1004,50,0,0.0001,0.0001,0.522,487,517
20,1104,50,0,0.0001,0.0001,0.512,542,562
20,1204,50,0,0.0001,0.0001,0.508,590,614
20,1304,50,0,0.0001,0.0001,0.508,643,661
20,1404,50,0,0.0001,0.0001,0.506,699,705
20,1504,50,0,0.0001,0.0001,0.512,747,757
20,1604,50,0,0.0001,0.0001,0.518,794,810
20,1704,50,0,0.0001,0.0001,0.518,836,868
20,1804,50,0,0.0001,0.0001,0.51,893,911
20,1904,50,0,0.0001,0.0001,0.508,952,952
1,0,50,0,0.0001,0.001,0.502,0,0
1,104,50,0,0.0001,0.001,0.52,59,45
1,204,50,0,0.0001,0.001,0.644,106,98
1,304,50,0,0.0001,0.001,0.544,155,149
1,404,50,0,0.0001,0.001,0.618,210,194
1,504,50,0,0.0001,0.001,0.654,261,243
1,604,50,0,0.0001,0.001,0.678,317,287
1,704,50,0,0.0001,0.001,0.662,369,335
1,804,50,0,0.0001,0.001,0.742,416,388
1,904,50,0,0.0001,0.001,0.794,468,436
1,1004,50,0,0.0001,0.001,0.824,510,494
1,1104,50,0,0.0001,0.001,0.862,559,545
1,1204,50,0,0.0001,0.001,0.896,595,609
1,1304,50,0,0.0001,0.001,0.932,651,653
1,1404,50,0,0.0001,0.001,0.956,706,698
1,1504,50,0,0.0001,0.001,0.968,753,751
1,1604,50,0,0.0001,0.001,0.982,804,800
1,1704,50,0,0.0001,0.001,0.99,859,845
1,1804,50,0,0.0001,0.001,0.992,904,900
1,1904,50,0,0.0001,0.001,0.994,952,952
2,0,50,0,0.0001,0.001,0.506,0,0
2,104,50,0,0.0001,0.001,0.514,51,53
2,204,50,0,0.0001,0.001,0.616,108,96
2,304,50,0,0.0001,0.001,0.544,160,144
2,404,50,0,0.0001,0.001,0.58,200,204
2,504,50,0,0.0001,0.001,0.666,252,252
2,604,50,0,0.0001,0.001,0.686,300,304
2,704,50,0,0.0001,0.001,0.704,351,353
2,804,50,0,0.0001,0.001,0.756,399,405
2,904,50,0,0.0001,0.001,0.784,452,452
2,1004,50,0,0.0001,0.001,0.822,491,513
2,1104,50,0,0.0001,0.001,0.848,541,563
2,1204,50,0,0.0001,0.001,0.882,596,608
2,1304,50,0,0.0001,0.001,0.912,640,664
2,1404,50,0,0.0001,0.001,0.938,689,715
2,1504,50,0,0.0001,0.001,0.95,745,759
2,1604,50,0,0.0001,0.001,0.968,795,809
2,1704,50,0,0.0001,0.001,0.974,850,854
2,1804,50,0,0.0001,0.001,0.978,901,903
2,1904,50,0,0.0001,0.001,0.98,952,952
3,0,50,0,0.0001,0.001,0.508,0,0
3,104,50,0,0.0001,0.001,0.514,46,58
3,204,50,0,0.0001,0.001,0.656,92,112
3,304,50,0,0.0001,0.001,0.56,143,161
3,404,50,0,0.0001,0.001,0.642,200,204
3,504,50,0,0.0001,0.001,0.652,249,255
3,604,50,0,0.0001,0.001,0.72,298,306
3,704,50,0,0.0001,0.001,0.704,349,355
3,804,50,0,0.0001,0.001,0.788,397,407
3,904,50,0,0.0001,0.001,0.812,446,458
3,1004,50,0,0.0001,0.001,0.822,499,505
3,1104,50,0,0.0001,0.001,0.88,545,559
3,1204,50,0,0.0001,0.001,0.894,602,602
3,1304,50,0,0.0001,0.001,0.92,653,651
3,1404,50,0,0.0001,0.001,0.944,705,699
3,1504,50,0,0.0001,0.001,0.958,757,747
3,1604,50,0,0.0001,0.001,0.968,808,796
3,1704,50,0,0.0001,0.001,0.974,851,853
3,1804,50,0,0.0001,0.001,0.98,897,907
3,1904,50,0,0.0001,0.001,0.992,952,952
4,0,50,0,0.0001,0.001,0.508,0,0
4,104,50,0,0.0001,0.001,0.52,55,49
4,204,50,0,0.0001,0.001,0.656,102,102
4,304,50,0,0.0001,0.001,0.584,153,151
4,404,50,0,0.0001,0.001,0.658,202,202
4,504,50,0,0.0001,0.001,0.672,247,257
4,604,50,0,0.0001,0.001,0.714,299,305
4,704,50,0,0.0001,0.001,0.72,354,350
4,804,50,0,0.0001,0.001,0.774,394,410
4,904,50,0,0.0001,0.001,0.798,438,466
4,1004,50,0,0.0001,0.001,0.824,487,517
4,1104,50,0,0.0001,0.001,0.874,539,565
4,1204,50,0,0.0001,0.001,0.904,595,609
4,1304,50,0,0.0001,0.001,0.936,653,651
4,1404,50,0,0.0001,0.001,0.956,698,706
4,1504,50,0,0.0001,0.001,0.968,753,751
4,1604,50,0,0.0001,0.001,0.972,807,797
4,1704,50,0,0.0001,0.001,0.982,853,851
4,1804,50,0,0.0001,0.001,0.982,901,903
4,1904,50,0,0.0001,0.001,0.986,952,952
5,0,50,0,0.0001,0.001,0.514,0,0
5,104,50,0,0.0001,0.001,0.544,50,54
5,204,50,0,0.0001,0.001,0.632,104,100
5,304,50,0,0.0001,0.001,0.526,157,147
5,404,50,0,0.0001,0.001,0.64,197,207
5,504,50,0,0.0001,0.001,0.624,241,263
5,604,50,0,0.0001,0.001,0.692,298,306
5,704,50,0,0.0001,0.001,0.692,350,354
5,804,50,0,0.0001,0.001,0.73,403,401
5,904,50,0,0.0001,0.001,0.792,449,455
5,1004,50,0,0.0001,0.001,0.842,498,506
5,1104,50,0,0.0001,0.001,0.874,553,551
5,1204,50,0,0.0001,0.001,0.896,599,605
5,1304,50,0,0.0001,0.001,0.916,649,655
5,1404,50,0,0.0001,0.001,0.932,695,709
5,1504,50,0,0.0001,0.001,0.946,747,757
5,1604,50,0,0.0001,0.001,0.956,804,800
5,1704,50,0,0.0001,0.001,0.974,855,849
5,1804,50,0,0.0001,0.001,0.984,906,898
5,1904,50,0,0.0001,0.001,0.99,952,952
6,0,50,0,0.0001,0.001,0.516,0,0
6,104,50,0,0.0001,0.001,0.538,53,51
6,204,50,0,0.0001,0.001,0.624,99,105
6,304,50,0,0.0001,0.001,0.532,146,158
6,404,50,0,0.0001,0.001,0.652,191,213
6,504,50,0,0.0001,0.001,0.618,249,255
6,604,50,0,0.0001,0.001,0.702,301,303
6,704,50,0,0.0001,0.001,0.676,353,351
6,804,50,0,0.0001,0.001,0.734,398,406
6,904,50,0,0.0001,0.001,0.772,447,457
6,1004,50,0,0.0001,0.001,0.808,493,511
6,1104,50,0,0.0001,0.001,0.844,543,561
6,1204,50,0,0.0001,0.001,0.876,597,607
6,1304,50,0,0.0001,0.001,0.912,645,659
6,1404,50,0,0.0001,0.001,0.946,694,710
6,1504,50,0,0.0001,0.001,0.96,745,759
6,1604,50,0,0.0001,0.001,0.974,802,802
6,1704,50,0,0.0001,0.001,0.978,848,856
6,1804,50,0,0.0001,0.001,0.99,900,904
6,1904,50,0,0.0001,0.001,0.992,952,952
7,0,50,0,0.0001,0.001,0.502,0,0
7,104,50,0,0.0001,0.001,0.506,55,49
7,204,50,0,0.0001,0.001,0.632,105,99
7,304,50,0,0.0001,0.001,0.544,152,152
7,404,50,0,0.0001,0.001,0.624,201,203
7,504,50,0,0.0001,0.001,0.654,250,254
7,604,50,0,0.0001,0.001,0.714,302,302
7,704,50,0,0.0001,0.001,0.71,348,356
7,804,50,0,0.0001,0.001,0.772,392,412
7,904,50,0,0.0001,0.001,0.818,443,461
7,1004,50,0,0.0001,0.001,0.838,485,519
7,1104,50,0,0.0001,0.001,0.868,529,575
7,1204,50,0,0.0001,0.001,0.902,573,631
7,1304,50,0,0.0001,0.001,0.928,620,684
7,1404,50,0,0.0001,0.001,0.94,681,723
7,1504,50,0,0.0001,0.001,0.956,735,769
7,1604,50,0,0.0001,0.001,0.974,797,807
7,1704,50,0,0.0001,0.001,0.972,846,858
7,1804,50,0,0.0001,0.001,0.974,895,909
7,1904,50,0,0.0001,0.001,0.984,952,952
8,0,50,0,0.0001,0.001,0.514,0,0
8,104,50,0,0.0001,0.001,0.548,55,49
8,204,50,0,0.0001,0.001,0.684,98,106
8,304,50,0,0.0001,0.001,0.562,149,155
8,404,50,0,0.0001,0.001,0.7,197,207
8,504,50,0,0.0001,0.001,0.672,250,254
8,604,50,0,0.0001,0.001,0.728,294,310
8,704,50,0,0.0001,0.001,0.762,347,357
8,804,50,0,0.0001,0.001,0.782,398,406
8,904,50,0,0.0001,0.001,0.82,440,464
8,1004,50,0,0.0001,0.001,0.868,491,513
8,1104,50,0,0.0001,0.001,0.912,536,568
8,1204,50,0,0.0001,0.001,0.94,588,616
8,1304,50,0,0.0001,0.001,0.962,638,666
8,1404,50,0,0.0001,0.001,0.98,687,717
8,1504,50,0,0.0001,0.001,0.984,741,763
8,1604,50,0,0.0001,0.001,0.988,802,802
8,1704,50,0,0.0001,0.001,0.994,850,854
8,1804,50,0,0.0001,0.001,0.996,899,905
8,1904,50,0,0.0001,0.001,0.998,952,952
9,0,50,0,0.0001,0.001,0.502,0,0
9,104,50,0,0.0001,0.001,0.512,59,45
9,204,50,0,0.0001,0.001,0.614,114,90
9,304,50,0,0.0001,0.001,0.546,163,141
9,404,50,0,0.0001,0.001,0.646,217,187
9,504,50,0,0.0001,0.001,0.664,258,246
9,604,50,0,0.0001,0.001,0.7,318,286
9,704,50,0,0.0001,0.001,0.714,365,339
9,804,50,0,0.0001,0.001,0.756,409,395
9,904,50,0,0.0001,0.001,0.804,460,444
9,1004,50,0,0.0001,0.001,0.824,511,493
9,1104,50,0,0.0001,0.001,0.846,565,539
9,1204,50,0,0.0001,0.001,0.888,621,583
9,1304,50,0,0.0001,0.001,0.912,667,637
9,1404,50,0,0.0001,0.001,0.932,716,688
9,1504,50,0,0.0001,0.001,0.944,760,744
9,1604,50,0,0.0001,0.001,0.956,801,803
9,1704,50,0,0.0001,0.001,0.974,855,849
9,1804,50,0,0.0001,0.001,0.976,907,897
9,1904,50,0,0.0001,0.001,0.98,952,952
10,0,50,0,0.0001,0.001,0.504,0,0
10,104,50,0,0.0001,0.001,0.506,48,56
10,204,50,0,0.0001,0.001,0.532,100,104
10,304,50,0,0.0001,0.001,0.518,154,150
10,404,50,0,0.0001,0.001,0.546,201,203
10,504,50,0,0.0001,0.001,0.564,251,253
10,604,50,0,0.0001,0.001,0.576,299,305
10,704,50,0,0.0001,0.001,0.596,351,353
10,804,50,0,0.0001,0.001,0.636,393,411
10,904,50,0,0.0001,0.001,0.662,441,463
10,1004,50,0,0.0001,0.001,0.684,490,514
10,1104,50,0,0.0001,0.001,0.712,546,558
10,1204,50,0,0.0001,0.001,0.736,595,609
10,1304,50,0,0.0001,0.001,0.776,648,656
10,1404,50,0,0.0001,0.001,0.816,699,705
10,1504,50,0,0.0001,0.001,0.842,747,757
10,1604,50,0,0.0001,0.001,0.892,796,808
10,1704,50,0,0.0001,0.001,0.916,853,851
10,1804,50,0,0.0001,0.001,0.942,897,907
10,1904,50,0,0.0001,0.001,0.952,952,952
11,0,50,0,0.0001,0.001,0.522,0,0
11,104,50,0,0.0001,0.001,0.534,45,59
11,204,50,0,0.0001,0.001,0.608,100,104
11,304,50,0,0.0001,0.001,0.574,149,155
11,404,50,0,0.0001,0.001,0.62,203,201
11,504,50,0,0.0001,0.001,0.644,250,254
11,604,50,0,0.0001,0.001,0.67,299,305
11,704,50,0,0.0001,0.001,0.71,341,363
11,804,50,0,0.0001,0.001,0.764,396,408
11,904,50,0,0.0001,0.001,0.792,445,459
11,1004,50,0,0.0001,0.001,0.808,493,511
11,1104,50,0,0.0001,0.001,0.84,544,560
11,1204,50,0,0.0001,0.001,0.874,598,606
11,1304,50,0,0.0001,0.001,0.902,648,656
11,1404,50,0,0.0001,0.001,0.94,706,698
11,1504,50,0,0.0001,0.001,0.956,750,754
11,1604,50,0,0.0001,0.001,0.968,806,798
11,1704,50,0,0.0001,0.001,0.978,852,852
11,1804,50,0,0.0001,0.001,0.98,905,899
11,1904,50,0,0.0001,0.001,0.98,952,952
12,0,50,0,0.0001,0.001,0.51,0,0
12,104,50,0,0.0001,0.001,0.53,53,51
12,204,50,0,0.0001,0.001,0.672,104,100
12,304,50,0,0.0001,0.001,0.574,155,149
12,404,50,0,0.0001,0.001,0.682,212,192
12,504,50,0,0.0001,0.001,0.71,255,249
12,604,50,0,0.0001,0.001,0.72,307,297
12,704,50,0,0.0001,0.001,0.762,349,355
12,804,50,0,0.0001,0.001,0.78,393,411
12,904,50,0,0.0001,0.001,0.824,444,460
12,1004,50,0,0.0001,0.001,0.85,499,505
12,1104,50,0,0.0001,0.001,0.894,547,557
12,1204,50,0,0.0001,0.001,0.914,597,607
12,1304,50,0,0.0001,0.001,0.94,661,643
12,1404,50,0,0.0001,0.001,0.95,713,691
12,1504,50,0,0.0001,0.001,0.97,763,741
12,1604,50,0,0.0001,0.001,0.978,812,792
12,1704,50,0,0.0001,0.001,0.982,864,840
12,1804,50,0,0.0001,0.001,0.99,908,896
12,1904,50,0,0.0001,0.001,0.992,952,952
13,0,50,0,0.0001,0.001,0.508,0,0
13,104,50,0,0.0001,0.001,0.51,51,53
13,204,50,0,0.0001,0.001,0.64,101,103
13,304,50,0,0.0001,0.001,0.558,155,149
13,404,50,0,0.0001,0.001,0.632,206,198
13,504,50,0,0.0001,0.001,0.674,260,244
13,604,50,0,0.0001,0.001,0.71,314,290
13,704,50,0,0.0001,0.001,0.702,368,336
13,804,50,0,0.0001,0.001,0.752,418,386
13,904,50,0,0.0001,0.001,0.78,466,438
13,1004,50,0,0.0001,0.001,0.83,513,491
13,1104,50,0,0.0001,0.001,0.854,568,536
13,1204,50,0,0.0001,0.001,0.89,609,595
13,1304,50,0,0.0001,0.001,0.934,662,642
13,1404,50,0,0.0001,0.001,0.948,712,692
13,1504,50,0,0.0001,0.001,0.964,763,741
13,1604,50,0,0.0001,0.001,0.97,811,793
13,1704,50,0,0.0001,0.001,0.972,860,844
13,1804,50,0,0.0001,0.001,0.982,907,897
13,1904,50,0,0.0001,0.001,0.984,952,952
14,0,50,0,0.0001,0.001,0.506,0,0
14,104,50,0,0.0001,0.001,0.522,50,54
14,204,50,0,0.0001,0.001,0.598,92,112
14,304,50,0,0.0001,0.001,0.554,140,164
14,404,50,0,0.0001,0.001,0.618,194,210
14,504,50,0,0.0001,0.001,0.61,238,266
14,604,50,0,0.0001,0.001,0.636,287,317
14,704,50,0,0.0001,0.001,0.66,334,370
14,804,50,0,0.0001,0.001,0.688,381,423
14,904,50,0,0.0001,0.001,0.718,430,474
14,1004,50,0,0.0001,0.001,0.772,482,522
14,1104,50,0,0.0001,0.001,0.802,538,566
14,1204,50,0,0.0001,0.001,0.84,591,613
14,1304,50,0,0.0001,0.001,0.884,646,658
14,1404,50,0,0.0001,0.001,0.916,697,707
14,1504,50,0,0.0001,0.001,0.948,741,763
14,1604,50,0,0.0001,0.001,0.96,792,812
14,1704,50,0,0.0001,0.001,0.972,848,856
14,1804,50,0,0.0001,0.001,0.98,901,903
14,1904,50,0,0.0001,0.001,0.98,952,952
15,0,50,0,0.0001,0.001,0.504,0,0
15,104,50,0,0.0001,0.001,0.514,54,50
15,204,50,0,0.0001,0.001,0.614,103,101
15,304,50,0,0.0001,0.001,0.588,155,149
15,404,50,0,0.0001,0.001,0.62,205,199
15,504,50,0,0.0001,0.001,0.66,253,251
15,604,50,0,0.0001,0.001,0.672,300,304
15,704,50,0,0.0001,0.001,0.708,344,360
15,804,50,0,0.0001,0.001,0.732,399,405
15,904,50,0,0.0001,0.001,0.774,441,463
15,1004,50,0,0.0001,0.001,0.806,488,516
15,1104,50,0,0.0001,0.001,0.844,541,563
15,1204,50,0,0.0001,0.001,0.878,589,615
15,1304,50,0,0.0001,0.001,0.904,639,665
15,1404,50,0,0.0001,0.001,0.928,692,712
15,1504,50,0,0.0001,0.001,0.94,749,755
15,1604,50,0,0.0001,0.001,0.954,801,803
15,1704,50,0,0.0001,0.001,0.966,855,849
15,1804,50,0,0.0001,0.001,0.976,906,898
15,1904,50,0,0.0001,0.001,0.984,952,952
16,0,50,0,0.0001,0.001,0.506,0,0
16,104,50,0,0.0001,0.001,0.514,48,56
16,204,50,0,0.0001,0.001,0.616,93,111
16,304,50,0,0.0001,0.001,0.586,140,164
16,404,50,0,0.0001,0.001,0.644,196,208
16,504,50,0,0.0001,0.001,0.598,247,257
16,604,50,0,0.0001,0.001,0.662,297,307
16,704,50,0,0.0001,0.001,0.674,352,352
16,804,50,0,0.0001,0.001,0.718,402,402
16,904,50,0,0.0001,0.001,0.768,447,457
16,1004,50,0,0.0001,0.001,0.786,502,502
16,1104,50,0,0.0001,0.001,0.808,552,552
16,1204,50,0,0.0001,0.001,0.848,597,607
16,1304,50,0,0.0001,0.001,0.868,646,658
16,1404,50,0,0.0001,0.001,0.902,697,707
16,1504,50,0,0.0001,0.001,0.934,749,755
16,1604,50,0,0.0001,0.001,0.964,796,808
16,1704,50,0,0.0001,0.001,0.976,849,855
16,1804,50,0,0.0001,0.001,0.982,901,903
16,1904,50,0,0.0001,0.001,0.988,952,952
17,0,50,0,0.0001,0.001,0.514,0,0
17,104,50,0,0.0001,0.001,0.526,42,62
17,204,50,0,0.0001,0.001,0.632,94,110
17,304,50,0,0.0001,0.001,0.554,150,154
17,404,50,0,0.0001,0.001,0.632,208,196
17,504,50,0,0.0001,0.001,0.686,258,246
17,604,50,0,0.0001,0.001,0.704,305,299
17,704,50,0,0.0001,0.001,0.726,359,345
17,804,50,0,0.0001,0.001,0.766,415,389
17,904,50,0,0.0001,0.001,0.804,474,430
17,1004,50,0,0.0001,0.001,0.834,524,480
17,1104,50,0,0.0001,0.001,0.858,571,533
17,1204,50,0,0.0001,0.001,0.884,614,590
17,1304,50,0,0.0001,0.001,0.906,665,639
17,1404,50,0,0.0001,0.001,0.928,708,696
17,1504,50,0,0.0001,0.001,0.95,757,747
17,1604,50,0,0.0001,0.001,0.962,813,791
17,1704,50,0,0.0001,0.001,0.966,858,846
17,1804,50,0,0.0001,0.001,0.972,901,903
17,1904,50,0,0.0001,0.001,0.974,952,952
18,0,50,0,0.0001,0.001,0.52,0,0
18,104,50,0,0.0001,0.001,0.546,51,53
18,204,50,0,0.0001,0.001,0.68,107,97
18,304,50,0,0.0001,0.001,0.556,160,144
18,404,50,0,0.0001,0.001,0.618,213,191
18,504,50,0,0.0001,0.001,0.684,263,241
18,604,50,0,0.0001,0.001,0.71,308,296
18,704,50,0,0.0001,0.001,0.746,355,349
18,804,50,0,0.0001,0.001,0.8,407,397
18,904,50,0,0.0001,0.001,0.846,453,451
18,1004,50,0,0.0001,0.001,0.864,501,503
18,1104,50,0,0.0001,0.001,0.91,553,551
18,1204,50,0,0.0001,0.001,0.914,607,597
18,1304,50,0,0.0001,0.001,0.936,656,648
18,1404,50,0,0.0001,0.001,0.95,706,698
18,1504,50,0,0.0001,0.001,0.958,757,747
18,1604,50,0,0.0001,0.001,0.966,802,802
18,1704,50,0,0.0001,0.001,0.978,846,858
18,1804,50,0,0.0001,0.001,0.98,898,906
18,1904,50,0,0.0001,0.001,0.984,952,952
19,0,50,0,0.0001,0.001,0.514,0,0
19,104,50,0,0.0001,0.001,0.528,49,55
19,204,50,0,0.0001,0.001,0.664,102,102
19,304,50,0,0.0001,0.001,0.552,157,147
19,404,50,0,0.0001,0.001,0.626,207,197
19,504,50,0,0.0001,0.001,0.688,258,246
19,604,50,0,0.0001,0.001,0.716,309,295
19,704,50,0,0.0001,0.001,0.716,356,348
19,804,50,0,0.0001,0.001,0.774,404,400
19,904,50,0,0.0001,0.001,0.812,445,459
19,1004,50,0,0.0001,0.001,0.828,494,510
19,1104,50,0,0.0001,0.001,0.862,545,559
19,1204,50,0,0.0001,0.001,0.906,590,614
19,1304,50,0,0.0001,0.001,0.942,640,664
19,1404,50,0,0.0001,0.001,0.948,688,716
19,1504,50,0,0.0001,0.001,0.96,738,766
19,1604,50,0,0.0001,0.001,0.97,793,811
19,1704,50,0,0.0001,0.001,0.974,842,862
19,1804,50,0,0.0001,0.001,0.98,901,903
19,1904,50,0,0.0001,0.001,0.986,952,952
20,0,50,0,0.0001,0.001,0.504,0,0
20,104,50,0,0.0001,0.001,0.514,54,50
20,204,50,0,0.0001,0.001,0.624,98,106
20,304,50,0,0.0001,0.001,0.56,146,158
20,404,50,0,0.0001,0.001,0.674,192,212
20,504,50,0,0.0001,0.001,0.616,236,268
20,604,50,0,0.0001,0.001,0.692,283,321
20,704,50,0,0.0001,0.001,0.73,333,371
20,804,50,0,0.0001,0.001,0.784,378,426
20,904,50,0,0.0001,0.001,0.816,431,473
20,1004,50,0,0.0001,0.001,0.852,478,526
20,1104,50,0,0.0001,0.001,0.878,536,568
20,1204,50,0,0.0001,0.001,0.908,581,623
20,1304,50,0,0.0001,0.001,0.918,631,673
20,1404,50,0,0.0001,0.001,0.934,686,718
20,1504,50,0,0.0001,0.001,0.946,736,768
20,1604,50,0,0.0001,0.001,0.962,789,815
20,1704,50,0,0.0001,0.001,0.972,841,863
20,1804,50,0,0.0001,0.001,0.976,899,905
20,1904,50,0,0.0001,0.001,0.982,952,952
1,0,50,0,0.0001,0.01,0.516,0,0
1,104,50,0,0.0001,0.01,0.5,54,50
1,204,50,0,0.0001,0.01,0.638,97,107
1,304,50,0,0.0001,0.01,0.572,153,151
1,404,50,0,0.0001,0.01,0.614,201,203
1,504,50,0,0.0001,0.01,0.628,254,250
1,604,50,0,0.0001,0.01,0.654,306,298
1,704,50,0,0.0001,0.01,0.644,347,357
1,804,50,0,0.0001,0.01,0.676,399,405
1,904,50,0,0.0001,0.01,0.68,452,452
1,1004,50,0,0.0001,0.01,0.738,502,502
1,1104,50,0,0.0001,0.01,0.742,555,549
1,1204,50,0,0.0001,0.01,0.766,614,590
1,1304,50,0,0.0001,0.01,0.8,675,629
1,1404,50,0,0.0001,0.01,0.784,715,689
1,1504,50,0,0.0001,0.01,0.816,769,735
1,1604,50,0,0.0001,0.01,0.846,819,785
1,1704,50,0,0.0001,0.01,0.884,859,845
1,1804,50,0,0.0001,0.01,0.884,907,897
1,1904,50,0,0.0001,0.01,0.888,952,952
2,0,50,0,0.0001,0.01,0.506,0,0
2,104,50,0,0.0001,0.01,0.54,52,52
2,204,50,0,0.0001,0.01,0.664,109,95
2,304,50,0,0.0001,0.01,0.596,159,145
2,404,50,0,0.0001,0.01,0.63,211,193
2,504,50,0,0.0001,0.01,0.59,253,251
2,604,50,0,0.0001,0.01,0.612,297,307
2,704,50,0,0.0001,0.01,0.628,349,355
2,804,50,0,0.0001,0.01,0.634,407,397
2,904,50,0,0.0001,0.01,0.632,458,446
2,1004,50,0,0.0001,0.01,0.67,506,498
2,1104,50,0,0.0001,0.01,0.71,550,554
2,1204,50,0,0.0001,0.01,0.744,592,612
2,1304,50,0,0.0001,0.01,0.758,645,659
2,1404,50,0,0.0001,0.01,0.77,696,708
2,1504,50,0,0.0001,0.01,0.81,753,751
2,1604,50,0,0.0001,0.01,0.848,805,799
2,1704,50,0,0.0001,0.01,0.868,854,850
2,1804,50,0,0.0001,0.01,0.884,904,900
2,1904,50,0,0.0001,0.01,0.892,952,952
3,0,50,0,0.0001,0.01,0.508,0,0
3,104,50,0,0.0001,0.01,0.5,64,40
3,204,50,0,0.0001,0.01,0.52,119,85
3,304,50,0,0.0001,0.01,0.526,163,141
3,404,50,0,0.0001,0.01,0.662,221,183
3,504,50,0,0.0001,0.01,0.624,265,239
3,604,50,0,0.0001,0.01,0.642,322,282
3,704,50,0,0.0001,0.01,0.662,365,339
3,804,50,0,0.0001,0.01,0.66,411,393
3,904,50,0,0.0001,0.01,0.7,456,448
3,1004,50,0,0.0001,0.01,0.724,503,501
3,1104,50,0,0.0001,0.01,0.744,555,549
3,1204,50,0,0.0001,0.01,0.782,600,604
3,1304,50,0,0.0001,0.01,0.806,647,657
3,1404,50,0,0.0001,0.01,0.828,698,706
3,1504,50,0,0.0001,0.01,0.864,747,757
3,1604,50,0,0.0001,0.01,0.882,799,805
3,1704,50,0,0.0001,0.01,0.914,848,856
3,1804,50,0,0.0001,0.01,0.922,900,904
3,1904,50,0,0.0001,0.01,0.924,952,952
4,0,50,0,0.0001,0.01,0.5,0,0
4,104,50,0,0.0001,0.01,0.5,56,48
4,204,50,0,0.0001,0.01,0.604,106,98
4,304,50,0,0.0001,0.01,0.54,154,150
4,404,50,0,0.0001,0.01,0.636,201,203
4,504,50,0,0.0001,0.01,0.616,238,266
4,604,50,0,0.0001,0.01,0.632,285,319
4,704,50,0,0.0001,0.01,0.654,324,380
4,804,50,0,0.0001,0.01,0.706,377,427
4,904,50,0,0.0001,0.01,0.74,427,477
4,1004,50,0,0.0001,0.01,0.776,476,528
4,1104,50,0,0.0001,0.01,0.818,539,565
4,1204,50,0,0.0001,0.01,0.854,587,617
4,1304,50,0,0.0001,0.01,0.888,640,664
4,1404,50,0,0.0001,0.01,0.9,693,711
4,1504,50,0,0.0001,0.01,0.914,745,759
4,1604,50,0,0.0001,0.01,0.942,805,799
4,1704,50,0,0.0001,0.01,0.94,852,852
4,1804,50,0,0.0001,0.01,0.95,898,906
4,1904,50,0,0.0001,0.01,0.962,952,952
5,0,50,0,0.0001,0.01,0.506,0,0
5,104,50,0,0.0001,0.01,0.5,53,51
5,204,50,0,0.0001,0.01,0.646,98,106
5,304,50,0,0.0001,0.01,0.536,144,160
5,404,50,0,0.0001,0.01,0.564,193,211
5,504,50,0,0.0001,0.01,0.574,251,253
5,604,50,0,0.0001,0.01,0.57,298,306
5,704,50,0,0.0001,0.01,0.602,348,356
5,804,50,0,0.0001,0.01,0.606,401,403
5,904,50,0,0.0001,0.01,0.648,459,445
5,1004,50,0,0.0001,0.01,0.684,512,492
5,1104,50,0,0.0001,0.01,0.708,562,542
5,1204,50,0,0.0001,0.01,0.748,608,596
5,1304,50,0,0.0001,0.01,0.788,660,644
5,1404,50,0,0.0001,0.01,0.836,705,699
5,1504,50,0,0.0001,0.01,0.874,759,745
5,1604,50,0,0.0001,0.01,0.902,805,799
5,1704,50,0,0.0001,0.01,0.914,855,849
5,1804,50,0,0.0001,0.01,0.932,904,900
5,1904,50,0,0.0001,0.01,0.928,952,952
6,0,50,0,0.0001,0.01,0.508,0,0
6,104,50,0,0.0001,0.01,0.502,57,47
6,204,50,0,0.0001,0.01,0.6,110,94
6,304,50,0,0.0001,0.01,0.536,160,144
6,404,50,0,0.0001,0.01,0.594,204,200
6,504,50,0,0.0001,0.01,0.636,254,250
6,604,50,0,0.0001,0.01,0.63,299,305
6,704,50,0,0.0001,0.01,0.644,351,353
6,804,50,0,0.0001,0.01,0.678,404,400
6,904,50,0,0.0001,0.01,0.712,451,453
6,1004,50,0,0.0001,0.01,0.696,505,499
6,1104,50,0,0.0001,0.01,0.75,558,546
6,1204,50,0,0.0001,0.01,0.78,608,596
6,1304,50,0,0.0001,0.01,0.81,660,644
6,1404,50,0,0.0001,0.01,0.822,706,698
6,1504,50,0,0.0001,0.01,0.854,759,745
6,1604,50,0,0.0001,0.01,0.866,801,803
6,1704,50,0,0.0001,0.01,0.87,853,851
6,1804,50,0,0.0001,0.01,0.878,907,897
6,1904,50,0,0.0001,0.01,0.892,952,952
7,0,50,0,0.0001,0.01,0.506,0,0
7,104,50,0,0.0001,0.01,0.504,58,46
7,204,50,0,0.0001,0.01,0.68,110,94
7,304,50,0,0.0001,0.01,0.544,154,150
7,404,50,0,0.0001,0.01,0.644,208,196
7,504,50,0,0.0001,0.01,0.664,244,260
7,604,50,0,0.0001,0.01,0.642,305,299
7,704,50,0,0.0001,0.01,0.668,351,353
7,804,50,0,0.0001,0.01,0.674,391,413
7,904,50,0,0.0001,0.01,0.698,435,469
7,1004,50,0,0.0001,0.01,0.736,498,506
7,1104,50,0,0.0001,0.01,0.764,546,558
7,1204,50,0,0.0001,0.01,0.8,587,617
7,1304,50,0,0.0001,0.01,0.814,635,669
7,1404,50,0,0.0001,0.01,0.848,690,714
7,1504,50,0,0.0001,0.01,0.872,745,759
7,1604,50,0,0.0001,0.01,0.876,793,811
7,1704,50,0,0.0001,0.01,0.9,849,855
7,1804,50,0,0.0001,0.01,0.91,903,901
7,1904,50,0,0.0001,0.01,0.91,952,952
8,0,50,0,0.0001,0.01,0.502,0,0
8,104,50,0,0.0001,0.01,0.498,52,52
8,204,50,0,0.0001,0.01,0.636,102,102
8,304,50,0,0.0001,0.01,0.55,142,162
8,404,50,0,0.0001,0.01,0.618,196,208
8,504,50,0,0.0001,0.01,0.624,248,256
8,604,50,0,0.0001,0.01,0.622,306,298
8,704,50,0,0.0001,0.01,0.61,355,349
8,804,50,0,0.0001,0.01,0.662,409,395
8,904,50,0,0.0001,0.01,0.708,451,453
8,1004,50,0,0.0001,0.01,0.712,504,500
8,1104,50,0,0.0001,0.01,0.726,556,548
8,1204,50,0,0.0001,0.01,0.782,608,596
8,1304,50,0,0.0001,0.01,0.826,661,643
8,1404,50,0,0.0001,0.01,0.846,710,694
8,1504,50,0,0.0001,0.01,0.874,758,746
8,1604,50,0,0.0001,0.01,0.904,815,789
8,1704,50,0,0.0001,0.01,0.922,865,839
8,1804,50,0,0.0001,0.01,0.93,908,896
8,1904,50,0,0.0001,0.01,0.938,952,952
9,0,50,0,0.0001,0.01,0.512,0,0
9,104,50,0,0.0001,0.01,0.5,45,59
9,204,50,0,0.0001,0.01,0.664,96,108
9,304,50,0,0.0001,0.01,0.542,144,160
9,404,50,0,0.0001,0.01,0.598,201,203
9,504,50,0,0.0001,0.01,0.652,243,261
9,604,50,0,0.0001,0.01,0.642,297,307
9,704,50,0,0.0001,0.01,0.658,345,359
9,804,50,0,0.0001,0.01,0.7,400,404
9,904,50,0,0.0001,0.01,0.74,447,457
9,1004,50,0,0.0001,0.01,0.734,497,507
9,1104,50,0,0.0001,0.01,0.772,545,559
9,1204,50,0,0.0001,0.01,0.794,606,598
9,1304,50,0,0.0001,0.01,0.846,649,655
9,1404,50,0,0.0001,0.01,0.872,700,704
9,1504,50,0,0.0001,0.01,0.894,757,747
9,1604,50,0,0.0001,0.01,0.912,800,804
9,1704,50,0,0.0001,0.01,0.912,847,857
9,1804,50,0,0.0001,0.01,0.94,899,905
9,1904,50,0,0.0001,0.01,0.952,952,952
10,0,50,0,0.0001,0.01,0.506,0,0
10,104,50,0,0.0001,0.01,0.5,55,49
10,204,50,0,0.0001,0.01,0.59,102,102
10,304,50,0,0.0001,0.01,0.534,148,156
10,404,50,0,0.0001,0.01,0.584,200,204
10,504,50,0,0.0001,0.01,0.594,244,260
10,604,50,0,0.0001,0.01,0.618,293,311
10,704,50,0,0.0001,0.01,0.642,344,360
10,804,50,0,0.0001,0.01,0.642,391,413
10,904,50,0,0.0001,0.01,0.656,442,462
10,1004,50,0,0.0001,0.01,0.662,492,512
10,1104,50,0,0.0001,0.01,0.704,547,557
10,1204,50,0,0.0001,0.01,0.718,594,610
10,1304,50,0,0.0001,0.01,0.754,641,663
10,1404,50,0,0.0001,0.01,0.794,691,713
10,1504,50,0,0.0001,0.01,0.814,746,758
10,1604,50,0,0.0001,0.01,0.83,795,809
10,1704,50,0,0.0001,0.01,0.862,848,856
10,1804,50,0,0.0001,0.01,0.882,898,906
10,1904,50,0,0.0001,0.01,0.896,952,952
11,0,50,0,0.0001,0.01,0.506,0,0
11,104,50,0,0.0001,0.01,0.504,54,50
11,204,50,0,0.0001,0.01,0.694,104,100
11,304,50,0,0.0001,0.01,0.566,149,155
11,404,50,0,0.0001,0.01,0.662,196,208
11,504,50,0,0.0001,0.01,0.702,251,253
11,604,50,0,0.0001,0.01,0.724,302,302
11,704,50,0,0.0001,0.01,0.726,348,356
11,804,50,0,0.0001,0.01,0.752,400,404
11,904,50,0,0.0001,0.01,0.8,455,449
11,1004,50,0,0.0001,0.01,0.822,500,504
11,1104,50,0,0.0001,0.01,0.828,541,563
11,1204,50,0,0.0001,0.01,0.876,590,614
11,1304,50,0,0.0001,0.01,0.906,637,667
11,1404,50,0,0.0001,0.01,0.908,689,715
11,1504,50,0,0.0001,0.01,0.918,740,764
11,1604,50,0,0.0001,0.01,0.936,791,813
11,1704,50,0,0.0001,0.01,0.958,848,856
11,1804,50,0,0.0001,0.01,0.954,907,897
11,1904,50,0,0.0001,0.01,0.958,952,952
12,0,50,0,0.0001,0.01,0.508,0,0
12,104,50,0,0.0001,0.01,0.506,48,56
12,204,50,0,0.0001,0.01,0.63,96,108
12,304,50,0,0.0001,0.01,0.576,146,158
12,404,50,0,0.0001,0.01,0.632,193,211
12,504,50,0,0.0001,0.01,0.628,246,258
12,604,50,0,0.0001,0.01,0.628,297,307
12,704,50,0,0.0001,0.01,0.632,340,364
12,804,50,0,0.0001,0.01,0.644,393,411
12,904,50,0,0.0001,0.01,0.672,450,454
12,1004,50,0,0.0001,0.01,0.7,499,505
12,1104,50,0,0.0001,0.01,0.738,544,560
12,1204,50,0,0.0001,0.01,0.768,597,607
12,1304,50,0,0.0001,0.01,0.81,654,650
12,1404,50,0,0.0001,0.01,0.858,701,703
12,1504,50,0,0.0001,0.01,0.878,748,756
12,1604,50,0,0.0001,0.01,0.898,798,806
12,1704,50,0,0.0001,0.01,0.896,851,853
12,1804,50,0,0.0001,0.01,0.94,905,899
12,1904,50,0,0.0001,0.01,0.948,952,952
13,0,50,0,0.0001,0.01,0.514,0,0
13,104,50,0,0.0001,0.01,0.502,62,42
13,204,50,0,0.0001,0.01,0.612,112,92
13,304,50,0,0.0001,0.01,0.602,167,137
13,404,50,0,0.0001,0.01,0.604,216,188
13,504,50,0,0.0001,0.01,0.622,270,234
13,604,50,0,0.0001,0.01,0.634,318,286
13,704,50,0,0.0001,0.01,0.636,366,338
13,804,50,0,0.0001,0.01,0.676,417,387
13,904,50,0,0.0001,0.01,0.698,466,438
13,1004,50,0,0.0001,0.01,0.704,512,492
13,1104,50,0,0.0001,0.01,0.73,568,536
13,1204,50,0,0.0001,0.01,0.764,612,592
13,1304,50,0,0.0001,0.01,0.782,660,644
13,1404,50,0,0.0001,0.01,0.81,708,696
13,1504,50,0,0.0001,0.01,0.838,765,739
13,1604,50,0,0.0001,0.01,0.87,810,794
13,1704,50,0,0.0001,0.01,0.884,858,846
13,1804,50,0,0.0001,0.01,0.904,902,902
13,1904,50,0,0.0001,0.01,0.92,952,952
14,0,50,0,0.0001,0.01,0.504,0,0
14,104,50,0,0.0001,0.01,0.502,48,56
14,204,50,0,0.0001,0.01,0.664,102,102
14,304,50,0,0.0001,0.01,0.67,153,151
14,404,50,0,0.0001,0.01,0.638,206,198
14,504,50,0,0.0001,0.01,0.654,254,250
14,604,50,0,0.0001,0.01,0.648,306,298
14,704,50,0,0.0001,0.01,0.678,358,346
14,804,50,0,0.0001,0.01,0.71,403,401
14,904,50,0,0.0001,0.01,0.772,452,452
14,1004,50,0,0.0001,0.01,0.786,500,504
14,1104,50,0,0.0001,0.01,0.818,555,549
14,1204,50,0,0.0001,0.01,0.832,607,597
14,1304,50,0,0.0001,0.01,0.854,660,644
14,1404,50,0,0.0001,0.01,0.858,709,695
14,1504,50,0,0.0001,0.01,0.898,762,742
14,1604,50,0,0.0001,0.01,0.9,806,798
14,1704,50,0,0.0001,0.01,0.912,857,847
14,1804,50,0,0.0001,0.01,0.928,904,900
14,1904,50,0,0.0001,0.01,0.958,952,952
15,0,50,0,0.0001,0.01,0.5,0,0
15,104,50,0,0.0001,0.01,0.5,57,47
15,204,50,0,0.0001,0.01,0.566,108,96
15,304,50,0,0.0001,0.01,0.52,153,151
15,404,50,0,0.0001,0.01,0.632,199,205
15,504,50,0,0.0001,0.01,0.602,257,247
15,604,50,0,0.0001,0.01,0.638,305,299
15,704,50,0,0.0001,0.01,0.626,352,352
15,804,50,0,0.0001,0.01,0.646,403,401
15,904,50,0,0.0001,0.01,0.654,454,450
15,1004,50,0,0.0001,0.01,0.664,509,495
15,1104,50,0,0.0001,0.01,0.666,559,545
15,1204,50,0,0.0001,0.01,0.712,603,601
15,1304,50,0,0.0001,0.01,0.748,645,659
15,1404,50,0,0.0001,0.01,0.752,697,707
15,1504,50,0,0.0001,0.01,0.8,737,767
15,1604,50,0,0.0001,0.01,0.83,796,808
15,1704,50,0,0.0001,0.01,0.84,848,856
15,1804,50,0,0.0001,0.01,0.852,903,901
15,1904,50,0,0.0001,0.01,0.836,952,952
16,0,50,0,0.0001,0.01,0.506,0,0
16,104,50,0,0.0001,0.01,0.504,49,55
16,204,50,0,0.0001,0.01,0.658,101,103
16,304,50,0,0.0001,0.01,0.632,157,147
16,404,50,0,0.0001,0.01,0.63,206,198
16,504,50,0,0.0001,0.01,0.642,258,246
16,604,50,0,0.0001,0.01,0.644,311,293
16,704,50,0,0.0001,0.01,0.664,361,343
16,804,50,0,0.0001,0.01,0.668,411,393
16,904,50,0,0.0001,0.01,0.704,457,447
16,1004,50,0,0.0001,0.01,0.732,502,502
16,1104,50,0,0.0001,0.01,0.78,554,550
16,1204,50,0,0.0001,0.01,0.794,605,599
16,1304,50,0,0.0001,0.01,0.856,655,649
16,1404,50,0,0.0001,0.01,0.85,707,697
16,1504,50,0,0.0001,0.01,0.882,747,757
16,1604,50,0,0.0001,0.01,0.906,797,807
16,1704,50,0,0.0001,0.01,0.906,854,850
16,1804,50,0,0.0001,0.01,0.928,903,901
16,1904,50,0,0.0001,0.01,0.94,952,952
17,0,50,0,0.0001,0.01,0.502,0,0
17,104,50,0,0.0001,0.01,0.504,46,58
17,204,50,0,0.0001,0.01,0.568,87,117
17,304,50,0,0.0001,0.01,0.644,141,163
17,404,50,0,0.0001,0.01,0.626,197,207
17,504,50,0,0.0001,0.01,0.616,259,245
17,604,50,0,0.0001,0.01,0.66,306,298
17,704,50,0,0.0001,0.01,0.658,355,349
17,804,50,0,0.0001,0.01,0.68,401,403
17,904,50,0,0.0001,0.01,0.68,456,448
17,1004,50,0,0.0001,0.01,0.654,503,501
17,1104,50,0,0.0001,0.01,0.698,558,546
17,1204,50,0,0.0001,0.01,0.754,608,596
17,1304,50,0,0.0001,0.01,0.776,651,653
17,1404,50,0,0.0001,0.01,0.818,698,706
17,1504,50,0,0.0001,0.01,0.844,757,747
17,1604,50,0,0.0001,0.01,0.87,810,794
17,1704,50,0,0.0001,0.01,0.902,860,844
17,1804,50,0,0.0001,0.01,0.922,901,903
17,1904,50,0,0.0001,0.01,0.934,952,952
18,0,50,0,0.0001,0.01,0.506,0,0
18,104,50,0,0.0001,0.01,0.502,50,54
18,204,50,0,0.0001,0.01,0.646,92,112
18,304,50,0,0.0001,0.01,0.592,139,165
18,404,50,0,0.0001,0.01,0.602,192,212
18,504,50,0,0.0001,0.01,0.654,234,270
18,604,50,0,0.0001,0.01,0.652,283,321
18,704,50,0,0.0001,0.01,0.686,340,364
18,804,50,0,0.0001,0.01,0.734,394,410
18,904,50,0,0.0001,0.01,0.762,442,462
18,1004,50,0,0.0001,0.01,0.768,492,512
18,1104,50,0,0.0001,0.01,0.818,536,568
18,1204,50,0,0.0001,0.01,0.862,590,614
18,1304,50,0,0.0001,0.01,0.892,639,665
18,1404,50,0,0.0001,0.01,0.9,688,716
18,1504,50,0,0.0001,0.01,0.918,736,768
18,1604,50,0,0.0001,0.01,0.934,788,816
18,1704,50,0,0.0001,0.01,0.946,844,860
18,1804,50,0,0.0001,0.01,0.962,897,907
18,1904,50,0,0.0001,0.01,0.962,952,952
19,0,50,0,0.0001,0.01,0.504,0,0
19,104,50,0,0.0001,0.01,0.514,48,56
19,204,50,0,0.0001,0.01,0.638,96,108
19,304,50,0,0.0001,0.01,0.574,151,153
19,404,50,0,0.0001,0.01,0.618,201,203
19,504,50,0,0.0001,0.01,0.668,246,258
19,604,50,0,0.0001,0.01,0.64,300,304
19,704,50,0,0.0001,0.01,0.666,352,352
19,804,50,0,0.0001,0.01,0.71,393,411
19,904,50,0,0.0001,0.01,0.71,448,456
19,1004,50,0,0.0001,0.01,0.718,504,500
19,1104,50,0,0.0001,0.01,0.758,553,551
19,1204,50,0,0.0001,0.01,0.784,602,602
19,1304,50,0,0.0001,0.01,0.826,655,649
19,1404,50,0,0.0001,0.01,0.842,701,703
19,1504,50,0,0.0001,0.01,0.874,747,757
19,1604,50,0,0.0001,0.01,0.898,801,803
19,1704,50,0,0.0001,0.01,0.916,846,858
19,1804,50,0,0.0001,0.01,0.924,898,906
19,1904,50,0,0.0001,0.01,0.936,952,952
20,0,50,0,0.0001,0.01,0.514,0,0
20,104,50,0,0.0001,0.01,0.5,54,50
20,204,50,0,0.0001,0.01,0.622,107,97
20,304,50,0,0.0001,0.01,0.54,153,151
20,404,50,0,0.0001,0.01,0.668,202,202
20,504,50,0,0.0001,0.01,0.69,256,248
20,604,50,0,0.0001,0.01,0.666,302,302
20,704,50,0,0.0001,0.01,0.714,351,353
20,804,50,0,0.0001,0.01,0.758,409,395
20,904,50,0,0.0001,0.01,0.762,457,447
20,1004,50,0,0.0001,0.01,0.782,508,496
20,1104,50,0,0.0001,0.01,0.826,565,539
20,1204,50,0,0.0001,0.01,0.854,617,587
20,1304,50,0,0.0001,0.01,0.846,664,640
20,1404,50,0,0.0001,0.01,0.87,707,697
20,1504,50,0,0.0001,0.01,0.886,753,751
20,1604,50,0,0.0001,0.01,0.898,801,803
20,1704,50,0,0.0001,0.01,0.91,851,853
20,1804,50,0,0.0001,0.01,0.922,898,906
20,1904,50,0,0.0001,0.01,0.926,952,952
1,0,50,0,0.001,0.0001,0.516,0,0
1,104,50,0,0.001,0.0001,0.516,47,57
1,204,50,0,0.001,0.0001,0.516,97,107
1,304,50,0,0.001,0.0001,0.51,149,155
1,404,50,0,0.001,0.0001,0.51,198,206
1,504,50,0,0.001,0.0001,0.512,242,262
1,604,50,0,0.001,0.0001,0.496,290,314
1,704,50,0,0.001,0.0001,0.486,330,374
1,804,50,0,0.001,0.0001,0.486,387,417
1,904,50,0,0.001,0.0001,0.498,438,466
1,1004,50,0,0.001,0.0001,0.486,488,516
1,1104,50,0,0.001,0.0001,0.49,534,570
1,1204,50,0,0.001,0.0001,0.494,580,624
1,1304,50,0,0.001,0.0001,0.5,639,665
1,1404,50,0,0.001,0.0001,0.48,693,711
1,1504,50,0,0.001,0.0001,0.482,745,759
1,1604,50,0,0.001,0.0001,0.484,796,808
1,1704,50,0,0.001,0.0001,0.482,844,860
1,1804,50,0,0.001,0.0001,0.484,898,906
1,1904,50,0,0.001,0.0001,0.502,952,952
2,0,50,0,0.001,0.0001,0.5,0,0
2,104,50,0,0.001,0.0001,0.5,54,50
2,204,50,0,0.001,0.0001,0.498,101,103
2,304,50,0,0.001,0.0001,0.498,148,156
2,404,50,0,0.001,0.0001,0.5,202,202
2,504,50,0,0.001,0.0001,0.492,247,257
2,604,50,0,0.001,0.0001,0.496,303,301
2,704,50,0,0.001,0.0001,0.504,352,352
2,804,50,0,0.001,0.0001,0.498,407,397
2,904,50,0,0.001,0.0001,0.506,462,442
2,1004,50,0,0.001,0.0001,0.512,515,489
2,1104,50,0,0.001,0.0001,0.514,560,544
2,1204,50,0,0.001,0.0001,0.52,612,592
2,1304,50,0,0.001,0.0001,0.516,661,643
2,1404,50,0,0.001,0.0001,0.514,716,688
2,1504,50,0,0.001,0.0001,0.516,762,742
2,1604,50,0,0.001,0.0001,0.522,815,789
2,1704,50,0,0.001,0.0001,0.53,861,843
2,1804,50,0,0.001,0.0001,0.532,904,900
2,1904,50,0,0.001,0.0001,0.532,952,952
3,0,50,0,0.001,0.0001,0.512,0,0
3,104,50,0,0.001,0.0001,0.512,57,47
3,204,50,0,0.001,0.0001,0.51,108,96
3,304,50,0,0.001,0.0001,0.51,169,135
3,404,50,0,0.001,0.0001,0.516,216,188
3,504,50,0,0.001,0.0001,0.512,258,246
3,604,50,0,0.001,0.0001,0.512,301,303
3,704,50,0,0.001,0.0001,0.508,349,355
3,804,50,0,0.001,0.0001,0.514,398,406
3,904,50,0,0.001,0.0001,0.518,453,451
3,1004,50,0,0.001,0.0001,0.514,497,507
3,1104,50,0,0.001,0.0001,0.522,550,554
3,1204,50,0,0.001,0.0001,0.516,601,603
3,1304,50,0,0.001,0.0001,0.522,655,649
3,1404,50,0,0.001,0.0001,0.524,701,703
3,1504,50,0,0.001,0.0001,0.518,746,758
3,1604,50,0,0.001,0.0001,0.532,801,803
3,1704,50,0,0.001,0.0001,0.53,852,852
3,1804,50,0,0.001,0.0001,0.522,901,903
3,1904,50,0,0.001,0.0001,0.526,952,952
4,0,50,0,0.001,0.0001,0.514,0,0
4,104,50,0,0.001,0.0001,0.512,51,53
4,204,50,0,0.001,0.0001,0.514,104,100
4,304,50,0,0.001,0.0001,0.512,157,147
4,404,50,0,0.001,0.0001,0.508,207,197
4,504,50,0,0.001,0.0001,0.512,264,240
4,604,50,0,0.001,0.0001,0.51,311,293
4,704,50,0,0.001,0.0001,0.522,358,346
4,804,50,0,0.001,0.0001,0.522,407,397
4,904,50,0,0.001,0.0001,0.522,455,449
4,1004,50,0,0.001,0.0001,0.52,509,495
4,1104,50,0,0.001,0.0001,0.514,563,541
4,1204,50,0,0.001,0.0001,0.512,606,598
4,1304,50,0,0.001,0.0001,0.506,652,652
4,1404,50,0,0.001,0.0001,0.51,700,704
4,1504,50,0,0.001,0.0001,0.514,754,750
4,1604,50,0,0.001,0.0001,0.514,810,794
4,1704,50,0,0.001,0.0001,0.512,860,844
4,1804,50,0,0.001,0.0001,0.524,901,903
4,1904,50,0,0.001,0.0001,0.512,952,952
5,0,50,0,0.001,0.0001,0.52,0,0
5,104,50,0,0.001,0.0001,0.52,53,51
5,204,50,0,0.001,0.0001,0.52,105,99
5,304,50,0,0.001,0.0001,0.522,160,144
5,404,50,0,0.001,0.0001,0.518,213,191
5,504,50,0,0.001,0.0001,0.516,257,247
5,604,50,0,0.001,0.0001,0.512,315,289
5,704,50,0,0.001,0.0001,0.512,359,345
5,804,50,0,0.001,0.0001,0.518,408,396
5,904,50,0,0.001,0.0001,0.52,455,449
5,1004,50,0,0.001,0.0001,0.518,508,496
5,1104,50,0,0.001,0.0001,0.522,558,546
5,1204,50,0,0.001,0.0001,0.518,599,605
5,1304,50,0,0.001,0.0001,0.518,650,654
5,1404,50,0,0.001,0.0001,0.532,700,704
5,1504,50,0,0.001,0.0001,0.526,753,751
5,1604,50,0,0.001,0.0001,0.532,802,802
5,1704,50,0,0.001,0.0001,0.542,854,850
5,1804,50,0,0.001,0.0001,0.542,902,902
5,1904,50,0,0.001,0.0001,0.534,952,952
6,0,50,0,0.001,0.0001,0.528,0,0
6,104,50,0,0.001,0.0001,0.528,53,51
6,204,50,0,0.001,0.0001,0.528,106,98
6,304,50,0,0.001,0.0001,0.528,152,152
6,404,50,0,0.001,0.0001,0.522,209,195
6,504,50,0,0.001,0.0001,0.524,262,242
6,604,50,0,0.001,0.0001,0.53,305,299
6,704,50,0,0.001,0.0001,0.534,347,357
6,804,50,0,0.001,0.0001,0.534,395,409
6,904,50,0,0.001,0.0001,0.53,448,456
6,1004,50,0,0.001,0.0001,0.528,501,503
6,1104,50,0,0.001,0.0001,0.524,546,558
6,1204,50,0,0.001,0.0001,0.508,595,609
6,1304,50,0,0.001,0.0001,0.508,646,658
6,1404,50,0,0.001,0.0001,0.5,699,705
6,1504,50,0,0.001,0.0001,0.498,754,750
6,1604,50,0,0.001,0.0001,0.492,797,807
6,1704,50,0,0.001,0.0001,0.494,852,852
6,1804,50,0,0.001,0.0001,0.476,896,908
6,1904,50,0,0.001,0.0001,0.49,952,952
7,0,50,0,0.001,0.0001,0.508,0,0
7,104,50,0,0.001,0.0001,0.512,60,44
7,204,50,0,0.001,0.0001,0.512,108,96
7,304,50,0,0.001,0.0001,0.518,166,138
7,404,50,0,0.001,0.0001,0.524,220,184
7,504,50,0,0.001,0.0001,0.514,265,239
7,604,50,0,0.001,0.0001,0.52,307,297
7,704,50,0,0.001,0.0001,0.532,357,347
7,804,50,0,0.001,0.0001,0.548,399,405
7,904,50,0,0.001,0.0001,0.546,439,465
7,1004,50,0,0.001,0.0001,0.536,488,516
7,1104,50,0,0.001,0.0001,0.512,539,565
7,1204,50,0,0.001,0.0001,0.514,589,615
7,1304,50,0,0.001,0.0001,0.512,636,668
7,1404,50,0,0.001,0.0001,0.506,681,723
7,1504,50,0,0.001,0.0001,0.512,731,773
7,1604,50,0,0.001,0.0001,0.5,779,825
7,1704,50,0,0.001,0.0001,0.496,836,868
7,1804,50,0,0.001,0.0001,0.502,891,913
7,1904,50,0,0.001,0.0001,0.496,952,952
8,0,50,0,0.001,0.0001,0.522,0,0
8,104,50,0,0.001,0.0001,0.522,50,54
8,204,50,0,0.001,0.0001,0.52,91,113
8,304,50,0,0.001,0.0001,0.52,134,170
8,404,50,0,0.001,0.0001,0.514,187,217
8,504,50,0,0.001,0.0001,0.51,236,268
8,604,50,0,0.001,0.0001,0.514,283,321
8,704,50,0,0.001,0.0001,0.512,332,372
8,804,50,0,0.001,0.0001,0.508,376,428
8,904,50,0,0.001,0.0001,0.508,427,477
8,1004,50,0,0.001,0.0001,0.508,472,532
8,1104,50,0,0.001,0.0001,0.51,530,574
8,1204,50,0,0.001,0.0001,0.51,583,621
8,1304,50,0,0.001,0.0001,0.51,637,667
8,1404,50,0,0.001,0.0001,0.512,698,706
8,1504,50,0,0.001,0.0001,0.512,753,751
8,1604,50,0,0.001,0.0001,0.516,803,801
8,1704,50,0,0.001,0.0001,0.522,854,850
8,1804,50,0,0.001,0.0001,0.526,905,899
8,1904,50,0,0.001,0.0001,0.538,952,952
9,0,50,0,0.001,0.0001,0.5,0,0
9,104,50,0,0.001,0.0001,0.5,55,49
9,204,50,0,0.001,0.0001,0.5,101,103
9,304,50,0,0.001,0.0001,0.5,161,143
9,404,50,0,0.001,0.0001,0.5,209,195
9,504,50,0,0.001,0.0001,0.498,261,243
9,604,50,0,0.001,0.0001,0.506,315,289
9,704,50,0,0.001,0.0001,0.506,354,350
9,804,50,0,0.001,0.0001,0.502,408,396
9,904,50,0,0.001,0.0001,0.498,456,448
9,1004,50,0,0.001,0.0001,0.496,509,495
9,1104,50,0,0.001,0.0001,0.486,559,545
9,1204,50,0,0.001,0.0001,0.494,607,597
9,1304,50,0,0.001,0.0001,0.486,652,652
9,1404,50,0,0.001,0.0001,0.49,706,698
9,1504,50,0,0.001,0.0001,0.474,759,745
9,1604,50,0,0.001,0.0001,0.484,810,794
9,1704,50,0,0.001,0.0001,0.482,863,841
9,1804,50,0,0.001,0.0001,0.496,907,897
9,1904,50,0,0.001,0.0001,0.49,952,952
10,0,50,0,0.001,0.0001,0.494,0,0
10,104,50,0,0.001,0.0001,0.498,56,48
10,204,50,0,0.001,0.0001,0.496,108,96
10,304,50,0,0.001,0.0001,0.496,159,145
10,404,50,0,0.001,0.0001,0.498,205,199
10,504,50,0,0.001,0.0001,0.498,257,247
10,604,50,0,0.001,0.0001,0.492,311,293
10,704,50,0,0.001,0.0001,0.496,365,339
10,804,50,0,0.001,0.0001,0.492,406,398
10,904,50,0,0.001,0.0001,0.492,447,457
10,1004,50,0,0.001,0.0001,0.496,483,521
10,1104,50,0,0.001,0.0001,0.502,540,564
10,1204,50,0,0.001,0.0001,0.502,594,610
10,1304,50,0,0.001,0.0001,0.504,642,662
10,1404,50,0,0.001,0.0001,0.51,697,707
10,1504,50,0,0.001,0.0001,0.51,749,755
10,1604,50,0,0.001,0.0001,0.51,799,805
10,1704,50,0,0.001,0.0001,0.508,851,853
10,1804,50,0,0.001,0.0001,0.514,904,900
10,1904,50,0,0.001,0.0001,0.5,952,952
11,0,50,0,0.001,0.0001,0.49,0,0
11,104,50,0,0.001,0.0001,0.49,59,45
11,204,50,0,0.001,0.0001,0.492,106,98
11,304,50,0,0.001,0.0001,0.498,160,144
11,404,50,0,0.001,0.0001,0.502,205,199
11,504,50,0,0.001,0.0001,0.502,256,248
11,604,50,0,0.001,0.0001,0.51,308,296
11,704,50,0,0.001,0.0001,0.506,363,341
11,804,50,0,0.001,0.0001,0.508,408,396
11,904,50,0,0.001,0.0001,0.516,455,449
11,1004,50,0,0.001,0.0001,0.524,501,503
11,1104,50,0,0.001,0.0001,0.532,546,558
11,1204,50,0,0.001,0.0001,0.526,602,602
11,1304,50,0,0.001,0.0001,0.516,651,653
11,1404,50,0,0.001,0.0001,0.516,695,709
11,1504,50,0,0.001,0.0001,0.51,758,746
11,1604,50,0,0.001,0.0001,0.514,806,798
11,1704,50,0,0.001,0.0001,0.508,862,842
11,1804,50,0,0.001,0.0001,0.502,916,888
11,1904,50,0,0.001,0.0001,0.496,952,952
12,0,50,0,0.001,0.0001,0.5,0,0
12,104,50,0,0.001,0.0001,0.5,61,43
12,204,50,0,0.001,0.0001,0.498,112,92
12,304,50,0,0.001,0.0001,0.498,165,139
12,404,50,0,0.001,0.0001,0.496,206,198
12,504,50,0,0.001,0.0001,0.5,258,246
12,604,50,0,0.001,0.0001,0.502,309,295
12,704,50,0,0.001,0.0001,0.498,347,357
12,804,50,0,0.001,0.0001,0.5,398,406
12,904,50,0,0.001,0.0001,0.5,452,452
12,1004,50,0,0.001,0.0001,0.512,505,499
12,1104,50,0,0.001,0.0001,0.504,549,555
12,1204,50,0,0.001,0.0001,0.498,599,605
12,1304,50,0,0.001,0.0001,0.514,648,656
12,1404,50,0,0.001,0.0001,0.514,698,706
12,1504,50,0,0.001,0.0001,0.522,743,761
12,1604,50,0,0.001,0.0001,0.52,800,804
12,1704,50,0,0.001,0.0001,0.538,851,853
12,1804,50,0,0.001,0.0001,0.542,901,903
12,1904,50,0,0.001,0.0001,0.54,952,952
13,0,50,0,0.001,0.0001,0.496,0,0
13,104,50,0,0.001,0.0001,0.496,54,50
13,204,50,0,0.001,0.0001,0.496,107,97
13,304,50,0,0.001,0.0001,0.496,161,143
13,404,50,0,0.001,0.0001,0.496,212,192
13,504,50,0,0.001,0.0001,0.484,268,236
13,604,50,0,0.001,0.0001,0.498,326,278
13,704,50,0,0.001,0.0001,0.514,379,325
13,804,50,0,0.001,0.0001,0.532,427,377
13,904,50,0,0.001,0.0001,0.528,475,429
13,1004,50,0,0.001,0.0001,0.534,525,479
13,1104,50,0,0.001,0.0001,0.502,576,528
13,1204,50,0,0.001,0.0001,0.518,620,584
13,1304,50,0,0.001,0.0001,0.504,674,630
13,1404,50,0,0.001,0.0001,0.504,721,683
13,1504,50,0,0.001,0.0001,0.51,763,741
13,1604,50,0,0.001,0.0001,0.518,812,792
13,1704,50,0,0.001,0.0001,0.514,864,840
13,1804,50,0,0.001,0.0001,0.516,909,895
13,1904,50,0,0.001,0.0001,0.496,952,952
14,0,50,0,0.001,0.0001,0.496,0,0
14,104,50,0,0.001,0.0001,0.496,58,46
14,204,50,0,0.001,0.0001,0.496,112,92
14,304,50,0,0.001,0.0001,0.496,163,141
14,404,50,0,0.001,0.0001,0.494,216,188
14,504,50,0,0.001,0.0001,0.492,264,240
14,604,50,0,0.001,0.0001,0.492,314,290
14,704,50,0,0.001,0.0001,0.494,360,344
14,804,50,0,0.001,0.0001,0.492,411,393
14,904,50,0,0.001,0.0001,0.49,457,447
14,1004,50,0,0.001,0.0001,0.494,510,494
14,1104,50,0,0.001,0.0001,0.494,560,544
14,1204,50,0,0.001,0.0001,0.49,612,592
14,1304,50,0,0.001,0.0001,0.492,652,652
14,1404,50,0,0.001,0.0001,0.492,696,708
14,1504,50,0,0.001,0.0001,0.494,745,759
14,1604,50,0,0.001,0.0001,0.494,799,805
14,1704,50,0,0.001,0.0001,0.494,842,862
14,1804,50,0,0.001,0.0001,0.488,907,897
14,1904,50,0,0.001,0.0001,0.492,952,952
15,0,50,0,0.001,0.0001,0.484,0,0
15,104,50,0,0.001,0.0001,0.482,58,46
15,204,50,0,0.001,0.0001,0.486,112,92
15,304,50,0,0.001,0.0001,0.484,161,143
15,404,50,0,0.001,0.0001,0.476,212,192
15,504,50,0,0.001,0.0001,0.478,261,243
15,604,50,0,0.001,0.0001,0.484,306,298
15,704,50,0,0.001,0.0001,0.48,357,347
15,804,50,0,0.001,0.0001,0.486,414,390
15,904,50,0,0.001,0.0001,0.484,462,442
15,1004,50,0,0.001,0.0001,0.49,519,485
15,1104,50,0,0.001,0.0001,0.49,566,538
15,1204,50,0,0.001,0.0001,0.494,615,589
15,1304,50,0,0.001,0.0001,0.49,668,636
15,1404,50,0,0.001,0.0001,0.49,718,686
15,1504,50,0,0.001,0.0001,0.502,768,736
15,1604,50,0,0.001,0.0001,0.5,809,795
15,1704,50,0,0.001,0.0001,0.5,865,839
15,1804,50,0,0.001,0.0001,0.496,912,892
15,1904,50,0,0.001,0.0001,0.492,952,952
16,0,50,0,0.001,0.0001,0.512,0,0
16,104,50,0,0.001,0.0001,0.514,49,55
16,204,50,0,0.001,0.0001,0.514,102,102
16,304,50,0,0.001,0.0001,0.512,156,148
16,404,50,0,0.001,0.0001,0.514,218,186
16,504,50,0,0.001,0.0001,0.518,272,232
16,604,50,0,0.001,0.0001,0.51,320,284
16,704,50,0,0.001,0.0001,0.51,367,337
16,804,50,0,0.001,0.0001,0.508,409,395
16,904,50,0,0.001,0.0001,0.522,461,443
16,1004,50,0,0.001,0.0001,0.526,519,485
16,1104,50,0,0.001,0.0001,0.532,570,534
16,1204,50,0,0.001,0.0001,0.536,626,578
16,1304,50,0,0.001,0.0001,0.538,684,620
16,1404,50,0,0.001,0.0001,0.538,730,674
16,1504,50,0,0.001,0.0001,0.53,777,727
16,1604,50,0,0.001,0.0001,0.522,833,771
16,1704,50,0,0.001,0.0001,0.51,868,836
16,1804,50,0,0.001,0.0001,0.522,911,893
16,1904,50,0,0.001,0.0001,0.532,952,952
17,0,50,0,0.001,0.0001,0.522,0,0
17,104,50,0,0.001,0.0001,0.522,58,46
17,204,50,0,0.001,0.0001,0.522,105,99
17,304,50,0,0.001,0.0001,0.52,157,147
17,404,50,0,0.001,0.0001,0.524,207,197
17,504,50,0,0.001,0.0001,0.512,258,246
17,604,50,0,0.001,0.0001,0.516,311,293
17,704,50,0,0.001,0.0001,0.516,363,341
17,804,50,0,0.001,0.0001,0.518,405,399
17,904,50,0,0.001,0.0001,0.512,456,448
17,1004,50,0,0.001,0.0001,0.516,500,504
17,1104,50,0,0.001,0.0001,0.514,545,559
17,1204,50,0,0.001,0.0001,0.52,600,604
17,1304,50,0,0.001,0.0001,0.508,652,652
17,1404,50,0,0.001,0.0001,0.514,703,701
17,1504,50,0,0.001,0.0001,0.514,753,751
17,1604,50,0,0.001,0.0001,0.506,809,795
17,1704,50,0,0.001,0.0001,0.514,855,849
17,1804,50,0,0.001,0.0001,0.518,904,900
17,1904,50,0,0.001,0.0001,0.516,952,952
18,0,50,0,0.001,0.0001,0.536,0,0
18,104,50,0,0.001,0.0001,0.534,49,55
18,204,50,0,0.001,0.0001,0.538,100,104
18,304,50,0,0.001,0.0001,0.532,149,155
18,404,50,0,0.001,0.0001,0.526,200,204
18,504,50,0,0.001,0.0001,0.532,249,255
18,604,50,0,0.001,0.0001,0.534,313,291
18,704,50,0,0.001,0.0001,0.532,357,347
18,804,50,0,0.001,0.0001,0.53,404,400
18,904,50,0,0.001,0.0001,0.534,452,452
18,1004,50,0,0.001,0.0001,0.532,505,499
18,1104,50,0,0.001,0.0001,0.528,551,553
18,1204,50,0,0.001,0.0001,0.536,604,600
18,1304,50,0,0.001,0.0001,0.534,647,657
18,1404,50,0,0.001,0.0001,0.534,699,705
18,1504,50,0,0.001,0.0001,0.538,750,754
18,1604,50,0,0.001,0.0001,0.546,795,809
18,1704,50,0,0.001,0.0001,0.538,845,859
18,1804,50,0,0.001,0.0001,0.544,900,904
18,1904,50,0,0.001,0.0001,0.55,952,952
19,0,50,0,0.001,0.0001,0.502,0,0
19,104,50,0,0.001,0.0001,0.502,48,56
19,204,50,0,0.001,0.0001,0.502,101,103
19,304,50,0,0.001,0.0001,0.502,145,159
19,404,50,0,0.001,0.0001,0.504,198,206
19,504,50,0,0.001,0.0001,0.504,253,251
19,604,50,0,0.001,0.0001,0.504,297,307
19,704,50,0,0.001,0.0001,0.504,341,363
19,804,50,0,0.001,0.0001,0.504,393,411
19,904,50,0,0.001,0.0001,0.502,439,465
19,1004,50,0,0.001,0.0001,0.504,488,516
19,1104,50,0,0.001,0.0001,0.504,538,566
19,1204,50,0,0.001,0.0001,0.504,588,616
19,1304,50,0,0.001,0.0001,0.504,633,671
19,1404,50,0,0.001,0.0001,0.502,690,714
19,1504,50,0,0.001,0.0001,0.502,739,765
19,1604,50,0,0.001,0.0001,0.498,790,814
19,1704,50,0,0.001,0.0001,0.496,845,859
19,1804,50,0,0.001,0.0001,0.5,898,906
19,1904,50,0,0.001,0.0001,0.5,952,952
20,0,50,0,0.001,0.0001,0.556,0,0
20,104,50,0,0.001,0.0001,0.556,52,52
20,204,50,0,0.001,0.0001,0.554,102,102
20,304,50,0,0.001,0.0001,0.554,149,155
20,404,50,0,0.001,0.0001,0.554,204,200
20,504,50,0,0.001,0.0001,0.552,252,252
20,604,50,0,0.001,0.0001,0.55,310,294
20,704,50,0,0.001,0.0001,0.554,355,349
20,804,50,0,0.001,0.0001,0.558,402,402
20,904,50,0,0.001,0.0001,0.558,448,456
20,1004,50,0,0.001,0.0001,0.56,496,508
20,1104,50,0,0.001,0.0001,0.568,547,557
20,1204,50,0,0.001,0.0001,0.556,596,608
20,1304,50,0,0.001,0.0001,0.556,651,653
20,1404,50,0,0.001,0.0001,0.56,712,692
20,1504,50,0,0.001,0.0001,0.568,753,751
20,1604,50,0,0.001,0.0001,0.566,807,797
20,1704,50,0,0.001,0.0001,0.562,853,851
20,1804,50,0,0.001,0.0001,0.57,904,900
20,1904,50,0,0.001,0.0001,0.586,952,952
1,0,50,0,0.001,0.001,0.508,0,0
1,104,50,0,0.001,0.001,0.51,49,55
1,204,50,0,0.001,0.001,0.622,101,103
1,304,50,0,0.001,0.001,0.576,149,155
1,404,50,0,0.001,0.001,0.65,195,209
1,504,50,0,0.001,0.001,0.632,251,253
1,604,50,0,0.001,0.001,0.7,301,303
1,704,50,0,0.001,0.001,0.716,348,356
1,804,50,0,0.001,0.001,0.742,398,406
1,904,50,0,0.001,0.001,0.81,445,459
1,1004,50,0,0.001,0.001,0.834,498,506
1,1104,50,0,0.001,0.001,0.876,551,553
1,1204,50,0,0.001,0.001,0.908,595,609
1,1304,50,0,0.001,0.001,0.924,646,658
1,1404,50,0,0.001,0.001,0.95,696,708
1,1504,50,0,0.001,0.001,0.97,746,758
1,1604,50,0,0.001,0.001,0.972,800,804
1,1704,50,0,0.001,0.001,0.982,852,852
1,1804,50,0,0.001,0.001,0.988,904,900
1,1904,50,0,0.001,0.001,0.994,952,952
2,0,50,0,0.001,0.001,0.506,0,0
2,104,50,0,0.001,0.001,0.53,49,55
2,204,50,0,0.001,0.001,0.642,97,107
2,304,50,0,0.001,0.001,0.568,141,163
2,404,50,0,0.001,0.001,0.702,189,215
2,504,50,0,0.001,0.001,0.65,246,258
2,604,50,0,0.001,0.001,0.74,303,301
2,704,50,0,0.001,0.001,0.736,346,358
2,804,50,0,0.001,0.001,0.788,391,413
2,904,50,0,0.001,0.001,0.806,446,458
2,1004,50,0,0.001,0.001,0.854,501,503
2,1104,50,0,0.001,0.001,0.9,549,555
2,1204,50,0,0.001,0.001,0.926,601,603
2,1304,50,0,0.001,0.001,0.948,652,652
2,1404,50,0,0.001,0.001,0.968,703,701
2,1504,50,0,0.001,0.001,0.982,760,744
2,1604,50,0,0.001,0.001,0.982,806,798
2,1704,50,0,0.001,0.001,0.988,857,847
2,1804,50,0,0.001,0.001,0.99,904,900
2,1904,50,0,0.001,0.001,0.992,952,952
3,0,50,0,0.001,0.001,0.51,0,0
3,104,50,0,0.001,0.001,0.538,59,45
3,204,50,0,0.001,0.001,0.588,111,93
3,304,50,0,0.001,0.001,0.534,165,139
3,404,50,0,0.001,0.001,0.618,212,192
3,504,50,0,0.001,0.001,0.61,261,243
3,604,50,0,0.001,0.001,0.676,311,293
3,704,50,0,0.001,0.001,0.68,358,346
3,804,50,0,0.001,0.001,0.742,412,392
3,904,50,0,0.001,0.001,0.756,453,451
3,1004,50,0,0.001,0.001,0.804,504,500
3,1104,50,0,0.001,0.001,0.846,551,553
3,1204,50,0,0.001,0.001,0.884,607,597
3,1304,50,0,0.001,0.001,0.908,653,651
3,1404,50,0,0.001,0.001,0.936,695,709
3,1504,50,0,0.001,0.001,0.958,746,758
3,1604,50,0,0.001,0.001,0.978,796,808
3,1704,50,0,0.001,0.001,0.984,855,849
3,1804,50,0,0.001,0.001,0.99,904,900
3,1904,50,0,0.001,0.001,0.994,952,952
4,0,50,0,0.001,0.001,0.512,0,0
4,104,50,0,0.001,0.001,0.53,61,43
4,204,50,0,0.001,0.001,0.646,112,92
4,304,50,0,0.001,0.001,0.52,171,133
4,404,50,0,0.001,0.001,0.584,219,185
4,504,50,0,0.001,0.001,0.632,262,242
4,604,50,0,0.001,0.001,0.662,308,296
4,704,50,0,0.001,0.001,0.68,353,351
4,804,50,0,0.001,0.001,0.722,405,399
4,904,50,0,0.001,0.001,0.75,452,452
4,1004,50,0,0.001,0.001,0.814,501,503
4,1104,50,0,0.001,0.001,0.846,549,555
4,1204,50,0,0.001,0.001,0.878,594,610
4,1304,50,0,0.001,0.001,0.918,648,656
4,1404,50,0,0.001,0.001,0.948,696,708
4,1504,50,0,0.001,0.001,0.968,750,754
4,1604,50,0,0.001,0.001,0.988,803,801
4,1704,50,0,0.001,0.001,0.99,855,849
4,1804,50,0,0.001,0.001,0.99,903,901
4,1904,50,0,0.001,0.001,0.99,952,952
5,0,50,0,0.001,0.001,0.522,0,0
5,104,50,0,0.001,0.001,0.538,46,58
5,204,50,0,0.001,0.001,0.674,101,103
5,304,50,0,0.001,0.001,0.544,157,147
5,404,50,0,0.001,0.001,0.698,208,196
5,504,50,0,0.001,0.001,0.676,261,243
5,604,50,0,0.001,0.001,0.742,298,306
5,704,50,0,0.001,0.001,0.758,349,355
5,804,50,0,0.001,0.001,0.804,396,408
5,904,50,0,0.001,0.001,0.858,442,462
5,1004,50,0,0.001,0.001,0.896,491,513
5,1104,50,0,0.001,0.001,0.932,544,560
5,1204,50,0,0.001,0.001,0.96,597,607
5,1304,50,0,0.001,0.001,0.976,644,660
5,1404,50,0,0.001,0.001,0.98,686,718
5,1504,50,0,0.001,0.001,0.982,736,768
5,1604,50,0,0.001,0.001,0.988,792,812
5,1704,50,0,0.001,0.001,0.992,844,860
5,1804,50,0,0.001,0.001,0.994,903,901
5,1904,50,0,0.001,0.001,0.996,952,952
6,0,50,0,0.001,0.001,0.508,0,0
6,104,50,0,0.001,0.001,0.53,51,53
6,204,50,0,0.001,0.001,0.658,99,105
6,304,50,0,0.001,0.001,0.57,147,157
6,404,50,0,0.001,0.001,0.656,204,200
6,504,50,0,0.001,0.001,0.646,249,255
6,604,50,0,0.001,0.001,0.72,301,303
6,704,50,0,0.001,0.001,0.738,353,351
6,804,50,0,0.001,0.001,0.772,409,395
6,904,50,0,0.001,0.001,0.824,461,443
6,1004,50,0,0.001,0.001,0.864,503,501
6,1104,50,0,0.001,0.001,0.906,547,557
6,1204,50,0,0.001,0.001,0.932,602,602
6,1304,50,0,0.001,0.001,0.954,657,647
6,1404,50,0,0.001,0.001,0.972,706,698
6,1504,50,0,0.001,0.001,0.98,759,745
6,1604,50,0,0.001,0.001,0.986,807,797
6,1704,50,0,0.001,0.001,0.99,858,846
6,1804,50,0,0.001,0.001,0.99,902,902
6,1904,50,0,0.001,0.001,0.994,952,952
7,0,50,0,0.001,0.001,0.506,0,0
7,104,50,0,0.001,0.001,0.534,59,45
7,204,50,0,0.001,0.001,0.656,109,95
7,304,50,0,0.001,0.001,0.552,156,148
7,404,50,0,0.001,0.001,0.646,207,197
7,504,50,0,0.001,0.001,0.634,254,250
7,604,50,0,0.001,0.001,0.73,308,296
7,704,50,0,0.001,0.001,0.68,355,349
7,804,50,0,0.001,0.001,0.782,404,400
7,904,50,0,0.001,0.001,0.824,451,453
7,1004,50,0,0.001,0.001,0.866,503,501
7,1104,50,0,0.001,0.001,0.886,549,555
7,1204,50,0,0.001,0.001,0.91,606,598
7,1304,50,0,0.001,0.001,0.95,652,652
7,1404,50,0,0.001,0.001,0.966,701,703
7,1504,50,0,0.001,0.001,0.984,745,759
7,1604,50,0,0.001,0.001,0.986,799,805
7,1704,50,0,0.001,0.001,0.994,853,851
7,1804,50,0,0.001,0.001,0.994,900,904
7,1904,50,0,0.001,0.001,0.994,952,952
8,0,50,0,0.001,0.001,0.504,0,0
8,104,50,0,0.001,0.001,0.522,45,59
8,204,50,0,0.001,0.001,0.646,86,118
8,304,50,0,0.001,0.001,0.584,128,176
8,404,50,0,0.001,0.001,0.638,178,226
8,504,50,0,0.001,0.001,0.638,233,271
8,604,50,0,0.001,0.001,0.656,285,319
8,704,50,0,0.001,0.001,0.708,331,373
8,804,50,0,0.001,0.001,0.744,393,411
8,904,50,0,0.001,0.001,0.782,451,453
8,1004,50,0,0.001,0.001,0.848,503,501
8,1104,50,0,0.001,0.001,0.882,543,561
8,1204,50,0,0.001,0.001,0.902,591,613
8,1304,50,0,0.001,0.001,0.952,639,665
8,1404,50,0,0.001,0.001,0.97,683,721
8,1504,50,0,0.001,0.001,0.98,737,767
8,1604,50,0,0.001,0.001,0.986,794,810
8,1704,50,0,0.001,0.001,0.99,851,853
8,1804,50,0,0.001,0.001,0.99,901,903
8,1904,50,0,0.001,0.001,0.992,952,952
9,0,50,0,0.001,0.001,0.524,0,0
9,104,50,0,0.001,0.001,0.534,50,54
9,204,50,0,0.001,0.001,0.624,98,106
9,304,50,0,0.001,0.001,0.576,150,154
9,404,50,0,0.001,0.001,0.678,198,206
9,504,50,0,0.001,0.001,0.636,254,250
9,604,50,0,0.001,0.001,0.696,312,292
9,704,50,0,0.001,0.001,0.7,369,335
9,804,50,0,0.001,0.001,0.76,413,391
9,904,50,0,0.001,0.001,0.804,460,444
9,1004,50,0,0.001,0.001,0.844,507,497
9,1104,50,0,0.001,0.001,0.878,559,545
9,1204,50,0,0.001,0.001,0.906,609,595
9,1304,50,0,0.001,0.001,0.934,661,643
9,1404,50,0,0.001,0.001,0.96,700,704
9,1504,50,0,0.001,0.001,0.964,747,757
9,1604,50,0,0.001,0.001,0.978,796,808
9,1704,50,0,0.001,0.001,0.978,847,857
9,1804,50,0,0.001,0.001,0.984,906,898
9,1904,50,0,0.001,0.001,0.988,952,952
10,0,50,0,0.001,0.001,0.514,0,0
10,104,50,0,0.001,0.001,0.544,60,44
10,204,50,0,0.001,0.001,0.638,109,95
10,304,50,0,0.001,0.001,0.546,151,153
10,404,50,0,0.001,0.001,0.664,199,205
10,504,50,0,0.001,0.001,0.604,239,265
10,604,50,0,0.001,0.001,0.682,289,315
10,704,50,0,0.001,0.001,0.672,348,356
10,804,50,0,0.001,0.001,0.752,405,399
10,904,50,0,0.001,0.001,0.784,450,454
10,1004,50,0,0.001,0.001,0.824,498,506
10,1104,50,0,0.001,0.001,0.87,549,555
10,1204,50,0,0.001,0.001,0.906,598,606
10,1304,50,0,0.001,0.001,0.93,655,649
10,1404,50,0,0.001,0.001,0.954,706,698
10,1504,50,0,0.001,0.001,0.966,747,757
10,1604,50,0,0.001,0.001,0.978,791,813
10,1704,50,0,0.001,0.001,0.984,843,861
10,1804,50,0,0.001,0.001,0.984,898,906
10,1904,50,0,0.001,0.001,0.988,952,952
11,0,50,0,0.001,0.001,0.506,0,0
11,104,50,0,0.001,0.001,0.514,56,48
11,204,50,0,0.001,0.001,0.636,119,85
11,304,50,0,0.001,0.001,0.53,168,136
11,404,50,0,0.001,0.001,0.562,218,186
11,504,50,0,0.001,0.001,0.634,261,243
11,604,50,0,0.001,0.001,0.624,315,289
11,704,50,0,0.001,0.001,0.63,354,350
11,804,50,0,0.001,0.001,0.666,403,401
11,904,50,0,0.001,0.001,0.688,449,455
11,1004,50,0,0.001,0.001,0.71,496,508
11,1104,50,0,0.001,0.001,0.744,555,549
11,1204,50,0,0.001,0.001,0.768,598,606
11,1304,50,0,0.001,0.001,0.812,651,653
11,1404,50,0,0.001,0.001,0.868,697,707
11,1504,50,0,0.001,0.001,0.906,741,763
11,1604,50,0,0.001,0.001,0.922,790,814
11,1704,50,0,0.001,0.001,0.95,842,862
11,1804,50,0,0.001,0.001,0.968,899,905
11,1904,50,0,0.001,0.001,0.976,952,952
12,0,50,0,0.001,0.001,0.512,0,0
12,104,50,0,0.001,0.001,0.536,46,58
12,204,50,0,0.001,0.001,0.682,98,106
12,304,50,0,0.001,0.001,0.618,151,153
12,404,50,0,0.001,0.001,0.708,205,199
12,504,50,0,0.001,0.001,0.676,247,257
12,604,50,0,0.001,0.001,0.762,301,303
12,704,50,0,0.001,0.001,0.764,350,354
12,804,50,0,0.001,0.001,0.818,396,408
12,904,50,0,0.001,0.001,0.872,445,459
12,1004,50,0,0.001,0.001,0.904,500,504
12,1104,50,0,0.001,0.001,0.934,550,554
12,1204,50,0,0.001,0.001,0.96,593,611
12,1304,50,0,0.001,0.001,0.978,642,662
12,1404,50,0,0.001,0.001,0.986,699,705
12,1504,50,0,0.001,0.001,0.988,755,749
12,1604,50,0,0.001,0.001,0.992,807,797
12,1704,50,0,0.001,0.001,0.994,856,848
12,1804,50,0,0.001,0.001,0.994,903,901
12,1904,50,0,0.001,0.001,0.994,952,952
13,0,50,0,0.001,0.001,0.528,0,0
13,104,50,0,0.001,0.001,0.558,50,54
13,204,50,0,0.001,0.001,0.65,111,93
13,304,50,0,0.001,0.001,0.556,156,148
13,404,50,0,0.001,0.001,0.676,208,196
13,504,50,0,0.001,0.001,0.67,259,245
13,604,50,0,0.001,0.001,0.722,302,302
13,704,50,0,0.001,0.001,0.746,353,351
13,804,50,0,0.001,0.001,0.794,406,398
13,904,50,0,0.001,0.001,0.818,458,446
13,1004,50,0,0.001,0.001,0.864,511,493
13,1104,50,0,0.001,0.001,0.918,561,543
13,1204,50,0,0.001,0.001,0.946,605,599
13,1304,50,0,0.001,0.001,0.954,656,648
13,1404,50,0,0.001,0.001,0.962,702,702
13,1504,50,0,0.001,0.001,0.972,750,754
13,1604,50,0,0.001,0.001,0.978,798,806
13,1704,50,0,0.001,0.001,0.982,850,854
13,1804,50,0,0.001,0.001,0.99,901,903
13,1904,50,0,0.001,0.001,0.99,952,952
14,0,50,0,0.001,0.001,0.516,0,0
14,104,50,0,0.001,0.001,0.532,55,49
14,204,50,0,0.001,0.001,0.61,110,94
14,304,50,0,0.001,0.001,0.528,161,143
14,404,50,0,0.001,0.001,0.622,206,198
14,504,50,0,0.001,0.001,0.576,254,250
14,604,50,0,0.001,0.001,0.634,305,299
14,704,50,0,0.001,0.001,0.664,356,348
14,804,50,0,0.001,0.001,0.662,403,401
14,904,50,0,0.001,0.001,0.72,460,444
14,1004,50,0,0.001,0.001,0.762,515,489
14,1104,50,0,0.001,0.001,0.796,563,541
14,1204,50,0,0.001,0.001,0.836,607,597
14,1304,50,0,0.001,0.001,0.864,658,646
14,1404,50,0,0.001,0.001,0.912,707,697
14,1504,50,0,0.001,0.001,0.936,756,748
14,1604,50,0,0.001,0.001,0.968,806,798
14,1704,50,0,0.001,0.001,0.972,864,840
14,1804,50,0,0.001,0.001,0.984,910,894
14,1904,50,0,0.001,0.001,0.988,952,952
15,0,50,0,0.001,0.001,0.514,0,0
15,104,50,0,0.001,0.001,0.524,42,62
15,204,50,0,0.001,0.001,0.654,87,117
15,304,50,0,0.001,0.001,0.598,137,167
15,404,50,0,0.001,0.001,0.68,186,218
15,504,50,0,0.001,0.001,0.656,241,263
15,604,50,0,0.001,0.001,0.722,285,319
15,704,50,0,0.001,0.001,0.76,340,364
15,804,50,0,0.001,0.001,0.804,387,417
15,904,50,0,0.001,0.001,0.866,433,471
15,1004,50,0,0.001,0.001,0.874,475,529
15,1104,50,0,0.001,0.001,0.916,528,576
15,1204,50,0,0.001,0.001,0.946,576,628
15,1304,50,0,0.001,0.001,0.954,630,674
15,1404,50,0,0.001,0.001,0.966,683,721
15,1504,50,0,0.001,0.001,0.978,741,763
15,1604,50,0,0.001,0.001,0.988,795,809
15,1704,50,0,0.001,0.001,0.992,851,853
15,1804,50,0,0.001,0.001,0.996,909,895
15,1904,50,0,0.001,0.001,0.996,952,952
16,0,50,0,0.001,0.001,0.504,0,0
16,104,50,0,0.001,0.001,0.51,48,56
16,204,50,0,0.001,0.001,0.628,97,107
16,304,50,0,0.001,0.001,0.584,157,147
16,404,50,0,0.001,0.001,0.67,209,195
16,504,50,0,0.001,0.001,0.692,259,245
16,604,50,0,0.001,0.001,0.736,315,289
16,704,50,0,0.001,0.001,0.734,366,338
16,804,50,0,0.001,0.001,0.802,418,386
16,904,50,0,0.001,0.001,0.8,465,439
16,1004,50,0,0.001,0.001,0.852,520,484
16,1104,50,0,0.001,0.001,0.882,569,535
16,1204,50,0,0.001,0.001,0.926,612,592
16,1304,50,0,0.001,0.001,0.956,668,636
16,1404,50,0,0.001,0.001,0.962,715,689
16,1504,50,0,0.001,0.001,0.974,761,743
16,1604,50,0,0.001,0.001,0.98,807,797
16,1704,50,0,0.001,0.001,0.99,861,843
16,1804,50,0,0.001,0.001,0.99,909,895
16,1904,50,0,0.001,0.001,0.994,952,952
17,0,50,0,0.001,0.001,0.508,0,0
17,104,50,0,0.001,0.001,0.52,43,61
17,204,50,0,0.001,0.001,0.616,91,113
17,304,50,0,0.001,0.001,0.55,142,162
17,404,50,0,0.001,0.001,0.644,203,201
17,504,50,0,0.001,0.001,0.632,254,250
17,604,50,0,0.001,0.001,0.664,302,302
17,704,50,0,0.001,0.001,0.69,344,360
17,804,50,0,0.001,0.001,0.732,389,415
17,904,50,0,0.001,0.001,0.798,433,471
17,1004,50,0,0.001,0.001,0.824,484,520
17,1104,50,0,0.001,0.001,0.89,537,567
17,1204,50,0,0.001,0.001,0.924,597,607
17,1304,50,0,0.001,0.001,0.948,654,650
17,1404,50,0,0.001,0.001,0.964,701,703
17,1504,50,0,0.001,0.001,0.978,748,756
17,1604,50,0,0.001,0.001,0.988,810,794
17,1704,50,0,0.001,0.001,0.99,854,850
17,1804,50,0,0.001,0.001,0.992,900,904
17,1904,50,0,0.001,0.001,0.996,952,952
18,0,50,0,0.001,0.001,0.512,0,0
18,104,50,0,0.001,0.001,0.538,57,47
18,204,50,0,0.001,0.001,0.69,107,97
18,304,50,0,0.001,0.001,0.544,155,149
18,404,50,0,0.001,0.001,0.678,202,202
18,504,50,0,0.001,0.001,0.662,257,247
18,604,50,0,0.001,0.001,0.718,309,295
18,704,50,0,0.001,0.001,0.734,362,342
18,804,50,0,0.001,0.001,0.772,411,393
18,904,50,0,0.001,0.001,0.82,455,449
18,1004,50,0,0.001,0.001,0.858,504,500
18,1104,50,0,0.001,0.001,0.892,556,548
18,1204,50,0,0.001,0.001,0.928,600,604
18,1304,50,0,0.001,0.001,0.95,658,646
18,1404,50,0,0.001,0.001,0.964,707,697
18,1504,50,0,0.001,0.001,0.982,758,746
18,1604,50,0,0.001,0.001,0.99,806,798
18,1704,50,0,0.001,0.001,0.996,852,852
18,1804,50,0,0.001,0.001,0.996,907,897
18,1904,50,0,0.001,0.001,0.996,952,952
19,0,50,0,0.001,0.001,0.504,0,0
19,104,50,0,0.001,0.001,0.516,55,49
19,204,50,0,0.001,0.001,0.612,94,110
19,304,50,0,0.001,0.001,0.626,145,159
19,404,50,0,0.001,0.001,0.666,194,210
19,504,50,0,0.001,0.001,0.676,249,255
19,604,50,0,0.001,0.001,0.708,298,306
19,704,50,0,0.001,0.001,0.742,350,354
19,804,50,0,0.001,0.001,0.814,401,403
19,904,50,0,0.001,0.001,0.846,451,453
19,1004,50,0,0.001,0.001,0.872,501,503
19,1104,50,0,0.001,0.001,0.912,561,543
19,1204,50,0,0.001,0.001,0.944,601,603
19,1304,50,0,0.001,0.001,0.954,647,657
19,1404,50,0,0.001,0.001,0.968,703,701
19,1504,50,0,0.001,0.001,0.976,754,750
19,1604,50,0,0.001,0.001,0.984,796,808
19,1704,50,0,0.001,0.001,0.988,842,862
19,1804,50,0,0.001,0.001,0.996,898,906
19,1904,50,0,0.001,0.001,0.998,952,952
20,0,50,0,0.001,0.001,0.508,0,0
20,104,50,0,0.001,0.001,0.516,51,53
20,204,50,0,0.001,0.001,0.632,101,103
20,304,50,0,0.001,0.001,0.552,151,153
20,404,50,0,0.001,0.001,0.666,208,196
20,504,50,0,0.001,0.001,0.652,265,239
20,604,50,0,0.001,0.001,0.676,313,291
20,704,50,0,0.001,0.001,0.688,375,329
20,804,50,0,0.001,0.001,0.73,426,378
20,904,50,0,0.001,0.001,0.75,483,421
20,1004,50,0,0.001,0.001,0.796,531,473
20,1104,50,0,0.001,0.001,0.816,584,520
20,1204,50,0,0.001,0.001,0.866,630,574
20,1304,50,0,0.001,0.001,0.908,678,626
20,1404,50,0,0.001,0.001,0.944,725,679
20,1504,50,0,0.001,0.001,0.962,778,726
20,1604,50,0,0.001,0.001,0.98,822,782
20,1704,50,0,0.001,0.001,0.988,869,835
20,1804,50,0,0.001,0.001,0.994,910,894
20,1904,50,0,0.001,0.001,0.998,952,952
1,0,50,0,0.001,0.01,0.724,0,0
1,104,50,0,0.001,0.01,0.5,61,43
1,204,50,0,0.001,0.01,0.554,101,103
1,304,50,0,0.001,0.01,0.572,159,145
1,404,50,0,0.001,0.01,0.582,213,191
1,504,50,0,0.001,0.01,0.562,252,252
1,604,50,0,0.001,0.01,0.572,303,301
1,704,50,0,0.001,0.01,0.586,347,357
1,804,50,0,0.001,0.01,0.616,413,391
1,904,50,0,0.001,0.01,0.612,459,445
1,1004,50,0,0.001,0.01,0.642,510,494
1,1104,50,0,0.001,0.01,0.654,556,548
1,1204,50,0,0.001,0.01,0.682,606,598
1,1304,50,0,0.001,0.01,0.708,653,651
1,1404,50,0,0.001,0.01,0.74,702,702
1,1504,50,0,0.001,0.01,0.78,753,751
1,1604,50,0,0.001,0.01,0.8,803,801
1,1704,50,0,0.001,0.01,0.844,852,852
1,1804,50,0,0.001,0.01,0.85,897,907
1,1904,50,0,0.001,0.01,0.876,952,952
2,0,50,0,0.001,0.01,0.574,0,0
2,104,50,0,0.001,0.01,0.656,50,54
2,204,50,0,0.001,0.01,0.5,107,97
2,304,50,0,0.001,0.01,0.508,148,156
2,404,50,0,0.001,0.01,0.558,205,199
2,504,50,0,0.001,0.01,0.576,251,253
2,604,50,0,0.001,0.01,0.544,301,303
2,704,50,0,0.001,0.01,0.582,350,354
2,804,50,0,0.001,0.01,0.544,395,409
2,904,50,0,0.001,0.01,0.578,440,464
2,1004,50,0,0.001,0.01,0.58,492,512
2,1104,50,0,0.001,0.01,0.598,545,559
2,1204,50,0,0.001,0.01,0.588,601,603
2,1304,50,0,0.001,0.01,0.624,647,657
2,1404,50,0,0.001,0.01,0.648,697,707
2,1504,50,0,0.001,0.01,0.678,751,753
2,1604,50,0,0.001,0.01,0.688,799,805
2,1704,50,0,0.001,0.01,0.742,846,858
2,1804,50,0,0.001,0.01,0.804,900,904
2,1904,50,0,0.001,0.01,0.832,952,952
3,0,50,0,0.001,0.01,0.666,0,0
3,104,50,0,0.001,0.01,0.51,55,49
3,204,50,0,0.001,0.01,0.562,103,101
3,304,50,0,0.001,0.01,0.566,149,155
3,404,50,0,0.001,0.01,0.604,192,212
3,504,50,0,0.001,0.01,0.592,243,261
3,604,50,0,0.001,0.01,0.556,302,302
3,704,50,0,0.001,0.01,0.568,342,362
3,804,50,0,0.001,0.01,0.554,389,415
3,904,50,0,0.001,0.01,0.582,445,459
3,1004,50,0,0.001,0.01,0.56,494,510
3,1104,50,0,0.001,0.01,0.58,545,559
3,1204,50,0,0.001,0.01,0.616,600,604
3,1304,50,0,0.001,0.01,0.628,651,653
3,1404,50,0,0.001,0.01,0.664,707,697
3,1504,50,0,0.001,0.01,0.668,763,741
3,1604,50,0,0.001,0.01,0.684,814,790
3,1704,50,0,0.001,0.01,0.736,862,842
3,1804,50,0,0.001,0.01,0.776,915,889
3,1904,50,0,0.001,0.01,0.758,952,952
4,0,50,0,0.001,0.01,0.662,0,0
4,104,50,0,0.001,0.01,0.61,50,54
4,204,50,0,0.001,0.01,0.594,106,98
4,304,50,0,0.001,0.01,0.568,154,150
4,404,50,0,0.001,0.01,0.57,198,206
4,504,50,0,0.001,0.01,0.568,246,258
4,604,50,0,0.001,0.01,0.57,296,308
4,704,50,0,0.001,0.01,0.57,348,356
4,804,50,0,0.001,0.01,0.568,388,416
4,904,50,0,0.001,0.01,0.578,431,473
4,1004,50,0,0.001,0.01,0.564,477,527
4,1104,50,0,0.001,0.01,0.604,528,576
4,1204,50,0,0.001,0.01,0.626,583,621
4,1304,50,0,0.001,0.01,0.658,639,665
4,1404,50,0,0.001,0.01,0.678,693,711
4,1504,50,0,0.001,0.01,0.71,750,754
4,1604,50,0,0.001,0.01,0.764,801,803
4,1704,50,0,0.001,0.01,0.806,855,849
4,1804,50,0,0.001,0.01,0.85,907,897
4,1904,50,0,0.001,0.01,0.878,952,952
5,0,50,0,0.001,0.01,0.694,0,0
5,104,50,0,0.001,0.01,0.5,52,52
5,204,50,0,0.001,0.01,0.5,98,106
5,304,50,0,0.001,0.01,0.53,152,152
5,404,50,0,0.001,0.01,0.514,202,202
5,504,50,0,0.001,0.01,0.57,255,249
5,604,50,0,0.001,0.01,0.572,302,302
5,704,50,0,0.001,0.01,0.574,349,355
5,804,50,0,0.001,0.01,0.572,398,406
5,904,50,0,0.001,0.01,0.592,453,451
5,1004,50,0,0.001,0.01,0.596,497,507
5,1104,50,0,0.001,0.01,0.608,542,562
5,1204,50,0,0.001,0.01,0.602,588,616
5,1304,50,0,0.001,0.01,0.606,641,663
5,1404,50,0,0.001,0.01,0.612,692,712
5,1504,50,0,0.001,0.01,0.628,750,754
5,1604,50,0,0.001,0.01,0.636,806,798
5,1704,50,0,0.001,0.01,0.658,859,845
5,1804,50,0,0.001,0.01,0.706,902,902
5,1904,50,0,0.001,0.01,0.754,952,952
6,0,50,0,0.001,0.01,0.604,0,0
6,104,50,0,0.001,0.01,0.61,55,49
6,204,50,0,0.001,0.01,0.584,98,106
6,304,50,0,0.001,0.01,0.584,150,154
6,404,50,0,0.001,0.01,0.582,200,204
6,504,50,0,0.001,0.01,0.56,254,250
6,604,50,0,0.001,0.01,0.578,303,301
6,704,50,0,0.001,0.01,0.592,352,352
6,804,50,0,0.001,0.01,0.572,405,399
6,904,50,0,0.001,0.01,0.59,461,443
6,1004,50,0,0.001,0.01,0.616,509,495
6,1104,50,0,0.001,0.01,0.636,549,555
6,1204,50,0,0.001,0.01,0.65,594,610
6,1304,50,0,0.001,0.01,0.65,639,665
6,1404,50,0,0.001,0.01,0.696,690,714
6,1504,50,0,0.001,0.01,0.758,748,756
6,1604,50,0,0.001,0.01,0.772,795,809
6,1704,50,0,0.001,0.01,0.796,857,847
6,1804,50,0,0.001,0.01,0.834,908,896
6,1904,50,0,0.001,0.01,0.834,952,952
7,0,50,0,0.001,0.01,0.718,0,0
7,104,50,0,0.001,0.01,0.5,56,48
7,204,50,0,0.001,0.01,0.544,101,103
7,304,50,0,0.001,0.01,0.606,150,154
7,404,50,0,0.001,0.01,0.57,202,202
7,504,50,0,0.001,0.01,0.566,254,250
7,604,50,0,0.001,0.01,0.598,303,301
7,704,50,0,0.001,0.01,0.608,352,352
7,804,50,0,0.001,0.01,0.598,401,403
7,904,50,0,0.001,0.01,0.604,443,461
7,1004,50,0,0.001,0.01,0.622,487,517
7,1104,50,0,0.001,0.01,0.632,536,568
7,1204,50,0,0.001,0.01,0.648,589,615
7,1304,50,0,0.001,0.01,0.69,638,666
7,1404,50,0,0.001,0.01,0.732,693,711
7,1504,50,0,0.001,0.01,0.75,742,762
7,1604,50,0,0.001,0.01,0.792,791,813
7,1704,50,0,0.001,0.01,0.81,845,859
7,1804,50,0,0.001,0.01,0.85,896,908
7,1904,50,0,0.001,0.01,0.862,952,952
8,0,50,0,0.001,0.01,0.726,0,0
8,104,50,0,0.001,0.01,0.5,53,51
8,204,50,0,0.001,0.01,0.498,105,99
8,304,50,0,0.001,0.01,0.534,162,142
8,404,50,0,0.001,0.01,0.52,212,192
8,504,50,0,0.001,0.01,0.51,270,234
8,604,50,0,0.001,0.01,0.524,323,281
8,704,50,0,0.001,0.01,0.522,366,338
8,804,50,0,0.001,0.01,0.544,418,386
8,904,50,0,0.001,0.01,0.53,471,433
8,1004,50,0,0.001,0.01,0.572,522,482
8,1104,50,0,0.001,0.01,0.556,576,528
8,1204,50,0,0.001,0.01,0.552,623,581
8,1304,50,0,0.001,0.01,0.578,668,636
8,1404,50,0,0.001,0.01,0.582,719,685
8,1504,50,0,0.001,0.01,0.576,765,739
8,1604,50,0,0.001,0.01,0.588,809,795
8,1704,50,0,0.001,0.01,0.6,860,844
8,1804,50,0,0.001,0.01,0.614,911,893
8,1904,50,0,0.001,0.01,0.65,952,952
9,0,50,0,0.001,0.01,0.532,0,0
9,104,50,0,0.001,0.01,0.502,57,47
9,204,50,0,0.001,0.01,0.5,110,94
9,304,50,0,0.001,0.01,0.532,153,151
9,404,50,0,0.001,0.01,0.55,209,195
9,504,50,0,0.001,0.01,0.566,258,246
9,604,50,0,0.001,0.01,0.54,316,288
9,704,50,0,0.001,0.01,0.546,365,339
9,804,50,0,0.001,0.01,0.544,408,396
9,904,50,0,0.001,0.01,0.56,460,444
9,1004,50,0,0.001,0.01,0.572,502,502
9,1104,50,0,0.001,0.01,0.604,553,551
9,1204,50,0,0.001,0.01,0.636,606,598
9,1304,50,0,0.001,0.01,0.664,651,653
9,1404,50,0,0.001,0.01,0.696,701,703
9,1504,50,0,0.001,0.01,0.776,755,749
9,1604,50,0,0.001,0.01,0.786,801,803
9,1704,50,0,0.001,0.01,0.804,851,853
9,1804,50,0,0.001,0.01,0.856,899,905
9,1904,50,0,0.001,0.01,0.876,952,952
10,0,50,0,0.001,0.01,0.692,0,0
10,104,50,0,0.001,0.01,0.5,60,44
10,204,50,0,0.001,0.01,0.502,106,98
10,304,50,0,0.001,0.01,0.62,152,152
10,404,50,0,0.001,0.01,0.596,205,199
10,504,50,0,0.001,0.01,0.602,246,258
10,604,50,0,0.001,0.01,0.622,296,308
10,704,50,0,0.001,0.01,0.63,351,353
10,804,50,0,0.001,0.01,0.634,402,402
10,904,50,0,0.001,0.01,0.67,448,456
10,1004,50,0,0.001,0.01,0.68,504,500
10,1104,50,0,0.001,0.01,0.718,548,556
10,1204,50,0,0.001,0.01,0.754,593,611
10,1304,50,0,0.001,0.01,0.794,636,668
10,1404,50,0,0.001,0.01,0.798,685,719
10,1504,50,0,0.001,0.01,0.834,740,764
10,1604,50,0,0.001,0.01,0.862,792,812
10,1704,50,0,0.001,0.01,0.872,838,866
10,1804,50,0,0.001,0.01,0.888,894,910
10,1904,50,0,0.001,0.01,0.924,952,952
11,0,50,0,0.001,0.01,0.682,0,0
11,104,50,0,0.001,0.01,0.5,53,51
11,204,50,0,0.001,0.01,0.5,103,101
11,304,50,0,0.001,0.01,0.52,156,148
11,404,50,0,0.001,0.01,0.56,204,200
11,504,50,0,0.001,0.01,0.55,255,249
11,604,50,0,0.001,0.01,0.564,298,306
11,704,50,0,0.001,0.01,0.554,349,355
11,804,50,0,0.001,0.01,0.554,395,409
11,904,50,0,0.001,0.01,0.566,448,456
11,1004,50,0,0.001,0.01,0.546,494,510
11,1104,50,0,0.001,0.01,0.57,538,566
11,1204,50,0,0.001,0.01,0.544,591,613
11,1304,50,0,0.001,0.01,0.568,640,664
11,1404,50,0,0.001,0.01,0.61,693,711
11,1504,50,0,0.001,0.01,0.616,747,757
11,1604,50,0,0.001,0.01,0.626,799,805
11,1704,50,0,0.001,0.01,0.64,847,857
11,1804,50,0,0.001,0.01,0.682,900,904
11,1904,50,0,0.001,0.01,0.74,952,952
12,0,50,0,0.001,0.01,0.724,0,0
12,104,50,0,0.001,0.01,0.5,43,61
12,204,50,0,0.001,0.01,0.5,93,111
12,304,50,0,0.001,0.01,0.538,147,157
12,404,50,0,0.001,0.01,0.634,199,205
12,504,50,0,0.001,0.01,0.626,242,262
12,604,50,0,0.001,0.01,0.602,285,319
12,704,50,0,0.001,0.01,0.638,337,367
12,804,50,0,0.001,0.01,0.644,381,423
12,904,50,0,0.001,0.01,0.686,432,472
12,1004,50,0,0.001,0.01,0.704,481,523
12,1104,50,0,0.001,0.01,0.758,533,571
12,1204,50,0,0.001,0.01,0.782,586,618
12,1304,50,0,0.001,0.01,0.8,641,663
12,1404,50,0,0.001,0.01,0.836,694,710
12,1504,50,0,0.001,0.01,0.86,748,756
12,1604,50,0,0.001,0.01,0.884,796,808
12,1704,50,0,0.001,0.01,0.892,847,857
12,1804,50,0,0.001,0.01,0.886,902,902
12,1904,50,0,0.001,0.01,0.936,952,952
13,0,50,0,0.001,0.01,0.694,0,0
13,104,50,0,0.001,0.01,0.5,47,57
13,204,50,0,0.001,0.01,0.5,102,102
13,304,50,0,0.001,0.01,0.612,146,158
13,404,50,0,0.001,0.01,0.498,194,210
13,504,50,0,0.001,0.01,0.592,248,256
13,604,50,0,0.001,0.01,0.572,305,299
13,704,50,0,0.001,0.01,0.542,350,354
13,804,50,0,0.001,0.01,0.568,395,409
13,904,50,0,0.001,0.01,0.562,454,450
13,1004,50,0,0.001,0.01,0.544,498,506
13,1104,50,0,0.001,0.01,0.546,545,559
13,1204,50,0,0.001,0.01,0.568,601,603
13,1304,50,0,0.001,0.01,0.558,645,659
13,1404,50,0,0.001,0.01,0.578,693,711
13,1504,50,0,0.001,0.01,0.576,736,768
13,1604,50,0,0.001,0.01,0.58,791,813
13,1704,50,0,0.001,0.01,0.606,851,853
13,1804,50,0,0.001,0.01,0.608,903,901
13,1904,50,0,0.001,0.01,0.61,952,952
14,0,50,0,0.001,0.01,0.74,0,0
14,104,50,0,0.001,0.01,0.5,62,42
14,204,50,0,0.001,0.01,0.5,111,93
14,304,50,0,0.001,0.01,0.594,163,141
14,404,50,0,0.001,0.01,0.61,214,190
14,504,50,0,0.001,0.01,0.574,261,243
14,604,50,0,0.001,0.01,0.622,313,291
14,704,50,0,0.001,0.01,0.594,357,347
14,804,50,0,0.001,0.01,0.598,408,396
14,904,50,0,0.001,0.01,0.604,459,445
14,1004,50,0,0.001,0.01,0.612,511,493
14,1104,50,0,0.001,0.01,0.634,566,538
14,1204,50,0,0.001,0.01,0.674,609,595
14,1304,50,0,0.001,0.01,0.672,654,650
14,1404,50,0,0.001,0.01,0.688,708,696
14,1504,50,0,0.001,0.01,0.728,750,754
14,1604,50,0,0.001,0.01,0.736,803,801
14,1704,50,0,0.001,0.01,0.768,847,857
14,1804,50,0,0.001,0.01,0.79,903,901
14,1904,50,0,0.001,0.01,0.826,952,952
15,0,50,0,0.001,0.01,0.686,0,0
15,104,50,0,0.001,0.01,0.506,48,56
15,204,50,0,0.001,0.01,0.562,95,109
15,304,50,0,0.001,0.01,0.558,148,156
15,404,50,0,0.001,0.01,0.602,204,200
15,504,50,0,0.001,0.01,0.596,250,254
15,604,50,0,0.001,0.01,0.614,312,292
15,704,50,0,0.001,0.01,0.598,352,352
15,804,50,0,0.001,0.01,0.602,405,399
15,904,50,0,0.001,0.01,0.616,462,442
15,1004,50,0,0.001,0.01,0.656,518,486
15,1104,50,0,0.001,0.01,0.686,560,544
15,1204,50,0,0.001,0.01,0.706,603,601
15,1304,50,0,0.001,0.01,0.694,650,654
15,1404,50,0,0.001,0.01,0.728,698,706
15,1504,50,0,0.001,0.01,0.77,743,761
15,1604,50,0,0.001,0.01,0.802,800,804
15,1704,50,0,0.001,0.01,0.858,849,855
15,1804,50,0,0.001,0.01,0.892,900,904
15,1904,50,0,0.001,0.01,0.912,952,952
16,0,50,0,0.001,0.01,0.658,0,0
16,104,50,0,0.001,0.01,0.5,54,50
16,204,50,0,0.001,0.01,0.502,109,95
16,304,50,0,0.001,0.01,0.608,166,138
16,404,50,0,0.001,0.01,0.646,206,198
16,504,50,0,0.001,0.01,0.616,248,256
16,604,50,0,0.001,0.01,0.654,293,311
16,704,50,0,0.001,0.01,0.652,342,362
16,804,50,0,0.001,0.01,0.684,389,415
16,904,50,0,0.001,0.01,0.724,440,464
16,1004,50,0,0.001,0.01,0.72,488,516
16,1104,50,0,0.001,0.01,0.782,541,563
16,1204,50,0,0.001,0.01,0.81,591,613
16,1304,50,0,0.001,0.01,0.824,638,666
16,1404,50,0,0.001,0.01,0.868,693,711
16,1504,50,0,0.001,0.01,0.892,742,762
16,1604,50,0,0.001,0.01,0.892,790,814
16,1704,50,0,0.001,0.01,0.906,847,857
16,1804,50,0,0.001,0.01,0.932,905,899
16,1904,50,0,0.001,0.01,0.944,952,952
17,0,50,0,0.001,0.01,0.73,0,0
17,104,50,0,0.001,0.01,0.504,37,67
17,204,50,0,0.001,0.01,0.534,80,124
17,304,50,0,0.001,0.01,0.56,134,170
17,404,50,0,0.001,0.01,0.614,178,226
17,504,50,0,0.001,0.01,0.634,228,276
17,604,50,0,0.001,0.01,0.612,276,328
17,704,50,0,0.001,0.01,0.644,328,376
17,804,50,0,0.001,0.01,0.654,376,428
17,904,50,0,0.001,0.01,0.68,426,478
17,1004,50,0,0.001,0.01,0.674,478,526
17,1104,50,0,0.001,0.01,0.688,538,566
17,1204,50,0,0.001,0.01,0.7,593,611
17,1304,50,0,0.001,0.01,0.768,641,663
17,1404,50,0,0.001,0.01,0.796,698,706
17,1504,50,0,0.001,0.01,0.844,748,756
17,1604,50,0,0.001,0.01,0.872,807,797
17,1704,50,0,0.001,0.01,0.914,848,856
17,1804,50,0,0.001,0.01,0.936,900,904
17,1904,50,0,0.001,0.01,0.934,952,952
18,0,50,0,0.001,0.01,0.676,0,0
18,104,50,0,0.001,0.01,0.516,43,61
18,204,50,0,0.001,0.01,0.502,89,115
18,304,50,0,0.001,0.01,0.528,143,161
18,404,50,0,0.001,0.01,0.518,185,219
18,504,50,0,0.001,0.01,0.552,246,258
18,604,50,0,0.001,0.01,0.562,294,310
18,704,50,0,0.001,0.01,0.52,346,358
18,804,50,0,0.001,0.01,0.55,388,416
18,904,50,0,0.001,0.01,0.574,434,470
18,1004,50,0,0.001,0.01,0.568,487,517
18,1104,50,0,0.001,0.01,0.6,532,572
18,1204,50,0,0.001,0.01,0.632,585,619
18,1304,50,0,0.001,0.01,0.69,637,667
18,1404,50,0,0.001,0.01,0.734,693,711
18,1504,50,0,0.001,0.01,0.79,742,762
18,1604,50,0,0.001,0.01,0.858,796,808
18,1704,50,0,0.001,0.01,0.868,847,857
18,1804,50,0,0.001,0.01,0.896,897,907
18,1904,50,0,0.001,0.01,0.896,952,952
19,0,50,0,0.001,0.01,0.58,0,0
19,104,50,0,0.001,0.01,0.528,56,48
19,204,50,0,0.001,0.01,0.582,102,102
19,304,50,0,0.001,0.01,0.524,154,150
19,404,50,0,0.001,0.01,0.52,197,207
19,504,50,0,0.001,0.01,0.548,256,248
19,604,50,0,0.001,0.01,0.544,295,309
19,704,50,0,0.001,0.01,0.534,344,360
19,804,50,0,0.001,0.01,0.516,391,413
19,904,50,0,0.001,0.01,0.54,439,465
19,1004,50,0,0.001,0.01,0.556,490,514
19,1104,50,0,0.001,0.01,0.57,542,562
19,1204,50,0,0.001,0.01,0.564,589,615
19,1304,50,0,0.001,0.01,0.612,647,657
19,1404,50,0,0.001,0.01,0.618,700,704
19,1504,50,0,0.001,0.01,0.654,747,757
19,1604,50,0,0.001,0.01,0.684,802,802
19,1704,50,0,0.001,0.01,0.692,851,853
19,1804,50,0,0.001,0.01,0.714,908,896
19,1904,50,0,0.001,0.01,0.772,952,952
20,0,50,0,0.001,0.01,0.728,0,0
20,104,50,0,0.001,0.01,0.5,52,52
20,204,50,0,0.001,0.01,0.624,104,100
20,304,50,0,0.001,0.01,0.604,153,151
20,404,50,0,0.001,0.01,0.57,195,209
20,504,50,0,0.001,0.01,0.574,250,254
20,604,50,0,0.001,0.01,0.564,298,306
20,704,50,0,0.001,0.01,0.546,343,361
20,804,50,0,0.001,0.01,0.576,403,401
20,904,50,0,0.001,0.01,0.578,452,452
20,1004,50,0,0.001,0.01,0.552,502,502
20,1104,50,0,0.001,0.01,0.592,555,549
20,1204,50,0,0.001,0.01,0.618,600,604
20,1304,50,0,0.001,0.01,0.634,641,663
20,1404,50,0,0.001,0.01,0.656,695,709
20,1504,50,0,0.001,0.01,0.686,742,762
20,1604,50,0,0.001,0.01,0.724,797,807
20,1704,50,0,0.001,0.01,0.76,846,858
20,1804,50,0,0.001,0.01,0.806,892,912
20,1904,50,0,0.001,0.01,0.818,952,952
1,0,100,0,1e-05,0.0001,0.496,0,0
1,104,100,0,1e-05,0.0001,0.494,46,58
1,204,100,0,1e-05,0.0001,0.498,95,109
1,304,100,0,1e-05,0.0001,0.498,156,148
1,404,100,0,1e-05,0.0001,0.5,205,199
1,504,100,0,1e-05,0.0001,0.5,247,257
1,604,100,0,1e-05,0.0001,0.504,292,312
1,704,100,0,1e-05,0.0001,0.5,345,359
1,804,100,0,1e-05,0.0001,0.504,404,400
1,904,100,0,1e-05,0.0001,0.522,450,454
1,1004,100,0,1e-05,0.0001,0.53,503,501
1,1104,100,0,1e-05,0.0001,0.542,552,552
1,1204,100,0,1e-05,0.0001,0.538,608,596
1,1304,100,0,1e-05,0.0001,0.552,660,644
1,1404,100,0,1e-05,0.0001,0.554,714,690
1,1504,100,0,1e-05,0.0001,0.56,760,744
1,1604,100,0,1e-05,0.0001,0.548,813,791
1,1704,100,0,1e-05,0.0001,0.548,860,844
1,1804,100,0,1e-05,0.0001,0.558,905,899
1,1904,100,0,1e-05,0.0001,0.542,952,952
2,0,100,0,1e-05,0.0001,0.512,0,0
2,104,100,0,1e-05,0.0001,0.516,46,58
2,204,100,0,1e-05,0.0001,0.52,97,107
2,304,100,0,1e-05,0.0001,0.516,147,157
2,404,100,0,1e-05,0.0001,0.52,206,198
2,504,100,0,1e-05,0.0001,0.518,255,249
2,604,100,0,1e-05,0.0001,0.518,305,299
2,704,100,0,1e-05,0.0001,0.516,356,348
2,804,100,0,1e-05,0.0001,0.508,409,395
2,904,100,0,1e-05,0.0001,0.502,458,446
2,1004,100,0,1e-05,0.0001,0.512,513,491
2,1104,100,0,1e-05,0.0001,0.504,562,542
2,1204,100,0,1e-05,0.0001,0.498,617,587
2,1304,100,0,1e-05,0.0001,0.49,671,633
2,1404,100,0,1e-05,0.0001,0.498,718,686
2,1504,100,0,1e-05,0.0001,0.502,763,741
2,1604,100,0,1e-05,0.0001,0.506,802,802
2,1704,100,0,1e-05,0.0001,0.488,852,852
2,1804,100,0,1e-05,0.0001,0.506,902,902
2,1904,100,0,1e-05,0.0001,0.524,952,952
3,0,100,0,1e-05,0.0001,0.532,0,0
3,104,100,0,1e-05,0.0001,0.53,47,57
3,204,100,0,1e-05,0.0001,0.526,95,109
3,304,100,0,1e-05,0.0001,0.524,150,154
3,404,100,0,1e-05,0.0001,0.524,194,210
3,504,100,0,1e-05,0.0001,0.526,248,256
3,604,100,0,1e-05,0.0001,0.53,295,309
3,704,100,0,1e-05,0.0001,0.542,350,354
3,804,100,0,1e-05,0.0001,0.548,388,416
3,904,100,0,1e-05,0.0001,0.524,433,471
3,1004,100,0,1e-05,0.0001,0.532,487,517
3,1104,100,0,1e-05,0.0001,0.534,541,563
3,1204,100,0,1e-05,0.0001,0.548,593,611
3,1304,100,0,1e-05,0.0001,0.548,642,662
3,1404,100,0,1e-05,0.0001,0.542,694,710
3,1504,100,0,1e-05,0.0001,0.546,747,757
3,1604,100,0,1e-05,0.0001,0.546,802,802
3,1704,100,0,1e-05,0.0001,0.534,855,849
3,1804,100,0,1e-05,0.0001,0.536,905,899
3,1904,100,0,1e-05,0.0001,0.54,952,952
4,0,100,0,1e-05,0.0001,0.5,0,0
4,104,100,0,1e-05,0.0001,0.502,52,52
4,204,100,0,1e-05,0.0001,0.502,108,96
4,304,100,0,1e-05,0.0001,0.5,158,146
4,404,100,0,1e-05,0.0001,0.5,208,196
4,504,100,0,1e-05,0.0001,0.502,260,244
4,604,100,0,1e-05,0.0001,0.504,314,290
4,704,100,0,1e-05,0.0001,0.514,361,343
4,804,100,0,1e-05,0.0001,0.532,415,389
4,904,100,0,1e-05,0.0001,0.544,461,443
4,1004,100,0,1e-05,0.0001,0.536,506,498
4,1104,100,0,1e-05,0.0001,0.526,557,547
4,1204,100,0,1e-05,0.0001,0.518,601,603
4,1304,100,0,1e-05,0.0001,0.528,643,661
4,1404,100,0,1e-05,0.0001,0.532,690,714
4,1504,100,0,1e-05,0.0001,0.54,748,756
4,1604,100,0,1e-05,0.0001,0.536,799,805
4,1704,100,0,1e-05,0.0001,0.536,850,854
4,1804,100,0,1e-05,0.0001,0.532,904,900
4,1904,100,0,1e-05,0.0001,0.534,952,952
5,0,100,0,1e-05,0.0001,0.522,0,0
5,104,100,0,1e-05,0.0001,0.522,54,50
5,204,100,0,1e-05,0.0001,0.524,107,97
5,304,100,0,1e-05,0.0001,0.528,160,144
5,404,100,0,1e-05,0.0001,0.54,216,188
5,504,100,0,1e-05,0.0001,0.546,263,241
5,604,100,0,1e-05,0.0001,0.546,306,298
5,704,100,0,1e-05,0.0001,0.544,349,355
5,804,100,0,1e-05,0.0001,0.54,407,397
5,904,100,0,1e-05,0.0001,0.544,456,448
5,1004,100,0,1e-05,0.0001,0.554,504,500
5,1104,100,0,1e-05,0.0001,0.554,556,548
5,1204,100,0,1e-05,0.0001,0.55,602,602
5,1304,100,0,1e-05,0.0001,0.55,656,648
5,1404,100,0,1e-05,0.0001,0.544,713,691
5,1504,100,0,1e-05,0.0001,0.538,762,742
5,1604,100,0,1e-05,0.0001,0.54,812,792
5,1704,100,0,1e-05,0.0001,0.538,857,847
5,1804,100,0,1e-05,0.0001,0.536,903,901
5,1904,100,0,1e-05,0.0001,0.532,952,952
6,0,100,0,1e-05,0.0001,0.524,0,0
6,104,100,0,1e-05,0.0001,0.522,54,50
6,204,100,0,1e-05,0.0001,0.518,111,93
6,304,100,0,1e-05,0.0001,0.518,154,150
6,404,100,0,1e-05,0.0001,0.51,208,196
6,504,100,0,1e-05,0.0001,0.504,262,242
6,604,100,0,1e-05,0.0001,0.498,317,287
6,704,100,0,1e-05,0.0001,0.506,360,344
6,804,100,0,1e-05,0.0001,0.51,410,394
6,904,100,0,1e-05,0.0001,0.502,453,451
6,1004,100,0,1e-05,0.0001,0.508,497,507
6,1104,100,0,1e-05,0.0001,0.518,547,557
6,1204,100,0,1e-05,0.0001,0.508,601,603
6,1304,100,0,1e-05,0.0001,0.52,655,649
6,1404,100,0,1e-05,0.0001,0.514,711,693
6,1504,100,0,1e-05,0.0001,0.526,761,743
6,1604,100,0,1e-05,0.0001,0.534,810,794
6,1704,100,0,1e-05,0.0001,0.524,860,844
6,1804,100,0,1e-05,0.0001,0.518,909,895
6,1904,100,0,1e-05,0.0001,0.524,952,952
7,0,100,0,1e-05,0.0001,0.502,0,0
7,104,100,0,1e-05,0.0001,0.5,50,54
7,204,100,0,1e-05,0.0001,0.502,104,100
7,304,100,0,1e-05,0.0001,0.504,159,145
7,404,100,0,1e-05,0.0001,0.506,213,191
7,504,100,0,1e-05,0.0001,0.522,255,249
7,604,100,0,1e-05,0.0001,0.506,303,301
7,704,100,0,1e-05,0.0001,0.512,355,349
7,804,100,0,1e-05,0.0001,0.502,404,400
7,904,100,0,1e-05,0.0001,0.508,453,451
7,1004,100,0,1e-05,0.0001,0.504,504,500
7,1104,100,0,1e-05,0.0001,0.508,546,558
7,1204,100,0,1e-05,0.0001,0.514,590,614
7,1304,100,0,1e-05,0.0001,0.518,644,660
7,1404,100,0,1e-05,0.0001,0.502,691,713
7,1504,100,0,1e-05,0.0001,0.5,747,757
7,1604,100,0,1e-05,0.0001,0.506,799,805
7,1704,100,0,1e-05,0.0001,0.51,850,854
7,1804,100,0,1e-05,0.0001,0.508,898,906
7,1904,100,0,1e-05,0.0001,0.512,952,952
8,0,100,0,1e-05,0.0001,0.506,0,0
8,104,100,0,1e-05,0.0001,0.506,46,58
8,204,100,0,1e-05,0.0001,0.506,102,102
8,304,100,0,1e-05,0.0001,0.506,143,161
8,404,100,0,1e-05,0.0001,0.506,202,202
8,504,100,0,1e-05,0.0001,0.506,246,258
8,604,100,0,1e-05,0.0001,0.506,301,303
8,704,100,0,1e-05,0.0001,0.506,357,347
8,804,100,0,1e-05,0.0001,0.51,400,404
8,904,100,0,1e-05,0.0001,0.504,453,451
8,1004,100,0,1e-05,0.0001,0.486,506,498
8,1104,100,0,1e-05,0.0001,0.482,552,552
8,1204,100,0,1e-05,0.0001,0.484,604,600
8,1304,100,0,1e-05,0.0001,0.482,657,647
8,1404,100,0,1e-05,0.0001,0.488,703,701
8,1504,100,0,1e-05,0.0001,0.49,756,748
8,1604,100,0,1e-05,0.0001,0.468,802,802
8,1704,100,0,1e-05,0.0001,0.462,848,856
8,1804,100,0,1e-05,0.0001,0.462,903,901
8,1904,100,0,1e-05,0.0001,0.474,952,952
9,0,100,0,1e-05,0.0001,0.492,0,0
9,104,100,0,1e-05,0.0001,0.49,54,50
9,204,100,0,1e-05,0.0001,0.49,99,105
9,304,100,0,1e-05,0.0001,0.49,146,158
9,404,100,0,1e-05,0.0001,0.492,189,215
9,504,100,0,1e-05,0.0001,0.488,232,272
9,604,100,0,1e-05,0.0001,0.486,282,322
9,704,100,0,1e-05,0.0001,0.502,325,379
9,804,100,0,1e-05,0.0001,0.512,374,430
9,904,100,0,1e-05,0.0001,0.504,428,476
9,1004,100,0,1e-05,0.0001,0.506,485,519
9,1104,100,0,1e-05,0.0001,0.502,531,573
9,1204,100,0,1e-05,0.0001,0.502,585,619
9,1304,100,0,1e-05,0.0001,0.5,631,673
9,1404,100,0,1e-05,0.0001,0.508,693,711
9,1504,100,0,1e-05,0.0001,0.508,748,756
9,1604,100,0,1e-05,0.0001,0.492,802,802
9,1704,100,0,1e-05,0.0001,0.482,854,850
9,1804,100,0,1e-05,0.0001,0.49,909,895
9,1904,100,0,1e-05,0.0001,0.486,952,952
10,0,100,0,1e-05,0.0001,0.522,0,0
10,104,100,0,1e-05,0.0001,0.522,53,51
10,204,100,0,1e-05,0.0001,0.52,100,104
10,304,100,0,1e-05,0.0001,0.524,152,152
10,404,100,0,1e-05,0.0001,0.528,197,207
10,504,100,0,1e-05,0.0001,0.548,245,259
10,604,100,0,1e-05,0.0001,0.556,300,304
10,704,100,0,1e-05,0.0001,0.548,348,356
10,804,100,0,1e-05,0.0001,0.552,410,394
10,904,100,0,1e-05,0.0001,0.54,458,446
10,1004,100,0,1e-05,0.0001,0.538,509,495
10,1104,100,0,1e-05,0.0001,0.542,554,550
10,1204,100,0,1e-05,0.0001,0.54,610,594
10,1304,100,0,1e-05,0.0001,0.544,656,648
10,1404,100,0,1e-05,0.0001,0.546,698,706
10,1504,100,0,1e-05,0.0001,0.53,749,755
10,1604,100,0,1e-05,0.0001,0.53,797,807
10,1704,100,0,1e-05,0.0001,0.53,850,854
10,1804,100,0,1e-05,0.0001,0.532,898,906
10,1904,100,0,1e-05,0.0001,0.53,952,952
11,0,100,0,1e-05,0.0001,0.51,0,0
11,104,100,0,1e-05,0.0001,0.514,49,55
11,204,100,0,1e-05,0.0001,0.514,107,97
11,304,100,0,1e-05,0.0001,0.52,156,148
11,404,100,0,1e-05,0.0001,0.516,211,193
11,504,100,0,1e-05,0.0001,0.498,256,248
11,604,100,0,1e-05,0.0001,0.502,300,304
11,704,100,0,1e-05,0.0001,0.504,352,352
11,804,100,0,1e-05,0.0001,0.508,402,402
11,904,100,0,1e-05,0.0001,0.51,457,447
11,1004,100,0,1e-05,0.0001,0.504,512,492
11,1104,100,0,1e-05,0.0001,0.512,555,549
11,1204,100,0,1e-05,0.0001,0.508,597,607
11,1304,100,0,1e-05,0.0001,0.512,650,654
11,1404,100,0,1e-05,0.0001,0.514,701,703
11,1504,100,0,1e-05,0.0001,0.524,757,747
11,1604,100,0,1e-05,0.0001,0.52,803,801
11,1704,100,0,1e-05,0.0001,0.516,857,847
11,1804,100,0,1e-05,0.0001,0.508,905,899
11,1904,100,0,1e-05,0.0001,0.504,952,952
12,0,100,0,1e-05,0.0001,0.52,0,0
12,104,100,0,1e-05,0.0001,0.518,46,58
12,204,100,0,1e-05,0.0001,0.518,100,104
12,304,100,0,1e-05,0.0001,0.528,147,157
12,404,100,0,1e-05,0.0001,0.524,207,197
12,504,100,0,1e-05,0.0001,0.516,266,238
12,604,100,0,1e-05,0.0001,0.506,322,282
12,704,100,0,1e-05,0.0001,0.532,370,334
12,804,100,0,1e-05,0.0001,0.538,414,390
12,904,100,0,1e-05,0.0001,0.53,463,441
12,1004,100,0,1e-05,0.0001,0.536,518,486
12,1104,100,0,1e-05,0.0001,0.532,557,547
12,1204,100,0,1e-05,0.0001,0.52,603,601
12,1304,100,0,1e-05,0.0001,0.526,660,644
12,1404,100,0,1e-05,0.0001,0.53,710,694
12,1504,100,0,1e-05,0.0001,0.532,764,740
12,1604,100,0,1e-05,0.0001,0.526,814,790
12,1704,100,0,1e-05,0.0001,0.528,864,840
12,1804,100,0,1e-05,0.0001,0.52,907,897
12,1904,100,0,1e-05,0.0001,0.522,952,952
13,0,100,0,1e-05,0.0001,0.462,0,0
13,104,100,0,1e-05,0.0001,0.464,63,41
13,204,100,0,1e-05,0.0001,0.464,114,90
13,304,100,0,1e-05,0.0001,0.464,165,139
13,404,100,0,1e-05,0.0001,0.476,215,189
13,504,100,0,1e-05,0.0001,0.492,258,246
13,604,100,0,1e-05,0.0001,0.476,308,296
13,704,100,0,1e-05,0.0001,0.484,344,360
13,804,100,0,1e-05,0.0001,0.486,392,412
13,904,100,0,1e-05,0.0001,0.482,436,468
13,1004,100,0,1e-05,0.0001,0.494,477,527
13,1104,100,0,1e-05,0.0001,0.494,523,581
13,1204,100,0,1e-05,0.0001,0.496,579,625
13,1304,100,0,1e-05,0.0001,0.49,631,673
13,1404,100,0,1e-05,0.0001,0.496,679,725
13,1504,100,0,1e-05,0.0001,0.494,726,778
13,1604,100,0,1e-05,0.0001,0.504,789,815
13,1704,100,0,1e-05,0.0001,0.506,839,865
13,1804,100,0,1e-05,0.0001,0.52,898,906
13,1904,100,0,1e-05,0.0001,0.528,952,952
14,0,100,0,1e-05,0.0001,0.524,0,0
14,104,100,0,1e-05,0.0001,0.522,51,53
14,204,100,0,1e-05,0.0001,0.516,107,97
14,304,100,0,1e-05,0.0001,0.516,157,147
14,404,100,0,1e-05,0.0001,0.508,208,196
14,504,100,0,1e-05,0.0001,0.51,255,249
14,604,100,0,1e-05,0.0001,0.502,303,301
14,704,100,0,1e-05,0.0001,0.506,350,354
14,804,100,0,1e-05,0.0001,0.514,395,409
14,904,100,0,1e-05,0.0001,0.52,444,460
14,1004,100,0,1e-05,0.0001,0.548,484,520
14,1104,100,0,1e-05,0.0001,0.552,539,565
14,1204,100,0,1e-05,0.0001,0.54,587,617
14,1304,100,0,1e-05,0.0001,0.544,640,664
14,1404,100,0,1e-05,0.0001,0.548,688,716
14,1504,100,0,1e-05,0.0001,0.536,734,770
14,1604,100,0,1e-05,0.0001,0.536,788,816
14,1704,100,0,1e-05,0.0001,0.538,845,859
14,1804,100,0,1e-05,0.0001,0.536,893,911
14,1904,100,0,1e-05,0.0001,0.554,952,952
15,0,100,0,1e-05,0.0001,0.488,0,0
15,104,100,0,1e-05,0.0001,0.484,45,59
15,204,100,0,1e-05,0.0001,0.482,102,102
15,304,100,0,1e-05,0.0001,0.484,156,148
15,404,100,0,1e-05,0.0001,0.496,217,187
15,504,100,0,1e-05,0.0001,0.504,264,240
15,604,100,0,1e-05,0.0001,0.512,309,295
15,704,100,0,1e-05,0.0001,0.512,361,343
15,804,100,0,1e-05,0.0001,0.516,412,392
15,904,100,0,1e-05,0.0001,0.51,464,440
15,1004,100,0,1e-05,0.0001,0.51,521,483
15,1104,100,0,1e-05,0.0001,0.514,569,535
15,1204,100,0,1e-05,0.0001,0.516,620,584
15,1304,100,0,1e-05,0.0001,0.524,668,636
15,1404,100,0,1e-05,0.0001,0.516,719,685
15,1504,100,0,1e-05,0.0001,0.508,761,743
15,1604,100,0,1e-05,0.0001,0.508,808,796
15,1704,100,0,1e-05,0.0001,0.492,856,848
15,1804,100,0,1e-05,0.0001,0.498,904,900
15,1904,100,0,1e-05,0.0001,0.498,952,952
16,0,100,0,1e-05,0.0001,0.516,0,0
16,104,100,0,1e-05,0.0001,0.516,54,50
16,204,100,0,1e-05,0.0001,0.518,105,99
16,304,100,0,1e-05,0.0001,0.534,160,144
16,404,100,0,1e-05,0.0001,0.53,211,193
16,504,100,0,1e-05,0.0001,0.534,258,246
16,604,100,0,1e-05,0.0001,0.53,303,301
16,704,100,0,1e-05,0.0001,0.528,357,347
16,804,100,0,1e-05,0.0001,0.53,415,389
16,904,100,0,1e-05,0.0001,0.526,468,436
16,1004,100,0,1e-05,0.0001,0.53,516,488
16,1104,100,0,1e-05,0.0001,0.536,566,538
16,1204,100,0,1e-05,0.0001,0.524,622,582
16,1304,100,0,1e-05,0.0001,0.536,673,631
16,1404,100,0,1e-05,0.0001,0.534,717,687
16,1504,100,0,1e-05,0.0001,0.534,765,739
16,1604,100,0,1e-05,0.0001,0.52,813,791
16,1704,100,0,1e-05,0.0001,0.524,857,847
16,1804,100,0,1e-05,0.0001,0.534,909,895
16,1904,100,0,1e-05,0.0001,0.522,952,952
17,0,100,0,1e-05,0.0001,0.5,0,0
17,104,100,0,1e-05,0.0001,0.5,43,61
17,204,100,0,1e-05,0.0001,0.5,93,111
17,304,100,0,1e-05,0.0001,0.498,143,161
17,404,100,0,1e-05,0.0001,0.5,199,205
17,504,100,0,1e-05,0.0001,0.498,253,251
17,604,100,0,1e-05,0.0001,0.51,298,306
17,704,100,0,1e-05,0.0001,0.512,350,354
17,804,100,0,1e-05,0.0001,0.516,407,397
17,904,100,0,1e-05,0.0001,0.52,454,450
17,1004,100,0,1e-05,0.0001,0.528,501,503
17,1104,100,0,1e-05,0.0001,0.528,550,554
17,1204,100,0,1e-05,0.0001,0.538,601,603
17,1304,100,0,1e-05,0.0001,0.538,654,650
17,1404,100,0,1e-05,0.0001,0.53,702,702
17,1504,100,0,1e-05,0.0001,0.534,750,754
17,1604,100,0,1e-05,0.0001,0.534,800,804
17,1704,100,0,1e-05,0.0001,0.532,850,854
17,1804,100,0,1e-05,0.0001,0.532,903,901
17,1904,100,0,1e-05,0.0001,0.538,952,952
18,0,100,0,1e-05,0.0001,0.502,0,0
18,104,100,0,1e-05,0.0001,0.502,59,45
18,204,100,0,1e-05,0.0001,0.502,120,84
18,304,100,0,1e-05,0.0001,0.504,164,140
18,404,100,0,1e-05,0.0001,0.512,209,195
18,504,100,0,1e-05,0.0001,0.516,254,250
18,604,100,0,1e-05,0.0001,0.518,298,306
18,704,100,0,1e-05,0.0001,0.514,355,349
18,804,100,0,1e-05,0.0001,0.518,399,405
18,904,100,0,1e-05,0.0001,0.524,450,454
18,1004,100,0,1e-05,0.0001,0.512,502,502
18,1104,100,0,1e-05,0.0001,0.522,550,554
18,1204,100,0,1e-05,0.0001,0.534,597,607
18,1304,100,0,1e-05,0.0001,0.53,647,657
18,1404,100,0,1e-05,0.0001,0.518,700,704
18,1504,100,0,1e-05,0.0001,0.508,746,758
18,1604,100,0,1e-05,0.0001,0.512,802,802
18,1704,100,0,1e-05,0.0001,0.508,856,848
18,1804,100,0,1e-05,0.0001,0.506,907,897
18,1904,100,0,1e-05,0.0001,0.514,952,952
19,0,100,0,1e-05,0.0001,0.512,0,0
19,104,100,0,1e-05,0.0001,0.512,49,55
19,204,100,0,1e-05,0.0001,0.514,94,110
19,304,100,0,1e-05,0.0001,0.516,146,158
19,404,100,0,1e-05,0.0001,0.52,199,205
19,504,100,0,1e-05,0.0001,0.522,249,255
19,604,100,0,1e-05,0.0001,0.534,296,308
19,704,100,0,1e-05,0.0001,0.532,353,351
19,804,100,0,1e-05,0.0001,0.536,402,402
19,904,100,0,1e-05,0.0001,0.53,448,456
19,1004,100,0,1e-05,0.0001,0.51,504,500
19,1104,100,0,1e-05,0.0001,0.496,551,553
19,1204,100,0,1e-05,0.0001,0.486,603,601
19,1304,100,0,1e-05,0.0001,0.496,656,648
19,1404,100,0,1e-05,0.0001,0.494,706,698
19,1504,100,0,1e-05,0.0001,0.49,754,750
19,1604,100,0,1e-05,0.0001,0.502,801,803
19,1704,100,0,1e-05,0.0001,0.494,847,857
19,1804,100,0,1e-05,0.0001,0.494,908,896
19,1904,100,0,1e-05,0.0001,0.494,952,952
20,0,100,0,1e-05,0.0001,0.51,0,0
20,104,100,0,1e-05,0.0001,0.512,52,52
20,204,100,0,1e-05,0.0001,0.508,104,100
20,304,100,0,1e-05,0.0001,0.508,147,157
20,404,100,0,1e-05,0.0001,0.504,195,209
20,504,100,0,1e-05,0.0001,0.502,239,265
20,604,100,0,1e-05,0.0001,0.494,293,311
20,704,100,0,1e-05,0.0001,0.498,338,366
20,804,100,0,1e-05,0.0001,0.494,385,419
20,904,100,0,1e-05,0.0001,0.492,438,466
20,1004,100,0,1e-05,0.0001,0.498,485,519
20,1104,100,0,1e-05,0.0001,0.498,541,563
20,1204,100,0,1e-05,0.0001,0.502,591,613
20,1304,100,0,1e-05,0.0001,0.498,646,658
20,1404,100,0,1e-05,0.0001,0.502,694,710
20,1504,100,0,1e-05,0.0001,0.504,738,766
20,1604,100,0,1e-05,0.0001,0.506,791,813
20,1704,100,0,1e-05,0.0001,0.504,850,854
20,1804,100,0,1e-05,0.0001,0.516,899,905
20,1904,100,0,1e-05,0.0001,0.516,952,952
1,0,100,0,1e-05,0.001,0.5,0,0
1,104,100,0,1e-05,0.001,0.512,51,53
1,204,100,0,1e-05,0.001,0.532,105,99
1,304,100,0,1e-05,0.001,0.546,158,146
1,404,100,0,1e-05,0.001,0.582,208,196
1,504,100,0,1e-05,0.001,0.656,256,248
1,604,100,0,1e-05,0.001,0.664,298,306
1,704,100,0,1e-05,0.001,0.738,345,359
1,804,100,0,1e-05,0.001,0.756,394,410
1,904,100,0,1e-05,0.001,0.852,445,459
1,1004,100,0,1e-05,0.001,0.886,495,509
1,1104,100,0,1e-05,0.001,0.908,545,559
1,1204,100,0,1e-05,0.001,0.952,588,616
1,1304,100,0,1e-05,0.001,0.964,643,661
1,1404,100,0,1e-05,0.001,0.986,694,710
1,1504,100,0,1e-05,0.001,0.992,742,762
1,1604,100,0,1e-05,0.001,0.994,797,807
1,1704,100,0,1e-05,0.001,0.994,846,858
1,1804,100,0,1e-05,0.001,0.996,895,909
1,1904,100,0,1e-05,0.001,1.0,952,952
2,0,100,0,1e-05,0.001,0.5,0,0
2,104,100,0,1e-05,0.001,0.51,49,55
2,204,100,0,1e-05,0.001,0.546,103,101
2,304,100,0,1e-05,0.001,0.558,157,147
2,404,100,0,1e-05,0.001,0.564,209,195
2,504,100,0,1e-05,0.001,0.684,260,244
2,604,100,0,1e-05,0.001,0.686,313,291
2,704,100,0,1e-05,0.001,0.764,357,347
2,804,100,0,1e-05,0.001,0.816,407,397
2,904,100,0,1e-05,0.001,0.852,463,441
2,1004,100,0,1e-05,0.001,0.9,518,486
2,1104,100,0,1e-05,0.001,0.93,565,539
2,1204,100,0,1e-05,0.001,0.966,607,597
2,1304,100,0,1e-05,0.001,0.968,646,658
2,1404,100,0,1e-05,0.001,0.976,695,709
2,1504,100,0,1e-05,0.001,0.988,741,763
2,1604,100,0,1e-05,0.001,0.992,799,805
2,1704,100,0,1e-05,0.001,0.992,849,855
2,1804,100,0,1e-05,0.001,0.994,900,904
2,1904,100,0,1e-05,0.001,0.994,952,952
3,0,100,0,1e-05,0.001,0.502,0,0
3,104,100,0,1e-05,0.001,0.54,43,61
3,204,100,0,1e-05,0.001,0.57,93,111
3,304,100,0,1e-05,0.001,0.704,146,158
3,404,100,0,1e-05,0.001,0.636,194,210
3,504,100,0,1e-05,0.001,0.726,242,262
3,604,100,0,1e-05,0.001,0.79,280,324
3,704,100,0,1e-05,0.001,0.848,337,367
3,804,100,0,1e-05,0.001,0.868,392,412
3,904,100,0,1e-05,0.001,0.9,443,461
3,1004,100,0,1e-05,0.001,0.912,501,503
3,1104,100,0,1e-05,0.001,0.934,549,555
3,1204,100,0,1e-05,0.001,0.966,599,605
3,1304,100,0,1e-05,0.001,0.974,650,654
3,1404,100,0,1e-05,0.001,0.984,700,704
3,1504,100,0,1e-05,0.001,0.984,751,753
3,1604,100,0,1e-05,0.001,0.988,806,798
3,1704,100,0,1e-05,0.001,0.994,853,851
3,1804,100,0,1e-05,0.001,0.996,904,900
3,1904,100,0,1e-05,0.001,0.996,952,952
4,0,100,0,1e-05,0.001,0.502,0,0
4,104,100,0,1e-05,0.001,0.526,56,48
4,204,100,0,1e-05,0.001,0.506,113,91
4,304,100,0,1e-05,0.001,0.536,161,143
4,404,100,0,1e-05,0.001,0.58,210,194
4,504,100,0,1e-05,0.001,0.698,257,247
4,604,100,0,1e-05,0.001,0.654,304,300
4,704,100,0,1e-05,0.001,0.73,355,349
4,804,100,0,1e-05,0.001,0.792,407,397
4,904,100,0,1e-05,0.001,0.834,456,448
4,1004,100,0,1e-05,0.001,0.858,500,504
4,1104,100,0,1e-05,0.001,0.888,545,559
4,1204,100,0,1e-05,0.001,0.936,594,610
4,1304,100,0,1e-05,0.001,0.944,648,656
4,1404,100,0,1e-05,0.001,0.952,705,699
4,1504,100,0,1e-05,0.001,0.966,747,757
4,1604,100,0,1e-05,0.001,0.972,797,807
4,1704,100,0,1e-05,0.001,0.99,853,851
4,1804,100,0,1e-05,0.001,0.992,900,904
4,1904,100,0,1e-05,0.001,0.992,952,952
5,0,100,0,1e-05,0.001,0.5,0,0
5,104,100,0,1e-05,0.001,0.522,52,52
5,204,100,0,1e-05,0.001,0.536,104,100
5,304,100,0,1e-05,0.001,0.63,151,153
5,404,100,0,1e-05,0.001,0.556,199,205
5,504,100,0,1e-05,0.001,0.698,245,259
5,604,100,0,1e-05,0.001,0.73,294,310
5,704,100,0,1e-05,0.001,0.732,346,358
5,804,100,0,1e-05,0.001,0.822,396,408
5,904,100,0,1e-05,0.001,0.844,451,453
5,1004,100,0,1e-05,0.001,0.906,506,498
5,1104,100,0,1e-05,0.001,0.918,553,551
5,1204,100,0,1e-05,0.001,0.958,609,595
5,1304,100,0,1e-05,0.001,0.97,661,643
5,1404,100,0,1e-05,0.001,0.98,709,695
5,1504,100,0,1e-05,0.001,0.98,760,744
5,1604,100,0,1e-05,0.001,0.982,813,791
5,1704,100,0,1e-05,0.001,0.988,856,848
5,1804,100,0,1e-05,0.001,0.992,909,895
5,1904,100,0,1e-05,0.001,0.996,952,952
6,0,100,0,1e-05,0.001,0.506,0,0
6,104,100,0,1e-05,0.001,0.572,58,46
6,204,100,0,1e-05,0.001,0.524,105,99
6,304,100,0,1e-05,0.001,0.7,159,145
6,404,100,0,1e-05,0.001,0.596,195,209
6,504,100,0,1e-05,0.001,0.722,246,258
6,604,100,0,1e-05,0.001,0.79,291,313
6,704,100,0,1e-05,0.001,0.792,342,362
6,804,100,0,1e-05,0.001,0.84,396,408
6,904,100,0,1e-05,0.001,0.886,447,457
6,1004,100,0,1e-05,0.001,0.9,500,504
6,1104,100,0,1e-05,0.001,0.932,557,547
6,1204,100,0,1e-05,0.001,0.95,612,592
6,1304,100,0,1e-05,0.001,0.958,662,642
6,1404,100,0,1e-05,0.001,0.97,712,692
6,1504,100,0,1e-05,0.001,0.974,761,743
6,1604,100,0,1e-05,0.001,0.99,804,800
6,1704,100,0,1e-05,0.001,0.988,845,859
6,1804,100,0,1e-05,0.001,0.99,901,903
6,1904,100,0,1e-05,0.001,0.992,952,952
7,0,100,0,1e-05,0.001,0.5,0,0
7,104,100,0,1e-05,0.001,0.566,58,46
7,204,100,0,1e-05,0.001,0.524,101,103
7,304,100,0,1e-05,0.001,0.696,152,152
7,404,100,0,1e-05,0.001,0.636,204,200
7,504,100,0,1e-05,0.001,0.714,254,250
7,604,100,0,1e-05,0.001,0.794,310,294
7,704,100,0,1e-05,0.001,0.796,358,346
7,804,100,0,1e-05,0.001,0.85,403,401
7,904,100,0,1e-05,0.001,0.916,459,445
7,1004,100,0,1e-05,0.001,0.936,504,500
7,1104,100,0,1e-05,0.001,0.952,560,544
7,1204,100,0,1e-05,0.001,0.958,607,597
7,1304,100,0,1e-05,0.001,0.964,660,644
7,1404,100,0,1e-05,0.001,0.972,714,690
7,1504,100,0,1e-05,0.001,0.984,761,743
7,1604,100,0,1e-05,0.001,0.988,807,797
7,1704,100,0,1e-05,0.001,0.992,853,851
7,1804,100,0,1e-05,0.001,0.996,905,899
7,1904,100,0,1e-05,0.001,0.998,952,952
8,0,100,0,1e-05,0.001,0.5,0,0
8,104,100,0,1e-05,0.001,0.522,51,53
8,204,100,0,1e-05,0.001,0.5,102,102
8,304,100,0,1e-05,0.001,0.612,152,152
8,404,100,0,1e-05,0.001,0.536,200,204
8,504,100,0,1e-05,0.001,0.622,264,240
8,604,100,0,1e-05,0.001,0.656,317,287
8,704,100,0,1e-05,0.001,0.7,365,339
8,804,100,0,1e-05,0.001,0.742,415,389
8,904,100,0,1e-05,0.001,0.78,467,437
8,1004,100,0,1e-05,0.001,0.834,518,486
8,1104,100,0,1e-05,0.001,0.876,565,539
8,1204,100,0,1e-05,0.001,0.914,623,581
8,1304,100,0,1e-05,0.001,0.936,666,638
8,1404,100,0,1e-05,0.001,0.95,715,689
8,1504,100,0,1e-05,0.001,0.968,754,750
8,1604,100,0,1e-05,0.001,0.974,807,797
8,1704,100,0,1e-05,0.001,0.982,851,853
8,1804,100,0,1e-05,0.001,0.986,904,900
8,1904,100,0,1e-05,0.001,0.988,952,952
9,0,100,0,1e-05,0.001,0.5,0,0
9,104,100,0,1e-05,0.001,0.52,51,53
9,204,100,0,1e-05,0.001,0.544,100,104
9,304,100,0,1e-05,0.001,0.662,156,148
9,404,100,0,1e-05,0.001,0.59,215,189
9,504,100,0,1e-05,0.001,0.772,265,239
9,604,100,0,1e-05,0.001,0.774,316,288
9,704,100,0,1e-05,0.001,0.814,368,336
9,804,100,0,1e-05,0.001,0.844,414,390
9,904,100,0,1e-05,0.001,0.9,458,446
9,1004,100,0,1e-05,0.001,0.93,498,506
9,1104,100,0,1e-05,0.001,0.948,545,559
9,1204,100,0,1e-05,0.001,0.964,603,601
9,1304,100,0,1e-05,0.001,0.97,651,653
9,1404,100,0,1e-05,0.001,0.974,698,706
9,1504,100,0,1e-05,0.001,0.978,745,759
9,1604,100,0,1e-05,0.001,0.982,801,803
9,1704,100,0,1e-05,0.001,0.988,853,851
9,1804,100,0,1e-05,0.001,0.99,907,897
9,1904,100,0,1e-05,0.001,0.994,952,952
10,0,100,0,1e-05,0.001,0.51,0,0
10,104,100,0,1e-05,0.001,0.556,48,56
10,204,100,0,1e-05,0.001,0.524,107,97
10,304,100,0,1e-05,0.001,0.632,153,151
10,404,100,0,1e-05,0.001,0.594,206,198
10,504,100,0,1e-05,0.001,0.65,253,251
10,604,100,0,1e-05,0.001,0.692,299,305
10,704,100,0,1e-05,0.001,0.744,346,358
10,804,100,0,1e-05,0.001,0.796,395,409
10,904,100,0,1e-05,0.001,0.832,450,454
10,1004,100,0,1e-05,0.001,0.876,500,504
10,1104,100,0,1e-05,0.001,0.91,549,555
10,1204,100,0,1e-05,0.001,0.93,598,606
10,1304,100,0,1e-05,0.001,0.958,648,656
10,1404,100,0,1e-05,0.001,0.976,687,717
10,1504,100,0,1e-05,0.001,0.988,739,765
10,1604,100,0,1e-05,0.001,0.992,796,808
10,1704,100,0,1e-05,0.001,0.994,846,858
10,1804,100,0,1e-05,0.001,0.996,896,908
10,1904,100,0,1e-05,0.001,0.996,952,952
11,0,100,0,1e-05,0.001,0.504,0,0
11,104,100,0,1e-05,0.001,0.536,62,42
11,204,100,0,1e-05,0.001,0.55,119,85
11,304,100,0,1e-05,0.001,0.53,173,131
11,404,100,0,1e-05,0.001,0.588,215,189
11,504,100,0,1e-05,0.001,0.706,257,247
11,604,100,0,1e-05,0.001,0.728,317,287
11,704,100,0,1e-05,0.001,0.882,363,341
11,804,100,0,1e-05,0.001,0.882,410,394
11,904,100,0,1e-05,0.001,0.906,463,441
11,1004,100,0,1e-05,0.001,0.952,510,494
11,1104,100,0,1e-05,0.001,0.962,560,544
11,1204,100,0,1e-05,0.001,0.962,614,590
11,1304,100,0,1e-05,0.001,0.978,662,642
11,1404,100,0,1e-05,0.001,0.984,709,695
11,1504,100,0,1e-05,0.001,0.988,750,754
11,1604,100,0,1e-05,0.001,0.994,799,805
11,1704,100,0,1e-05,0.001,0.994,851,853
11,1804,100,0,1e-05,0.001,0.998,899,905
11,1904,100,0,1e-05,0.001,0.998,952,952
12,0,100,0,1e-05,0.001,0.502,0,0
12,104,100,0,1e-05,0.001,0.552,54,50
12,204,100,0,1e-05,0.001,0.52,110,94
12,304,100,0,1e-05,0.001,0.646,154,150
12,404,100,0,1e-05,0.001,0.57,207,197
12,504,100,0,1e-05,0.001,0.702,261,243
12,604,100,0,1e-05,0.001,0.734,305,299
12,704,100,0,1e-05,0.001,0.742,358,346
12,804,100,0,1e-05,0.001,0.822,408,396
12,904,100,0,1e-05,0.001,0.874,452,452
12,1004,100,0,1e-05,0.001,0.908,496,508
12,1104,100,0,1e-05,0.001,0.936,544,560
12,1204,100,0,1e-05,0.001,0.966,594,610
12,1304,100,0,1e-05,0.001,0.982,640,664
12,1404,100,0,1e-05,0.001,0.99,695,709
12,1504,100,0,1e-05,0.001,0.996,743,761
12,1604,100,0,1e-05,0.001,0.996,796,808
12,1704,100,0,1e-05,0.001,0.996,851,853
12,1804,100,0,1e-05,0.001,0.998,899,905
12,1904,100,0,1e-05,0.001,0.998,952,952
13,0,100,0,1e-05,0.001,0.504,0,0
13,104,100,0,1e-05,0.001,0.534,51,53
13,204,100,0,1e-05,0.001,0.528,107,97
13,304,100,0,1e-05,0.001,0.634,157,147
13,404,100,0,1e-05,0.001,0.608,212,192
13,504,100,0,1e-05,0.001,0.728,267,237
13,604,100,0,1e-05,0.001,0.778,317,287
13,704,100,0,1e-05,0.001,0.792,364,340
13,804,100,0,1e-05,0.001,0.856,416,388
13,904,100,0,1e-05,0.001,0.888,462,442
13,1004,100,0,1e-05,0.001,0.912,510,494
13,1104,100,0,1e-05,0.001,0.948,564,540
13,1204,100,0,1e-05,0.001,0.964,619,585
13,1304,100,0,1e-05,0.001,0.98,673,631
13,1404,100,0,1e-05,0.001,0.984,719,685
13,1504,100,0,1e-05,0.001,0.99,765,739
13,1604,100,0,1e-05,0.001,0.994,813,791
13,1704,100,0,1e-05,0.001,0.994,866,838
13,1804,100,0,1e-05,0.001,0.998,908,896
13,1904,100,0,1e-05,0.001,1.0,952,952
14,0,100,0,1e-05,0.001,0.5,0,0
14,104,100,0,1e-05,0.001,0.544,51,53
14,204,100,0,1e-05,0.001,0.534,103,101
14,304,100,0,1e-05,0.001,0.656,146,158
14,404,100,0,1e-05,0.001,0.58,197,207
14,504,100,0,1e-05,0.001,0.764,254,250
14,604,100,0,1e-05,0.001,0.748,301,303
14,704,100,0,1e-05,0.001,0.842,354,350
14,804,100,0,1e-05,0.001,0.882,401,403
14,904,100,0,1e-05,0.001,0.926,451,453
14,1004,100,0,1e-05,0.001,0.944,493,511
14,1104,100,0,1e-05,0.001,0.96,528,576
14,1204,100,0,1e-05,0.001,0.972,579,625
14,1304,100,0,1e-05,0.001,0.988,626,678
14,1404,100,0,1e-05,0.001,0.99,686,718
14,1504,100,0,1e-05,0.001,0.994,733,771
14,1604,100,0,1e-05,0.001,0.998,790,814
14,1704,100,0,1e-05,0.001,1.0,843,861
14,1804,100,0,1e-05,0.001,1.0,895,909
14,1904,100,0,1e-05,0.001,1.0,952,952
15,0,100,0,1e-05,0.001,0.5,0,0
15,104,100,0,1e-05,0.001,0.534,49,55
15,204,100,0,1e-05,0.001,0.516,108,96
15,304,100,0,1e-05,0.001,0.61,155,149
15,404,100,0,1e-05,0.001,0.57,195,209
15,504,100,0,1e-05,0.001,0.728,249,255
15,604,100,0,1e-05,0.001,0.722,298,306
15,704,100,0,1e-05,0.001,0.77,347,357
15,804,100,0,1e-05,0.001,0.828,398,406
15,904,100,0,1e-05,0.001,0.892,453,451
15,1004,100,0,1e-05,0.001,0.92,499,505
15,1104,100,0,1e-05,0.001,0.94,545,559
15,1204,100,0,1e-05,0.001,0.962,593,611
15,1304,100,0,1e-05,0.001,0.974,646,658
15,1404,100,0,1e-05,0.001,0.98,695,709
15,1504,100,0,1e-05,0.001,0.984,751,753
15,1604,100,0,1e-05,0.001,0.984,800,804
15,1704,100,0,1e-05,0.001,0.99,852,852
15,1804,100,0,1e-05,0.001,0.996,895,909
15,1904,100,0,1e-05,0.001,0.996,952,952
16,0,100,0,1e-05,0.001,0.502,0,0
16,104,100,0,1e-05,0.001,0.558,60,44
16,204,100,0,1e-05,0.001,0.524,106,98
16,304,100,0,1e-05,0.001,0.668,155,149
16,404,100,0,1e-05,0.001,0.594,211,193
16,504,100,0,1e-05,0.001,0.726,260,244
16,604,100,0,1e-05,0.001,0.754,307,297
16,704,100,0,1e-05,0.001,0.782,354,350
16,804,100,0,1e-05,0.001,0.84,405,399
16,904,100,0,1e-05,0.001,0.862,450,454
16,1004,100,0,1e-05,0.001,0.91,502,502
16,1104,100,0,1e-05,0.001,0.944,554,550
16,1204,100,0,1e-05,0.001,0.958,604,600
16,1304,100,0,1e-05,0.001,0.972,646,658
16,1404,100,0,1e-05,0.001,0.978,701,703
16,1504,100,0,1e-05,0.001,0.984,748,756
16,1604,100,0,1e-05,0.001,0.984,803,801
16,1704,100,0,1e-05,0.001,0.984,856,848
16,1804,100,0,1e-05,0.001,0.994,907,897
16,1904,100,0,1e-05,0.001,0.992,952,952
17,0,100,0,1e-05,0.001,0.504,0,0
17,104,100,0,1e-05,0.001,0.54,50,54
17,204,100,0,1e-05,0.001,0.526,104,100
17,304,100,0,1e-05,0.001,0.632,154,150
17,404,100,0,1e-05,0.001,0.574,200,204
17,504,100,0,1e-05,0.001,0.684,246,258
17,604,100,0,1e-05,0.001,0.756,301,303
17,704,100,0,1e-05,0.001,0.722,340,364
17,804,100,0,1e-05,0.001,0.81,390,414
17,904,100,0,1e-05,0.001,0.848,439,465
17,1004,100,0,1e-05,0.001,0.868,494,510
17,1104,100,0,1e-05,0.001,0.894,548,556
17,1204,100,0,1e-05,0.001,0.926,597,607
17,1304,100,0,1e-05,0.001,0.954,647,657
17,1404,100,0,1e-05,0.001,0.956,707,697
17,1504,100,0,1e-05,0.001,0.98,758,746
17,1604,100,0,1e-05,0.001,0.984,809,795
17,1704,100,0,1e-05,0.001,0.992,855,849
17,1804,100,0,1e-05,0.001,0.994,909,895
17,1904,100,0,1e-05,0.001,0.998,952,952
18,0,100,0,1e-05,0.001,0.502,0,0
18,104,100,0,1e-05,0.001,0.544,52,52
18,204,100,0,1e-05,0.001,0.506,105,99
18,304,100,0,1e-05,0.001,0.62,155,149
18,404,100,0,1e-05,0.001,0.568,195,209
18,504,100,0,1e-05,0.001,0.658,246,258
18,604,100,0,1e-05,0.001,0.684,300,304
18,704,100,0,1e-05,0.001,0.726,352,352
18,804,100,0,1e-05,0.001,0.782,395,409
18,904,100,0,1e-05,0.001,0.818,452,452
18,1004,100,0,1e-05,0.001,0.88,501,503
18,1104,100,0,1e-05,0.001,0.896,547,557
18,1204,100,0,1e-05,0.001,0.934,594,610
18,1304,100,0,1e-05,0.001,0.952,648,656
18,1404,100,0,1e-05,0.001,0.97,709,695
18,1504,100,0,1e-05,0.001,0.98,751,753
18,1604,100,0,1e-05,0.001,0.988,809,795
18,1704,100,0,1e-05,0.001,0.99,855,849
18,1804,100,0,1e-05,0.001,0.994,907,897
18,1904,100,0,1e-05,0.001,0.994,952,952
19,0,100,0,1e-05,0.001,0.5,0,0
19,104,100,0,1e-05,0.001,0.554,55,49
19,204,100,0,1e-05,0.001,0.51,99,105
19,304,100,0,1e-05,0.001,0.678,150,154
19,404,100,0,1e-05,0.001,0.584,201,203
19,504,100,0,1e-05,0.001,0.722,258,246
19,604,100,0,1e-05,0.001,0.792,308,296
19,704,100,0,1e-05,0.001,0.814,357,347
19,804,100,0,1e-05,0.001,0.842,411,393
19,904,100,0,1e-05,0.001,0.892,464,440
19,1004,100,0,1e-05,0.001,0.916,510,494
19,1104,100,0,1e-05,0.001,0.934,557,547
19,1204,100,0,1e-05,0.001,0.956,612,592
19,1304,100,0,1e-05,0.001,0.962,666,638
19,1404,100,0,1e-05,0.001,0.974,711,693
19,1504,100,0,1e-05,0.001,0.978,761,743
19,1604,100,0,1e-05,0.001,0.986,811,793
19,1704,100,0,1e-05,0.001,0.99,855,849
19,1804,100,0,1e-05,0.001,0.99,905,899
19,1904,100,0,1e-05,0.001,0.992,952,952
20,0,100,0,1e-05,0.001,0.5,0,0
20,104,100,0,1e-05,0.001,0.536,52,52
20,204,100,0,1e-05,0.001,0.518,96,108
20,304,100,0,1e-05,0.001,0.664,149,155
20,404,100,0,1e-05,0.001,0.552,196,208
20,504,100,0,1e-05,0.001,0.696,247,257
20,604,100,0,1e-05,0.001,0.726,302,302
20,704,100,0,1e-05,0.001,0.776,352,352
20,804,100,0,1e-05,0.001,0.828,393,411
20,904,100,0,1e-05,0.001,0.882,449,455
20,1004,100,0,1e-05,0.001,0.924,494,510
20,1104,100,0,1e-05,0.001,0.952,549,555
20,1204,100,0,1e-05,0.001,0.972,603,601
20,1304,100,0,1e-05,0.001,0.98,654,650
20,1404,100,0,1e-05,0.001,0.984,699,705
20,1504,100,0,1e-05,0.001,0.988,744,760
20,1604,100,0,1e-05,0.001,0.99,795,809
20,1704,100,0,1e-05,0.001,0.996,850,854
20,1804,100,0,1e-05,0.001,0.998,904,900
20,1904,100,0,1e-05,0.001,0.998,952,952
1,0,100,0,1e-05,0.01,0.5,0,0
1,104,100,0,1e-05,0.01,0.5,50,54
1,204,100,0,1e-05,0.01,0.512,102,102
1,304,100,0,1e-05,0.01,0.516,149,155
1,404,100,0,1e-05,0.01,0.574,198,206
1,504,100,0,1e-05,0.01,0.556,248,256
1,604,100,0,1e-05,0.01,0.532,304,300
1,704,100,0,1e-05,0.01,0.51,359,345
1,804,100,0,1e-05,0.01,0.512,419,385
1,904,100,0,1e-05,0.01,0.53,462,442
1,1004,100,0,1e-05,0.01,0.544,510,494
1,1104,100,0,1e-05,0.01,0.532,558,546
1,1204,100,0,1e-05,0.01,0.54,608,596
1,1304,100,0,1e-05,0.01,0.548,657,647
1,1404,100,0,1e-05,0.01,0.552,705,699
1,1504,100,0,1e-05,0.01,0.548,757,747
1,1604,100,0,1e-05,0.01,0.54,803,801
1,1704,100,0,1e-05,0.01,0.568,849,855
1,1804,100,0,1e-05,0.01,0.582,905,899
1,1904,100,0,1e-05,0.01,0.574,952,952
2,0,100,0,1e-05,0.01,0.5,0,0
2,104,100,0,1e-05,0.01,0.5,51,53
2,204,100,0,1e-05,0.01,0.508,115,89
2,304,100,0,1e-05,0.01,0.53,173,131
2,404,100,0,1e-05,0.01,0.532,223,181
2,504,100,0,1e-05,0.01,0.534,275,229
2,604,100,0,1e-05,0.01,0.506,314,290
2,704,100,0,1e-05,0.01,0.52,360,344
2,804,100,0,1e-05,0.01,0.518,411,393
2,904,100,0,1e-05,0.01,0.534,464,440
2,1004,100,0,1e-05,0.01,0.536,508,496
2,1104,100,0,1e-05,0.01,0.546,556,548
2,1204,100,0,1e-05,0.01,0.524,599,605
2,1304,100,0,1e-05,0.01,0.514,658,646
2,1404,100,0,1e-05,0.01,0.54,706,698
2,1504,100,0,1e-05,0.01,0.518,744,760
2,1604,100,0,1e-05,0.01,0.51,793,811
2,1704,100,0,1e-05,0.01,0.544,843,861
2,1804,100,0,1e-05,0.01,0.526,898,906
2,1904,100,0,1e-05,0.01,0.558,952,952
3,0,100,0,1e-05,0.01,0.5,0,0
3,104,100,0,1e-05,0.01,0.5,56,48
3,204,100,0,1e-05,0.01,0.506,108,96
3,304,100,0,1e-05,0.01,0.526,156,148
3,404,100,0,1e-05,0.01,0.536,206,198
3,504,100,0,1e-05,0.01,0.536,258,246
3,604,100,0,1e-05,0.01,0.53,314,290
3,704,100,0,1e-05,0.01,0.516,370,334
3,804,100,0,1e-05,0.01,0.542,422,382
3,904,100,0,1e-05,0.01,0.562,475,429
3,1004,100,0,1e-05,0.01,0.56,524,480
3,1104,100,0,1e-05,0.01,0.548,574,530
3,1204,100,0,1e-05,0.01,0.556,619,585
3,1304,100,0,1e-05,0.01,0.554,664,640
3,1404,100,0,1e-05,0.01,0.562,710,694
3,1504,100,0,1e-05,0.01,0.554,759,745
3,1604,100,0,1e-05,0.01,0.532,809,795
3,1704,100,0,1e-05,0.01,0.544,856,848
3,1804,100,0,1e-05,0.01,0.564,907,897
3,1904,100,0,1e-05,0.01,0.554,952,952
4,0,100,0,1e-05,0.01,0.5,0,0
4,104,100,0,1e-05,0.01,0.5,57,47
4,204,100,0,1e-05,0.01,0.5,112,92
4,304,100,0,1e-05,0.01,0.568,158,146
4,404,100,0,1e-05,0.01,0.568,204,200
4,504,100,0,1e-05,0.01,0.576,242,262
4,604,100,0,1e-05,0.01,0.568,291,313
4,704,100,0,1e-05,0.01,0.558,339,365
4,804,100,0,1e-05,0.01,0.534,384,420
4,904,100,0,1e-05,0.01,0.564,439,465
4,1004,100,0,1e-05,0.01,0.526,489,515
4,1104,100,0,1e-05,0.01,0.522,537,567
4,1204,100,0,1e-05,0.01,0.55,586,618
4,1304,100,0,1e-05,0.01,0.552,642,662
4,1404,100,0,1e-05,0.01,0.534,685,719
4,1504,100,0,1e-05,0.01,0.55,737,767
4,1604,100,0,1e-05,0.01,0.538,785,819
4,1704,100,0,1e-05,0.01,0.56,835,869
4,1804,100,0,1e-05,0.01,0.546,886,918
4,1904,100,0,1e-05,0.01,0.536,952,952
5,0,100,0,1e-05,0.01,0.502,0,0
5,104,100,0,1e-05,0.01,0.5,54,50
5,204,100,0,1e-05,0.01,0.504,109,95
5,304,100,0,1e-05,0.01,0.526,159,145
5,404,100,0,1e-05,0.01,0.516,214,190
5,504,100,0,1e-05,0.01,0.514,269,235
5,604,100,0,1e-05,0.01,0.53,311,293
5,704,100,0,1e-05,0.01,0.52,364,340
5,804,100,0,1e-05,0.01,0.55,415,389
5,904,100,0,1e-05,0.01,0.544,463,441
5,1004,100,0,1e-05,0.01,0.546,508,496
5,1104,100,0,1e-05,0.01,0.522,565,539
5,1204,100,0,1e-05,0.01,0.504,617,587
5,1304,100,0,1e-05,0.01,0.546,661,643
5,1404,100,0,1e-05,0.01,0.528,705,699
5,1504,100,0,1e-05,0.01,0.52,760,744
5,1604,100,0,1e-05,0.01,0.558,806,798
5,1704,100,0,1e-05,0.01,0.534,850,854
5,1804,100,0,1e-05,0.01,0.538,902,902
5,1904,100,0,1e-05,0.01,0.556,952,952
6,0,100,0,1e-05,0.01,0.5,0,0
6,104,100,0,1e-05,0.01,0.5,50,54
6,204,100,0,1e-05,0.01,0.508,98,106
6,304,100,0,1e-05,0.01,0.506,147,157
6,404,100,0,1e-05,0.01,0.54,197,207
6,504,100,0,1e-05,0.01,0.534,246,258
6,604,100,0,1e-05,0.01,0.522,297,307
6,704,100,0,1e-05,0.01,0.508,355,349
6,804,100,0,1e-05,0.01,0.536,407,397
6,904,100,0,1e-05,0.01,0.538,454,450
6,1004,100,0,1e-05,0.01,0.56,504,500
6,1104,100,0,1e-05,0.01,0.532,550,554
6,1204,100,0,1e-05,0.01,0.54,611,593
6,1304,100,0,1e-05,0.01,0.54,662,642
6,1404,100,0,1e-05,0.01,0.53,714,690
6,1504,100,0,1e-05,0.01,0.524,754,750
6,1604,100,0,1e-05,0.01,0.542,808,796
6,1704,100,0,1e-05,0.01,0.53,852,852
6,1804,100,0,1e-05,0.01,0.566,904,900
6,1904,100,0,1e-05,0.01,0.564,952,952
7,0,100,0,1e-05,0.01,0.5,0,0
7,104,100,0,1e-05,0.01,0.5,45,59
7,204,100,0,1e-05,0.01,0.556,96,108
7,304,100,0,1e-05,0.01,0.53,146,158
7,404,100,0,1e-05,0.01,0.598,201,203
7,504,100,0,1e-05,0.01,0.59,248,256
7,604,100,0,1e-05,0.01,0.58,298,306
7,704,100,0,1e-05,0.01,0.58,351,353
7,804,100,0,1e-05,0.01,0.59,403,401
7,904,100,0,1e-05,0.01,0.592,459,445
7,1004,100,0,1e-05,0.01,0.588,505,499
7,1104,100,0,1e-05,0.01,0.596,558,546
7,1204,100,0,1e-05,0.01,0.596,602,602
7,1304,100,0,1e-05,0.01,0.592,648,656
7,1404,100,0,1e-05,0.01,0.624,704,700
7,1504,100,0,1e-05,0.01,0.622,753,751
7,1604,100,0,1e-05,0.01,0.654,802,802
7,1704,100,0,1e-05,0.01,0.654,850,854
7,1804,100,0,1e-05,0.01,0.636,902,902
7,1904,100,0,1e-05,0.01,0.676,952,952
8,0,100,0,1e-05,0.01,0.5,0,0
8,104,100,0,1e-05,0.01,0.5,53,51
8,204,100,0,1e-05,0.01,0.5,108,96
8,304,100,0,1e-05,0.01,0.534,162,142
8,404,100,0,1e-05,0.01,0.562,220,184
8,504,100,0,1e-05,0.01,0.558,274,230
8,604,100,0,1e-05,0.01,0.566,324,280
8,704,100,0,1e-05,0.01,0.548,364,340
8,804,100,0,1e-05,0.01,0.554,413,391
8,904,100,0,1e-05,0.01,0.576,457,447
8,1004,100,0,1e-05,0.01,0.554,505,499
8,1104,100,0,1e-05,0.01,0.568,563,541
8,1204,100,0,1e-05,0.01,0.57,611,593
8,1304,100,0,1e-05,0.01,0.6,661,643
8,1404,100,0,1e-05,0.01,0.554,712,692
8,1504,100,0,1e-05,0.01,0.59,761,743
8,1604,100,0,1e-05,0.01,0.588,816,788
8,1704,100,0,1e-05,0.01,0.598,855,849
8,1804,100,0,1e-05,0.01,0.608,906,898
8,1904,100,0,1e-05,0.01,0.598,952,952
9,0,100,0,1e-05,0.01,0.5,0,0
9,104,100,0,1e-05,0.01,0.5,47,57
9,204,100,0,1e-05,0.01,0.532,103,101
9,304,100,0,1e-05,0.01,0.546,159,145
9,404,100,0,1e-05,0.01,0.602,214,190
9,504,100,0,1e-05,0.01,0.572,260,244
9,604,100,0,1e-05,0.01,0.592,306,298
9,704,100,0,1e-05,0.01,0.574,344,360
9,804,100,0,1e-05,0.01,0.584,397,407
9,904,100,0,1e-05,0.01,0.582,451,453
9,1004,100,0,1e-05,0.01,0.6,506,498
9,1104,100,0,1e-05,0.01,0.61,565,539
9,1204,100,0,1e-05,0.01,0.596,617,587
9,1304,100,0,1e-05,0.01,0.61,659,645
9,1404,100,0,1e-05,0.01,0.584,718,686
9,1504,100,0,1e-05,0.01,0.616,759,745
9,1604,100,0,1e-05,0.01,0.622,809,795
9,1704,100,0,1e-05,0.01,0.644,854,850
9,1804,100,0,1e-05,0.01,0.648,911,893
9,1904,100,0,1e-05,0.01,0.666,952,952
10,0,100,0,1e-05,0.01,0.5,0,0
10,104,100,0,1e-05,0.01,0.5,54,50
10,204,100,0,1e-05,0.01,0.534,98,106
10,304,100,0,1e-05,0.01,0.514,157,147
10,404,100,0,1e-05,0.01,0.626,214,190
10,504,100,0,1e-05,0.01,0.59,271,233
10,604,100,0,1e-05,0.01,0.564,313,291
10,704,100,0,1e-05,0.01,0.554,365,339
10,804,100,0,1e-05,0.01,0.562,419,385
10,904,100,0,1e-05,0.01,0.56,465,439
10,1004,100,0,1e-05,0.01,0.556,516,488
10,1104,100,0,1e-05,0.01,0.56,563,541
10,1204,100,0,1e-05,0.01,0.588,609,595
10,1304,100,0,1e-05,0.01,0.602,655,649
10,1404,100,0,1e-05,0.01,0.598,706,698
10,1504,100,0,1e-05,0.01,0.582,756,748
10,1604,100,0,1e-05,0.01,0.588,805,799
10,1704,100,0,1e-05,0.01,0.592,854,850
10,1804,100,0,1e-05,0.01,0.626,902,902
10,1904,100,0,1e-05,0.01,0.642,952,952
11,0,100,0,1e-05,0.01,0.5,0,0
11,104,100,0,1e-05,0.01,0.5,51,53
11,204,100,0,1e-05,0.01,0.502,99,105
11,304,100,0,1e-05,0.01,0.49,145,159
11,404,100,0,1e-05,0.01,0.534,189,215
11,504,100,0,1e-05,0.01,0.552,237,267
11,604,100,0,1e-05,0.01,0.538,276,328
11,704,100,0,1e-05,0.01,0.552,328,376
11,804,100,0,1e-05,0.01,0.534,377,427
11,904,100,0,1e-05,0.01,0.534,429,475
11,1004,100,0,1e-05,0.01,0.564,483,521
11,1104,100,0,1e-05,0.01,0.542,543,561
11,1204,100,0,1e-05,0.01,0.56,597,607
11,1304,100,0,1e-05,0.01,0.558,652,652
11,1404,100,0,1e-05,0.01,0.574,702,702
11,1504,100,0,1e-05,0.01,0.554,752,752
11,1604,100,0,1e-05,0.01,0.562,804,800
11,1704,100,0,1e-05,0.01,0.566,861,843
11,1804,100,0,1e-05,0.01,0.58,905,899
11,1904,100,0,1e-05,0.01,0.612,952,952
12,0,100,0,1e-05,0.01,0.5,0,0
12,104,100,0,1e-05,0.01,0.5,59,45
12,204,100,0,1e-05,0.01,0.5,113,91
12,304,100,0,1e-05,0.01,0.56,153,151
12,404,100,0,1e-05,0.01,0.57,204,200
12,504,100,0,1e-05,0.01,0.564,257,247
12,604,100,0,1e-05,0.01,0.544,301,303
12,704,100,0,1e-05,0.01,0.56,352,352
12,804,100,0,1e-05,0.01,0.56,397,407
12,904,100,0,1e-05,0.01,0.558,454,450
12,1004,100,0,1e-05,0.01,0.564,508,496
12,1104,100,0,1e-05,0.01,0.54,549,555
12,1204,100,0,1e-05,0.01,0.556,602,602
12,1304,100,0,1e-05,0.01,0.572,655,649
12,1404,100,0,1e-05,0.01,0.532,703,701
12,1504,100,0,1e-05,0.01,0.538,757,747
12,1604,100,0,1e-05,0.01,0.548,808,796
12,1704,100,0,1e-05,0.01,0.582,854,850
12,1804,100,0,1e-05,0.01,0.57,904,900
12,1904,100,0,1e-05,0.01,0.584,952,952
13,0,100,0,1e-05,0.01,0.5,0,0
13,104,100,0,1e-05,0.01,0.5,57,47
13,204,100,0,1e-05,0.01,0.508,103,101
13,304,100,0,1e-05,0.01,0.51,160,144
13,404,100,0,1e-05,0.01,0.58,212,192
13,504,100,0,1e-05,0.01,0.576,260,244
13,604,100,0,1e-05,0.01,0.58,309,295
13,704,100,0,1e-05,0.01,0.58,365,339
13,804,100,0,1e-05,0.01,0.582,418,386
13,904,100,0,1e-05,0.01,0.594,469,435
13,1004,100,0,1e-05,0.01,0.566,520,484
13,1104,100,0,1e-05,0.01,0.578,572,532
13,1204,100,0,1e-05,0.01,0.58,617,587
13,1304,100,0,1e-05,0.01,0.6,663,641
13,1404,100,0,1e-05,0.01,0.596,709,695
13,1504,100,0,1e-05,0.01,0.628,754,750
13,1604,100,0,1e-05,0.01,0.63,804,800
13,1704,100,0,1e-05,0.01,0.602,849,855
13,1804,100,0,1e-05,0.01,0.63,894,910
13,1904,100,0,1e-05,0.01,0.632,952,952
14,0,100,0,1e-05,0.01,0.5,0,0
14,104,100,0,1e-05,0.01,0.5,46,58
14,204,100,0,1e-05,0.01,0.568,94,110
14,304,100,0,1e-05,0.01,0.518,151,153
14,404,100,0,1e-05,0.01,0.592,205,199
14,504,100,0,1e-05,0.01,0.556,259,245
14,604,100,0,1e-05,0.01,0.532,309,295
14,704,100,0,1e-05,0.01,0.51,351,353
14,804,100,0,1e-05,0.01,0.528,401,403
14,904,100,0,1e-05,0.01,0.53,452,452
14,1004,100,0,1e-05,0.01,0.536,505,499
14,1104,100,0,1e-05,0.01,0.578,558,546
14,1204,100,0,1e-05,0.01,0.564,605,599
14,1304,100,0,1e-05,0.01,0.568,654,650
14,1404,100,0,1e-05,0.01,0.562,706,698
14,1504,100,0,1e-05,0.01,0.59,760,744
14,1604,100,0,1e-05,0.01,0.586,809,795
14,1704,100,0,1e-05,0.01,0.588,857,847
14,1804,100,0,1e-05,0.01,0.564,903,901
14,1904,100,0,1e-05,0.01,0.604,952,952
15,0,100,0,1e-05,0.01,0.5,0,0
15,104,100,0,1e-05,0.01,0.5,46,58
15,204,100,0,1e-05,0.01,0.526,95,109
15,304,100,0,1e-05,0.01,0.508,142,162
15,404,100,0,1e-05,0.01,0.566,188,216
15,504,100,0,1e-05,0.01,0.558,234,270
15,604,100,0,1e-05,0.01,0.572,281,323
15,704,100,0,1e-05,0.01,0.58,330,374
15,804,100,0,1e-05,0.01,0.552,370,434
15,904,100,0,1e-05,0.01,0.572,425,479
15,1004,100,0,1e-05,0.01,0.588,486,518
15,1104,100,0,1e-05,0.01,0.586,539,565
15,1204,100,0,1e-05,0.01,0.562,594,610
15,1304,100,0,1e-05,0.01,0.544,638,666
15,1404,100,0,1e-05,0.01,0.544,694,710
15,1504,100,0,1e-05,0.01,0.59,746,758
15,1604,100,0,1e-05,0.01,0.57,796,808
15,1704,100,0,1e-05,0.01,0.57,849,855
15,1804,100,0,1e-05,0.01,0.55,907,897
15,1904,100,0,1e-05,0.01,0.572,952,952
16,0,100,0,1e-05,0.01,0.5,0,0
16,104,100,0,1e-05,0.01,0.5,53,51
16,204,100,0,1e-05,0.01,0.514,99,105
16,304,100,0,1e-05,0.01,0.518,146,158
16,404,100,0,1e-05,0.01,0.586,200,204
16,504,100,0,1e-05,0.01,0.572,249,255
16,604,100,0,1e-05,0.01,0.586,288,316
16,704,100,0,1e-05,0.01,0.59,346,358
16,804,100,0,1e-05,0.01,0.586,397,407
16,904,100,0,1e-05,0.01,0.582,447,457
16,1004,100,0,1e-05,0.01,0.58,491,513
16,1104,100,0,1e-05,0.01,0.584,541,563
16,1204,100,0,1e-05,0.01,0.576,593,611
16,1304,100,0,1e-05,0.01,0.634,648,656
16,1404,100,0,1e-05,0.01,0.622,708,696
16,1504,100,0,1e-05,0.01,0.642,751,753
16,1604,100,0,1e-05,0.01,0.672,801,803
16,1704,100,0,1e-05,0.01,0.64,857,847
16,1804,100,0,1e-05,0.01,0.656,906,898
16,1904,100,0,1e-05,0.01,0.67,952,952
17,0,100,0,1e-05,0.01,0.502,0,0
17,104,100,0,1e-05,0.01,0.5,45,59
17,204,100,0,1e-05,0.01,0.586,93,111
17,304,100,0,1e-05,0.01,0.524,140,164
17,404,100,0,1e-05,0.01,0.596,192,212
17,504,100,0,1e-05,0.01,0.58,245,259
17,604,100,0,1e-05,0.01,0.554,297,307
17,704,100,0,1e-05,0.01,0.57,337,367
17,804,100,0,1e-05,0.01,0.574,387,417
17,904,100,0,1e-05,0.01,0.636,429,475
17,1004,100,0,1e-05,0.01,0.624,481,523
17,1104,100,0,1e-05,0.01,0.6,528,576
17,1204,100,0,1e-05,0.01,0.606,576,628
17,1304,100,0,1e-05,0.01,0.594,624,680
17,1404,100,0,1e-05,0.01,0.602,668,736
17,1504,100,0,1e-05,0.01,0.59,716,788
17,1604,100,0,1e-05,0.01,0.594,772,832
17,1704,100,0,1e-05,0.01,0.622,829,875
17,1804,100,0,1e-05,0.01,0.626,888,916
17,1904,100,0,1e-05,0.01,0.616,952,952
18,0,100,0,1e-05,0.01,0.5,0,0
18,104,100,0,1e-05,0.01,0.5,47,57
18,204,100,0,1e-05,0.01,0.594,96,108
18,304,100,0,1e-05,0.01,0.53,148,156
18,404,100,0,1e-05,0.01,0.584,194,210
18,504,100,0,1e-05,0.01,0.592,251,253
18,604,100,0,1e-05,0.01,0.592,307,297
18,704,100,0,1e-05,0.01,0.568,358,346
18,804,100,0,1e-05,0.01,0.592,406,398
18,904,100,0,1e-05,0.01,0.588,459,445
18,1004,100,0,1e-05,0.01,0.602,505,499
18,1104,100,0,1e-05,0.01,0.596,548,556
18,1204,100,0,1e-05,0.01,0.59,597,607
18,1304,100,0,1e-05,0.01,0.594,644,660
18,1404,100,0,1e-05,0.01,0.592,693,711
18,1504,100,0,1e-05,0.01,0.616,741,763
18,1604,100,0,1e-05,0.01,0.592,790,814
18,1704,100,0,1e-05,0.01,0.624,852,852
18,1804,100,0,1e-05,0.01,0.62,904,900
18,1904,100,0,1e-05,0.01,0.644,952,952
19,0,100,0,1e-05,0.01,0.5,0,0
19,104,100,0,1e-05,0.01,0.5,58,46
19,204,100,0,1e-05,0.01,0.5,109,95
19,304,100,0,1e-05,0.01,0.528,164,140
19,404,100,0,1e-05,0.01,0.552,216,188
19,504,100,0,1e-05,0.01,0.544,265,239
19,604,100,0,1e-05,0.01,0.56,318,286
19,704,100,0,1e-05,0.01,0.542,361,343
19,804,100,0,1e-05,0.01,0.584,415,389
19,904,100,0,1e-05,0.01,0.58,469,435
19,1004,100,0,1e-05,0.01,0.564,524,480
19,1104,100,0,1e-05,0.01,0.548,580,524
19,1204,100,0,1e-05,0.01,0.578,628,576
19,1304,100,0,1e-05,0.01,0.536,677,627
19,1404,100,0,1e-05,0.01,0.574,717,687
19,1504,100,0,1e-05,0.01,0.56,764,740
19,1604,100,0,1e-05,0.01,0.568,816,788
19,1704,100,0,1e-05,0.01,0.58,864,840
19,1804,100,0,1e-05,0.01,0.574,904,900
19,1904,100,0,1e-05,0.01,0.6,952,952
20,0,100,0,1e-05,0.01,0.5,0,0
20,104,100,0,1e-05,0.01,0.5,49,55
20,204,100,0,1e-05,0.01,0.5,94,110
20,304,100,0,1e-05,0.01,0.506,149,155
20,404,100,0,1e-05,0.01,0.578,197,207
20,504,100,0,1e-05,0.01,0.552,247,257
20,604,100,0,1e-05,0.01,0.562,299,305
20,704,100,0,1e-05,0.01,0.56,356,348
20,804,100,0,1e-05,0.01,0.586,398,406
20,904,100,0,1e-05,0.01,0.58,449,455
20,1004,100,0,1e-05,0.01,0.594,502,502
20,1104,100,0,1e-05,0.01,0.576,552,552
20,1204,100,0,1e-05,0.01,0.59,598,606
20,1304,100,0,1e-05,0.01,0.584,645,659
20,1404,100,0,1e-05,0.01,0.54,697,707
20,1504,100,0,1e-05,0.01,0.568,749,755
20,1604,100,0,1e-05,0.01,0.572,802,802
20,1704,100,0,1e-05,0.01,0.562,850,854
20,1804,100,0,1e-05,0.01,0.576,897,907
20,1904,100,0,1e-05,0.01,0.59,952,952
1,0,100,0,0.0001,0.0001,0.512,0,0
1,104,100,0,0.0001,0.0001,0.512,46,58
1,204,100,0,0.0001,0.0001,0.508,98,106
1,304,100,0,0.0001,0.0001,0.514,144,160
1,404,100,0,0.0001,0.0001,0.516,198,206
1,504,100,0,0.0001,0.0001,0.524,247,257
1,604,100,0,0.0001,0.0001,0.528,295,309
1,704,100,0,0.0001,0.0001,0.526,348,356
1,804,100,0,0.0001,0.0001,0.53,398,406
1,904,100,0,0.0001,0.0001,0.53,451,453
1,1004,100,0,0.0001,0.0001,0.526,506,498
1,1104,100,0,0.0001,0.0001,0.528,555,549
1,1204,100,0,0.0001,0.0001,0.53,602,602
1,1304,100,0,0.0001,0.0001,0.526,657,647
1,1404,100,0,0.0001,0.0001,0.532,704,700
1,1504,100,0,0.0001,0.0001,0.532,758,746
1,1604,100,0,0.0001,0.0001,0.524,798,806
1,1704,100,0,0.0001,0.0001,0.526,846,858
1,1804,100,0,0.0001,0.0001,0.512,903,901
1,1904,100,0,0.0001,0.0001,0.518,952,952
2,0,100,0,0.0001,0.0001,0.496,0,0
2,104,100,0,0.0001,0.0001,0.5,59,45
2,204,100,0,0.0001,0.0001,0.502,111,93
2,304,100,0,0.0001,0.0001,0.502,155,149
2,404,100,0,0.0001,0.0001,0.5,208,196
2,504,100,0,0.0001,0.0001,0.498,251,253
2,604,100,0,0.0001,0.0001,0.502,303,301
2,704,100,0,0.0001,0.0001,0.5,356,348
2,804,100,0,0.0001,0.0001,0.5,403,401
2,904,100,0,0.0001,0.0001,0.494,455,449
2,1004,100,0,0.0001,0.0001,0.494,507,497
2,1104,100,0,0.0001,0.0001,0.51,559,545
2,1204,100,0,0.0001,0.0001,0.506,605,599
2,1304,100,0,0.0001,0.0001,0.506,651,653
2,1404,100,0,0.0001,0.0001,0.508,705,699
2,1504,100,0,0.0001,0.0001,0.496,760,744
2,1604,100,0,0.0001,0.0001,0.492,811,793
2,1704,100,0,0.0001,0.0001,0.482,860,844
2,1804,100,0,0.0001,0.0001,0.5,914,890
2,1904,100,0,0.0001,0.0001,0.496,952,952
3,0,100,0,0.0001,0.0001,0.478,0,0
3,104,100,0,0.0001,0.0001,0.476,44,60
3,204,100,0,0.0001,0.0001,0.484,89,115
3,304,100,0,0.0001,0.0001,0.488,143,161
3,404,100,0,0.0001,0.0001,0.488,198,206
3,504,100,0,0.0001,0.0001,0.486,248,256
3,604,100,0,0.0001,0.0001,0.482,295,309
3,704,100,0,0.0001,0.0001,0.482,348,356
3,804,100,0,0.0001,0.0001,0.482,399,405
3,904,100,0,0.0001,0.0001,0.478,444,460
3,1004,100,0,0.0001,0.0001,0.486,496,508
3,1104,100,0,0.0001,0.0001,0.486,544,560
3,1204,100,0,0.0001,0.0001,0.492,589,615
3,1304,100,0,0.0001,0.0001,0.5,640,664
3,1404,100,0,0.0001,0.0001,0.504,685,719
3,1504,100,0,0.0001,0.0001,0.504,732,772
3,1604,100,0,0.0001,0.0001,0.5,792,812
3,1704,100,0,0.0001,0.0001,0.494,845,859
3,1804,100,0,0.0001,0.0001,0.498,895,909
3,1904,100,0,0.0001,0.0001,0.488,952,952
4,0,100,0,0.0001,0.0001,0.524,0,0
4,104,100,0,0.0001,0.0001,0.52,55,49
4,204,100,0,0.0001,0.0001,0.514,105,99
4,304,100,0,0.0001,0.0001,0.518,156,148
4,404,100,0,0.0001,0.0001,0.52,196,208
4,504,100,0,0.0001,0.0001,0.516,247,257
4,604,100,0,0.0001,0.0001,0.524,300,304
4,704,100,0,0.0001,0.0001,0.51,342,362
4,804,100,0,0.0001,0.0001,0.518,392,412
4,904,100,0,0.0001,0.0001,0.51,435,469
4,1004,100,0,0.0001,0.0001,0.51,483,521
4,1104,100,0,0.0001,0.0001,0.508,542,562
4,1204,100,0,0.0001,0.0001,0.508,597,607
4,1304,100,0,0.0001,0.0001,0.512,653,651
4,1404,100,0,0.0001,0.0001,0.51,701,703
4,1504,100,0,0.0001,0.0001,0.512,757,747
4,1604,100,0,0.0001,0.0001,0.5,800,804
4,1704,100,0,0.0001,0.0001,0.508,844,860
4,1804,100,0,0.0001,0.0001,0.498,897,907
4,1904,100,0,0.0001,0.0001,0.504,952,952
5,0,100,0,0.0001,0.0001,0.54,0,0
5,104,100,0,0.0001,0.0001,0.54,48,56
5,204,100,0,0.0001,0.0001,0.542,93,111
5,304,100,0,0.0001,0.0001,0.536,147,157
5,404,100,0,0.0001,0.0001,0.536,198,206
5,504,100,0,0.0001,0.0001,0.544,249,255
5,604,100,0,0.0001,0.0001,0.546,314,290
5,704,100,0,0.0001,0.0001,0.572,360,344
5,804,100,0,0.0001,0.0001,0.572,398,406
5,904,100,0,0.0001,0.0001,0.572,451,453
5,1004,100,0,0.0001,0.0001,0.568,498,506
5,1104,100,0,0.0001,0.0001,0.578,538,566
5,1204,100,0,0.0001,0.0001,0.578,593,611
5,1304,100,0,0.0001,0.0001,0.582,642,662
5,1404,100,0,0.0001,0.0001,0.578,698,706
5,1504,100,0,0.0001,0.0001,0.578,742,762
5,1604,100,0,0.0001,0.0001,0.568,801,803
5,1704,100,0,0.0001,0.0001,0.558,852,852
5,1804,100,0,0.0001,0.0001,0.562,899,905
5,1904,100,0,0.0001,0.0001,0.564,952,952
6,0,100,0,0.0001,0.0001,0.532,0,0
6,104,100,0,0.0001,0.0001,0.532,53,51
6,204,100,0,0.0001,0.0001,0.53,93,111
6,304,100,0,0.0001,0.0001,0.528,146,158
6,404,100,0,0.0001,0.0001,0.528,192,212
6,504,100,0,0.0001,0.0001,0.526,253,251
6,604,100,0,0.0001,0.0001,0.526,305,299
6,704,100,0,0.0001,0.0001,0.522,353,351
6,804,100,0,0.0001,0.0001,0.526,412,392
6,904,100,0,0.0001,0.0001,0.546,465,439
6,1004,100,0,0.0001,0.0001,0.544,505,499
6,1104,100,0,0.0001,0.0001,0.532,558,546
6,1204,100,0,0.0001,0.0001,0.542,610,594
6,1304,100,0,0.0001,0.0001,0.55,647,657
6,1404,100,0,0.0001,0.0001,0.552,695,709
6,1504,100,0,0.0001,0.0001,0.554,746,758
6,1604,100,0,0.0001,0.0001,0.55,798,806
6,1704,100,0,0.0001,0.0001,0.548,848,856
6,1804,100,0,0.0001,0.0001,0.558,904,900
6,1904,100,0,0.0001,0.0001,0.566,952,952
7,0,100,0,0.0001,0.0001,0.528,0,0
7,104,100,0,0.0001,0.0001,0.536,48,56
7,204,100,0,0.0001,0.0001,0.53,97,107
7,304,100,0,0.0001,0.0001,0.522,145,159
7,404,100,0,0.0001,0.0001,0.518,193,211
7,504,100,0,0.0001,0.0001,0.526,247,257
7,604,100,0,0.0001,0.0001,0.534,296,308
7,704,100,0,0.0001,0.0001,0.528,344,360
7,804,100,0,0.0001,0.0001,0.534,395,409
7,904,100,0,0.0001,0.0001,0.53,447,457
7,1004,100,0,0.0001,0.0001,0.524,499,505
7,1104,100,0,0.0001,0.0001,0.522,545,559
7,1204,100,0,0.0001,0.0001,0.53,597,607
7,1304,100,0,0.0001,0.0001,0.528,645,659
7,1404,100,0,0.0001,0.0001,0.534,698,706
7,1504,100,0,0.0001,0.0001,0.546,750,754
7,1604,100,0,0.0001,0.0001,0.558,811,793
7,1704,100,0,0.0001,0.0001,0.554,863,841
7,1804,100,0,0.0001,0.0001,0.558,899,905
7,1904,100,0,0.0001,0.0001,0.554,952,952
8,0,100,0,0.0001,0.0001,0.52,0,0
8,104,100,0,0.0001,0.0001,0.528,38,66
8,204,100,0,0.0001,0.0001,0.528,96,108
8,304,100,0,0.0001,0.0001,0.53,149,155
8,404,100,0,0.0001,0.0001,0.548,196,208
8,504,100,0,0.0001,0.0001,0.546,247,257
8,604,100,0,0.0001,0.0001,0.548,287,317
8,704,100,0,0.0001,0.0001,0.562,338,366
8,804,100,0,0.0001,0.0001,0.564,388,416
8,904,100,0,0.0001,0.0001,0.552,436,468
8,1004,100,0,0.0001,0.0001,0.542,485,519
8,1104,100,0,0.0001,0.0001,0.534,532,572
8,1204,100,0,0.0001,0.0001,0.536,581,623
8,1304,100,0,0.0001,0.0001,0.536,632,672
8,1404,100,0,0.0001,0.0001,0.534,680,724
8,1504,100,0,0.0001,0.0001,0.544,734,770
8,1604,100,0,0.0001,0.0001,0.554,791,813
8,1704,100,0,0.0001,0.0001,0.548,840,864
8,1804,100,0,0.0001,0.0001,0.538,894,910
8,1904,100,0,0.0001,0.0001,0.536,952,952
9,0,100,0,0.0001,0.0001,0.498,0,0
9,104,100,0,0.0001,0.0001,0.496,54,50
9,204,100,0,0.0001,0.0001,0.496,104,100
9,304,100,0,0.0001,0.0001,0.496,158,146
9,404,100,0,0.0001,0.0001,0.498,203,201
9,504,100,0,0.0001,0.0001,0.5,253,251
9,604,100,0,0.0001,0.0001,0.508,293,311
9,704,100,0,0.0001,0.0001,0.51,351,353
9,804,100,0,0.0001,0.0001,0.506,406,398
9,904,100,0,0.0001,0.0001,0.5,457,447
9,1004,100,0,0.0001,0.0001,0.506,502,502
9,1104,100,0,0.0001,0.0001,0.508,549,555
9,1204,100,0,0.0001,0.0001,0.504,602,602
9,1304,100,0,0.0001,0.0001,0.496,650,654
9,1404,100,0,0.0001,0.0001,0.502,698,706
9,1504,100,0,0.0001,0.0001,0.516,749,755
9,1604,100,0,0.0001,0.0001,0.528,802,802
9,1704,100,0,0.0001,0.0001,0.54,846,858
9,1804,100,0,0.0001,0.0001,0.54,897,907
9,1904,100,0,0.0001,0.0001,0.528,952,952
10,0,100,0,0.0001,0.0001,0.504,0,0
10,104,100,0,0.0001,0.0001,0.504,53,51
10,204,100,0,0.0001,0.0001,0.504,104,100
10,304,100,0,0.0001,0.0001,0.508,154,150
10,404,100,0,0.0001,0.0001,0.506,201,203
10,504,100,0,0.0001,0.0001,0.506,253,251
10,604,100,0,0.0001,0.0001,0.514,300,304
10,704,100,0,0.0001,0.0001,0.496,344,360
10,804,100,0,0.0001,0.0001,0.498,395,409
10,904,100,0,0.0001,0.0001,0.51,439,465
10,1004,100,0,0.0001,0.0001,0.508,491,513
10,1104,100,0,0.0001,0.0001,0.51,547,557
10,1204,100,0,0.0001,0.0001,0.524,589,615
10,1304,100,0,0.0001,0.0001,0.516,641,663
10,1404,100,0,0.0001,0.0001,0.53,698,706
10,1504,100,0,0.0001,0.0001,0.522,747,757
10,1604,100,0,0.0001,0.0001,0.512,800,804
10,1704,100,0,0.0001,0.0001,0.514,855,849
10,1804,100,0,0.0001,0.0001,0.506,904,900
10,1904,100,0,0.0001,0.0001,0.526,952,952
11,0,100,0,0.0001,0.0001,0.516,0,0
11,104,100,0,0.0001,0.0001,0.514,54,50
11,204,100,0,0.0001,0.0001,0.52,104,100
11,304,100,0,0.0001,0.0001,0.516,157,147
11,404,100,0,0.0001,0.0001,0.52,208,196
11,504,100,0,0.0001,0.0001,0.516,258,246
11,604,100,0,0.0001,0.0001,0.522,308,296
11,704,100,0,0.0001,0.0001,0.506,350,354
11,804,100,0,0.0001,0.0001,0.508,405,399
11,904,100,0,0.0001,0.0001,0.53,461,443
11,1004,100,0,0.0001,0.0001,0.556,510,494
11,1104,100,0,0.0001,0.0001,0.58,561,543
11,1204,100,0,0.0001,0.0001,0.574,612,592
11,1304,100,0,0.0001,0.0001,0.572,654,650
11,1404,100,0,0.0001,0.0001,0.562,696,708
11,1504,100,0,0.0001,0.0001,0.566,747,757
11,1604,100,0,0.0001,0.0001,0.56,797,807
11,1704,100,0,0.0001,0.0001,0.554,846,858
11,1804,100,0,0.0001,0.0001,0.568,900,904
11,1904,100,0,0.0001,0.0001,0.578,952,952
12,0,100,0,0.0001,0.0001,0.482,0,0
12,104,100,0,0.0001,0.0001,0.48,46,58
12,204,100,0,0.0001,0.0001,0.488,95,109
12,304,100,0,0.0001,0.0001,0.488,150,154
12,404,100,0,0.0001,0.0001,0.486,206,198
12,504,100,0,0.0001,0.0001,0.494,260,244
12,604,100,0,0.0001,0.0001,0.486,311,293
12,704,100,0,0.0001,0.0001,0.48,359,345
12,804,100,0,0.0001,0.0001,0.474,413,391
12,904,100,0,0.0001,0.0001,0.476,462,442
12,1004,100,0,0.0001,0.0001,0.482,510,494
12,1104,100,0,0.0001,0.0001,0.48,553,551
12,1204,100,0,0.0001,0.0001,0.486,602,602
12,1304,100,0,0.0001,0.0001,0.478,658,646
12,1404,100,0,0.0001,0.0001,0.484,709,695
12,1504,100,0,0.0001,0.0001,0.484,757,747
12,1604,100,0,0.0001,0.0001,0.482,803,801
12,1704,100,0,0.0001,0.0001,0.48,855,849
12,1804,100,0,0.0001,0.0001,0.49,899,905
12,1904,100,0,0.0001,0.0001,0.488,952,952
13,0,100,0,0.0001,0.0001,0.502,0,0
13,104,100,0,0.0001,0.0001,0.5,53,51
13,204,100,0,0.0001,0.0001,0.504,95,109
13,304,100,0,0.0001,0.0001,0.502,142,162
13,404,100,0,0.0001,0.0001,0.512,192,212
13,504,100,0,0.0001,0.0001,0.506,240,264
13,604,100,0,0.0001,0.0001,0.506,288,316
13,704,100,0,0.0001,0.0001,0.504,331,373
13,804,100,0,0.0001,0.0001,0.506,386,418
13,904,100,0,0.0001,0.0001,0.508,445,459
13,1004,100,0,0.0001,0.0001,0.51,495,509
13,1104,100,0,0.0001,0.0001,0.528,552,552
13,1204,100,0,0.0001,0.0001,0.526,603,601
13,1304,100,0,0.0001,0.0001,0.536,649,655
13,1404,100,0,0.0001,0.0001,0.534,704,700
13,1504,100,0,0.0001,0.0001,0.534,753,751
13,1604,100,0,0.0001,0.0001,0.526,809,795
13,1704,100,0,0.0001,0.0001,0.514,854,850
13,1804,100,0,0.0001,0.0001,0.522,899,905
13,1904,100,0,0.0001,0.0001,0.52,952,952
14,0,100,0,0.0001,0.0001,0.508,0,0
14,104,100,0,0.0001,0.0001,0.51,54,50
14,204,100,0,0.0001,0.0001,0.514,106,98
14,304,100,0,0.0001,0.0001,0.514,162,142
14,404,100,0,0.0001,0.0001,0.502,212,192
14,504,100,0,0.0001,0.0001,0.494,266,238
14,604,100,0,0.0001,0.0001,0.474,318,286
14,704,100,0,0.0001,0.0001,0.484,370,334
14,804,100,0,0.0001,0.0001,0.49,416,388
14,904,100,0,0.0001,0.0001,0.5,464,440
14,1004,100,0,0.0001,0.0001,0.49,513,491
14,1104,100,0,0.0001,0.0001,0.498,555,549
14,1204,100,0,0.0001,0.0001,0.506,610,594
14,1304,100,0,0.0001,0.0001,0.508,662,642
14,1404,100,0,0.0001,0.0001,0.498,705,699
14,1504,100,0,0.0001,0.0001,0.486,756,748
14,1604,100,0,0.0001,0.0001,0.48,798,806
14,1704,100,0,0.0001,0.0001,0.478,848,856
14,1804,100,0,0.0001,0.0001,0.472,901,903
14,1904,100,0,0.0001,0.0001,0.486,952,952
15,0,100,0,0.0001,0.0001,0.494,0,0
15,104,100,0,0.0001,0.0001,0.494,48,56
15,204,100,0,0.0001,0.0001,0.496,100,104
15,304,100,0,0.0001,0.0001,0.494,148,156
15,404,100,0,0.0001,0.0001,0.5,203,201
15,504,100,0,0.0001,0.0001,0.496,245,259
15,604,100,0,0.0001,0.0001,0.496,294,310
15,704,100,0,0.0001,0.0001,0.488,344,360
15,804,100,0,0.0001,0.0001,0.494,388,416
15,904,100,0,0.0001,0.0001,0.496,445,459
15,1004,100,0,0.0001,0.0001,0.492,491,513
15,1104,100,0,0.0001,0.0001,0.484,547,557
15,1204,100,0,0.0001,0.0001,0.482,597,607
15,1304,100,0,0.0001,0.0001,0.488,653,651
15,1404,100,0,0.0001,0.0001,0.486,705,699
15,1504,100,0,0.0001,0.0001,0.5,756,748
15,1604,100,0,0.0001,0.0001,0.492,801,803
15,1704,100,0,0.0001,0.0001,0.5,852,852
15,1804,100,0,0.0001,0.0001,0.502,906,898
15,1904,100,0,0.0001,0.0001,0.5,952,952
16,0,100,0,0.0001,0.0001,0.52,0,0
16,104,100,0,0.0001,0.0001,0.524,63,41
16,204,100,0,0.0001,0.0001,0.526,98,106
16,304,100,0,0.0001,0.0001,0.522,153,151
16,404,100,0,0.0001,0.0001,0.528,202,202
16,504,100,0,0.0001,0.0001,0.526,249,255
16,604,100,0,0.0001,0.0001,0.526,313,291
16,704,100,0,0.0001,0.0001,0.526,365,339
16,804,100,0,0.0001,0.0001,0.516,416,388
16,904,100,0,0.0001,0.0001,0.512,468,436
16,1004,100,0,0.0001,0.0001,0.504,519,485
16,1104,100,0,0.0001,0.0001,0.502,565,539
16,1204,100,0,0.0001,0.0001,0.508,617,587
16,1304,100,0,0.0001,0.0001,0.516,661,643
16,1404,100,0,0.0001,0.0001,0.512,710,694
16,1504,100,0,0.0001,0.0001,0.508,761,743
16,1604,100,0,0.0001,0.0001,0.508,804,800
16,1704,100,0,0.0001,0.0001,0.504,858,846
16,1804,100,0,0.0001,0.0001,0.514,906,898
16,1904,100,0,0.0001,0.0001,0.51,952,952
17,0,100,0,0.0001,0.0001,0.528,0,0
17,104,100,0,0.0001,0.0001,0.526,53,51
17,204,100,0,0.0001,0.0001,0.532,117,87
17,304,100,0,0.0001,0.0001,0.532,165,139
17,404,100,0,0.0001,0.0001,0.524,217,187
17,504,100,0,0.0001,0.0001,0.51,267,237
17,604,100,0,0.0001,0.0001,0.524,325,279
17,704,100,0,0.0001,0.0001,0.53,371,333
17,804,100,0,0.0001,0.0001,0.494,426,378
17,904,100,0,0.0001,0.0001,0.488,475,429
17,1004,100,0,0.0001,0.0001,0.486,524,480
17,1104,100,0,0.0001,0.0001,0.488,572,532
17,1204,100,0,0.0001,0.0001,0.488,616,588
17,1304,100,0,0.0001,0.0001,0.496,665,639
17,1404,100,0,0.0001,0.0001,0.506,708,696
17,1504,100,0,0.0001,0.0001,0.508,764,740
17,1604,100,0,0.0001,0.0001,0.524,807,797
17,1704,100,0,0.0001,0.0001,0.516,855,849
17,1804,100,0,0.0001,0.0001,0.514,906,898
17,1904,100,0,0.0001,0.0001,0.53,952,952
18,0,100,0,0.0001,0.0001,0.508,0,0
18,104,100,0,0.0001,0.0001,0.508,52,52
18,204,100,0,0.0001,0.0001,0.51,111,93
18,304,100,0,0.0001,0.0001,0.514,174,130
18,404,100,0,0.0001,0.0001,0.524,225,179
18,504,100,0,0.0001,0.0001,0.514,276,228
18,604,100,0,0.0001,0.0001,0.516,325,279
18,704,100,0,0.0001,0.0001,0.528,377,327
18,804,100,0,0.0001,0.0001,0.552,414,390
18,904,100,0,0.0001,0.0001,0.526,461,443
18,1004,100,0,0.0001,0.0001,0.52,503,501
18,1104,100,0,0.0001,0.0001,0.518,542,562
18,1204,100,0,0.0001,0.0001,0.526,596,608
18,1304,100,0,0.0001,0.0001,0.542,637,667
18,1404,100,0,0.0001,0.0001,0.514,687,717
18,1504,100,0,0.0001,0.0001,0.514,741,763
18,1604,100,0,0.0001,0.0001,0.512,797,807
18,1704,100,0,0.0001,0.0001,0.518,851,853
18,1804,100,0,0.0001,0.0001,0.526,904,900
18,1904,100,0,0.0001,0.0001,0.53,952,952
19,0,100,0,0.0001,0.0001,0.484,0,0
19,104,100,0,0.0001,0.0001,0.48,58,46
19,204,100,0,0.0001,0.0001,0.486,108,96
19,304,100,0,0.0001,0.0001,0.486,159,145
19,404,100,0,0.0001,0.0001,0.498,209,195
19,504,100,0,0.0001,0.0001,0.484,259,245
19,604,100,0,0.0001,0.0001,0.48,306,298
19,704,100,0,0.0001,0.0001,0.486,345,359
19,804,100,0,0.0001,0.0001,0.492,408,396
19,904,100,0,0.0001,0.0001,0.492,458,446
19,1004,100,0,0.0001,0.0001,0.496,506,498
19,1104,100,0,0.0001,0.0001,0.502,556,548
19,1204,100,0,0.0001,0.0001,0.506,597,607
19,1304,100,0,0.0001,0.0001,0.506,650,654
19,1404,100,0,0.0001,0.0001,0.502,693,711
19,1504,100,0,0.0001,0.0001,0.49,740,764
19,1604,100,0,0.0001,0.0001,0.504,787,817
19,1704,100,0,0.0001,0.0001,0.496,850,854
19,1804,100,0,0.0001,0.0001,0.508,901,903
19,1904,100,0,0.0001,0.0001,0.5,952,952
20,0,100,0,0.0001,0.0001,0.49,0,0
20,104,100,0,0.0001,0.0001,0.492,51,53
20,204,100,0,0.0001,0.0001,0.492,104,100
20,304,100,0,0.0001,0.0001,0.49,163,141
20,404,100,0,0.0001,0.0001,0.494,214,190
20,504,100,0,0.0001,0.0001,0.498,259,245
20,604,100,0,0.0001,0.0001,0.522,311,293
20,704,100,0,0.0001,0.0001,0.522,357,347
20,804,100,0,0.0001,0.0001,0.518,407,397
20,904,100,0,0.0001,0.0001,0.534,459,445
20,1004,100,0,0.0001,0.0001,0.536,501,503
20,1104,100,0,0.0001,0.0001,0.528,546,558
20,1204,100,0,0.0001,0.0001,0.526,597,607
20,1304,100,0,0.0001,0.0001,0.52,653,651
20,1404,100,0,0.0001,0.0001,0.52,706,698
20,1504,100,0,0.0001,0.0001,0.52,746,758
20,1604,100,0,0.0001,0.0001,0.514,799,805
20,1704,100,0,0.0001,0.0001,0.498,848,856
20,1804,100,0,0.0001,0.0001,0.49,898,906
20,1904,100,0,0.0001,0.0001,0.502,952,952
1,0,100,0,0.0001,0.001,0.5,0,0
1,104,100,0,0.0001,0.001,0.534,49,55
1,204,100,0,0.0001,0.001,0.566,88,116
1,304,100,0,0.0001,0.001,0.706,133,171
1,404,100,0,0.0001,0.001,0.646,192,212
1,504,100,0,0.0001,0.001,0.646,251,253
1,604,100,0,0.0001,0.001,0.752,298,306
1,704,100,0,0.0001,0.001,0.828,347,357
1,804,100,0,0.0001,0.001,0.864,403,401
1,904,100,0,0.0001,0.001,0.894,452,452
1,1004,100,0,0.0001,0.001,0.934,494,510
1,1104,100,0,0.0001,0.001,0.952,546,558
1,1204,100,0,0.0001,0.001,0.954,605,599
1,1304,100,0,0.0001,0.001,0.964,648,656
1,1404,100,0,0.0001,0.001,0.982,692,712
1,1504,100,0,0.0001,0.001,0.988,746,758
1,1604,100,0,0.0001,0.001,0.99,795,809
1,1704,100,0,0.0001,0.001,0.99,840,864
1,1804,100,0,0.0001,0.001,0.99,894,910
1,1904,100,0,0.0001,0.001,0.998,952,952
2,0,100,0,0.0001,0.001,0.5,0,0
2,104,100,0,0.0001,0.001,0.528,52,52
2,204,100,0,0.0001,0.001,0.55,104,100
2,304,100,0,0.0001,0.001,0.684,150,154
2,404,100,0,0.0001,0.001,0.642,208,196
2,504,100,0,0.0001,0.001,0.706,253,251
2,604,100,0,0.0001,0.001,0.816,298,306
2,704,100,0,0.0001,0.001,0.814,342,362
2,804,100,0,0.0001,0.001,0.88,389,415
2,904,100,0,0.0001,0.001,0.904,444,460
2,1004,100,0,0.0001,0.001,0.934,496,508
2,1104,100,0,0.0001,0.001,0.944,551,553
2,1204,100,0,0.0001,0.001,0.974,596,608
2,1304,100,0,0.0001,0.001,0.984,646,658
2,1404,100,0,0.0001,0.001,0.988,688,716
2,1504,100,0,0.0001,0.001,0.992,740,764
2,1604,100,0,0.0001,0.001,0.992,791,813
2,1704,100,0,0.0001,0.001,0.996,851,853
2,1804,100,0,0.0001,0.001,0.998,900,904
2,1904,100,0,0.0001,0.001,1.0,952,952
3,0,100,0,0.0001,0.001,0.5,0,0
3,104,100,0,0.0001,0.001,0.51,49,55
3,204,100,0,0.0001,0.001,0.558,107,97
3,304,100,0,0.0001,0.001,0.598,157,147
3,404,100,0,0.0001,0.001,0.576,213,191
3,504,100,0,0.0001,0.001,0.738,262,242
3,604,100,0,0.0001,0.001,0.7,319,285
3,704,100,0,0.0001,0.001,0.75,361,343
3,804,100,0,0.0001,0.001,0.84,416,388
3,904,100,0,0.0001,0.001,0.88,464,440
3,1004,100,0,0.0001,0.001,0.908,507,497
3,1104,100,0,0.0001,0.001,0.924,556,548
3,1204,100,0,0.0001,0.001,0.966,608,596
3,1304,100,0,0.0001,0.001,0.972,670,634
3,1404,100,0,0.0001,0.001,0.984,719,685
3,1504,100,0,0.0001,0.001,0.984,766,738
3,1604,100,0,0.0001,0.001,0.99,814,790
3,1704,100,0,0.0001,0.001,0.99,859,845
3,1804,100,0,0.0001,0.001,0.99,900,904
3,1904,100,0,0.0001,0.001,0.992,952,952
4,0,100,0,0.0001,0.001,0.5,0,0
4,104,100,0,0.0001,0.001,0.546,56,48
4,204,100,0,0.0001,0.001,0.536,103,101
4,304,100,0,0.0001,0.001,0.628,148,156
4,404,100,0,0.0001,0.001,0.558,194,210
4,504,100,0,0.0001,0.001,0.744,240,264
4,604,100,0,0.0001,0.001,0.726,291,313
4,704,100,0,0.0001,0.001,0.768,338,366
4,804,100,0,0.0001,0.001,0.824,390,414
4,904,100,0,0.0001,0.001,0.876,442,462
4,1004,100,0,0.0001,0.001,0.908,493,511
4,1104,100,0,0.0001,0.001,0.936,541,563
4,1204,100,0,0.0001,0.001,0.958,587,617
4,1304,100,0,0.0001,0.001,0.974,637,667
4,1404,100,0,0.0001,0.001,0.98,691,713
4,1504,100,0,0.0001,0.001,0.986,740,764
4,1604,100,0,0.0001,0.001,0.992,788,816
4,1704,100,0,0.0001,0.001,0.994,841,863
4,1804,100,0,0.0001,0.001,0.996,901,903
4,1904,100,0,0.0001,0.001,0.998,952,952
5,0,100,0,0.0001,0.001,0.5,0,0
5,104,100,0,0.0001,0.001,0.526,55,49
5,204,100,0,0.0001,0.001,0.574,100,104
5,304,100,0,0.0001,0.001,0.692,147,157
5,404,100,0,0.0001,0.001,0.6,194,210
5,504,100,0,0.0001,0.001,0.668,244,260
5,604,100,0,0.0001,0.001,0.742,289,315
5,704,100,0,0.0001,0.001,0.812,340,364
5,804,100,0,0.0001,0.001,0.828,386,418
5,904,100,0,0.0001,0.001,0.85,438,466
5,1004,100,0,0.0001,0.001,0.904,491,513
5,1104,100,0,0.0001,0.001,0.95,547,557
5,1204,100,0,0.0001,0.001,0.966,599,605
5,1304,100,0,0.0001,0.001,0.976,654,650
5,1404,100,0,0.0001,0.001,0.984,703,701
5,1504,100,0,0.0001,0.001,0.988,756,748
5,1604,100,0,0.0001,0.001,0.994,808,796
5,1704,100,0,0.0001,0.001,0.998,856,848
5,1804,100,0,0.0001,0.001,1.0,899,905
5,1904,100,0,0.0001,0.001,1.0,952,952
6,0,100,0,0.0001,0.001,0.5,0,0
6,104,100,0,0.0001,0.001,0.55,49,55
6,204,100,0,0.0001,0.001,0.532,98,106
6,304,100,0,0.0001,0.001,0.728,145,159
6,404,100,0,0.0001,0.001,0.652,196,208
6,504,100,0,0.0001,0.001,0.728,247,257
6,604,100,0,0.0001,0.001,0.824,297,307
6,704,100,0,0.0001,0.001,0.856,350,354
6,804,100,0,0.0001,0.001,0.884,393,411
6,904,100,0,0.0001,0.001,0.928,443,461
6,1004,100,0,0.0001,0.001,0.926,496,508
6,1104,100,0,0.0001,0.001,0.966,539,565
6,1204,100,0,0.0001,0.001,0.966,599,605
6,1304,100,0,0.0001,0.001,0.988,657,647
6,1404,100,0,0.0001,0.001,0.986,710,694
6,1504,100,0,0.0001,0.001,0.996,755,749
6,1604,100,0,0.0001,0.001,0.992,806,798
6,1704,100,0,0.0001,0.001,0.992,853,851
6,1804,100,0,0.0001,0.001,0.992,896,908
6,1904,100,0,0.0001,0.001,0.994,952,952
7,0,100,0,0.0001,0.001,0.502,0,0
7,104,100,0,0.0001,0.001,0.518,43,61
7,204,100,0,0.0001,0.001,0.594,94,110
7,304,100,0,0.0001,0.001,0.72,149,155
7,404,100,0,0.0001,0.001,0.682,195,209
7,504,100,0,0.0001,0.001,0.75,248,256
7,604,100,0,0.0001,0.001,0.802,297,307
7,704,100,0,0.0001,0.001,0.824,345,359
7,804,100,0,0.0001,0.001,0.868,398,406
7,904,100,0,0.0001,0.001,0.898,444,460
7,1004,100,0,0.0001,0.001,0.904,498,506
7,1104,100,0,0.0001,0.001,0.926,544,560
7,1204,100,0,0.0001,0.001,0.946,596,608
7,1304,100,0,0.0001,0.001,0.96,648,656
7,1404,100,0,0.0001,0.001,0.968,696,708
7,1504,100,0,0.0001,0.001,0.976,746,758
7,1604,100,0,0.0001,0.001,0.982,804,800
7,1704,100,0,0.0001,0.001,0.992,855,849
7,1804,100,0,0.0001,0.001,0.996,908,896
7,1904,100,0,0.0001,0.001,0.996,952,952
8,0,100,0,0.0001,0.001,0.5,0,0
8,104,100,0,0.0001,0.001,0.552,50,54
8,204,100,0,0.0001,0.001,0.536,98,106
8,304,100,0,0.0001,0.001,0.722,141,163
8,404,100,0,0.0001,0.001,0.574,186,218
8,504,100,0,0.0001,0.001,0.716,240,264
8,604,100,0,0.0001,0.001,0.75,303,301
8,704,100,0,0.0001,0.001,0.806,365,339
8,804,100,0,0.0001,0.001,0.84,410,394
8,904,100,0,0.0001,0.001,0.902,467,437
8,1004,100,0,0.0001,0.001,0.93,517,487
8,1104,100,0,0.0001,0.001,0.95,563,541
8,1204,100,0,0.0001,0.001,0.964,608,596
8,1304,100,0,0.0001,0.001,0.976,651,653
8,1404,100,0,0.0001,0.001,0.988,700,704
8,1504,100,0,0.0001,0.001,0.994,757,747
8,1604,100,0,0.0001,0.001,0.994,801,803
8,1704,100,0,0.0001,0.001,0.994,852,852
8,1804,100,0,0.0001,0.001,0.994,901,903
8,1904,100,0,0.0001,0.001,0.992,952,952
9,0,100,0,0.0001,0.001,0.504,0,0
9,104,100,0,0.0001,0.001,0.558,58,46
9,204,100,0,0.0001,0.001,0.536,101,103
9,304,100,0,0.0001,0.001,0.71,153,151
9,404,100,0,0.0001,0.001,0.596,194,210
9,504,100,0,0.0001,0.001,0.76,242,262
9,604,100,0,0.0001,0.001,0.82,303,301
9,704,100,0,0.0001,0.001,0.8,351,353
9,804,100,0,0.0001,0.001,0.886,405,399
9,904,100,0,0.0001,0.001,0.934,458,446
9,1004,100,0,0.0001,0.001,0.954,503,501
9,1104,100,0,0.0001,0.001,0.978,543,561
9,1204,100,0,0.0001,0.001,0.984,597,607
9,1304,100,0,0.0001,0.001,0.986,641,663
9,1404,100,0,0.0001,0.001,0.992,700,704
9,1504,100,0,0.0001,0.001,0.996,754,750
9,1604,100,0,0.0001,0.001,0.998,803,801
9,1704,100,0,0.0001,0.001,0.998,851,853
9,1804,100,0,0.0001,0.001,0.998,896,908
9,1904,100,0,0.0001,0.001,0.998,952,952
10,0,100,0,0.0001,0.001,0.5,0,0
10,104,100,0,0.0001,0.001,0.548,55,49
10,204,100,0,0.0001,0.001,0.538,103,101
10,304,100,0,0.0001,0.001,0.654,159,145
10,404,100,0,0.0001,0.001,0.602,214,190
10,504,100,0,0.0001,0.001,0.644,261,243
10,604,100,0,0.0001,0.001,0.714,313,291
10,704,100,0,0.0001,0.001,0.742,352,352
10,804,100,0,0.0001,0.001,0.8,398,406
10,904,100,0,0.0001,0.001,0.852,450,454
10,1004,100,0,0.0001,0.001,0.886,498,506
10,1104,100,0,0.0001,0.001,0.928,547,557
10,1204,100,0,0.0001,0.001,0.94,598,606
10,1304,100,0,0.0001,0.001,0.962,641,663
10,1404,100,0,0.0001,0.001,0.962,698,706
10,1504,100,0,0.0001,0.001,0.98,743,761
10,1604,100,0,0.0001,0.001,0.99,794,810
10,1704,100,0,0.0001,0.001,0.992,844,860
10,1804,100,0,0.0001,0.001,0.988,899,905
10,1904,100,0,0.0001,0.001,0.994,952,952
11,0,100,0,0.0001,0.001,0.508,0,0
11,104,100,0,0.0001,0.001,0.58,57,47
11,204,100,0,0.0001,0.001,0.508,108,96
11,304,100,0,0.0001,0.001,0.66,163,141
11,404,100,0,0.0001,0.001,0.592,211,193
11,504,100,0,0.0001,0.001,0.68,256,248
11,604,100,0,0.0001,0.001,0.766,313,291
11,704,100,0,0.0001,0.001,0.788,364,340
11,804,100,0,0.0001,0.001,0.852,416,388
11,904,100,0,0.0001,0.001,0.888,461,443
11,1004,100,0,0.0001,0.001,0.902,520,484
11,1104,100,0,0.0001,0.001,0.934,568,536
11,1204,100,0,0.0001,0.001,0.948,623,581
11,1304,100,0,0.0001,0.001,0.972,666,638
11,1404,100,0,0.0001,0.001,0.984,710,694
11,1504,100,0,0.0001,0.001,0.986,763,741
11,1604,100,0,0.0001,0.001,0.988,812,792
11,1704,100,0,0.0001,0.001,0.992,865,839
11,1804,100,0,0.0001,0.001,0.996,906,898
11,1904,100,0,0.0001,0.001,0.998,952,952
12,0,100,0,0.0001,0.001,0.5,0,0
12,104,100,0,0.0001,0.001,0.53,52,52
12,204,100,0,0.0001,0.001,0.518,99,105
12,304,100,0,0.0001,0.001,0.676,149,155
12,404,100,0,0.0001,0.001,0.606,194,210
12,504,100,0,0.0001,0.001,0.676,244,260
12,604,100,0,0.0001,0.001,0.756,291,313
12,704,100,0,0.0001,0.001,0.804,338,366
12,804,100,0,0.0001,0.001,0.876,390,414
12,904,100,0,0.0001,0.001,0.878,439,465
12,1004,100,0,0.0001,0.001,0.926,485,519
12,1104,100,0,0.0001,0.001,0.942,528,576
12,1204,100,0,0.0001,0.001,0.966,577,627
12,1304,100,0,0.0001,0.001,0.978,629,675
12,1404,100,0,0.0001,0.001,0.984,685,719
12,1504,100,0,0.0001,0.001,0.988,743,761
12,1604,100,0,0.0001,0.001,0.988,790,814
12,1704,100,0,0.0001,0.001,0.99,848,856
12,1804,100,0,0.0001,0.001,0.994,898,906
12,1904,100,0,0.0001,0.001,0.994,952,952
13,0,100,0,0.0001,0.001,0.5,0,0
13,104,100,0,0.0001,0.001,0.554,55,49
13,204,100,0,0.0001,0.001,0.522,107,97
13,304,100,0,0.0001,0.001,0.682,157,147
13,404,100,0,0.0001,0.001,0.59,205,199
13,504,100,0,0.0001,0.001,0.758,258,246
13,604,100,0,0.0001,0.001,0.766,309,295
13,704,100,0,0.0001,0.001,0.782,349,355
13,804,100,0,0.0001,0.001,0.86,389,415
13,904,100,0,0.0001,0.001,0.894,444,460
13,1004,100,0,0.0001,0.001,0.924,494,510
13,1104,100,0,0.0001,0.001,0.944,551,553
13,1204,100,0,0.0001,0.001,0.972,605,599
13,1304,100,0,0.0001,0.001,0.978,654,650
13,1404,100,0,0.0001,0.001,0.98,699,705
13,1504,100,0,0.0001,0.001,0.986,745,759
13,1604,100,0,0.0001,0.001,0.994,791,813
13,1704,100,0,0.0001,0.001,0.996,847,857
13,1804,100,0,0.0001,0.001,1.0,898,906
13,1904,100,0,0.0001,0.001,1.0,952,952
14,0,100,0,0.0001,0.001,0.5,0,0
14,104,100,0,0.0001,0.001,0.54,48,56
14,204,100,0,0.0001,0.001,0.568,91,113
14,304,100,0,0.0001,0.001,0.718,144,160
14,404,100,0,0.0001,0.001,0.658,192,212
14,504,100,0,0.0001,0.001,0.768,241,263
14,604,100,0,0.0001,0.001,0.804,290,314
14,704,100,0,0.0001,0.001,0.822,340,364
14,804,100,0,0.0001,0.001,0.89,387,417
14,904,100,0,0.0001,0.001,0.918,438,466
14,1004,100,0,0.0001,0.001,0.946,493,511
14,1104,100,0,0.0001,0.001,0.97,555,549
14,1204,100,0,0.0001,0.001,0.982,597,607
14,1304,100,0,0.0001,0.001,0.99,650,654
14,1404,100,0,0.0001,0.001,0.996,700,704
14,1504,100,0,0.0001,0.001,0.996,751,753
14,1604,100,0,0.0001,0.001,0.996,804,800
14,1704,100,0,0.0001,0.001,0.996,853,851
14,1804,100,0,0.0001,0.001,0.996,902,902
14,1904,100,0,0.0001,0.001,0.998,952,952
15,0,100,0,0.0001,0.001,0.502,0,0
15,104,100,0,0.0001,0.001,0.556,61,43
15,204,100,0,0.0001,0.001,0.516,119,85
15,304,100,0,0.0001,0.001,0.548,172,132
15,404,100,0,0.0001,0.001,0.618,218,186
15,504,100,0,0.0001,0.001,0.778,266,238
15,604,100,0,0.0001,0.001,0.724,315,289
15,704,100,0,0.0001,0.001,0.81,361,343
15,804,100,0,0.0001,0.001,0.876,415,389
15,904,100,0,0.0001,0.001,0.912,454,450
15,1004,100,0,0.0001,0.001,0.932,499,505
15,1104,100,0,0.0001,0.001,0.97,553,551
15,1204,100,0,0.0001,0.001,0.98,599,605
15,1304,100,0,0.0001,0.001,0.986,646,658
15,1404,100,0,0.0001,0.001,0.996,700,704
15,1504,100,0,0.0001,0.001,0.996,742,762
15,1604,100,0,0.0001,0.001,0.996,794,810
15,1704,100,0,0.0001,0.001,0.998,847,857
15,1804,100,0,0.0001,0.001,1.0,896,908
15,1904,100,0,0.0001,0.001,1.0,952,952
16,0,100,0,0.0001,0.001,0.506,0,0
16,104,100,0,0.0001,0.001,0.588,54,50
16,204,100,0,0.0001,0.001,0.506,106,98
16,304,100,0,0.0001,0.001,0.676,160,144
16,404,100,0,0.0001,0.001,0.618,206,198
16,504,100,0,0.0001,0.001,0.692,244,260
16,604,100,0,0.0001,0.001,0.774,302,302
16,704,100,0,0.0001,0.001,0.804,364,340
16,804,100,0,0.0001,0.001,0.828,419,385
16,904,100,0,0.0001,0.001,0.872,456,448
16,1004,100,0,0.0001,0.001,0.898,505,499
16,1104,100,0,0.0001,0.001,0.934,559,545
16,1204,100,0,0.0001,0.001,0.956,604,600
16,1304,100,0,0.0001,0.001,0.966,656,648
16,1404,100,0,0.0001,0.001,0.978,705,699
16,1504,100,0,0.0001,0.001,0.978,743,761
16,1604,100,0,0.0001,0.001,0.99,802,802
16,1704,100,0,0.0001,0.001,0.994,852,852
16,1804,100,0,0.0001,0.001,0.994,902,902
16,1904,100,0,0.0001,0.001,1.0,952,952
17,0,100,0,0.0001,0.001,0.502,0,0
17,104,100,0,0.0001,0.001,0.544,44,60
17,204,100,0,0.0001,0.001,0.532,93,111
17,304,100,0,0.0001,0.001,0.648,148,156
17,404,100,0,0.0001,0.001,0.6,194,210
17,504,100,0,0.0001,0.001,0.692,244,260
17,604,100,0,0.0001,0.001,0.754,295,309
17,704,100,0,0.0001,0.001,0.782,342,362
17,804,100,0,0.0001,0.001,0.844,392,412
17,904,100,0,0.0001,0.001,0.864,442,462
17,1004,100,0,0.0001,0.001,0.9,497,507
17,1104,100,0,0.0001,0.001,0.922,542,562
17,1204,100,0,0.0001,0.001,0.946,592,612
17,1304,100,0,0.0001,0.001,0.964,643,661
17,1404,100,0,0.0001,0.001,0.972,697,707
17,1504,100,0,0.0001,0.001,0.982,752,752
17,1604,100,0,0.0001,0.001,0.986,806,798
17,1704,100,0,0.0001,0.001,0.994,859,845
17,1804,100,0,0.0001,0.001,0.998,911,893
17,1904,100,0,0.0001,0.001,1.0,952,952
18,0,100,0,0.0001,0.001,0.502,0,0
18,104,100,0,0.0001,0.001,0.558,52,52
18,204,100,0,0.0001,0.001,0.502,102,102
18,304,100,0,0.0001,0.001,0.606,149,155
18,404,100,0,0.0001,0.001,0.564,198,206
18,504,100,0,0.0001,0.001,0.646,253,251
18,604,100,0,0.0001,0.001,0.748,300,304
18,704,100,0,0.0001,0.001,0.766,355,349
18,804,100,0,0.0001,0.001,0.814,395,409
18,904,100,0,0.0001,0.001,0.852,445,459
18,1004,100,0,0.0001,0.001,0.902,503,501
18,1104,100,0,0.0001,0.001,0.924,549,555
18,1204,100,0,0.0001,0.001,0.94,595,609
18,1304,100,0,0.0001,0.001,0.956,647,657
18,1404,100,0,0.0001,0.001,0.978,690,714
18,1504,100,0,0.0001,0.001,0.99,740,764
18,1604,100,0,0.0001,0.001,0.996,792,812
18,1704,100,0,0.0001,0.001,0.996,847,857
18,1804,100,0,0.0001,0.001,0.998,903,901
18,1904,100,0,0.0001,0.001,0.998,952,952
19,0,100,0,0.0001,0.001,0.5,0,0
19,104,100,0,0.0001,0.001,0.566,55,49
19,204,100,0,0.0001,0.001,0.51,104,100
19,304,100,0,0.0001,0.001,0.684,148,156
19,404,100,0,0.0001,0.001,0.642,206,198
19,504,100,0,0.0001,0.001,0.64,257,247
19,604,100,0,0.0001,0.001,0.712,311,293
19,704,100,0,0.0001,0.001,0.784,358,346
19,804,100,0,0.0001,0.001,0.822,413,391
19,904,100,0,0.0001,0.001,0.88,469,435
19,1004,100,0,0.0001,0.001,0.916,514,490
19,1104,100,0,0.0001,0.001,0.944,567,537
19,1204,100,0,0.0001,0.001,0.948,611,593
19,1304,100,0,0.0001,0.001,0.964,658,646
19,1404,100,0,0.0001,0.001,0.978,709,695
19,1504,100,0,0.0001,0.001,0.986,759,745
19,1604,100,0,0.0001,0.001,0.99,802,802
19,1704,100,0,0.0001,0.001,0.992,851,853
19,1804,100,0,0.0001,0.001,0.992,899,905
19,1904,100,0,0.0001,0.001,0.996,952,952
20,0,100,0,0.0001,0.001,0.506,0,0
20,104,100,0,0.0001,0.001,0.576,50,54
20,204,100,0,0.0001,0.001,0.528,97,107
20,304,100,0,0.0001,0.001,0.666,146,158
20,404,100,0,0.0001,0.001,0.632,194,210
20,504,100,0,0.0001,0.001,0.646,238,266
20,604,100,0,0.0001,0.001,0.722,285,319
20,704,100,0,0.0001,0.001,0.77,341,363
20,804,100,0,0.0001,0.001,0.82,398,406
20,904,100,0,0.0001,0.001,0.858,444,460
20,1004,100,0,0.0001,0.001,0.882,494,510
20,1104,100,0,0.0001,0.001,0.918,552,552
20,1204,100,0,0.0001,0.001,0.942,606,598
20,1304,100,0,0.0001,0.001,0.96,654,650
20,1404,100,0,0.0001,0.001,0.968,705,699
20,1504,100,0,0.0001,0.001,0.984,748,756
20,1604,100,0,0.0001,0.001,0.988,799,805
20,1704,100,0,0.0001,0.001,0.994,852,852
20,1804,100,0,0.0001,0.001,0.994,900,904
20,1904,100,0,0.0001,0.001,0.994,952,952
1,0,100,0,0.0001,0.01,0.506,0,0
1,104,100,0,0.0001,0.01,0.54,46,58
1,204,100,0,0.0001,0.01,0.588,86,118
1,304,100,0,0.0001,0.01,0.606,132,172
1,404,100,0,0.0001,0.01,0.578,180,224
1,504,100,0,0.0001,0.01,0.59,235,269
1,604,100,0,0.0001,0.01,0.598,285,319
1,704,100,0,0.0001,0.01,0.576,338,366
1,804,100,0,0.0001,0.01,0.586,393,411
1,904,100,0,0.0001,0.01,0.608,450,454
1,1004,100,0,0.0001,0.01,0.626,499,505
1,1104,100,0,0.0001,0.01,0.616,547,557
1,1204,100,0,0.0001,0.01,0.618,605,599
1,1304,100,0,0.0001,0.01,0.606,662,642
1,1404,100,0,0.0001,0.01,0.628,710,694
1,1504,100,0,0.0001,0.01,0.626,764,740
1,1604,100,0,0.0001,0.01,0.65,808,796
1,1704,100,0,0.0001,0.01,0.676,859,845
1,1804,100,0,0.0001,0.01,0.678,905,899
1,1904,100,0,0.0001,0.01,0.662,952,952
2,0,100,0,0.0001,0.01,0.498,0,0
2,104,100,0,0.0001,0.01,0.58,48,56
2,204,100,0,0.0001,0.01,0.546,99,105
2,304,100,0,0.0001,0.01,0.558,155,149
2,404,100,0,0.0001,0.01,0.544,205,199
2,504,100,0,0.0001,0.01,0.558,258,246
2,604,100,0,0.0001,0.01,0.548,311,293
2,704,100,0,0.0001,0.01,0.546,364,340
2,804,100,0,0.0001,0.01,0.562,404,400
2,904,100,0,0.0001,0.01,0.558,461,443
2,1004,100,0,0.0001,0.01,0.558,516,488
2,1104,100,0,0.0001,0.01,0.564,564,540
2,1204,100,0,0.0001,0.01,0.574,609,595
2,1304,100,0,0.0001,0.01,0.546,659,645
2,1404,100,0,0.0001,0.01,0.55,713,691
2,1504,100,0,0.0001,0.01,0.562,756,748
2,1604,100,0,0.0001,0.01,0.566,806,798
2,1704,100,0,0.0001,0.01,0.568,853,851
2,1804,100,0,0.0001,0.01,0.586,905,899
2,1904,100,0,0.0001,0.01,0.58,952,952
3,0,100,0,0.0001,0.01,0.504,0,0
3,104,100,0,0.0001,0.01,0.552,46,58
3,204,100,0,0.0001,0.01,0.53,90,114
3,304,100,0,0.0001,0.01,0.566,149,155
3,404,100,0,0.0001,0.01,0.536,195,209
3,504,100,0,0.0001,0.01,0.514,240,264
3,604,100,0,0.0001,0.01,0.514,293,311
3,704,100,0,0.0001,0.01,0.534,345,359
3,804,100,0,0.0001,0.01,0.526,394,410
3,904,100,0,0.0001,0.01,0.532,454,450
3,1004,100,0,0.0001,0.01,0.524,507,497
3,1104,100,0,0.0001,0.01,0.55,553,551
3,1204,100,0,0.0001,0.01,0.566,605,599
3,1304,100,0,0.0001,0.01,0.544,657,647
3,1404,100,0,0.0001,0.01,0.552,706,698
3,1504,100,0,0.0001,0.01,0.528,751,753
3,1604,100,0,0.0001,0.01,0.552,801,803
3,1704,100,0,0.0001,0.01,0.564,857,847
3,1804,100,0,0.0001,0.01,0.6,898,906
3,1904,100,0,0.0001,0.01,0.582,952,952
4,0,100,0,0.0001,0.01,0.516,0,0
4,104,100,0,0.0001,0.01,0.5,53,51
4,204,100,0,0.0001,0.01,0.512,92,112
4,304,100,0,0.0001,0.01,0.506,143,161
4,404,100,0,0.0001,0.01,0.538,187,217
4,504,100,0,0.0001,0.01,0.524,244,260
4,604,100,0,0.0001,0.01,0.514,304,300
4,704,100,0,0.0001,0.01,0.506,351,353
4,804,100,0,0.0001,0.01,0.492,395,409
4,904,100,0,0.0001,0.01,0.48,446,458
4,1004,100,0,0.0001,0.01,0.496,491,513
4,1104,100,0,0.0001,0.01,0.5,546,558
4,1204,100,0,0.0001,0.01,0.492,594,610
4,1304,100,0,0.0001,0.01,0.498,643,661
4,1404,100,0,0.0001,0.01,0.5,691,713
4,1504,100,0,0.0001,0.01,0.49,743,761
4,1604,100,0,0.0001,0.01,0.484,793,811
4,1704,100,0,0.0001,0.01,0.476,844,860
4,1804,100,0,0.0001,0.01,0.514,901,903
4,1904,100,0,0.0001,0.01,0.514,952,952
5,0,100,0,0.0001,0.01,0.502,0,0
5,104,100,0,0.0001,0.01,0.566,49,55
5,204,100,0,0.0001,0.01,0.584,92,112
5,304,100,0,0.0001,0.01,0.586,147,157
5,404,100,0,0.0001,0.01,0.566,203,201
5,504,100,0,0.0001,0.01,0.572,257,247
5,604,100,0,0.0001,0.01,0.572,306,298
5,704,100,0,0.0001,0.01,0.566,350,354
5,804,100,0,0.0001,0.01,0.534,395,409
5,904,100,0,0.0001,0.01,0.528,446,458
5,1004,100,0,0.0001,0.01,0.532,499,505
5,1104,100,0,0.0001,0.01,0.544,551,553
5,1204,100,0,0.0001,0.01,0.556,599,605
5,1304,100,0,0.0001,0.01,0.542,649,655
5,1404,100,0,0.0001,0.01,0.55,696,708
5,1504,100,0,0.0001,0.01,0.58,746,758
5,1604,100,0,0.0001,0.01,0.566,793,811
5,1704,100,0,0.0001,0.01,0.596,849,855
5,1804,100,0,0.0001,0.01,0.588,899,905
5,1904,100,0,0.0001,0.01,0.594,952,952
6,0,100,0,0.0001,0.01,0.504,0,0
6,104,100,0,0.0001,0.01,0.544,50,54
6,204,100,0,0.0001,0.01,0.604,104,100
6,304,100,0,0.0001,0.01,0.616,156,148
6,404,100,0,0.0001,0.01,0.532,206,198
6,504,100,0,0.0001,0.01,0.568,252,252
6,604,100,0,0.0001,0.01,0.57,314,290
6,704,100,0,0.0001,0.01,0.552,361,343
6,804,100,0,0.0001,0.01,0.568,408,396
6,904,100,0,0.0001,0.01,0.566,454,450
6,1004,100,0,0.0001,0.01,0.562,507,497
6,1104,100,0,0.0001,0.01,0.558,571,533
6,1204,100,0,0.0001,0.01,0.586,617,587
6,1304,100,0,0.0001,0.01,0.608,664,640
6,1404,100,0,0.0001,0.01,0.606,712,692
6,1504,100,0,0.0001,0.01,0.606,758,746
6,1604,100,0,0.0001,0.01,0.606,813,791
6,1704,100,0,0.0001,0.01,0.622,855,849
6,1804,100,0,0.0001,0.01,0.636,899,905
6,1904,100,0,0.0001,0.01,0.622,952,952
7,0,100,0,0.0001,0.01,0.5,0,0
7,104,100,0,0.0001,0.01,0.548,44,60
7,204,100,0,0.0001,0.01,0.564,94,110
7,304,100,0,0.0001,0.01,0.604,145,159
7,404,100,0,0.0001,0.01,0.552,199,205
7,504,100,0,0.0001,0.01,0.584,247,257
7,604,100,0,0.0001,0.01,0.586,300,304
7,704,100,0,0.0001,0.01,0.562,341,363
7,804,100,0,0.0001,0.01,0.584,391,413
7,904,100,0,0.0001,0.01,0.574,444,460
7,1004,100,0,0.0001,0.01,0.586,492,512
7,1104,100,0,0.0001,0.01,0.586,543,561
7,1204,100,0,0.0001,0.01,0.586,596,608
7,1304,100,0,0.0001,0.01,0.596,651,653
7,1404,100,0,0.0001,0.01,0.582,703,701
7,1504,100,0,0.0001,0.01,0.572,751,753
7,1604,100,0,0.0001,0.01,0.558,796,808
7,1704,100,0,0.0001,0.01,0.584,848,856
7,1804,100,0,0.0001,0.01,0.588,902,902
7,1904,100,0,0.0001,0.01,0.606,952,952
8,0,100,0,0.0001,0.01,0.5,0,0
8,104,100,0,0.0001,0.01,0.526,47,57
8,204,100,0,0.0001,0.01,0.524,98,106
8,304,100,0,0.0001,0.01,0.518,147,157
8,404,100,0,0.0001,0.01,0.528,195,209
8,504,100,0,0.0001,0.01,0.52,247,257
8,604,100,0,0.0001,0.01,0.534,295,309
8,704,100,0,0.0001,0.01,0.512,351,353
8,804,100,0,0.0001,0.01,0.516,408,396
8,904,100,0,0.0001,0.01,0.524,452,452
8,1004,100,0,0.0001,0.01,0.528,502,502
8,1104,100,0,0.0001,0.01,0.524,547,557
8,1204,100,0,0.0001,0.01,0.542,594,610
8,1304,100,0,0.0001,0.01,0.548,652,652
8,1404,100,0,0.0001,0.01,0.592,700,704
8,1504,100,0,0.0001,0.01,0.586,743,761
8,1604,100,0,0.0001,0.01,0.55,793,811
8,1704,100,0,0.0001,0.01,0.536,846,858
8,1804,100,0,0.0001,0.01,0.566,903,901
8,1904,100,0,0.0001,0.01,0.548,952,952
9,0,100,0,0.0001,0.01,0.5,0,0
9,104,100,0,0.0001,0.01,0.532,55,49
9,204,100,0,0.0001,0.01,0.522,109,95
9,304,100,0,0.0001,0.01,0.532,160,144
9,404,100,0,0.0001,0.01,0.55,207,197
9,504,100,0,0.0001,0.01,0.57,258,246
9,604,100,0,0.0001,0.01,0.55,307,297
9,704,100,0,0.0001,0.01,0.56,361,343
9,804,100,0,0.0001,0.01,0.544,407,397
9,904,100,0,0.0001,0.01,0.55,456,448
9,1004,100,0,0.0001,0.01,0.534,508,496
9,1104,100,0,0.0001,0.01,0.538,559,545
9,1204,100,0,0.0001,0.01,0.526,609,595
9,1304,100,0,0.0001,0.01,0.526,665,639
9,1404,100,0,0.0001,0.01,0.538,710,694
9,1504,100,0,0.0001,0.01,0.536,761,743
9,1604,100,0,0.0001,0.01,0.548,806,798
9,1704,100,0,0.0001,0.01,0.558,858,846
9,1804,100,0,0.0001,0.01,0.546,904,900
9,1904,100,0,0.0001,0.01,0.56,952,952
10,0,100,0,0.0001,0.01,0.502,0,0
10,104,100,0,0.0001,0.01,0.53,54,50
10,204,100,0,0.0001,0.01,0.542,106,98
10,304,100,0,0.0001,0.01,0.558,158,146
10,404,100,0,0.0001,0.01,0.6,209,195
10,504,100,0,0.0001,0.01,0.582,257,247
10,604,100,0,0.0001,0.01,0.598,306,298
10,704,100,0,0.0001,0.01,0.596,355,349
10,804,100,0,0.0001,0.01,0.592,405,399
10,904,100,0,0.0001,0.01,0.602,452,452
10,1004,100,0,0.0001,0.01,0.606,505,499
10,1104,100,0,0.0001,0.01,0.594,546,558
10,1204,100,0,0.0001,0.01,0.608,602,602
10,1304,100,0,0.0001,0.01,0.602,654,650
10,1404,100,0,0.0001,0.01,0.606,707,697
10,1504,100,0,0.0001,0.01,0.604,748,756
10,1604,100,0,0.0001,0.01,0.594,806,798
10,1704,100,0,0.0001,0.01,0.602,859,845
10,1804,100,0,0.0001,0.01,0.58,900,904
10,1904,100,0,0.0001,0.01,0.58,952,952
11,0,100,0,0.0001,0.01,0.504,0,0
11,104,100,0,0.0001,0.01,0.534,46,58
11,204,100,0,0.0001,0.01,0.56,96,108
11,304,100,0,0.0001,0.01,0.57,148,156
11,404,100,0,0.0001,0.01,0.562,204,200
11,504,100,0,0.0001,0.01,0.57,252,252
11,604,100,0,0.0001,0.01,0.558,308,296
11,704,100,0,0.0001,0.01,0.558,354,350
11,804,100,0,0.0001,0.01,0.536,405,399
11,904,100,0,0.0001,0.01,0.524,454,450
11,1004,100,0,0.0001,0.01,0.536,503,501
11,1104,100,0,0.0001,0.01,0.528,548,556
11,1204,100,0,0.0001,0.01,0.516,592,612
11,1304,100,0,0.0001,0.01,0.542,631,673
11,1404,100,0,0.0001,0.01,0.558,685,719
11,1504,100,0,0.0001,0.01,0.54,735,769
11,1604,100,0,0.0001,0.01,0.546,791,813
11,1704,100,0,0.0001,0.01,0.554,842,862
11,1804,100,0,0.0001,0.01,0.526,895,909
11,1904,100,0,0.0001,0.01,0.54,952,952
12,0,100,0,0.0001,0.01,0.502,0,0
12,104,100,0,0.0001,0.01,0.558,52,52
12,204,100,0,0.0001,0.01,0.538,96,108
12,304,100,0,0.0001,0.01,0.592,149,155
12,404,100,0,0.0001,0.01,0.612,202,202
12,504,100,0,0.0001,0.01,0.58,249,255
12,604,100,0,0.0001,0.01,0.572,303,301
12,704,100,0,0.0001,0.01,0.57,353,351
12,804,100,0,0.0001,0.01,0.568,399,405
12,904,100,0,0.0001,0.01,0.594,451,453
12,1004,100,0,0.0001,0.01,0.578,506,498
12,1104,100,0,0.0001,0.01,0.598,556,548
12,1204,100,0,0.0001,0.01,0.594,605,599
12,1304,100,0,0.0001,0.01,0.594,659,645
12,1404,100,0,0.0001,0.01,0.624,708,696
12,1504,100,0,0.0001,0.01,0.626,757,747
12,1604,100,0,0.0001,0.01,0.63,807,797
12,1704,100,0,0.0001,0.01,0.644,855,849
12,1804,100,0,0.0001,0.01,0.636,904,900
12,1904,100,0,0.0001,0.01,0.626,952,952
13,0,100,0,0.0001,0.01,0.506,0,0
13,104,100,0,0.0001,0.01,0.564,60,44
13,204,100,0,0.0001,0.01,0.518,116,88
13,304,100,0,0.0001,0.01,0.578,162,142
13,404,100,0,0.0001,0.01,0.566,220,184
13,504,100,0,0.0001,0.01,0.55,272,232
13,604,100,0,0.0001,0.01,0.542,323,281
13,704,100,0,0.0001,0.01,0.53,372,332
13,804,100,0,0.0001,0.01,0.528,425,379
13,904,100,0,0.0001,0.01,0.536,469,435
13,1004,100,0,0.0001,0.01,0.536,519,485
13,1104,100,0,0.0001,0.01,0.54,563,541
13,1204,100,0,0.0001,0.01,0.54,610,594
13,1304,100,0,0.0001,0.01,0.56,665,639
13,1404,100,0,0.0001,0.01,0.564,715,689
13,1504,100,0,0.0001,0.01,0.56,760,744
13,1604,100,0,0.0001,0.01,0.572,808,796
13,1704,100,0,0.0001,0.01,0.578,855,849
13,1804,100,0,0.0001,0.01,0.566,913,891
13,1904,100,0,0.0001,0.01,0.592,952,952
14,0,100,0,0.0001,0.01,0.502,0,0
14,104,100,0,0.0001,0.01,0.55,52,52
14,204,100,0,0.0001,0.01,0.502,104,100
14,304,100,0,0.0001,0.01,0.564,160,144
14,404,100,0,0.0001,0.01,0.582,215,189
14,504,100,0,0.0001,0.01,0.564,265,239
14,604,100,0,0.0001,0.01,0.586,308,296
14,704,100,0,0.0001,0.01,0.582,352,352
14,804,100,0,0.0001,0.01,0.562,400,404
14,904,100,0,0.0001,0.01,0.562,454,450
14,1004,100,0,0.0001,0.01,0.568,506,498
14,1104,100,0,0.0001,0.01,0.564,557,547
14,1204,100,0,0.0001,0.01,0.576,604,600
14,1304,100,0,0.0001,0.01,0.562,656,648
14,1404,100,0,0.0001,0.01,0.572,709,695
14,1504,100,0,0.0001,0.01,0.57,763,741
14,1604,100,0,0.0001,0.01,0.556,813,791
14,1704,100,0,0.0001,0.01,0.58,859,845
14,1804,100,0,0.0001,0.01,0.594,908,896
14,1904,100,0,0.0001,0.01,0.59,952,952
15,0,100,0,0.0001,0.01,0.504,0,0
15,104,100,0,0.0001,0.01,0.568,57,47
15,204,100,0,0.0001,0.01,0.526,106,98
15,304,100,0,0.0001,0.01,0.574,151,153
15,404,100,0,0.0001,0.01,0.564,202,202
15,504,100,0,0.0001,0.01,0.522,253,251
15,604,100,0,0.0001,0.01,0.538,291,313
15,704,100,0,0.0001,0.01,0.542,341,363
15,804,100,0,0.0001,0.01,0.53,396,408
15,904,100,0,0.0001,0.01,0.53,439,465
15,1004,100,0,0.0001,0.01,0.54,488,516
15,1104,100,0,0.0001,0.01,0.562,539,565
15,1204,100,0,0.0001,0.01,0.57,584,620
15,1304,100,0,0.0001,0.01,0.57,645,659
15,1404,100,0,0.0001,0.01,0.564,686,718
15,1504,100,0,0.0001,0.01,0.566,738,766
15,1604,100,0,0.0001,0.01,0.572,790,814
15,1704,100,0,0.0001,0.01,0.596,843,861
15,1804,100,0,0.0001,0.01,0.594,899,905
15,1904,100,0,0.0001,0.01,0.598,952,952
16,0,100,0,0.0001,0.01,0.508,0,0
16,104,100,0,0.0001,0.01,0.53,46,58
16,204,100,0,0.0001,0.01,0.498,98,106
16,304,100,0,0.0001,0.01,0.558,150,154
16,404,100,0,0.0001,0.01,0.52,192,212
16,504,100,0,0.0001,0.01,0.568,240,264
16,604,100,0,0.0001,0.01,0.568,293,311
16,704,100,0,0.0001,0.01,0.538,338,366
16,804,100,0,0.0001,0.01,0.532,393,411
16,904,100,0,0.0001,0.01,0.552,444,460
16,1004,100,0,0.0001,0.01,0.558,496,508
16,1104,100,0,0.0001,0.01,0.54,550,554
16,1204,100,0,0.0001,0.01,0.54,601,603
16,1304,100,0,0.0001,0.01,0.56,651,653
16,1404,100,0,0.0001,0.01,0.548,705,699
16,1504,100,0,0.0001,0.01,0.586,768,736
16,1604,100,0,0.0001,0.01,0.582,818,786
16,1704,100,0,0.0001,0.01,0.588,860,844
16,1804,100,0,0.0001,0.01,0.584,906,898
16,1904,100,0,0.0001,0.01,0.582,952,952
17,0,100,0,0.0001,0.01,0.502,0,0
17,104,100,0,0.0001,0.01,0.576,47,57
17,204,100,0,0.0001,0.01,0.568,105,99
17,304,100,0,0.0001,0.01,0.592,153,151
17,404,100,0,0.0001,0.01,0.568,203,201
17,504,100,0,0.0001,0.01,0.58,258,246
17,604,100,0,0.0001,0.01,0.564,302,302
17,704,100,0,0.0001,0.01,0.57,356,348
17,804,100,0,0.0001,0.01,0.572,401,403
17,904,100,0,0.0001,0.01,0.58,443,461
17,1004,100,0,0.0001,0.01,0.574,499,505
17,1104,100,0,0.0001,0.01,0.578,557,547
17,1204,100,0,0.0001,0.01,0.6,598,606
17,1304,100,0,0.0001,0.01,0.592,644,660
17,1404,100,0,0.0001,0.01,0.598,699,705
17,1504,100,0,0.0001,0.01,0.608,756,748
17,1604,100,0,0.0001,0.01,0.63,805,799
17,1704,100,0,0.0001,0.01,0.608,851,853
17,1804,100,0,0.0001,0.01,0.6,905,899
17,1904,100,0,0.0001,0.01,0.616,952,952
18,0,100,0,0.0001,0.01,0.502,0,0
18,104,100,0,0.0001,0.01,0.526,58,46
18,204,100,0,0.0001,0.01,0.576,107,97
18,304,100,0,0.0001,0.01,0.616,155,149
18,404,100,0,0.0001,0.01,0.584,209,195
18,504,100,0,0.0001,0.01,0.594,259,245
18,604,100,0,0.0001,0.01,0.59,306,298
18,704,100,0,0.0001,0.01,0.57,348,356
18,804,100,0,0.0001,0.01,0.564,403,401
18,904,100,0,0.0001,0.01,0.556,443,461
18,1004,100,0,0.0001,0.01,0.592,491,513
18,1104,100,0,0.0001,0.01,0.584,548,556
18,1204,100,0,0.0001,0.01,0.574,604,600
18,1304,100,0,0.0001,0.01,0.596,650,654
18,1404,100,0,0.0001,0.01,0.606,701,703
18,1504,100,0,0.0001,0.01,0.608,755,749
18,1604,100,0,0.0001,0.01,0.612,806,798
18,1704,100,0,0.0001,0.01,0.656,857,847
18,1804,100,0,0.0001,0.01,0.664,904,900
18,1904,100,0,0.0001,0.01,0.666,952,952
19,0,100,0,0.0001,0.01,0.5,0,0
19,104,100,0,0.0001,0.01,0.528,52,52
19,204,100,0,0.0001,0.01,0.502,106,98
19,304,100,0,0.0001,0.01,0.53,147,157
19,404,100,0,0.0001,0.01,0.574,200,204
19,504,100,0,0.0001,0.01,0.59,240,264
19,604,100,0,0.0001,0.01,0.6,294,310
19,704,100,0,0.0001,0.01,0.584,342,362
19,804,100,0,0.0001,0.01,0.588,395,409
19,904,100,0,0.0001,0.01,0.578,441,463
19,1004,100,0,0.0001,0.01,0.558,487,517
19,1104,100,0,0.0001,0.01,0.576,536,568
19,1204,100,0,0.0001,0.01,0.586,587,617
19,1304,100,0,0.0001,0.01,0.578,635,669
19,1404,100,0,0.0001,0.01,0.558,690,714
19,1504,100,0,0.0001,0.01,0.568,750,754
19,1604,100,0,0.0001,0.01,0.586,793,811
19,1704,100,0,0.0001,0.01,0.624,847,857
19,1804,100,0,0.0001,0.01,0.626,901,903
19,1904,100,0,0.0001,0.01,0.62,952,952
20,0,100,0,0.0001,0.01,0.502,0,0
20,104,100,0,0.0001,0.01,0.472,53,51
20,204,100,0,0.0001,0.01,0.502,100,104
20,304,100,0,0.0001,0.01,0.504,154,150
20,404,100,0,0.0001,0.01,0.486,199,205
20,504,100,0,0.0001,0.01,0.514,245,259
20,604,100,0,0.0001,0.01,0.5,289,315
20,704,100,0,0.0001,0.01,0.522,342,362
20,804,100,0,0.0001,0.01,0.514,389,415
20,904,100,0,0.0001,0.01,0.518,443,461
20,1004,100,0,0.0001,0.01,0.504,493,511
20,1104,100,0,0.0001,0.01,0.512,542,562
20,1204,100,0,0.0001,0.01,0.516,586,618
20,1304,100,0,0.0001,0.01,0.502,637,667
20,1404,100,0,0.0001,0.01,0.496,684,720
20,1504,100,0,0.0001,0.01,0.482,750,754
20,1604,100,0,0.0001,0.01,0.504,808,796
20,1704,100,0,0.0001,0.01,0.52,853,851
20,1804,100,0,0.0001,0.01,0.528,899,905
20,1904,100,0,0.0001,0.01,0.532,952,952
1,0,100,0,0.001,0.0001,0.5,0,0
1,104,100,0,0.001,0.0001,0.5,53,51
1,204,100,0,0.001,0.0001,0.5,102,102
1,304,100,0,0.001,0.0001,0.5,147,157
1,404,100,0,0.001,0.0001,0.5,191,213
1,504,100,0,0.001,0.0001,0.5,238,266
1,604,100,0,0.001,0.0001,0.5,289,315
1,704,100,0,0.001,0.0001,0.5,334,370
1,804,100,0,0.001,0.0001,0.5,377,427
1,904,100,0,0.001,0.0001,0.5,430,474
1,1004,100,0,0.001,0.0001,0.5,474,530
1,1104,100,0,0.001,0.0001,0.5,533,571
1,1204,100,0,0.001,0.0001,0.5,584,620
1,1304,100,0,0.001,0.0001,0.5,636,668
1,1404,100,0,0.001,0.0001,0.502,694,710
1,1504,100,0,0.001,0.0001,0.512,747,757
1,1604,100,0,0.001,0.0001,0.518,798,806
1,1704,100,0,0.001,0.0001,0.53,852,852
1,1804,100,0,0.001,0.0001,0.536,899,905
1,1904,100,0,0.001,0.0001,0.546,952,952
2,0,100,0,0.001,0.0001,0.514,0,0
2,104,100,0,0.001,0.0001,0.514,57,47
2,204,100,0,0.001,0.0001,0.522,110,94
2,304,100,0,0.001,0.0001,0.518,158,146
2,404,100,0,0.001,0.0001,0.522,211,193
2,504,100,0,0.001,0.0001,0.536,254,250
2,604,100,0,0.001,0.0001,0.53,309,295
2,704,100,0,0.001,0.0001,0.528,352,352
2,804,100,0,0.001,0.0001,0.526,409,395
2,904,100,0,0.001,0.0001,0.526,458,446
2,1004,100,0,0.001,0.0001,0.52,508,496
2,1104,100,0,0.001,0.0001,0.524,559,545
2,1204,100,0,0.001,0.0001,0.524,609,595
2,1304,100,0,0.001,0.0001,0.528,661,643
2,1404,100,0,0.001,0.0001,0.532,714,690
2,1504,100,0,0.001,0.0001,0.538,761,743
2,1604,100,0,0.001,0.0001,0.538,804,800
2,1704,100,0,0.001,0.0001,0.536,858,846
2,1804,100,0,0.001,0.0001,0.54,905,899
2,1904,100,0,0.001,0.0001,0.556,952,952
3,0,100,0,0.001,0.0001,0.504,0,0
3,104,100,0,0.001,0.0001,0.504,51,53
3,204,100,0,0.001,0.0001,0.504,102,102
3,304,100,0,0.001,0.0001,0.506,151,153
3,404,100,0,0.001,0.0001,0.506,201,203
3,504,100,0,0.001,0.0001,0.508,246,258
3,604,100,0,0.001,0.0001,0.51,300,304
3,704,100,0,0.001,0.0001,0.502,355,349
3,804,100,0,0.001,0.0001,0.506,402,402
3,904,100,0,0.001,0.0001,0.52,452,452
3,1004,100,0,0.001,0.0001,0.528,506,498
3,1104,100,0,0.001,0.0001,0.532,548,556
3,1204,100,0,0.001,0.0001,0.524,598,606
3,1304,100,0,0.001,0.0001,0.526,653,651
3,1404,100,0,0.001,0.0001,0.51,706,698
3,1504,100,0,0.001,0.0001,0.51,752,752
3,1604,100,0,0.001,0.0001,0.51,797,807
3,1704,100,0,0.001,0.0001,0.508,847,857
3,1804,100,0,0.001,0.0001,0.504,905,899
3,1904,100,0,0.001,0.0001,0.496,952,952
4,0,100,0,0.001,0.0001,0.496,0,0
4,104,100,0,0.001,0.0001,0.496,55,49
4,204,100,0,0.001,0.0001,0.496,108,96
4,304,100,0,0.001,0.0001,0.496,155,149
4,404,100,0,0.001,0.0001,0.504,211,193
4,504,100,0,0.001,0.0001,0.504,258,246
4,604,100,0,0.001,0.0001,0.506,306,298
4,704,100,0,0.001,0.0001,0.49,353,351
4,804,100,0,0.001,0.0001,0.5,403,401
4,904,100,0,0.001,0.0001,0.5,447,457
4,1004,100,0,0.001,0.0001,0.502,485,519
4,1104,100,0,0.001,0.0001,0.502,539,565
4,1204,100,0,0.001,0.0001,0.5,588,616
4,1304,100,0,0.001,0.0001,0.496,637,667
4,1404,100,0,0.001,0.0001,0.502,680,724
4,1504,100,0,0.001,0.0001,0.508,736,768
4,1604,100,0,0.001,0.0001,0.508,787,817
4,1704,100,0,0.001,0.0001,0.504,844,860
4,1804,100,0,0.001,0.0001,0.492,897,907
4,1904,100,0,0.001,0.0001,0.49,952,952
5,0,100,0,0.001,0.0001,0.52,0,0
5,104,100,0,0.001,0.0001,0.522,60,44
5,204,100,0,0.001,0.0001,0.524,108,96
5,304,100,0,0.001,0.0001,0.524,158,146
5,404,100,0,0.001,0.0001,0.518,205,199
5,504,100,0,0.001,0.0001,0.53,247,257
5,604,100,0,0.001,0.0001,0.528,297,307
5,704,100,0,0.001,0.0001,0.528,342,362
5,804,100,0,0.001,0.0001,0.53,379,425
5,904,100,0,0.001,0.0001,0.522,435,469
5,1004,100,0,0.001,0.0001,0.516,480,524
5,1104,100,0,0.001,0.0001,0.512,528,576
5,1204,100,0,0.001,0.0001,0.514,588,616
5,1304,100,0,0.001,0.0001,0.512,632,672
5,1404,100,0,0.001,0.0001,0.508,682,722
5,1504,100,0,0.001,0.0001,0.52,737,767
5,1604,100,0,0.001,0.0001,0.518,790,814
5,1704,100,0,0.001,0.0001,0.51,845,859
5,1804,100,0,0.001,0.0001,0.512,901,903
5,1904,100,0,0.001,0.0001,0.522,952,952
6,0,100,0,0.001,0.0001,0.492,0,0
6,104,100,0,0.001,0.0001,0.49,54,50
6,204,100,0,0.001,0.0001,0.49,109,95
6,304,100,0,0.001,0.0001,0.496,159,145
6,404,100,0,0.001,0.0001,0.49,201,203
6,504,100,0,0.001,0.0001,0.49,247,257
6,604,100,0,0.001,0.0001,0.49,308,296
6,704,100,0,0.001,0.0001,0.49,356,348
6,804,100,0,0.001,0.0001,0.49,399,405
6,904,100,0,0.001,0.0001,0.494,445,459
6,1004,100,0,0.001,0.0001,0.494,497,507
6,1104,100,0,0.001,0.0001,0.5,544,560
6,1204,100,0,0.001,0.0001,0.5,601,603
6,1304,100,0,0.001,0.0001,0.498,652,652
6,1404,100,0,0.001,0.0001,0.496,700,704
6,1504,100,0,0.001,0.0001,0.5,753,751
6,1604,100,0,0.001,0.0001,0.504,803,801
6,1704,100,0,0.001,0.0001,0.502,854,850
6,1804,100,0,0.001,0.0001,0.512,903,901
6,1904,100,0,0.001,0.0001,0.512,952,952
7,0,100,0,0.001,0.0001,0.512,0,0
7,104,100,0,0.001,0.0001,0.51,49,55
7,204,100,0,0.001,0.0001,0.51,96,108
7,304,100,0,0.001,0.0001,0.512,137,167
7,404,100,0,0.001,0.0001,0.514,192,212
7,504,100,0,0.001,0.0001,0.514,243,261
7,604,100,0,0.001,0.0001,0.51,295,309
7,704,100,0,0.001,0.0001,0.51,349,355
7,804,100,0,0.001,0.0001,0.51,402,402
7,904,100,0,0.001,0.0001,0.508,452,452
7,1004,100,0,0.001,0.0001,0.506,500,504
7,1104,100,0,0.001,0.0001,0.512,560,544
7,1204,100,0,0.001,0.0001,0.506,607,597
7,1304,100,0,0.001,0.0001,0.5,661,643
7,1404,100,0,0.001,0.0001,0.506,707,697
7,1504,100,0,0.001,0.0001,0.514,765,739
7,1604,100,0,0.001,0.0001,0.51,818,786
7,1704,100,0,0.001,0.0001,0.52,867,837
7,1804,100,0,0.001,0.0001,0.524,908,896
7,1904,100,0,0.001,0.0001,0.516,952,952
8,0,100,0,0.001,0.0001,0.502,0,0
8,104,100,0,0.001,0.0001,0.502,61,43
8,204,100,0,0.001,0.0001,0.502,97,107
8,304,100,0,0.001,0.0001,0.502,140,164
8,404,100,0,0.001,0.0001,0.502,185,219
8,504,100,0,0.001,0.0001,0.5,236,268
8,604,100,0,0.001,0.0001,0.502,290,314
8,704,100,0,0.001,0.0001,0.502,342,362
8,804,100,0,0.001,0.0001,0.508,400,404
8,904,100,0,0.001,0.0001,0.506,447,457
8,1004,100,0,0.001,0.0001,0.496,500,504
8,1104,100,0,0.001,0.0001,0.492,548,556
8,1204,100,0,0.001,0.0001,0.506,597,607
8,1304,100,0,0.001,0.0001,0.502,648,656
8,1404,100,0,0.001,0.0001,0.508,697,707
8,1504,100,0,0.001,0.0001,0.498,748,756
8,1604,100,0,0.001,0.0001,0.5,805,799
8,1704,100,0,0.001,0.0001,0.506,848,856
8,1804,100,0,0.001,0.0001,0.508,906,898
8,1904,100,0,0.001,0.0001,0.496,952,952
9,0,100,0,0.001,0.0001,0.498,0,0
9,104,100,0,0.001,0.0001,0.5,56,48
9,204,100,0,0.001,0.0001,0.5,101,103
9,304,100,0,0.001,0.0001,0.494,152,152
9,404,100,0,0.001,0.0001,0.492,198,206
9,504,100,0,0.001,0.0001,0.494,246,258
9,604,100,0,0.001,0.0001,0.488,295,309
9,704,100,0,0.001,0.0001,0.502,345,359
9,804,100,0,0.001,0.0001,0.496,394,410
9,904,100,0,0.001,0.0001,0.496,445,459
9,1004,100,0,0.001,0.0001,0.496,491,513
9,1104,100,0,0.001,0.0001,0.5,534,570
9,1204,100,0,0.001,0.0001,0.506,582,622
9,1304,100,0,0.001,0.0001,0.492,634,670
9,1404,100,0,0.001,0.0001,0.49,695,709
9,1504,100,0,0.001,0.0001,0.496,746,758
9,1604,100,0,0.001,0.0001,0.49,799,805
9,1704,100,0,0.001,0.0001,0.494,853,851
9,1804,100,0,0.001,0.0001,0.5,909,895
9,1904,100,0,0.001,0.0001,0.504,952,952
10,0,100,0,0.001,0.0001,0.542,0,0
10,104,100,0,0.001,0.0001,0.542,53,51
10,204,100,0,0.001,0.0001,0.542,113,91
10,304,100,0,0.001,0.0001,0.534,168,136
10,404,100,0,0.001,0.0001,0.54,218,186
10,504,100,0,0.001,0.0001,0.55,262,242
10,604,100,0,0.001,0.0001,0.552,310,294
10,704,100,0,0.001,0.0001,0.548,362,342
10,804,100,0,0.001,0.0001,0.526,418,386
10,904,100,0,0.001,0.0001,0.522,464,440
10,1004,100,0,0.001,0.0001,0.526,512,492
10,1104,100,0,0.001,0.0001,0.528,570,534
10,1204,100,0,0.001,0.0001,0.528,626,578
10,1304,100,0,0.001,0.0001,0.528,664,640
10,1404,100,0,0.001,0.0001,0.548,703,701
10,1504,100,0,0.001,0.0001,0.548,757,747
10,1604,100,0,0.001,0.0001,0.55,813,791
10,1704,100,0,0.001,0.0001,0.552,860,844
10,1804,100,0,0.001,0.0001,0.56,909,895
10,1904,100,0,0.001,0.0001,0.578,952,952
11,0,100,0,0.001,0.0001,0.474,0,0
11,104,100,0,0.001,0.0001,0.476,52,52
11,204,100,0,0.001,0.0001,0.468,96,108
11,304,100,0,0.001,0.0001,0.47,145,159
11,404,100,0,0.001,0.0001,0.472,198,206
11,504,100,0,0.001,0.0001,0.48,252,252
11,604,100,0,0.001,0.0001,0.476,313,291
11,704,100,0,0.001,0.0001,0.486,367,337
11,804,100,0,0.001,0.0001,0.476,417,387
11,904,100,0,0.001,0.0001,0.48,468,436
11,1004,100,0,0.001,0.0001,0.492,520,484
11,1104,100,0,0.001,0.0001,0.508,569,535
11,1204,100,0,0.001,0.0001,0.512,618,586
11,1304,100,0,0.001,0.0001,0.508,665,639
11,1404,100,0,0.001,0.0001,0.516,723,681
11,1504,100,0,0.001,0.0001,0.522,765,739
11,1604,100,0,0.001,0.0001,0.518,815,789
11,1704,100,0,0.001,0.0001,0.52,854,850
11,1804,100,0,0.001,0.0001,0.514,908,896
11,1904,100,0,0.001,0.0001,0.516,952,952
12,0,100,0,0.001,0.0001,0.506,0,0
12,104,100,0,0.001,0.0001,0.504,44,60
12,204,100,0,0.001,0.0001,0.504,100,104
12,304,100,0,0.001,0.0001,0.506,152,152
12,404,100,0,0.001,0.0001,0.506,203,201
12,504,100,0,0.001,0.0001,0.522,262,242
12,604,100,0,0.001,0.0001,0.528,315,289
12,704,100,0,0.001,0.0001,0.526,364,340
12,804,100,0,0.001,0.0001,0.534,412,392
12,904,100,0,0.001,0.0001,0.54,469,435
12,1004,100,0,0.001,0.0001,0.528,517,487
12,1104,100,0,0.001,0.0001,0.518,561,543
12,1204,100,0,0.001,0.0001,0.51,613,591
12,1304,100,0,0.001,0.0001,0.512,652,652
12,1404,100,0,0.001,0.0001,0.506,704,700
12,1504,100,0,0.001,0.0001,0.516,753,751
12,1604,100,0,0.001,0.0001,0.512,800,804
12,1704,100,0,0.001,0.0001,0.504,854,850
12,1804,100,0,0.001,0.0001,0.508,901,903
12,1904,100,0,0.001,0.0001,0.482,952,952
13,0,100,0,0.001,0.0001,0.516,0,0
13,104,100,0,0.001,0.0001,0.516,50,54
13,204,100,0,0.001,0.0001,0.516,105,99
13,304,100,0,0.001,0.0001,0.51,149,155
13,404,100,0,0.001,0.0001,0.51,198,206
13,504,100,0,0.001,0.0001,0.514,253,251
13,604,100,0,0.001,0.0001,0.516,304,300
13,704,100,0,0.001,0.0001,0.512,355,349
13,804,100,0,0.001,0.0001,0.502,404,400
13,904,100,0,0.001,0.0001,0.502,456,448
13,1004,100,0,0.001,0.0001,0.506,506,498
13,1104,100,0,0.001,0.0001,0.5,549,555
13,1204,100,0,0.001,0.0001,0.508,593,611
13,1304,100,0,0.001,0.0001,0.504,646,658
13,1404,100,0,0.001,0.0001,0.522,693,711
13,1504,100,0,0.001,0.0001,0.518,743,761
13,1604,100,0,0.001,0.0001,0.524,794,810
13,1704,100,0,0.001,0.0001,0.53,845,859
13,1804,100,0,0.001,0.0001,0.522,901,903
13,1904,100,0,0.001,0.0001,0.53,952,952
14,0,100,0,0.001,0.0001,0.544,0,0
14,104,100,0,0.001,0.0001,0.548,52,52
14,204,100,0,0.001,0.0001,0.552,105,99
14,304,100,0,0.001,0.0001,0.55,148,156
14,404,100,0,0.001,0.0001,0.552,196,208
14,504,100,0,0.001,0.0001,0.57,242,262
14,604,100,0,0.001,0.0001,0.572,287,317
14,704,100,0,0.001,0.0001,0.562,333,371
14,804,100,0,0.001,0.0001,0.544,384,420
14,904,100,0,0.001,0.0001,0.534,444,460
14,1004,100,0,0.001,0.0001,0.532,506,498
14,1104,100,0,0.001,0.0001,0.526,564,540
14,1204,100,0,0.001,0.0001,0.52,608,596
14,1304,100,0,0.001,0.0001,0.546,655,649
14,1404,100,0,0.001,0.0001,0.538,702,702
14,1504,100,0,0.001,0.0001,0.552,755,749
14,1604,100,0,0.001,0.0001,0.556,798,806
14,1704,100,0,0.001,0.0001,0.57,850,854
14,1804,100,0,0.001,0.0001,0.558,891,913
14,1904,100,0,0.001,0.0001,0.552,952,952
15,0,100,0,0.001,0.0001,0.498,0,0
15,104,100,0,0.001,0.0001,0.498,56,48
15,204,100,0,0.001,0.0001,0.498,106,98
15,304,100,0,0.001,0.0001,0.494,155,149
15,404,100,0,0.001,0.0001,0.492,202,202
15,504,100,0,0.001,0.0001,0.49,245,259
15,604,100,0,0.001,0.0001,0.492,292,312
15,704,100,0,0.001,0.0001,0.496,347,357
15,804,100,0,0.001,0.0001,0.494,396,408
15,904,100,0,0.001,0.0001,0.51,445,459
15,1004,100,0,0.001,0.0001,0.498,496,508
15,1104,100,0,0.001,0.0001,0.47,553,551
15,1204,100,0,0.001,0.0001,0.472,604,600
15,1304,100,0,0.001,0.0001,0.484,644,660
15,1404,100,0,0.001,0.0001,0.496,697,707
15,1504,100,0,0.001,0.0001,0.492,748,756
15,1604,100,0,0.001,0.0001,0.494,801,803
15,1704,100,0,0.001,0.0001,0.492,846,858
15,1804,100,0,0.001,0.0001,0.488,906,898
15,1904,100,0,0.001,0.0001,0.488,952,952
16,0,100,0,0.001,0.0001,0.494,0,0
16,104,100,0,0.001,0.0001,0.494,52,52
16,204,100,0,0.001,0.0001,0.498,110,94
16,304,100,0,0.001,0.0001,0.504,154,150
16,404,100,0,0.001,0.0001,0.51,205,199
16,504,100,0,0.001,0.0001,0.508,249,255
16,604,100,0,0.001,0.0001,0.514,306,298
16,704,100,0,0.001,0.0001,0.518,360,344
16,804,100,0,0.001,0.0001,0.518,398,406
16,904,100,0,0.001,0.0001,0.532,437,467
16,1004,100,0,0.001,0.0001,0.528,483,521
16,1104,100,0,0.001,0.0001,0.526,532,572
16,1204,100,0,0.001,0.0001,0.522,578,626
16,1304,100,0,0.001,0.0001,0.51,630,674
16,1404,100,0,0.001,0.0001,0.512,681,723
16,1504,100,0,0.001,0.0001,0.52,741,763
16,1604,100,0,0.001,0.0001,0.522,792,812
16,1704,100,0,0.001,0.0001,0.53,853,851
16,1804,100,0,0.001,0.0001,0.542,903,901
16,1904,100,0,0.001,0.0001,0.544,952,952
17,0,100,0,0.001,0.0001,0.502,0,0
17,104,100,0,0.001,0.0001,0.502,49,55
17,204,100,0,0.001,0.0001,0.502,92,112
17,304,100,0,0.001,0.0001,0.502,145,159
17,404,100,0,0.001,0.0001,0.5,187,217
17,504,100,0,0.001,0.0001,0.5,247,257
17,604,100,0,0.001,0.0001,0.502,299,305
17,704,100,0,0.001,0.0001,0.504,340,364
17,804,100,0,0.001,0.0001,0.504,390,414
17,904,100,0,0.001,0.0001,0.506,440,464
17,1004,100,0,0.001,0.0001,0.512,493,511
17,1104,100,0,0.001,0.0001,0.514,553,551
17,1204,100,0,0.001,0.0001,0.5,605,599
17,1304,100,0,0.001,0.0001,0.504,658,646
17,1404,100,0,0.001,0.0001,0.516,707,697
17,1504,100,0,0.001,0.0001,0.514,762,742
17,1604,100,0,0.001,0.0001,0.522,805,799
17,1704,100,0,0.001,0.0001,0.522,850,854
17,1804,100,0,0.001,0.0001,0.52,897,907
17,1904,100,0,0.001,0.0001,0.536,952,952
18,0,100,0,0.001,0.0001,0.516,0,0
18,104,100,0,0.001,0.0001,0.514,48,56
18,204,100,0,0.001,0.0001,0.512,100,104
18,304,100,0,0.001,0.0001,0.508,154,150
18,404,100,0,0.001,0.0001,0.506,206,198
18,504,100,0,0.001,0.0001,0.508,248,256
18,604,100,0,0.001,0.0001,0.512,298,306
18,704,100,0,0.001,0.0001,0.524,357,347
18,804,100,0,0.001,0.0001,0.532,407,397
18,904,100,0,0.001,0.0001,0.528,464,440
18,1004,100,0,0.001,0.0001,0.54,519,485
18,1104,100,0,0.001,0.0001,0.536,570,534
18,1204,100,0,0.001,0.0001,0.552,612,592
18,1304,100,0,0.001,0.0001,0.546,663,641
18,1404,100,0,0.001,0.0001,0.538,715,689
18,1504,100,0,0.001,0.0001,0.54,759,745
18,1604,100,0,0.001,0.0001,0.53,804,800
18,1704,100,0,0.001,0.0001,0.552,851,853
18,1804,100,0,0.001,0.0001,0.56,898,906
18,1904,100,0,0.001,0.0001,0.56,952,952
19,0,100,0,0.001,0.0001,0.504,0,0
19,104,100,0,0.001,0.0001,0.504,48,56
19,204,100,0,0.001,0.0001,0.504,94,110
19,304,100,0,0.001,0.0001,0.502,146,158
19,404,100,0,0.001,0.0001,0.502,192,212
19,504,100,0,0.001,0.0001,0.502,236,268
19,604,100,0,0.001,0.0001,0.5,278,326
19,704,100,0,0.001,0.0001,0.498,332,372
19,804,100,0,0.001,0.0001,0.5,383,421
19,904,100,0,0.001,0.0001,0.5,425,479
19,1004,100,0,0.001,0.0001,0.496,476,528
19,1104,100,0,0.001,0.0001,0.496,530,574
19,1204,100,0,0.001,0.0001,0.496,583,621
19,1304,100,0,0.001,0.0001,0.496,639,665
19,1404,100,0,0.001,0.0001,0.496,686,718
19,1504,100,0,0.001,0.0001,0.508,738,766
19,1604,100,0,0.001,0.0001,0.51,791,813
19,1704,100,0,0.001,0.0001,0.506,842,862
19,1804,100,0,0.001,0.0001,0.514,903,901
19,1904,100,0,0.001,0.0001,0.526,952,952
20,0,100,0,0.001,0.0001,0.508,0,0
20,104,100,0,0.001,0.0001,0.508,50,54
20,204,100,0,0.001,0.0001,0.508,97,107
20,304,100,0,0.001,0.0001,0.504,132,172
20,404,100,0,0.001,0.0001,0.504,189,215
20,504,100,0,0.001,0.0001,0.504,236,268
20,604,100,0,0.001,0.0001,0.498,290,314
20,704,100,0,0.001,0.0001,0.498,341,363
20,804,100,0,0.001,0.0001,0.502,392,412
20,904,100,0,0.001,0.0001,0.506,441,463
20,1004,100,0,0.001,0.0001,0.502,492,512
20,1104,100,0,0.001,0.0001,0.502,543,561
20,1204,100,0,0.001,0.0001,0.51,583,621
20,1304,100,0,0.001,0.0001,0.508,642,662
20,1404,100,0,0.001,0.0001,0.504,694,710
20,1504,100,0,0.001,0.0001,0.512,748,756
20,1604,100,0,0.001,0.0001,0.5,798,806
20,1704,100,0,0.001,0.0001,0.488,846,858
20,1804,100,0,0.001,0.0001,0.484,899,905
20,1904,100,0,0.001,0.0001,0.486,952,952
1,0,100,0,0.001,0.001,0.55,0,0
1,104,100,0,0.001,0.001,0.724,49,55
1,204,100,0,0.001,0.001,0.53,104,100
1,304,100,0,0.001,0.001,0.65,151,153
1,404,100,0,0.001,0.001,0.782,198,206
1,504,100,0,0.001,0.001,0.74,254,250
1,604,100,0,0.001,0.001,0.794,309,295
1,704,100,0,0.001,0.001,0.83,357,347
1,804,100,0,0.001,0.001,0.896,399,405
1,904,100,0,0.001,0.001,0.934,453,451
1,1004,100,0,0.001,0.001,0.96,510,494
1,1104,100,0,0.001,0.001,0.956,563,541
1,1204,100,0,0.001,0.001,0.982,615,589
1,1304,100,0,0.001,0.001,0.982,669,635
1,1404,100,0,0.001,0.001,0.986,722,682
1,1504,100,0,0.001,0.001,0.986,768,736
1,1604,100,0,0.001,0.001,0.988,814,790
1,1704,100,0,0.001,0.001,0.988,859,845
1,1804,100,0,0.001,0.001,0.998,897,907
1,1904,100,0,0.001,0.001,1.0,952,952
2,0,100,0,0.001,0.001,0.526,0,0
2,104,100,0,0.001,0.001,0.636,47,57
2,204,100,0,0.001,0.001,0.564,95,109
2,304,100,0,0.001,0.001,0.658,147,157
2,404,100,0,0.001,0.001,0.72,198,206
2,504,100,0,0.001,0.001,0.714,253,251
2,604,100,0,0.001,0.001,0.728,301,303
2,704,100,0,0.001,0.001,0.788,363,341
2,804,100,0,0.001,0.001,0.834,414,390
2,904,100,0,0.001,0.001,0.886,466,438
2,1004,100,0,0.001,0.001,0.908,516,488
2,1104,100,0,0.001,0.001,0.946,564,540
2,1204,100,0,0.001,0.001,0.962,614,590
2,1304,100,0,0.001,0.001,0.976,665,639
2,1404,100,0,0.001,0.001,0.986,710,694
2,1504,100,0,0.001,0.001,0.988,746,758
2,1604,100,0,0.001,0.001,0.99,800,804
2,1704,100,0,0.001,0.001,0.996,852,852
2,1804,100,0,0.001,0.001,0.996,905,899
2,1904,100,0,0.001,0.001,0.998,952,952
3,0,100,0,0.001,0.001,0.564,0,0
3,104,100,0,0.001,0.001,0.708,55,49
3,204,100,0,0.001,0.001,0.522,109,95
3,304,100,0,0.001,0.001,0.706,159,145
3,404,100,0,0.001,0.001,0.742,202,202
3,504,100,0,0.001,0.001,0.81,259,245
3,604,100,0,0.001,0.001,0.838,299,305
3,704,100,0,0.001,0.001,0.88,351,353
3,804,100,0,0.001,0.001,0.912,397,407
3,904,100,0,0.001,0.001,0.942,455,449
3,1004,100,0,0.001,0.001,0.97,497,507
3,1104,100,0,0.001,0.001,0.98,545,559
3,1204,100,0,0.001,0.001,0.986,594,610
3,1304,100,0,0.001,0.001,0.992,648,656
3,1404,100,0,0.001,0.001,0.996,702,702
3,1504,100,0,0.001,0.001,1.0,756,748
3,1604,100,0,0.001,0.001,1.0,808,796
3,1704,100,0,0.001,0.001,1.0,859,845
3,1804,100,0,0.001,0.001,1.0,908,896
3,1904,100,0,0.001,0.001,1.0,952,952
4,0,100,0,0.001,0.001,0.504,0,0
4,104,100,0,0.001,0.001,0.628,58,46
4,204,100,0,0.001,0.001,0.522,110,94
4,304,100,0,0.001,0.001,0.722,157,147
4,404,100,0,0.001,0.001,0.718,213,191
4,504,100,0,0.001,0.001,0.672,268,236
4,604,100,0,0.001,0.001,0.822,321,283
4,704,100,0,0.001,0.001,0.854,366,338
4,804,100,0,0.001,0.001,0.886,413,391
4,904,100,0,0.001,0.001,0.904,457,447
4,1004,100,0,0.001,0.001,0.93,508,496
4,1104,100,0,0.001,0.001,0.956,555,549
4,1204,100,0,0.001,0.001,0.972,611,593
4,1304,100,0,0.001,0.001,0.984,666,638
4,1404,100,0,0.001,0.001,0.99,719,685
4,1504,100,0,0.001,0.001,0.996,761,743
4,1604,100,0,0.001,0.001,0.998,812,792
4,1704,100,0,0.001,0.001,0.998,865,839
4,1804,100,0,0.001,0.001,0.998,906,898
4,1904,100,0,0.001,0.001,0.998,952,952
5,0,100,0,0.001,0.001,0.516,0,0
5,104,100,0,0.001,0.001,0.598,46,58
5,204,100,0,0.001,0.001,0.532,97,107
5,304,100,0,0.001,0.001,0.636,147,157
5,404,100,0,0.001,0.001,0.708,202,202
5,504,100,0,0.001,0.001,0.744,250,254
5,604,100,0,0.001,0.001,0.73,296,308
5,704,100,0,0.001,0.001,0.78,356,348
5,804,100,0,0.001,0.001,0.852,407,397
5,904,100,0,0.001,0.001,0.858,453,451
5,1004,100,0,0.001,0.001,0.932,508,496
5,1104,100,0,0.001,0.001,0.934,562,542
5,1204,100,0,0.001,0.001,0.98,613,591
5,1304,100,0,0.001,0.001,0.978,652,652
5,1404,100,0,0.001,0.001,0.984,699,705
5,1504,100,0,0.001,0.001,0.994,753,751
5,1604,100,0,0.001,0.001,0.994,798,806
5,1704,100,0,0.001,0.001,0.994,845,859
5,1804,100,0,0.001,0.001,1.0,902,902
5,1904,100,0,0.001,0.001,1.0,952,952
6,0,100,0,0.001,0.001,0.52,0,0
6,104,100,0,0.001,0.001,0.616,48,56
6,204,100,0,0.001,0.001,0.56,97,107
6,304,100,0,0.001,0.001,0.614,146,158
6,404,100,0,0.001,0.001,0.706,192,212
6,504,100,0,0.001,0.001,0.728,243,261
6,604,100,0,0.001,0.001,0.726,299,305
6,704,100,0,0.001,0.001,0.776,348,356
6,804,100,0,0.001,0.001,0.822,406,398
6,904,100,0,0.001,0.001,0.868,456,448
6,1004,100,0,0.001,0.001,0.898,501,503
6,1104,100,0,0.001,0.001,0.916,560,544
6,1204,100,0,0.001,0.001,0.926,607,597
6,1304,100,0,0.001,0.001,0.958,656,648
6,1404,100,0,0.001,0.001,0.966,706,698
6,1504,100,0,0.001,0.001,0.976,752,752
6,1604,100,0,0.001,0.001,0.986,810,794
6,1704,100,0,0.001,0.001,0.992,856,848
6,1804,100,0,0.001,0.001,0.99,900,904
6,1904,100,0,0.001,0.001,0.994,952,952
7,0,100,0,0.001,0.001,0.508,0,0
7,104,100,0,0.001,0.001,0.622,53,51
7,204,100,0,0.001,0.001,0.524,108,96
7,304,100,0,0.001,0.001,0.632,152,152
7,404,100,0,0.001,0.001,0.706,208,196
7,504,100,0,0.001,0.001,0.718,250,254
7,604,100,0,0.001,0.001,0.722,291,313
7,704,100,0,0.001,0.001,0.778,348,356
7,804,100,0,0.001,0.001,0.832,400,404
7,904,100,0,0.001,0.001,0.866,444,460
7,1004,100,0,0.001,0.001,0.918,496,508
7,1104,100,0,0.001,0.001,0.936,544,560
7,1204,100,0,0.001,0.001,0.962,598,606
7,1304,100,0,0.001,0.001,0.968,649,655
7,1404,100,0,0.001,0.001,0.972,700,704
7,1504,100,0,0.001,0.001,0.984,744,760
7,1604,100,0,0.001,0.001,0.99,788,816
7,1704,100,0,0.001,0.001,0.996,849,855
7,1804,100,0,0.001,0.001,0.996,907,897
7,1904,100,0,0.001,0.001,0.994,952,952
8,0,100,0,0.001,0.001,0.522,0,0
8,104,100,0,0.001,0.001,0.676,56,48
8,204,100,0,0.001,0.001,0.54,97,107
8,304,100,0,0.001,0.001,0.65,144,160
8,404,100,0,0.001,0.001,0.74,188,216
8,504,100,0,0.001,0.001,0.768,238,266
8,604,100,0,0.001,0.001,0.81,290,314
8,704,100,0,0.001,0.001,0.84,340,364
8,804,100,0,0.001,0.001,0.888,392,412
8,904,100,0,0.001,0.001,0.912,444,460
8,1004,100,0,0.001,0.001,0.94,501,503
8,1104,100,0,0.001,0.001,0.962,552,552
8,1204,100,0,0.001,0.001,0.972,600,604
8,1304,100,0,0.001,0.001,0.986,653,651
8,1404,100,0,0.001,0.001,0.988,703,701
8,1504,100,0,0.001,0.001,0.992,749,755
8,1604,100,0,0.001,0.001,0.996,798,806
8,1704,100,0,0.001,0.001,0.996,854,850
8,1804,100,0,0.001,0.001,0.998,906,898
8,1904,100,0,0.001,0.001,0.998,952,952
9,0,100,0,0.001,0.001,0.53,0,0
9,104,100,0,0.001,0.001,0.682,51,53
9,204,100,0,0.001,0.001,0.522,107,97
9,304,100,0,0.001,0.001,0.748,161,143
9,404,100,0,0.001,0.001,0.732,217,187
9,504,100,0,0.001,0.001,0.722,266,238
9,604,100,0,0.001,0.001,0.8,316,288
9,704,100,0,0.001,0.001,0.804,361,343
9,804,100,0,0.001,0.001,0.878,409,395
9,904,100,0,0.001,0.001,0.888,466,438
9,1004,100,0,0.001,0.001,0.946,523,481
9,1104,100,0,0.001,0.001,0.948,572,532
9,1204,100,0,0.001,0.001,0.974,629,575
9,1304,100,0,0.001,0.001,0.986,674,630
9,1404,100,0,0.001,0.001,0.994,714,690
9,1504,100,0,0.001,0.001,0.996,757,747
9,1604,100,0,0.001,0.001,0.998,810,794
9,1704,100,0,0.001,0.001,1.0,865,839
9,1804,100,0,0.001,0.001,1.0,910,894
9,1904,100,0,0.001,0.001,1.0,952,952
10,0,100,0,0.001,0.001,0.52,0,0
10,104,100,0,0.001,0.001,0.65,53,51
10,204,100,0,0.001,0.001,0.556,102,102
10,304,100,0,0.001,0.001,0.664,148,156
10,404,100,0,0.001,0.001,0.714,195,209
10,504,100,0,0.001,0.001,0.768,233,271
10,604,100,0,0.001,0.001,0.776,274,330
10,704,100,0,0.001,0.001,0.824,327,377
10,804,100,0,0.001,0.001,0.876,373,431
10,904,100,0,0.001,0.001,0.904,428,476
10,1004,100,0,0.001,0.001,0.924,481,523
10,1104,100,0,0.001,0.001,0.948,535,569
10,1204,100,0,0.001,0.001,0.968,585,619
10,1304,100,0,0.001,0.001,0.978,641,663
10,1404,100,0,0.001,0.001,0.986,695,709
10,1504,100,0,0.001,0.001,0.99,748,756
10,1604,100,0,0.001,0.001,0.994,796,808
10,1704,100,0,0.001,0.001,0.998,841,863
10,1804,100,0,0.001,0.001,0.998,895,909
10,1904,100,0,0.001,0.001,0.998,952,952
11,0,100,0,0.001,0.001,0.522,0,0
11,104,100,0,0.001,0.001,0.626,48,56
11,204,100,0,0.001,0.001,0.616,90,114
11,304,100,0,0.001,0.001,0.696,138,166
11,404,100,0,0.001,0.001,0.774,187,217
11,504,100,0,0.001,0.001,0.81,228,276
11,604,100,0,0.001,0.001,0.834,283,321
11,704,100,0,0.001,0.001,0.888,332,372
11,804,100,0,0.001,0.001,0.922,389,415
11,904,100,0,0.001,0.001,0.936,441,463
11,1004,100,0,0.001,0.001,0.958,493,511
11,1104,100,0,0.001,0.001,0.978,545,559
11,1204,100,0,0.001,0.001,0.988,594,610
11,1304,100,0,0.001,0.001,0.994,647,657
11,1404,100,0,0.001,0.001,0.994,701,703
11,1504,100,0,0.001,0.001,0.996,754,750
11,1604,100,0,0.001,0.001,0.998,812,792
11,1704,100,0,0.001,0.001,0.998,851,853
11,1804,100,0,0.001,0.001,0.998,904,900
11,1904,100,0,0.001,0.001,0.996,952,952
12,0,100,0,0.001,0.001,0.502,0,0
12,104,100,0,0.001,0.001,0.604,57,47
12,204,100,0,0.001,0.001,0.514,106,98
12,304,100,0,0.001,0.001,0.726,158,146
12,404,100,0,0.001,0.001,0.63,204,200
12,504,100,0,0.001,0.001,0.76,249,255
12,604,100,0,0.001,0.001,0.796,298,306
12,704,100,0,0.001,0.001,0.866,345,359
12,804,100,0,0.001,0.001,0.908,402,402
12,904,100,0,0.001,0.001,0.936,452,452
12,1004,100,0,0.001,0.001,0.944,505,499
12,1104,100,0,0.001,0.001,0.972,550,554
12,1204,100,0,0.001,0.001,0.992,602,602
12,1304,100,0,0.001,0.001,0.986,653,651
12,1404,100,0,0.001,0.001,0.992,694,710
12,1504,100,0,0.001,0.001,0.994,739,765
12,1604,100,0,0.001,0.001,0.996,797,807
12,1704,100,0,0.001,0.001,0.996,845,859
12,1804,100,0,0.001,0.001,0.996,897,907
12,1904,100,0,0.001,0.001,0.994,952,952
13,0,100,0,0.001,0.001,0.508,0,0
13,104,100,0,0.001,0.001,0.622,53,51
13,204,100,0,0.001,0.001,0.512,110,94
13,304,100,0,0.001,0.001,0.684,150,154
13,404,100,0,0.001,0.001,0.686,198,206
13,504,100,0,0.001,0.001,0.632,252,252
13,604,100,0,0.001,0.001,0.762,307,297
13,704,100,0,0.001,0.001,0.83,345,359
13,804,100,0,0.001,0.001,0.87,396,408
13,904,100,0,0.001,0.001,0.898,451,453
13,1004,100,0,0.001,0.001,0.932,494,510
13,1104,100,0,0.001,0.001,0.958,550,554
13,1204,100,0,0.001,0.001,0.968,595,609
13,1304,100,0,0.001,0.001,0.982,644,660
13,1404,100,0,0.001,0.001,0.986,695,709
13,1504,100,0,0.001,0.001,0.99,746,758
13,1604,100,0,0.001,0.001,0.994,795,809
13,1704,100,0,0.001,0.001,0.994,853,851
13,1804,100,0,0.001,0.001,0.994,901,903
13,1904,100,0,0.001,0.001,0.996,952,952
14,0,100,0,0.001,0.001,0.508,0,0
14,104,100,0,0.001,0.001,0.582,48,56
14,204,100,0,0.001,0.001,0.538,105,99
14,304,100,0,0.001,0.001,0.722,149,155
14,404,100,0,0.001,0.001,0.7,200,204
14,504,100,0,0.001,0.001,0.65,246,258
14,604,100,0,0.001,0.001,0.736,291,313
14,704,100,0,0.001,0.001,0.842,340,364
14,804,100,0,0.001,0.001,0.904,385,419
14,904,100,0,0.001,0.001,0.93,437,467
14,1004,100,0,0.001,0.001,0.946,493,511
14,1104,100,0,0.001,0.001,0.96,534,570
14,1204,100,0,0.001,0.001,0.982,586,618
14,1304,100,0,0.001,0.001,0.988,635,669
14,1404,100,0,0.001,0.001,0.988,688,716
14,1504,100,0,0.001,0.001,0.994,740,764
14,1604,100,0,0.001,0.001,0.994,799,805
14,1704,100,0,0.001,0.001,0.996,849,855
14,1804,100,0,0.001,0.001,0.998,902,902
14,1904,100,0,0.001,0.001,0.998,952,952
15,0,100,0,0.001,0.001,0.522,0,0
15,104,100,0,0.001,0.001,0.684,57,47
15,204,100,0,0.001,0.001,0.502,119,85
15,304,100,0,0.001,0.001,0.724,165,139
15,404,100,0,0.001,0.001,0.582,211,193
15,504,100,0,0.001,0.001,0.626,265,239
15,604,100,0,0.001,0.001,0.81,314,290
15,704,100,0,0.001,0.001,0.806,365,339
15,804,100,0,0.001,0.001,0.872,410,394
15,904,100,0,0.001,0.001,0.928,465,439
15,1004,100,0,0.001,0.001,0.946,513,491
15,1104,100,0,0.001,0.001,0.972,558,546
15,1204,100,0,0.001,0.001,0.982,614,590
15,1304,100,0,0.001,0.001,0.998,668,636
15,1404,100,0,0.001,0.001,0.998,713,691
15,1504,100,0,0.001,0.001,0.998,762,742
15,1604,100,0,0.001,0.001,1.0,817,787
15,1704,100,0,0.001,0.001,1.0,860,844
15,1804,100,0,0.001,0.001,1.0,905,899
15,1904,100,0,0.001,0.001,1.0,952,952
16,0,100,0,0.001,0.001,0.512,0,0
16,104,100,0,0.001,0.001,0.6,41,63
16,204,100,0,0.001,0.001,0.676,88,116
16,304,100,0,0.001,0.001,0.624,141,163
16,404,100,0,0.001,0.001,0.736,191,213
16,504,100,0,0.001,0.001,0.826,245,259
16,604,100,0,0.001,0.001,0.838,292,312
16,704,100,0,0.001,0.001,0.892,343,361
16,804,100,0,0.001,0.001,0.922,396,408
16,904,100,0,0.001,0.001,0.954,444,460
16,1004,100,0,0.001,0.001,0.952,489,515
16,1104,100,0,0.001,0.001,0.962,539,565
16,1204,100,0,0.001,0.001,0.968,592,612
16,1304,100,0,0.001,0.001,0.984,641,663
16,1404,100,0,0.001,0.001,0.988,688,716
16,1504,100,0,0.001,0.001,0.99,746,758
16,1604,100,0,0.001,0.001,0.99,793,811
16,1704,100,0,0.001,0.001,0.99,851,853
16,1804,100,0,0.001,0.001,0.99,900,904
16,1904,100,0,0.001,0.001,0.988,952,952
17,0,100,0,0.001,0.001,0.51,0,0
17,104,100,0,0.001,0.001,0.618,43,61
17,204,100,0,0.001,0.001,0.562,90,114
17,304,100,0,0.001,0.001,0.61,141,163
17,404,100,0,0.001,0.001,0.726,190,214
17,504,100,0,0.001,0.001,0.712,241,263
17,604,100,0,0.001,0.001,0.718,286,318
17,704,100,0,0.001,0.001,0.77,333,371
17,804,100,0,0.001,0.001,0.834,389,415
17,904,100,0,0.001,0.001,0.874,435,469
17,1004,100,0,0.001,0.001,0.922,490,514
17,1104,100,0,0.001,0.001,0.936,540,564
17,1204,100,0,0.001,0.001,0.962,589,615
17,1304,100,0,0.001,0.001,0.982,641,663
17,1404,100,0,0.001,0.001,0.99,699,705
17,1504,100,0,0.001,0.001,0.996,750,754
17,1604,100,0,0.001,0.001,0.996,814,790
17,1704,100,0,0.001,0.001,0.996,861,843
17,1804,100,0,0.001,0.001,0.998,903,901
17,1904,100,0,0.001,0.001,0.998,952,952
18,0,100,0,0.001,0.001,0.516,0,0
18,104,100,0,0.001,0.001,0.648,55,49
18,204,100,0,0.001,0.001,0.546,99,105
18,304,100,0,0.001,0.001,0.642,140,164
18,404,100,0,0.001,0.001,0.716,199,205
18,504,100,0,0.001,0.001,0.704,248,256
18,604,100,0,0.001,0.001,0.776,296,308
18,704,100,0,0.001,0.001,0.8,351,353
18,804,100,0,0.001,0.001,0.852,399,405
18,904,100,0,0.001,0.001,0.88,458,446
18,1004,100,0,0.001,0.001,0.92,509,495
18,1104,100,0,0.001,0.001,0.954,552,552
18,1204,100,0,0.001,0.001,0.968,606,598
18,1304,100,0,0.001,0.001,0.978,658,646
18,1404,100,0,0.001,0.001,0.98,707,697
18,1504,100,0,0.001,0.001,0.984,754,750
18,1604,100,0,0.001,0.001,0.99,807,797
18,1704,100,0,0.001,0.001,0.992,855,849
18,1804,100,0,0.001,0.001,0.994,900,904
18,1904,100,0,0.001,0.001,0.992,952,952
19,0,100,0,0.001,0.001,0.506,0,0
19,104,100,0,0.001,0.001,0.636,59,45
19,204,100,0,0.001,0.001,0.556,99,105
19,304,100,0,0.001,0.001,0.704,151,153
19,404,100,0,0.001,0.001,0.728,212,192
19,504,100,0,0.001,0.001,0.638,263,241
19,604,100,0,0.001,0.001,0.762,318,286
19,704,100,0,0.001,0.001,0.792,360,344
19,804,100,0,0.001,0.001,0.844,403,401
19,904,100,0,0.001,0.001,0.888,446,458
19,1004,100,0,0.001,0.001,0.914,498,506
19,1104,100,0,0.001,0.001,0.932,551,553
19,1204,100,0,0.001,0.001,0.962,608,596
19,1304,100,0,0.001,0.001,0.982,655,649
19,1404,100,0,0.001,0.001,0.986,703,701
19,1504,100,0,0.001,0.001,0.992,758,746
19,1604,100,0,0.001,0.001,0.996,806,798
19,1704,100,0,0.001,0.001,0.998,859,845
19,1804,100,0,0.001,0.001,1.0,910,894
19,1904,100,0,0.001,0.001,1.0,952,952
20,0,100,0,0.001,0.001,0.506,0,0
20,104,100,0,0.001,0.001,0.638,51,53
20,204,100,0,0.001,0.001,0.536,102,102
20,304,100,0,0.001,0.001,0.734,158,146
20,404,100,0,0.001,0.001,0.77,215,189
20,504,100,0,0.001,0.001,0.778,258,246
20,604,100,0,0.001,0.001,0.848,314,290
20,704,100,0,0.001,0.001,0.87,360,344
20,804,100,0,0.001,0.001,0.888,411,393
20,904,100,0,0.001,0.001,0.93,468,436
20,1004,100,0,0.001,0.001,0.946,522,482
20,1104,100,0,0.001,0.001,0.958,567,537
20,1204,100,0,0.001,0.001,0.97,613,591
20,1304,100,0,0.001,0.001,0.982,658,646
20,1404,100,0,0.001,0.001,0.982,703,701
20,1504,100,0,0.001,0.001,0.99,753,751
20,1604,100,0,0.001,0.001,0.988,807,797
20,1704,100,0,0.001,0.001,0.994,857,847
20,1804,100,0,0.001,0.001,0.992,899,905
20,1904,100,0,0.001,0.001,0.994,952,952
1,0,100,0,0.001,0.01,0.52,0,0
1,104,100,0,0.001,0.01,0.506,48,56
1,204,100,0,0.001,0.01,0.506,100,104
1,304,100,0,0.001,0.01,0.524,148,156
1,404,100,0,0.001,0.01,0.506,199,205
1,504,100,0,0.001,0.01,0.484,253,251
1,604,100,0,0.001,0.01,0.472,301,303
1,704,100,0,0.001,0.01,0.504,353,351
1,804,100,0,0.001,0.01,0.476,409,395
1,904,100,0,0.001,0.01,0.482,461,443
1,1004,100,0,0.001,0.01,0.452,520,484
1,1104,100,0,0.001,0.01,0.484,562,542
1,1204,100,0,0.001,0.01,0.468,605,599
1,1304,100,0,0.001,0.01,0.492,654,650
1,1404,100,0,0.001,0.01,0.498,708,696
1,1504,100,0,0.001,0.01,0.53,767,737
1,1604,100,0,0.001,0.01,0.492,816,788
1,1704,100,0,0.001,0.01,0.512,867,837
1,1804,100,0,0.001,0.01,0.476,921,883
1,1904,100,0,0.001,0.01,0.508,952,952
2,0,100,0,0.001,0.01,0.652,0,0
2,104,100,0,0.001,0.01,0.508,47,57
2,204,100,0,0.001,0.01,0.532,95,109
2,304,100,0,0.001,0.01,0.562,154,150
2,404,100,0,0.001,0.01,0.574,202,202
2,504,100,0,0.001,0.01,0.584,253,251
2,604,100,0,0.001,0.01,0.554,309,295
2,704,100,0,0.001,0.01,0.536,355,349
2,804,100,0,0.001,0.01,0.566,397,407
2,904,100,0,0.001,0.01,0.548,449,455
2,1004,100,0,0.001,0.01,0.534,492,512
2,1104,100,0,0.001,0.01,0.538,539,565
2,1204,100,0,0.001,0.01,0.524,597,607
2,1304,100,0,0.001,0.01,0.554,655,649
2,1404,100,0,0.001,0.01,0.56,704,700
2,1504,100,0,0.001,0.01,0.568,753,751
2,1604,100,0,0.001,0.01,0.55,807,797
2,1704,100,0,0.001,0.01,0.55,856,848
2,1804,100,0,0.001,0.01,0.524,902,902
2,1904,100,0,0.001,0.01,0.536,952,952
3,0,100,0,0.001,0.01,0.552,0,0
3,104,100,0,0.001,0.01,0.516,50,54
3,204,100,0,0.001,0.01,0.516,98,106
3,304,100,0,0.001,0.01,0.596,147,157
3,404,100,0,0.001,0.01,0.536,199,205
3,504,100,0,0.001,0.01,0.564,239,265
3,604,100,0,0.001,0.01,0.572,288,316
3,704,100,0,0.001,0.01,0.548,338,366
3,804,100,0,0.001,0.01,0.522,391,413
3,904,100,0,0.001,0.01,0.52,445,459
3,1004,100,0,0.001,0.01,0.528,498,506
3,1104,100,0,0.001,0.01,0.536,537,567
3,1204,100,0,0.001,0.01,0.532,583,621
3,1304,100,0,0.001,0.01,0.54,634,670
3,1404,100,0,0.001,0.01,0.548,686,718
3,1504,100,0,0.001,0.01,0.534,740,764
3,1604,100,0,0.001,0.01,0.554,792,812
3,1704,100,0,0.001,0.01,0.54,848,856
3,1804,100,0,0.001,0.01,0.524,896,908
3,1904,100,0,0.001,0.01,0.558,952,952
4,0,100,0,0.001,0.01,0.472,0,0
4,104,100,0,0.001,0.01,0.544,52,52
4,204,100,0,0.001,0.01,0.512,100,104
4,304,100,0,0.001,0.01,0.52,153,151
4,404,100,0,0.001,0.01,0.532,206,198
4,504,100,0,0.001,0.01,0.548,252,252
4,604,100,0,0.001,0.01,0.55,308,296
4,704,100,0,0.001,0.01,0.502,367,337
4,804,100,0,0.001,0.01,0.482,407,397
4,904,100,0,0.001,0.01,0.502,459,445
4,1004,100,0,0.001,0.01,0.51,512,492
4,1104,100,0,0.001,0.01,0.482,561,543
4,1204,100,0,0.001,0.01,0.49,619,585
4,1304,100,0,0.001,0.01,0.504,676,628
4,1404,100,0,0.001,0.01,0.498,721,683
4,1504,100,0,0.001,0.01,0.52,770,734
4,1604,100,0,0.001,0.01,0.5,817,787
4,1704,100,0,0.001,0.01,0.504,865,839
4,1804,100,0,0.001,0.01,0.502,904,900
4,1904,100,0,0.001,0.01,0.506,952,952
5,0,100,0,0.001,0.01,0.538,0,0
5,104,100,0,0.001,0.01,0.54,54,50
5,204,100,0,0.001,0.01,0.506,109,95
5,304,100,0,0.001,0.01,0.52,158,146
5,404,100,0,0.001,0.01,0.52,204,200
5,504,100,0,0.001,0.01,0.502,257,247
5,604,100,0,0.001,0.01,0.518,313,291
5,704,100,0,0.001,0.01,0.508,371,333
5,804,100,0,0.001,0.01,0.516,418,386
5,904,100,0,0.001,0.01,0.522,462,442
5,1004,100,0,0.001,0.01,0.522,517,487
5,1104,100,0,0.001,0.01,0.512,568,536
5,1204,100,0,0.001,0.01,0.514,618,586
5,1304,100,0,0.001,0.01,0.524,661,643
5,1404,100,0,0.001,0.01,0.494,712,692
5,1504,100,0,0.001,0.01,0.514,759,745
5,1604,100,0,0.001,0.01,0.516,803,801
5,1704,100,0,0.001,0.01,0.476,853,851
5,1804,100,0,0.001,0.01,0.5,903,901
5,1904,100,0,0.001,0.01,0.538,952,952
6,0,100,0,0.001,0.01,0.548,0,0
6,104,100,0,0.001,0.01,0.566,52,52
6,204,100,0,0.001,0.01,0.522,108,96
6,304,100,0,0.001,0.01,0.504,155,149
6,404,100,0,0.001,0.01,0.528,202,202
6,504,100,0,0.001,0.01,0.498,253,251
6,604,100,0,0.001,0.01,0.502,307,297
6,704,100,0,0.001,0.01,0.508,359,345
6,804,100,0,0.001,0.01,0.496,405,399
6,904,100,0,0.001,0.01,0.506,458,446
6,1004,100,0,0.001,0.01,0.51,507,497
6,1104,100,0,0.001,0.01,0.53,553,551
6,1204,100,0,0.001,0.01,0.524,608,596
6,1304,100,0,0.001,0.01,0.522,658,646
6,1404,100,0,0.001,0.01,0.538,708,696
6,1504,100,0,0.001,0.01,0.494,763,741
6,1604,100,0,0.001,0.01,0.552,801,803
6,1704,100,0,0.001,0.01,0.53,854,850
6,1804,100,0,0.001,0.01,0.52,906,898
6,1904,100,0,0.001,0.01,0.534,952,952
7,0,100,0,0.001,0.01,0.558,0,0
7,104,100,0,0.001,0.01,0.482,51,53
7,204,100,0,0.001,0.01,0.53,93,111
7,304,100,0,0.001,0.01,0.52,142,162
7,404,100,0,0.001,0.01,0.49,192,212
7,504,100,0,0.001,0.01,0.514,253,251
7,604,100,0,0.001,0.01,0.512,300,304
7,704,100,0,0.001,0.01,0.484,344,360
7,804,100,0,0.001,0.01,0.498,389,415
7,904,100,0,0.001,0.01,0.526,443,461
7,1004,100,0,0.001,0.01,0.544,492,512
7,1104,100,0,0.001,0.01,0.542,546,558
7,1204,100,0,0.001,0.01,0.53,595,609
7,1304,100,0,0.001,0.01,0.53,642,662
7,1404,100,0,0.001,0.01,0.522,693,711
7,1504,100,0,0.001,0.01,0.554,748,756
7,1604,100,0,0.001,0.01,0.532,796,808
7,1704,100,0,0.001,0.01,0.528,843,861
7,1804,100,0,0.001,0.01,0.534,900,904
7,1904,100,0,0.001,0.01,0.534,952,952
8,0,100,0,0.001,0.01,0.574,0,0
8,104,100,0,0.001,0.01,0.602,48,56
8,204,100,0,0.001,0.01,0.508,104,100
8,304,100,0,0.001,0.01,0.612,153,151
8,404,100,0,0.001,0.01,0.592,200,204
8,504,100,0,0.001,0.01,0.526,253,251
8,604,100,0,0.001,0.01,0.572,299,305
8,704,100,0,0.001,0.01,0.548,351,353
8,804,100,0,0.001,0.01,0.554,400,404
8,904,100,0,0.001,0.01,0.554,452,452
8,1004,100,0,0.001,0.01,0.536,502,502
8,1104,100,0,0.001,0.01,0.526,549,555
8,1204,100,0,0.001,0.01,0.536,596,608
8,1304,100,0,0.001,0.01,0.538,654,650
8,1404,100,0,0.001,0.01,0.538,698,706
8,1504,100,0,0.001,0.01,0.542,752,752
8,1604,100,0,0.001,0.01,0.544,797,807
8,1704,100,0,0.001,0.01,0.504,836,868
8,1804,100,0,0.001,0.01,0.53,903,901
8,1904,100,0,0.001,0.01,0.536,952,952
9,0,100,0,0.001,0.01,0.546,0,0
9,104,100,0,0.001,0.01,0.56,50,54
9,204,100,0,0.001,0.01,0.546,104,100
9,304,100,0,0.001,0.01,0.57,145,159
9,404,100,0,0.001,0.01,0.558,192,212
9,504,100,0,0.001,0.01,0.516,243,261
9,604,100,0,0.001,0.01,0.52,293,311
9,704,100,0,0.001,0.01,0.528,344,360
9,804,100,0,0.001,0.01,0.526,392,412
9,904,100,0,0.001,0.01,0.536,446,458
9,1004,100,0,0.001,0.01,0.54,495,509
9,1104,100,0,0.001,0.01,0.52,552,552
9,1204,100,0,0.001,0.01,0.522,597,607
9,1304,100,0,0.001,0.01,0.526,651,653
9,1404,100,0,0.001,0.01,0.54,704,700
9,1504,100,0,0.001,0.01,0.546,748,756
9,1604,100,0,0.001,0.01,0.536,793,811
9,1704,100,0,0.001,0.01,0.534,853,851
9,1804,100,0,0.001,0.01,0.522,904,900
9,1904,100,0,0.001,0.01,0.512,952,952
10,0,100,0,0.001,0.01,0.524,0,0
10,104,100,0,0.001,0.01,0.514,53,51
10,204,100,0,0.001,0.01,0.502,108,96
10,304,100,0,0.001,0.01,0.54,164,140
10,404,100,0,0.001,0.01,0.52,216,188
10,504,100,0,0.001,0.01,0.526,267,237
10,604,100,0,0.001,0.01,0.498,322,282
10,704,100,0,0.001,0.01,0.518,376,328
10,804,100,0,0.001,0.01,0.482,422,382
10,904,100,0,0.001,0.01,0.478,470,434
10,1004,100,0,0.001,0.01,0.486,530,474
10,1104,100,0,0.001,0.01,0.488,580,524
10,1204,100,0,0.001,0.01,0.508,628,576
10,1304,100,0,0.001,0.01,0.486,677,627
10,1404,100,0,0.001,0.01,0.476,721,683
10,1504,100,0,0.001,0.01,0.49,770,734
10,1604,100,0,0.001,0.01,0.484,815,789
10,1704,100,0,0.001,0.01,0.476,861,843
10,1804,100,0,0.001,0.01,0.5,904,900
10,1904,100,0,0.001,0.01,0.494,952,952
11,0,100,0,0.001,0.01,0.606,0,0
11,104,100,0,0.001,0.01,0.526,56,48
11,204,100,0,0.001,0.01,0.566,101,103
11,304,100,0,0.001,0.01,0.552,147,157
11,404,100,0,0.001,0.01,0.536,204,200
11,504,100,0,0.001,0.01,0.502,254,250
11,604,100,0,0.001,0.01,0.51,312,292
11,704,100,0,0.001,0.01,0.502,360,344
11,804,100,0,0.001,0.01,0.502,407,397
11,904,100,0,0.001,0.01,0.502,449,455
11,1004,100,0,0.001,0.01,0.502,494,510
11,1104,100,0,0.001,0.01,0.53,552,552
11,1204,100,0,0.001,0.01,0.518,598,606
11,1304,100,0,0.001,0.01,0.484,654,650
11,1404,100,0,0.001,0.01,0.474,702,702
11,1504,100,0,0.001,0.01,0.482,748,756
11,1604,100,0,0.001,0.01,0.496,801,803
11,1704,100,0,0.001,0.01,0.484,849,855
11,1804,100,0,0.001,0.01,0.512,901,903
11,1904,100,0,0.001,0.01,0.506,952,952
12,0,100,0,0.001,0.01,0.53,0,0
12,104,100,0,0.001,0.01,0.574,53,51
12,204,100,0,0.001,0.01,0.532,102,102
12,304,100,0,0.001,0.01,0.594,150,154
12,404,100,0,0.001,0.01,0.546,202,202
12,504,100,0,0.001,0.01,0.584,253,251
12,604,100,0,0.001,0.01,0.524,306,298
12,704,100,0,0.001,0.01,0.508,355,349
12,804,100,0,0.001,0.01,0.536,412,392
12,904,100,0,0.001,0.01,0.5,464,440
12,1004,100,0,0.001,0.01,0.506,513,491
12,1104,100,0,0.001,0.01,0.516,559,545
12,1204,100,0,0.001,0.01,0.512,609,595
12,1304,100,0,0.001,0.01,0.482,656,648
12,1404,100,0,0.001,0.01,0.5,706,698
12,1504,100,0,0.001,0.01,0.496,744,760
12,1604,100,0,0.001,0.01,0.472,793,811
12,1704,100,0,0.001,0.01,0.49,851,853
12,1804,100,0,0.001,0.01,0.53,902,902
12,1904,100,0,0.001,0.01,0.508,952,952
13,0,100,0,0.001,0.01,0.488,0,0
13,104,100,0,0.001,0.01,0.566,47,57
13,204,100,0,0.001,0.01,0.524,100,104
13,304,100,0,0.001,0.01,0.556,154,150
13,404,100,0,0.001,0.01,0.52,199,205
13,504,100,0,0.001,0.01,0.52,247,257
13,604,100,0,0.001,0.01,0.508,296,308
13,704,100,0,0.001,0.01,0.488,349,355
13,804,100,0,0.001,0.01,0.482,395,409
13,904,100,0,0.001,0.01,0.518,440,464
13,1004,100,0,0.001,0.01,0.524,489,515
13,1104,100,0,0.001,0.01,0.486,540,564
13,1204,100,0,0.001,0.01,0.492,594,610
13,1304,100,0,0.001,0.01,0.496,640,664
13,1404,100,0,0.001,0.01,0.474,695,709
13,1504,100,0,0.001,0.01,0.492,746,758
13,1604,100,0,0.001,0.01,0.486,797,807
13,1704,100,0,0.001,0.01,0.472,851,853
13,1804,100,0,0.001,0.01,0.466,900,904
13,1904,100,0,0.001,0.01,0.49,952,952
14,0,100,0,0.001,0.01,0.588,0,0
14,104,100,0,0.001,0.01,0.5,50,54
14,204,100,0,0.001,0.01,0.5,102,102
14,304,100,0,0.001,0.01,0.522,145,159
14,404,100,0,0.001,0.01,0.502,185,219
14,504,100,0,0.001,0.01,0.508,246,258
14,604,100,0,0.001,0.01,0.514,295,309
14,704,100,0,0.001,0.01,0.504,343,361
14,804,100,0,0.001,0.01,0.474,388,416
14,904,100,0,0.001,0.01,0.478,438,466
14,1004,100,0,0.001,0.01,0.514,497,507
14,1104,100,0,0.001,0.01,0.542,546,558
14,1204,100,0,0.001,0.01,0.524,594,610
14,1304,100,0,0.001,0.01,0.514,649,655
14,1404,100,0,0.001,0.01,0.53,706,698
14,1504,100,0,0.001,0.01,0.534,756,748
14,1604,100,0,0.001,0.01,0.54,800,804
14,1704,100,0,0.001,0.01,0.534,850,854
14,1804,100,0,0.001,0.01,0.538,895,909
14,1904,100,0,0.001,0.01,0.488,952,952
15,0,100,0,0.001,0.01,0.662,0,0
15,104,100,0,0.001,0.01,0.5,55,49
15,204,100,0,0.001,0.01,0.502,106,98
15,304,100,0,0.001,0.01,0.5,163,141
15,404,100,0,0.001,0.01,0.53,209,195
15,504,100,0,0.001,0.01,0.49,256,248
15,604,100,0,0.001,0.01,0.488,306,298
15,704,100,0,0.001,0.01,0.512,355,349
15,804,100,0,0.001,0.01,0.496,407,397
15,904,100,0,0.001,0.01,0.488,453,451
15,1004,100,0,0.001,0.01,0.492,508,496
15,1104,100,0,0.001,0.01,0.484,554,550
15,1204,100,0,0.001,0.01,0.498,600,604
15,1304,100,0,0.001,0.01,0.504,651,653
15,1404,100,0,0.001,0.01,0.49,701,703
15,1504,100,0,0.001,0.01,0.494,751,753
15,1604,100,0,0.001,0.01,0.518,800,804
15,1704,100,0,0.001,0.01,0.526,853,851
15,1804,100,0,0.001,0.01,0.484,894,910
15,1904,100,0,0.001,0.01,0.53,952,952
16,0,100,0,0.001,0.01,0.654,0,0
16,104,100,0,0.001,0.01,0.564,51,53
16,204,100,0,0.001,0.01,0.594,101,103
16,304,100,0,0.001,0.01,0.548,154,150
16,404,100,0,0.001,0.01,0.526,204,200
16,504,100,0,0.001,0.01,0.53,251,253
16,604,100,0,0.001,0.01,0.55,307,297
16,704,100,0,0.001,0.01,0.514,348,356
16,804,100,0,0.001,0.01,0.558,395,409
16,904,100,0,0.001,0.01,0.548,458,446
16,1004,100,0,0.001,0.01,0.518,516,488
16,1104,100,0,0.001,0.01,0.554,559,545
16,1204,100,0,0.001,0.01,0.554,601,603
16,1304,100,0,0.001,0.01,0.532,653,651
16,1404,100,0,0.001,0.01,0.55,704,700
16,1504,100,0,0.001,0.01,0.546,751,753
16,1604,100,0,0.001,0.01,0.54,804,800
16,1704,100,0,0.001,0.01,0.552,847,857
16,1804,100,0,0.001,0.01,0.556,902,902
16,1904,100,0,0.001,0.01,0.534,952,952
17,0,100,0,0.001,0.01,0.628,0,0
17,104,100,0,0.001,0.01,0.502,59,45
17,204,100,0,0.001,0.01,0.612,114,90
17,304,100,0,0.001,0.01,0.586,159,145
17,404,100,0,0.001,0.01,0.558,203,201
17,504,100,0,0.001,0.01,0.554,262,242
17,604,100,0,0.001,0.01,0.55,311,293
17,704,100,0,0.001,0.01,0.542,361,343
17,804,100,0,0.001,0.01,0.54,411,393
17,904,100,0,0.001,0.01,0.526,466,438
17,1004,100,0,0.001,0.01,0.534,514,490
17,1104,100,0,0.001,0.01,0.548,569,535
17,1204,100,0,0.001,0.01,0.538,619,585
17,1304,100,0,0.001,0.01,0.54,673,631
17,1404,100,0,0.001,0.01,0.554,722,682
17,1504,100,0,0.001,0.01,0.582,765,739
17,1604,100,0,0.001,0.01,0.582,810,794
17,1704,100,0,0.001,0.01,0.606,856,848
17,1804,100,0,0.001,0.01,0.624,905,899
17,1904,100,0,0.001,0.01,0.59,952,952
18,0,100,0,0.001,0.01,0.606,0,0
18,104,100,0,0.001,0.01,0.5,52,52
18,204,100,0,0.001,0.01,0.51,110,94
18,304,100,0,0.001,0.01,0.508,167,137
18,404,100,0,0.001,0.01,0.53,220,184
18,504,100,0,0.001,0.01,0.516,277,227
18,604,100,0,0.001,0.01,0.532,328,276
18,704,100,0,0.001,0.01,0.532,380,324
18,804,100,0,0.001,0.01,0.53,427,377
18,904,100,0,0.001,0.01,0.524,472,432
18,1004,100,0,0.001,0.01,0.53,523,481
18,1104,100,0,0.001,0.01,0.538,575,529
18,1204,100,0,0.001,0.01,0.524,623,581
18,1304,100,0,0.001,0.01,0.514,671,633
18,1404,100,0,0.001,0.01,0.492,718,686
18,1504,100,0,0.001,0.01,0.5,762,742
18,1604,100,0,0.001,0.01,0.476,813,791
18,1704,100,0,0.001,0.01,0.496,856,848
18,1804,100,0,0.001,0.01,0.506,905,899
18,1904,100,0,0.001,0.01,0.504,952,952
19,0,100,0,0.001,0.01,0.62,0,0
19,104,100,0,0.001,0.01,0.65,47,57
19,204,100,0,0.001,0.01,0.622,90,114
19,304,100,0,0.001,0.01,0.57,143,161
19,404,100,0,0.001,0.01,0.534,193,211
19,504,100,0,0.001,0.01,0.53,251,253
19,604,100,0,0.001,0.01,0.518,303,301
19,704,100,0,0.001,0.01,0.518,354,350
19,804,100,0,0.001,0.01,0.532,405,399
19,904,100,0,0.001,0.01,0.514,460,444
19,1004,100,0,0.001,0.01,0.538,512,492
19,1104,100,0,0.001,0.01,0.516,555,549
19,1204,100,0,0.001,0.01,0.554,601,603
19,1304,100,0,0.001,0.01,0.532,646,658
19,1404,100,0,0.001,0.01,0.536,703,701
19,1504,100,0,0.001,0.01,0.536,752,752
19,1604,100,0,0.001,0.01,0.534,801,803
19,1704,100,0,0.001,0.01,0.54,847,857
19,1804,100,0,0.001,0.01,0.52,901,903
19,1904,100,0,0.001,0.01,0.546,952,952
20,0,100,0,0.001,0.01,0.572,0,0
20,104,100,0,0.001,0.01,0.51,51,53
20,204,100,0,0.001,0.01,0.584,104,100
20,304,100,0,0.001,0.01,0.562,149,155
20,404,100,0,0.001,0.01,0.546,197,207
20,504,100,0,0.001,0.01,0.528,251,253
20,604,100,0,0.001,0.01,0.548,303,301
20,704,100,0,0.001,0.01,0.552,353,351
20,804,100,0,0.001,0.01,0.528,413,391
20,904,100,0,0.001,0.01,0.516,459,445
20,1004,100,0,0.001,0.01,0.518,507,497
20,1104,100,0,0.001,0.01,0.516,559,545
20,1204,100,0,0.001,0.01,0.544,613,591
20,1304,100,0,0.001,0.01,0.548,660,644
20,1404,100,0,0.001,0.01,0.538,715,689
20,1504,100,0,0.001,0.01,0.528,770,734
20,1604,100,0,0.001,0.01,0.538,818,786
20,1704,100,0,0.001,0.01,0.57,852,852
20,1804,100,0,0.001,0.01,0.546,899,905
20,1904,100,0,0.001,0.01,0.552,952,952
